leave sth. (sb.) out: [acc]/liːv ˈsʌmθɪŋ ˈsʌmbədi aʊt/; [phr]遗漏,不考虑;
in stock: [acc]/ɪn stɒk/; [phr]有存货;
stick to sb. (sth.): [acc]/stɪk tu ˈsʌmbədi (ˈsʌmθɪŋ)/; [phr]忠于;
come along: [acc]/kʌm ə'lɔːŋ/; [phr]一起;进步;出现;
look for: [acc]/lʊk fɔr/; [phr]寻找;期待;
keep away (from): [acc]/kiːp əˈweɪ frʌm/; [phr]远离,回避;
be all set: [acc]/bi ɔl set/; [phr]准备就绪;
take sth. back: [acc]/teɪk ˈsʌmθɪŋ bæk/; [phr]收回;取回;
find fault with: [acc]/faɪnd fɔlt wɪθ/; [phr]埋怨,挑剔;
look down on: [acc]/lʊk daʊn ɑːn/; [phr]轻视;
bear with (sb.): [acc]/ber wɪθ ˈsʌmbədi/; [phr]耐心等待;宽容;
stand out: [acc]/stænd aut/; [phr]突出;继续抵抗;
live up to: [acc]/lɪv ʌp tu/; [phr]不辜负;做到;
make for sb.(sth.): [acc]/meɪk fɔːr ˈsʌmbədi ˈsʌmθɪŋ/; [phr]有助于;促进;走向;
stand by sth.: [acc]/stænd baɪ ˈsʌmθɪŋ/; [phr]信守;支持;
on behalf of: [acc]/ɔn bɪˈhæf ɑv/; [phr]代表.,为了.;
on the air: [acc]/ɔn ðə er/; [phr]直播中;
pay for: [acc]/peɪ fɔr/; [phr]付出代价,出钱;因.受处罚,为.而付钱;
permeate through (among): [acc]/ˈpɜːrmieɪt θruː əˈmʌŋ/; [phr]渗透,透入;
pull through: [acc]/pʊl θru/; [phr]渡过难关;恢复健康;
settle down: [acc]/ˈset(ə)l daʊn/; [phr]定居,安定下来;
hold back: [acc]/hoʊld bæk/; [phr]阻挡,抑制,控制; [v]隐瞒;
come upon: [acc]/kʌm əˈpɑn/; [phr]遇到;对⋯⋯有感觉;突然⋯⋯想做;
bring about: [acc]/brɪŋ əˈbaʊt/; [phr]导致,引起;
for the most part: [acc]/fɔr ðə moʊst pɑrt/; [phr]多半;通常;在极大程度上;
merge into: [acc]/mɜrdʒ ˈɪntu/; [phr]合并;结合;
carry out: [acc]/ˈkærɪ aʊt/; [phr]执行,实行;实现;完成;
consist of: [acc]/kənˈsɪst ɑv/; [phr]由..组成;
go off: [acc]/ɡoʊ ɑf/; [phr]爆炸;进行;变质;
get off: [acc]/ɡet ɑf/; [phr]动身;免于受罚;从..下来;把手拿开;
get on: [acc]/ɡet ɔːn/; [phr]上车(飞机,船),进展,使前进;
look back (on sth.): [acc]/lʊk bæk ɒn ˈsʌmθɪŋ/; [phr]回顾;
the present day: [acc]/ˌpreznt ˈdeɪ/; [phr]现代;
come apart: [acc]/kʌm əˈpɑrt/; [phr]破碎;瓦解;崩塌;
get away: [acc]/ɡet, əˈweɪ/; [phr]离开,逃脱;
get down to business: [acc]/ɡet daʊn tu ˈbɪznəs/; [phr]着手干正事;
get into: [acc]/ɡet ˈɪntu/; [phr]穿上;陷入,染上(习惯);对.有兴趣;
get nowhere: [acc]/ɡet ˈnoʊˌhwer/; [phr](使)无进展;行不通;
go by: [acc]/ɡoʊ baɪ/; [phr]走过,过去;(时间)流逝;
hard and fast: [acc]/hɑrd ənd fæst/; [phr](规则等)严格的,不容改变的;
keep in with sb.: [acc]/kiːp ɪn wɪθ ˈsʌmbədi/; [phr]与(某人)友好相处;
let alone: [acc]/let əˈloʊn/; [phr]听任;不打扰;更别说;
make off: [acc]/meɪk ɑf/; [phr]逃走;离开;匆忙离开;
on account of: [acc]/ɑːn ə'kaʊnt əv/; [phr]因为;
pass sb. (sth.) by: [acc]/pæs ˈsʌmbədi ˈsʌmθɪŋ baɪ/; [phr]经过,走过;打..旁边走过;忽视;
pay sb. back for sth.: [acc]/peɪ ˈsʌmbədi bæk fɔːr ˈsʌmθɪŋ/; [phr]向.报复,报答;
reckon on: [acc]/ˈrekən ɔn/; [phr]依赖;估计;计划;指望;
say to oneself: [acc]/seɪ tu wʌnˈself/; [phr]心中暗想;自言自语;
look forward to: [acc]/lʊk ˈfɔːrwərd tu/; [phr]盼望;
go down: [acc]/ɡoʊ daʊn/; [phr]下降;平静下来;被接受;
live through: [acc]/lɪv θru/; [phr]度过;
come to nothing: [acc]/kʌm tu ˈnʌθɪŋ/; [phr]失败,落空;
take to sth.(sb.): [acc]/teɪk tu ˈsʌmθɪŋ ˈsʌmbədi/; [phr]喜欢;养成.习惯;
lay sth. aside: [acc]/leɪ ˈsʌmθɪŋ əˈsaɪd/; [phr]储蓄;放一边;
go into: [acc]/ɡoʊ ˈɪntu/; [phr]进入;加入;变得;探究;
take sth. apart: [acc]/teɪk ˈsʌmθɪŋ əˈpɑːrt/; [phr]拆开;
out of line (with): [acc]/aʊt ʌv laɪn wɪθ/; [phr]跟.(不)一致;
cut sth. (sb.) down: [acc]/kʌt ˈsʌmθɪŋ ˈsʌmbədi daʊn/; [phr]砍倒;削减;说服某人降价;
in the air: [acc]/ɪn ðə er/; [phr]在空中;悬而未决;在流传中;
stand off: [acc]/stænd ɑf/; [phr]远离;疏远;
live with: [acc]/lɪv wɪθ/; [phr]接受,忍受;同居;
bring up: [acc]/brɪŋ ʌp/; [phr]养育;呕出;提出;
hold on: [acc]/həʊld ɒn/; [phr]坚持;不挂断;稍等;紧紧抓住;
learn/know sth. by heart: [acc]/lɜːrn noʊ ˈsʌmθɪŋ baɪ hɑːrt/; [phr]记住,背下;
call (sth.) off: [acc]/kɔːl ˈsʌmθɪŋ ɑːf/; [phr]停止;
all out: [acc]/ˌɔːl ˈaʊt/; [phr]全力以赴;
do away with: [acc]/doʊ əˈweɪ wɪθ/; [phr]废除;消灭;去掉;
hang on: [acc]/hæŋ ɔn/; [phr]坚持下去;不挂断;稍等;握住不放;
keep off: [acc]/kip ɑf/; [phr]让开;不接近;
look after: [acc]/lʊk ˈæftər/; [phr]照顾,照看;
back sb. up: [acc]/bæk ˈsʌmbədi ʌp/; [phr]支持某人;
back down (from): [acc]/bæk daʊn frəm/; [phr]投降,认输;
hold the line: [acc]/hoʊld ðə laɪn/; [phr]坚持下去;不挂断电话;
leave sb. (sth.) alone: [acc]/liːv ˈsʌmbədi ˈsʌmθɪŋ əˈloʊn/; [phr]不干涉某人(某事);
leave sb. (sth.) behind: [acc]/liːv ˈsʌmbədi ˈsʌmθɪŋ bɪˈhaɪnd/; [phr]忘带,留下;
check out: [acc]/tʃek aʊt/; [phr]结账后离开,检验,通过考核,合格;
break down: [acc]/brek daʊn/; [phr]发生故障;失败;(精神)垮下来;
feel for: [acc]/fil fɔr/; [phr]同情;
lose face: [acc]/luz feɪs/; [phr]丢面子;
curriculum vitae: [acc]/kəˌrɪkjələm ˈviːtaɪ/; [phr]简短的履历书;
lay bare: [acc]/leɪ ber/; [phr]揭发;暴露;公开;
lay (sth.) bare: [acc]/leɪ ˈsʌmθɪŋ ber/; [phr]显示;揭露;
look round: [acc]/lʊk raʊnd/; [phr]四处看;寻找;
be better off: [acc]/bi ˈbetər ɑf/; [phr]较富裕;更好;
get out: [acc]/ɡet aʊt/; [phr]出去;逃脱;泄露;
bring back: [acc]/briŋbæk/; [phr]拿回来;使.回忆起来;
go after sb. (sth.): [acc]/ɡoʊ ˈæftər ˈsʌmbədi ˈsʌmθɪŋ/; [phr]追求,追逐;
keep an eye on: [acc]/kiːp æn aɪɑːn/; [phr]密切注视;
take off: [acc]/teɪk, ɒf/; [phr](飞机)起飞;拿掉;取消;脱衣;(事业)突然成功,突然蹿红;
fall back on: [acc]/fɔl bæk ɔn/; [phr]求助于;
look over: [acc]/lʊk ˈoʊvər/; [phr]检查;
take-away: [acc]/teɪk əˈweɪ/; [phr]外带,外卖;
call on: [acc]/kɔːl ɑːn/; [phr]拜访,呼吁,请求;
take sth. to heart: [acc]/teɪk ˈsʌmθɪŋ tu hɑːrt/; [phr]牢记;为某事耿耿于怀;
look sth. up: [acc]/lʊk ˈsʌmθɪŋ ʌp/; [phr]查字典;
all the same to: [acc]/ɔl ðə seɪm tu/; [phr]对.说来都一样;无所谓;
at its best: [acc]/ət ɪts best/; [phr]处在最好状态;
hang up: [acc]/hæŋ ʌp/; [phr]挂断电话;
go back: [acc]/ɡoʊ bæk/; [phr]回去;追溯;
be on good terms (with sb.): [acc]/biː ɔːn ɡʊd tɜːrmz wɪθ ˈsʌmbədi/; [phr]关系好;
hold one's ground: [acc]/hold wʌnz ɡraʊnd/; [phr]坚持立场;
clear out: [acc]/klɪr aʊt/; [phr]匆忙离开;逃离;清空;腾空;
look at: [acc]/lʊk ət/; [phr]看,浏览,检查;
come about: [acc]/kʌm ə'baʊt/; [phr]发生;
come off: [acc]/kʌm ɑf/; [phr]从..掉下,发生,举行,(计划)实现;
live on: [acc]/liːv ɑːn/; [phr]以.为主食;靠.生活;
come on: [acc]/kʌm ɔn/; [phr]来吧;发展;开始;
go over: [acc]/ɡoʊ ˈoʊvər/; [v]仔细检查; [phr]复习,重温;
get the better of: [acc]/ɡet ðə ˈbetər ɑv/; [phr]打败;
take sth. off: [acc]/teɪk ˈsʌmθɪŋ ɑːf/; [phr]除去;取消;脱掉;
the pick of: [acc]/ðə pɪk ɑv/; [phr]精华,最好部分;
learn sth. the hard way: [acc]/lɜːrn ˈsʌmθɪŋ ðə hɑːrd weɪ/; [phr]经过艰难困苦而学到;
come round(around): [acc]/kʌm raʊnd əˈraʊnd/; [phr]绕道而来;过访;重又来到;改变主意;苏醒;
take sth. upon oneself: [acc]/teɪk ˈsʌmθɪŋ əˈpɔːn wʌnˈself/; [phr]承担;担任;
have one's hands full: [acc]/hæv wʌnz hændz fʊl/; [phr]忙得不可开交;手头事情应接不暇;离不开手;
at fault: [acc]/ət fɔlt/; [phr]⋯⋯过错,⋯⋯责任;
do sth. with a bad grace: [acc]/duː ˈsʌmθɪŋ wɪð ə bæd ɡreɪs/; [phr]勉强做某事;
make one's day: [acc]/meɪk wʌnz deɪ/; [phr]使某人快活;
go (very) far: [acc]/ɡoʊ ˈveri fɑːr/; [phr]成功;扬名;大有前途;
at the outset: [acc]/ət ðə ˈaʊtˌset/; [phr]在开头时;
lose one's bearings: [acc]/luːz wʌnz ˈberɪŋs/; [phr]迷失方向;不知所措;
go up: [acc]/ɡoʊ ʌp/; [phr]上升;被建立;被炸毁;
stick up: [acc]/stɪk ʌp/; [phr]竖起;
go with sb. (sth.): [acc]/ɡoʊ wɪθ ˈsʌmbədi ˈsʌmθɪŋ/; [phr]陪伴.去;与.相配;
keep to the beaten track: [acc]/kip tu ðə ˈbit(ə)n træk/; [phr]循规蹈矩;
get round to doing sth: [acc]/ɡet raʊnd tu ˈduːɪŋ ˈsʌmθɪŋ/; [phr]抽出时间做;
to one's face: [acc]/tu wʌnz feɪs/; [phr]坦白地;当面;
have one's say: [acc]/hæv wʌnz seɪ/; [phr]利用机会发表意见;
catch on: [acc]/kætʃ ɔn/; [phr]变得流行;理解;
cash crop: [acc]/ˈkæʃ krɑːp/; [phr]经济作物;
end up: [acc]/end ʌp/; [phr]以.告终;
come down: [acc]/kʌm daʊn/; [phr]倒塌;下降,下来;
be hard to say: [acc]/bi hɑrd tu seɪ/; [phr]难以开口;
come to terms (with sb.): [acc]/kʌm tu tɜːrmz wɪθ ˈsʌmbədi/; [phr]与..达成协议;
for one thing: [acc]/fɔr wʌn θɪŋ/; [phr]首先;一则;
on and on: [acc]/ɔn ənd ɔn/; [phr]继续不停地;
pass on: [acc]/pæs ɔn/; [phr]传给;去世;
pull sth. down: [acc]/pʊl ˈsʌmθɪŋ daʊn/; [phr]摧毁;破坏;拆除;
set off: [acc]/set ɑf/; [phr]出发;
settle (sb.) in: [acc]/ˈsetl ˈsʌmbədi ɪn/; [phr]迁入(新居),(使)习惯;
sort sth. out: [acc]/sɔːrt ˈsʌmθɪŋ aʊt/; [phr]分类,拣选,整理;解决;消除误会;
speak one's mind: [acc]/spik wʌnz maɪnd/; [phr]直言不讳,吐露心声;
take sb. off: [acc]/teɪk ˈsʌmbədi ɑːf/; [phr]带走;
give way to: [acc]/ɡɪv weɪ tu/; [phr]让位于..;让路;
as opposed to: [acc]/æz ə'poʊʊzd tu/; [phr]与.形成对照;
be on to: [acc]/bi ɔn tu/; [phr]意识到,识透;找..岔子;
give oneself up: [acc]/ɡɪv wʌnˈself ʌp/; [phr]自首;投降;
hand sth. out: [acc]/hænd ˈsʌmθɪŋ aʊt/; [phr]分发;
hand sth. over to sb.: [acc]/hænd ˈsʌmθɪŋ ˈoʊvər tu ˈsʌmbədi/; [phr]移交;
open one's eyes to: [acc]/ˈoʊpən wʌnz aɪz tu/; [phr]使某人看清;
pull sth. off: [acc]/pʊl ˈsʌmθɪŋ ɑːf/; [phr]努力实现;
take sb. out: [acc]/teɪk ˈsʌmbədi aʊt/; [phr]带.出去;淘汰出局;
hold out (against): [acc]/hoʊld aʊt əˈɡeɪnst/; [phr]坚持(反抗),顶住;
in sb.'s favour: [acc]/ɪn ˈsʌmbədiz ˈfeɪvər/; [phr]对某人有利;偏爱;
get down to: [acc]/ɡet daʊn tu/; [phr]开始认真对待;着手处理;
null and void: [acc]/nʌl ənd vɔɪd/; [phr]无效的;
back and forth: [acc]/bæk ənd fɔrθ/; [phr]来回地;
regardless of: [acc]/rɪˈɡɑːrdləs əv/; [phr]不论,不管;
all but: [acc]/ɔl bət/; [phr]几乎;差不多;除.以外所有的;
apart from: [acc]/əˈpɑːrt frəm/; [phr]除..之外;
waste disposal: [acc]/weɪst dɪˈspoʊz(ə)l/; [phr]废物处理;
living quarters: [acc]/ˈlɪvɪŋ ˈkwɔːrtərs/; [phr]住处;
account for: [acc]/əˈkaʊnt fɔr/; [phr]解释,说明;(在数量方面)占;对.负责;导致,引起;
equilateral triangle: [acc]/ˌiːkwɪˌlætərəl ˈtraɪæŋɡl/; [phr]等边三角形;
wipe out: [acc]/waɪp aʊt/; [phr]消灭;
deal with: [acc]/dil wɪθ/; [phr]处理;研究;
follow suit: [acc]/‘fɔləusuːt/; [phr]学样,照着做;
testify to: [acc]/ˈtestɪˌfaɪ tu/; [phr]证实;
light bulb: [acc]/ˈlaɪt bʌlb/; [phr]灯泡;
critical point: [acc]/ˈkrɪtɪk(ə)l pɔɪnt/; [phr]临界点;
feed on: [acc]/fid ɔn/; [phr]以..为食;
snack bar: [acc]/ˈsnæk bɑːr/; [phr]快餐馆;小吃店;
ward off: [acc]/wɔrd ɑf/; [phr]避开;挡住;
a great deal: [acc]/ə ɡreɪt dil/; [phr]丰富;大量;
a pivotal figure: [acc]/eɪ ˈpɪvətl ˈfɪɡjər/; [phr]关键人物;
an army of: [acc]/ən ˈɑrmi ɑv/; [phr]大群的,大量的;
be characterized by: [acc]/biː ˈkærəktəraɪzd baɪ/; [phr]以.为特征,典型代表;
be informed about: [acc]/bi ɪnˈfɔrmd əˈbaʊt/; [phr]熟悉,知晓;
behave oneself: [acc]/biˈheɪv wʌnˈself/; [phr]举止得体,端庄;
believe in: [acc]/bɪˈliv ɪn/; [phr]相信;
belong to: [acc]/bɪˈlɔŋ tu/; [phr]属于;
big deal: [acc]/bɪɡ dil/; [phr]重大的事,重要的人;
biological diversity: [acc]/ˌbaɪəˌlɑːdʒɪkl daɪˈvɜːrsəti/; [phr]生物多样性;
boiling point: [acc]/ˈbɔɪlɪŋ pɔɪnt/; [phr]沸点;
break apart: [acc]/breɪk əˈpɑrt/; [phr]分开,分裂;
break out: [acc]/breikaut/; [phr]爆发;发生;越狱;摆脱,逃脱;
break up: [acc]/breikʌp/; [phr]关系破裂,离异,结束,散会,解散,驱散,衰弱;
cast away: [acc]/kæst əˈweɪ/; [phr]使漂流;抛弃;
comply with: [acc]/kəmˈplaɪ wɪθ/; [phr]遵从,符合;
confined to bed: [acc]/kənˈfaɪnd tu bed/; [phr]卧病不起的;
coral reef: [acc]/ˈkɔrəl rif/; [phr]珊瑚礁;
coupled with: [acc]/'kʌpld wɪθ/; [phr]加之;结合;
dash off: [acc]/dæʃ ɑf/; [phr]匆忙地把.写好;
depend on: [acc]/dɪˈpend ɔn/; [phr]依靠;取决于;
dispense with: [acc]/dɪˈspens wɪθ/; [phr]免除;省却;
dispose of: [acc]/dɪˈspoʊz ɑv/; [phr]解决;处理,安排;
dividing line: [acc]/dɪˈvaɪdɪŋ laɪn/; [phr]分界线;
draw out: [acc]/drɔ aʊt/; [phr]拉;抽;使离开;延长;鼓励说出;
draw up: [acc]/drɔ ʌp/; [phr]起草;停靠在;
drop in: [acc]/drɑp ɪn/; [phr]顺便拜访;
engage in: [acc]/ɪnˈɡeɪdʒ ɪn/; [phr]从事于;参加;
exempt from: [acc]/ɪɡˈzempt frɒm/; [phr]豁免;免除;
lunar eclipse: [acc]/ˈlunər ɪˈklɪps/; [phr]月蚀,月食;
mistrustful of: [acc]/ˌmɪs'trʌstfl ɑv/; [phr]不相信,怀疑;
most distinctive: [acc]/moʊst dɪˈstɪŋktɪv/; [phr]最杰出的;
native to: [acc]/ˈneɪtɪv tu/; [phr]土生土长的;
natural gas: [acc]/ˌnætʃrəl ˈɡæs/; [phr]天然气;
object to: [acc]/əbˈdʒekt tu/; [phr]反对;
pack animal: [acc]/ˈpæk ænɪml/; [phr]畜(如马;骆驼等);
pack down: [acc]/pæk daʊn/; [phr]填塞,夯实;
postal service: [acc]/ˈpoʊstl sɜːrvɪs/; [phr]邮政服务;
preside over: [acc]/ˌpriˈzaɪd ˈoʊvər/; [phr]主持,掌管;
presidential election: [acc]/ˌprezɪˈdenʃ(ə)l ɪˈlekʃ(ə)n/; [phr]总统选举;
prime number: [acc]/ˌpraɪm ˈnʌmbər/; [phr]质数;
pry open: [acc]/praɪ ˈoʊpən/; [phr]撬开;
sea cucumber: [acc]/ˌsiː ˈkjuːkʌmbər/; [phr]海参;
set aside for: [acc]/set əˈsaɪd fɔr/; [phr]专门留..给;
shuffle the deck: [acc]/ˈʃʌf(ə)l ðə dek/; [phr]洗牌;
slip one's mind: [acc]/slɪp wʌnz maɪnd/; [phr]忘记;
smoke detector: [acc]/smoʊk dɪˈtektər/; [phr]烟雾探测器;
solar cell: [acc]/ˌsoʊlər ˈsel/; [phr]太阳能电池;
solar eclipse: [acc]/ˈsoʊlər ɪˈklɪps/; [phr]日食;
spring up: [acc]/sprɪŋ ʌp/; [phr]出现,产生;
stand in the way of: [acc]/stænd ɪn ðə weɪ ɑv/; [phr]挡住.的道路,阻止;
take into account: [acc]/teɪk ˈɪntu əˈkaʊnt/; [phr]重视,考虑;
teem with: [acc]/tim wɪθ/; [phr]富有;拥有大量,充满;
to and fro: [acc]/tu ənd froʊ/; [phr]往复,来来回回;
usher in: [acc]/ˈʌʃər ɪn/; [phr]迎接;传报;引发;产生,开创;引领;
wear away: [acc]/wer əˈweɪ/; [phr]磨去;
well organized: [acc]/wel ˈɔrɡəˌnaɪzd/; [phr]有组织的;
artificial leg: [acc]/ˌɑrtɪˈfɪʃ(ə)l leɡ/; [phr]假腿;
wear out: [acc]/wer aʊt/; [phr]用坏,磨损; [v]使...筋疲力尽;
express train: [acc]/ɪkˈspres treɪn/; [phr]特快列车;
fend for oneself: [acc]/fend fɔr wʌnˈself/; [phr]自己谋生;
field research: [acc]/fild ˈriˌsɜrtʃ/; [phr]野外实地考察;
flock to: [acc]/flɑk tu/; [phr]成群结队地去;
get in the way of: [acc]/ɡet ɪn ðə weɪ ɑv/; [phr]阻挡;
go broke: [acc]/ɡoʊ broʊk/; [phr]破产;
gravitational field: [acc]/ˌɡrævɪˈteɪʃən(ə)l fild/; [phr]重力场;
gravitational pull: [acc]/ˌɡrævɪˈteɪʃən(ə)l pʊl/; [phr]地心引力;
grazing land: [acc]/'ɡreɪzɪŋ lænd/; [phr]牧场,草场;
horror film/movie: [acc]/ˈhɔrər fɪlm ˈmuvi/; [phr]恐怖片;
ice cream cone: [acc]/aɪs krim koʊn/; [phr]冰淇淋蛋卷;
immune system: [acc]/ɪˈmjuːn sɪstəm/; [phr]免疫系统;
in accord with: [acc]/ɪn əˈkɔrd wɪθ/; [phr]与.一致;
in common: [acc]/ɪn ˈkɑmən/; [phr]相同的,共有,有共同之处;
in terms of: [acc]/ɪn tɜːrmz əv/; [phr]就.而论;用..字眼;依据;
inorganic chemical: [acc]/ˌɪnɔrˈɡænɪk ˈkemɪk(ə)l/; [n]无机化合物; [phr]无机化学;
learn by rote: [acc]/lɜrn baɪ roʊt/; [phr]死记硬背学习;
log cabin: [acc]/ˌlɔːɡ ˈkæbɪn/; [phr]小木屋;
all in all: [acc]/ɔːl ɪn ɔːl/; [phr]总而言之;总的来说;
as for: [acc]/əz fɔr/; [phr]至于,就.方面说;
get over: [acc]/ɡet ˈoʊvər/; [phr]克服;恢复;熬过;原谅;
in one: [acc]/ɪn wʌn/; [phr]成为一体;只试一次;
not to say: [acc]/nɑːt tə seɪ/; [phr]并不是说;
set in: [acc]/set ɪn/; [phr]开始;到来;生效;流行;设置(戏剧,小说等的)背景;上涨;插入;
give way (to sth.): [acc]/ɡɪv weɪ tuː ˈsʌmθɪŋ/; [phr]给.让路;为.所代替;
make sth. up: [acc]/meɪk ˈsʌmθɪŋ ʌp/; [phr]补足;弥补;编造;虚构;组成;准备;
pass sth. off: [acc]/pæs ˈsʌmθɪŋ ɔːf/; [phr]冒充,假装;蒙混过去,敷衍过去,搪塞过去;
scale up (down): [acc]/skeɪl ʌp daʊn/; [phr]按比例增加(或降低);
check in: [acc]/tʃek ɪn/; [phr]报到,记录;登记入住;
on purpose: [acc]/ɒn, ‘pə:pəs/; [phr]故意;
according to: [acc]/əˈkɔːrdɪŋ tu/; [phr]根据,据..所说;
shut off: [acc]/ʃʌt ɑf/; [phr]关掉(煤气等),切断,使隔绝,脱离;
die out: [acc]/daɪ aʊt/; [phr]灭绝,绝种;
prior to: [acc]/ˈpraɪr tu/; [phr]在..之前;
list price: [acc]/ˈlɪst praɪs/; [phr]目录价格,标价;
pull away: [acc]/pʊl əˈweɪ/; [phr]脱身,离开,脱出;
odd number: [acc]/ɑd ˈnʌmbər/; [phr]奇数;
break through: [acc]/breɪk, θruː/; [phr]突破;突围;
couch potato: [acc]/ˈkaʊtʃ pəteɪtoʊ/; [phr]终日懒散在家的人,电视迷,成天看电视的人;
cover up: [acc]/ˈkʌvə(r), ʌp/; [phr]掩盖;掩饰;盖住;裹住;
dress up: [acc]/dres, ʌp/; [phr]盛装,打扮,装饰;
drop out: [acc]/drɔp aut/; [phr]退学;拒绝传统社会;放弃;退出;辍学;不参与;离去;
emergency exit: [acc]/i'mə:dʒənsi 'eksit, 'eɡ zit/; [phr]紧急出口,太平门;
eye contact: [acc]/ai  'kɔntækt/; [phr]目光接触,眼神交会;
fall over: [acc]/fɔl ˈovɚ/; [phr]跌倒,从..掉下来,落在.上,叛变,颠覆;
food chain: [acc]/ˈfuːd tʃeɪn/; [phr]食物链;
give in: [acc]/ɡɪv ɪn/; [phr]屈服,让步;投降;
grow up: [acc]/ɡrəʊ ʌp/; [phr]长大成人,成长;
hot pot: [acc]/'hɔt pɔt/; [phr]火锅;
look out: [acc]/lʊk aʊt/; [phr]当心,留神;
lost and found: [acc]/ˌlɔːst ən ˈfaʊnd/; [phr]失物招领处;
make faces: [acc]/meɪk feɪs/; [phr]做鬼脸;
make up: [acc]/meɪk, ʌp/; [phr]组成;补足;化妆;编造;
mix up: [acc]/mɪks ʌp/; [phr]混和,混淆;
pass by: [acc]/pɑːs  baɪ/; [phr]经过;
point of view: [acc]/ˌpɔɪnt əv ˈvjuː/; [phr]观点,见地,立场;
put out: [acc]/pʊt aʊt/; [phr]扑灭,熄灯;
throw (sth.) away: [acc]/θrəʊ, əˈweɪ/; [phr]扔掉;
virtual reality: [acc]/ˌvɜːrtʃuəl riˈæləti/; [phr]虚拟现实;
zebra crossing: [acc]/ˌzebrə ˈkrɔːsɪŋ/; [phr]人行横道线(斑马线);
simple interest: [acc]/ˌsɪmpl ˈɪntrəst/; [phr]单利;
every now and then: [acc]/ˈevriː naʊ ənd ðen/; [phr]不时;
range from...to...: [acc]/reɪndʒ frəm tu/; [phr]从.到.的范围;在.中变化;
side effect: [acc]/ˈsaɪd ɪfekt/; [phr]副作用;
do with: [acc]/duː wɪθ/; [phr]需要;
take sb. in: [acc]/teɪk ˈsʌmbədi ɪn/; [phr]收留;欺骗;带到警察局;
be on edge: [acc]/bi ɑn ɛdʒ/; [phr]紧张不安;
prone to: [acc]/proʊn tu/; [phr]易于..的;
gold rush: [acc]/ˈɡoʊld rʌʃ/; [phr]淘金热;
susceptible to: [acc]/səˈseptəb(ə)l tu/; [phr]易受..影响的;
per capita: [acc]/pər ˈkæpɪtə/; [phr]人均;
take pains to do: [acc]/teɪk peɪnz tu doʊ/; [phr]尽力去做;费劲苦心做某事;
natural number: [acc]/ˌnætʃrəl ˈnʌmbər/; [phr]自然数;
speak out: [acc]/spik aʊt/; [phr]大胆地说,清楚和响亮地说;
take precedence over: [acc]/teɪk ˈpresɪdəns ˈoʊvər/; [phr]优先于..,地位在..之上;
daylight saving time: [acc]/ˌdeɪlaɪt ˈseɪvɪŋ taɪm/; [phr]夏时制;
put away: [acc]/pʊt əˈweɪ/; [phr]放好;把.收起来;储存;
right angle: [acc]/ˈraɪt æŋɡl/; [phr]直角;
antitrust law: [acc]/ˌæntiˈtrʌst lɔ/; [phr]反托拉斯法;
in full bloom: [acc]/ɪn fʊl blum/; [phr]全盛时期;
whole number: [acc]/ˌhoʊl ˈnʌmbər/; [phr]整数;
at stake: [acc]/ət steɪk/; [phr]存亡攸关,处于危险中;
interest rate: [acc]/ˈɪntrəst reɪt/; [phr]利率;
give rise to: [acc]/ɡɪv raɪz tu/; [phr]引起,发生;
fill in: [acc]/fɪl ɪn/; [phr]填充;
swimming pool: [acc]/ˈswɪmɪŋ puːl/; [phr]游泳池;
take over: [acc]/teɪk ˈoʊvər/; [phr]接收,接管,接任,夺取;
pick up: [acc]/pɪk ʌp/; [phr]捡起,接人;搭载,拿回;清理;学会;
come across: [acc]/kʌm əˈkrɔs/; [phr]遇到;
add up to: [acc]/æd ʌp tu/; [phr]总计;
turn down: [acc]/tɜrn daʊn/; [phr]拒绝;调低;关小;
care for: [acc]/ker fɔr/; [phr]照料(看),喜欢;
put up: [acc]/pʊt ʌp/; [phr]建造;
show off: [acc]/ʃəʊ ɒf/; [phr]炫耀,卖弄;
run out of: [acc]/rʌn aʊt ɒv/; [phr]用完;
work out: [acc]/wɜrk aʊt/; [phr]计算出;锻炼;计划;解决;
soft drink: [acc]/ˌsɔːft ˈdrɪŋk/; [phr](不含酒精的)清凉饮料;
driver's license: [acc]/ˈdraɪvərz ˈlaɪsns/; [phr]驾驶执照;
gold medal: [acc]/ˌɡoʊld ˈmedl/; [phr]金牌;
from mouth to mouth: [acc]/frɒm maʊθ tu maʊθ/; [phr]口口相传地;人传人地;
night club: [acc]/naɪt klʌb/; [phr]夜总会;
wake up: [acc]/weɪk ʌp/; [phr]醒来;
put on: [acc]/pʊt ɔn/; [phr]穿,戴上,上演;
turn off: [acc]/tɜrn ɑf/; [phr]关掉(水,电,电视,收音机等);
turn on: [acc]/tɜrn ɔn/; [phr]打开(水,电视,收音机,灯,煤气等);  quant. 取决于;攻击;激发性欲;
get up: [acc]/ɡet ʌp/; [phr]起床;
look up: [acc]/lʊk ʌp/; [phr]查找;抬头,仰望;敬仰,尊敬;
side by side: [acc]/saɪd baɪ saɪd/; [phr]肩并肩,一起;
fall asleep: [acc]/fɔl əˈslip/; [phr]入睡;
make a face: [acc]/meɪk ə feɪs/; [phr]做鬼脸,做苦脸;
turn over: [acc]/tɜrn ˈoʊvər/;  quant. 翻动,犁翻(土地),翻转; [phr]交;移交;
give up: [acc]/ɡɪv ʌp/; [phr]放弃;
run away: [acc]/rʌn əˈweɪ/; [phr]逃跑,出走,私奔;避开,失控;
break off: [acc]/breɪk ɔːf/; [phr]折断,掰掉;突然停止,暂停,中断;终止 (关系);
rather than: [acc]/ˈræðər ðən/; [phr]而不是;
point out: [acc]/pɔɪnt aʊt/; [phr]指出;
break in: [acc]/breɪk ɪn/; [phr]闯入,强行进入,插嘴,打断;
think about: [acc]/θɪŋk əˈbaʊt/; [phr]考虑;
face to face: [acc]/feɪs tu feɪs/; [phr]面对面;
hurry up: [acc]/ˈhɜːri ʌp/; [phr]赶快,快点;
think of: [acc]/θɪŋk ɑv/; [phr]想起,考虑;认为,看法;
as a result: [acc]/əz ə rɪˈzʌlt/; [phr]因此,由于;
get together: [acc]/ɡet təˈɡeðər/; [phr]聚集;汇集;开会;
ring road: [acc]/ˈrɪŋ roʊd/; [phr]环形公路;
a bit: [acc]/ə bɪt/; [phr]有一点;一会儿;
a good many: [acc]/ə ɡʊd ˈmeni/; [phr]大量;许多;
a little: [acc]/ə ˈlɪtl/; [phr]一点,少许;
a lot of: [acc]/ə lɑːt əv/; [phr]许多,大量;
a pair of: [acc]/e pɛr ʌv/; [phr]一双,一副;
a piece of: [acc]/e pis ʌv/; [phr]一块,一张,一根,一片;
above all: [acc]/əˈbʌv ɔːl/; [phr]首先,首要;
after class: [acc]/ˈæftɚ klæs/; [phr]课后;
agree to do sth.: [acc]/əˈɡriː tuː duː ˈsʌmθɪŋ/; [phr]同意做某事;
agree with sb.: [acc]/əˈɡriː wɪð ˈsʌmbədi/; [phr]同意某人的看法,与某人看法一致;
all kinds of: [acc]/ɔːl kaɪnds əv/; [phr]各种各样的;
all over: [acc]/ɔːl ˈoʊvər/; [phr]到处,遍及;
all right: [acc]/ˌɔːl ˈraɪt/; [phr]好;顺利的;正确的;
as though: [acc]/æz ðoʊ/; [phr]好像,仿佛;
as usual: [acc]/æz ˈjuːʒuəl/; [phr]通常,平常地;
be proud of: [acc]/bi praʊd ʌv/; [phr]因.骄傲,自豪;
be strict with: [acc]/bi strɪkt wɪð/; [phr]对..严格要求;
break away from: [acc]/brek əˈwe frʌm/; [phr]脱离..;
by air: [acc]/baɪ er/; [phr]乘飞机;
by and by: [acc]/baɪ ənd baɪ/; [phr]逐渐地,不久以后;
by day: [acc]/baɪ deɪ/; [phr]日间,在白天;
call in: [acc]/ˈkɔːlˌɪn/; [phr]叫来;顺便拜访;召回;
call up: [acc]/ˈkɔːlˌʌp/; [phr]打电话,号召;  quant. 使想起;
carry off: [acc]/ˈkæri ɔːf/; [phr]夺走;获得(奖项,奖杯);成功应对;
catch up with: [acc]/kætʃ ʌp wɪð/; [phr]赶上;
change into: [acc]/tʃeɪndʒ ˈɪntʊ/; [phr]变成;把..变成;转换成;
come back: [acc]/kʌm bæk/; [phr]回来,想起来;
come from: [acc]/kʌm frʌm/; [phr]来自,出生(于);
come in: [acc]/kʌm ɪn/; [phr]进入,进来;
come true: [acc]/kʌm truː/; [phr]变为现实;
compare to: [acc]/kəmˈper tu/; [phr]与..相比;
compare with: [acc]/kəmˈper wɪð/; [phr]与..相比;
congratulate...on: [acc]/kənˈɡrætʃuleɪt ɔːn/; [phr]祝贺..;
connect to: [acc]/kəˈnekt tuː/; [phr]连接,相连;
connect with: [acc]/kəˈnɛkt wɪð/; [phr]与..相连;
cut off: [acc]/kʌt ɔːf/; [phr]切断;
cut up: [acc]/kʌt ʌp/; [phr]切碎;
day and night: [acc]/deɪ ənd naɪt/; [phr]日夜不停地,不断地;
different from: [acc]/ˈdɪfərənt frʌm/; [phr]与..不同;
divide up: [acc]/dɪˈvaɪd ʌp/; [phr]分配;
do some cleaning: [acc]/duː səm ˈkliːnɪŋ/; [phr]做扫除;
do some shopping: [acc]/du sʌm ˈʃɑpɪŋ/; [phr]买东西;
dozens of: [acc]/ˈdʌznz əv/; [phr]几十;
each other: [acc]/ˌiːtʃ ˈʌðər/; [phr]相互;
fall ill: [acc]/fɔːl ɪl/; [phr]患病,病倒;
far away: [acc]/fɑːr əˈweɪ/; [phr]遥远的;
figure out: [acc]/ˈfɪɡjər aʊt/; [phr]想明白,理解;
find out: [acc]/faɪnd aʊt/; [phr]查明,发现,了解;
for ever: [acc]/fər ˈevər/; [phr]永远;
have to: [acc]/ˈhæv tə/; [phr]必须;不得不;
in surprise: [acc]/ɪn sɚˈpraɪz/; [phr]吃惊,惊讶;
keep back: [acc]/kiːp bæk/; [phr]保留,阻止,阻挡,隐瞒;
knock at: [acc]/nɑk æt/; [phr]敲;
let sb. in: [acc]/let ˈsʌmbədi ɪn/; [phr]让..进来,放进;
let out: [acc]/ˈletˌaʊt/; [phr]放出;泄露;发出;
look through: [acc]/lʊk θrʊ/; [phr]浏览,看穿;
make up of: [acc]/mek ʌp ʌv/; [phr]由..组成,构成;
millions of: [acc]/ˈmɪljənz əv/; [phr]成百万上千万,数以百万计;
on duty: [acc]/ɑːn ˈdʊti/; [phr]值日,值班;
on foot: [acc]/ɑːn fʊt/; [phr]走路,步行;
on show: [acc]/ɑːn ʃoʊ/; [phr]展出,在上演(放映);
out of work: [acc]/aʊt əv wɜːrk/; [phr]失业;
take up: [acc]/teɪk ʌp/; [phr]占据,占用,拿起,开始做,继续;
tape recorder: [acc]/ˈteɪp rɪkɔːrdər/; [phr]磁带录音机;
a kind of: [acc]/ə kaɪnd əv/; [phr]一种,一类;
again and again: [acc]/əˈɡen ənd əˈɡen/; [phr]再三地;反复地;
all the best: [acc]/ɔːl ðə best/; [phr]一切顺利;一路平安;
answer for: [acc]/ˈænsər fɔːr/; [phr]对..负责;
as a matter of fact: [acc]/æz ə ˈmætər əv fækt/; [phr]事实上,其实;
as...as: [acc]/æz æz/; [phr]像,如同;
as long as: [acc]/æz lɔːŋ æz/; [phr]只要;
both...and: [acc]/boʊθ ænd/; [phr]两个都,既..又..;
either...or: [acc]/ˈiːðər ɔːr/; [phr].或者.;不是.就是.;
enjoy oneself: [acc]/enˈdʒɔːɪ wʌnˈself/; [phr]过得愉快;
even if: [acc]/ˈiːvən ɪf/; [phr]即使,尽管;
even though: [acc]/ˈiːvən ðoʊ/; [phr]尽管,即使;
ever since: [acc]/ˈevər sɪns/; [phr]自那时起直到现在;
fill with: [acc]/fɪl wɪð/; [phr]用..填充;
from now on: [acc]/frʌm naʊ ɑːn/; [phr]从今以后,今后;
get along with: [acc]/ɡet əˈlɔːŋ wɪð/; [phr]与..相处;
give away: [acc]/ɡɪv ə'weɪ/; [phr]分发;出卖;泄露;赠送;
go ahead: [acc]/ˈɡoʊəˌhed/; [phr]走在前面,领先,干吧,干下去;
go away: [acc]/ɡoʊ əˈweɪ/; [phr]走开,出去;
go fishing: [acc]/ɡo ˈfɪʃɪŋ/; [phr](去)钓鱼;
go for a walk: [acc]/ɡoʊ fɔːr ə wɔːk/; [phr]散步;
go on doing: [acc]/ɡoʊ ɔːn ˈduːɪŋ/; [phr]继续干某事,不停地干某事;
go through: [acc]/ɡoʊ θruː/; [phr]浏览,查阅;通过,完成;经历,经受;
have a cold: [acc]/hæv e kold/; [phr]患感冒;
have a gift for: [acc]/hæv e ɡɪft fɔr/; [phr]对..有天赋;
have a good time: [acc]/hæv ə ɡʊd taɪm/; [phr]玩得高兴,过得愉快;
have classes: [acc]/hæv klɑ:sɪz/; [phr]上课;
have fun with: [acc]/hæv fʌn wɪð/; [phr]玩得高兴;
hear from: [acc]/hɪr frʌm/; [phr]收到..的来信;
help oneself to: [acc]/help wʌnˈself tu/; [phr]请随便吃点;
help sb. with sth.: [acc]/help ˈsʌmbədi wɪð ˈsʌmθɪŋ/; [phr]帮助某人做某事;
hundreds of: [acc]/hʌndrədz əv/; [phr]几百;成百上千;
in a hurry: [acc]/ɪn ə ˈhɜːri/; [phr]匆忙,很快地;
in all: [acc]/ɪn ɔːl/;  quant. 总共;共计; [phr]总共;共计;
in debt: [acc]/ɪn det/; [phr]欠债;
in danger: [acc]/ɪn ˈdeɪndʒər/; [phr]处在危险状态;
in front of: [acc]/ɪn frʌnt ʌv/; [phr]在⋯⋯前面;
in need of: [acc]/ɪn niːd əv/; [phr]需要;
in order: [acc]/ɪn ˈɔːrdər/; [phr]按顺序;
in peace: [acc]/ɪn pis/; [phr]安静,宁静;和平地;
in public: [acc]/ɪn ˈpʌblɪk/; [phr]当众;公开地;
in the end: [acc]/ɪn ðə end/; [phr]最后,终于;
instead of: [acc]/ɪnˈsted əv/; [phr]代替,顶替,反而;代替,而不是;
keep on: [acc]/kiːp ɑːn/; [phr]持续(进行);
lead to: [acc]/liːd tu/; [phr]导致,导向;
look ahead: [acc]/lʊk əˈhed/; [phr]向前看,展望未来;
look down upon: [acc]/lʊk daʊn əˈpɑːn/; [phr]看不起,轻视;
make friends with: [acc]/meɪk frends wɪð/; [phr]与..交朋友;
more or less: [acc]/mɔːr ɔːr les/; [phr]或多或少;
not any more: [acc]/nɒt ˈeni mɔr/; [phr]不再;
of course: [acc]/əv kɔːrs/; [phr]当然;
once again: [acc]/wʌns əˈɡen/; [phr]再一次;
ought to: [acc]/ˈɔːt tə/; [phr]应该;
out of breath: [acc]/aʊt əv breθ/; [phr]上气不接下气;
out of order: [acc]/aʊt əv ˈɔːrdər/; [phr]出毛病,运转不正常;
pay attention to: [acc]/peɪ əˈtenʃən tu/; [phr]注意;
pay back: [acc]/peɪ bæk/; [phr]偿还(借款等);
pick out: [acc]/pɪk aʊt/; [phr]选出,找出,挑选;
prevent ... from: [acc]/prɪˈvent frəm/; [phr]防止,妨碍,预防;
put on a performance: [acc]/pʊt ɑːn ə pərˈfɔːrməns/; [phr]演出;
put on weight: [acc]/pʊt ɑn wet/; [phr]发福,增加体重;
put up with: [acc]/pʊt ʌp wɪð/; [phr]忍受,容忍;
ring sb. back: [acc]/rɪŋ ˈsʌmbədi bæk/; [phr]回电话;
ring up: [acc]/rɪŋ ʌp/; [phr]打电话给;
right away: [acc]/raɪt əˈweɪ/; [phr]立即,马上;
scores of: [acc]/skɔrz ʌv/; [phr]许多,大量;
send out: [acc]/send aʊt/; [phr]发出,派遣;
spend...on: [acc]/spend ɑːn/; [phr]消耗,消磨(时间);在..花钱;
stand for: [acc]/stænd fɔːr/; [phr]代表,象征;容忍;
stop doing sth.: [acc]/stɑːp ˈduːɪŋ ˈsʌmθɪŋ/; [phr]停止做某事;
struggle against: [acc]/'strʌɡl ə'ɡɛnst/; [phr]同..作斗争;
talk about: [acc]/tɔːk əˈbaʊt/; [phr]谈论,议论;
talk of: [acc]/tɔːk əv/; [phr]谈论,议论;
the day after tomorrow: [acc]/ðə deɪ ˈæftər təˈmɔːroʊ/; [phr]后天;
the day before yesterday: [acc]/ðə deɪ bɪˈfɔːr ˈjestərˌdeɪ/; [phr]前天;
try sth. on: [acc]/traɪ ˈsʌmθɪŋ ɑːn/; [phr]试穿,试试看;
up and down: [acc]/ʌp ænd daʊn/; [phr]来回,来来回回;上上下下;
be used to sth.: [acc]/biː ju:st tuː ˈsʌmθɪŋ/; [phr]习惯于;  quant. 习惯于;
wait for: [acc]/weɪt fɔːr/; [phr]等候,等待;
worry about: [acc]/'wɜːri ə'baʊt/; [phr]担心,烦恼;
write down: [acc]/ˈraɪtˌdaʊn/; [phr]写下,记下;
write to: [acc]/raɪt tu/; [phr]写信给..;
arrive at a place: [acc]/əˈraɪv æt eɪ pleɪs/; [phr]到达某地;
do one's best: [acc]/duː wʌnz best/; [phr]尽最大的努力;
divide...into...: [acc]/dɪˈvaɪd ˈɪntu/; [phr]把..分成..;
earn one's living: [acc]/ɜː(r)n wʌnz ˈlɪvɪŋ/; [phr]谋生;
had better (do): [acc]/hæd ˈbetər doʊ/; [phr]最好(做);
help...out: [acc]/help aʊt/; [phr]帮助某人解决困难;
hold one's breath: [acc]/hoʊld wʌnz breθ/; [phr]不出气,屏住呼吸;
keep doing sth.: [acc]/kiːp ˈduːɪŋ ˈsʌmθɪŋ/; [phr]不停做某事;继续做某事;
make up one's mind: [acc]/meɪk ʌp wʌnz maɪnd/; [phr]下决心,决定;
on average: [acc]/ɔn ˈæv(ə)rɪdʒ/; [phr]平均,通常;
save one's life: [acc]/seɪv wʌnz laɪf/; [phr]挽救某人生命;
take one's time: [acc]/tek wʌnz taɪm/; [phr]从容;慢慢行动;不急;
the more...the more...: [acc]/ðə mɔːr ðə mɔːr/; [phr]越..就越..;
too...to: [acc]/tu tu/; [phr]太..以至于不..;
turn up: [acc]/tɜrn ʌp/; [phr]调高,来到,出现,到场;卷起;
speed up: [acc]/spid ʌp/; [phr]加快速度;
refer to: [acc]/rɪˈfɜr tu/; [phr]参考;涉及;指的是;适用于;谈到;
far from: [acc]/fɑːr frɒm/; [phr]远离,绝不,远非;
in order that: [acc]/ɪn ˈɔːrdər ðæt/; [phr]为了;
the other day: [acc]/ðə ˈʌðər deɪ/; [phr]前几天,某日;
by the way: [acc]/baɪ ðə weɪ/; [phr]顺便说一下;
keep one's word: [acc]/kip wʌnz wɚd/; [phr]守信用,履行诺言;
by accident: [acc]/baɪ ˈæksɪdənt/; [phr]意外地;偶然;
wrap up: [acc]/ræp ʌp/; [phr]包起来;完成某事;
point to: [acc]/pɔːɪnt tu/; [phr]表明,显示;
cut down: [acc]/kʌt daʊn/; [phr]砍倒;减少,削减;
roller skating: [acc]/ˈroʊlər skeɪtɪŋ/; [phr]滑旱冰;
take out: [acc]/teɪk aʊt/; [phr]取出;除去;拔掉;把.带出去;
keep up: [acc]/kiːp ʌp/; [phr]保持;继续;不落后于;赶上;
get in: [acc]/ɡet ɪn/; [phr]进入;收获,收割;当选;参加;到达;
the United Kingdom(UK): [acc]/ðə juˈnaɪtəd ˈkɪŋdəm ˌjuː'keɪ/; [phr]英国;
give back: [acc]/ɡɪv bæk/; [phr]归还;送回;
put down: [acc]/pʊt daʊn/; [phr]放下,记下,镇压;
build up: [acc]/bɪld ʌp/; [phr]逐步增加(增强),逐渐增进;建立;聚集;
in other words: [acc]/ɪn ˈʌðər wɜːdz/; [phr]换句话说;
a number of: [acc]/ə ˈnʌmbər əv/; [phr]一些,许多;
ahead of: [acc]/əˈhed əv/; [phr]在..之前;
as soon as: [acc]/æz suːn æz/; [phr]一..就..;
feel like doing: [acc]/fil laɪk ˈduɪŋ/; [phr]想要..,感觉要..;
for example: [acc]/fɔːr ɪɡˈzæmpəl/; [phr]例如,举个例子;
for good: [acc]/fɔːr ɡʊd/; [phr]永远;
get on with sb.: [acc]/ɡet ɑːn wɪð ˈsʌmbədi/; [phr]与..相处;
go on with: [acc]/ɡoʊ ɑːn wɪð/; [phr]继续;进行;暂时使用;
hold out: [acc]/hoʊld aʊt/; [phr]伸出;坚持,维持;
in a word: [acc]/ɪn ə wɜːrd/; [phr]总之,简言之;
in fact: [acc]/ɪn fækt/; [phr]事实上,实际上;
in order to: [acc]/ɪn ˈɔːrdər tu/; [phr]为了,目的是;
join in: [acc]/dʒɔːɪn ɪn/; [phr]加入,参加;
join up: [acc]/dʒɔːɪn ʌp/; [phr]参军,入伍;与..联手;
lots of: [acc]/lɒts əv/; [phr]许多,大量;
no doubt: [acc]/noʊ daʊt/; [phr]无疑地;
no longer: [acc]/noʊ ˈlɔːŋɡər/; [phr]不再;
not at all: [acc]/nɑːt æt ɔːl/; [phr]一点也不,绝非;不必客气;
once upon a time: [acc]/wʌns əˈpɑːn ə taɪm/; [phr]很久以前,从前;
one after another: [acc]/wʌn ˈæftər əˈnʌðər/; [phr]一个接一个;
or else: [acc]/ɔːr els/; [phr]否则;要不然;
put off: [acc]/pʊt ɔːf/; [phr]推迟;
ring off: [acc]/rɪŋ ɔːf/; [phr]挂断电话,停止讲话;
right now: [acc]/raɪt naʊ/; [phr]马上,立即;
separate...from...: [acc]/ˈseprət frɑːm/; [phr]分开;
so as to: [acc]/soʊʊ æz tu/; [phr]为的是,以便;
so far: [acc]/soʊʊ fɑːr/; [phr]到目前为止;
so long as: [acc]/soʊʊ lɔːŋ æz/; [phr]只要;
so...that: [acc]/soʊ ðæt/; [phr]太..以至于..;
such as: [acc]/sʌtʃ æz/; [phr]例如;
take it easy: [acc]/teɪk ɪt ˈiːzi/; [phr]别着急,别紧张;
take place: [acc]/tek ples/; [phr]发生;举行;来;
thousands of: [acc]/ˈθaʊznds əv/; [phr]成千上万,几千;
try sth. out: [acc]/traɪ ˈsʌmθɪŋ aʊt/; [phr]试验;
used to do sth.: [acc]/ju:st tuː duː ˈsʌmθɪŋ/; [phr]过去常常做某事;
depend on (upon): [acc]/dɪˈpend ɔn əˈpɑn/; [phr]依靠,相信,信赖;
get close (to): [acc]/ɡet kloʊs tu/; [phr]接近;
not till: [acc]/nɑːt tɪl/; [phr]直到..才;
over the radio: [acc]/ˈoʊvər ðə ˈreɪdioʊ/; [phr]通过收音机;
regard... as: [acc]/rɪˈɡɑrd æz/; [phr]把..看作;
see...off: [acc]/si ɑf/; [phr]为某人送行;
sentence...to death: [acc]/ˈsentəns tuː deθ/; [phr]判处死刑;
come to: [acc]/kʌm tu/; [phr]谈到;提及;总计;开始(认识,理解);苏醒;到达;
hand out: [acc]/hænd aʊt/; [phr]分发;施舍;把.拿出来;
family name: [acc]/ˈfæməli neɪm/; [phr]姓氏;
not only...but also: [acc]/nɑːt ˈoʊnli bət ˈɔːlsoʊ/; [phr]不仅..而且..;
not until: [acc]/nɑt ʌnˈtɪl/; [phr]直到⋯⋯才;
send up: [acc]/ˈsendˌʌp/; [phr]发射,射出;
take the place of: [acc]/teɪk ðə pleɪs əv/; [phr]取代,代替;
from...to: [acc]/frɒm tu/; [phr]从..到..;
after all: [acc]/ˈæftər ɔːl/; [phr]毕竟,终究;
as far as: [acc]/æz fɑːr æz/; [phr](表示程度,范围)就..;尽..;
as if: [acc]/æz ɪf/; [phr]好像,仿佛;
first of all: [acc]/fɜːrst əv ɔːl/; [phr]首先;
hear of: [acc]/hɪr əv/; [phr]听说,听到;知道; [v]同意,允许;
not as...as: [acc]/nɑːt æz æz/; [phr]不像;不如;
now that: [acc]/naʊ ðæt/; [phr]既然;
take sb. in one's arms: [acc]/teɪk ˈsʌmbədi ɪn wʌnz ɑːrmz/; [phr]搂抱;
sell out: [acc]/sel aʊt/; [phr]卖完,卖出;
hand in: [acc]/hænd ɪn/; [phr]上交,递交;
send for: [acc]/send fɔːr/; [phr]派人去请(拿),召唤;
give birth to: [acc]/ɡɪv bɜːrθ tu/; [phr]产生,形成;
break into: [acc]/breɪk ˈɪntʊ/; [phr]闯入,碰到,发现;
come into being: [acc]/kʌm ˈɪntʊ ˈbiːɪŋ/; [phr]形成,产生;
before long: [acc]/bɪˈfɔːr lɔːŋ/; [phr]不久以后;
blow up: [acc]/bloʊ ʌp/; [phr]炸毁;
turn to: [acc]/tɚn tu/; [phr]求助于;变成,转向;
be connected with: [acc]/bi kəˈnɛktɪd wɪð/; [phr]与..有关;
in general: [acc]/ɪn ˈdʒenərəl/; [phr]总的说来;
series of: [acc]/ˈsɪriz ʌv/; [phr]一系列;
be at war with: [acc]/bi æt wɔr wɪð/; [phr]与..交战;
solar system: [acc]/ˈsoʊlər sɪstəm/; [phr]太阳系;
cling to: [acc]/klɪŋ tu/; [phr]依靠,粘在..上;
as a result of: [acc]/æz ə rɪˈzʌlt əv/; [phr]作为..的结果;
set up: [acc]/set ʌp/; [phr]设立,创立;提议,提倡;预备;(军事)训练;
calm down: [acc]/kɑm daʊn/; [phr](使)平静下来,(使)镇定下来;
not...any longer: [acc]/nɑːt ˈeni ˈlɔːŋɡər/; [phr]不再..;
add up: [acc]/æd ʌp/; [phr]合计;
walk the dog: [acc]/wɔk ðə dɔɡ/; [phr]遛狗;
at dusk: [acc]/ət dʌsk/; [phr]在黄昏时刻;
suffer from: [acc]/'sʌfər frʌm/; [phr]遭受,患病;
pack (sth.) up: [acc]/pæk ˈsʌmθɪŋ ʌp/; [phr]将(东西)装箱打包;
fall in love: [acc]/fɔːl ɪn lʌv/; [phr]相爱,爱上;
because of: [acc]/bɪˈkɔːz əv/; [phr]因为;由于;
at present: [acc]/æt 'preznt/; [phr]现在;目前;
play a part (in): [acc]/pleɪ ə pɑːrt ɪn/; [phr]扮演一个角色,参与;
at midnight: [acc]/ət ˈmɪdˌnaɪt/; [phr]在午夜;
at an end: [acc]/æt ən ɛnd/; [phr]结束,终结;
in ruins: [acc]/ɪn 'ruːɪnz/; [phr]严重受损,破败不堪;
dig out: [acc]/dɪɡ aʊt/; [phr]掘出,发现;
a (great) number of: [acc]/ə ɡreɪt ˈnʌmbər əv/; [phr]许多,大量的;
in trouble: [acc]/ɪn 'trʌbəl/; [phr]在危险,受罚,痛苦,忧虑等的处境中;
come to power: [acc]/kʌm tu ˈpaʊər/; [phr]掌权;
be sentenced to: [acc]/biː ˈsentənst tuː/; [phr]被判处..(徒刑);
get/be tired of: [acc]/ɡet biː ˈtaɪərd əv/; [phr]对..厌烦;
dream of: [acc]/driːm əv/; [phr]梦见,梦想,设想;
less than: [acc]/les ðən/; [phr]少于;
watch over: [acc]/wɑːtʃ 'oʊvər/; [phr]看守,监视;
take apart: [acc]/teɪk ə'pɑːrt/; [phr]拆开;
in search of: [acc]/ɪn sɜːrtʃ əv/; [phr]寻找;
in return: [acc]/ɪn rɪ'tɜːrn/; [phr]作为报答,回报;
at war: [acc]/æt wɔːr/; [phr]处于交战状态;
take part in: [acc]/tek pɑrt ɪn/; [phr]参加;
in charge: [acc]/ɪn tʃɑːrdʒ/; [phr]主管,看管;
human race: [acc]/ˈhjumən reɪs/; [phr]人类;
with the help of: [acc]/wɪθ ðə help ɑv/; [phr]在..的帮助下;
in danger (of): [acc]/ɪn 'deɪndʒər əv/; [phr]在危险中,垂危;
burst into laughter: [acc]/bɜːrst 'ɪntʊ 'læftər/; [phr]突然笑起来,放声大笑;
colobus monkey: [acc]/'kɑːləbəs ˈmʌŋki/; [phr](非洲产)疣猴,髯猴;
to be honest: [acc]/tu bi ˈɑnəst/; [phr]说实在地,实话说;
attach...to: [acc]/əˈtætʃ tuː/; [phr]认为有(重要性,意义),附上,连接;
in cash: [acc]/ɪn kæʃ/; [phr]用现金,有现钱;
play jokes on: [acc]/pleɪ dʒoʊks ɑːn/; [phr]戏弄;
rely on: [acc]/rɪ'laɪ ɑːn/; [phr]依靠;
be/get familiar with: [acc]/biː ɡet fəˈmɪliər wɪð/; [phr]熟悉,与..熟悉起来;
lose weight: [acc]/luz wet/; [phr]体重减轻,减肥;
play a trick on: [acc]/pleɪ ə trɪk ɑːn/; [phr]搞恶作剧,诈骗,开玩笑;
carbon dioxide: [acc]/ˌkɑːrbən daɪˈɑːksaɪd/; [phr]二氧化碳;
in memory of: [acc]/ɪn 'meməri əv/; [phr]纪念,追念;
remind...of...: [acc]/rɪˈmaɪnd əv/; [phr]使..想起..;
balanced diet: [acc]/ˈbælənst ˈdaɪət/; [phr]平衡膳食;
get away with: [acc]/ɡet əˈweɪ wɪθ/; [phr]被放过,(做坏事)不受惩罚;
tell a lie: [acc]/tel ə lai/; [phr]说谎;
win back: [acc]/wɪn bæk/; [phr]赢回,重新获得;
spy on: [acc]/spaɪ ɔn/; [phr]暗中监视,侦查;
make a bet: [acc]/meɪk ə bet/; [phr]打赌;
stare at: [acc]/ster ət/; [phr]盯着看,凝视;
on the contrary: [acc]/ɑːn ðə 'kɑːnˌtreri/; [phr]与此相反,正相反;
take a chance: [acc]/teɪk ə tʃæns/; [phr]冒险;
in rags: [acc]/ɪn ræɡz/; [phr]衣衫褴褛;
lay eggs: [acc]/leɪ ˌeɡz/; [phr]下蛋;
prevent from: [acc]/prɪˈvent frɒm/; [phr]阻止,制止;
block out: [acc]/blɑk aʊt/; [phr]挡住(光线);
cheer up: [acc]/tʃɪr ʌp/; [phr]感到高兴,感到振奋;
get the hang of: [acc]/ɡet ðə hæŋ ɑv/; [phr]熟悉,掌握,理解;
watch out for: [acc]/wɑːtʃ aʊt fɔːr/; [phr]密切注视,当心,提防;
manage to do: [acc]/ˈmænɪdʒ tu doʊ/; [phr]设法做;
catch sight of: [acc]/kætʃ saɪt əv/; [phr]看见,瞥见;
in the distance: [acc]/ɪn ðə 'dɪstəns/; [phr]在远处;
would rather: [acc]/wʊd ˈræðər/; [phr]宁愿,宁可;
fairy tale: [acc]/ˈferi teɪl/; [phr]神话故事;童话故事;
thanks to: [acc]/θæŋks tu/; [phr]幸亏,由于,因为;
lead a...life: [acc]/liːd ə laɪf/; [phr]过着..的生活;
crowd in: [acc]/kraʊd ɪn/; [phr](想法,问题等)涌上心头,涌入脑海,挤入;
rid of: [acc]/rɪd ɑv/; [phr]摆脱,除去;
be satisfied with: [acc]/bi ˈsætɪsˌfaɪd wɪθ/; [phr]对..感到满意;
up to now: [acc]/ʌp tu naʊ/; [phr]到目前为止;
badly off: [acc]/ˌbædli ˈɔːf/; [phr]穷的,缺少的;
star in: [acc]/stɑr ɪn/; [phr]担任主角,主演;
defend against: [acc]/dɪˈfend əˈɡenst/; [phr]保卫..以免受;
be likely to: [acc]/bi ˈlaɪkli tu/; [phr]很可能..,有希望..;
at ease: [acc]/æt iːz/; [phr]舒适,快活,自由自在;
be famous for: [acc]/bi ˈfeɪməs fɔr/; [phr]以..而闻名;
be modelled after: [acc]/bi'mɑːdl ˈæftər/; [phr]根据..模仿,仿造;
get close to: [acc]/ɡet kloʊs tu/; [phr]接近;
come to life: [acc]/kʌm tə laɪf/; [phr]活跃起来;
look down upon/on: [acc]/lʊk daʊn əˈpɑːn ɑːn/; [phr]蔑视,瞧不起;
keep...free from/of: [acc]/kiːp friː frɑːm əv/; [phr]使..免受(影响,伤害等),使..不含(有害物);
feel/be content with: [acc]/fiːl biː ˈkɑːntent wɪð/; [phr]对..满足;
safety belt: [acc]/ˈseɪfti belt/; [phr]安全带;
leave...out: [acc]/liːv aʊt/; [phr]省去;遗漏;不考虑;
put forward: [acc]/pʊt 'fɔːrwəd/; [phr]提出;
draw a conclusion: [acc]/drɔ ə kənˈkluʒ(ə)n/; [phr]得出结论;
expose...to: [acc]/ɪkˈspoʊz tuː/; [phr]使显露,暴露;
make sense: [acc]/meɪk sens/; [phr]讲得通;有意义;
divide...into: [acc]/dɪˈvaɪd ˈɪntuː/; [phr]把..分成;
to one's credit: [acc]/tuː wʌnz ˈkredɪt/; [phr]为..带来荣誉,值得赞扬,在..名下;
be back on one's feet: [acc]/biː bæk ɔːn wʌnz fiːt/; [phr](困境后)恢复,完全复原;
lose sight of...: [acc]/luːz saɪt əv/; [phr]看不见..;
sweep up: [acc]/swiːp ʌp/; [phr]打扫,横扫;
slide into: [acc]/slaɪd ˈɪntu/; [phr](快捷而悄声地)移动,溜进..;
concentrate on: [acc]/'kɑːnsənˌtreɪt ɑːn/; [phr]聚精会神,集中思想;
accuse...of: [acc]/əˈkjuːz əv/; [phr]因..指责或控告..;
first aid: [acc]/ˌfɜːrst ˈeɪd/; [phr](对伤患者的)急救;
electric shock: [acc]/ɪˌlektrɪk ˈʃɑːk/; [phr]触电,电休克;
squeeze out: [acc]/skwiz aʊt/; [phr]榨出,挤出;
in place: [acc]/ɪn pleɪs/; [phr]在适当的位置;适当;
put one's hands on: [acc]/pʊt wʌnz hændz ɑːn/; [phr]找到;
make a difference: [acc]/meɪk ə 'dɪfərəns/; [phr]有影响,使不相同;
out of date: [acc]/ˌaʊt əv ˈdeɪt/; [phr]过时;
at the start of: [acc]/ət ðə stɑrt ɑv/; [phr]在..开始的时候;
at the end of: [acc]/ət ðə end ɑv/; [phr]在..结束的时候;
go to college: [acc]/ɡoʊ tu ˈkɑlɪdʒ/; [phr]上大学;
be divided into: [acc]/bi dɪˈvaɪdɪd ˈɪntu/; [phr]被(划)分成..;
make sure: [acc]/meɪk ʃʊr/; [phr]确定;确信;查明;弄清楚;
tell jokes: [acc]/tel dʒoʊks/; [phr]讲笑话,开玩笑;
get out of: [acc]/ɡet aʊt ɑv/; [phr]摆脱;逃避;下(车);
be short for: [acc]/bi ʃɔrt fɔr/; [phr]是..的缩写/简称;
till now: [acc]/tɪl naʊ/; [phr]到目前为止;
used to: [acc]/ˈjuːst tu/; [phr]过去(常常)..;
add...to...: [acc]/æd tu/; [phr]往..加入..;
in the area of: [acc]/ɪn ðə ˈeriə ɑv/; [phr]在..领域;
consists of: [acc]/kənˈsɪsts əv/; [phr]由..组成;
take turns: [acc]/teɪk ˈtɜːnz/; [phr]轮流;
put into: [acc]/pʊt ˈɪntu/; [phr]将..投入..;
be crazy about: [acc]/bi ˈkreɪzi əˈbaʊt/; [phr]迷恋;
have a temperature: [acc]/həv ə ˈtemp(ə)rəˌtʃʊr/; [phr]发烧;
lie down: [acc]/laɪ daʊn/; [phr]躺下;
begin with: [acc]/bɪˈɡɪn wɪθ/; [phr]以..开始;
become ill: [acc]/bɪˈkʌm ɪl/; [phr]生病;
related to: [acc]/rɪˈleɪtəd tu/; [phr]有关系的,有关联的;
be impressed with: [acc]/biː ɪmˈprest wɪð/; [phr]留下深刻印象;
split up: [acc]/splɪt ʌp/; [phr]分裂,分割;
make a note of: [acc]/meɪk ə noʊt ɑv/; [phr]记录;
be/get tired of: [acc]/bi ɡet 'taɪərd ɑv/; [phr]对..厌烦;
tell by: [acc]/tel baɪ/; [phr]从..可以看出;
in total: [acc]/ɪn 'toʊtl/; [phr]总共,合计;
be similar to: [acc]/bi ˈsɪmɪlər tu/; [phr]和..相似;
fall in love with: [acc]/fɔːl ɪn lʌv wɪð/; [phr]爱上,喜欢(表动作);
be in love with: [acc]/bi ɪn lʌv wɪθ/; [phr]爱上,喜欢(表状态);
play a part: [acc]/pleɪ ə pɑrt/; [phr]扮演角色;
become addicted to: [acc]/bɪˈkʌm əˈdɪktəd tu/; [phr]对..上瘾,沉迷于;
take one's advice: [acc]/teɪk wʌnz ədˈvaɪs/; [phr]听某人的意见;
to one's surprise: [acc]/tuː wʌnz sərˈpraɪz/; [phr]令某人吃惊的是;
date from: [acc]/deɪt frʌm/; [phr]起源于;
take in: [acc]/teɪk ɪn/; [phr]吸收;欺骗;
be known as: [acc]/bi noʊn əz/; [phr]作为..而出名/闻名;
on the other hand: [acc]/ɔn ðə ˈʌðər hænd/; [phr]另一方面,反过来说;
little by little: [acc]/'lɪtl baɪ 'lɪtl/; [phr]一点点地,逐渐地;
at the top of: [acc]/ət ðə tɑp ɑv/; [phr]在..顶端;
at the bottom of: [acc]/ət ðə ˈbɑtəm ɑv/; [phr]在..底部;
make effort: [acc]/meɪk ˈefərt/; [phr]努力;
be close to: [acc]/bi kloʊs tu/; [phr]接近,靠近;
set fire to: [acc]/set faɪr tu/; [phr]放火(焚烧)..;
catch fire: [acc]/kætʃ ˈfaɪər/; [phr]着火,失火;
become interested in: [acc]/bɪˈkʌm ˈɪntrəstəd ɪn/; [phr]对..感兴趣;
in conclusion: [acc]/ɪn kən'klʊʒən/; [phr]总之;
for the first time: [acc]/fɔr ðə fɜrst taɪm/; [phr]第一次;
switch on: [acc]/swɪtʃ ɑːn/; [phr]打开(灯,无线电等);
on guard: [acc]/ɑːn ɡɑːrd/; [phr](保持)警惕;
use up: [acc]/juːz ʌp/; [phr]用完;
get around: [acc]/ɡet ə'raʊnd/; [phr]四处走动(旅行);
place order: [acc]/pleɪs ˈɔrdər/; [phr]订购;
free of charge: [acc]/friː əv tʃɑːrdʒ/; [phr]不收费,免费的,无偿的;
for a start: [acc]/fɔr ə stɑrt/; [phr]首先;
be connected to: [acc]/bi kəˈnektəd tu/; [phr]与.相连;
be/get stuck in: [acc]/bi ɡet stʌk ɪn/; [phr]被困在..;
switch off: [acc]/swɪtʃ ɔːf/; [phr]关上(点灯,电视等);断掉(电源);
at the edge of: [acc]/ət ðə edʒ ɑv/; [phr]在..的边缘;
get a kick out of: [acc]/ɡet ə kɪk aʊt ɑv/; [phr](俚语)从..中得到乐趣;
throw light on: [acc]/θroʊ laɪt ɔn/; [phr]帮助弄清楚,阐明某事;
come straight to the point: [acc]/kʌm streɪt tu ðə pɔɪnt/; [phr]谈正题,开门见山;
have difficulty (in) doing sth.: [acc]/hæv ˈdɪfɪkəlti ɪn ˈduːɪŋ ˈsʌmθɪŋ/; [phr]做某事有困难;
in particular: [acc]/ɪn pər'tɪkjələr/; [phr]尤其,特别;
in practice: [acc]/ɪn 'præktɪs/; [phr]实际上,在实践中;
have an effect on: [acc]/hæv ən ɪˈfɛkt ɑn/; [phr]对..产生影响;
take notice of: [acc]/teɪk ˈnoʊtɪs ɑv/; [phr]注意,留心;注意到;
in response to: [acc]/ɪn rɪ'spɑːns tu/; [phr]作为..的回应;
have connection with: [acc]/həv kəˈnekʃ(ə)n wɪθ/; [phr]与..有联系/有关联;
play a trick on sb.: [acc]/pleɪ ə trɪk ɑːn ˈsʌmbədi/; [phr]捉弄某人,对某人恶作剧;
be in the mood for sth.: [acc]/biː ɪn ðə muːd fɔːr ˈsʌmθɪŋ/; [phr]有意(做某事),有(做某事的)心情;
come to an end: [acc]/kʌm tu: æn end/; [phr]完结;
on the increase: [acc]/ɑːn ðə ɪn'kriːs/; [phr]正在增加;
have in common: [acc]/həv ɪn ˈkɑmən/; [phr]有相同的特点;
refer to...as: [acc]/rɪˈfɜr tu æz/; [phr]称.为.;
take...for granted: [acc]/teɪk fɔr ˈɡræntəd/; [phr]以为..理所当然;
make one's fortune: [acc]/meɪk wʌnz ˈfɔːrtʃən/; [phr]发财;
rise to one's feet: [acc]/raɪz tuː wʌnz fiːt/; [phr]站起身;
hot dog: [acc]/ˈhɑːt dɔːɡ/; [phr]热狗;红肠面包;
stay up: [acc]/steɪ ʌp/; [phr]熬夜;
look back (on): [acc]/lʊk bæk ɔn/; [phr]回顾,回忆起;
in charge of: [acc]/ɪn tʃɑrdʒ ʌv/; [phr]负责;主管;
insist on: [acc]/ɪn'sɪst ɑːn/; [phr]坚持,强调,坚决要求,督促;
get into shape: [acc]/ɡet ˈɪntu ʃeɪp/; [phr]强身健体,使有条理,恰当安排;
in the long term: [acc]/ɪn ðə lɔŋ tɜrm/; [phr]长期来说;
can't wait to: [acc]/kænt weɪt tuː duː ˈsʌmθɪŋ/; [phr]迫不及待地做某事;
in sight: [acc]/ɪn saɪt/; [phr]看得见;被看到;在即;在望;
wish for: [acc]/wɪʃ fɔr/; [phr]希望得到,想要;
reach out: [acc]/ritʃ aʊt/; [phr]伸出,伸展;
be made up of: [acc]/bi meɪd ʌp əv/; [phr]由.构成,由.组成;
differ from: [acc]/ˈdɪfər frɑːm/; [phr]不同于,与..有区别;
as a whole: [acc]/æz ə hoʊl/; [phr]整个来说,总体上;
come down with: [acc]/kʌm daʊn wɪθ/; [phr]得(传染性的病),感染;
make way for: [acc]/meɪk weɪ fɔːr/; [phr]为..腾出地方,让路;
play trick on: [acc]/pleɪ trɪk ɔn/; [phr]开..的玩笑,捉弄,欺诈;
in honour of: [acc]/ɪn 'ɑːnər əv/; [phr]为纪念,为庆祝,向.表示敬意;
lead the way: [acc]/lid ðə weɪ/; [phr]引路,带路;
last but not least: [acc]/læst bət nɒt list/; [phr]最后但同样重要的;放在最后但并非最不重要的一点;
even if/though: [acc]/ˈiv(ə)n ɪf ðoʊ/; [phr]虽然,即使;
get something across: [acc]/ɡet ˈsʌmθɪŋ əˈkrɔs/; [phr]把..表达清楚;
pass sth. on: [acc]/pæs ˈsʌmθɪŋ ɔn/; [phr](to somebody)转交,传给,递给;
keep pace with: [acc]/kiːp peɪs wɪð/; [phr]跟上,与..齐步前进,跟上.的最新发展;
be based on: [acc]/biː beɪst ɑːn/; [phr]根据,以..为基准;
cut back on: [acc]/kʌt bæk ɔn/; [phr]减少;
run out (of): [acc]/rʌn aʊt əv/; [phr]用完,耗尽,从..跑出;
queue up: [acc]/kju ʌp/; [phr]排队;
under way: [acc]/'ʌndər weɪ/; [phr]在进行中;
push ahead with: [acc]/pʊʃ ə'hed wɪð/; [phr]促进,推动;
for sale: [acc]/fɔːr seɪl/; [phr]出售,待售;
on the one hand...on the other hand...: [acc]/ɔn ðə wʌn hænd ɔn ðə ˈʌðər hænd/; [phr]一方面..另一方面..;
be/get burnt out: [acc]/bi ɡet bɜrnt aʊt/; [phr]耗尽体力,累垮;
burn down: [acc]/bɜːrn daʊn/; [phr]烧成平地,烧毁,烧光;
TV series: [acc]/ˌti ˈvi ˈsɪriz/; [phr]电视系列片,电视剧;
talk show: [acc]/ˈtɔːk ʃoʊ/; [phr]脱口秀,谈话节目;
switch over: [acc]/swɪtʃ ˈoʊvər/; [phr]切换,转变;
distance learning: [acc]/ˈdɪstəns lɜːrnɪŋ/; [phr]远程教育;
at the moment: [acc]/ət ðə 'moʊmənt/; [phr]此时,此刻,现在,目前;
over the years: [acc]/ˈoʊvər ði jɪrz/; [phr]多年来;
kong fu: [acc]/ˌkʌŋ ˈfuː/; [phr](中国)功夫;
manned spaceship: [acc]/mænd ˈspeɪsˌʃɪp/; [phr]载人宇宙飞船;
commit suicide: [acc]/kəˈmɪt ˈsuɪˌsaɪd/; [phr]自杀;
apply for: [acc]/ə'plaɪ fɔːr/; [phr]申请;
auto shop: [acc]/ˈɔtoʊ ʃɑp/; [phr]自动售货店;
get in touch: [acc]/ɡet ɪn tʌtʃ/; [phr]联络,联系;
in the flesh: [acc]/ɪn ðə fleʃ/; [phr]本人;
be/get used to: [acc]/biː juːzd tu/; [phr]习惯于;被用来;
date back (to): [acc]/deɪt bæk tu/; [phr]可追溯到,始于(某时期);
upside down: [acc]/ˌʌpsaɪd ˈdaʊn/; [phr]颠倒,混乱,倒转,翻转;
watch out: [acc]/wɑːtʃ aʊt/; [phr]小心,提防;
water skiing: [acc]/ˈwɔtər ˈskiɪŋ/; [phr]滑水;
get into trouble: [acc]/ɡet 'ɪntʊ 'trʌbəl/; [phr]陷入困境,惹上麻烦;
make it to: [acc]/meɪk ɪt tu/; [phr]到达某地;
make a living: [acc]/meɪk ə ˈlɪvɪŋ/; [phr]谋生;
all at once: [acc]/ɔːl æt wʌns/; [phr]同时;一起;突然;忽然;
back out: [acc]/bæk aʊt/; [phr]退出,放弃,食言;
on one's way: [acc]/ɔːn wʌnz weɪ/; [phr]即将来,即将上菜;
fed up: [acc]/ˌfed ˈʌp/; [phr]厌倦;
air hostess: [acc]/ˈer hoʊstəs/; [phr]空中小姐;
put into prison: [acc]/pʊt ˈɪntu ˈprɪz(ə)n/; [phr]关进监狱;
credit card: [acc]/ˈkredɪt kɑːrd/; [phr]信用卡;
go ahead with: [acc]/ɡoʊ əˈhed wɪθ/; [phr]继续;
get used to: [acc]/ɡet juːzd tu/; [phr]习惯于;
give...a lift: [acc]/ɡɪv ə lɪft/; [phr]让---搭车;
sit up: [acc]/'sɪtˌʌp/; [phr]坐直,坐起来,迟睡,熬夜;
speak up: [acc]/spik ʌp/; [phr]大声讲,毫无顾虑地说出;
can't help doing sth.: [acc]/kænt help ˈduːɪŋ ˈsʌmθɪŋ/; [phr]禁不住做某事;
fellow students: [acc]/ˈfeloʊ ˈstuːdnts/; [phr]同学;
dairy product: [acc]/ˈdɛri ˈprɑdəkt/; [phr]乳制品;
lack of: [acc]/læk ɑv/; [phr]缺乏;
in authority: [acc]/ɪn ɔˈθɔrəti/; [phr]有权;
be shocked at: [acc]/bi ʃɑkt ət/; [phr]对..很震惊;
burst in: [acc]/bɜː(r)st ɪn/; [phr]打断,破门而入,突然出现;
bring back to life: [acc]/brɪŋ bæk tu laɪf/; [phr]使恢复生命使.苏醒,使.复活,使.生动活泼;
banyan tree: [acc]/'bænjən tri/; [phr]悦榕庄(酒店名),榕树;
school uniform: [acc]/skul ˈjunəˌfɔrm/; [phr]校服;
close down: [acc]/kloʊz daʊn/; [phr]关闭,停业;关闭;
get straight A's: [acc]/ɡet streɪteɪ/; [phr]得全优;
in many ways: [acc]/ɪn ˈmɛni wez/; [phr]在不同方面;
make money: [acc]/meɪk 'mʌni/; [phr]赚钱;
be willing to do: [acc]/bi ˈwɪlɪŋ tu doʊ/; [phr]愿意做某事,不反对做某事;
at one's own pace: [acc]/æt wʌnz oʊn peɪs/; [phr]以轻松自在的速度;
make comments: [acc]/meɪk ˈkɑːments/; [phr]发表议论,提出意见;
sense of achievement: [acc]/sens ɑv əˈtʃivmənt/; [phr]成就感;
sense of satisfaction: [acc]/sens ɑv ˌsætɪsˈfækʃ(ə)n/; [phr]满意感;
bring along: [acc]/brɪŋ əˈlɔŋ/; [phr]带来;
search for: [acc]/sɜːrtʃ fɔːr/; [phr]搜寻,寻找;
go out of style: [acc]/ɡoʊ aʊt ɑv staɪl/; [phr]不再时兴,过时;
go against: [acc]/ɡoʊ ə'ɡenst/; [phr]违反,对..不利;
be linked to: [acc]/bi lɪŋkt tu/; [phr]连接,联系;
of some kind: [acc]/ɑv səm kaɪnd/; [phr]某种;
pop into: [acc]/pɑp ˈɪntu/; [phr]急急走进.;
meet one's needs: [acc]/miːt wʌnz niːdz/; [phr]符合某人的需要;
a wide range of: [acc]/ə waɪd reɪndʒ ɑv/; [phr]各式各样的;
step into: [acc]/step ˈɪntu/; [phr]进入,着手做;
the greenhouse effect: [acc]/ðə ˈɡriːnhaʊs ɪfekt/; [phr]温室效应;
go up to: [acc]/ɡoʊ ʌp tu/; [phr]走上前去;
be equal in: [acc]/bi ˈikwəl ɪn/; [phr]在..方面相同的;
command of: [acc]/kəˈmænd ɑv/; [phr]掌握;
be forced to do: [acc]/bi fɔrst tu doʊ/; [phr]被迫做某事;
be convenient for: [acc]/bi kənˈviniənt fɔr/; [phr]方便的;
adapt...to: [acc]/əˈdæpt tu/; [phr]使..适应;
a piece of clothing: [acc]/ə pis ɑv ˈkloʊðɪŋ/; [phr]一件衣服;
be likely to do: [acc]/bi ˈlaɪkli tu doʊ/; [phr]很有可能做某事;
distinguish...from: [acc]/dɪˈstɪŋɡwɪʃ frɒm/; [phr]区别;
stick to: [acc]/stɪk tu/; [phr]坚持,遵守,粘附在.上,紧跟,紧随;
keep fit: [acc]/kiːp fɪt/; [phr]保持健康;
cosmetic surgery: [acc]/kɑzˈmetɪk ˈsɜrdʒəri/; [phr]整容外科(手术);
ear lobe: [acc]/ɪr loʊb/; [phr]耳垂;
aim at: [acc]/eɪm æt/; [phr]瞄准,目的在于;
roar with laughter: [acc]/rɔr wɪθ ˈlæftər/; [phr]哄堂大笑;
on top of: [acc]/ɑːn tɑːp əv/; [phr]在..之上,停留在.之上,加之,控制住,对.了如指掌;
be equivalent to: [acc]/bi ɪˈkwɪvələnt tu/; [phr]等于,相当于;
rowing machine: [acc]/ˈroʊwɪŋ məʃiːn/; [phr]划式练力机;
take one's own life: [acc]/teɪk wʌnz oʊn laɪf/; [phr]自杀;
take a peek at: [acc]/teɪk ə pik ət/; [phr]偷看;
face cream: [acc]/ˈfeɪs kriːm/; [phr]面霜;
define...as: [acc]/dɪˈfaɪn əz/; [phr]给..下定义;
serve as: [acc]/sɜrv əz ˈsʌmθɪŋ/; [phr]可用作,可当..使;
by coincidence: [acc]/baɪ koˈɪnsɪdəns/; [phr]巧合地;
appeal to: [acc]/əˈpiːl tu/; [phr](对某人)有吸引力,(使某人)感兴趣;
star rating: [acc]/stɑːr ˈreɪtɪŋ/; [phr]星级评定;
price range: [acc]/praɪs rendʒ/; [phr]价格区间;
special request: [acc]/ˈspeʃl rɪˈkwest/; [phr]特殊要求;
whipped cream: [acc]/wɪpt kriːm/; [phr]奶油;
salad dressing: [acc]/ˈsæləd dresɪŋ/; [phr](供拌色拉或其他菜用的)沙拉酱,调味汁;
wine list: [acc]/ˈwaɪn lɪst/; [phr]酒水单; [n](餐馆供应的)酒单;
on the rocks: [acc]/ɑːn ðə rɑːks/; [phr]加冰的;
mixed drink: [acc]/mɪkst drɪŋk/; [phr]鸡尾酒;
hard drink: [acc]/hɑː(r)d drɪŋk/; [phr]带酒精的饮料;
main course: [acc]/men kɔː(r)s/; [phr]主菜;
medium rare: [acc]/ˈmidiəm rɛr/; [phr]3分熟;
medium well: [acc]/ˈmidiəm wɛl/; [phr]7分熟;
well done: [acc]/ˌwel ˈdʌn/; [phr]全熟的;
side dish: [acc]/ˈsaɪd dɪʃ/; [phr]配菜;
by the window: [acc]/baɪ ðə ˈwɪndoʊ/; [phr]靠窗;
out of: [acc]/aʊt əv/; [phr]缺少,没有,售罄;
pepper mill: [acc]/ˈpɛpɚ mɪl/; [phr]胡椒磨;
by card: [acc]/baɪ kɑːrd/; [phr]用卡;
quiet table: [acc]/ˈkwaɪət ˈteɪbl/; [phr]安静的位置;
romaine lettuce: [acc]/roˈmen ˈlɛtəs/; [phr]长叶莴苣;
red cabbage: [acc]/rɛd ˈkæbɪdʒ/; [phr]紫甘蓝;
bell pepper: [acc]/ˈbel pepər/; [phr]甜椒;
red onion: [acc]/red ˈʌnjən/; [phr]红皮洋葱;
green onion: [acc]/ˌɡriːn ˈʌnjən/; [phr]青葱;
green bean: [acc]/ˌɡriːn ˈbiːn/; [phr]四季豆;
black bean: [acc]/blæk bin/; [phr]黑豆;
green pea: [acc]/ɡriːn piː/; [phr]豌豆;
black olive: [acc]/blæk ˈɑlɪv/; [phr]黑橄榄;
ground beef: [acc]/ˌɡraʊnd ˈbiːf/; [phr]绞碎的牛肉;
grilled chicken: [acc]/ɡrɪld ˈtʃɪkɪn/; [phr]烤鸡肉;
hard-boiled egg: [acc]/ˌhɑːrd ˈbɔɪld eɡ/; [phr]水煮蛋;
pine nut: [acc]/ˈpaɪn nʌt/; [phr]松子;
black pepper: [acc]/ˌblæk ˈpepər/; [phr]黑胡椒;
lemon juice: [acc]/ˈlemən dʒʊs/; [phr]柠檬汁;
olive oil: [acc]/ˌɑːlɪv ˈɔɪl/; [phr]橄榄油;
vegetable oil: [acc]/ˈvedʒtəbl ɔɪl/; [phr]植物油;
serving bowl: [acc]/ˈsɜːrvɪŋ boʊl/; [phr]盛菜碗;
salad bowl: [acc]/ˈsæləd bol/; [phr]沙拉碗;
salad spoon: [acc]/ˈsæləd spuːn/; [phr]沙拉勺;
cutting board: [acc]/ˈkʌtɪŋ bɔːrd/; [phr]砧板;
chef's knife: [acc]/ˌʃefs naɪf/; [phr]主厨刀;
bread knife: [acc]/brɛd naɪf/; [phr]面包刀;
cheese knife: [acc]/tʃiz naɪf/; [phr]奶酪刀;
measuring cup: [acc]/ˈmeʒərɪŋ kʌp/; [phr]量杯;
mortar and pestle: [acc]/ˈmɔːrtər ənd ˈpesl/; [phr]研钵和研杵;
Ranch dressing: [acc]/ræntʃ ˈdresɪŋ/; [phr]田园沙拉酱;
Caesar dressing: [acc]/ˌsiːzər ˈdresɪŋ/; [phr]凯撒沙拉酱;
Italian dressing: [acc]/ɪˈtæliən ˈdresɪŋ/; [phr]意式沙拉调味酱;
Blue Cheese dressing: [acc]/bluː tʃiːz ˈdresɪŋ/; [phr]蓝纹奶酪酱;
Thousand Island dressing: [acc]/ˌθaʊznd ˌaɪlənd ˈdresɪŋ/; [phr]千岛酱;
Honey mustard dressing: [acc]/ˈhʌni ˈmʌstərd ˈdresɪŋ/; [phr]蜂蜜芥末沙拉酱;
French dressing: [acc]/ˌfrentʃ ˈdresɪŋ/; [phr]法式沙拉酱;
burn to the ground: [acc]/bɜːrn tu ði ɡraʊnd/; [phr]焚烧殆尽;
make one's way: [acc]/meɪk wʌnz weɪ/; [phr]去往,前进;
glance through: [acc]/ɡlæns θruː/; [phr]快速扫一眼,匆匆一瞥;
vary from...to...: [acc]/ˈværi frʌm tu/; [phr]从..到..不等;
addicted to: [acc]/ə'dɪktɪd tu/; [phr]对..上瘾;
accustomed to: [acc]/əˈkʌstəmd tu/; [phr]习惯于;
decide on: [acc]/dɪˈsaɪd ɑn/; [phr]决定,选定;
in spite of: [acc]/ɪn spaɪt ʌv/; [phr]尽管,不管;
take risks: [acc]/teɪk rɪsks/; [phr]冒险(做某事);
at risk: [acc]/æt rɪsk/; [phr]有危险,冒风险;
quantities of: [acc]/ˈkwɑ:ntəties ʌv/; [phr]大量,众多;
result in: [acc]/rɪˈzʌlt ɪn/; [phr]导致,致使;
be opposed to: [acc]/bi əˈpoʊzd tu/; [phr]强烈反对;
and so on: [acc]/ənd soʊ ɑn/; [phr]等等,诸如此类;
make fun of: [acc]/meɪk fʌn əv/; [phr]嘲笑,取笑;
test out: [acc]/test aʊt/; [phr]彻底检查,仔细检查;
leave...alone: [acc]/liːv əˈloʊn/; [phr]不烦扰,不打扰;
set aside: [acc]/set əˈsaɪd/; [phr]省出(时间,金钱),放置一边;
in the meantime: [acc]/ɪn ði ˈmiːntaɪm/; [phr]在..期间;
help out: [acc]/help aʊt/; [phr]帮助..脱离困境;
be aware of: [acc]/biː əˈwer əv/; [phr]发觉,意识到;
(be) scared to death: [acc]/skerd tuː deθ/; [phr]吓得要死;
stick out: [acc]/stɪk aʊt/; [phr]伸出;
dry out: [acc]/draɪ aʊt/; [phr]使干透;
dry up: [acc]/draɪ ʌp/; [phr]干涸;
in need: [acc]/ɪn niːd/; [phr]在贫困中,在困难中;
sewing machine: [acc]/ˈsoʊɪŋ məʃiːn/; [phr]缝纫机;
trunk library: [acc]/trʌŋk ˈlaɪbrəri/; [phr]箱子图书馆;
adjust to: [acc]/əˈdʒʌst tu:/; [phr]适应;
as far as one is concerned: [acc]/æz fɑ: æz wʌn ɪz kənˈsɜ:nd/; [phr]就我而言;
feel at home: [acc]/fi:l æt həum/; [phr]感到很舒服;
settle in: [acc]/ˈsetl in/; [phr]迁入新居并安顿好;
make a life: [acc]/meɪk ə laɪf/; [phr]谋生;
occur to...: [acc]/əˈkɜː(r) tuː/; [phr]想起;
cast down: [acc]/kɑːst daʊn/; [phr]沮丧;
in favor of: [acc]/ɪn ˈfeɪvə əv/; [phr]支持;
set about: [acc]/set əˈbaʊt/; [phr]着手进行;
in case: [acc]/ɪn keɪs/; [phr]以防万一;
beaten track: [acc]/ˈbiːtn træk/; [phr]常规;
dive into: [acc]/daɪv ˈɪntuː/; [phr]手伸进去掏,跳进;
in truth: [acc]/ɪn truːθ/; [phr]实际上;
in disguise: [acc]/ɪn dɪsˈɡaɪz/; [phr]装扮,伪装;
make one's acquaintance: [acc]/meɪk wʌnz əˈkweɪntəns/; [phr]与..相识;
in amazement: [acc]/əˈmeɪzmənt/; [phr]惊愕,惊诧;
show...in: [acc]/ʃəu in/; [phr]领进;
fade out: [acc]/feid aut/; [phr](声音,画面)慢慢淡出;
small talk: [acc]/ˈsmɔːl tɔːk/; [phr]闲谈,聊天;
make friends: [acc]/meɪk frends/; [phr]交朋友;
(be)nervous about: [acc]/ˈnɜːrvəs əˈbaʊt/; [phr]对..神经紧张/害怕/胆怯/焦虑不安;
body language: [acc]/ˈbɑːdi læŋɡwɪdʒ/; [phr]身体语言,肢体语言;
look away from: [acc]/lʊk əˈweɪ frəm/; [phr]把目光从.移开;
in addition: [acc]/ɪn əˈdɪʃn/; [phr]除此之外,另外;
cheer sb. up: [acc]/tʃɪr sb ʌp/; [phr]使某人高兴/振作起来;
(be)aware of: [acc]/əˈwer əv/; [phr]知道;
take the lead: [acc]/teɪk ðə liːd/; [phr]领先;
play an important part in: [acc]/pleɪ ən ɪmˈpɔːrtnt  pɑːrt ɪn/; [phr]在.中起重要作用,对.有重要影响;
come up to: [acc]/kʌm ʌp tu/; [phr]朝.走过来;
turn away: [acc]/təːrn əˈweɪ/; [phr]走开;转变方向;
sweep over: [acc]/swip ˈoʊvər/; [phr]扫过;拓展;
keep one's eyes on: [acc]/kiːp wʌnz aɪ ɑːn/; [phr]注视,盯着看,主意;
fix on: [acc]/fɪks  ɔːn/; [phr]注视,凝视;
cast about: [acc]/kæst əˈbaʊt/; [phr]寻找,搜索,想办法;
(be)laden with: [acc]/biː ˈleɪdn wɪð/; [phr](空气中)充溢着(某种味道)的;
look around for: [acc]/lʊk əˈraʊnd fər/; [phr]四处寻找;
put a spell on: [acc]/pʊt  ə  spel ɔːn/; [phr]用符咒镇住;
(be) associated with: [acc]/əˈsoʊʃieɪtɪd wɪð/; [phr]与.有关系,与.联系在一起;
appeal to sb.: [acc]/əˈpiːl tu sb./; [phr]对某人有吸引力,引起某人的兴趣;
(be)restricted to: [acc]/rɪˈstrɪktɪd tu/; [phr]限于;
look back over one's shoulder: [acc]/lʊk bæk ˈoʊvər wʌnz ˈʃoʊldər/; [phr]回头看;
catch a glimpse of: [acc]/kætʃ ə ɡlɪmps əv/; [phr]瞥一眼,瞥见了;
burst out: [acc]/bɜːrst aʊt/; [phr]突然发生,突然..起来;
knock...over: [acc]/nɑːk ˈoʊvər/; [phr](开车)撞死,撞伤;
lose interest in: [acc]/luːz ˈɪntrəst ɪn/; [phr]对.失去兴趣;
turn round: [acc]/təːrn raʊnd/; [phr]转过身来;
raise money: [acc]/reɪz ˈmʌni/; [phr]筹钱;
on the phone: [acc]/ɑːn ðə foʊn/; [phr]在通话中;
keep in touch: [acc]/kiːp in tʌtʃ/; [phr]与.保持联系;
lose touch with: [acc]/luːz tʌtʃ  wɪð/; [phr]与..失去联系;
(be)ashamed of: [acc]/əˈʃeɪmd əv/; [phr]对..感到羞愧,惭愧;
(be)allergic to: [acc]/əˈlɜːrdʒɪk tu/; [phr]对.过敏;
(be)on good terms with: [acc]/bi: ɔːn ɡʊd tɜːrm wɪð/; [phr]与某人关系很好;
(be)nostalgic for: [acc]/biː nəˈstældʒɪk fɔːr/; [phr]对.很怀念;
bring...to mind: [acc]/brɪŋ tu  maɪnd/; [phr]使.想起;
give concerts: [acc]/ɡɪv ˈkɑːnsərts/; [phr]举办音乐会;
folk song: [acc]/ˈfoʊk sɔːŋ/; [phr]民歌;
give life to: [acc]/ɡɪv laɪf tu/; [phr]赋予.生命(生命力,活力);
(be)the same with: [acc]/ðə seɪm wɪð/; [phr]与.情况相同;
share feelings and idea with: [acc]/ʃer ˈfiːlɪŋz ənd aɪˈdiːə wɪð/; [phr]与.分享感受与想法;
make contact with: [acc]/meɪk kɑːntækt wɪð/; [phr]与.进行往来;
master musician: [acc]/ˈmæstər  mjuˈzɪʃn/; [phr]音乐大师;
compose music: [acc]/kəmˈpoʊz  ˈmjuːzɪk/; [phr]创造乐曲;
barrel organ: [acc]/ˈbærəl ɔːrɡən/; [phr]手摇风琴;
dance to the music: [acc]/dæns tə ðə ˈmjuːzɪk/; [phr]伴着音乐跳舞;
draw upon: [acc]/drɔ əˈpɔn/; [phr]凭借,利用;
burn out: [acc]/bɜːrn aʊt/; [phr](火)燃尽,烧完自灭;
contrast with: [acc]/kənˈtræst  wɪð/; [phr]与.形成对照;
throw oneself on: [acc]/θrəu wʌnˋsɛlf ɔn/; [phr]扑倒在..上;
make a sound: [acc]/meɪk ə saʊnd/; [phr]发出声音;
stem cell: [acc]/ˈstem sel/; [phr]干细胞;
(be)identical to: [acc]/aɪˈdentɪkl tə/; [phr]和.一样,与.一致;
knock out: [acc]/nɑːk aʊt/; [phr]摧毁;
get out of control: [acc]/ɡet aʊt kənˈtroʊl əv/; [phr]摆脱.控制;
bring...back to life: [acc]/brɪŋ bæk tu laɪf/; [phr]使.复活;
declare war on: [acc]/dɪˈkler wɔːr  ɔːn/; [phr]向.宣战;
make a breakthrough: [acc]/meɪk ə ˈbreɪkθruː/; [phr]取得重大突破(进展);
war memorial: [acc]/ wɔːr məˋmɔrɪəl/; [phr]战争纪念碑;
to one's astonishment: [acc]/tə wʌns ə`stɑnɪʃmənt/; [phr]令某人惊讶的是;
adapt to: [acc]/əˈdæpt tu/; [phr](使)适应;
set foot on: [acc]/set fut ɔn/; [phr]进入,到达;
in case of: [acc]/ɪn keɪs əv/; [phr]假使;
leave sth. behind: [acc]/liːv ˋsʌmθɪŋ bɪˋhaɪnd/; [phr]把.抛在后面;
get tired of doing sth.: [acc]/get taɪəd əv/; [phr]厌倦做某事;
at liberty: [acc]/æt `lɪbərti /; [phr]获得自由的;
up to: [acc]/ʌp tuː/; [phr]到(某个数量);
have...in common: [acc]/hæv ɪn ˈkɔmən/; [phr]与.有共同点;
tell...apart: [acc]/tɛl əˋpɑrt/; [phr]区分开;
a huge number of: [acc]/ə  hjuːdʒ ˈnʌmbə(r)  əv/; [phr]大量的;
get down to sth.: [acc]/get daun tu/; [phr]开始做某事;
at the very beginning of: [acc]/æt ðə ˋvɛrɪ bɪˈgɪnɪŋ əv/; [phr]在.一开始的时候;
accuse sb. of doing sth.: [acc]/əˈkjuːz ˈsʌmbədɪ əv ˈduːɪŋ ˈsʌmθɪŋ/; [phr]指责某人某事;
pray for: [acc]/preɪ fɔr/; [phr]祈望;
take hold of: [acc]/teɪk hold əv/; [phr]抓住;
approve of sth.: [acc]/əˈpruːv  əv/; [phr]赞成某事;
a chorus of: [acc]/ə ˋkɔrəs əv/; [phr]异口同声的;
cater for: [acc]/keɪtər fɔr/; [phr]满足.的要求;
correspond with: [acc]/,kɔrə`spɑnd wɪθ/; [phr]与.通信;
with an average of: [acc]/wɪð æn ˈævrɪdʒ əv/; [phr]平均为;
be rude to: [acc]/bi ruːd tu/; [phr]对.粗鲁;
draw sb's attention to: [acc]/drɔ ˈsʌmbədi s əˈtɛnʃn tu/; [phr]引起某人注意(某事物);
take possession of: [acc]/teɪk pəˈzeʃn əv/; [phr]占有,占据,拥有;
look back at: [acc]/lʊk bæk ət/; [phr]回顾,回忆;
have fun: [acc]/həv fʌn/; [phr]玩得开心;
dinner jacket: [acc]/ˈdɪnər dʒækɪt/; [phr]男子晚礼服上装,无尾礼服上装(正式场合穿着,黑色或白色,通常打蝶形领结);
as far as I'm concerned: [acc]/æz fɑ: æz aɪ ɛm kənˈsɜ:nd/; [phr]就我而言;
be considered as: [acc]/bi kənˈsɪdərd æz/; [phr]被看作,被认为是;
in astonishment: [acc]/ɪn əˈstɑːnɪʃmənt/; [phr]惊讶地,吃惊地;
in a...voice: [acc]/ɪn ə vɔɪs/; [phr]用.声音(说),.声地;
no sooner...than...: [acc]/noʊ 'su:nə ðæn/; [phr]刚一...就;
a huge amount of: [acc]/ə hjuːdʒ əˈmaʊnt əv/; [phr]大量的;
bring sth. to the attention of sb: [acc]/brɪŋ ˈsʌmθɪŋ tu ði əˈtɛnʃn ʌv ˈsʌmθɪŋ/; [phr]使某人关注某事;
hip hop: [acc]/ˈhɪp hɑːp/; [phr]嬉蹦乐(节奏强烈,说唱形式的一种流行伴舞音乐);
be bored with: [acc]/bi bɔːrd wɪð/; [phr]厌烦;
take advantage of: [acc]/teɪk ədˈvæntɪdʒ əv/; [phr]利用;
be devoted to: [acc]/bi dɪˈvoʊtɪd tu/; [phr]对.专一,专注;
beg for: [acc]/beɡ fər/; [phr]乞求,请求;
make an impression on sb.: [acc]/meɪk ən ɪmˈpreʃn ɑːn ˈsʌmbədi/; [phr]给某人留下印象;
bright-coloured: [acc]/braɪt ˈkʌlərd/; [phr]颜色鲜艳的;
in use: [acc]/ɪn yuz/; [phr]在使用;
remind sb. of sth.: [acc]/rɪˈmaɪnd ˈsʌmbədi əv ˈsʌmθɪŋ/; [phr]使某人想起.;
symbolic ambassador: [acc]/sɪmˈbɑlɪk æmˈbæsədər/; [phr]形象大使;
at the mercy of...: [acc]/æt ðə ˈmɜːrsi əv/; [phr]受...支配;
be honoured for: [acc]/ bi ˈɑːnərd tu/; [phr]因.受人尊敬;
come into view: [acc]/kʌm ɪntə vjuː/; [phr]出现;
volcanic eruption: [acc]/vɑːlˈkænɪk  ɪˈrʌpʃn/; [phr]火山爆发;
in a way: [acc]/in ə weɪ/; [phr]在某种程度上说;
on one's side: [acc]/ ɔːn  wʌnz saɪd/; [phr]侧身;
on the way to: [acc]/ɔːn ðə weɪ tu/; [phr]在去.的路上;
pay rise: [acc]/peɪ raɪz/; [phr]涨工资;
name...after: [acc]/neɪm ˈæftər/; [phr]以.命名;
count on: [acc]/kaʊnt  ɔːn/; [phr]依靠;
musical instrument: [acc]/ˌmjuːzɪkl ˈɪnstrəmənt/; [phr]乐器;
suspension bridge: [acc]/səˈspenʃn brɪdʒ/; [phr]吊桥;
burst out laughing: [acc]/bɜːrst aʊt læfɪŋ/; [phr]突然大笑起来;
cash a cheque: [acc]/kæʃ  ə tʃek/; [phr]兑现支票;
wait in line: [acc]/weɪt ɪn laɪn/; [phr]排队等候;
black eye: [acc]/ˌblæk ˈaɪ/; [phr](打得)鼻青脸肿;
from time to time: [acc]/frəm taɪm tu  taɪm/; [phr]不时地;
run into: [acc]/rʌn ˈɪntə/; [phr]撞上;
turn sb. off: [acc]/tɜːrn sb. ɔːf/; [phr]令人讨厌;
boarding school: [acc]/ˈbɔːrdɪŋ skuːl/; [phr]寄宿学校;
play around: [acc]/pleɪ əˈraʊnd/; [phr]四处玩耍;
pull faces: [acc]/pʊl feɪsis/; [phr]做鬼脸;
hang on a second: [acc]/hæŋ ɑːn ə ˈsekənd/; [phr]等一下;
bits and pieces: [acc]/bɪts ənd piːsis/; [phr]各种各样的零碎东西;
greenhouse effect: [acc]/ 'ɡrinhaʊs ɪ'fɛkt /; [phr]温室效应;
beyond one's control: [acc]/ bɪ'jɑnd wʌns kənˈtrol /; [phr]处于某人控制范围之外;
pin (on): [acc]/ pɪn ɑn /; [phr]把责任加在(某人)身上;
take action: [acc]/ tek 'ækʃən /; [phr]采取行动;
call for an end to sth.: [acc]/kɔl fɔr ən ɛnd tu 'sʌmθɪŋ/; [phr]要求结束..;
on one's behalf: [acc]/ɑn wʌns bɪ'hæf/; [phr]代表;
plug one's ears: [acc]/ plʌɡ wʌns ɪrs /; [phr]塞住耳朵;
sum up: [acc]/sʌm ʌp/; [phr]总结;
hand over: [acc]/ hand ˈəʊvə /; [phr]把.交给; [v]转交; [n](权力,责任等的)移交;
bid...goodbye: [acc]/bɪd gʊd'baɪ/; [phr]向.告别;
be exposed to: [acc]/bi ɪk'spozd tu/; [phr]处于可能受伤害的境地;
in a flash: [acc]/ɪn ə flæʃ/; [phr]瞬间,即刻;
stand up for: [acc]/ stand ʌp fɔr /; [phr]维护;
from then on: [acc]/frʌm ðɛn ɑn/; [phr]从那时起;
subscribe (to): [acc]/səb'skraɪb tu/; [phr]订阅(杂志或报纸);
the more...the more: [acc]/ðə mɔr ðə mɔr/; [phr]越.就越.;
pushing up daisies: [acc]/ pʊʃɪŋ ʌp 'deziz /; [phr](俚)死;
rope off: [acc]/ rop ɔf /; [phr]用绳围起(隔开);
bring sth. on sb.: [acc]/ brɪŋ 'sʌmθɪŋ ɑn 'sʌmbədi /; [phr]给某人招来(不愉快的)事情;
sort out: [acc]/sɔːrt aʊt/; [phr]整理分类;解决(问题或困难);让.意识到;
life expectancy: [acc]/ˈlaɪf ɪkspektənsi/; [phr]预期寿命;
wind sb. up: [acc]/wɪnd ˈsʌmbədi ʌp/; [phr]故意惹恼某人(尤指开玩笑);
knock into sb.: [acc]/ nɑk 'ɪntə /; [phr]撞上某人;
turning point: [acc]/ˈtɜːrnɪŋ pɔɪnt/; [phr]转折点;
on principle: [acc]/ɑn 'prɪnsəpl/; [phr]根据原则;
mother tongue: [acc]/ˌmʌðər ˈtʌŋ/; [phr]母语;
for ages: [acc]/fɔːr eɪdʒiz/; [phr]很久,很长时间;
I bet: [acc]/aɪ bet/; [phr]我敢打赌;
Academy of Arts: [acc]/əˈkædəmi əv arts/; [phr]艺术学院;
track and field: [acc]/ˌtræk ən ˈfiːld/; [phr]田径运动;
in vain: [acc]/ɪn veɪn/; [phr]徒然,白费力气;
at random: [acc]/æt ˈrændəm/; [phr]随便地,随意地;
at all costs: [acc]/æt ɔːl kɔsts/; [phr]不管多大代价,无论如何;
straight away: [acc]/streɪt əˈweɪ/; [phr]立即,马上;
stop sth. in its tracks: [acc]/stɑːp ˈsʌmθɪŋ ɪn ɪts træks/; [phr]终止,消灭;
at any rate: [acc]/æt ˈeni reɪt/; [phr]无论如何,至少;
attend a workshop: [acc]/əˈtend ə ˈwɜːrkʃɑːp/; [phr]参加研讨会;
annual meeting: [acc]/ˈænjuəl ˈmitɪŋ/; [phr]年会;
be responsible for: [acc]/bi rɪˈspɑnsəbəl fɔr/; [phr]对.负责,是.的原因;
award a prize: [acc]/əˈwɔːrd ə praɪz/; [phr]授奖;
catering service: [acc]/ˈkeɪtərɪŋ ˈsɜːrvɪs/; [phr]饮食服务;
be in charge of: [acc]/bi ɪn tʃɑrdʒ ʌv/; [phr]负责;
make a contribution: [acc]/meɪk ə ˌkɑːntrɪˈbjuːʃn/; [phr]做贡献;
IT consultant: [acc]/aɪtiː kənˈsʌltənt/; [phr](Information Technology consultant)信息技术顾问;
head office: [acc]/ˌhed ˈɔːfɪs/; [phr]总公司;
finance assistant: [acc]/ˈfaɪnæns əˈsɪstənt/; [phr]财务助理;会计助理;
chronic fatigue syndrome: [acc]/ˌkrɑːnɪk fəˈtiːɡ sɪndroʊm/; [phr]慢性疲劳综合征;
job title: [acc]/dʒɑb ˈtaɪtl/; [phr]职称,职位;
PA: [acc]/ˌpiː ˈeɪ/; [phr](Personal Assistance)私人秘书;(=Product Assurance)产品安全;
production flow: [acc]/prəˈdʌkʃən flo/; [phr]生产流程;
production manager: [acc]/prəˈdʌkʃən ˈmænɪdʒɚ/; [phr]生产经理;
marathon running: [acc]/ˈmærəθɑːn ˈrʌnɪŋ/; [phr]马拉松赛跑;
job applicant: [acc]/dʒɑb ˈæplɪkənt/; [phr]求职人员;
sales rep: [acc]/ˈseɪlz rep/; [phr]推销员;
scuba diving: [acc]/ˈskubə 'daɪvɪŋ/; [phr]戴水肺潜水;
work for: [acc]/wɚk fɔr/; [phr]为.工作;
convention centre: [acc]/kənˈvɛnʃən ˈsɛntɚ/; [phr]会议中心;
finance director: [acc]/fəˈnæns dɪˈrɛktɚ/; [phr]财务经理;
for or against: [acc]/fɔːr ɔːr əˈɡeɪnst/; [phr]支持或反对;
one-to-one session: [acc]/ˌwʌn tə ˈwʌn ˈseʃn/; [phr]一对一谈话,一对一会议;
marketing manager: [acc]/ˈmɑːrkɪtɪŋ ˈmænɪdʒər/; [phr]市场销售经理;
maternity leave: [acc]/məˈtɜːrnəti liːv/; [phr]产假;
period of transition: [acc]/ˈpɪriəd ʌv trænˈzɪʃən/; [phr]过渡时期;
overall grade: [acc]/ˌoʊvərˈɔːl ɡreɪd/; [phr]整体成绩;
potential client: [acc]/pəˈtenʃl ˈklaɪənt/; [phr]潜在客户;
production plant: [acc]/prəˈdʌkʃən plænt/; [phr]生产工厂;
project manager: [acc]/prəˈdʒɛkt ˈmænɪdʒɚ/; [phr]项目经理;
quality inspector: [acc]/ˈkwɑlɪti ɪnˈspɛktɚ/; [phr]质量检验员;
return flight: [acc]/rɪˈtɚn flaɪt/; [phr]往返航班;
shopping centre: [acc]/ˈʃɑːpɪŋ sentər/; [phr]购物中心;
core business: [acc]/kɔr ˈbɪznɪs/; [phr]核心业务;
go public: [acc]/ɡo ˈpʌblɪk/; [phr]上市;
level off: [acc]/ˈlevəl ɔːf/; [phr](升或跌之后)呈平稳状态;
tour guide: [acc]/tʊr ɡaɪd/; [phr]导游;
budget airline: [acc]/ˈbʌdʒɪt ˈɛrˌlaɪn/; [phr]廉价航空;
trade fair: [acc]/treɪd fer/; [phr]商品交易会;
take shape: [acc]/teɪk ʃeɪp/; [phr]形成;体现;
take on: [acc]/teɪk ɑːn/; [phr]从事;呈现;承担;接受;较量;开始雇用;
business partner: [acc]/ˈbɪznəs ˈpɑːrtnər/; [phr]合伙人;
limited company: [acc]/ˌlɪmɪtɪd ˈkʌmpəni/; [phr]有限公司;
budget figures: [acc]/ˈbʌdʒɪt ˈfɪɡjərz/; [phr]预算数据;
still water: [acc]/stɪl ˈwɔtɚ/; [phr]无气饮用水;
business conference: [acc]/ˈbɪznɪs ˈkɑnfərəns/; [phr]业务会议;
purchasing manager: [acc]/ˈpɜːrtʃəsɪŋ ˈmænɪdʒər/; [phr]采购经理;
sparkling water: [acc]/ˈspɑrklɪŋ ˈwɔtɚ/; [phr]苏打水;
press release: [acc]/ˈpres rɪliːs/; [phr]新闻稿;
remain steady: [acc]/rɪˈmeɪn ˈstedi/; [phr](物价)稳定;
extension number: [acc]/ɪkˈstɛnʃən ˈnʌmbɚ/; [phr]分机号码;
freight forwarder: [acc]/fret ˈfɔrwədɚ/; [phr]货运代理;运输经纪人;
import ban: [acc]/ˈɪmpɔrt bæn/; [phr]进口禁令;
mute button: [acc]/ˈmjuːt bʌtn/; [phr]静音键,静噪键;
dish of the day: [acc]/dɪʃ əv ðə deɪ/; [phr]今日推荐菜品;
printer cartridge: [acc]/ˈprɪntɚ ˈkɑrtrɪdʒ/; [phr]打印机墨盒;
sole trader: [acc]/sol ˈtredɚ/; [phr]独资经营;个体经营;
retail trade: [acc]/ˈriˌtel treid/; [phr]零售业;
tax form: [acc]/tæks fɔrm/; [phr]纳税申报表格;
time difference: [acc]/taɪm ˈdɪfərəns/; [phr]时间差;
bank loan: [acc]/bæŋk loʊn/; [phr]银行贷款;
be off: [acc]/bi ɔf/; [phr]腐烂,变味;掉下,落下;离开;被取消;
business card: [acc]/ˈbɪznəs kɑːrd/; [phr]名片;
business park: [acc]/ˈbɪznəs pɑːrk/; [phr]商业园;商业区;
loan application: [acc]/lon ˌæplɪˈkeʃən/; [phr]贷款申请;
make a loss: [acc]/mek e lɔs/; [phr]亏损;
make a profit: [acc]/mek e ˈprɑfɪt/; [phr]获利;
meet up: [acc]/miːt ʌp/; [phr]遇见;约见;会见;
office block: [acc]/ˈɔːfɪs blɑːk/; [phr]办公大楼;
on a small scale: [acc]/ɑn e smɔl skel/; [phr]小规模地;
progress report: [acc]/ˈprɑɡˌrɛs rɪˈpɔrt/; [phr]进度报告;
rat race: [acc]/ræt reɪs/; [phr]不停的劳碌奔波;商业上竞争;
removal company: [acc]/rɪˈmuːvl ˈkʌmpəni/; [phr]搬家公司;
stress out: [acc]/strɛs aʊt/; [phr]过度劳累;紧张;
air traffic controller: [acc]/ˌer træfɪk kənˈtroʊlər/; [phr]空中交通管制员;
best regards: [acc]/best rɪˈɡɑːrdz/; [phr]问候;致敬;
excess charge: [acc]/ˈɛkˌsɛs tʃɑrdʒ/; [phr]逾重费;
first class: [acc]/ˌfɜːrst ˈklæs/; [phr]头等舱;
flight attendant: [acc]/ˈflaɪt ətendənt/; [phr]空中服务员;
fully booked: [acc]/ˈfʊli bʊkt/; [phr]客满;
concierge service: [acc]/kɔːnˈsjerʒ ˈsɜːrvɪs/; [phr]门房服务;
in-flight magazine: [acc]/ˌɪn ˈflaɪt ˈmæɡəziːn/; [phr]机上杂志;
check-in clerk: [acc]/ˈtʃek ɪn klɜːrk/; [phr]验票员;
secretarial services: [acc]/ˌsekrəˈteriəl ˈsɜːrvɪsɪs/; [phr]秘书服务;
video projector: [acc]/ˈvɪdioʊ prəˈdʒektər/; [phr]图像投影机;
agree on: [acc]/əˈɡriː ɑːn/; [phr]对.意见一致;
be made of: [acc]/bi meɪd əv/; [phr]由..构成;由..组成;
economy class: [acc]/ɪˈkɑnəmi klæs/; [phr]经济舱;
business class: [acc]/ˈbɪznəs klæs/; [phr]商务舱;
connecting flight: [acc]/kəˈnɛktɪŋ flaɪt/; [phr]转接班机;
courier company: [acc]/ˈkʊriər ˈkʌmpəni/; [phr]速递公司;
penalty charge: [acc]/ˈpenəlti tʃɑːrdʒ/; [phr]罚款费用;
filing cabinet: [acc]/ˈfaɪlɪŋ kæbɪnət/; [phr]档案橱柜;
per annum: [acc]/pər ˈænəm/; [phr]每年;
fire brigade: [acc]/ˈfaɪər brɪɡeɪd/; [phr]消防队;
pen drive: [acc]/ˈpen draɪv/; [phr]闪存盘,U盘;
running costs: [acc]/ˈrʌnɪŋ kɔːsts/; [phr]运行成本,日常管理费用,流水成本;
tuition fee: [acc]/tuˈɪʃən fi/; [phr]学费;
light setting: [acc]/laɪt ˈsetɪŋ/; [phr]照明装置;
value for money: [acc]/ˈvælju fɔr ˈmʌni/; [phr]物超所值;
anti-virus program: [acc]/ˈænti ˈvaɪrəs ˈproʊɡræm/; [phr]反病毒程序;
dial-up connection: [acc]/ˈdaɪəl ʌp kəˈnekʃn/; [phr]拨号连接;
be on site: [acc]/bi ɑːn saɪt/; [phr]在现场;
factory floor: [acc]/ˌfæktri ˈflɔːr/; [phr]工厂车间;
financial return: [acc]/faɪˈnænʃl rɪˈtɜːrn/; [phr]财政收益;
heat up: [acc]/hit ʌp/; [phr]加热;加剧;
key feature: [acc]/ki ˈfitʃɚ/; [phr]关键特征;
plug in: [acc]/ˈplʌɡˌɪn/; [phr]插入;插上插头;
smoke alarm: [acc]/ˈsmoʊk əlɑːrm/; [phr]烟气报警器;
loading bay: [acc]/ˈlodɪŋ be/; [phr]装货间;进料台;
under licence: [acc]/ˈʌndər ˈlaɪsns/; [phr]获得许可证,领有执照;
lean manufacturing: [acc]/liːn ˌmænjuˈfæktʃərɪŋ/; [phr]精益生产,精实制造;
optical cell: [acc]/ˈɑːptɪkl sel/; [phr]光学元件;
response time: [acc]/rɪˈspɑːns taɪm/; [phr]响应时间;
shipping company: [acc]/ˈʃɪpɪŋ ˈkʌmpəni/; [phr]航运公司;轮船公司;
local council: [acc]/ˈloʊkl ˈkaʊnsl/; [phr]市政委员会;市议会;
departmental meeting: [acc]/ˌdiːpɑːrtˈmentl ˈmiːtɪŋ/; [phr]部门会议;
after-school care: [acc]/ˈæftər skuːl ker/; [phr]托儿中心;课后托管;
draw up a plan: [acc]/drɔ ʌp e plæn/; [phr]制定计划;
bring down: [acc]/brɪŋ daʊn/; [phr]使倒下;减少;
blow over: [acc]/blo ˈovɚ/; [phr]平息;停止;被忘掉;
exhaust emission: [acc]/ɪɡˈzɔst ɪˈmɪʃən/; [phr]汽车废气排放;
emergency team: [acc]/iˈmɜːrdʒənsi tiːm/; [phr]抢救队;
lamb chops: [acc]/læm tʃɑːps/; [phr]羊排;
run a meeting: [acc]/rʌn eɪ ˈmiːtɪŋ/; [phr]开会;
solar panel: [acc]/ˌsoʊlər ˈpænl/; [phr]太阳能电池板;
steak tartar: [acc]/steɪk ˈtɑːrtər/; [phr]鞑靼牛排;
high-speed trains: [acc]/ˌhaɪ ˈspiːd treɪns/; [phr]高速列车;
start up: [acc]/ˈstɑːrtˌʌp/; [phr]创办;开动;开机;开办;新成立的;
exchange rate: [acc]/ɪksˈtʃeɪndʒ reɪt/; [phr]汇率;兑换率;
sweep across: [acc]/swiːp əˈkrɔːs/; [phr]席卷,横扫;冲过,迅速掠过;
take time off: [acc]/teɪk taɪm ɔːf/; [phr]抽出时间;
waiting time: [acc]/ˈwetɪŋ taɪm/; [phr]等待时间;待命时间;停工时间;
joint venture: [acc]/ˌdʒɔɪnt ˈventʃər/; [phr]合资企业;
sales team: [acc]/ˈseɪlz tiːm/; [phr]销售团队;
shopping list: [acc]/ˈʃɑːpɪŋ lɪst/; [phr]购物单;
viable option: [acc]/ˈvaɪəbl ˈɑːpʃn/; [phr]可行的替代方案;
chamber of commerce: [acc]/ˈtʃembɚ ʌv ˈkɑməs/; [phr]商会;
dress code: [acc]/ˈdres koʊd/; [phr]着装要求;
move on: [acc]/mʊv ɑːn/; [phr]继续前进,更换工作(话题等),离开;
assembly point: [acc]/əˈsɛmbli pɔɪnt/; [phr]集合地点;
baggage handler: [acc]/ˈbæɡɪdʒ ˈhændlɚ/; [phr]行李员;
baby grand piano: [acc]/ˈbebi ɡrænd piˈæno/; [phr]小型平台式钢琴;
be hospitalised: [acc]/bi ˈhɑːspɪtəlaɪz/; [phr]住院;
big toe: [acc]/ˌbɪɡ ˈtoʊ/; [phr]大趾;
clock in: [acc]/klɑk ɪn/; [phr]打卡上班;记录上班时间;
facial bruising: [acc]/ˈfeɪʃl ˈbruːzɪŋ/; [phr]面部擦伤;
fire drill: [acc]/ˈfaɪər drɪl/; [phr]消防演习;
fire exit: [acc]/faɪr ˈɛɡzɪt/; [phr]安全出口,紧急出口;
get the sack: [acc]/ɡɛt ði sæk/; [phr]被解雇;被辞退;
heat exhaustion: [acc]/hit ɪɡˈzɔstʃən/; [phr]中暑衰竭(指轻度中暑);
high voltage: [acc]/haɪ ˈvoʊltɪdʒ/; [phr]高电压,高压;
listen for: [acc]/ˈlɪsən fɔr/; [phr]注意倾听;
locker room: [acc]/ˈlɑːkər ruːm/; [phr]更衣室,衣帽间;
lose one's balance: [acc]/luːz wʌnz ˈbæləns/; [phr]失去平衡,心慌意乱;
movable barrier: [acc]/ˈmuvəbəl ˈbæriɚ/; [phr]可移动障碍物,可移动阻片;
on offer: [acc]/ɑn ˈɔfɚ/; [phr]降价出售;
pool table: [acc]/pʊl ˈteɪbəl/; [phr]台球桌;
protective mask: [acc]/prəˈtɛktɪv mæsk/; [phr]防毒面具;
reduce the risk: [acc]/rɪˈduːs ðə rɪsk/; [phr]降低风险;
video beamer: [acc]/ˈvɪdioʊ ˈbiːmə/; [phr]视频投影机;
covering letter: [acc]/ˌkʌvərɪŋ ˈletər/; [phr](附于包裹或信件内用于说明或附言的)附信,求职信;
cruise ship: [acc]/kruz ʃɪp/; [phr]游艇;
sound system: [acc]/ˈsaʊnd sɪstəm/; [phr]音响设备;
export contract: [acc]/ɪksˈpɔrt ˈkɑnˌtrækt/; [phr]出口合同;
financial services: [acc]/faɪˈnænʃ(ə)l ˈsɜːvɪsis/; [phr]金融服务;
waste material: [acc]/west məˈtɪriəl/; [phr]废料;
water consumption: [acc]/ˈwɔtɚ kənˈsʌmpʃən/; [phr]水消耗,耗水量;
participate in: [acc]/pɑrˈtɪsəˌpet ɪn/; [phr]参与,参加;
global marketplace: [acc]/ˈɡloʊbl ˈmɑːrkɪtpleɪs/; [phr]全球市场;
health care: [acc]/ˈhelθ ker/; [phr]卫生保健;
fight back: [acc]/faɪt bæk/; [phr]反击,抵抗;
job-related skills: [acc]/dʒɑːb rɪˈleɪtɪd skɪls/; [phr]职业相关技能;
solid waste: [acc]/ˈsɑlɪd west/; [phr]固体废料;
sign in: [acc]/saɪn ɪn/; [phr]签到,登记;
sign out: [acc]/saɪn aʊt/; [phr]签名登记离开;
parent company: [acc]/ˈperənt ˈkʌmpəni/; [phr]母公司,总公司;
accounts clerk: [acc]/əˌkaʊnts klɜːrk/; [phr]财务文员,会计文员,账务员;
product launch: [acc]/ˈprɑːdʌkt lɔːntʃ/; [phr]产品发布;
post office: [acc]/ˈpoʊst ɔːfɪs/; [phr]邮局;
business plan: [acc]/ˈbɪznɪs plæn/; [phr]商务计划,经营规划;
do sth. different: [acc]/duː ˈsʌmθɪŋ ˈdɪfrənt/; [phr]做些不同的事;
make progress: [acc]/mek ˈprɑɡˌrɛs/; [phr]取得进步;
more than ever: [acc]/mɔːr ðən ˈevər/; [phr]更加,越发,尤其;
spend on sth.: [acc]/spend ɑːn ˈsʌmθɪŋ/; [phr]在某物上花费多少钱;
take a holiday: [acc]/tek e ˈhɑlɪˌde/; [phr]休假;
business centre: [acc]/ˈbɪznɪs ˈsɛntɚ/; [phr]商业中心;
check-in desk: [acc]/ˈtʃek ɪn desk/; [phr]办理登机手续处;
low cost: [acc]/lo kɔst/; [phr]低成本;
email address: [acc]/ˈiːmeɪl əˈdres/; [phr]电子邮件地址;
lose your job: [acc]/luːz jʊr dʒɑːb/; [phr]失去你的工作;
Internet connection: [acc]/ˈɪntərnet kəˈnekʃn/; [phr]网络连接;
personal details: [acc]/ˈpɜːrsənl ˈdiːteɪlz/; [phr]个人信息;
IT technician: [acc]/ɪt tekˈnɪʃn/; [phr](information technology technician)信息技术员,信息技术工程师;
factory worker: [acc]/ˈfæktəri ˈwɚkɚ/; [phr]工厂工人;
kind regards: [acc]/kaɪnd rɪˈɡɑːrdz/; [phr]谨致问候;
magazine editor: [acc]/ˈmæɡəziːn ˈedɪtər/; [phr]期刊编辑;
electrical goods: [acc]/ɪˈlektrɪkl ɡʊdz/; [phr]电气产品;
training course: [acc]/ˈtrenɪŋ kɔː(r)s/; [phr]培训课程;
personnel manager: [acc]/ˌpɚsəˈnɛl ˈmænɪdʒɚ/; [phr]人事主管人;
service user: [acc]/ˈsɜːrvɪs ˈjuːzər/; [phr]服务使用者;
career field: [acc]/kəˈrɪr fild/; [phr]事业领域;
run a business: [acc]/rʌn eɪ ˈbɪznəs/; [phr]经营生意;
high-heel shoes: [acc]/ˌhaɪ ˈhiːl ʃuːz/; [phr]高跟鞋;
university campus: [acc]/ˌjuːnɪˈvɜːrsəti ˈkæmpəs/; [phr]大学校园;
fire alarm: [acc]/ˈfaɪər əlɑːrm/; [phr]火警;
application form: [acc]/ˌæplɪˈkeɪʃən fɔːrm/; [phr]申请表;
conference pack: [acc]/ˈkɑːnfərəns pæk/; [phr]会议文件;
safety inspection: [acc]/ˈsefti ɪnˈspɛkʃən/; [phr]安全检查;
health and safety: [acc]/hɛlθ ənd ˈsefti/; [phr]健康与安全部门;
rail link: [acc]/rel lɪŋk/; [phr]铁路联络线;
shift work: [acc]/ʃɪft wɚk/; [phr]换班工作,倒班工作; [n]轮班;
involved in: [acc]/ɪnˈvɑːlvd ɪn/; [phr]涉及,包含在..中;
branch out: [acc]/bræntʃ aʊt/; [phr]拓展业务,扩展范围;
profit margin: [acc]/ˈprɑːfɪt mɑːrdʒən/; [phr]利润率;
trade name: [acc]/ˈtreɪd neɪm/; [phr]商品名称,商号,店名;
search engine: [acc]/ˈsɜːrtʃ endʒɪn/; [phr]搜索引擎;
TV commercial: [acc]/ˌtiː ˈviː kəˈmɜːrʃl/; [phr]电视中的商业广告;
give a presentation: [acc]/ɡɪv eɪ ˌpriːzenˈteɪʃn/; [phr]做演示,做展示;
go along: [acc]/ɡoʊ əˈlɔːŋ/; [phr]赞同,支持,进行,前进;
hold a meeting: [acc]/hold e ˈmitɪŋ/; [phr]举行会议;
reach an agreement: [acc]/ritʃ ən əˈɡrimənt/; [phr]达成一致;
see one's point: [acc]/siː wʌnz pɔɪnt/; [phr]明白某人的意思;
set the agenda: [acc]/sɛt ði əˈdʒɛndə/; [phr]制定议程;
take the minutes: [acc]/teɪk ðə ˈmɪnɪts/; [phr]做会议记录;
click on: [acc]/klɪk ɑn/; [phr]点击,打开,启动;
call center: [acc]/kɔl ˈsɛntɚ/; [phr]呼叫中心;
walk out: [acc]/wɔːk aʊt/; [phr]罢工;
cash bonus: [acc]/kæʃ ˈboʊnəs/; [phr]现金分红;
distribution centre: [acc]/ˌdɪstrəˈbjuʃən ˈsɛntɚ/; [phr]配送中心,分销中心;
word of mouth: [acc]/wɚd ʌv maʊθ/; [phr]口头语,口碑;
newspaper advert: [acc]/ˈnuːzpeɪpər ˈædvɜːrt/; [phr]报纸广告;
take with a pinch of salt: [acc]/teɪk wɪð eɪ pɪntʃ əv sɔːlt/; [phr]部分相信(将信将疑);
internet advertising: [acc]/ˈɪntərnet ˈædvərtaɪzɪŋ/; [phr]互联网广告;
parental leave: [acc]/pəˌrentl ˈliːv/; [phr]育婴假,亲职假;
make redundant: [acc]/meɪk rɪˈdʌndənt/; [phr]裁员;
shut down: [acc]/ʃʌt daʊn/; [phr]关闭,(使)停工;
joint responsibility: [acc]/dʒɔɪnt rɪˌspɑnsəˈbɪlɪti/; [phr]连带责任;
key factor: [acc]/ki ˈfæktɚ/; [phr]关键因素;
formulate a response: [acc]/ˈfɔːrmjuleɪt eɪ rɪˈspɑːns/; [phr]制定对策,回应;
meet objective: [acc]/miːt əbˈdʒektɪv/; [phr]满足目标;
single user: [acc]/ˈsɪŋɡl ˈjuːzər/; [phr]单用户模式,单一使用者;
team building: [acc]/ˈtiːm bɪldɪŋ/; [phr]团队建设;
brand identity: [acc]/brænd aɪˈdentəti/; [phr]品牌特色,品牌识别,品牌标识;
quality assurance: [acc]/ˈkwɑːləti əʃʊrəns/; [phr]质量保证;
speech recognition technology: [acc]/spiːtʃ ˌrekəɡˈnɪʃn tekˈnɑːlədʒi/; [phr]语音识别技术;
plan a strategy: [acc]/plæn eɪ ˈstrætədʒi/; [phr]制定策略;
sales pitch: [acc]/ˈseɪlz pɪtʃ/; [phr]兜揽生意的话,推销词;
set targets: [acc]/set ˈtɑːrɡɪts/; [phr]制定目标;
succeed in: [acc]/səkˈsid ɪn/; [phr]取得成功;
break even: [acc]/ˈbreɪkˈiːvən/; [phr]不赔不赚,收支相抵;
avoid interruption: [acc]/əˈvɔɪd ˌɪntəˈrʌpʃn/; [phr]避免中断;
cross-cultural awareness: [acc]/ˌkrɔːs ˈkʌltʃərəl əˈwernəs/; [phr]跨文化意识;
face-to-face training: [acc]/ˌfeɪs tə ˈfeɪs ˈtreɪnɪŋ/; [phr]面对面教学;
remain stable: [acc]/rɪˈmeɪn ˈsteɪbl/; [phr]保持稳定;
ahead of schedule: [acc]/əˈhed əv ˈskedʒuːl/; [phr]提前,超前;
behind schedule: [acc]/bɪˈhaɪnd ˈskɛdʒul/; [phr]晚点,比预定计划(时间)晚;
develop an understanding: [acc]/dɪˈveləp ən ˌʌndərˈstændɪŋ/; [phr]理解;
learn a great deal: [acc]/lɜːrn eɪ ɡreɪt diːl/; [phr]学到很多;
miss opportunity: [acc]/mɪs ˌɑːpərˈtuːnəti/; [phr]错失机会;
on schedule: [acc]/ɑːn ˈskedʒʊl/; [phr]按预定时间;
out of time: [acc]/aʊt ʌv taɪm/; [phr]不合拍,不合时宜;
take care: [acc]/teɪk ker/; [phr]保重,当心,注意;
fire off: [acc]/faɪr ɔf/; [phr]一连串提问(责难等),开炮,发射;
give notice: [acc]/ɡɪv ˈnoʊtɪs/; [phr]离职通知;
take someone on: [acc]/tek ˈsʌmˌwʌn ɑn/; [phr]聘用某人;
holding company: [acc]/ˈhoʊldɪŋ kʌmpəni/; [phr]控股公司;
take seriously: [acc]/tek ˈsɪriəsli/; [phr]认真对待.;
take voluntary redundancy: [acc]/teɪk ˈvɑːlənteri rɪˈdʌndənsi/; [phr]自愿裁汰;
subject line: [acc]/ˈsʌbdʒekt laɪn/; [phr]标题栏,主题栏;
close the sale: [acc]/kloʊz ðə seɪl/; [phr]完成销售,成交;
a day off: [acc]/e de ɔf/; [phr]放一天假,休息日,请一天假;
interpersonal skill: [acc]/ˌɪntɚˈpɚsənəl skɪl/; [phr]社交技巧;
job seeker: [acc]/ˈdʒɑːb siːkər/; [phr]求职者;
personal achievement: [acc]/ˈpɜːrsənl əˈtʃiːvmənt/; [phr]个人成就;
listed company: [acc]/ˌlɪstɪd ˈkʌmpəni/; [phr]上市公司;
clear lines of reporting: [acc]/klɪr laɪnz əv rɪˈpɔːrtɪŋ/; [phr]明确划分权限和职责范围;
customer satisfaction: [acc]/ˈkʌstəmɚ ˌsætɪsˈfækʃən/; [phr]客户满意度;
go out of business: [acc]/ɡoʊ aʊt əv ˈbɪznɪs/; [phr]倒闭,歇业,破产;
high tempo: [acc]/haɪ ˈtempoʊ/; [phr]高速度;
job security: [acc]/dʒɑːb səˈkjʊrəti/; [phr]职业安全感,工作保障;
issue a press release: [acc]/ˈɪʃuː eɪ pres rɪˈliːs/; [phr]发布新闻稿;
long-term planning: [acc]/ˌlɔːŋ ˈtɜːrm ˈplænɪŋ/; [phr]长期规划;
non-financial reward: [acc]/nɑːn faɪˈnænʃl rɪˈwɔːrd/; [phr]非财务奖励;
sales office: [acc]/seɪlz ˈɔːfɪs/; [phr]销售办事处;
sell off: [acc]/ˈselˌɔːfˌ-ˌɑːf/; [phr]廉价出售(存货);
communication channel: [acc]/kəˌmjunɪˈkeʃən ˈtʃænəl/; [phr]信道,通信电路;
advertising campaign: [acc]/ˈædvɚˌtaɪzɪŋ kæmˈpen/; [phr]广告活动;
what's more: [acc]/wɑːts mɔːr/; [phr](常用作插入语)更重要的是,而且,另外,此外,甚者;
owing to: [acc]/ˈoʊɪŋ tə/; [phr]由于,因为;
buying signal: [acc]/baɪ-ɪŋ ˈsɪɡnəl/; [phr]购买信号;
added value: [acc]/æd ˈvæljuː/; [phr]净增值,增值价值;
after-sales service: [acc]/ˌæftər ˌseɪlz ˈsɜːrvɪs/; [phr]售后服务;
competitive advantage: [acc]/kəmˈpɛtɪtɪv ædˈvæntɪdʒ/; [phr]竞争优势;
customer needs: [acc]/ˈkʌstəmər niːdz/; [phr]顾客需求,消费者需求;
decision maker: [acc]/dɪˈsɪʒən ˈmekɚ/; [phr]决策者;
direct mail: [acc]/dəˌrekt ˈmeɪl/; [phr]直接邮寄广告;
perceived benefits: [acc]/pərˈsiːvd ˈbenɪfɪts/; [phr]感知利得,感知利益;
favorable terms: [acc]/ˈfeɪvərəbl tɜːrmz/; [phr]优惠条件;
mass marketing: [acc]/mæs ˈmɑrkɪtɪŋ/; [phr]大众营销,大规模市场销售;
niche marketing: [acc]/niːʃ ˈmɑːrkɪtɪŋ/; [phr]利基营销,对路适销;
point-of-sale promotion: [acc]/ˌpɔɪnt əv ˈseɪl prəˈmoʊʃn/; [phr]销售终端促销;
price competition: [acc]/praɪs ˌkɑmpɪˈtɪʃən/; [phr]价格竞争;
unique selling point: [acc]/juˈniːk ˈselɪŋ pɔɪnt/; [phr]独特卖点;
viral marketing: [acc]/ˌvaɪrəl ˈmɑːrkətɪŋ/; [phr]病毒式营销;
pension scheme: [acc]/ˈpenʃn skiːm/; [phr]退休金计划;
accounts payable: [acc]/əˌkaʊnts ˈpeɪəbl/; [phr]应付账款;
accounts receivable: [acc]/əˌkaʊnts rɪˈsiːvəbl/; [phr]应收账款;
asset value: [acc]/ˈæsˌɛt ˈvælju/; [phr]资产价值;
be short of money: [acc]/bi ʃɔːrt əv ˈmʌni/; [phr]缺钱;
negative equity: [acc]/ˌneɡətɪv ˈekwəti/; [phr]负资产净值,负资产抵押;
negotiate a discount: [acc]/nɪˈɡoʊʃieɪt eɪ ˈdɪskaʊnt/; [phr]商讨折扣;
net income: [acc]/net ˈɪnˌkʌm/; [phr]净收入;
profit and loss: [acc]/ˈprɑːfɪt ənd lɔːs/; [phr]盈亏帐目,损益;
retained profit: [acc]/rɪˈteɪnd ˈprɑːfɪt/; [phr]留存收益,留存盈利;
wage bill: [acc]/weɪdʒ bɪl/; [phr]工资单;
seasonal discounts: [acc]/ˈsiːzənl ˈdɪskaʊnts/; [phr]季节性折扣;
mint condition: [acc]/mɪnt kənˈdɪʃn/; [phr]崭新的;
prompt payment: [acc]/prɑmpt ˈpemənt/; [phr]立即付款;
overseas subsidiary: [acc]/ˌoʊvərˈsiːz səbˈsɪdieri/; [phr]海外子公司;
control freak: [acc]/kənˈtroʊl friːk/; [phr]控制狂;
people skills: [acc]/ˈpiːpl skɪls/; [phr]社交技能,待人处世技能;
share the cost of: [acc]/ʃer ðə kɔːst əv/; [phr]分担费用;
in addition to: [acc]/ɪn əˈdɪʃən tu/; [phr]除..之外(还);
nuclear radiation leak: [acc]/ˈnuːkliər ˌreɪdiˈeɪʃn liːk/; [phr]核辐射泄漏;
shortage of stock: [acc]/ˈʃɔːrtɪdʒ əv stɑːk/; [phr]存货短缺;
oil spill: [acc]/ɔːɪl spɪl/; [phr]漏油;
right to anonymity: [acc]/raɪt tə ˌænəˈnɪməti/; [phr]匿名权;
social responsibility: [acc]/ˈsoʃəl rɪˌspɑnsəˈbɪlɪti/; [phr]社会责任;
support local shops: [acc]/səˈpɔːrt ˈloʊkl ʃɑːps/; [phr]扶持本地企业;
economic policy: [acc]/ˌiːkəˈnɑːmɪk ˈpɑːlɪsi/; [phr]经济政策;
renew the contract: [acc]/rɪˈnuː ðə ˈkɑːntrækt/; [phr]续签合同;
see sth. through: [acc]/siː ˈsʌmθɪŋ θruː/; [phr]把某事坚持到底,使(某事)顺利通过.;
stand up to sb.: [acc]/stænd ʌp tə ˈsʌmbədi/; [phr]与某人对抗;
do a deal: [acc]/duː eɪ diːl/; [phr]达成一笔交易;
break the ice: [acc]/breɪk ðə aɪs/; [phr]打破冷场,打破僵局;
consumer confidence: [acc]/kənˌsuːmər ˈkɑːnfɪdəns/; [phr]消费者信心;
car share scheme: [acc]/kɑːr ʃer skiːm/; [phr]汽车共享计划;
get lost: [acc]/ɡet lɔːst/; [phr]迷路,滚开;
get married: [acc]/ɡet ˈmæriːd/; [phr]结婚;
get sb. involved: [acc]/ɡet ˈsʌmbədi ɪnˈvɑːlvd/; [phr]使某人参与;
get ready: [acc]/ɡɛt ˈrɛdi/; [phr]准备好;
get to know: [acc]/ɡet tə noʊʊ/; [phr]了解,认识;
give sb. a lift: [acc]/ɡɪv ˈsʌmbədi eɪ lɪft/; [phr]让某人搭便车;
climate change: [acc]/ˈklaɪmət tʃeɪndʒ/; [phr]气候变化;
environmentally friendly: [acc]/ɪnˌvaɪrənmentəli ˈfrendli/; [phr]环境友好型的;
go according to plan: [acc]/ɡoʊ əˈkɔːrdɪŋ tə plæn/; [phr]按计划进行;
go crazy: [acc]/ɡo ˈkrezi/; [phr]发疯;
ethical code: [acc]/ˈɛθɪkəl kod/; [phr]伦理规章;
go wrong: [acc]/ɡoʊ rɔːŋ/; [phr]出错,发生故障;
rush hour: [acc]/ˈrʌʃ aʊər/; [phr]上下班高峰时间,交通拥挤时间;
travel expenses: [acc]/ˈtrævl ɪkˈspensɪs/; [phr]旅费;
affordable housing: [acc]/əˈfɔrdəbəl ˈhaʊzɪŋ/; [phr]经济适用房;
ageing population: [acc]/ˈedʒɪŋ ˌpɑpjəˈleʃən/; [phr]人口老龄化;
buying power: [acc]/baɪ-ɪŋ ˈpaʊər/; [phr]购买力;
cost of living: [acc]/kɔːst əv ˈlɪvɪŋ/; [phr]生活成本;
import duty: [acc]/ˈɪmpɔːrt ˈdʊti/; [phr]进口税;
man-made disaster: [acc]/ˌmæn ˈmeɪd dɪˈzæstər/; [phr]人为灾害;
in touch: [acc]/ɪn tʌtʃ/; [phr]保持联系;在.能达到的地方;
cultural values: [acc]/ˈkʌltʃərəl ˈvæljuːz/; [phr]文化价值观;
firsthand experience: [acc]/ˌfɜːrstˈhænd ɪkˈspɪriəns/; [phr]亲身体验;
free trade: [acc]/ˌfriː ˈtreɪd/; [phr]自由贸易;
welfare state: [acc]/ˌwelfer ˈsteɪt/; [phr]福利国家;
get straight to the point: [acc]/ɡet streɪt tə ðə pɔɪnt/; [phr]直奔主题;
multi-national corporation: [acc]/ˈmʌlti ˈnæʃnəl ˌkɔːrpəˈreɪʃn/; [phr]跨国公司;
stock levels: [acc]/stɑːk ˈlevls/; [phr]库存水平;
propose a toast: [acc]/prəˈpoz e tost/; [phr]举杯,敬酒;
shake hands: [acc]/ʃeɪk hændz/; [phr]握手;
social integration: [acc]/ˈsoʃəl ˌɪntɪˈɡreʃən/; [phr]社会融合,社会平等,社会整体化;
trade deficit: [acc]/ˈtreɪd defɪsɪt/; [phr]贸易逆差;
the global village: [acc]/ðə ˈɡloʊbl ˈvɪlɪdʒ/; [phr]地球村;
swift delivery: [acc]/swɪft dɪˈlɪvəri/; [phr]快速交付;
be pressed for: [acc]/bi prɛst fɔr/; [phr]缺乏,缺少;
keep up with: [acc]/kiːp ʌp wɪð/; [phr]跟上,紧跟;
tax incentive: [acc]/tæks ɪnˈsɛntɪv/; [phr]税收激励;
retail at: [acc]/ˈriˌtel æt/; [phr](使)以.(价格)零售;
run on: [acc]/rʌn ɑn/; [phr]继续,不停地讲,滔滔不绝;
standard of living: [acc]/ˌstændərd əv ˈlɪvɪŋ/; [phr]生活水平,生活标准;
income gap: [acc]/ˈɪnkʌm ɡæp/; [phr]收入差距;
day-to-day operations: [acc]/ˌdeɪ tə ˈdeɪ ɑːpəˈreɪʃnz/; [phr]日常经营;
press conference: [acc]/ˈpres kɑːnfərəns/; [phr]记者招待会;
fixed cost: [acc]/fɪkst kɔːst/; [phr]固定成本;
variable cost: [acc]/ˈveriːəbəl kɔːst/; [phr]可变成本;
cash flow: [acc]/ˈkæʃ floʊ/; [phr]资金流动,现金流动量;
tax burden: [acc]/tæks ˈbɜːrdn/; [phr]税负;
renegotiate terms: [acc]/reɪnɪˈɡoʊʃieɪt tɜːrmz/; [phr]重新谈判条款;
current debt: [acc]/ˈkɚrənt dɛt/; [phr]短期债务;
long-term debt: [acc]/ˈlɔŋˈtəm dɛt/; [phr]长期债务;
squeeze a supplier: [acc]/skwiːz eɪ səˈplaɪər/; [phr]打压供应商;
bridging loan: [acc]/ˈbrɪdʒɪŋ loʊn/; [phr]过渡性贷款;
measure success: [acc]/ˈmeʒər səkˈses/; [phr]估量成就;
bearing circle: [acc]/ˈbɛrɪŋ ˈsɚkəl/; [phr]方位圆;
set loose: [acc]/sɛt lus/; [phr]释放,出发,开始;
in force: [acc]/ɪn fɔːrs/; [phr]有效的,在实施中;
think ill of: [acc]/θɪŋk ɪl ʌv/; [phr]对..评价不高;
do everything in one's power to: [acc]/duː ˈevriθɪŋ ɪn wʌnz ˈpaʊər tə/; [phr]竭尽全力做某事;
against one's will: [acc]/əˈɡenst wʌnz wɪl/; [phr]违心地;
at length: [acc]/æt leŋkθ/; [phr]最后,详细地;
under the name of: [acc]/ˈʌndɚ ði nem ʌv/; [phr]用..的名字,在..的名字下;
see through: [acc]/ˈsiːˌθrʊ/; [phr]看穿,识破;
tend to: [acc]/tend tu/; [phr]易于,往往会,倾向于,有助于;
associate with: [acc]/əˈsoʊʊʃiːˌeɪt wɪð/; [phr]与..常在一起,和..联想在一起;
Great Barrier Reef: [acc]/ɡreɪt ˈbæriər riːf/; [phr]大堡礁;
Rafflesia arnoldii: [acc]/ræ'fliːʒɪə ɑː'nəʊldɪɪ/; [phr]大王花;
date back to: [acc]/det bæk tu/; [phr]追溯到,远在..年代;
out of respect: [acc]/aʊt əv rɪˈspekt/; [phr]出于尊敬;
talk sb. into: [acc]/tɔk ˈɪntu/; [phr]说服某人做某事;
red date: [acc]/rɛd det/; [phr]红枣;
attach to: [acc]/əˈtætʃ tu/; [phr]缚上,系上,附加;
turn into: [acc]/tɜːrn ɪntu/; [phr](使)变成;
fit into: [acc]/fɪt ˈɪntʊ/; [phr]适合;
have no use for: [acc]/hæv noʊ juz fɔr/; [phr]不需要,厌恶,对..不耐烦;
not to mention: [acc]/nɑːt tə ˈmenʃən/; [phr]不必提及,更不必说;
cater for sb./sth.: [acc]/ˈkeɪtər fər ˈsʌmbədi ˈsʌmθɪŋ/; [phr]为某人提供,适合某人的需要;
subscribe to: [acc]/səbˈskraɪb tu/; [phr]同意,赞成,订购;
on the whole: [acc]/ɑːn ðə hoʊl/; [phr]大体上,基本上;
cut out: [acc]/kʌt aʊt/; [phr]切去,省略,停止(做某事);
sit around: [acc]/sit əˈraʊnd/; [phr]闲坐着,无所事事;
never mind: [acc]/ˈnevər maɪnd/; [phr]不必担心,不要紧,没有关系;
give off: [acc]/ɡɪv ɔːf/; [phr]发出(蒸汽,光等);
by law: [acc]/baɪ lɔ/; [phr]根据法律;
keep it up: [acc]/kip ɪt ʌp/; [phr]保持优秀成绩,继续干下去;
be occupied with: [acc]/bi ˈɑːkjupaɪd wɪð/; [phr]忙着做..,忙于某事物;
out of the question: [acc]/aʊt əv ðə ˈkwestʃən/; [phr]不可能;
by means of: [acc]/baɪ miːnz əv/; [phr]用..办法,借助..;
team up with: [acc]/tim ʌp wɪð/; [phr]与..合作或一起工作;
the media: [acc]/ði ˈmidiə/; [phr]媒体;
fed up with: [acc]/fɛd ʌp wɪð/; [phr]受够了,饱受,厌烦;
hula hooping: [acc]/ˈhuːlə huːp-ɪŋ/; [phr]玩呼啦圈;
jumping jack: [acc]/ˈdʒʌmpɪŋ dʒæk/; [phr]跳爆竹(一种跳跃运动,跳起时双腿展开,双手在头顶接触,然后恢复到双脚并拢,手臂垂放在身体两侧的姿势);
in detail: [acc]/ɪn dɪˈteɪl/; [phr]详细地;
beyond question: [acc]/biˈɑnd ˈkwɛstʃən/; [phr]无可争辩,毫无疑问;
meet with: [acc]/miːt wɪð/; [phr]遇到,经历,会晤;
master's degree: [acc]/ˈmæstərz dɪˈɡriː/; [phr]硕士学位;
back to back: [acc]/bæk tə bæk/; [phr]背靠背;
pass off as: [acc]/pæs ɔf æz/; [phr](把某人)改变或冒充成..;
generally speaking: [acc]/ˈdʒenərəliː ˈspiːkɪŋ/; [phr]一般来说;
show in: [acc]/ʃoʊ ɪn/; [phr]带或领..进来;
at most: [acc]/æt moʊst/; [phr]至多,最多;
pack up: [acc]/pæk ʌp/; [phr]把..打包,整理;
make a name: [acc]/mek e nem/; [phr]出名;
make of sth./sb.: [acc]/meɪk əv ˈsʌmθɪŋ ˈsʌmbədi/; [phr]了解,理解;
every so often: [acc]/ˈevriː soʊʊ ˈɔːfən/; [phr]时常,偶尔;
cope with: [acc]/koʊp wɪð/; [phr]应付,对付,克服;
let down: [acc]/let daʊn/; [phr]使失望,辜负;
seize on: [acc]/siːz ɑːn/; [phr]抓住,利用;
collision course: [acc]/kəˈlɪʒən kɔː(r)s/; [phr]冲突(的进程或行动);
self-evident: [acc]/ˌself ˈevɪdənt/; [phr]不证自明的,不言而喻的;
live out: [acc]/liːv aʊt/; [phr]活过,实践;
glory in: [acc]/ˈɡlɔri ɪn/; [phr]以..为荣;
for one's own sake: [acc]/fər wʌnz oʊn seɪk/; [phr]为了..的缘故;
sleep rough: [acc]/slip rʌf/; [phr]露宿;
count up: [acc]/kaʊnt ʌp/; [phr]把..加起来;
at the crack of dawn: [acc]/ət ðə kræk əv dɔːn/; [phr]黎明,大清早;
quick as a flash: [acc]/kwɪk əz eɪ flæʃ/; [phr]立刻,马上,一刹那;
a wolf in sheep's clothing: [acc]/eɪ wʊlf ɪn ʃiːps ˈkloʊðɪŋ/; [phr]披着羊皮的狼,伪装友好的敌人;
dead to the world: [acc]/dɛd tu ði wɜrld/; [phr]熟睡的,完全失去知觉的;
wear off: [acc]/wer ɔːf/; [phr]逐渐消失,磨灭,损耗;
zoom in on: [acc]/zuːm ɪn ɑːn/; [phr]拉近,推进,拉开;
in disbelief: [acc]/ɪn ˌdɪsbɪˈliːf/; [phr]不相信,怀疑;
drop into: [acc]/drɑp ˈɪntu/; [phr]偶然进入(某地),顺便拜访;
now and again: [acc]/naʊ ənd əˈɡɛn/; [phr]不时地,有时;
day off: [acc]/ˌdeɪ ˈɔːf/; [phr]休假日,休息日;
mid: [acc]/mɪd/; [adj]中间的;[语]央元音的; [prep]在...的中间; [phr]移动互联网设备(=Mobile Internet Device);
diss: [acc]/dɪs/; [v]轻蔑表示对某人的不敬;在口头上耍弄或者取笑某人; [phr]论文(=dissertation); [n]似芦苇属草纤维;
forearmed: [acc]/ˌfɔːrˈɑːrmd/; [phr]凡事预则立;有备无患;
at the rate of: [acc]/æt ði reɪt ʌv/; [phr]以...速度或比率;
at the risk of: [acc]/æt ði rɪsk ʌv/; [phr]冒着...的危险;
beyond doubt: [acc]/biːˈɑːnd daʊt/; [phr]无疑地;
break away: [acc]/breɪk əˈweɪ/; [phr]消散;拆毁;脱开;突然离开;逃脱;
burst into: [acc]/bɜːrst ˈɪntʊ/; [phr]突然开始;闯入;
bury oneself in: [acc]/ˈbɛri wʌnˈsɛlf ɪn/; [phr]埋头于某事,对.入迷;
call off: [acc]/kɔːl ɔːf/; [phr]取消;把(注意力)转移开;
catch up: [acc]/kætʃ ʌp/; [phr]赶上;很快拾起;缠住;了解近况,叙旧;
check off: [acc]/tʃek ɔːf/; [phr]核对;查对;扣款;
close up: [acc]/kloʊz ʌp/; [phr]靠近;愈合;关闭;
come in for: [acc]/kʌm ɪn fɔːr/; [phr]得到;接受;遭到;受到;
come out with: [acc]/kʌm aʊt wɪð/; [phr]出版;说出,泄露(秘密);提出,发表,讲出;
conform to: [acc]/kənˈfɔrm tu/; [phr]遵从,遵守;符合;
contrary to: [acc]/ˈkɑːnˌtreriː tu/; [phr]与.相反;
count for: [acc]/kaʊnt fɔr/; [phr]有重要性,有价值;
curl up: [acc]/kɜːrl ʌp/; [phr]卷起,蜷曲,撅起;
dedicate...to: [acc]/ˈdedɪkeɪt tu/; [phr]把(时间,力量等)用在..;题献;
devote...to: [acc]/dɪˈvot tu/; [phr]把...献于;
dip into: [acc]/dɪp ˈɪntʊ/; [phr]浸入;浏览;动用(款项等);掏取;
discriminate against: [acc]/dɪˈskrɪməˌnet əˈɡenst/; [phr]歧视,排斥; [vt]虐待;
doze off: [acc]/doʊz ɑːf/; [phr]打瞌睡;打盹儿;
ease in: [acc]/iːz ɪn/; [phr](小心翼翼地)把某物移入或放入某一位置,使逐步适应;逐步适应,放松自己;
eat up: [acc]/iːt ʌp/; [phr]吃光;
fall out: [acc]/fɔːl aʊt/; [phr]争吵;松掉;解散;掉队;结果;退出;
fossil fuel: [acc]/ˈfɑːsl fjuːəl/; [phr]化石燃料;
get back at: [acc]/ɡet bæk æt/; [phr]报复;
green with envy: [acc]/ɡrin wɪð ˈɛnvi/; [phr]十分妒忌,非常嫉妒;
have a ball: [acc]/hæv ə bɔːl/; [phr]狂欢,玩得开心,享受;
hit it off: [acc]/hɪt ɪt ɔf/; [phr]一见如故,合得来;
in and out: [acc]/ɪn ənd aʊt/; [adv]进进出出; [phr]进进出出;
in black and white: [acc]/ɪn blæk ənd waɪt/; [phr]白纸黑字;
in compliance with: [acc]/ɪn kəmˈplaɪəns wɪð/; [phr]遵守,遵从;按照;
in possession of: [acc]/ɪn pəˈzeʃən əv/; [phr]控制;拥有,拥有某物;
in the same boat: [acc]/ɪn ðə seɪm boʊt/; [phr]面临同样的危险;处境相同;
in the wrong: [acc]/ɪn ðə rɔːŋ/; [phr]有错,错误的;负有责任;
keep to oneself: [acc]/kip tu wʌnˈsɛlf/; [phr]保守秘密;不交际;
knock down: [acc]/nɑːk daʊn/; [phr]击倒;拆除;
look out for: [acc]/lʊk aʊt fɔːr/; [phr]密切注意;  quant. 提防;小心,留神;
lose track of: [acc]/luːz træk ʌv/; [phr]失去线索,失去消息,失去联系;
major in: [acc]/ˈmedʒɚ ɪn/; [phr]主修;专攻;专修(某课程);
make a fortune: [acc]/meɪk eɪ ˈfɔːrtʃən/; [phr]发财;赚钱;
make oneself at home: [acc]/mek wʌnˈsɛlf æt hom/; [phr]不要拘束,别客气;
make sense of: [acc]/mek sɛns ʌv/; [phr]了解...的意义,理解;
make use of: [acc]/meɪk juːz əv/; [phr]利用;
none the less: [acc]/nʌn ðə les/; [phr]还是;尽管如此.仍然,依然;
on the verge of: [acc]/ɑn ði vɚdʒ ʌv/; [phr]接近于,濒于;
out of condition: [acc]/aʊt əv kənˈdɪʃən/; [phr]健康不佳;身体不好;情况不佳;
patch up: [acc]/pætʃ ʌp/; [phr]修补;平息;拼凑;
plunge into: [acc]/plʌndʒ ˈɪntu/; [phr]跳入;突然冲入,突然或仓促地开始某事;
pocket money: [acc]/ˈpɑːkɪt mʌni/; [phr]零用钱;
pop out: [acc]/pɑp aʊt/; [phr]弹出;突出出现;突然退出;
prop up: [acc]/prɑp ʌp/; [phr]支撑;支持,支撑;给...撑腰;资助;
pull down: [acc]/pʊl daʊn/; [phr]拉下;拆毁;<非正式>赚钱;
puzzle out: [acc]/ˈpʌzəl aʊt/; [phr]苦苦思索而弄清楚或解决,解决难题;
puzzle over: [acc]/ˈpʌzəl ˈovɚ/; [phr]苦苦思考;苦心思索;
refrain from: [acc]/rɪˈfreɪn frʌm/; [phr]抑制;制止;戒(烟);
result from: [acc]/rɪˈzʌlt frʌm/; [phr]起因于;
round about: [acc]/raʊnd əˈbaʊt/; [phr]大约;围绕;向相反方向;迂回地;
run off: [acc]/ˈrʌnˌɔːf/; [phr]逃跑;流掉;迅速离开;
sea gull: [acc]/si ɡʌl/; [phr]海鸥;
second to none: [acc]/ˈsekənd tə nʌn/; [phr]最好的,顶呱呱;
see about: [acc]/siː əˈbaʊt/; [phr]考虑;负责处理;调查;
send off: [acc]/send ɔːf/; [phr][体]罚下场,给.送行; [vt]寄出(逐出;欢送);
set forth: [acc]/set fɔːrθ/; [vt]陈述;阐明; [phr]出发,启程;
sneer at: [acc]/snɪr æt/; [phr]嘲笑; [v]讥笑;轻视;
specialize in: [acc]/ˈspɛʃəˌlaɪz ɪn/; [phr]专攻;
step by step: [acc]/step baɪ step/; [phr]一步步地,逐步地,逐渐地;
strip down: [acc]/strɪp daʊn/; [phr]脱去;拆开;
strive for: [acc]/straɪv fɔr/; [phr]奋斗;争取;
take account of: [acc]/teɪk əˈkaʊnt ʌv/; [phr]考虑到;顾及;体谅;
take charge of: [acc]/teɪk tʃɑːrdʒ əv/; [phr]负责;照管;监理;担任;
take delight in: [acc]/teɪk dɪˈlaɪt ɪn/; [phr]以..为乐;
take exception to: [acc]/teɪk ɪkˈsepʃən tu/; [phr]反对;表示异议;
take pity on: [acc]/tek ˈpɪti ɑn/; [phr]怜悯;
tear off: [acc]/ter ɔːf/; [phr]撕掉,扯下来,扯掉;匆匆离开;
tear up: [acc]/tɛə ʌp/; [phr]撕毁,撕掉撕成碎片;
tell apart: [acc]/tel əˈpɑːrt/; [phr]辨别;区分,区别;
think highly of: [acc]/θɪŋk ˈhaɪli əv/; [phr]尊重;对.高度评价;
think over: [acc]/θɪŋk ˈoʊvər/; [phr]仔细考虑;
think up: [acc]/θɪŋk ʌp/; [phr]想出;设计出;发明;编造;
throw up: [acc]/θroʊ ʌp/; [phr]呕吐;恶心;匆匆建造;产生;放弃;
to begin with: [acc]/tu ˈbeɪɡɪn wɪð/; [phr]首先;
to the contrary: [acc]/tu ðə ˈkɑːnˌtreri/; [phr]相反;
turn against: [acc]/tɜːrn əˈɡenst/; [phr]背叛;
under consideration: [acc]/ˈʌndɚ kənˌsɪdəˈreʃən/; [phr]在考虑之中;
under control: [acc]/ˈʌndər kənˈtroʊl/; [phr]被控制住,在...控制下;
vantage point: [acc]/ˈvæntɪdʒ pɔɪnt/; [phr](观察事物的)有利地点;有利地位;
vote in: [acc]/vot ɪn/; [phr]选举(选出来);
waste away: [acc]/weɪst əˈweɪ/; [phr]日渐消瘦;
water closet: [acc]/ˈwɔːtər klɑːzət/; [phr]盥洗室;盥洗室,厕所;
with all one's heart: [acc]/wɪð ɔːl wʌnz hɑːrt/; [phr]全心全意地;十分愿意地;
with reference to: [acc]/wɪð ˈrefərəns tu/; [phr]关于,有关;根据;
make a deal: [acc]/meɪk ə dil/; [phr]订个协议;达成协议,做成交易;
count down: [acc]/kaʊnt daʊn/; [phr](发射火箭等时)倒读数;
look down: [acc]/lʊk daʊn/; [phr]俯视;看不起;蔑视;低落;
date back: [acc]/det bæk/; [phr]回溯至,追溯;
subject to: [acc]/ˈsʌbdʒeɪkt tu/; [phr]处于.中;易受...影响的;屈服于...的;取决于;
in the light of: [acc]/ɪn ðə laɪt əv/; [phr]根据,按照;
a variety of: [acc]/ə vəˈraɪtiː əv/; [phr]多种多样,种种;
a wealth of: [acc]/eɪ welθəv/; [phr]很多的;大量的,丰富的;
be limited to: [acc]/bi ˈlɪmɪtɪd tu/; [phr]局限于;
be of prime importance: [acc]/bi ʌv praɪm ɪmˈpɔrtns/; [phr]极其重要;
be paved with: [acc]/biː peɪvd wɪð/; [phr]铺满,遍布;
be resistant to: [acc]/bi rɪˈzɪstənt tu/; [phr]对...有抵御能力的,抗拒的,抵抗的;耐...的;
build confidence: [acc]/bɪld ˈkɑnfɪdəns/; [phr]树立信心;
carve out of: [acc]/kɑrv aʊt ʌv/; [phr]用...雕刻出(引伸为修建);
devoid of: [acc]/dɪˈvɔɪd əv/; [phr]没有,缺乏的;
indulge in: [acc]/ɪnˈdʌldʒ ɪn/; [phr]任凭自己沉溺于.,耽,耽于,醉;
run parallel to: [acc]/rʌn ˈpærəˌlɛl tu/; [phr]与.平行;
satisfy one's needs: [acc]/ˈsætɪsfaɪ wʌnz niːd/; [phr]满足某人的需要;
throw oneself into: [acc]/θro wʌnˈsɛlf ˈɪntu/; [phr]热心投身于,开始努力干;
hang about: [acc]/hæŋ əˈbaʊt/; [phr]闲逛;徘徊;逗留;
then and there: [acc]/ðen ænd ðer/; [phr]当场,立即;
and so forth: [acc]/ənd soʊ fɔːrθ/; [phr]等等,诸如此类;
come around: [acc]/kʌm əˈraʊnd/; [phr]顺便来访;苏醒;复苏;
pull out of: [acc]/pʊl aʊt ʌv/; [phr]离开,退出;取消;
be made from: [acc]/biː meɪd frəm/; [phr]由..制造;
on the way out: [acc]/ɑːn ðə weɪ aʊt/; [phr]即将灭亡;渐渐过时,正在离开;
take one's temperature: [acc]/teɪk wʌnz ˈtemprətʃər/; [phr]量体温;
in contrast to: [acc]/ɪn ˈkɑːntræst tu/; [phr]和...对比,相比之下;与...相反;
be keen on: [acc]/bi kin ɑn/; [phr]渴望,喜爱,爱好,热衷于;
miss out on: [acc]/mɪs aʊt ɑn/; [phr]失去...的好机会;
tidy up: [acc]/ˈtaɪdi ʌp/; [phr]整理;收拾;
in the beginning: [acc]/ɪn ði bɪˈɡɪnɪŋ/; [phr]起初;
come back to life: [acc]/kʌm bæk tu laɪf/; [phr]苏醒过来;复活;
be ready to do: [acc]/bi ˈrɛdi tu/; [phr]随时可,乐意,即将;
take one's place: [acc]/teɪk wʌns pleɪs/; [phr]取代某人;
a case in point: [acc]/ə keɪs ɪn pɔːɪnt/; [phr]恰当的例子;
a hard nut to crack: [acc]/ə hɑːrd nʌt tə kræk/; [phr]棘手的问题;难对付的人;
at the instance of: [acc]/æt ði ˈɪnstəns ʌv/; [phr]经.提议,应.之请;
be attached to: [acc]/bi əˈtætʃt tu/; [phr]依恋;附属于;
be comparable to: [acc]/biː ˈkɑːmpərəbl tuː/; [phr]和.相当,比得上,犹如;
be ignorant of: [acc]/bi ˈɪɡnərənt ʌv/; [phr]不知道,不了解;
be jealous of: [acc]/bi ˈdʒɛləs ʌv/; [phr]嫉妒;
be loyal to: [acc]/bi ˈlɔɪəl tu/; [phr]对.忠诚,忠于;忠实于...;
be rid of: [acc]/bi rɪd ʌv/; [phr]摆脱;
be subject to: [acc]/biː ˈsʌbdʒeɪkt tu/; [phr]服从;以...为条件;容易遭受;
bear on: [acc]/ber ɑːn/; [phr]压在.之上;与..有关;对..有影响;依靠;
combine with: [acc]/kəmˈbaɪn wɪð/; [phr]与...结合(联合);
come into effect: [acc]/kʌm ˈɪntʊ ɪˈfekt/; [phr]生效;实施;
feel up to: [acc]/fiːl ʌp tu/; [phr]觉得能够胜任,觉得身体挺得住;
help oneself: [acc]/help wʌnˈself/; [phr]自助,自取所需(食物);
in excess of: [acc]/ɪn ˈekˌses əv/; [phr]超过;
no fewer than: [acc]/noʊ ˈfjuːə ðæn/; [phr]不少于,至少;不下于;多至;
no other than: [acc]/noʊ ˈʌðər ðæn/; [phr]除...外没有;恰恰是;
out of control: [acc]/aʊt əv kənˈtroʊl/; [phr]失去控制;
pull in: [acc]/pʊl ɪn/; [phr]停车; [v]赚得;逮捕;
track down: [acc]/træk daʊn/; [phr]跟踪追捕;追查;
tune out: [acc]/tuːn aʊt/; [phr]关掉;无视,不理会;
under the heel of: [acc]/ˈʌndər ðə hiːl əv/; [phr]被.践踏(支配);
without fail: [acc]/wɪðˈaʊt feɪl/; [phr]必定;一定;
appeal for: [acc]/əˈpiːl fɔːr/; [phr]要求,呼吁;
brand new: [acc]/ˌbrænd ˈnuː/; [phr]全新的,崭新的;
by the time: [acc]/baɪ ðə taɪm/; [phr]到.时候;直到.时候;
chase up: [acc]/tʃeɪs ʌp/; [phr]提醒某人快做某事;追上;设法(迅速)找到;
chew up: [acc]/tʃuː ʌp/; [phr]损害;嚼碎;
commit a crime: [acc]/kəˈmɪt ə kraɪm/; [phr]犯罪;
compensate for: [acc]/ˈkɑmpənˌset fɔr/; [phr]弥补;赔偿;
conference room: [acc]/ˈkɑːnfərəns ruːm/; [phr]会议厅,会议场所及教室会议室;
construction site: [acc]/kənˈstrʌkʃn saɪt/; [phr]建筑工地;
fight for: [acc]/faɪt fɔr/; [phr]为.而战斗;争斗,争取;
immerse oneself in: [acc]/ɪˈmɜːrs wʌnˈself ɪn/; [phr]埋头于(专心于);陷入;
infringe on: [acc]/ɪnˈfrɪndʒ ɔːn/; [phr]侵犯;违反,违背;
interference with: [acc]/ˌɪntərˈfɪrəns wɪð/; [phr]干涉,干扰;
lash out: [acc]/læʃ aʊt/; [phr]痛打;狠批;挥霍;
lavish...on: [acc]/ˈlævɪʃ ɑn/; [phr]大肆花费;
lighten up: [acc]/ˈlaɪtn ʌp/; [phr]放松;不要生气;
quite a number of: [acc]/kwaɪt ə ˈnʌmbər ʌv/; [phr]相当多的(许多);
ramp up: [acc]/ræmp ʌp/; [v]巩固; [phr]提高,斜升,提升;
root for: [acc]/rut fɔr/; [phr]全力支持,为.加油喝彩,赞助;
speak highly of: [acc]/spiːk ˈhaɪli əv/; [phr]赞扬,高度赞美;
without prejudice: [acc]/wɪðˈaʊt ˈprɛdʒədɪs/; [phr]没偏见;不使受损害;
be afraid of: [acc]/biː əˈfreɪd əv/; [phr]害怕;
collide with: [acc]/kəˈlaɪd wɪð/; [phr]碰撞;抵触;
composite number: [acc]/kəmˈpɑːzət ˈnʌmbər/; [phr]合成数,合数;
compound interest: [acc]/ˌkɑːmpaʊnd ˈɪntrəst/; [phr]复利;
fade away: [acc]/feɪd əˈweɪ/; [phr]逐渐消失;褪色;
at full speed: [acc]/æt fʊl spiːd/; [phr]全速;
in private: [acc]/ɪn ˈpraɪvɪt/; [phr]秘密地;私下地;
on the quiet: [acc]/ɑːn ðə ˈkwaɪt/; [phr]秘密地;私下地;
interfere with: [acc]/ˌɪntərˈfɪr wɪð/; [phr]打扰;妨碍;与...抵触;
lag behind: [acc]/læɡ bɪˈhaɪnd/; [phr]滞后;落在后面;
mark up: [acc]/mɑːrk ʌp/; [phr]标记;加价;提高分数;
out of style: [acc]/aʊt əv staɪl/; [phr]不时髦的,过时的;
out of tune: [acc]/aʊt əv tuːn/; [phr]走调;不一致;
concentric circle: [acc]/kənˈsentrɪk ˈsɜːrkl/; [phr]同心圆;
gain weight: [acc]/ɡeɪn weɪt/; [phr]增加体重,增肥,长胖了;
in cooperation with: [acc]/ɪn koˌɑpəˈreʃən wɪð/; [phr]与..合作;
all year round: [acc]/ɔl jɪr raʊnd/; [phr]一年到头,终年,四季;全年;
exert oneself: [acc]/ɪɡˈzɜːrt wʌnˈself/; [phr]努力;尽力;
adopted child: [acc]/əˈdɑːptɪd tʃaɪld/; [phr]养子(女),义子;
expand on: [acc]/ɪkˈspænd ɑːn/; [phr]进一步阐述,详述;
be proficient in: [acc]/bi prəˈfɪʃənt ɪn/; [phr]熟练;精通;
make a move: [acc]/meɪk ə mʊv/; [phr]采取行动;动身;
keep abreast of: [acc]/kip əˈbrɛst ʌv/; [phr]与.齐头并进;了解.的最新情况;
be ill at ease: [acc]/bi ɪl æt iːz/; [phr]局促不安,心神不宁;困窘;
be worthy of: [acc]/bi ˈwɚði ʌv/; [phr]值得,配得上,当之无愧;
come to light: [acc]/kʌm tə laɪt/; [phr]显露;出现;为众人所知;
through thick and thin: [acc]/θrʊ θɪk ənd θɪn/; [phr]不顾艰难险阻;在任何情况下;患难与共,风雨同舟;
catch a cold: [acc]/kætʃ ə koʊld/; [phr]伤风;感冒;
put in order: [acc]/pʊt ɪn ˈɔrdɚ/; [phr]整理,排列;检修;
take an interest in: [acc]/tek ən ˈɪntrɪst ɪn/; [phr]对.产生兴趣,过问;
be suspicious of: [acc]/bi səˈspɪʃəs ʌv/; [phr]怀疑;
be equipped with: [acc]/bi ɪˈkwɪpt wɪð/; [phr]装备着;
be involved in: [acc]/bi ɪnˈvɑlvd ɪn/; [phr]涉及到;与...有关联,参与;
be eager for: [acc]/biː ˈiːɡər fɔːr/; [phr]想得到;渴望;
peep at: [acc]/pip æt/; [phr]偷看...;
one after the other: [acc]/wʌn ˈæftɚ ði ˈʌðər/; [phr]一个接着一个,陆续; [pron]相继);
show respect for: [acc]/ʃo rɪˈspɛkt fɔr/; [phr]对...表示尊敬;
take a risk: [acc]/tek e rɪsk/; [phr]冒险;
the former: [acc]/ði ˈfɔrmɚ/; [phr]前者;
set foot in: [acc]/set fʊt ɪn/; [vt]进入; [phr]踏进;
so much so that: [acc]/soʊ mʌtʃ soʊ ðæt/; [phr]达到这样的程度以至.;
rise to fame: [acc]/raɪz tu fem/; [phr]成名,出名;
be suitable for: [acc]/biː ˈsuːtəbl fɔːr/; [phr]适合...的;
at any moment: [acc]/ət ˈeni ˈmoʊmənt/; [phr]随时,在任何时候;
be sick of: [acc]/bi sɪk ʌv/; [phr]对...感到厌烦的;
as poor as a church mouse: [acc]/æz pʊr æz e tʃɚtʃ maʊs/; [phr]一贫如洗;
be dependent on: [acc]/bi dɪˈpɛndənt ɑn/; [phr]取决于;依赖;
take the blame: [acc]/tek ði blem/; [phr]承担责任;
cast light on: [acc]/kæst laɪt ɑn/; [phr]使人们明白;阐明;
be conducive to: [acc]/bi kənˈdusɪv tu/; [phr]有助于;
be infected with: [acc]/biː ɪnˈfektɪd wɪð/; [phr]感染(疾病);
out of shape: [acc]/aʊt əv ʃeɪp/; [phr]身体状况不佳;变形,走样;身材不好;
be incapable of: [acc]/bi ɪnˈkepəbəl ʌv/; [phr]不会,不能;
be unaware of: [acc]/bi ˌʌnəˈwɛr ʌv/; [phr]不知道,没有察觉到,没有意识到;
be prone to: [acc]/bi pron tu/; [phr]易于.;
be convinced of: [acc]/bi kənˈvɪnst ʌv/; [phr]确信,相信,深信;
be fit for: [acc]/biː fɪt fɔːr/; [phr]适合于;胜任;
stand on one's feet: [acc]/stænd ɑːn wʌnz fiːt/; [phr]依靠自己,自力更生,自食其力;站起来;
official language: [acc]/əˈfɪʃəl ˈlæŋɡwɪdʒ/; [phr]官方语言;
take an active part in: [acc]/tek ən ˈæktɪv pɑrt ɪn/; [phr]积极参加;
be indifferent to: [acc]/biː ɪnˈdɪfrənt tuː/; [phr]对...漠不关心;把...置之度外;
in short supply: [acc]/ɪn ʃɔrt səˈplaɪ/; [phr]缺乏;短缺;
the more the better: [acc]/ðə mɔːr ðəˈbetər/; [phr]多多益善;
play on the swing: [acc]/pleɪ ɑn ði swɪŋ/; [phr]荡秋千;
beyond expression: [acc]/biˈɑnd ɪkˈsprɛʃən/; [phr]无法表达(形容不出);
drain away: [acc]/dreɪn əˈweɪ/; [phr]渐渐枯竭;流尽;
figure in: [acc]/ˈfɪɡjər ɪn/; [phr]算进去;
become acquainted with: [acc]/bɪˈkʌm əˈkweɪntɪd wɪð/; [phr]开始认识,开始了解,同.结识,熟悉;
in the balance: [acc]/ɪn ðə ˈbæləns/; [phr](生命等)在危急状态中;(命运等)未定;
turn a blind eye: [acc]/tɚn e blaɪnd aɪ/; [phr]视而不见,熟视无睹;
in competition with: [acc]/ɪnˌkɑːmpəˈtɪʃn wɪð/; [phr]在与.竞争之中;与..比赛;
make a complaint: [acc]/mek e kəmˈplent/; [phr]抱怨;
in conflict with: [acc]/ɪn ˈkɑːnˌflɪkt wɪð/; [phr]和...有争执;不一致;
computer crime: [acc]/kəmˈpjuːtər kraɪm/; [phr]电脑犯罪;
be delighted with: [acc]/bi dɪˈlaɪtɪd wɪð/; [phr]因...而十分高兴;
tourist destination: [acc]/ˈtʊrɪst ˌdestɪˈneɪʃn/; [phr]目的地,旅游胜地,旅游目的地;
be distinct from: [acc]/bi dɪˈstɪŋkt frəm/; [phr]与.有差别;
place emphasis on: [acc]/pleɪsˈemfəsɪs ɑːn/; [phr]强调;着重于; [v]重视;
be engaged in: [acc]/bi ɪnˈɡeɪdʒd ɪn/; [phr]从事于,忙于; [vt]致力于...;
face up: [acc]/feɪs ʌp/; [phr]面对;正面朝上;
fade into: [acc]/feɪd ɪntu/; [phr]逐渐消失而变成(无足轻重的东西),在.逐渐消失;渐渐融入于;
form the habit of: [acc]/fɔːrm ðə ˈhæbɪt əv/; [phr]养成...的习惯;
infer from: [acc]/ɪnˈfɚ frʌm/; [phr]从.中推测出.;
under investigation: [acc]/ˈʌndər ɪnˌvestɪˈɡeɪʃn/; [phr]在调查研究中,正在调查中;在观察中;
preside at: [acc]/prɪˈzaɪd æt/; [phr]主持;
in quest of: [acc]/ɪn kwɛst ʌv/; [phr]探索;寻求,寻找,探求;设法找到;
show signs of: [acc]/ʃoʊ saɪnz əv/; [phr]显示...迹象;
tee off: [acc]/tiː ɔːf/; [phr]开球; [vi]发球;
be terrified at: [acc]/biː ˈterɪfaɪd æt/; [phr]被..吓一大跳;
tick away: [acc]/tɪk əˈwe/; [phr](时间一分一秒地)过去;
in commemoration of: [acc]/ɪn kəˌmɛməˈreʃən ʌv/; [phr]为纪念(为庆祝);
out of curiosity: [acc]/aʊt ʌv ˌkjʊriˈɑsɪti/; [phr]出于好奇心;
hold...in high esteem: [acc]/hold ɪn haɪ ɪˈstim/; [phr]十分尊敬,推崇;
a multitude of: [acc]/e ˈmʌltɪˌtud ʌv/; [phr]许多,众多;
under attack: [acc]/ˈʌndɚ əˈtæk/; [phr]遭受攻击;
have an eye for: [acc]/hæv æn aɪ fɔːr/; [phr]有眼光,对.有鉴赏力;
from that moment on: [acc]/frəm ðæt ˈmoʊmənt ɔːn/; [phr]那时起,从那一刻起;
protect...from: [acc]/prəˈtekt frəm/; [phr]保护.不受.;
would rather...than...: [acc]/wʊd ˈræðər ðæn/; [phr]宁愿.而不愿.;
in the mood: [acc]/ɪn ði mud/; [phr]兴致勃勃;
teach sb. a lesson: [acc]/titʃ ˈsʌmˌwʌn e ˈlɛsən/; [phr]给某人一个教训;
career development: [acc]/kəˈrɪr dɪˈvɛləpmənt/; [phr]职业培训,职业发展;
confronted with: [acc]/kənˈfrʌnt wɪð/; [phr]面临;对质;
full refund: [acc]/fʊl ˈriːfʌnd/; [phr]全额退款,全额偿还;
get familiar with: [acc]/ɡɛt fəˈmɪljɚ wɪð/; [phr]变得熟悉,与..熟悉起来;
struggle to do: [acc]/ˈstrʌɡl tə duː/; [phr]奋斗,努力做某事;挣扎着做某事;
be enthusiastic about: [acc]/bi ɛnˌθuziˈæstɪk əˈbaʊt/; [phr]对.热情;
in an effort to: [acc]/ɪn ən ˈefərt tu/; [phr]企图, 努力想;为了,努力;
at the head of: [acc]/æt ði hɛd ʌv/; [phr]在.的最前面;
be stressed out: [acc]/bi strest aʊt/; [phr]紧张,有压力的;
be tolerant of: [acc]/bi ˈtɑːlərənt əv/; [phr]对 ... 容忍(或宽容);
take a day off: [acc]/teɪk ə deɪ ɔːf/; [phr]放一天假;
be content with: [acc]/bi ˈkɑnˌtɛnt wɪð/; [phr]满足于;以 ... 为满足;
be annoyed with: [acc]/bi əˈnɔɪd wɪð/; [phr]被 ... 惹恼;对 ... 生气;
get sick of: [acc]/ɡet sɪk əv/; [phr]厌烦,对.感到厌恶;
be confident in: [acc]/biˈkɑnfədənt ɪn/; [phr]确信;深信;对.有信心;对..充满信心;
an amount of: [acc]/ən əˈmaʊnt ʌv/; [phr]相当数量的;
be tied up with: [acc]/bi taɪd ʌp wɪð/; [phr]和..密切联系;和 ... 协作;
fill up...with...: [acc]/fɪl ʌp wɪð/; [phr]用.把.装满;被 ... 填满;
be worn out: [acc]/bi ˌwɔːrn ˈaʊt/; [phr]累坏了;
come in the form of: [acc]/kʌm ɪn ðə fɔːrm əv/; [phr]以..的形式;
be of benefit to: [acc]/bi əv ˈbenɪfɪt tu/; [phr]对.有益,有好处;
be laid off: [acc]/biː leɪd ɔːf/; [phr]下岗,被解雇;
be piled with: [acc]/bi paɪld wɪð/; [phr]堆积着.;
dissatisfy with: [acc]/dɪsˈsætɪsfaɪ wɪð/; [phr]对..不满意;
be eager to do sth.: [acc]/bi ˈiːɡər tu duː ˈsʌmθɪŋ/; [phr]急欲,渴望做;
threaten to do sth.: [acc]/ˈθretn tu duː ˈsʌmθɪŋ/; [phr]扬言要.;
in contrast with: [acc]/ɪn ˈkɑːntræst wɪθ/; [phr]和.成对比;和.大不相同;
put...into practice: [acc]/pʊt ˈɪntu ˈpræktɪs/; [phr]实施,实行;
can't help but do sth.: [acc]/kænt help bət du ˈsʌmθɪŋ/; [phr]忍不住做某事;
have a good appetite: [acc]/hæv eɪ ɡʊdˈæpɪtaɪt/; [phr]胃口好;饭量大;
credit to: [acc]/ˈkredɪt tu/; [phr]赞赏,归功于,把.归于;
be obliged to sb.: [acc]/biː əˈblaɪdʒd tuː ˈsʌmbədi/; [phr]感激某人;
put a halt to: [acc]/pʊt eɪ hɔːlt tu/; [phr](使)停止,制止;
narrow down to: [acc]/ˈnæroʊ daʊn tu/; [phr]缩减,缩小,收紧;
exert pressure on: [acc]/ɪɡˈzɜːrt ˈpreʃər ɑːn/; [phr]对.施加压力;
expand one's knowledge: [acc]/ɪkˈspænd wʌnzˈnɑːlɪdʒ/; [phr]增长知识;
gain a reputation for: [acc]/ɡeɪn ə ˌrepjuˈteɪʃn fɔːr/; [phr]以.而出名,赢得.的声誉;
be discontent with: [acc]/bi ˌdɪskənˈtent wɪð/; [phr]不满足于;
take...into account: [acc]/teɪk ˈɪntu əˈkaʊnt/; [phr]把.考虑在内;
take over one's business: [acc]/teɪk ˈoʊvər wʌnz ˈbɪznəs/; [phr]接管某人的生意;
come in sight: [acc]/kʌm ɪn saɪt/; [phr]看见,出现,表示看见;
be fit to: [acc]/bi fɪt tu/; [phr]适合;
gain access to: [acc]/ɡeɪn ˈækses tə/; [phr]接近,有接近.的权利;
take a photograph of: [acc]/teɪk ə ˈfoʊtəɡræf əv/; [phr]拍照;
be dying to do sth.: [acc]/biˈdaɪɪŋ tuː duːˈsʌmθɪŋ/; [phr]渴望做某事;
the Gold Rush: [acc]/ðə ɡoʊld rʌʃ/; [phr]淘金热;
in great shape: [acc]/ɪn ɡreɪt ʃeɪp/; [phr]身体状态好,身材好;
make an effort to do: [acc]/meɪk ən ˈefərt tə duː/; [phr]努力(做).;
take priority over: [acc]/teɪk praɪˈɔːrəti ˈoʊvər/; [phr]优先;
draw one's attention to: [acc]/drɔː wʌnz əˈtenʃn tu/; [phr]引起某人注意;
be determined to do sth.: [acc]/bi dɪˈtɜːrmɪnd tu du ˈsʌmθɪŋ/; [phr]下定决心要.;
be inappropriate for: [acc]/bi ɪnəˈproʊpriət fɔːr/; [phr]不合适的,不适当的;
volunteer to do: [acc]/ˌvɑːlənˈtɪr tu du/; [phr]自愿做;
a shortage of: [acc]/ə ˈʃɔːrtɪdʒ ʌv/; [phr]短缺,缺乏;
to the delight of: [acc]/tu ðə dɪˈlaɪt ʌv/; [phr]令.感到喜悦;
have taste in: [acc]/hæv teɪst ɪn/; [phr]有品位,有鉴赏力;
raise one's spirits: [acc]/reɪz wʌnz ˈspɪrɪt/; [phr]使人振奋,打起精神;
all day and all night: [acc]/ɔːl deɪ ænd ɔːl naɪt/; [phr]整日整夜;
be strict about: [acc]/biː strɪkt əˈbaʊt/; [phr]对某事很严格,对某事严格要求;
be diverse from: [acc]/bi daɪˈvɜːrs frʌm/; [phr]和.不同;
career planning: [acc]/kəˈrɪr ˈplænɪŋ/; [phr]职业生涯规划,职业规划;
within walking distance: [acc]/wɪˈðɪn ˈwɔːkɪŋ ˈdɪstəns/; [phr]步行可及,很近;
warn sb. about: [acc]/wɔːrn əˈbaʊt/; [phr]警告,警醒;
make it difficult for sb.: [acc]/meɪk ɪt ˈdɪfɪkəlt fɔːr ˈsʌmbədi/; [phr]难以,使.觉得困难;
put...into prison: [acc]/pʊt ˈɪntu ˈprɪzn/; [phr]关进监狱;把.投进监狱;使.坐牢;
get tired of sth.: [acc]/ɡet ˈtaɪərd əv ˈsʌmθɪŋ/; [phr]厌倦了某事;
play a joke: [acc]/pleɪ eɪ dʒoʊk/; [phr]开玩笑;
have trouble in doing: [acc]/hæv ˈtrʌbl ɪn ˈduːɪŋ/; [phr]做某事有困难;
shear off: [acc]/ʃɪr ɔf/; [phr]剪断,切掉;
inspire sth: [acc]/ɪnˈspaɪər ˈsʌmθɪŋ/; [phr]激励,鼓舞,启迪;
offer opportunity to: [acc]/ˈɔːfər ˌɑːpərˈtuːnəti tuː/; [phr]给...提供机会;
throw up one's hands: [acc]/θroʊ ʌp wʌnz hænds/; [phr]绝望;放弃;
have no time to: [acc]/hæv noʊ taɪm tə/; [phr]没时间.;
by comparison to: [acc]/baɪ kəmˈpærɪsn tuː/; [phr]比较下,相比;
compliance with: [acc]/kəmˈplaɪəns wɪð/; [phr]遵守,遵从,顺从,符合;
cultural environment: [acc]/ˈkʌltʃərəl ɪnˈvaɪrənmənt/; [phr]文化环境;
arouse one's curiosity: [acc]/əˈraʊz wʌnz ˌkjʊriˈɑːsəti/; [phr]引起某人的好奇心;
support one's argument: [acc]/səˈpɔːrt wʌnz ˈɑːrɡjumənt/; [phr]支持...的观点;
take...into consideration: [acc]/teɪk ˈɪntuː kənˌsɪdəˈreɪʃn/; [phr]考虑到;
be reluctant to: [acc]/biː rɪˈlʌktənt tuː/; [phr]不愿意;不情愿;不愿做.的;
not...but rather: [acc]/nɑːt bət ˈræðər/; [phr]不是...而是;
get off with: [acc]/ɡet ɔːf wɪð/; [phr]与.要好;罚款;
cooperate with sb.: [acc]/koʊˈɑːpəreɪt wɪð ˈsʌmbədi/; [phr]和.合作;
focus one's attention on: [acc]/ˈfoʊkəs wʌnz əˈtenʃn ɔːn/; [phr]集中注意力在.上;
make face: [acc]/meɪk feɪs/; [phr]做鬼脸;
engaged to sb.: [acc]/ɪnˈɡeɪdʒd tuː ˈsʌmbədi/; [phr]和.订婚;
insufficient for: [acc]/ˌɪnsəˈfɪʃnt fɔːr/; [phr]不足的;
be wary of: [acc]/bi ˈweri əv/; [phr]提防,小心翼翼;
balance between...and...: [acc]/ˈbæləns bɪˈtwiːn ənd/; [phr]平衡.和.;
in the manner of: [acc]/ɪn ðə ˈmænər əv/; [phr]照.的式样,做出.的样子;
have an insight into sth.: [acc]/hæv æn ˈɪnsaɪt ˈɪntu ˈsʌmθɪŋ/; [phr]洞察某事;
be furious with sb.: [acc]/bi ˈfjʊriəs wɪθ ˈsʌmbədi/; [phr]对..生气;
sign a contract with: [acc]/saɪn ə ˈkɑːntrækt wɪð/; [phr]和..签合同;
build up one's confidence: [acc]/bɪld ʌp wʌnz ˈkɑːnfɪdəns/; [phr]树立信心;
in the circumstance: [acc]/ɪn ðə ˈsɜːrkəmstæns/; [phr]在这种情况下;
be dexterous in: [acc]/bi ˈdɛkstərəs ɪn/; [phr]灵敏于..;
be inadequate for: [acc]/bi ɪnˈædɪkwət fər/; [phr]不够,缺乏;
have the advantage over: [acc]/hæv ðə ədˈvæntɪdʒ ˈoʊvər/; [phr]胜过,优于;
be replaced with: [acc]/bi rɪˈpleɪst wɪð/; [phr]被..代替;
be urged to do: [acc]/biː ɜːrdʒd tə duː/; [phr]不得不做;受到敦促去做;
be obliged to do sth.: [acc]/bi əˈblaɪdʒd tu du ˈsʌmθɪŋ/; [phr]有义务做,不得不;
spend time on: [acc]/spend taɪm ɔːn/; [phr]花时间做某事;
be well-known for: [acc]/bi ˌwel ˈnoʊn fər/; [phr]以.出名;因.而著名;
be skeptical of: [acc]/bi ˈskeptɪkl əv/; [phr]怀疑;
be ready to: [acc]/biː ˈredi tuː duː/; [phr]准备好..;
upper management: [acc]/ˈʌpər ˈmænɪdʒmənt/; [phr]高层管理;
have a good relationship with: [acc]/hæv ə ɡʊd rɪˈleɪʃnʃɪp wɪð/; [phr]和..关系好;
have a go: [acc]/həv ə ɡoʊ/; [phr]企图,尝试;
occupy one's time: [acc]/ˈɑːkjupaɪ wʌnz taɪm/; [phr]占用某人的时间;
in comparison to: [acc]/in kəmˈpærɪsn tu/; [phr]与.相比;
call in on: [acc]/kɔːl ɪn ɑːn/; [phr]拜访,访问;
debate over: [acc]/dɪˈbeɪt ˈoʊvər/; [phr]辩论..;
wave down: [acc]/weɪv daʊn/; [phr]挥手示意..停下;
much to one's surprise: [acc]/mʌtʃ tu wʌnz sərˈpraɪz/; [phr]令.相当吃惊的是;
keep one's fingers crossed: [acc]/kiːp wʌnz ˈfɪŋɡərs krɔːst/; [phr]为.祈祷;
at an alarming rate: [acc]/ət ən əˈlɑːrmɪŋ reɪt/; [phr]以惊人的速度;
proposal for: [acc]/prəˈpoʊzl fɔːr/; [phr]提案,提议;
be apparent to: [acc]/bi əˈpærənt tə/; [phr]清楚,明显;
chase out: [acc]/tʃeɪs aʊt/; [phr]赶走,驱散;
be mindful of: [acc]/bi ˈmaɪndfl əv/; [phr]留意,注意;
be approximate to: [acc]/bi əˈprɑːksɪmət tu/; [phr]近似;接近于.的;
dried food: [acc]/draɪd fuːd/; [phr]干货,干制食品;
find it difficult to do: [acc]/faɪnd ɪt ˈdɪfɪkəlt tə duː/; [phr]觉得做某事很困难;
go without saying: [acc]/ɡoʊ wɪðˈaʊt ˈseɪɪŋ/; [v]不言而喻,理所当然;
above(beyond) reproach: [acc]/əˈbʌv bɪˈjɑːnd rɪˈproʊtʃ/; [adv]无可指责,无可厚非;
behind time: [acc]/bɪˈhaɪnd taɪm/; [adj]迟到;
do sb. a favour: [acc]/duːˈsʌmbədi ə ˈfeɪvər/; [v]为某人帮个忙;
break off (sth.): [acc]/breɪk ɑːf ˈsʌmθɪŋ/; [v]折断;突然结束;
look out for sb.(sth.): [acc]/lʊk aʊt fɔːrˈ sʌmbədi ˈsʌmθɪŋ/; [v]注意;
go round: [acc]/ɡoʊ raʊnd/; [v]足够分配;绕道走,到处走动;
give in (to sb.): [acc]/ɡɪv ɪn tu ˈsʌmbədi/; [v]屈服,投降;
stand by sb.: [acc]/stænd baɪ ˈsʌmbədi/; [v]支持某人;
in hand: [acc]/ɪn hænd/; [adv]可以动用的;在处理中;在控制中;
lay (sth.) out: [acc]/leɪ ˈsʌmθɪŋ aʊt/; [v]展示,摆开;布置,设计;
keep sb. down: [acc]/kiːp ˈsʌmbədi daʊn/; [v]控制;为难;压制;
get by: [acc]/ɡet baɪ/; [v]侥幸躲过,勉强生活;
make sb. out to be: [acc]/meɪk ˈsʌmbədi aʊt tu bi/; [v]把.说成;
once (and) for all: [acc]/wʌns ənd fɔːr ɔːl/; [adv]只此一次,彻底地;
pass away: [acc]/pæs əˈweɪ/; [v]死,逝世;
plead for sb.: [acc]/pliːd fɔːr ˈsʌmbədi/; [v]恳求;为.辩护;
put an end to: [acc]/pʊt ən end tu/; [v]停止,消灭;
set sth. off: [acc]/set ˈsʌmθɪŋ ɑːf/; [v]使爆炸;平衡;
settle on (upon) sth.: [acc]/ˈsetl ɑːn əˈpɔːn ˈsʌmθɪŋ/; [v]决定;
snap at sb.: [acc]/snæp æt ˈsʌmbədi/; [v]对人厉声说;
go about: [acc]/ɡoʊ əˈbaʊt/; [v]着手做;四处走动;传开;从事;
call for: [acc]/kɔːl fɔr/; [v]需要;邀请;呼吁;
look into: [acc]/lʊk ˈɪntu/; [v]研究;调查;
give out: [acc]/ɡɪv aʊt/; [v]停止;耗尽;分发;产生;发出;
look up to: [acc]/lʊk ʌp tu/; [v]尊敬;
pay off: [acc]/peɪ ɔːf/; [v]付清;取得成功,使得益;贿赂;报复;
in favour of: [acc]/ɪn ˈfeɪvər ɑv/; [prep]赞成;以.为收款人;
come out: [acc]/kʌm aʊt/; [vi]出现,显露,出版,被算出,结果是,公开表态;
bring forward: [acc]/brɪŋ ˈfɔrwərd/; [v]提出;提前;
take sth. out: [acc]/teɪk ˈsʌmθɪŋ aʊt/; [v]去掉;取得,取出;
come to nought: [acc]/kʌm tu nɔt/; [v]失败;
call sb. (sth.) up: [acc]/kɔːl ˈsʌmbədi ˈsʌmθɪŋ ʌp/; [v]打电话;征召;
get at sb.(sth.): [acc]/ɡet æt ˈsʌmbədi ˈsʌmθɪŋ/; [v]到达,得到;接近;
give (sth.) off: [acc]/ɡɪv ˈsʌmθɪŋ ɑːf/; [v]发出(烟,气);
hold onto: [acc]/hoʊld ˈɑntə/; [v]抓住,不放;不卖掉;
in line for: [acc]/ɪn laɪn fɔr/; [adv]即可得到;排队;
look in (on sb.): [acc]/lʊk ɪn ɔːn ˈsʌmbədi/; [v](顺便)看望;
look on (sb.) as: [acc]/lʊk ɔːn ˈsʌmbədi æz/; [v]当作..看待;
make up with sb.: [acc]/meɪk ʌp wɪθ ˈsʌmbədi/; [v]与.和解;
make the most of: [acc]/meɪk ðə moʊst ɑv/; [v]充分利用;
mind one's own business: [acc]/maɪnd wʌnz oʊn ˈbɪznəs/; [v]少管闲事;各人自扫门前雪;
on and off: [acc]/ɔn ənd ɑf/;  quant. 断断续续地;
on hand: [acc]/ɔn hænd/; [adv]手头现有;
once more: [acc]/wʌns mɔr/; [adv]再一次;
one another: [acc]/ˌwʌn əˈnʌðər/; [pron]彼此;
orientate oneself: [acc]/ˈɔriənˌteɪt wʌnˈself/; [v]确认方位,地址;
out of stock: [acc]/aʊt ɑv stɒk/; [v]无存货,已脱销;
pass over: [acc]/pæs ˈoʊvər/; [v]忽略;不注意;
pass sth. on to: [acc]/pæs ˈsʌmθɪŋ ɔːn tu/; [v]把.交给.;
persevere with: [acc]/ˌpɜːrsəˈvɪr wɪð/; [v]坚持,不屈不挠;
phase out: [acc]/feɪz aʊt/; [v]逐渐淘汰;
pick sb. (sth.) out: [acc]/pɪk ˈsʌmbədi ˈsʌmθɪŋ aʊt/; [v]选出;认出,挑选;
pick sth. up: [acc]/pɪk ˈsʌmθɪŋ ʌp/; [v]买;得到;知道;捡起;
pull oneself together: [acc]/pʊl wʌnˈself təˈɡeðər/; [v]振作起来;恢复镇定;
reckon with sb.: [acc]/ˈrekən wɪθ ˈsʌmbədi/; [v]清算;将.加以考虑,认真对待;
rise to the occasion: [acc]/raɪz tu ði əˈkeʒən/; [v]应付自如;
see eye to eye (with): [acc]/siː aɪ tu aɪ wɪθ/; [v]看法完全一致;
set about sth.: [acc]/siː əˈbaʊt ˈsʌmθɪŋ/; [v]着手;
bring in: [acc]/brɪŋ ɪn/; [v]增加,赚取,产生,引进;
day in and day out: [acc]/deɪ ɪn ənd deɪ aʊt/; [adv]天天,一天又一天;
the accused: [acc]/ði əˈkjuːzd/; [n]被告;
find one's bearings: [acc]/faɪnd wʌnz ˈberɪŋs/; [v]指明方向;信心十足;
clear the air: [acc]/klɪr ðə er/; [v]消除误会;
for the sake of: [acc]/fɔr ði sek ʌv/; [prep]为.起见;为了.的利益;
come up against: [acc]/kʌm ʌp əˈɡenst/; [v]碰到(困难,反对);
take sth. over: [acc]/teɪk ˈsʌmθɪŋ ˈoʊvər/; [v]接管;
come (bring) sth. to light: [acc]/kʌm brɪŋ ˈsʌmθɪŋ tu laɪt/; [v]显露,揭露;
keep at: [acc]/kip ət/; [v]不断地做;
keep sb. (sth.) out (of): [acc]/kiːp ˈsʌmbədi ˈsʌmθɪŋ aʊt ʌv/; [v]不让.入内;
try one's hand at: [acc]/traɪ wʌnz hænd æt/; [v]尝试着做.;
from the outset: [acc]/frɒm ðə ˈaʊtˌset/; [adv]从一开始;
get somewhere: [acc]/ɡet ˈsʌmwer/; [v]有所成就;
in one's face: [acc]/ɪn wʌnz feɪs/; [adv]公开地;当着某人的面;
come across sb.(sth.): [acc]/kʌm əˈkrɑːs ˈsʌmbədi ˈsʌmθɪŋ/; [v]偶然碰见;
keep sth. (back) from: [acc]/kiːp ˈsʌmθɪŋ bæk frʌm/; [v]不让某事.;离开;
look one's best: [acc]/lʊk wʌnz bɛst/; [v]表现出最好的状态;
lose heart: [acc]/luz hɑrt/; [v]丧失信心;
keep sb. on: [acc]/kiːp ˈsʌmbədi ɔːn/; [v]继续雇用某人;
go without (sth.): [acc]/ɡoʊ wɪˈðaʊt ˈsʌmθɪŋ/; [v]在缺少.的情况下勉强对付;
make up for: [acc]/meɪk ʌp fɔr/; [v]补偿,弥补;
come up: [acc]/kʌm ʌp/; [v]升起;出现;发生;发芽;
give sth. up: [acc]/ɡɪv ˈsʌmθɪŋ ʌp/; [v]放弃;戒烟;
apply oneself (to sth.): [acc]/əˈplaɪ wʌnˈself tu ˈsʌmθɪŋ/; [v]专心致志于;
keep to: [acc]/kip tu/; [v]履行诺言;限制自己;坚持;
at the same time: [acc]/ət ðə seɪm taɪm/; [adv]同时;然而;
be set on sth.: [acc]/biː set ɔːn ˈsʌmθɪŋ/; [adj]决心做某事;
have (get) the upper hand: [acc]/hæv ɡet ði ˈʌpər hænd/; [v]取得优势,占上风;
at all times: [acc]/ət ɔl taɪmz/; [adv]经常,一直;无论何时;
leave for: [acc]/liv fɔr/; [v]动身去;
in no time: [acc]/ɪn noʊ taɪm/; [adv]立刻;
take sth. into account: [acc]/teɪk ˈsʌmθɪŋ ˈɪntu əˈkaʊnt/; [v]考虑到某事;
all told: [acc]/ɔːl toʊld/; [adv]总共;
take sth. in: [acc]/teɪk ˈsʌmθɪŋ ɪn/; [v]承接;领会;改小尺寸;
cast off: [acc]/kæst ɑf/; [v]解缆放船;抛弃,丢弃;
take sth. down: [acc]/teɪk ˈsʌmθɪŋ daʊn/; [v]记录下来;拆除;
cut across: [acc]/kʌt əˈkrɔs/; [v]抄近路通过;  quant. 与...相抵触;与...相反;
go on about sth.: [acc]/ɡoʊ ɔːn əˈbaʊt ˈsʌmθɪŋ/; [v]喋喋不休;
as well: [acc]/əz wel/; [adv]同样地;也;
in time: [acc]/ɪn taɪm/; [adv]及时;总有一天;
break away (from): [acc]/breɪk əˈweɪ frʌm/; [v]突然走开;放弃;革除;
let oneself go: [acc]/let wʌnˈself ɡoʊ/; [v]尽情,情不自禁;
call it a day: [acc]/kɔl ɪt ə deɪ/; [v]收工;
hand sth. down to sb.: [acc]/hænd ˈsʌmθɪŋ daʊn tu ˈsʌmbədi/; [v](作为传统)传下,传给;
break one's heart: [acc]/brek wʌnz hɑrt/; [v]使人心碎;
for good (and all): [acc]/fɔːr ɡʊd ənd ɔːl/; [adv]永久地,一劳永逸地;
be at odds (with sb.)(over sth.): [acc]/biː æt ɑːdz wɪθ ˈsʌmbədi ˈoʊvər ˈsʌmθɪŋ/; [adj]与.有争执;
stand in line: [acc]/stænd ɪn laɪn/; [v]排队;
make light of: [acc]/meɪk laɪt ɑv/; [v]轻视;
fall behind: [acc]/fɔl bɪˈhaɪnd/; [v]落后;
clear away: [acc]/klɪr əˈweɪ/; [v]把.除掉;
let sb. down: [acc]/let ˈsʌmbədi daʊn/; [n]使失望;
at the mercy of: [acc]/ət ðə ˈmɜrsi ɑv/; [prep]在.支配中,任凭.摆布;
keep sb. up: [acc]/kiːp ˈsʌmbədi ʌp/; [v]坚持,继续;
go out: [acc]/ɡoʊ aʊt/; [v]外出,参加社交活动,熄灭,(衣服式样)过时,出去,交往;
be obsessed with: [acc]/bi əbˈsest wɪð/; [v](指恐惧等)缠住;使烦扰;对.着迷;
think nothing of: [acc]/θɪŋk ˈnʌθɪŋ ɑv/; [v]把.看作平常;
clear up: [acc]/klɪr ʌp/; [v]放晴,清除,整理;
come to sb.: [acc]/kʌm tu ˈsʌmbədi/; [v]被想到;
hit on (upon): [acc]/hɪt ɔːn əˈpɔːn/; [v]碰巧打到,偶然发现;
go for sb.: [acc]/ɡoʊ fɔːr ˈsʌmbədi/; [v]去请(人);袭击;
at a loose end: [acc]/ət ə lus end/; [adv]不知做什么好;
stick sth. out: [acc]/stɪk ˈsʌmθɪŋ aʊt/; [v]伸出;
hit it off (with sb./together): [acc]/hɪt ɪt ɑːf wɪθ ˈsʌmbədi təˈɡeðər/; [v]一见如故,合得来;
give oneself (put on) airs: [acc]/ɡɪv wʌnˈself pʊt ɔːn erz/; [v]装腔作势;
make sb. up: [acc]/meɪk ˈsʌmbədi ʌp/; [v]化妆;
at a stroke: [acc]/ət ə stroʊk/; [adv]一下子;
stick around: [acc]/stɪk ə'raʊnd/; [v]逗留;
live it up: [acc]/lɪv ɪt ʌp/; [v]过着逍遥的日子;狂欢一场;
at full tilt: [acc]/ət fʊl tɪlt/; [adv]全速地;全力以赴地;
bring (call) sth. to mind: [acc]/brɪŋ kɔːl ˈsʌmθɪŋ tu maɪnd/; [v]想起某事;
cast sb. (sth.) aside: [acc]/kæst ˈsʌmbədi ˈsʌmθɪŋ əˈsaɪd/; [v]抛弃,废除;
behind the times: [acc]/bɪˈhaɪnd ðə taɪmz/; [adv]过时的;
have the makings of: [acc]/həv ðə ˈmeɪkɪŋz ɑv/; [v]具有成为.所需要的素质;
stand for sth.: [acc]/stænd fɔːr ˈsʌmθɪŋ/; [v]表示;代表;
carry on: [acc]/'kæriː ɔn/; [v]继续开展;坚持;举止失常;
go through (sth.): [acc]/ɡoʊ θruː ˈsʌmθɪŋ/; [v]仔细讨论;搜查;经受;用光(钱);穿过;
come over sb.: [acc]/kʌm ˈoʊvər ˈsʌmbədi/; [v](被感觉等)支配,攥住,拜访;
come up with: [acc]/kʌm ʌp wɪð/; [v]提出;想出;
first and foremost: [acc]/fɜrst ənd ˈfɔrˌmoʊst/; [adv]首先;
in the hands of: [acc]/ɪn ðə hændz ʌv/; [prep]在.掌握中;
bear sth. in mind: [acc]/ber ˈsʌmθɪŋ ɪn maɪnd/; [v]记住某事;
at full blast: [acc]/æt fʊl blæst/; [adv]最大地;
leave off: [acc]/liv ɑf/; [v](使)停止;
catch up with sb.: [acc]/kætʃ ʌp wɪθ ˈsʌmbədi/; [v]赶上;逮捕;
keep on (doing sth.): [acc]/kiːp ɔːn ˈduːɪŋ ˈsʌmθɪŋ/; [v]继续做某事;
be bent on: [acc]/bi bent ɔn/; [v]专心致志于;决心要;
cash in on: [acc]/kæʃ ɪn ɔn/; [v]以.获利,营利;
keep sth. in mind: [acc]/kiːp ˈsʌmθɪŋ ɪn maɪnd/; [v]记住;
take after sb.: [acc]/teɪk ˈæftər ˈsʌmbədi/; [v]像某人;
accountable for: [acc]/əˈkaʊntəb(ə)l fɔr/; [adj]对.应负责任;
get sth. down: [acc]/ɡet ˈsʌmθɪŋ daʊn/; [v]吞下;写下;
be in two minds about sth.: [acc]/biː ɪn tuː maɪndz əˈbaʊt ˈsʌmθɪŋ/; [adj]犹豫不决;
take one's time (over sth.): [acc]/teɪk wʌnz taɪm ˈoʊvər ˈsʌmθɪŋ/; [v]慢慢做;
keep sth. to oneself: [acc]/kiːp ˈsʌmθɪŋ tu wʌnˈself/; [v]不让他人分享,独自享用;
get through (sth.): [acc]/ɡet θruː ˈsʌmθɪŋ/; [v]通过(考试等);
beat sb. (sth.) off: [acc]/biːt ˈsʌmbədi ˈsʌmθɪŋ ɑːf/; [v]击退;
be (go) on board: [acc]/biː ɡoʊ ɔːn bɔːrd/; [adv]在船上,在飞机上;
the gist: [acc]/ðə dʒɪst/; [n]要旨;
take stock of: [acc]/teɪk stɒk ɑv/; [v]估量;观察;
carry through: [acc]/ˈkeri θru/; [v]维持;使渡过难关,坚持下去;
bear sth.(sb.) out: [acc]/ber ˈsʌmθɪŋ ˈsʌmbədi aʊt/; [v]证实;
become of: [acc]/bɪˈkʌm ɑv/; [v](命运等)降临;使遭遇;发生.情况;
feel like: [acc]/fil laɪk/; [v]想要;  quant. 像要.似的;觉得;摸起来像.似的;
get along: [acc]/ɡet əˈlɔŋ/; [v]与.和睦相处;进展;
on end: [acc]/ɔn end/; [adv]直立;
on no account: [acc]/ɔn noʊ əˈkaʊnt/; [adv]决不;
on time: [acc]/ɑːn taɪm/; [adv]准时;
pass the time of day with: [acc]/pæs ðə taɪm ɑv deɪ wɪθ/; [v]交谈;共渡;
pay sb. back: [acc]/peɪ ˈsʌmbədi bæk/; [v]还债;受到惩罚;
pay up: [acc]/peɪ ʌp/; [v]付清,结账;
plead guilty (not guilty): [acc]/pliːd ˈɡɪlti nɑːt ˈɡɪlti/; [v]服罪(不服罪);
set on sb.: [acc]/set ɔːn ˈsʌmbədi/; [v]攻击;
set out: [acc]/set aʊt/; [v]出发;
set sth. back: [acc]/set ˈsʌmθɪŋ bæk/; [v]把(钟,表)向回拨;
single out: [acc]/ˈsɪŋɡ(ə)l aʊt/; [v]挑选,选出;
snap at sth.: [acc]/snæp æt ˈsʌmθɪŋ/; [v]咬住;
assembly line: [acc]/əˈsembli laɪn/; [n]装配线(生产上一环接一环的),流水线;
real estate: [acc]/ˈriːəl əsteɪt/; [n]不动产,房地产;
all the time: [acc]/ɔl ðə taɪm/; [adv]始终;一直;
border on (upon): [acc]/ˈbɔːrdər ɔːn əˈpɔːn/; [v]接近,近似;
give way (to sb.): [acc]/ɡɪv weɪ tu ˈsʌmbədi/; [v]让步,屈服;
nominate sb. for: [acc]/ˈnɑːmɪneɪt ˈsʌmbədi fɔːr/; [v]提名,推荐;
stand in (for sb.): [acc]/stænd ɪn fɔːr ˈsʌmbədi/; [v]代替;
have to do with: [acc]/hæv tə dʊ wɪð/; [v]与.有关;
later on: [acc]/'leɪtər ɔn/; [adv]后来;稍后;
get through: [acc]/ɡet θru/; [v]完成;穿过;(成功)渡过(困难时期);打通(电话);
had better: [acc]/hæd ˈbetər/; [v]最好还是;
boil down to: [acc]/bɔɪl daʊn tu/; [v]归结起来是,问题是;
nothing to do with: [acc]/ˈnʌθɪŋ tu doʊ wɪθ/; [v]与.无关;
pass off: [acc]/pæs ɑf/; [v]冒充,误导使把.当做.;发生;
pull over: [acc]/pʊl ˈoʊvər/; [v]开到路边;
chamber music: [acc]/ˈtʃeɪmbər mjuːzɪk/; [n]室内乐;
superior to: [acc]/sʊˈpɪriər tu/; [adj]高于..,优于..;
air conditioner: [acc]/ˈer kəndɪʃənər/; [n]空调,空调设备;
get rid of: [acc]/ɡet rɪd ɑv/; [v]摆脱;除去;
bald eagle: [acc]/ˌbɔːld ˈiːɡl/; [n]秃头鹰(美国国鸟);
barbed wire: [acc]/ˌbɑːrbd ˈwaɪər/; [n]带倒钩的铁丝(铁丝网);
blast furnace: [acc]/ˈblæst fɜːrnəs/; [n]鼓风炉;
compound eyes: [acc]/ˌkɑːmpaʊnd ˈaɪz/; [n]复眼;
contribute to: [acc]/ˈkɑntrɪˌbjut tu/; [v]导致;是...的原因;有助于,捐赠;
crude oil: [acc]/krud ɔɪl/; [n]原油;
draft animal: [acc]/dræft ˈænɪm(ə)l/; [n]役用动物;
popular tune: [acc]/ˈpɑpjələr tun/; [n]流行歌曲;
spinal cord: [acc]/ˌspaɪnl ˈkɔːrd/; [n]脊髓;
treasure trove: [acc]/ˈtreʒər troʊv/; [n]无主珍宝;宝藏,宝库;
gravitational force: [acc]/ˌɡrævɪˈteɪʃən(ə)l fɔrs/; [n]地心引力;
ice sheet: [acc]/ˈaɪs ʃiːt/; [n]冰层;
life span: [acc]/laif spæn/; [n]寿命;生命的源泉;
make the best of a bad job: [acc]/meɪk ðə best ɑv ə bæd dʒɑb/; [v]尽力把损失减少到最小;
pick sb. up: [acc]/pɪk ˈsʌmbədi ʌp/; [v]结识;中途搭乘;举起;
rule of thumb: [acc]/rul ɑv θʌm/; [n]单凭经验的做法;经验法则;
beat about/around the bush: [acc]/biːt əˈbaʊt əˈraʊnd ðə bʊʃ/; [v]转弯抹角;
per cent: [acc]/pər ˈsent/; [n]百分数;
blind spot: [acc]/ˈblaɪnd spɑːt/; [n]<物>盲点,<无>静区,(驾驶车辆等视力以外的)盲区;
better off: [acc]/ˈbetər ɑf/; [adj]境况(尤指经济境况)较好;
Wall Street: [acc]/ˈwɔːl striːt/; [n]华尔街(美金融业集中之地);
mark down: [acc]/mɑrk daʊn/; [v]降价; [n]降价;
free market: [acc]/ˌfriː ˈmɑːrkɪt/; [n]<经>自由竞争的市场;
roller coaster: [acc]/ˈroʊlər koʊstər/; [n]过山车;
bad breath: [acc]/ˌbæd ˈbreθ/; [n]口臭;
best man: [acc]/ˌbest ˈmæn/; [n]伴郎;
boarding pass: [acc]/ˈbɔːrdɪŋ pæs/; [n]登机牌;
bungee jumping: [acc]/ˈbʌndʒi dʒʌmpɪŋ/; [n]蹦极跳,身上系着橡皮带从高处往下跳的游戏;
cheer on: [acc]/tʃiə ɔn/; [v]鼓励,为某人打气;
fire extinguisher: [acc]/ˈfaɪər ɪkstɪŋɡwɪʃər/; [n]灭火器;熄灭者;
hide and seek: [acc]/haid ænd si:k/; [n]捉迷藏;
kung fu: [acc]/ˌkʌŋ ˈfuː/; [n]中国功夫;
parking lot: [acc]/ˈpɑːrkɪŋ lɑːt/; [n]停车场;
pass out: [acc]/pæs aʊt/; [v]昏倒,死;
praying mantis: [acc]/ˌpreɪɪŋ ˈmæntɪs/; [n]螳螂;
run out: [acc]/rʌn, aʊt/; [v]跑出,离开,完成,被用完,伸向,流逝,逐出,放出去;
slam dunk: [acc]/ˈslæm dʌŋk/; [n]扣篮;
sleeping bag: [acc]/ˈsliːpɪŋ bæɡ/; [n](野外用的)睡袋;
Valentine's Day: [acc]/ˈvælənˌtaɪnzdeɪ/; [n]情人节(二月十四日);
make (sth. )out: [acc]/meɪk ˈsʌmθɪŋ aʊt/; [v]写;辨认出;理解;歪曲;
closed-circuit television: [acc]/ˌkloʊzd ˌsɜːrkɪt ˈtelɪvɪʒn/; [n]闭路电视;
know better (than): [acc]/noʊ ˈbetər ðən/; [v]很明白(而不至于);
sale price: [acc]/seɪl praɪs/; [n]特价,廉价;
amino acid: [acc]/əˌmiːnoʊ ˈæsɪd/; [n]<生>氨基酸;
take issue with: [acc]/teɪk ˈɪʃu wɪθ/;  quant. 与...争论;对...提出异议;
due to: [acc]/duː tu/; [prep]由于,取决于;
strep throat: [acc]/ˌstrep ˈθroʊt/; [n]<医>脓毒性咽喉炎;
fool around: [acc]/ful əˈraʊnd/; [v]闲荡,干蠢事(或无用,琐悄的事);
stumbling block: [acc]/ˈstʌmblɪŋ blɑːk/; [n]障碍物,绊脚石;
bona fides: [acc]/ˌboʊnə ˈfaɪdiːz/; [n]<拉>诚意,善意;
lay sb. off: [acc]/leɪ ˈsʌmbədi ɑf/; [v]解雇;关闭;停止活动; [n](临时)解雇期;
trade off: [acc]/treɪd ɑf/; [v]交替换位,通过交换抛掉,权衡;
status quo: [acc]/ˌsteɪtəs ˈkwoʊ/; [n]<拉>现状;
take issue: [acc]/teɪk ˈɪʃu/; [v]就某事与某人争论;
live show: [acc]/lɪv ʃoʊ/; [n]现场表演;
hold up: [acc]/hoʊld ʌp/; [v]举起;支撑;耽搁;(在逆境中) 保持良好状况;
a great many: [acc]/ə ɡreɪt ˈmeni/; [adj]许多;
information desk: [acc]/ˌɪnfərˈmeɪʃ(ə)n desk/; [n]问讯处;
bank account: [acc]/ˈbæŋk əkaʊnt/; [n]银行账户;
bean curd: [acc]/ˈbiːn kɜːrd/; [n]豆腐;
boat race: [acc]/boʊt reɪs/; [n]划船比赛;
body building: [acc]/ˈbɑːdi ˈbɪldɪŋ/; [n]健美;
bus stop: [acc]/ˈbʌs stɑːp/; [n]公共汽车站;
department store: [acc]/dɪˈpɑːrtmənt stɔːr/; [n]百货商场;
fitting room: [acc]/ˈfɪtɪŋ ruːm/; [n]试衣间;
table manners: [acc]/ˈteɪbl mænərz/; [n]餐桌礼仪;
physical education: [acc]/ˌfɪzɪkl edʒuˈkeɪʃn/; [n]体育课,体育教育;
record holder: [acc]/ˈrekərd hoʊldər/; [n]记录保持者;
shop assistant: [acc]/ˈʃɑːp əsɪstənt/; [n](英)售货员;
skipping rope: [acc]/ˈskɪpɪŋ roʊp/; [n](跳绳用)绳;
table tennis: [acc]/ˈteɪbl tenɪs/; [n]乒乓球;
traffic lights: [acc]/ˈtræfɪk laɪts/; [n]交通指挥灯,红绿灯;
zip code: [acc]/ˈzɪp koʊd/; [n]邮政编码;
hand truck: [acc]/hænd trʌk/; [n]手推运货车;
washing machine: [acc]/ˈwɑːʃɪŋ məʃiːn/; [n]洗衣机;
New York: [acc]/nuː jɔːrk/; [n]纽约;
laugh at: [acc]/læf æt/;  quant. 嘲笑;
human being: [acc]/ˈhjumən ˈbiɪŋ/; [n]人;
fruit juice: [acc]/frut dʒus/; [n]果汁;
moon cake: [acc]/mun keɪk/; [n]月饼;
opera house: [acc]/ˈɑːprə haʊs/; [n]歌剧院,艺术剧院;
service charge: [acc]/ˈsɜːrvɪs tʃɑːrdʒ/; [n]服务费,小费;
short wave: [acc]/ˌʃɔːrt ˈweɪv/; [n]短波;
side road: [acc]/ˈsaɪd roʊd/; [n]岔道;
telephone box: [acc]/ˈtelɪfoʊn bɑːks/; [n]电话亭;
the United Nations(UN): [acc]/ði juˈnaɪtɪd ˈneɪʃnz/; [n]联合国; [(U.N./UN(缩)]
waiting room: [acc]/ˈweɪtɪŋ ruːm/; [n]候车室,候诊室;
can opener: [acc]/ˈkæn oʊpnər/; [n]开罐器;
next to: [acc]/ˈnekst tu/; [prep]相邻,紧挨着;仅次于,在..之后;几乎;与..相比;
as well as: [acc]/æz wel æz/; [conj]也,和;
Middle East: [acc]/ˈmɪd(ə)l ist/; [n]中东;
tax free: [acc]/ˌtæks ˈfriː/; [adj]免税的;
over and over again: [acc]/ˈoʊvər ənd ˈoʊvər əˈɡen/; [adv]反复,多次重复;
set free: [acc]/set friː/; [v]释放;使获得自由;
New Zealand: [acc]/ˌnuːˈziːlənd/; [n]新西兰;
raw material: [acc]/ˌrɑː məˈtɪriəl/; [n]原材料,原料;
chain store: [acc]/ˈtʃeɪn stɔːr/; [n]连锁店;连锁商店;
trolley bus: [acc]/ˈtrɑli bʌs/; [n]无轨电车;
dressing gown: [acc]/ˈdresɪŋ ɡaʊn/; [n]晨衣,便袍;
driving licence: [acc]/ˈdraɪvɪŋ laɪsns/; [n](英)驾驶执照;
sooner or later: [acc]/ˈsʊnər ɔːr ˈleɪtər/; [adv]迟早;早晚有一天;
get round sth.: [acc]/ɡet raʊnd ˈsʌmθɪŋ/; [v]规避(法律),避开;
soya bean: [acc]/ˈsɔɪbiːn/; [n]大豆;
pencil case: [acc]/ˈpensl keɪs/; [n]文具盒;
Hong Kong: [acc]/hɒŋ kɒŋ/; [n]香港;
San Francisco: [acc]/sæn fræn'siskəu/; [n]旧金山(美国城市);
stand by: [acc]/stænd baɪ/; [v]袖手旁观,准备行动;
in advance: [acc]/ɪn ædˈvæns/;  quant. 提前,预先;
focus on: [acc]/ˈfoʊkəs ɑːn/; [n]以..为焦点,集中于; [v]聚焦于;
care about: [acc]/ker əˈbaʊt/; [v]对..感兴趣,关心,顾虑,在乎;
under construction: [acc]/ˈʌndər kənˈstrʌkʃ(ə)n/; [prep]正在施工之中;
jet lag: [acc]/ˈdʒet læɡ/; [n]飞行时差反应,时差感;
the Antarctic: [acc]/ænˈtɑːrktɪk/; [n] [地理]南极地区;
the Arctic: [acc]/ðə ˈɑrktɪk/; [n]北极区;
personal computer: [acc]/ˌpɜːrsənl kəmˈpjuːtər/; [n](PC)个人电脑,; [计]个人计算机;
Taj Mahal: [acc]/'tɑ:dʒ məˈhɑːl/; [n]泰姬陵;
Czech Republic: [acc]/ˌtʃekrɪ'pʌblɪk/; [n]捷克共和国(东欧国家);
Milu deer: [acc]/mɪ'luː dɪr/; [n]麋鹿;
rock 'n' roll: [acc]/ˌrɑːk ən ˈroʊl/; [n](rock-and-roll)摇滚乐;
Prime Minister: [acc]/ˌpraɪm ˈmɪnɪstər/; [n]总理,首相;
the Milky Way: [acc]/ðə ˌmɪlki ˈweɪ/; [n]银河;
Big Bang: [acc]/ˌbɪɡ ˈbæŋ/; [n]宇宙大爆炸,创世大爆炸;
the Vatican City State: [acc]/ðə'vætɪkən ˈsɪti steɪt/; [n]梵蒂冈城国;
Northern Ireland: [acc]/'nɔːrðərn 'aɪrlənd/; [n]北爱尔兰(英);
the Union Jack: [acc]/ðə ˌjuːniən ˈdʒæk/; [n]英国国旗;
water color: [acc]/ˈwɔtər ˈkʌlər/; [n]水彩画;
mind reader: [acc]/ˈmaɪnd riːdər/; [n](自称或被认为)能看透别人心思的人;
on sale: [acc]/ɑːn seɪl/; [adj]待售的,拍卖的;
go on a diet: [acc]/ɡoʊ ɑːn ə ˈdaɪt/; [n]节食;
garbage can: [acc]/ˈɡɑːrbɪdʒ kæn/; [n]垃圾桶,垃圾箱;
the North Pole: [acc]/ðə ˌnɔːrθ ˈpoʊl/; [n]北极;
the Norman Conquest: [acc]/ðə ˈnɔːrmən ˈkɑːŋkwest/; [n]诺曼征服;
the Renaissance: [acc]/ðə'renəsɑːns/; [n]文艺复兴;
fall for: [acc]/fɔːl fɔːr/; [v]信以为真,对..倾倒,受..的骗;
tae kwon do: [acc]/ˌtaɪ ˌkwɑːn ˈdoʊ/; [n] [体]跆拳道;
power boating: [acc]/ˈpaʊər ˈboʊtɪŋ/; [n](运动项目)汽艇,摩托艇;
amusement park: [acc]/əˈmjuːzmənt pɑːrk/; [n]游乐场;
public relations: [acc]/ˌpʌblɪk rɪˈleɪʃnz/; [n]公共关系;
follow in one's footsteps: [acc]/ˈfɑːloʊ ɪn wʌnz ˈfʊtsteps/;  quant. 追踪别人的脚步;效法某人,以某人为榜样;效法某人,以某人为榜样;
genetically modified: [acc]/dʒəˌnetɪkli ˈmɑːdɪfaɪd/; [adj]转基因的;
alarm clock: [acc]/əˈlɑːrm klɑːk/; [n]闹钟;
remote control: [acc]/rɪˌmoʊt kənˈtroʊl/; [n]遥控,遥控装置,遥控操作;
the United Nations: [acc]/ðə juˌnaɪtɪd ˈneɪʃnz/; [n]联合国;
the Mid-Autumn Festival: [acc]/ðə mɪd ˈɔːtəm ˈfestɪvl/; [n]中秋节;
the Lantern Festival: [acc]/ðə ˈlæntə(r)n ˈfestɪv(ə)l/; [n]元宵节;
global warming: [acc]/ˌɡloʊbl ˈwɔːrmɪŋ/; [n]全球变暖;
the Pentagon: [acc]/ðə ˈpentəˌɡɑn/; [n]五角大楼;
tap dancing: [acc]/tæp ˈdænsɪŋ/; [n]踢踏舞;
sort of: [acc]/sɔːrt əv/; [adv]有几分地;
traffic jam: [acc]/ˈtræfɪk dʒæm/; [n]塞车,交通拥塞;
pull out: [acc]/pʊl aʊt/; [v]拔出,离开,度过难关,恢复健康;
get across: [acc]/ɡet ə'krɔːs/; [vi]通过(渡过,被人了解);
carbon monoxide: [acc]/ˌkɑːrbən mənˈɑːksaɪd/; [n] [化]一氧化碳;
mobile phone: [acc]/ˌmoʊbl ˈfoʊn/; [n]手机;
heart attack: [acc]/ˈhɑːrt ətæk/; [n]心脏病发作;
without hesitation: [acc]/wɪðˈaʊt ˌhezɪˈteɪʃ(ə)n/; [adv]毫不犹豫地;
water lily: [acc]/ˈwɔːtər lɪli/; [n] [植]睡莲;
Yulan magnolia: [acc]/'juːlæn mæɡˈnoʊliə/; [n]玉兰;
South Korea: [acc]/ˌsaʊθ kəˈriə/; [n]南朝鲜,韩国;
the Olympic Games: [acc]/ði əˌlɪmpɪk ˈɡeɪmz/; [n]奥林匹克运动会;
track event: [acc]/ˈtræk ɪvent/; [n]径赛项目;
field event: [acc]/ˈfiːld ɪvent/; [n] [体]田赛;
correspondence course: [acc]/kɔːrəˈspɑːndəns kɔːrs/; [n]函授课程;
car park: [acc]/ˈkɑːr pɑːrk/; [n]停车场;
convenience store: [acc]/kənˈviːniəns stɔːr/; [n](全天或长时间营业的)便利商店;
water vapour: [acc]/ˈwɔtər 'veɪpər/; [n]水蒸汽;
practical joke: [acc]/ˌpræktɪkl ˈdʒoʊk/; [n]恶作剧;
ozone layer: [acc]/ˈoʊzoʊn ler/; [n]臭氧层;
peace and quiet: [acc]/pis ənd ˈkwaɪət/; [n]宁静;
travel agent: [acc]/ˈtrævl eɪdʒənt/; [n]旅行代理人;
the Netherlands: [acc]/ði ˈnɛðələndz/; [n]荷兰;
base on: [acc]/beɪs ɔn/; [v]基于,以..为依据;
the Stone Age: [acc]/ðə ˈstoʊn eɪdʒ/; [n]石器时代;
MSG(mono-sodium glutamate): [acc]/ˌem es ˈdʒiː (ˌmɑːnəˌsoʊdiəm ˈɡluːtəmeɪt)/; [n]味精;
nursery rhyme: [acc]/ˈnɜːrsəri raɪm/; [n]童谣;
chewing gum: [acc]/ˈtʃuːɪŋ ɡʌm/; [n]口香糖;
turn around: [acc]/tɜːrn əˈraʊnd/;  quant. 掉头,转向;(生意或经济) 好转;
baleen whale: [acc]/bəˈlin hwel/; [n]须鲸;
sea anemone: [acc]/ˈsiː əneməni/; [n]海葵;
fit in: [acc]/fit in/;  quant. 适合;适应,融入(群体);
cable car: [acc]/ˈkeɪbl kɑːr/; [n](登山)缆车;
mark out: [acc]/mɑːk aʊt/; [v]划界;
make out: [acc]/meɪk aʊt/;  quant. 理解;辨认出;
DJ(=disk jockey): [acc]/ˈdiː dʒeɪ/; [n](电台)音乐唱片节目主持人,(俱乐部)舞曲唱片播放员;
in turn: [acc]/ ɪn tɝn /;  quant. 依次;反过来;转而;
the Statue of Liberty: [acc]/ðə ˌstætʃuː əv ˈlɪbərti/; [n]自由女神像;
cater (to): [acc]/ˈkeɪtər tu/; [vi]满足,迎合;
strategy meeting: [acc]/ˈstrætədʒi ˈmiːtɪŋ/; [n]战略会议;
crisis meeting: [acc]/ˈkraɪsɪs ˈmiːtɪŋ/; [n]危机会议;
vice versa: [acc]/ˌvaɪs ˈvɜːrsə/; [adv]反过来也是一样地;
PR coordinator: [acc]/ˌpiː ˈɑːr koʊˈɔːrdɪneɪtər/; [n]公关协调员(public relations coordinator);
quality control: [acc]/ˈkwɑːləti kəntroʊl/; [n]质量管理,质量控制;
the Press: [acc]/ðə pres/; [n]新闻界,报刊(总称);
specialise in: [acc]/ˈspeʃəlaɪz ɪn/; [v]专门从事,专门研究;
cold calling: [acc]/kold ˈkɔlɪŋ/; [n]不请自来的推销电话;
put (sb.) through: [acc]/pʊt θrʊ/; [vt]接通(电话),顺利完成;
economic growth: [acc]/ˌiːkəˈnɑːmɪk ɡroʊθ/; [n]经济成长,经济增长;
be aimed at: [acc]/bi eɪmd ət/; [prep]目的在于,致力于;
insider dealing: [acc]/ɪnˈsaɪdər ˈdiːlɪŋ/; [n](股市的)内部交易;
job market: [acc]/dʒɑb ˈmɑrkɪt/; [n]工作市场,就业市场;
low income: [acc]/lo ˈɪnˌkʌm/; [n]低收入;
ad valorem: [acc]/ˌæd vəˈlɔːrem/; [adj]按价的,从价的;
jaws of death: [acc]/dʒɔːz əv deθ/; [n]死地(鬼门关,险境);
nautical mile: [acc]/ˌnɔːtɪkl ˈmaɪl/; [n]海里;
fill out: [acc]/fɪl aʊt/; [v]填写;长胖;充实;
speak well of: [acc]/spik wɛl ʌv/; [v]称赞;
move away: [acc]/muv əˈwe/; [v]搬走;搬开;
tuck in: [acc]/tʌk ɪn/; [vt]塞入;大吃一顿;
index finger: [acc]/ˈɪndeks fɪŋɡər/;  食指;
lung cancer: [acc]/lʌŋ ˈkænsɚ/; [n]肺癌;
be safe from: [acc]/bi sef frʌm/; [prep]免受;
without reservation: [acc]/wɪðˈaʊt ˌrɛzɚˈveʃən/; [adj]无保留地,无条件地;坦白地);
be adapted to: [acc]/bi əˈdæptid tu/; [v]适合于;适应于;
lend an ear: [acc]/lɛnd ən ɪr/; [vi]听(倾听);
lose control of: [acc]/luz kənˈtrol ʌv/; [v]失控;
be susceptible to: [acc]/bi səˈsɛptəbəl tu/; [vt]易感染(对...敏感);
stay in touch with: [acc]/steɪ ɪn tʌtʃ wɪð/; [v]与 ... 保持联系;
