against the grain: 与..相违背  
Lake Baikal: 贝加尔湖
Soviet Union: 苏联(苏维尔联盟)
yield or death: 投降或者死亡  
my calling: 我的使命
split up: 分开走
hold tight: 抓紧
every walk of life: 各行各业  
first rank: 一流的  
get..in tune: 与..相呼应  
mirror into: 反映到..    
black out: 昏过去
live in the now: 活在当下
be under arrest: 被捕
promised land: 应许之地,乐土
slot machine: 老虎机
a life for a life: 一命换一命
piss pot: 尿壶
seat belt: 安全带
pain killers: 止痛药
sleeping pills: 安眠药
free food: 免费的食物  
new you: 一个崭新的你
chase me: 来抓我啊
shut the fuckup: 闭嘴  
dead soul: 灵魂已死  
stay close: 紧跟着我 
the cross: 十字架  
inner circle: 核心集团  
stay back: 退后
purge the evil: 净化邪恶
purge the sins: 净化罪过
sign and date: 签字并注明日期
keep showing up: 阴魂不算 
sb. has seen/known too much: 某人知道的太多了
move on: 释然  
ice cold: 冰凉的(酒)
make the first move: 走出第一步  
break a leg: 演出成功
to celebrate the upcoming Year of the Pig: 庆祝即将来临的猪年
render sth. realizable: 是..变为现实  
incessant rain confined them indoors: 不停的雨把他们限制在室内
hero or villain: 英雄还是恶棍
my bad: 我的锅

sick ward: 病房
bird poop: 鸟屎
mess with sb's head: 迷惑某人
have a sad face: (看起来)不高兴
find a way in: 找个方法进去(封闭的场所)
make you pretty: 把你打扮的漂漂亮亮
the moral of the story: 这个故事的寓意
surrender myself to you: 把自己奉献(投降)给你
warm up: 热身
slow sb down: 拖某人后腿
many a time: 很多次
not even close: 差得远
for good: 永远
read people: 看人
finders keepers: 谁找到是谁的
no more plans: 没有别的计划了
get sb some water: 给某人倒点水
hold position: 保持(你的)姿势
the top of the food chain: 食物链顶端
stick together: 待在一起
make sb do sth: 逼迫某人做某事
have 50/50 shot: 有五成机会
deal with one problem at a time: 一次解决一个问题
sb is a quick learner: 某人学的快
detail instructions: 详细指导  
pick up the pace: 跟上步伐,快点
pick up the bill(check): 付账,买单
pick up the candidates: 挑选候选人
pick up the goods: 提货
pick up the girl: 结识这个女孩
pick up the habit: 养成习惯
pick up the phone: 接起电话
have no choice but to do sth:除了做..别无选择
cold-blooded murder: 冷血杀手
make the same mistake: 犯同样的错
deserve better: 值得(得到)更好的
force of habit: 习惯的力量
be meant to be: 注定是
hang on: 稍等一下(不要挂电话);坚持住;  
previously on + ..(剧名): ..的前情回顾
heart beat: 心跳(声)
birth/biological father: 生父
foster father: 养父
Lady Justice: 正义女神
Your Majesty: 陛下
a lightning rod: 一根避雷针
pay the price: 付出代价
wake up: 醒来
glow stick: 荧光棒
go through: 通过(考试),挺过(艰难的时期)
slow suicide: 慢性自杀
stir things up: 挑拨是非
mid-life crisis: 中年危机
drop sb off: 让某人下车
flip a coin: 抛硬币(决定某事)
crossword puzzle: 纵横字谜游戏
side effect: 副作用
Walt junior: 小Walt(大Walt的儿子)
hair loss: 脱发
shopping list: 购物清单
take it out on sb: 把气出在..身上
big time: 历史性时刻
one true love: 唯一的爱
money laundering: 洗钱
put sb in jail: 把某人送进监狱
put sth away: 把..收起来
tough guy: 硬汉
walk away: 走开
boarding school: 寄宿学校 
formal invitation: 正式邀请
take a day off: 请一天假
drive sb crazy: 把某人逼疯
set sb up: 设计陷害某人
vice present: 副总统
work ethic: 职业道德
give a hand to sb: 帮助某人
check my balance: 检查我的收支(账户)
three out of five: 五局三胜
here and there: 乱逛
the best view in town: 小镇最好的风景
time after time: 一次又一次
take a breath: 深呼吸
take sb's life: 取某人的性命
serial number: (抢上的)序列号 
start over: 重新开始
Great Lakes: 北美五大湖, Superior,Michigan,Huron,Erie,Ontario.
little by little: 渐渐地
backup plan: 后备计划 
hard way or easy way: 来硬的还是软的
lucky cat: 招财猫
bucket list: 遗愿清单 
be messy and clumsy: 笨手笨脚
psychic: 灵媒;灵魂的
an eye for an eye: 以牙还牙
safe travels: 一路顺风
nail salon: 修甲沙龙
undercover cop: 卧底警察
collar them: 给它们带上项圈 
holy spirit: 圣灵
open season: 非禁渔期;狩猎季节
weiner dog: 腊肠犬
to-do list: 待办列表
final decision: 最后通牒
big dumb limb: 四肢发达的笨蛋
drag  yourself out of the shit: 把自己从这糟糕的状况中拉出来
real word: 现实世界
be abducted by aliens: 被外星人绑架
storeroom: 存储室
minder reader: 读心者
hobo look: 流浪汉的样子
arranged marriage: 包办婚姻
cheerleader: 啦啦队长
a second chance: 第二次机会
Rotten Romans: 腐朽的古罗马
Smashing Saxons: 牛气的撒克逊人
Terrible Tudors: 恐怖的都邑王朝
a member of crew: 一名工作人员
Vicious Viking: 凶残的维京人
Groovy Greeks: 绝妙的希腊人
gun control: 枪支管控
Magma Carta: 自由大宪章
Genghis Khan: 成吉思汗
civil war: 内战
group therapy: 群体治疗
stupid stuff: 蠢事
bro code: 兄弟法则
check it out: 看一下这个
nice/good man: 好人
character flaw: 性格缺陷
play dead: 装死
body fluids: 体液
a big fat loser: 怂胖子
chicken wings: 鸡翅
gray area: 灰色地带
from time to time: 不时地
hurtful comment: 刻薄的话
prawn crackers: 虾条
lost your faith: 你去了你的信仰
make you fell small: 打压他人
give me a hand: 来搭把手
push sb away: 疏远某人
make myself useful: 让自己变得有用.
be quiet as a mouse: 像老鼠一样安静
on a different frequency: 跟正常人不在同一个频率上
instinct and training: 直觉和训练
mind control: 精神控制
long day: 漫长的一天
panic attack: 惊慌发作
one-night stand: 一夜情
be no ease job: 不是简单的事
the past: 过去
the present: 现在
the future: 未来
road map: 路线图
freelance junk collector: 自由废品收购人
on your territory: 在你的地盘上
without clearance: 未经许可
charge sb with murder: 控告某人谋杀
make coffe: 煮咖啡
a road trip: 一趟公路旅行
take sb's instructions: 听从某人的指示
a cat person: 一个喜欢猫的人
right time: 合适的时间
single losers: 单身狗们 
uninvited guest: 不速之客 
black out: 昏过去
live in the now: 活在当下
be under arrest: 被捕
promised land: 应许之地,乐土
Lake Baikal: 贝加尔湖
slot machine: 老虎机
Soviet Union: 苏联(苏维尔联盟)
start over: 重新开始;从头再来  
wake up: 自己醒来或被别人唤醒(醒一醒);激起;  
last word: 遗言
young offenders: 少年犯
log in: 登陆
community service: 社区服务
make fan of people: 取笑别人
log off/out: 退出;注销;离开;
serial killer: 连环杀手  
walk sb home: 陪某人走回家
be sb'ears and eyes: 做某人的耳目  
weak point: 弱点
fake sb: 冒充某人
raw/cooked potatoes: 生土豆;熟土豆;
don't want sb seeing me like this: 不想让某人看到我这个样子
get out of my way: 给我让开
dark thought: 黑暗思想  
a pair of merry little twins: 一对快乐的双胞胎(兄弟俩)
a haunted house: 鬼屋
sb/sth be haunted: 某人被鬼追,某物闹鬼
maintain the peace: 维持秩序  

multiply times: [x]乘;
divided evenly: [x]被整除;
radical sign, root sign: [x]根号;
round to: [x]四舍五入;
to the nearest: [x]四舍五入;
proper subset: [x]真子集;
solution set: [x]解集;
algebraic term: [x]代数项;
like terms, similar terms: [x]同类项;
numerical coefficient: [x]数字系数;
literal coefficient: [x]字母系数;
triangle inequality: [x]三角不等式;
original equation: [x]原方程;
equivalent equation 同解方程: [x]等价方程;
linear equation: [x]线性方程e.g.5x+6=22;
proper fraction: [x]真分数;
improper fraction: [x]假分数;
mixed number: [x]带分数;
vulgar fraction,common fraction: [x]普通分数;
simple fraction: [x]简分数;
complex fraction: [x]繁分数;
leastcommon denominator: [x]最小公分母;
decimal fraction: [x]纯小数;
infinite decimal: [x]无穷小数;
recurring decimal: [x]循环小数;
tenths unit: [x]十分位;
arithmetic mean: [x]算术平均值;
weighted average: [x]加权平均值;
geometric mean: [x]几何平均数;
square root: [x]平方根;
cube root: [x]立方根;
common logarithm: [x]常用对数;
inverse function: [x]反函数;
complementary function: [x]余函数;
absolute value: [x]绝对值;
round off: [x]四舍五入;
natural number: [x]自然数;
positive number: [x]正数;
negative number: [x]负数;
odd integer: [x]奇整数,;
odd number: [x]奇数;
even integer, even number: [x]偶数;
integer, whole number: [x]整数;
positive whole number: [x]正整数;
negative whole number: [x]负整数;
consecutive number: [x]连续整数;
real number, rational number: [x]实数,有理数;
composite number 合数: [x]e.g.4,6,8,9,10,12,14,15..;
common divisor: [x]公约数;
leastcommon multiple: [x]最小公倍数;
common factor: [x]公因子;
prime number  质数: [x]e.g.2,3,5,7,11,13,15..;
ordinary scale, decimal scale: [x]十进制;
common ratio: [x]公比;
arithmetic progressionsequence: [x]等差数列;
geometric progressionsequence: [x]等比数列;
direct proportion: [x]正比;
trigonometric function: [x]三角函数;
alternate angle: [x]内错角;
corresponding angle: [x]同位角;
vertical angle: [x]对顶角;
central angle: [x]圆心角;
interior angle: [x]内角;
exterior angle: [x]外角;
supplementary angles: [x]补角;
complementary angle: [x]余角;
adjacent angle: [x]邻角;
acute angle: [x]锐角;
obtuse angle: [x]钝角;
right angle: [x]直角;
round angle: [x]周角;
straight angle: [x]平角;
included angle: [x]夹角;
equilateral triangle: [x]等边三角形;
scalene triangle: [x]不等边三角形;
isosceles triangle: [x]等腰三角形;
right triangle: [x]直角三角形;
inscribed triangle: [x]内接三角形;
concentric circles: [x]同心圆;
regular polygon: [x]正多边形;
line, straight line: [x]直线;
line segment: [x]线段;
parallel lines: [x]平行线;
segment of a circle: [x]弧形;
rectangular solid: [x]长方体;
regular solid/regular polyhedron: [x]正多面体;
circular cylinder: [x]圆柱体;
circumference, perimeter: [x]周长;
surface area: [x]表面积;
cross section: [x]横截面;
center of acircle: [x]圆心;
angle bisector: [x]角平分线;
face of a solid: [x]立体的面;
included side: [x]夹边;
median of a triangle: [x]三角形的中线;
coordinate system: [x]坐标系;
rectangular coordinate: [x]直角坐标系;
Number line: [x]数轴;
complex plane: [x]复平面;
plane geometry: [x]平面几何;
Pythagorean theorem: [x]勾股定理;
square measure: [x]平方单位制;
cubic meter: [x]立方米;
breeding ground: 温床
be cross: 生气,发怒; [or]self;
