##2020-4-3#23-54
flotsam: [c]/ˈflɒtsəm/t与s不连读?  
hell-hole: [a]/ˈhɛlˌhəʊl/; [n]藏污纳垢之地;地狱;[or]bt;  

记单词: 解释性语言用于理解,翻译性语言用于记忆;

have no proff: 没有证据 
first love: 初恋  
bring sb back: 医生把病人救回来  
race me: 看谁跑得快  
cannot be denied: 不可否认  
be never simple: 从来不简单  
numb the senses: 麻木感觉  
try to make the best: [vi]尽力而为;
du: [a]/,di:'ju:/; [n]二重唱;双人组合; [or]bt;  
环形物语 
##2020-4-7#23-56
Suez: [a]/sʊ'ɛz/; [n]苏伊士(埃及东北部港市);苏伊士运河(Suez Canal); [or]bt;
eye-watering: [a]/ˈaɪ wɔːtərɪŋ/; [adj]令人心痛的; 惨不忍睹的; [or]bt;
a motion of no confidence: 不信任投票  
sooner the better: [spk]越快越好;  
on the tip of one's tongue: 比喻话在嘴边,差一点儿就说出口,或者快说出口却一时想不起来;  
sb be getting on with it: 某人正在尽量适应某事  
go mad: [vi]出格
an unqualified triumph: 一场绝对的胜利
a cruel truth: 一个残酷的现实
ruin sth: [vt]毁掉..; [ex]~ our friendship,毁掉我们之间的友谊;  
with all my heart: 全心全意  
a tidy scratch: 轻微擦伤  
community payback: 社区回报,用社区服务偿还所犯的错;  
angel's share: 酿酒时的蒸发损害(约2%的量),天使份额,天使税;  
lobster's bluff: 龙虾的嚣张声势  

tv: 轻轻摇晃: lilting  
cn: 铎: 都铎/duó/王朝;
