Arabian: [a]/əˈreɪbiən/; [adj]阿拉伯的;阿拉伯人的; [n]阿拉伯人; [or]4j;
Atlantic: [a]/æt'læntɪk/; [n]大西洋; [adj]大西洋的; [or]4j;
Britain: [a]/ˈbrɪtn/; [n]大不列颠,英国(包括英格兰,威尔士和苏格兰); [or]4j;
British: [a]/ˈbrɪtɪʃ/; [adj]不列颠的,英联邦的; [n]英国人;英式英语; [or]4j;
Canadian: [a]/kəˈneɪdiən/; [adj]加拿大的; [n]加拿大人; [or]4j;
China: [a]/ˈtʃaɪnə/; [n]中国;瓷器(china); [or]4j;
Chinese: [a]/ˌtʃaɪˈniːz/; [adj]中国的; [n]中国人;中文; [or]4j;
Christ: [a]/kraɪst/; [n]基督,救世主; [int]天啊!; [or]4j;
Christian: [a]/ˈkrɪstʃən/; [n]基督教徒; [adj]基督教的,基督教徒的; [or]4j;
English: [a]/ˈɪŋɡlɪʃ/; [n]英语,英国人; [adj]英国的,英国人的,英语的; [or]4j;
Fahrenheit: [a]/ˈfærənhaɪt/; [n]华氏度; [adj]华氏度的,华氏温度计的; [or]4j;
German: [a]/ˈdʒɜːrmən/; [adj]德国的; [n]德语,德国人; [or]4j;
Greek: [a]/ɡriːk/; [n]希腊人,希腊语; [adj]希腊的,希腊人的,希腊语的; [or]4j;
Italian: [a]/ɪˈtæliən/; [adj]意大利的,意大利人的,意大利语的; [n]意大利人,意大利语; [or]4j;
Japanese: [a]/ˌdʒæpəˈniːz/; [adj]日本的,日本人的,日语的; [n]日本人,日语; [or]4j;
Latin: [a]/ˈlætn/; [adj]拉丁的; [n]拉丁语; [or]4j;
Marxist: [a]/ˈmɑːrksɪst/; [adj]马克思主义的; [n]马克思主义者; [or]4j;
Negro: [a]/ˈniːɡroʊ/; [n]黑人(过时且通常有冒犯之意); [or]4j;
Roman: [a]/ˈroʊmən/; [adj]罗马的,罗马文字的,罗马人的; [n]罗马天主教的; [or]4j;
Swiss: [a]/swɪs/; [adj]瑞士的; [n]瑞士人; [or]4j;
Tuesday: [a]/ˈtuːzdeɪ/; [n]星期二; [or]4j;
Wednesday: [a]/ˈwenzdeɪ/; [n]星期三; [or]4j;
X-ray: [a]/ˈeks reɪ/; [n]X射线;X光照片; [v]用X射线检查; [or]4j;
abandon: [a]/əˈbændən/; [v]抛弃;放弃;放纵; [or]4j;
abandoned: [a]/əˈbændənd/; [adj]被抛弃了的,被遗弃了的,被放弃了的;放荡的,堕落的; [or]4j;
ability: [a]/əˈbɪləti/; [n]能力,技能,本领; [or]4j;
able: [a]/ˈeɪbl/; [adj]能够..的;有能力的; [or]4j;
aboard: [a]/əˈbɔːrd/; [adv]在船(或火车,公共汽车,飞机等运输工具)上,上船; prep. 在(船,火车,汽车,飞机等)上,上(船,火车,汽车,飞机等); [or]4j;
abroad: [a]/əˈbrɔːd/; [adv]到国外,在国外;在户外; [or]4j;
absence: [a]/ˈæbsəns/; [n]缺席;缺勤;缺乏;缺席,心不在焉; [or]4j;
absent: [a]/ˈæbsənt/; [adj]缺席的,不在的;心不在焉的,出神的; [v]缺席;使缺席; prep. 缺乏; [or]4j;
absolute: [a]/ˈæbsəluːt/; [adj]完全的;绝对的;纯粹的; [or]4j;
absolutely: [a]/ˈæbsəluːtli/; [adv]完全地;绝对地; [or]4j;
absorb: [a]/əbˈzɔːrb/; [vt]吸收;汲取;吸引..的注意;理解,掌握;承受; [or]4j;
absorbed: [a]/əbˈzɔːrbd/; [adj]全神贯注的,专心致志的; [or]4j;
abstract: [a]/ˈæbstrækt/; [adj]抽象的; [n]摘要,抽象; [v]提取; [or]4j;
abundance: [a]/əˈbʌndəns/; [n]丰富;大量; [or]4j;
abundant: [a]/əˈbʌndənt/; [adj]丰富的;大量的; [or]4j;
abuse: [a]/əˈbjuːs/; [v]虐待;辱骂;(对麻醉毒品,兴奋剂等的)非法服用;滥用; [n]滥用;虐待;辱骂; [or]4j;
academic: [a]/ˌækəˈdemɪk/; [adj]学术的;学院的,大学的;理论的; [n]学者; [or]4j;
academy: [a]/əˈkædəmi/; [n]学院; [or]4j;
accelerate: [a]/əkˈseləreɪt/; [v]加速,增长;使增速,促进; [or]4j;
accent: [a]/ˈæksent/; [n]口音,腔调;重音;重音符号; [v]重读; [or]4j;
accept: [a]/əkˈsept/; [v]接受;接受(所提供或给予的物品); [or]4j;
access: [a]/ˈækses/; [n]进入;使用权;通道; [v]进入;访问; [or]4j;
accident: [a]/ˈæksɪdənt/; [n]事故;意外;偶然; [or]4j;
accidental: [a]/ˌæksɪˈdentl/; [adj]偶然的,意外的;非本质的; [or]4j;
accommodate: [a]/əˈkɑːmədeɪt/; [v]向.提供住处(或膳宿);给.提供方便;容纳;使适应,顺应; [or]4j;
accommodation: [a]/əˌkɑːməˈdeɪʃn/; [n]住宿,食宿;调解;住处; [or]4j;
accompany: [a]/əˈkʌmpəni/; [v]陪伴;为..伴奏(或伴唱); [or]4j;
accomplish: [a]/əˈkɑːmplɪʃ/; [v]完成,做到;实现; [or]4j;
accord: [a]/əˈkɔːrd/; [n]协议; [v]授予; [or]4j;
accordance: [a]/əˈkɔːrdns/; [n]符合;一致;授予; [or]4j;
according to: [a]/əˈkɔːrdɪŋ tu/; [phr]根据,据..所说; [or]4j;
account: [a]/əˈkaʊnt/; [n]账户;原因,理由;叙述; [v]报账,做出说明(或解释),为.负责,受罚;认为,考虑; [or]4j;
accountant: [a]/əˈkaʊntənt/; [n]会计人员,会计师; [or]4j;
accumulate: [a]/əˈkjuːmjəleɪt/; [vi]聚积,堆积; [vt]积攒,积累; [or]4j;
accuracy: [a]/ˈækjərəsi/; [n]准确(性);准确度; [or]4j;
accurate: [a]/ˈækjərət/; [adj]精确的;正确的;符合标准的; [or]4j;
accuse: [a]/əˈkjuːz/; [v]指责;控告;把..归咎于; [or]4j;
accustomed: [a]/əˈkʌstəmd/; [adj]通常的,惯常的;独特的;习惯的,适应了的(to); [or]4j;
ache: [a]/eɪk/; [n]疼痛; [v]觉得疼痛;渴望; [or]4j;
achieve: [a]/əˈtʃiːv/; [v]完成,达到,获得,实现; [or]4j;
achievement: [a]/əˈtʃiːvmənt/; [n]成绩,成就;实现,完成; [or]4j;
acid: [a]/ˈæsɪd/; [n]<化学>酸;酸性物质;尖酸; [adj]尖刻的;敏锐的;含酸过多的;酸的;酸味的; [or]4j;
acknowledge: [a]/əkˈnɑːlɪdʒ/; [v]告知收到;对(人)打招呼,招呼(某人)以示相识,致意;就..表示谢忱,鸣谢,感谢,感激,答谢,对..表示感谢;承认(属实),承认(权威,地位); [or]4j;
acquaintance: [a]/əˈkweɪntəns/; [n]认识;对..有了解,熟知;熟人,相识的人; [or]4j;
acquire: [a]/əˈkwaɪər/; [v](尤指靠自己的努力或行动或经过一个过程)获得;学到;取得; [or]4j;
acquisition: [a]/ˌækwɪˈzɪʃn/; [n]并购;获得;掌握;获得物;取得物; [or]4j;
acre: [a]/ˈeɪkər/; [n]英亩(≈4047平方米); [or]4j;
action: [a]/ˈækʃn/; [n]行动,行为,动作,运转; [v]对...进行处理; [or]4j;
active: [a]/ˈæktɪv/; [adj]积极的,主动的;活跃的,好动的;起作用的,有效的;现役的; [n]积极分子;主动语态; [or]4j;
activity: [a]/ækˈtɪvəti/; [n]活动;行动;活跃; [or]4j;
actor: [a]/ˈæktər/; [n]演员,男演员; [or]4j;
actress: [a]/ˈæktrəs/; [n]女演员; [or]4j;
actual: [a]/ˈæktʃuəl/; [adj]实际的,真实的; [or]4j;
acute: [a]/əˈkjut/; [adj](疼痛,妒忌等)剧烈的,严重的;敏锐的;急性的;尖声的; [or]4j;
ad: [a]/æd/; [n]广告; [or]4j;
adapt: [a]/əˈdæpt/; [vi]适应不同情况; [vt]使适合;改编; [or]4j;
addition: [a]/əˈdɪʃn/; [n]加法;添加;附加物; [or]4j;
additional: [a]/əˈdɪʃənl/; [adj]增加的;附加的; [or]4j;
address: [a]/əˈdres/; [n]地址;致词; [v]致函;写姓名地址;向..讲话;处理; [or]4j;
adequate: [a]/ˈædɪkwət/; [adj]充足的,充分的,足够的;尚可的,过得去的; [or]4j;
adjective: [a]/ˈædʒɪktɪv/; [n]<语法学>形容词;形容词短语; [adj]形容词的;不独立的; [or]4j;
adjust: [a]/əˈdʒʌst/; [v]调整,调节;校正;改变.以适应; [or]4j;
administration: [a]/ədˌmɪnɪˈstreɪʃn/; [n]管理;管理层,管理部门;政府;(药的)配给; [or]4j;
admire: [a]/ədˈmaɪər/; [v]钦佩,崇拜;喜欢,羡慕; [or]4j;
admission: [a]/ədˈmɪʃn/; [n]准许进入;进入权;入场费; [or]4j;
admit: [a]/ədˈmɪt/; [v]承认;准许.进入,允许.加入;容许,可容纳; [or]4j;
adopt: [a]/əˈdɑːpt/; [v]收养;采纳,采用; [or]4j;
adult: [a]/əˈdʌlt/; [n]成年人; [adj]成年的;成年人的;色情的,暴力的; [or]4j;
advance: [a]/ədˈvæns/; [n]预先,超前;前进;增长;进展; [v]提升;提前;提议;前进; [adj]预先的;先遣队;事先的;先头部队;预先; [or]4j;
advanced: [a]/ədˈvænst/; [adj]先进的;高级的; [or]4j;
advantage: [a]/ədˈvæntɪdʒ/; [v]使处于有利地位;有利于;有助于; [n]优势,利益,有利条件; [or]4j;
adventure: [a]/ədˈventʃər/; [n]冒险,冒险活动;冒险精神; [or]4j;
adverb: [a]/ˈædvɜːrb/; [n]副词(缩写形式为adv.); [or]4j;
advertise: [a]/ˈædvərtaɪz/; [v]为..做广告;公告;公布; [or]4j;
advertisement: [a]/ˌædvərˈtaɪzmənt/; [n]广告;公告;登广告;宣传; [or]4j;
advice: [a]/ədˈvaɪs/; [n](医生等的)意见,建议;劝告;忠告; [or]4j;
advisable: [a]/ədˈvaɪzəbl/; [adj]明智的;可取的; [or]4j;
advise: [a]/ədˈvaɪz/; [v]劝告,忠告;建议;通知; [or]4j;
advocate: [a]/ˈædvəkeɪt/; [v]提倡;主张;为.辩护; [n]辩护者;提倡者;律师; [or]4j;
aerial: [a]/ˈeriəl/; [adj]飞机的,航空的,由飞机进行的;空中的,架空的; [n]天线; [or]4j;
aeroplane: [a]/ˈerəpleɪn/; [n]飞机; [or]4j;
affair: [a]/əˈfer/; [n]事情,事务,恋爱事件;私通,风流韵事;事件;政治事务,公共事务; [or]4j;
affect: [a]/əˈfekt/; [v]影响,感动,作用; [n]感情,情感,心情;<精神病学>(表露或觉察到的)情绪反应; [or]4j;
affection: [a]/əˈfekʃn/; [n]关爱,爱慕;感情;作用,影响;疾病; [or]4j;
afford: [a]/əˈfɔːrd/; [v]买得起;抽得出时间;担负得起;提供;产生;赐予; [vi]担负得起;买得起; [or]4j;
afternoon: [a]/ˌæftərˈnuːn/; [n]午后,下午; [or]4j;
afterward(s): [a]/ˈæftərwərd(z)/; [adv]后来; [or]4j;
afterward: [a]/'ɑːftəwəd/; [adv]之后,后来,以后; [or]4j;
age: [a]/eɪdʒ/; [n]年龄,时代,时期; [v](使)变老,(使)陈化; [or]4j;
agency: [a]/ˈeɪdʒənsi/; [n]代理(处);政府机构;代理;介入;作用; [or]4j;
agenda: [a]/əˈdʒendə/; [n]议事日程; [or]4j;
agent: [a]/ˈeɪdʒənt/; [n]政府特工;代理商,代理人; [or]4j;
aggressive: [a]/əˈɡresɪv/; [adj]好斗的,挑衅性的;有闯劲的,积极进取的; [or]4j;
ago: [a]/əˈɡoʊ/; [adv]以前; [or]4j;
agree: [a]/əˈɡriː/; [v]同意,赞成,承认,符合; [or]4j;
agreement: [a]/əˈɡriːmənt/; [n]协议,协定;一致,相合; [or]4j;
agriculture: [a]/ˈæɡrɪkʌltʃər/; [n]农业; [or]4j;
ahead: [a]/əˈhed/; [adv]领先;向前,在前面;提前; [adj]在前,向前,提前; [or]4j;
aid: [a]/eɪd/; [n]帮助;救护,援助;帮助者,助手; [v]帮助;援助,帮助,有助于; [or]4j;
aim: [a]/eɪm/; [v]瞄准;以..为目标; [n]目标;对准; [or]4j;
air: [a]/er/; [n]空气;天空,空中;感觉,神态;曲调; [vi]通风; [vt]晾干;公开发表; [or]4j;
aircraft: [a]/ˈerkræft/; [n]飞机,飞行器,航空器; [or]4j;
airline: [a]/ˈerlaɪn/; [n]航空公司,航空系统,(飞机的)航线; [adj]航空公司的;在航线上的; [or]4j;
airplane: [a]/ˈerpleɪn/; [n]飞机; [or]4j;
airport: [a]/ˈerpɔːrt/; [n]机场,航空站; [or]4j;
aisle: [a]/aɪl/; [n](席位间的)通道,过道; [or]4j;
alarm: [a]/əˈlɑːrm/; [n]警报器,警报;闹钟;惊恐,忧虑; [v]使惊恐,使忧虑; [or]4j;
alcohol: [a]/ˈælkəhɔːl/; [n]酒;酒精,乙醇; [or]4j;
alert: [a]/əˈlɜːrt/; [adj]警惕的;充分意识到的; [n]警觉(状态),戒备(状态);警报; [v]向.报警,使警惕;使意识到; [or]4j;
alike: [a]/əˈlaɪk/; [adj]相同的,相似的;相像的; [adv]相像地,相似地;同样都; [or]4j;
alive: [a]/əˈlaɪv/; [adj]活着的;活跃的,有生气的;存在的; [or]4j;
alliance: [a]/əˈlaɪəns/; [n]联盟,同盟;盟约;盟国,同盟者;类同; [or]4j;
allocate: [a]/ˈæləkeɪt/; [v]分配,配给; [or]4j;
allow: [a]/əˈlaʊ/; [v]准许,允许;同意给;承认; [or]4j;
allowance: [a]/əˈlaʊəns/; [v]定量供应(食物,饮料等物品);配给; [n]零用钱;津贴,补贴;限额;免税额;允许,容忍,让步;考虑; [or]4j;
alloy: [a]/ˈælɔɪ/; [n]合金; [v]使成合金; [or]4j;
ally: [a]/ˈælaɪ/; [n]盟友;同盟国;(二战时的) 同盟国; [v]结盟; [or]4j;
alongside: [a]/əˌlɔːŋˈsaɪd/; [adv]在旁边,并排地,并肩地; prep. 在.旁边,和.并排;和.一起; [or]4j;
alphabet: [a]/ˈælfəbet/; [n]字母表;入门;初步; [or]4j;
alter: [a]/ˈɔːltər/; [v]改变;改动,使变样;改做; [or]4j;
alternative: [a]/ɔːlˈtɜːrnətɪv/; [adj]可供选择的;替代的;不寻常的; [n]可供选择的事物; [or]4j;
although: [a]/ɔːlˈðoʊ/; [conj]虽然,尽管; [or]4j;
altitude: [a]/ˈæltɪtuːd/; [n]海拔,高度; [or]4j;
altogether: [a]/ˌɔːltəˈɡeðər/; [adv]总而言之;完全地;合计; [n](口)裸体; [or]4j;
aluminum: [a]/əˈluːmɪnəm/; [n]铝; [or]4j;
amateur: [a]/ˈæmətʃər/; [n]业余爱好者;外行; [adj]外行的;业余爱好的,业余(身份)的; [or]4j;
amaze: [a]/əˈmeɪz/; [v]使惊奇,使惊诧; [or]4j;
ambassador: [a]/æmˈbæsədər/; [n](特命全权)大使;代表; [or]4j;
ambition: [a]/æmˈbɪʃn/; [n]雄心,强烈欲望,抱负;(具体的)追求目标; [vt]追求;有.野心; [or]4j;
ambitious: [a]/æmˈbɪʃəs/; [adj]有抱负的;雄心勃勃的;(计划,想法等)宏大的,艰巨的; [or]4j;
ambulance: [a]/ˈæmbjələns/; [n]救护车; [or]4j;
amid: [a]/əˈmɪd/; prep. 在.中间,被.围绕; [or]4j;
among: [a]/əˈmʌŋ/; prep. 在.中间,在.之中;包括其中; [or]4j;
amongst: [a]/ə'mʌŋst/; prep. 在..之中,为.所围绕(=among); [or]4j;
amount: [a]/əˈmaʊnt/; [n]数量,总额; [v]合计,共计;等同,接近(to); [or]4j;
amuse: [a]/əˈmjuːz/; [v]娱乐,消遣,使发笑; [or]4j;
analysis: [a]/əˈnæləsɪs/; [n]分析;分解;分析报告;精神分析; [or]4j;
analyze: [a]/ˈænəlaɪz/; [v]分析;细察; [or]4j;
ancestor: [a]/ˈænsestər/; [n]祖宗;祖先;原型; [or]4j;
anchor: [a]/ˈæŋkər/; [n]担任(广播电视新闻节目)的主持人;支柱;锚; [v]抛锚; [vt]使固定; [or]4j;
ancient: [a]/ˈeɪnʃənt/; [adj]远古的,古代的,古老的; [n]古代人;古文明国的国民; [or]4j;
anger: [a]/ˈæŋɡər/; [n]怒,愤怒; [v]使发怒,激怒; [or]4j;
angle: [a]/ˈæŋɡl/; [n](数学)角;角度;观点,立场; [v]移动角度; [or]4j;
ankle: [a]/ˈæŋkl/; [n]踝,踝关节; [v]走路; [or]4j;
anniversary: [a]/ˌænɪˈvɜːrsəri/; [n]周年纪念日; [adj]周年的,(有关)周年纪念的; [or]4j;
announce: [a]/əˈnaʊns/; [vt]宣布,宣告;预示;播报; [vi]作播音员,宣布竞选; [or]4j;
annoy: [a]/əˈnɔɪ/; [v]使烦恼,使生气; [n]烦恼(等于annoyance); [or]4j;
annual: [a]/ˈænjuəl/; [adj]一年一次的,年度的; [n]年鉴,一年生植物,一年一度的事件; [or]4j;
ant: [a]/ænt/; [n]蚂蚁; [or]4j;
anticipate: [a]/ænˈtɪsɪpeɪt/; [v]预测;期待;提早(做); [or]4j;
antique: [a]/ænˈtiːk/; [n]古董;古玩;古物; [adj]古代的;古董的; [or]4j;
anxiety: [a]/æŋˈzaɪəti/; [n]焦虑;忧虑;担心; [or]4j;
anxious: [a]/ˈæŋkʃəs/; [adj](about)忧虑的,担心的,焦急的;渴望的; [or]4j;
anybody: [a]/ˈenibɑːdi/; pro[n]无论什么人;任何人;随便哪个人; [or]4j;
anyhow: [a]/ˈenihaʊ/; [adv]不论用何种方法,无论如何;随意地;尽管如此; [or]4j;
anyone: [a]/ˈeniwʌn/; pro[n]任何人,无论什么人; [or]4j;
anyway: [a]/ˈeniweɪ/; [adv]不管怎么说,无论如何,至少; [or]4j;
anywhere: [a]/ˈeniwer/; [adv]无论何处,任何地方; pro[n]任何(一个)地方; [or]4j;
apart: [a]/əˈpɑːrt/; [adv]相隔,相距; 分散地,分开地; [adj]分隔的,拆开的,撇开的; [or]4j;
apartment: [a]/əˈpɑːrtmənt/; [n](美)公寓,一套房间; [or]4j;
apologize: [a]/əˈpɑːlədʒaɪz/; [v]道歉,认错; [or]4j;
apology: [a]/əˈpɑːlədʒi/; [n]道歉,(表达)歉意; [or]4j;
apparatus: [a]/ˌæpəˈrætəs/; [n]装置,仪器;设备;组织,机构; [or]4j;
apparent: [a]/əˈpærənt/; [adj]显然的,明白的,清晰可见的;表面上的,貌似(真实)的; [or]4j;
appeal: [a]/əˈpiːl/; [vi]呼吁,请求;申诉;有吸引力; [n]呼吁;恳求;(为慈善或好的事业所做的) 筹款努力;(人或物的)吸引力; [or]4j;
appear: [a]/əˈpɪr/; [v]出现,露面;显得,好像,;出版; [or]4j;
appearance: [a]/əˈpɪrəns/; [n]外貌,外表;到达,抵达;公开露面;出版,发表,刊登; [or]4j;
appetite: [a]/ˈæpɪtaɪt/; [n]食欲,胃口;欲望; [or]4j;
applaud: [a]/əˈplɔːd/; [v]鼓掌; [vi]喝彩; [vt]向.鼓掌表示赞赏;给.捧场; [or]4j;
applause: [a]/əˈplɔːz/; [n]鼓掌,掌声; [or]4j;
apple: [a]/ˈæpl/; [n]苹果; [or]4j;
appliance: [a]/əˈplaɪəns/; [n]家用器具;家用电器;装置;应用; [or]4j;
applicant: [a]/ˈæplɪkənt/; [n]申请人;请求者; [or]4j;
application: [a]/ˌæplɪˈkeɪʃn/; [n]运用;申请(书);应用程序; [or]4j;
apply: [a]/əˈplaɪ/; [v]涂,敷;应用;申请; [or]4j;
appoint: [a]/əˈpɔɪnt/; [v]委派,任命;约定;确定,指定; [or]4j;
appointment: [a]/əˈpɔɪntmənt/; [n]约会,会面;委派;任命的职位;接受委派者;制定; [or]4j;
appraisal: [a]/əˈpreɪzl/; [n]评估;估价;评价; [or]4j;
appreciate: [a]/əˈpriːʃieɪt/; [v]赏识;为..表示感激;领会;使增值;增值; [or]4j;
approach: [a]/əˈproʊtʃ/; [v]接近;靠近;着手处理; [n]接近;途径;方法; [or]4j;
appropriate: [a]/əˈproʊpriət/; [adj]合适的;适当的; [v]挪用;拨款;私占; [or]4j;
approval: [a]/əˈpruːvl/; [n]批准;赞同;试销; [or]4j;
approve: [a]/əˈpruːv/; [v]称许,赞成,批准; [or]4j;
approximate: [a]/əˈprɑːksɪmət/; [adj]近似的,约略的; [v]接近,近似; [or]4j;
arbitrary: [a]/ˈɑːrbətreri/; [adj]随意的,任性的,随心所欲的;霸道的,专制的,专横的;主观的,武断的; [or]4j;
architect: [a]/ˈɑːrkɪtekt/; [n]设计师;建筑师; [or]4j;
architecture: [a]/ˈɑːrkɪtektʃər/; [n](总称)建筑物,建筑学,建筑体系,结构; [or]4j;
argue: [a]/ˈɑːrɡjuː/; [v]争吵;主张,认为;提供.证据,提出证明;表明(原因等); [or]4j;
argument: [a]/ˈɑːrɡjumənt/; [n]争吵,争论,辩论;论据,论点; [or]4j;
arise: [a]/əˈraɪz/; [v]起床;出现;升起;由.引起,发生; [or]4j;
arithmetic: [a]/əˈrɪθmətɪk/; [n]计算;算术; [or]4j;
arrange: [a]/əˈreɪndʒ/; [v]整理;改编(乐曲);筹备,安排;达成;达成协议;做安排; [or]4j;
arrangement: [a]/əˈreɪndʒmənt/; [n]布置;排列;组合体;整齐;调解;办法;协议;计划; [or]4j;
arrest: [a]/əˈrest/; [v]逮捕,拘留;吸引; [n]逮捕,拘留; [or]4j;
arrival: [a]/əˈraɪvl/; [n]到来,到达;到达者; [or]4j;
arrow: [a]/ˈæroʊ/; [n]箭;箭头; [or]4j;
article: [a]/ˈɑːrtɪkl/; [n]物品;文章;条款;冠词; [or]4j;
artificial leg: [a]/ˌɑrtɪˈfɪʃ(ə)l leɡ/; [phr]假腿; [or]4j;
artificial: [a]/ˌɑːrtɪˈfɪʃl/; [adj]人造的,人工的,假的;假装的,虚伪的; [n]人造肥料;<美>假花; [or]4j;
artist: [a]/ˈɑːrtɪst/; [n]艺术家,画家; [or]4j;
artistic: [a]/ɑːrˈtɪstɪk/; [adj]艺术家的;艺术的; [or]4j;
ash: [a]/æʃ/; [n]灰;灰烬;白蜡树; [or]4j;
ashamed: [a]/əˈʃeɪmd/; [adj]感到羞愧的;害臊的; [or]4j;
aside: [a]/əˈsaɪd/; [adv]在旁边,留存;把..放在一边; [n]独白;私语;离题的话; [or]4j;
aspect: [a]/ˈæspekt/; [n]外表,面貌;(问题等的)方面; [or]4j;
assemble: [a]/əˈsembl/; [v]装配(机器等);集合;召集; [or]4j;
assembly: [a]/əˈsembli/; [n]集合;集会;装配;立法机构; [or]4j;
assess: [a]/əˈses/; [v]评估;估值; [or]4j;
asset: [a]/ˈæset/; [n]财产,资产,有价值的东西或人; [or]4j;
assign: [a]/əˈsaɪn/; [v]布置;分配;指定;指派;归因;确定; [or]4j;
assignment: [a]/əˈsaɪnmənt/; [n]任务,(课外)作业;分配,委派; [or]4j;
assist: [a]/əˈsɪst/; [n]帮助;助攻; [v]帮助;促进; [or]4j;
assistance: [a]/əˈsɪstəns/; [n]援助;帮助;补助; [or]4j;
assistant: [a]/əˈsɪstənt/; [n]助理,助手;售货员; [adj]助理的,辅助的; [or]4j;
associate: [a]/əˈsoʊʃieɪt/; [v]联想;联合;联系,交往; [n]伙伴;同事; [adj]副的; [or]4j;
association: [a]/əˌsəʊsiˈeɪʃn/; [n]结合;伙伴,关系;协会,联盟,社团;联想; [or]4j;
assume: [a]/əˈsuːm/; [v]猜想;以为,假设;呈现;就职;(想当然地)认为;承担(责任); [or]4j;
assumption: [a]/əˈsʌmpʃn/; [n]假定,设想;采取;承担; [or]4j;
assure: [a]/əˈʃʊr/; [v]向..保证,使确信;保证,确保; [or]4j;
astonish: [a]/əˈstɑːnɪʃ/; [v]使惊讶,使吃惊; [or]4j;
astronaut: [a]/ˈæstrənɔːt/; [n]宇航员; [or]4j;
athlete: [a]/ˈæθliːt/; [n]运动员,体育家,强壮的人; [or]4j;
atmosphere: [a]/ˈætməsfɪr/; [n]大气层;大气;空气;气氛; [or]4j;
atom: [a]/ˈætəm/; [n]原子;微粒;原子能; [or]4j;
atomic: [a]/əˈtɑːmɪk/; [adj]原子的;原子能的; [or]4j;
attach: [a]/əˈtætʃ/; [v]系;贴;附上;附加;缚; [or]4j;
attack: [a]/əˈtæk/; [n](病)发作,攻击; [v]攻击,进攻,抨击;毁坏; [or]4j;
attain: [a]/əˈteɪn/; [v]获得;达到(某个年纪,水平,条件);实现; [n]成就; [or]4j;
attempt: [a]/əˈtempt/; [n]尝试;企图; [vt]努力去做;试图,尝试; [or]4j;
attend: [a]/əˈtend/; [vi]护理;照顾; [vt]出席;参加; [v]上(学); [or]4j;
attention: [a]/əˈtenʃn/; [n]专心,留心,注意,注意力,关心,体贴,礼貌; [int]立正,注意; [or]4j;
attitude: [a]/ˈætɪtuːd/; [n]态度;看法;姿势; [or]4j;
attorney: [a]/əˈtɜːrni/; [n](辩护)律师; [or]4j;
attract: [a]/əˈtrækt/; [v]吸引,引诱; [or]4j;
attraction: [a]/əˈtrækʃn/; [n]吸引,魅力,吸引力; [or]4j;
attractive: [a]/əˈtræktɪv/; [adj]有魅力的;吸引人的;引起兴趣的; [or]4j;
auction: [a]/ˈɔːkʃn/; [n]拍卖; [v]拍卖; [or]4j;
audience: [a]/ˈɔːdiəns/; [n](演讲,音乐会等的)听众,观众;正式会见;拥护者; [or]4j;
audio: [a]/ˈɔːdioʊ/; [adj]声音的,听觉的; [n]音频; [or]4j;
aunt: [a]/ænt/; [n]小姨,姑妈,伯母,舅妈;阿姨; [or]4j;
author: [a]/ˈɔːθər/; [n]作者;发起人; [v]成为作家; [or]4j;
authority: [a]/əˈθɔːrəti/; [n]权威;威信;当局,官方;权力,职权; [or]4j;
auto: [a]/ˈɔːtoʊ/; [n]汽车; [adj]自动的; [or]4j;
automatic: [a]/ˌɔːtəˈmætɪk/; [adj]无意识的;自动的;自发的; [n]自动手枪;自动工具; [or]4j;
automobile: [a]/ˈɔːtəməbiːl/; [n]汽车,机动车; [v]开汽车;坐汽车; [adj]自动的; [or]4j;
auxiliary: [a]/ɔːɡˈzɪliəri/; [adj]备用的,辅助的,协助的; [or]4j;
available: [a]/əˈveɪləbl/; [adj]可得到的,可利用的,有空的,有效的; [or]4j;
avenue: [a]/ˈævənuː/; [n]林荫道,道路;大街; [or]4j;
average: [a]/ˈævərɪdʒ/; [n]平均数,平均水平; [adj]通常的,一般的;平均的; [v]平均为; [or]4j;
aviation: [a]/ˌeɪviˈeɪʃn/; [n]航空,航空学;飞机制造业; [or]4j;
avoid: [a]/əˈvɔɪd/; [v]躲开,避开;避免,防止; [or]4j;
await: [a]/əˈweɪt/; [v]等候;等待..发生; [or]4j;
awake: [a]/əˈweɪk/; [adj]醒着的,警觉的; [v]唤醒;觉醒,认识到;认识到; [or]4j;
award: [a]/əˈwɔːrd/; [n]奖品;奖学金;判决; [vt]授予;给予; [or]4j;
aware: [a]/əˈwer/; [adj]意识到的,知道的; [or]4j;
awful: [a]/ˈɔːfl/; [adj]可怕的,极坏的;糟糕的,讨厌的;极其; [adv]极其,非常; [or]4j;
awkward: [a]/ˈɔːkwərd/; [adj]尴尬的;笨拙的;棘手的;不雅观的;不方便的;困难的,危险的; [or]4j;
ax: [a]/æks/; [n]斧子; [v]用斧头砍; [or]4j;
baby: [a]/ˈbeɪbi/; [n]宝宝;婴儿;孩子气的人; [adj]幼嫩的; [or]4j;
bachelor: [a]/ˈbætʃələr/; [n]单身汉;学士学位; [or]4j;
background: [a]/ˈbækɡraʊnd/; [n]图片背景,底色;出身;背景;时代背景; [or]4j;
backward: [a]/ˈbækwərd/; [adj]落后的;向后的,倒行的; [adv]向后地; [or]4j;
bacon: [a]/ˈbeɪkən/; [n]熏猪肉,培根; [or]4j;
bacteria: [a]/bækˈtɪriə/; [n]细菌(复数); [or]4j;
bad: [a]/bæd/; [adj]坏的,恶的,错的;低劣的,拙劣的;不舒服的,病的;严重的,糟糕的; [n]坏人,坏事; [adv]非常,不好地; [or]4j;
badly: [a]/ˈbædli/; [adv]坏,恶劣地;严重地,非常; [or]4j;
badminton: [a]/ˈbædmɪntən/; [n]羽毛球;羽毛球运动; [or]4j;
baffle: [a]/ˈbæfl/; [v]使困惑;难住;阻碍; [n]挡板; [or]4j;
bag: [a]/bæɡ/; [n]袋,包; [v]把..装进口袋; [or]4j;
baggage: [a]/ˈbæɡɪdʒ/; [n]行李; [or]4j;
bake: [a]/beɪk/; [v]烤,烘焙;烧制; [n]晒;烘烤食品; [or]4j;
balance: [a]/ˈbæləns/; [n]平衡;称;平静;和谐;余额; [v]保持平衡;使平衡;补偿; [or]4j;
balcony: [a]/ˈbælkəni/; [n]阳台,剧院楼厅; [or]4j;
ball: [a]/bɔːl/; [n]球;舞会; [v]使成球状; [or]4j;
ballet: [a]/bæˈleɪ/; [n]芭蕾舞,芭蕾舞剧;芭蕾舞团; [or]4j;
balloon: [a]/bəˈluːn/; [n]气球;热气球; [v]充气;膨胀; [adj]气球般的; [or]4j;
ban: [a]/bæn/; [vt]禁止;查禁; [n]禁止,禁令; [or]4j;
banana: [a]/bəˈnænə/; [n]香蕉;芭蕉属植物; [or]4j;
band: [a]/bænd/; [n]乐队;帮伙;带; [v]用带捆扎;联合; [or]4j;
bang: [a]/bæŋ/; [n]巨响;重击;刘海; [adv]准确地,完全地; [v]发出砰的一声;重击;猛敲;砰地关上; [or]4j;
bangs: [a]/bæŋz/; [n]刘海; [or]4j;
bankrupt: [a]/ˈbæŋkrʌpt/; [adj]破产的;彻底失败的;彻底缺乏的; [n]破产者; [v]使破产;使枯竭; [or]4j;
banner: [a]/ˈbænər/; [n]旗帜,横幅,大标题; [or]4j;
bar: [a]/bɑːr/; [n]酒吧;(金属)棒;闩;障碍;柜台; [vt]阻挡;禁止;闩住; prep. 除.之外; [or]4j;
barber: [a]/ˈbɑːrbər/; [n]理发师,理发店; [or]4j;
bare: [a]/ber/; [adj]赤裸的,空的,贫瘠的; [v]使裸露,暴露; [or]4j;
barely: [a]/ˈberli/; [adv]几乎不;仅仅;只不过; [or]4j;
bargain: [a]/ˈbɑːrɡən/; [n]交易,特价商品;便宜货;契约; [vi]讨价还价,讲价;成交; [vt]经讨价还价成交;用.交换; [adj](价格),低廉的; [or]4j;
bark: [a]/bɑːrk/; [v]狗吠;厉声发令; [n]树皮;吠声; [or]4j;
barn: [a]/bɑːrn/; [n]谷仓,牲口棚;简陋的大房子; [or]4j;
barrel: [a]/ˈbærəl/; [n]桶;枪管; [vi]快速移动; [or]4j;
barrier: [a]/ˈbæriər/; [n]障碍;屏障;隔阂;壁垒; [v]用栅栏围住; [or]4j;
base: [a]/beɪs/; [n]地基,基础;底座;<化>碱; [adj]卑鄙的,无耻的; [vt]以..作基础; [or]4j;
baseball: [a]/ˈbeɪsbɔːl/; [n]棒球(运动);棒球; [or]4j;
basement: [a]/ˈbeɪsmənt/; [n]<建筑学>地下室;根基; [or]4j;
basin: [a]/ˈbeɪsn/; [n]水池;盆地;流域;盆; [or]4j;
basis: [a]/ˈbeɪsɪs/; [n]基础,根据;原因,缘由;基准; [or]4j;
bat: [a]/bæt/; [n]蝙蝠;球棒,球拍; [v]用球板击球;拍打(空中飞舞的小东西); [or]4j;
bath: [a]/bæθ/; [n]洗澡,沐浴,浴缸; [v]给..洗澡;洗澡; [adj]沐浴着(光线);汗流浃背;泪流满面; [or]4j;
bathe: [a]/beɪð/; [v]给..洗澡;洗澡;洗澡,游泳; [or]4j;
battery: [a]/ˈbætəri/; [n]电池(组);排炮;一组,许多,众多; [or]4j;
battle: [a]/ˈbætl/; [n]战役,战斗;斗争; [v]作战; [or]4j;
bay: [a]/beɪ/; [n]海湾,港湾;困境; [vi](尤指猎犬等)吠,叫,咆哮;筑堤遏(水); [v]穷追,使陷入绝境;阻止(敌人)不使前进;向.吠叫; [adj]赤褐色的,栗色的; [or]4j;
beach: [a]/biːtʃ/; [n]海滩,河滩; [v]把..拖上岸,使(船)靠岸; [or]4j;
beam: [a]/biːm/; [n]光线;(房屋等)大梁;(横)梁; [v]发光;照射;发射,播送;微笑;用梁支撑; [or]4j;
bean: [a]/biːn/; [n]豆子; [v]将(球)击中击球员头部; [or]4j;
bear: [a]/ber/; [n]熊;(股市)看跌的人; [v]容忍,忍受;承担;带有;生育;开花结果,结(果实); [or]4j;
beard: [a]/bɪrd/; [n](下巴上的)胡须; [v]公开反对;抓住胡须; [or]4j;
bearing: [a]/ˈberɪŋ/; [n]方向;举止;轴承; [or]4j;
beast: [a]/biːst/; [n]野兽; [or]4j;
beat: [a]/biːt/; [v]敲打;打败;打;(心脏)跳动;搅拌; [n]敲打;拍子; [adj]精疲力竭的,疲惫不堪的;垮掉的,属于"垮掉的一代"的; [or]4j;
beauty: [a]/ˈbjuːti/; [n]美(丽);美人;美丽的东西; [or]4j;
become: [a]/bɪˈkʌm/; [v]成为,开始变得,变成;适合,适宜;相称; [or]4j;
bee: [a]/biː/; [n]蜜蜂;忙碌的人; [or]4j;
beer: [a]/bɪr/; [n]啤酒; [or]4j;
beg: [a]/beɡ/; [v]乞求,恳求;乞讨; [or]4j;
beggar: [a]/ˈbeɡər/; [n]乞丐; [v]使贫穷; [or]4j;
behalf: [a]/bɪˈhæf/; [n]代表(某人),因为某人;利益;赞同,支持; [or]4j;
behave: [a]/bɪˈheɪv/; [v]举动;举止端正(或良好,适当); [or]4j;
behavior: [a]/bɪ'heɪvjə/; [n]行为;举止;态度; [or]4j;
belief: [a]/bɪˈliːf/; [n]信仰;相信;信任;被信仰之物;看法; [or]4j;
belong: [a]/bɪˈlɔːŋ/; [v]属于,附属;归属; [or]4j;
beloved: [a]/bɪˈlʌvɪd/; [n]爱人; [adj]心爱的,所钟爱的;受爱戴的; [or]4j;
belt: [a]/belt/; [n]带,腰带;皮带;传送带;规则;地带;重击; [v]用皮带抽打;用带系上;用带标示;疾驰;大声歌唱; [or]4j;
bench: [a]/bentʃ/; [n]长凳,条凳;长形工作台;法官(席位);(体育比赛的)替补席; [or]4j;
bend: [a]/bend/; [v](使)弯曲,(使)改变(主意),使屈服; [n]弯曲,弯曲处,倾向,屈服;(复数形式)减压症; [or]4j;
beneath: [a]/bɪˈniːθ/; prep. 在..下方;低于; [adv]在下方; [or]4j;
beneficial: [a]/ˌbenɪˈfɪʃl/; [adj]有益的,有利的; [or]4j;
benefit: [a]/ˈbenɪfɪt/; [v]受益,有助于,使受益; [n]好处,益处;救济金; [or]4j;
besides: [a]/bɪˈsaɪdz/; prep. 除..之外; [adv]而且,还有; [or]4j;
bet: [a]/bet/; [n]赌注;打赌; [v]打赌;敢断定; [or]4j;
beyond: [a]/bɪˈjɑːnd/; [adv]更远处,更多,以后; prep. 超过;在能力,理解力之外;除..之外; [or]4j;
bible: [a]/ˈbaɪbl/; [n]《圣经》;权威书籍; [or]4j;
bicycle: [a]/ˈbaɪsɪkl/; [n]自行车,脚踏车; [vi]骑自行车; [or]4j;
bid: [a]/bɪd/; [n]出价;投标;努力争取; [v]出价;投标;问候;道别;吩咐; [or]4j;
big: [a]/bɪɡ/; [adj]大的,巨大的; [adv]大大,给人印象深地; [n]大亨,大公司; [or]4j;
bike: [a]/baɪk/; [n]自行车; [v]骑自行车; [or]4j;
billion: [a]/ˈbɪljən/; [num]<美>十亿,<英>万亿;万亿,一万亿;大量,无数; [adj]大量的; [or]4j;
bind: [a]/baɪnd/; [v]捆绑;装订;约束;结合; [n]窘境,困境;讨厌的事情;捆绑;植物的藤蔓; [or]4j;
biology: [a]/baɪˈɑːlədʒi/; [n]生物学;生物;生命周期; [or]4j;
biscuit: [a]/ˈbɪskɪt/; [n]饼干;软饼;褐色; [or]4j;
bite: [a]/baɪt/; [v]咬,叮,螫;剌穿; [n]咬;(咬下的)一口;少量食物;简单的一餐; [or]4j;
bitterly: [a]/ˈbɪtərli/; [adv](形容不快或伤痛)极其,非常;伤心地,愤怒地; [or]4j;
blade: [a]/bleɪd/; [n]刀片,刀刃;(飞机,植物的)叶片; [or]4j;
blame: [a]/bleɪm/; [v]责备,把..归咎于; [n]责备,过失; [or]4j;
blank: [a]/blæŋk/; [adj](纸等)空白的,茫然的; [n]空白,空白处; [v]忽视; [or]4j;
blanket: [a]/ˈblæŋkɪt/; [n]毛毯;毯子;覆盖层; [adj]总括的;全面的;不加区别的; [vt]用毯子盖;掩盖; [or]4j;
blast: [a]/blæst/; [n]一阵(疾风等);爆炸;冲击波; [v](用炸药)炸,摧毁; [or]4j;
bleed: [a]/bliːd/; [vi]流血;散开; [vt]榨取,敲诈;使流血;使..排出液体; [n]出血; [adj]<印>出血版的; [or]4j;
blend: [a]/blend/; [v]混合;把.混成一体; [n]混合物; [or]4j;
blind: [a]/blaɪnd/; [adj]瞎的,盲目的; [v]使失明;蒙蔽; [n]盲点,百叶窗; [adv]盲目地; [or]4j;
block: [a]/blɑːk/; [v]阻挡;妨碍;阻塞; [n]街区;块状物;积木;阻碍;大厦; [or]4j;
blockade: [a]/blɑːˈkeɪd/; [n]封锁,阻碍物; [v]封锁; [or]4j;
blonde: [a]/blɑːnd/; [adj](头发)亚麻色的,金色的; [n]金(浅)发女郎; [or]4j;
bloody: [a]/ˈblʌdi/; [adj]血的,血腥的,残忍的; [v]血污,血染; [adv]过分,太; [or]4j;
bloom: [a]/bluːm/; [v]开花; [n]开花期;青春时期;花;兴旺时期; [or]4j;
blouse: [a]/blaʊs/; [n]宽松工作服;女式衬衫;短上衣; [v]宽松下垂; [or]4j;
board: [a]/bɔːrd/; [n]木板;董事会;甲板;膳食; [v]乘船,登机;用板铺;供膳食;寄宿; [or]4j;
boast: [a]/boʊst/; [v]夸耀;吹牛,吹嘘;自负; [n]感到骄傲的事; [or]4j;
boil: [a]/bɔɪl/; [v]烧开,沸腾;用开水煮,在沸水中煮; [n]煮沸,沸腾;疔,疖子;<医>疡肿,脓肿; [or]4j;
bold: [a]/boʊld/; [adj]大胆的,勇敢的;无耻的,放肆的;醒目的; [n]粗体字; [or]4j;
bolt: [a]/boʊlt/; [n]门栓,螺栓;闪电;弩箭; [v]闩门;(马受惊)脱缰; [adv]突然地;像箭似地;直立地; [or]4j;
bomb: [a]/bɑːm/; [n]炸弹; [v]投弹于,轰炸; [or]4j;
bond: [a]/bɑːnd/; [n]束缚物,联结物;凝聚力;债券;保释金;联系; [vi]结合;团结一致; [or]4j;
bone: [a]/boʊn/; [n]骨头; [v]将..去骨; [or]4j;
boom: [a]/buːm/; [n]隆隆声;繁荣;景气;激增; [v]发出低沉有回响的声音;迅速发展,蓬勃发展;以低沉有回响的声音发出; [or]4j;
boost: [a]/buːst/; [v]增加;偷盗; [n]提高;激励;后推;助推发动机; [or]4j;
boot: [a]/buːt/; [n](长筒)靴;箱子,行李箱;解雇; [v]踢;启动; [or]4j;
border: [a]/ˈbɔːrdər/; [n]边界;花坛;滚边,边沿,包边; [v]近似;毗邻;与..接壤;为..镶边; [or]4j;
boring: [a]/ˈbɔːrɪŋ/; [adj]令人厌烦的;单调的;无聊的,乏味的; [or]4j;
bother: [a]/ˈbɑːðər/; [v]麻烦,打扰;花时间; [n]烦扰,麻烦,打扰; [or]4j;
bottle: [a]/ˈbɑːtl/; [n]瓶(子); [v]装瓶;抑制,约束,遏制,控制; [or]4j;
bottom: [a]/ˈbɑːtəm/; [n]底部;尽头;末端;臀部;水底; [adj]底部的; [v]触底; [or]4j;
bounce: [a]/baʊns/; [vi]弹起,蹦跳; [vt]使弹起; [v]拒付 (支票); [n]弹跳,弹力,活力; [or]4j;
bound: [a]/baʊnd/; [adj]受约束的;有义务的;一定的; [v]束缚;跳跃着前行; [n]跳跃;范围;界限; [or]4j;
boundary: [a]/ˈbaʊndri/; [n]边界,分界线;使球越过边界线的击球(得加分); [or]4j;
bow: [a]/baʊ/; [v]鞠躬,点头,弯腰;压弯,(使)弯曲,弄弯; [n]弓,蝴蝶结,鞠躬;船首; [or]4j;
box: [a]/bɑːks/; [n]盒子,箱子; [v]拳击; [or]4j;
boy: [a]/bɔɪ/; [n]男孩;少年;小家伙; [int]表示惊奇,高兴,痛苦等; [or]4j;
brake: [a]/breɪk/; [v]刹车; [n]刹车,制动器,闸; [or]4j;
branch: [a]/bræntʃ/; [n]树枝;分支(学科);(政府等的)部门;分支机构,分部; [vi]出枝桠,分叉; [or]4j;
brand: [a]/brænd/; [n]商标,品牌;烙印; [v]给..打上烙印;归为 (不好的事物); [or]4j;
brandy: [a]/ˈbrændi/; [n]白兰地酒;白兰地; [v]把.在白兰地酒中浸泡; [or]4j;
brass: [a]/bræs/; [n]黄铜(器);铜管乐器;<口语>厚脸皮;高级将领官员;黄铜; [v]付(款); [or]4j;
brave: [a]/breɪv/; [adj]勇敢的;崭新的; [v]勇敢面对;不怕,不顾; [n]勇士;美洲印第安武士; [or]4j;
breadth: [a]/bredθ/; [n]宽度;广度; [or]4j;
breakthrough: [a]/ˈbreɪkθruː/; [n]突破,突破性进展,重要的新发现; [adj]突破性的; [or]4j;
breast: [a]/brest/; [n]胸膛,乳房;胸脯肉; [v]挺胸穿过; [or]4j;
breed: [a]/briːd/; [n]血统;种类; [v]产仔;繁殖;使繁殖; [or]4j;
breeze: [a]/briːz/; [n]微风,清风;轻而易举的事; [v]飘然而行;轻松通过; [or]4j;
brick: [a]/brɪk/; [n]砖块,砖;积木; [vt]用砖砌; [or]4j;
bride: [a]/braɪd/; [n]新娘; [or]4j;
brief: [a]/briːf/; [adj]简短的,扼要的,短暂的,短时间的; [n]摘要,概要,简短声明,诉讼要点;职责; [v]作.的摘要,向.通报情况; [or]4j;
briefcase: [a]/ˈbriːfkeɪs/; [n]公文包; [or]4j;
brilliant: [a]/ˈbrɪliənt/; [adj]聪颖的;卓越的,有才气的;明亮的; [or]4j;
broad: [a]/brɔːd/; [adj]宽的,宽阔的;广阔的;广泛的;明显的; [or]4j;
broadcast: [a]/ˈbrɔːdkæst/; [v]播放,广播,播音; [n]广播(节目); [or]4j;
broom: [a]/bruːm/; [n]扫帚;金雀花; [or]4j;
brother: [a]/ˈbrʌðər/; [n]兄弟;同事;同胞; [int]表示生气或吃惊; [v]和..结成弟兄; [or]4j;
brow: [a]/braʊ/; [n]眉,眉毛;额; [or]4j;
brown: [a]/braʊn/; [n]褐色,棕色; [adj]褐色的,棕色的; [v](使)变褐色; [or]4j;
brush: [a]/brʌʃ/; [vi]刷牙;刷;掠过; [vt]刷;涂;写,画;拭去;掠过; [n]画笔;毛笔;刷子;刷状物;小冲突; [or]4j;
brutal: [a]/ˈbruːtl/; [adj]残忍的,粗鲁的;严酷的,难以忍受的;严峻的; [or]4j;
bubble: [a]/ˈbʌbl/; [v]起泡;兴奋,欢闹;充满生气,情绪高涨; [n]气泡,水泡;虚幻之事;靠不住的计划;泡影;幻想,妄想; [or]4j;
bucket: [a]/ˈbʌkɪt/; [n]水桶,(机器上的)桶装物,大量; [v]颠簸行进,下倾盆大雨;装在桶里; [or]4j;
budget: [a]/ˈbʌdʒɪt/; [n]预算; [v]预算,安排; [adj]廉价的; [or]4j;
bulb: [a]/bʌlb/; [n]电灯泡;球状物;球茎; [or]4j;
bulk: [a]/bʌlk/; [n]大批;容量;体积;大块; [adj]大量的;散装的; [v]膨胀;显得重要; [or]4j;
bullet: [a]/ˈbʊlɪt/; [n]子弹,枪弹; [or]4j;
bump: [a]/bʌmp/; [n]隆起物;撞击;(碰撞造成的)肿块; [v]撞击;颠簸地行驶;凹凸不平;除名,撵走; [or]4j;
bunch: [a]/bʌntʃ/; [n]束;串;群,伙; [v]集中,挤在一起;使成一束(或一群等); [or]4j;
bundle: [a]/ˈbʌndl/; [n]捆,包; [vt]捆; [or]4j;
burden: [a]/ˈbɜːrdn/; [n]负担,重担; [v]使负重,装载;烦扰; [or]4j;
bureau: [a]/ˈbjʊroʊ/; [n]局,司,处,社,所; [or]4j;
burst: [a]/bɜːrst/; [n]爆炸;爆裂;迸发; [v]爆炸;冲;冲出;突破;冲破; [vi]迸发;突然出现;充满; [vt]使爆炸;使胀满;使绽开; [or]4j;
bury: [a]/ˈberi/; [v]埋葬;隐藏,埋藏;埋头于;抛开; [or]4j;
bus: [a]/bʌs/; [n]公共汽车; [v]用公共汽车运送; [or]4j;
bush: [a]/bʊʃ/; [n]灌木;灌木丛;矮树; [vi]丛生;灌木般丛生;浓密(或茂密)地生长;生密枝; [vt]加(金属)衬套于;加套管于;用耙耙平(耕地);以灌木(或灌木丛)装饰(或覆盖,围绕,围住,支撑,标志,保护等); [adj](豆科植物等)如灌木般长得低矮的;粗野的;粗鲁的;粗糙但实用的; [or]4j;
butcher: [a]/ˈbʊtʃər/; [n]屠夫,肉贩子;刽子手; [v]屠宰;屠戮,残杀; [or]4j;
butterfly: [a]/ˈbʌtərflaɪ/; [n]蝴蝶; [vt](烹饪时把鱼肉等)切开摊平; [or]4j;
button: [a]/ˈbʌtn/; [n]纽扣;按钮(开关); [v]扣紧;扣上纽扣; [or]4j;
cab: [a]/kæb/; [n]出租车;司机室,驾驶室; [or]4j;
cabbage: [a]/ˈkæbɪdʒ/; [n]洋白菜,卷心菜; [or]4j;
cabin: [a]/ˈkæbɪn/; [n](简陋的)小屋;船舱;客舱,机舱; [v]住在小屋里; [or]4j;
cabinet: [a]/ˈkæbɪnət/; [n]橱;柜;内阁; [or]4j;
cable: [a]/ˈkeɪbl/; [n]电缆,缆,索; [v]拍电报; [or]4j;
cafe: [a]/kæˈfeɪ/; [n]咖啡馆,餐馆; [or]4j;
cage: [a]/keɪdʒ/; [n]笼;鸟笼;囚笼; [v]关进(笼子); [or]4j;
cake: [a]/keɪk/; [n]蛋糕,饼,糕; [v](使)结块;(使)胶;涂厚厚的一层; [or]4j;
calculate: [a]/ˈkælkjuleɪt/; [vt]计算;估计;计划; [vi]计算;估计; [or]4j;
calculator: [a]/ˈkælkjuleɪtər/; [n]计算器,计算者; [or]4j;
calendar: [a]/ˈkælɪndər/; [n]日历;时间表;历法; [vt]把.记入日程表中;把.列入表中;为(文件等)作分类索引;将.排入日程表; [or]4j;
calm: [a]/kɑːm/; [adj]平静的,镇静的; [n]平静,安宁; [v](使)平静,(使)镇定; [or]4j;
calorie: [a]/ˈkæləri/; [n]卡(热量单位); [or]4j;
camel: [a]/ˈkæml/; [n]骆驼,浮船箱,驼色; [or]4j;
campaign: [a]/kæmˈpeɪn/; [n](社会性,政治性)活动,运动;战役; [v]从事活动,参加运动; [or]4j;
campus: [a]/ˈkæmpəs/; [n]校园,学校场地; [or]4j;
canal: [a]/kəˈnæl/; [n]运河,河流;水渠;(人体的)导管,食管,气管; [or]4j;
cancel: [a]/ˈkænsl/; [v]取消;撤消;删去; [or]4j;
cancer: [a]/ˈkænsər/; [n]癌,癌症;迅速蔓延的恶劣的或危险的事物; [or]4j;
candidate: [a]/ˈkændɪdət/; [n](官职,获奖资格等的)候选人;投考人;申请求职者; [or]4j;
candy: [a]/ˈkændi/; [n]糖果; [vt](用糖煮过以)保存;使结晶为砂糖; [adj]〈美俚〉(服饰)花哨的;甜言蜜语的; [or]4j;
cap: [a]/kæp/; [n]帽子; [v]覆盖;给..定限额; [or]4j;
capable: [a]/ˈkeɪpəbl/; [adj]有本领的,有能力的;有才能的,能干的; [or]4j;
capacity: [a]/kəˈpæsəti/; [n]产能;容量;本领;才能;负载量;职位; [or]4j;
capital: [a]/ˈkæpɪtl/; [n]资金,资本;首都;大写(字母); [adj]大写的;资本的;优秀的;处以死刑的;致命的; [or]4j;
captain: [a]/ˈkæptɪn/; [n]船长,机长;上校,上尉;队长;领袖;消防中队长; [vt]做..的首领; [or]4j;
capture: [a]/ˈkæptʃər/; [v]捕获,俘获;俘虏;掌控;使迷住;捕捉,留存; [n]战利品; [or]4j;
car: [a]/kɑːr/; [n]汽车,小汽车,轿车;车厢; [or]4j;
carbon: [a]/ˈkɑːrbən/; [n]碳;复写纸; [adj]碳的; [or]4j;
card: [a]/kɑːrd/; [n]卡,卡片,名片; [v](纺纱前纤维)梳理,梳,刷;把..记入卡片,把..制成卡片; [or]4j;
career: [a]/kəˈrɪr/; [n]职业,事业;生涯,经历; [vi]全速前进,猛冲; [or]4j;
cargo: [a]/ˈkɑːrɡoʊ/; [n]货物; [or]4j;
carpenter: [a]/ˈkɑːrpəntər/; [n]木匠;木工; [or]4j;
carpet: [a]/ˈkɑːrpɪt/; [n]地毯; [v]铺以地毯; [or]4j;
carriage: [a]/ˈkærɪdʒ/; [n]四轮马车;运输;客车厢;姿态,仪态,举止; [or]4j;
carrier: [a]/ˈkæriər/; [n]搬运工,运送人;运输公司;航空母舰; [or]4j;
carrot: [a]/ˈkærət/; [n]胡萝卜; [or]4j;
cart: [a]/kɑːrt/; [n]手推车,运货马车; [v]用车装载; [or]4j;
cartoon: [a]/kɑːrˈtuːn/; [n]卡通(片),动画片;(尤指报刊上讽刺政客或时事的)漫画,幽默画; [or]4j;
cash: [a]/kæʃ/; [n]现金; [v]兑现;付(或收)现款; [or]4j;
cashier: [a]/kæˈʃɪr/; [n]出纳员,收银员; [v]把..撤职;驱逐,革除,废除; [or]4j;
cassette: [a]/kəˈset/; [n]磁带盒;录像带,盒式磁带; [or]4j;
cast: [a]/kæst/; [v]投;抛下,投射(光线和阴影);瞥,飞快看(一眼),扫视;掷;放钓;投票;选定演员; [n]投掷物;铸件;演员表,演员阵容; [or]4j;
castle: [a]/ˈkæsl/; [n]城堡;(国际象棋中的)车; [or]4j;
casual: [a]/ˈkæʒuəl/; [adj]偶然的;临时的;随便的; [n]临时工;便服; [or]4j;
casualty: [a]/ˈkæʒuəlti/; [n]伤亡人员,死伤者,受害人;急诊室(英); [or]4j;
cat: [a]/kæt/; [n]猫;猫科动物; [or]4j;
catalog: [a]/ˈkætəlɔːɡ/; [n]目录,目录册,商品目录; [v]为..编目录,登记; [or]4j;
category: [a]/ˈkætəɡɔːri/; [n]类别;范畴; [or]4j;
cattle: [a]/ˈkætl/; [n](总称)牛,牲口; [or]4j;
cause: [a]/kɔːz/; [v]引起,使发生; [n]原因,理由;事业;目标; [or]4j;
cautious: [a]/ˈkɔːʃəs/; [adj]小心的,谨慎的; [or]4j;
cave: [a]/keɪv/; [n]洞穴; [v]塌落; [or]4j;
cease: [a]/siːs/; [v]停止,结束; [n]停止,停息; [or]4j;
cell: [a]/sel/; [n]细胞;牢房;蜂房;电池;小隔间; [or]4j;
cement: [a]/sɪˈment/; [n]水泥,混凝土;胶合剂; [vt]巩固,加强;用水泥涂;接合; [vi]粘牢; [or]4j;
census: [a]/ˈsensəs/; [n]人口普查,人口调查;统计; [v]调查(某地区等的)人口数字;统计.的数字; [or]4j;
center: [a]/ˈsentər/; [n]中央,中心; [v]集中;居中; [or]4j;
centigrade: [a]/ˈsentɪɡreɪd/; [adj]百分度的;摄氏的; [n]摄氏度; [or]4j;
centimeter: [a]/ˈsentɪmiːtər/; [n]厘米,公分; [or]4j;
central: [a]/ˈsentrəl/; [adj]中心的;主要的; [or]4j;
ceremony: [a]/ˈserəmoʊni/; [n]典礼,仪式;礼节; [or]4j;
certain: [a]/ˈsɜːrtn/; [adj]有把握的;肯定的,必然的;某个,特定的; pro[n]某些,某几个; [or]4j;
certainly: [a]/ˈsɜːrtnli/; [adv]无疑,确定;当然,没问题(用于回答); [or]4j;
certificate: [a]/sərˈtɪfɪkət/; [n]合格证书,文凭;证明,证明书; [v]给..发证书; [or]4j;
chain: [a]/tʃeɪn/; [v]束缚;用链条拴住; [n]链;链条;项圈;连锁;一系列; [or]4j;
chair: [a]/tʃer/; [n]椅子;主席(职位);大学教授; [v]担任主席; [or]4j;
challenge: [a]/ˈtʃælɪndʒ/; [n]挑战;质疑; [v]挑战;质疑; [or]4j;
chamber: [a]/ˈtʃeɪmbər/; [n]会议室;(作特殊用途的)房间;议院; [or]4j;
champion: [a]/ˈtʃæmpiən/; [n]冠军;拥护者,战士; [v]拥护;保卫;为..而斗争; [adj]夺得第一名的;优胜的; [or]4j;
channel: [a]/ˈtʃænl/; [n]频道;渠道,方法;海峡; [v]引导;经沟槽输送; [or]4j;
chaos: [a]/ˈkeɪɑːs/; [n]混沌;混乱,纷乱; [or]4j;
chap: [a]/tʃæp/; [n]男人,家伙;<口语>小伙子;皲裂; [adj]开裂的; [v]皲裂;(皮肤)变粗糙; [or]4j;
chapter: [a]/ˈtʃæptər/; [n]章,回,篇;时期; [or]4j;
character: [a]/ˈkærəktər/; [n]人物,角色;性格;(书写或印刷)符号,(汉)字;特点;人格,品性; [or]4j;
characteristic: [a]/ˌkærəktəˈrɪstɪk/; [n]特点;特性;特色; [adj]典型的;特有的;独特的; [or]4j;
characterize: [a]/ˈkærəktəraɪz/; [v]表示..的特性;描述..特性; [or]4j;
charge: [a]/tʃɑːrdʒ/; [v]充电,充值;索价;控告;向.冲去; [n]费用;主管;控告; [or]4j;
charity: [a]/ˈtʃærəti/; [n]慈善团体;慈善;仁慈;施舍; [or]4j;
charm: [a]/tʃɑːrm/; [n]魅力,吸引力,符咒; [v](使)着迷,施魔法; [or]4j;
charming: [a]/ˈtʃɑːrmɪŋ/; [adj]迷人的;妩媚的;娇艳的;好极了的;用于表示你不喜欢某人说的话或者做的事情; [or]4j;
chart: [a]/tʃɑːrt/; [n]图表,表格;航海图;每周排行榜; [v]制成图表;制航海图; [or]4j;
charter: [a]/ˈtʃɑːrtər/; [n]宪章;特权,豁免权;契约,证书;租赁; [v]包,租(飞机,汽车等); [adj]包租的,租用的; [or]4j;
chase: [a]/tʃeɪs/; [v]追赶;驱逐;追求; [n]追逐;追求; [or]4j;
chat: [a]/tʃæt/; [v]闲谈,聊天; [n]闲谈,聊天; [or]4j;
cheat: [a]/tʃiːt/; [v]欺骗,哄骗,蒙骗;作弊; [n]欺骗,作弊;骗子,骗术; [or]4j;
check: [a]/tʃek/; [v]检查;阻止; [n]支票;阻止;检查;阻止物; [or]4j;
cheek: [a]/tʃiːk/; [n]面颊,脸蛋; [vt]<口语>无礼地说; [or]4j;
cheerful: [a]/ˈtʃɪrfl/; [adj]令人愉快的;高兴的; [or]4j;
chemical: [a]/ˈkemɪkl/; [n]化学制品; [adj]化学的; [or]4j;
chemist: [a]/ˈkemɪst/; [n]化学家;(英)药剂师; [or]4j;
chest: [a]/tʃest/; [n]胸膛;箱子; [or]4j;
chew: [a]/tʃuː/; [v]嚼,咀嚼; [n]嚼碎,咀嚼; [or]4j;
chief: [a]/tʃiːf/; [n]老板,头子;主管;(部落) 首领;酋长;长官; [adj]主要的;首席的; [or]4j;
child: [a]/tʃaɪld/; [n]小孩,儿童;子女; [or]4j;
childhood: [a]/ˈtʃaɪldhʊd/; [n]童年,幼年; [or]4j;
chill: [a]/tʃɪl/; [n]寒冷; [v](使)感到冷,使变冷; [adj]扫兴的; [or]4j;
chimney: [a]/ˈtʃɪmni/; [n]烟囱; [or]4j;
chin: [a]/tʃɪn/; [n]颏;下巴; [v]用下巴夹住;聊天;作引体向上动作; [or]4j;
chip: [a]/tʃɪp/; [n]木屑,碎片;缺口;圆形筹码;芯片;炸薯条,炸薯片; [v]碎裂;削,凿;将.削成,凿成; [or]4j;
chocolate: [a]/ˈtʃɑːklət/; [n]巧克力;赭色;巧克力糖;巧克力饮料; [or]4j;
choice: [a]/tʃɔɪs/; [n]选择(机会),抉择;选项;精华; [adj](食物)精选的,上等的,优等的; [or]4j;
choke: [a]/tʃoʊk/; [v]噎住,(使)窒息,阻塞; [n]窒息,噎住; [or]4j;
choose: [a]/tʃuːz/; [v]选择,挑选; [or]4j;
chop: [a]/tʃɑːp/; [v](用力)切,砍;降低;向下猛击;终止; [n]砍;劈;剁;排骨;嘴周围的地方; [or]4j;
chronic: [a]/ˈkrɑːnɪk/; [adj](疾病)慢性的;长期的;(人)久病的;积习难改的;严重的; [or]4j;
chronological: [a]/ˌkrɑːnəˈlɑːdʒɪkl/; [adj]按照时间顺序排列的; [or]4j;
cigar: [a]/sɪˈɡɑːr/; [n]雪茄烟; [or]4j;
cigarette: [a]/ˈsɪɡəret/; [n]香烟,纸烟,卷烟; [or]4j;
circle: [a]/ˈsɜːrkl/; [n]周期;范围;圆圈; [v]围绕; [or]4j;
circuit: [a]/ˈsɜːrkɪt/; [n]电路,线路;巡游,环形; [or]4j;
circulate: [a]/ˈsɜːrkjəleɪt/; [v](使)流通;(使)循环;(使)传播,流传; [or]4j;
circumference: [a]/sərˈkʌmfərəns/; [n]圆周长度,圆周;周围; [or]4j;
circumstance: [a]/ˈsɜːrkəmstæns/; [n]条件;情况;命运;客观环境; [or]4j;
cite: [a]/saɪt/; [v]引用,引证;传唤,传讯;表彰,嘉奖; [or]4j;
citizen: [a]/ˈsɪtɪzn/; [n]公民;市民;居民; [or]4j;
civil: [a]/ˈsɪvl/; [adj]公民的,民用的;国内的;有礼貌的,客气的; [or]4j;
civilian: [a]/səˈvɪliən/; [n]平民,百姓; [adj]平民的,百姓的,民用的; [or]4j;
civilization: [a]/ˌsɪvələˈzeɪʃn/; [n]文明,开化,教养; [or]4j;
claim: [a]/kleɪm/; [v]声称;要求;断言;主张;认领;索赔; [n]索赔;主张;声称;断言;要求; [or]4j;
clap: [a]/klæp/; [v]拍(手),鼓(掌);轻拍,轻敲;砰然出声,啪地关上,发出噼啪声; [n]轻拍(以示热情招呼),拍手(喝彩),鼓掌(欢迎),善意的拍打;霹雳声,破裂声,噼啪声,突然的爆炸声,砰然巨响; [or]4j;
clarify: [a]/ˈklærəfaɪ/; [v]阐明,澄清;净化; [or]4j;
clash: [a]/klæʃ/; [vi]发生冲突;发出撞击声;不合,不一致,不调和; [n]冲突;抵触;撞击声; [or]4j;
class: [a]/klæs/; [n]课,上课;种类,门类;阶级,社会等级,阶层,等级制度;班级,同届学生;等级,级别,舱位等级; [v]把..分组,分组,分班;把..归入某等级; [or]4j;
classic: [a]/ˈklæsɪk/; [adj]经典的;古典的;高雅的;一流的; [n]经典著作;文豪;优秀典范; [or]4j;
classical: [a]/ˈklæsɪkl/; [adj]古典的;传统的;正统的;权威的; [n]古典音乐; [or]4j;
classification: [a]/ˌklæsɪfɪˈkeɪʃn/; [n]分类,归类;(动植物等的)分类学; [or]4j;
classify: [a]/ˈklæsɪfaɪ/; [v]把.分类; [or]4j;
clause: [a]/klɔːz/; [n]条款;从句; [or]4j;
claw: [a]/klɔː/; [n]爪,钳;(某些节肢动物的),钳; [v]抓,挖; [vi]抓,挖; [or]4j;
clay: [a]/kleɪ/; [n](制砖瓦,陶瓷制品的)黏土;泥土;肉体; [vt]用黏土处理; [or]4j;
clerk: [a]/klɜːrk/; [n]店员;职员;办事员; [vi]当职员; [or]4j;
click: [a]/klɪk/; [v]点击(鼠标);(使)发出咔哒声;情投意合;博得喝彩; [n]咔哒声,点击; [or]4j;
client: [a]/ˈklaɪənt/; [n]委托人,当事人,主顾,客户;客户端; [or]4j;
cliff: [a]/klɪf/; [n]悬崖;峭壁; [or]4j;
climate: [a]/ˈklaɪmət/; [n]气候;(社会思想等)趋势; [or]4j;
climb: [a]/klaɪm/; [v]攀登,爬,上升; [n]爬,攀爬处; [or]4j;
cling: [a]/klɪŋ/; [v]紧紧抓住;黏着,挨近;依恋,依附;坚持,墨守,忠实于; [or]4j;
cloth: [a]/klɔːθ/; [n]布;衣料;桌布; [or]4j;
clothe: [a]/kloʊð/; [v]穿衣; [or]4j;
clothing: [a]/ˈkloʊðɪŋ/; [n]衣服;被褥; [or]4j;
clue: [a]/kluː/; [n]线索;提示;暗示; [vt]为..提供线索; [or]4j;
clumsy: [a]/ˈklʌmzi/; [adj]笨拙的,不灵活的;拙劣的,不得体的; [or]4j;
coach: [a]/koʊtʃ/; [n]四轮大马车;教练;长途汽车; [v]训练,指导; [or]4j;
coarse: [a]/kɔːrs/; [adj]粗糙的;粗俗的;粗鲁的; [or]4j;
cock: [a]/kɑːk/; [n]公鸡;雄鸟;龙头;首领;架子十足的人; [vt]使某物竖起;使某物倾斜;使朝上;扳上扳机; [vi]翘起,竖起;大摇大摆; [or]4j;
code: [a]/koʊd/; [n]编码,代码;准则,法典;密码; [v]将.编码; [or]4j;
cognitive: [a]/ˈkɑːɡnətɪv/; [adj]认识能力的;认知的; [or]4j;
coil: [a]/kɔɪl/; [n](一)卷,(一)圈;线圈; [v]卷,盘绕; [or]4j;
collapse: [a]/kəˈlæps/; [v](使)倒塌,(使)崩溃,(使)瓦解; [n]倒塌,崩溃,暴跌; [or]4j;
collar: [a]/ˈkɑːlər/; [n]项圈,衣领,<机>轴环; [v]抓住,为..戴上项圈,为..上领子; [or]4j;
colleague: [a]/ˈkɑːliːɡ/; [n]同事;同行; [or]4j;
collect: [a]/kəˈlekt/; [v]收集;领取;聚集;募捐; [adj]接收者付费的; [adv]接收者付费地; [or]4j;
collection: [a]/kəˈlekʃn/; [n]收藏,收藏品;收集;募捐;系,组; [or]4j;
collective: [a]/kəˈlektɪv/; [adj]集体的,共同的; [n]集体; [or]4j;
college: [a]/ˈkɑːlɪdʒ/; [n]学院,高等专科学校;大学; [or]4j;
collision: [a]/kəˈlɪʒn/; [n]碰撞;冲突; [or]4j;
colony: [a]/ˈkɑːləni/; [n]殖民地;侨居地;群体;菌落; [or]4j;
color: [a]/ˈkʌlər/; [n]颜色;颜料;肤色; [v]上颜色;(观念等)受..影响;脸红; [or]4j;
column: [a]/ˈkɑːləm/; [n]柱,支柱,圆柱;专栏;长队; [or]4j;
comb: [a]/koʊm/; [v]梳理; [n]梳子;梳理; [or]4j;
combat: [a]/ˈkɑːmbæt/; [n]战斗,格斗; [v]与.战斗,与.斗争; [adj]战斗的; [or]4j;
combination: [a]/ˌkɑːmbɪˈneɪʃn/; [n]结合,联合,组合;(保险锁等的)暗码; [or]4j;
combine: [a]/kəmˈbaɪn/; [v]使混合(结合,组合,联合);结合;联合;组合; [n]联合体,联合企业;联合收割机; [or]4j;
comedy: [a]/ˈkɑːmədi/; [n]喜剧,有趣的事情; [or]4j;
comfort: [a]/ˈkʌmfərt/; [n]舒适;安慰; [v]安慰;使舒适; [or]4j;
command: [a]/kəˈmænd/; [n]命令,指挥; [v]发布命令,指挥;掌管,控制;指挥,命令;控制,管理; [or]4j;
commander: [a]/kəˈmændər/; [n]司令官,指挥官; [or]4j;
comment: [a]/ˈkɑːment/; [n]评论,议论;批评,意见;注解; [vt]评论; [vi]进行评论;为.作评语; [or]4j;
commerce: [a]/ˈkɑːmɜːrs/; [n]商业,贸易; [or]4j;
commercial: [a]/kəˈmɜːrʃl/; [adj]商业性的,贸易的; [n]商业广告; [or]4j;
commission: [a]/kəˈmɪʃn/; [n]委员会;任务;权限;委任;销售佣金; [v]委任; [or]4j;
commit: [a]/kəˈmɪt/; [v]犯(罪);进行 (自杀);调拨 (钱,资源);监禁;送交 (到精神病院,监狱等);承诺,保证; [or]4j;
commitment: [a]/kəˈmɪtmənt/; [n]承诺;许诺;委任;承担的义务;献身;赞助;委托;犯罪;罪行;信奉; [or]4j;
committee: [a]/kəˈmɪti/; [n]委员会;全体委员; [or]4j;
communicate: [a]/kəˈmjuːnɪkeɪt/; [v]沟通,交流;传达,传递;传染;相连,相通;显露; [or]4j;
communication: [a]/kəˌmjuːnɪˈkeɪʃn/; [n]沟通方式;交流,通讯;信息; [or]4j;
communism: [a]/ˈkɑːmjunɪzəm/; [n]共产主义; [or]4j;
communist: [a]/ˈkɑːmjənɪst/; [adj]共产主义的; [n]共产主义者,共产党员; [or]4j;
community: [a]/kəˈmjuːnəti/; [n]社区;团体;(生)群落;人群,很多个体的集合体; [or]4j;
companion: [a]/kəmˈpæniən/; [n]同伴,志同道合的人;参考书; [or]4j;
company: [a]/ˈkʌmpəni/; [n]公司;交往;陪伴; [v]陪伴; [or]4j;
comparable: [a]/ˈkɑːmpərəbl/; [adj]类似的,比得上的,可比较的; [or]4j;
comparative: [a]/kəmˈpærətɪv/; [adj]相当的;比较的,相对而言的; [n]比较级;对手; [or]4j;
compare: [a]/kəmˈper/; [v]比较,比作; [n]比较;对照; [or]4j;
comparison: [a]/kəmˈpærɪsn/; [n]比较;对照;比较等级;比喻; [or]4j;
compass: [a]/ˈkʌmpəs/; [n]罗盘,指南针;圆规; [v]达到;围绕;图谋; [or]4j;
compel: [a]/kəmˈpel/; [v]强迫;迫使屈服;(使)不得已; [or]4j;
compensate: [a]/ˈkɑːmpenseɪt/; [v]补偿,赔偿,给..报酬; [or]4j;
compete: [a]/kəmˈpiːt/; [v]参加比赛;竞争,对抗; [or]4j;
competent: [a]/ˈkɑːmpɪtənt/; [adj]有能力的,能干的,胜任的;合格的; [or]4j;
competition: [a]/ˌkɑːmpəˈtɪʃn/; [n]比赛;竞争;竞争者; [or]4j;
competitive: [a]/kəmˈpetətɪv/; [adj]竞争的;好胜的;有竞争力的; [or]4j;
competitor: [a]/kəmˈpetɪtər/; [n]竞争对手,参赛者; [or]4j;
complain: [a]/kəmˈpleɪn/; [v]抱怨;诉苦;申诉;控诉;诉说;控告; [vt]申诉; [n]抱怨,诉苦; [or]4j;
complaint: [a]/kəmˈpleɪnt/; [n]抱怨,怨言;不满的缘由,痛苦根源;控诉;投诉; [or]4j;
complete: [a]/kəmˈpliːt/; [adj]完整的;完成的; [v]完成;使完整; [or]4j;
complex: [a]/ˈkɑːmpleks/; [adj]复杂的,难解的;复合的; [n]情结;建筑群;综合体,集合体; [or]4j;
complicated: [a]/ˈkɑːmplɪkeɪtɪd/; [adj]复杂的;难解的; [v]使复杂; [or]4j;
component: [a]/kəmˈpoʊnənt/; [n]零件; [adj]组成的; [or]4j;
compose: [a]/kəmˈpoʊz/; [v]创作,作曲,形成,构成; [or]4j;
composition: [a]/ˌkɑːmpəˈzɪʃn/; [n]构成;作文;(文章或音乐的)创作;成分; [or]4j;
compound: [a]/ˈkɑːmpaʊnd/; [n]复合物;<化学>化合物; [adj]合成的;复合的;多功能的; [vi]妥协;和解; [vt]混合;调和;调停;使恶化; [or]4j;
comprehension: [a]/ˌkɑːmprɪˈhenʃn/; [n]测试;理解力; [or]4j;
comprehensive: [a]/ˌkɑːmprɪˈhensɪv/; [adj]综合的;有充分理解力的,悟性好的;全面的,完整的;详尽的;广泛的,无所不包的;广义的; [n]综合测验;综合学校; [or]4j;
compress: [a]/kəmˈpres/; [v]压紧,压缩,压榨; [or]4j;
comprise: [a]/kəmˈpraɪz/; [v]包含,包括;构成; [or]4j;
compromise: [a]/ˈkɑːmprəmaɪz/; [n]妥协;折中; [v]妥协;使遭受危害; [or]4j;
compute: [a]/kəmˈpjuːt/; [v]计算,估计; [or]4j;
comrade: [a]/ˈkɑːmræd/; [n]同伴;同志;战友; [or]4j;
conceal: [a]/kənˈsiːl/; [v]隐藏,隐瞒,掩盖; [or]4j;
concede: [a]/kənˈsiːd/; [v]承认;承认失败;让给,让与;让步; [or]4j;
concentrate: [a]/ˈkɑːnsntreɪt/; [v]全神贯注于,集中于;浓缩; [n]浓缩物; [or]4j;
concentration: [a]/ˌkɑːnsnˈtreɪʃn/; [n]集中;专注;浓缩; [or]4j;
concept: [a]/ˈkɑːnsept/; [n]设想;想法;概念;观念; [or]4j;
concern: [a]/kənˈsɜːrn/; [n]关心,担忧; [v]感兴趣,涉及,关心,(使)担忧; [or]4j;
concert: [a]/ˈkɑːnsərt/; [n]音乐会;一致;和谐,合作; [or]4j;
concession: [a]/kənˈseʃn/; [n]让步;特许,特许权;承认; [or]4j;
concise: [a]/kənˈsaɪs/; [adj]简明的,简要的;简洁的,简要的; [or]4j;
conclude: [a]/kənˈkluːd/; [v]使结束;推断出;缔结;结束,总结,作决定,作协议; [or]4j;
conclusion: [a]/kənˈkluːʒn/; [n]结论,推论;结束;结局; [or]4j;
concrete: [a]/ˈkɑːŋkriːt/; [n]混凝土; [adj]具体的,实质性的; [v]给 (道路等) 浇混凝土; [or]4j;
condemn: [a]/kənˈdem/; [v]谴责,责备;判(某人某罪); [or]4j;
condense: [a]/kənˈdens/; [v]压缩;精炼;冷凝; [or]4j;
condition: [a]/kənˈdɪʃn/; [n]状况,状态;疾病,症状;环境,形势,条件; [v]使适应,使处于良好状态; [or]4j;
conduct: [a]/kənˈdʌkt/; [v]指挥;进行;实施;处理;传导(电,热等);护送; [n]行为,举止;指挥,带领; [or]4j;
conductor: [a]/kənˈdʌktər/; [n]售票员;指挥;导体; [or]4j;
conference: [a]/ˈkɑːnfərəns/; [n]会议;讨论会; [or]4j;
confess: [a]/kənˈfes/; [v](向神父或上帝)忏悔;承认,坦白; [or]4j;
confidence: [a]/ˈkɑːnfɪdəns/; [n]自信,信心;信任;有把握; [or]4j;
confident: [a]/ˈkɑːnfɪdənt/; [adj]自信的;确信的,深信的; [or]4j;
confine: [a]/kənˈfaɪn/; [v]限制;监禁; [n]范围,界限,约束,限制; [or]4j;
confirm: [a]/kənˈfɜːrm/; [v]确认;证实;批准; [or]4j;
conflict: [a]/ˈkɑːnflɪkt/; [n]冲突,(意见)分歧,战斗,斗争; [v]冲突,抵触,争执; [or]4j;
conform: [a]/kənˈfɔːrm/; [vi]一致;遵照,顺从;符合; [vt]使一致;使遵照; [adj]一致的; [or]4j;
confront: [a]/kənˈfrʌnt/; [v]与某人对峙;与..对抗;正视; [or]4j;
confuse: [a]/kənˈfjuːz/; [v]混淆;使混乱,使迷糊; [or]4j;
confusion: [a]/kənˈfjuːʒn/; [n]困惑;混淆;混乱;窘迫; [or]4j;
congratulate: [a]/kənˈɡrætʃuleɪt/; [v]祝贺,向..致贺词; [or]4j;
congratulation: [a]/kənˌɡrætʃuˈleɪʃn/; [n]祝贺;祝贺信; [or]4j;
congress: [a]/ˈkɑːŋɡrəs/; [n]国会(美);代表大会;议会;立法机关; [or]4j;
conjunction: [a]/kənˈdʒʌŋkʃn/; [n]连接;联合,结合;连接词; [or]4j;
connect: [a]/kəˈnekt/; [v]连接;联想;使有联系; [or]4j;
connection: [a]/kəˈnekʃn/; [n]亲戚;连接物;联系,关系; [or]4j;
conquer: [a]/ˈkɑːŋkər/; [v]征服,攻克;破除; [or]4j;
conquest: [a]/ˈkɑːŋkwest/; [n]征服,战胜;战利品;爱情的俘虏; [or]4j;
conscience: [a]/ˈkɑːnʃəns/; [n]良心,良知; [or]4j;
conscious: [a]/ˈkɑːnʃəs/; [adj]神志清醒的;自觉的;意识到的;有意的; [n]意识; [or]4j;
consciousness: [a]/ˈkɑːnʃəsnəs/; [n]意识,知觉;思想; [or]4j;
consent: [a]/kənˈsent/; [n]同意,准许;赞成; [v]同意; [or]4j;
consequence: [a]/ˈkɑːnsɪkwens/; [n]结果,后果;重要性; [or]4j;
consequent: [a]/ˈkɑːnsəkwənt/; [adj]作为结果(或后果)的,随之发生的; [n]结果,随后的事; [or]4j;
consequently: [a]/ˈkɑːnsəkwentli/; [adv]结果;因此;所以; [or]4j;
conservation: [a]/ˌkɑːnsərˈveɪʃn/; [n]保护;保存;维持; [or]4j;
conservative: [a]/kənˈsɜːrvətɪv/; [adj]保守的;保守估计的;保守党的; [n]保守主义者;保守党党员; [or]4j;
consider: [a]/kənˈsɪdər/; [v]考虑,细想;认为,觉得; [or]4j;
considerable: [a]/kənˈsɪdərəbl/; [adj]相当大的;重要的;可观的; [or]4j;
considerate: [a]/kənˈsɪdərət/; [adj]考虑周到的;体贴的; [or]4j;
consideration: [a]/kənˌsɪdəˈreɪʃn/; [n]考虑,思考;体贴,体谅,顾及; [or]4j;
consist: [a]/kənˈsɪst/; [v]由..组成;在于; [or]4j;
consistent: [a]/kənˈsɪstənt/; [adj]始终如一的,持续的,一致的; [or]4j;
console: [a]/kənˈsoʊl/; [v]安慰,慰问; [n]控制台,仪表板;落地柜; [or]4j;
constant: [a]/ˈkɑːnstənt/; [adj]不变的,始终如一的;持续不断的; [n]常数,恒量; [or]4j;
constitute: [a]/ˈkɑːnstətuːt/; [v]构成,组成;任命; [or]4j;
constitution: [a]/ˌkɑːnstəˈtuːʃn/; [n]宪法,章程;组成,结构;体质,体格; [or]4j;
construct: [a]/kənˈstrʌkt/; [v]建造;作(图);构筑; [n]概念;构筑物;结构体;建造物; [or]4j;
construction: [a]/kənˈstrʌkʃn/; [n]建造;施工;建设;建筑业,建筑物;构造;构思;解释; [or]4j;
consult: [a]/kənˈsʌlt/; [v]请教,咨询;查阅;商量; [or]4j;
consultant: [a]/kənˈsʌltənt/; [n]会诊医师,顾问医生;顾问; [or]4j;
consume: [a]/kənˈsuːm/; [v]消耗,耗尽; [vt]吃光,喝光;毁灭; [or]4j;
consumer: [a]/kənˈsuːmər/; [n]消费者;用户;消耗者; [or]4j;
consumption: [a]/kənˈsʌmpʃn/; [n]消耗,消费,耗尽;肺痨; [or]4j;
contact: [a]/ˈkɑːntækt/; [v]接触;联系; [n]接触;联系; [adj]保持接触的;由接触引起的;<航>可看见地面景物的; [adv]<航>以目力观察(飞行); [int]开动; [or]4j;
contain: [a]/kənˈteɪn/; [vt]包含,容纳; [vi]自制,抑制,克制; [or]4j;
container: [a]/kənˈteɪnər/; [n]容器;集装箱; [or]4j;
contemporary: [a]/kənˈtempəreri/; [adj]同时代的;当代的,现代的; [n]同龄人,同时代的人; [or]4j;
contempt: [a]/kənˈtempt/; [n]轻视,鄙视; [or]4j;
content: [a]/ˈkɑːntent/; [n]内容,目录;满足; [adj]满足的; [v]使满意; [or]4j;
contest: [a]/ˈkɑːntest/; [n]比赛,竞争; [v]争夺,争论; [or]4j;
continent: [a]/ˈkɑːntɪnənt/; [n]大陆,洲; [adj]克制的,禁欲的; [or]4j;
continual: [a]/kənˈtɪnjuəl/; [adj]不断的;连续的;频繁的; [or]4j;
continuity: [a]/ˌkɑːntəˈnuːəti/; [n]连续性;(电影或电视节目中)镜头的连接,衔接; [or]4j;
continuous: [a]/kənˈtɪnjuəs/; [adj]连续的;持续不断的;重复多次的; [or]4j;
contract: [a]/ˈkɑːntrækt/; [n]合同,契约; [v]感染(疾病);招致;订合同;订立(婚约);缩减; [or]4j;
contrary: [a]/ˈkɑːntreri/; [adj]相反的,对立的,矛盾的;叛逆的; [n]相反; [or]4j;
contrast: [a]/ˈkɑːntræst/; [n]差异,对照,对比;对照;对比; [v](with)使与..对比; [or]4j;
contribute: [a]/kənˈtrɪbjuːt/; [v]增进,起促成作用;捐献,捐助;..的原因之一;投稿; [or]4j;
contribution: [a]/ˌkɑːntrɪˈbjuːʃn/; [n]贡献,投稿稿件,捐献物; [or]4j;
controversial: [a]/ˌkɑːntrəˈvɜːrʃl/; [adj]引起争论的,有争议的; [or]4j;
controversy: [a]/ˈkɑːntrəvɜːrsi/; [n]争论,辩论; [or]4j;
convenience: [a]/kənˈviːniəns/; [n]方便;便利设施; [or]4j;
convenient: [a]/kənˈviːniənt/; [adj]方便的;便利的; [or]4j;
convention: [a]/kənˈvenʃn/; [n]会议;习俗;惯例; [or]4j;
conventional: [a]/kənˈvenʃənl/; [adj]普通的,常规的;依照惯例的,依照传统的; [or]4j;
conversation: [a]/ˌkɑːnvərˈseɪʃn/; [n]会话,谈话; [or]4j;
conversely: [a]/kənˈvɜːrsli/; [adv]相反地,反过来; [or]4j;
conversion: [a]/kənˈvɜːrʒn/; [n]转变,转换;宗教,信仰上的转变;<经济学>兑换; [or]4j;
convert: [a]/kənˈvɜːrt/; [v]可转变为,可变换成;改变,转变,转化;使改变信仰; [n]皈依者;改变宗教信仰者; [or]4j;
convey: [a]/kənˈveɪ/; [v]传送,运送;表达,传达; [or]4j;
convict: [a]/ˈkɑːnvɪkt/; [n]犯人; [v](经审讯)证明..有罪,使..知罪; [or]4j;
conviction: [a]/kənˈvɪkʃn/; [n]定罪;信服;坚强信念; [or]4j;
convince: [a]/kənˈvɪns/; [v]使确信;使信服; [or]4j;
cook: [a]/kʊk/; [n]厨师; [v]烹饪; [vi]烹调,煮,烧; [or]4j;
cooperate: [a]/koʊˈɑːpəreɪt/; [v]协作,合作; [or]4j;
cooperation: [a]/koʊˌɑːpəˈreɪʃn/; [n]合作;协力;协作; [or]4j;
cooperative: [a]/koʊˈɑːpərətɪv/; [adj]合作的;协作的; [n]合作社; [or]4j;
coordinate: [a]/koʊˈɔːrdɪneɪt/; [v]使协调,使一致,调整; [n]坐标,同等的人物,配套服装; [adj]并列的;同等的; [or]4j;
cop: [a]/kɑːp/; [n]<口语>警察; [v]抓住,发现(某人)在干坏事;获得;遭受;握住; [or]4j;
copper: [a]/ˈkɑːpər/; [n]铜;铜币;警官;铜色;铜(制); [or]4j;
copyright: [a]/ˈkɑːpiraɪt/; [n]版权,著作权; [or]4j;
cord: [a]/kɔːrd/; [n]细绳,索,(电工学)电绳;索,(电工学)电绳; [or]4j;
core: [a]/kɔːr/; [n]果心;核心,要点; [adj]最重要的;主要的;基本的; [v]挖去果核; [or]4j;
corn: [a]/kɔːrn/; [n]玉米;谷物,谷粒; [v]形成(颗粒状);腌;(用谷物)喂; [or]4j;
corner: [a]/ˈkɔːrnər/; [n]角落;拐角;困境; [v]将..逼入困境; [or]4j;
corporate: [a]/ˈkɔːrpərət/; [adj]公司的;全体的;共同的;(法人)团体的; [or]4j;
corporation: [a]/ˌkɔːrpəˈreɪʃn/; [n]企业,公司;法人(团体); [or]4j;
correct: [a]/kəˈrekt/; [adj]正确的;恰当的,合适的; [v]改正,纠正;矫正;批改; [or]4j;
correspond: [a]/ˌkɔːrəˈspɑːnd/; [v]符合;相符,一致;通信; [or]4j;
correspondence: [a]/ˌkɔːrəˈspɑːndəns/; [n]通信,通信联系;信件,函件;符合,一致;相似; [or]4j;
correspondent: [a]/ˌkɔːrəˈspɑːndənt/; [n]通讯员,记者;通信者; [or]4j;
corresponding: [a]/ˌkɔːrəˈspɑːndɪŋ/; [adj]相应的;符合的,一致的;通信的; [or]4j;
corridor: [a]/ˈkɔːrɪdɔːr/; [n]走廊,长条地带,回廊,通道; [or]4j;
costly: [a]/ˈkɔːstli/; [adj]昂贵的;代价高的;价值高的; [or]4j;
costume: [a]/ˈkɑːstuːm/; [n]服装,剧装; [vt]提供服装;为 ... 设计服装; [adj]服装打扮的; [or]4j;
cottage: [a]/ˈkɑːtɪdʒ/; [n]村舍,小屋;小房子; [or]4j;
council: [a]/ˈkaʊnsl/; [n]议会;理事会;委员会; [or]4j;
counsel: [a]/ˈkaʊnsl/; [n]忠告;律师,法律顾问; [v]劝告,提议; [or]4j;
count: [a]/kaʊnt/; [v]计算;认为;看作;重要,有价值;依赖; [n]计数;总数;计算; [or]4j;
counter: [a]/ˈkaʊntər/; [n]柜台;回击,反击; [v]抵消,抗衡; [adv]相反地; [or]4j;
county: [a]/ˈkaʊnti/; [n]<英国>郡,<美国>县; [or]4j;
court: [a]/kɔːrt/; [n]法院,法庭;庭院;球场;宫廷; [v]讨好,取悦;招致危险;追求; [or]4j;
courtesy: [a]/ˈkɜːrtəsi/; [n]礼貌; [or]4j;
courtyard: [a]/ˈkɔːrtjɑːrd/; [n]庭院,院子; [or]4j;
coverage: [a]/ˈkʌvərɪdʒ/; [n]新闻报道;可达范围;覆盖范围; [or]4j;
cow: [a]/kaʊ/; [n]母牛,奶牛;母兽; [v]恐吓,吓倒; [or]4j;
crack: [a]/kræk/; [v]敲出裂痕,敲破;垮掉;断裂,折断;说(笑话); [n]裂缝;破裂声;挖苦话;强效纯可卡因; [adj]最好的,一流的; [adv]尖锐地; [vi]断裂,折断; [or]4j;
craft: [a]/kræft/; [n]手工艺,手工制品,船,航天器; [v]手工制作,精心制作; [or]4j;
crane: [a]/kreɪn/; [n]起重机,鹤; [v]伸长(脖子)以便看得更清楚; [or]4j;
crash: [a]/kræʃ/; [n]碰撞,坠落,轰隆声; [v]碰撞,坠落,崩溃; [adj]紧急的; [or]4j;
crawl: [a]/krɔːl/; [v]爬,爬行;缓慢行进; [n]缓慢行进;自由式游泳; [or]4j;
crazy: [a]/ˈkreɪzi/; [adj]疯狂的,荒唐的;狂热的,迷恋的;生气的,气愤的; [n]荒唐的人; [adv]疯狂地; [or]4j;
cream: [a]/kriːm/; [n]面霜;奶油,乳脂;奶油色;精英; [v]凝成乳脂,起泡沫; [or]4j;
create: [a]/kriˈeɪt/; [v]创造;引起,产生; [or]4j;
creation: [a]/kriˈeɪʃn/; [n]创造,创作;创造物,作品; [or]4j;
creative: [a]/kriˈeɪtɪv/; [adj]创造性的,创意的,创作的; [n](非正式)创意人士; [or]4j;
creature: [a]/ˈkriːtʃər/; [n]人;生物;动物;工具; [or]4j;
credit: [a]/ˈkredɪt/; [n]信用;荣誉;学分;信贷;称赞;债权; [v]信赖;归因于;记学分; [or]4j;
creep: [a]/kriːp/; [vi]爬行;潜入;蔓延;变形;毛发直竖; [n]卑鄙小人;爬行;变形;毛骨悚然的感觉; [or]4j;
crew: [a]/kruː/; [n](飞机,轮船等的)全体工作人员;一群人; [or]4j;
crime: [a]/kraɪm/; [n]罪行;犯罪;违反道德的行为; [v]判定犯罪;处罚军事犯; [or]4j;
criminal: [a]/ˈkrɪmɪnl/; [n]罪犯; [adj]犯罪的,违法的,刑法的;可耻的; [or]4j;
crisis: [a]/ˈkraɪsɪs/; [n]危机;存亡之际; [or]4j;
critic: [a]/ˈkrɪtɪk/; [n]评论家,批判者;挑剔的人; [or]4j;
critical: [a]/ˈkrɪtɪkl/; [adj]批评的;文艺评论的;爱挑剔的;危急的;关键的,重要的; [or]4j;
criticism: [a]/ˈkrɪtɪsɪzəm/; [n]批评;批判;评论; [or]4j;
criticize: [a]/ˈkrɪtɪsaɪz/; [v]批评,评论,挑剔,责难; [or]4j;
crop: [a]/krɑːp/; [n]作物,庄稼;(谷类等的)一熟收成;一批,大量; [v]收获;啃吃;裁切;突然出现; [or]4j;
cross: [a]/krɔːs/; [adj]易怒的,脾气坏的; [v]穿过;使交叉; [n]十字架,十字物; [or]4j;
crossing: [a]/ˈkrɔːsɪŋ/; [n]人行横道;十字路口;横渡; [or]4j;
crowd: [a]/kraʊd/; [n]人群,一群;民众;朋友; [v]聚集;涌入(脑海);挤满; [or]4j;
crown: [a]/kraʊn/; [n]王冠,冕;王权;花冠; [v]加冕; [or]4j;
crucial: [a]/ˈkruːʃl/; [adj]关键的;决定性的; [or]4j;
crude: [a]/kruːd/; [adj]天然的;粗糙的;粗鲁的;简陋的; [n]原油; [or]4j;
cruel: [a]/ˈkruːəl/; [adj]残忍的,残酷的;伤人的; [or]4j;
cruise: [a]/kruːz/; [n]巡航;漫游;旅行; [v]航游;巡航;(出租车,船等)缓慢巡行; [or]4j;
crush: [a]/krʌʃ/; [vt]压坏;压扁;弄皱;弄碎,压碎;榨出;紧抱;挤入;镇压;欺压; [n]压扁;极度拥挤; [vi]被压坏;被揉皱;蜂拥而来; [or]4j;
crust: [a]/krʌst/; [n]外壳,面包皮,硬外皮; [or]4j;
crystal: [a]/ˈkrɪstl/; [n]水晶,晶体;结晶;水晶做成的东西; [or]4j;
cube: [a]/kjuːb/; [n]立方体,立方; [or]4j;
cubic: [a]/ˈkjuːbɪk/; [adj]立方体的,立体的,立方的;立方的; [or]4j;
cue: [a]/kjuː/; [n]提示;暗号;球杆; [v]给.提示; [or]4j;
cultivate: [a]/ˈkʌltɪveɪt/; [v]耕作,养植,栽培;培养,陶冶,发展; [or]4j;
culture: [a]/ˈkʌltʃər/; [n]文化;文明;修养;栽培; [v]使有教养;培养; [or]4j;
cumulative: [a]/ˈkjuːmjəleɪtɪv/; [adj]渐增的;累积的; [or]4j;
cup: [a]/kʌp/; [n]杯子;(一)杯(的容量);杯状物;杯,杯子;奖杯; [v]拔火罐;窝成杯形;使成杯状;用杯盛;为.拔火罐; [or]4j;
cupboard: [a]/ˈkʌbərd/; [n]碗橱,衣柜,壁橱; [or]4j;
cure: [a]/kjʊr/; [n]对策,措施;治疗,医治; [v]治愈,治疗; [or]4j;
curiosity: [a]/ˌkjʊriˈɑːsəti/; [n]珍品;古董;好奇心; [or]4j;
curious: [a]/ˈkjʊriəs/; [adj]好奇的;好管闲事的;古怪的; [or]4j;
curl: [a]/kɜːrl/; [n]卷毛,卷发; [v]使卷曲; [or]4j;
currency: [a]/ˈkɜːrənsi/; [n]货币;流通;流行; [or]4j;
current: [a]/ˈkɜːrənt/; [adj]当前的,现在的;流动的; [n](电,水,气)流; [or]4j;
curriculum: [a]/kəˈrɪkjələm/; [n]课程,(学校或专业的)全部课程; [or]4j;
curse: [a]/kɜːrs/; [n]诅咒;咒骂;祸因; [v]诅咒;咒骂;使受罪; [or]4j;
curtain: [a]/ˈkɜːrtn/; [n]窗帘;幕(布); [v]装帘子,遮掉; [or]4j;
curve: [a]/kɜːrv/; [v]使弯曲; [n]曲线,弯曲; [adj]弯曲的;曲线形的; [or]4j;
cushion: [a]/ˈkʊʃn/; [n]坐垫; [v]减轻,缓和; [or]4j;
custom: [a]/ˈkʌstəm/; [n]习惯;风俗; [adj]定制的; [or]4j;
customer: [a]/ˈkʌstəmər/; [n]顾客,主顾; [or]4j;
cut: [a]/kʌt/; [v]切,割,剪;减少; [n]伤口;划口;(锋利物留下的)开口;缩减; [or]4j;
cycle: [a]/ˈsaɪkl/; [n]自行车;周期,循环; [v](英)骑自行车;循环; [or]4j;
daily: [a]/ˈdeɪli/; [adj]每日的,日常的; [n]日报; [adv]每日,天天; [or]4j;
dairy: [a]/ˈderi/; [n]牛奶场;乳制品; [adj]牛奶的,奶制的; [or]4j;
dam: [a]/dæm/; [n]水坝;母兽; [v]用水坝阻止;阻塞,抑制; [or]4j;
damage: [a]/ˈdæmɪdʒ/; [v]损害;毁坏; [n]损害;赔偿费; [or]4j;
damn: [a]/dæm/; [int]该死,讨厌; [v]诅咒; [n]诅咒; [adj]该死的;完全的; [adv](表示厌烦)该死;非常; [or]4j;
damp: [a]/dæmp/; [adj]潮湿的,有湿气的; [or]4j;
dangerous: [a]/ˈdeɪndʒərəs/; [adj]有危险的,不安全的,引起危险的; [or]4j;
daring: [a]/ˈderɪŋ/; [adj]勇敢的,大胆的,鲁莽的; [n]勇敢,冒险; [or]4j;
dark: [a]/dɑːrk/; [n]黑暗,暗处;深色; [adj]神秘的;邪恶的;黑暗的,昏暗的;深色的; [or]4j;
darling: [a]/ˈdɑːrlɪŋ/; [n](昵称)亲爱的,宝贝; [adj]惹人喜爱的,迷人的; [or]4j;
dash: [a]/dæʃ/; [vi]猛冲,突进; [v]猛掷; [n]破折号;猛冲; [or]4j;
data: [a]/ˈdeɪtə/; [n]数据;资料; [or]4j;
date: [a]/deɪt/; [n]日期;约会对象;约会;枣子; [v]约会;始于(某一历史时期);给..注明日期,记载日期;确定..的年代; [or]4j;
daughter: [a]/ˈdɔːtər/; [n]女儿; [or]4j;
dawn: [a]/dɔːn/; [n]黎明;开始; [v]破晓; [or]4j;
daylight: [a]/ˈdeɪlaɪt/; [n]日光;白昼;黎明; [or]4j;
deadline: [a]/ˈdedlaɪn/; [n]截止期限,最后期限; [vt]通过设定一时间期限来统治; [or]4j;
deadly: [a]/ˈdedli/; [adj]致命的,致死的,十足的; [adv]死一般地;非常; [or]4j;
deaf: [a]/def/; [adj]聋的;不愿听的; [n]聋子;耳聋的人; [or]4j;
deal: [a]/diːl/; [n]协议;交易,生意;待遇;大量,很多;交易; [v]处理; [adj]冷杉木制的,松木制的; [or]4j;
dear: [a]/dɪr/; [adj]亲爱的;昂贵的; [n]亲爱的人; [int]啊; [or]4j;
debate: [a]/dɪˈbeɪt/; [n]辩论;讨论; [v]辩论;争论;议论; [or]4j;
debt: [a]/det/; [n]债,债务,欠债;人情债; [or]4j;
decade: [a]/ˈdekeɪd/; [n]十年,十年间; [or]4j;
decay: [a]/dɪˈkeɪ/; [v]腐烂;衰退;腐朽; [n]腐烂;衰退;腐败; [or]4j;
deceit: [a]/dɪˈsiːt/; [n]欺骗,欺诈; [or]4j;
deceive: [a]/dɪˈsiːv/; [v]欺骗,行骗; [or]4j;
decent: [a]/ˈdiːsnt/; [adj]体面的;像样的;合宜的;正直的; [or]4j;
decide: [a]/dɪˈsaɪd/; [v]决定,决心,判断; [or]4j;
decision: [a]/dɪˈsɪʒn/; [n]决定;决断力;做决定; [or]4j;
decisive: [a]/dɪˈsaɪsɪv/; [adj]决定性的; [or]4j;
deck: [a]/dek/; [n]甲板,公共汽车一层的车厢,纸牌; [v]装饰;击倒; [or]4j;
declaration: [a]/ˌdekləˈreɪʃn/; [n]宣言,声明书;宣布,宣告;申报; [or]4j;
declare: [a]/dɪˈkler/; [vt]表明;宣布;强调;申报(收益);申报(应纳税品); [vi]板球(在击球员还未全部出局时)宣布结束赛局; [or]4j;
decline: [a]/dɪˈklaɪn/; [n]下降;衰退; [v]<语>使发生词尾变化,使变格;下降;拒绝; [or]4j;
decorate: [a]/ˈdekəreɪt/; [v]装饰,布置;把(勋章)授给(某人); [or]4j;
decrease: [a]/dɪˈkriːs/; [v]减少;减; [n]减;减少; [or]4j;
deduce: [a]/dɪˈduːs/; [v]演绎;推论,推断; [or]4j;
deed: [a]/diːd/; [n]行为;契约; [or]4j;
deepen: [a]/ˈdiːpən/; [v]挖深,使变深;使..变浓;使..更了解;使..变强烈;使..更糟糕; [or]4j;
deer: [a]/dɪr/; [n]鹿; [or]4j;
defeat: [a]/dɪˈfiːt/; [n]挫败;击败,战胜; [v]打败;战胜; [or]4j;
defect: [a]/ˈdiːfekt/; [n]缺陷,缺点,不足之处; [v]背叛,逃跑,开小差; [or]4j;
defend: [a]/dɪˈfend/; [v]防卫,保卫,防守;为..辩护,为..辩解;捍卫,维护; [or]4j;
defense: [a]/dɪ'fens/; [n]防御,防护; [or]4j;
defiance: [a]/dɪˈfaɪəns/; [n]蔑视;反抗;挑战; [or]4j;
deficiency: [a]/dɪˈfɪʃnsi/; [n]缺乏,不足;缺陷; [or]4j;
define: [a]/dɪˈfaɪn/; [v]给(词,短语等)下定义;使明确;规定;下定义,构成释义; [or]4j;
definite: [a]/ˈdefɪnət/; [adj]明确的,肯定的;清楚的,明显的; [or]4j;
definitely: [a]/ˈdefɪnətli/; [adv]一定地,明确地;当然; [or]4j;
definition: [a]/ˌdefɪˈnɪʃn/; [n](轮廓等)清晰;定义,释义; [or]4j;
degree: [a]/dɪˈɡriː/; [n]程度,等级;学位;度;阶层; [or]4j;
delay: [a]/dɪˈleɪ/; [v]耽搁;延迟; [n]耽搁,延期,推迟; [or]4j;
delegate: [a]/ˈdelɪɡət/; [n]代表; [v]委派..为代表,授权; [or]4j;
delegation: [a]/ˌdelɪˈɡeɪʃn/; [n]代表团;委托,授权; [or]4j;
delete: [a]/dɪˈliːt/; [v]删除; [or]4j;
deliberate: [a]/dɪˈlɪbərət/; [adj]故意的;深思熟虑的;从容不迫的; [v]仔细考虑;研讨; [or]4j;
delicate: [a]/ˈdelɪkət/; [adj]易碎的,易坏的,脆弱的;(人)娇弱的,体弱多病的;精美的,精致的,精巧的;微妙的,需要谨慎处理的;优美的,优雅的;柔和的,清淡的,淡雅的; [or]4j;
delicious: [a]/dɪˈlɪʃəs/; [adj]美味的,可口的; [or]4j;
delight: [a]/dɪˈlaɪt/; [n]高兴,愉快;高兴事; [v]使高兴; [or]4j;
deliver: [a]/dɪˈlɪvər/; [v]递送,交付;履行;发表(演讲);分娩;投掷; [or]4j;
delivery: [a]/dɪˈlɪvəri/; [n]陈述,讲演;演讲的姿态;投递,交付,分娩; [or]4j;
demand: [a]/dɪˈmænd/; [n]要求(坚决的),需求; [v]强烈要求,需要; [or]4j;
democracy: [a]/dɪˈmɑːkrəsi/; [n]民主制度;民主国家;民主主义;民众; [or]4j;
democratic: [a]/ˌdeməˈkrætɪk/; [adj]民主的,民主政体的,民主党的; [or]4j;
demonstrate: [a]/ˈdemənstreɪt/; [vt](用实例,实验)论证;演示,展示;示范; [vi]示威; [or]4j;
dense: [a]/dens/; [adj](物质) 密度大的;稠密的,浓密的;愚钝的;难懂的,费解的; [or]4j;
density: [a]/ˈdensəti/; [n]密集,稠密;密度; [or]4j;
dental: [a]/ˈdentl/; [adj]牙齿的,牙科的; [or]4j;
deny: [a]/dɪˈnaɪ/; [v]否认,拒绝承认,拒绝给予,自制; [or]4j;
depart: [a]/dɪˈpɑːrt/; [v]离开;起程;出发;起程;出发;离职; [or]4j;
department: [a]/dɪˈpɑːrtmənt/; [n]部门;系;部; [or]4j;
departure: [a]/dɪˈpɑːrtʃər/; [n]离去,离开,起程;背离;离职;开端; [or]4j;
depend: [a]/dɪˈpend/; [v]依靠,相信,依赖; [or]4j;
dependent: [a]/dɪˈpendənt/; [adj]依赖的;取决于..的; [n]依赖他人者; [or]4j;
deposit: [a]/dɪˈpɑːzɪt/; [v]存款,存放;沉淀; [n]存款,定金;沉积物,矿床; [or]4j;
depress: [a]/dɪˈpres/; [vt]使沮丧;使萧条;压下,压低; [or]4j;
depression: [a]/dɪˈpreʃn/; [n]抑郁,沮丧;不景气,萧条(期);洼地,凹陷; [or]4j;
depth: [a]/depθ/; [n]纵深;深奥,奥妙;深度;深海;最深处; [or]4j;
deputy: [a]/ˈdepjuti/; [n]副手;代表;代表,代理人; [or]4j;
derive: [a]/dɪˈraɪv/; [v]获取;得自;起源; [or]4j;
descend: [a]/dɪˈsend/; [vi]走下;降临; [v]下降,下来;突然访问;下移,下降; [or]4j;
describe: [a]/dɪˈskraɪb/; [v]描述;形容; [or]4j;
description: [a]/dɪˈskrɪpʃn/; [n]描写,形容,叙述;种类,类型; [or]4j;
desert: [a]/ˈdezərt/; [n]沙漠; [v]离开; [or]4j;
deserve: [a]/dɪˈzɜːrv/; [v]值得,应得;应受; [or]4j;
design: [a]/dɪˈzaɪn/; [vt]设计; [n]设计;图样; [vi]设计略图;(为工艺品,装潢项目等)设计;当设计师;构思; [or]4j;
desirable: [a]/dɪˈzaɪərəbl/; [adj]有吸引力的;性感的;令人向往的;令人满意的; [or]4j;
desire: [a]/dɪˈzaɪər/; [n]渴望;欲望;愿望;要求; [vi]有希望,期望,愿望; [vt]希望,渴望;请求,要求; [or]4j;
desk: [a]/desk/; [n]书桌,办公桌;工作台;服务台; [adj]书桌上用的;书桌的; [v]派某人做办公室工作; [or]4j;
despair: [a]/dɪˈsper/; [n]绝望,失望; [v]失望; [or]4j;
desperate: [a]/ˈdespərət/; [adj]绝望的;孤注一掷的;极需要的,渴望的;(情况) 极严重的;极危险的;很危急的; [or]4j;
despise: [a]/dɪˈspaɪz/; [vt]轻视,蔑视,看不起; [or]4j;
dessert: [a]/dɪˈzɜːrt/; [n]甜点; [or]4j;
destination: [a]/ˌdestɪˈneɪʃn/; [n]目的地,终点; [adj]目的地的; [or]4j;
destroy: [a]/dɪˈstrɔɪ/; [v]破坏,消灭,毁灭; [or]4j;
destruction: [a]/dɪˈstrʌkʃn/; [n]破坏,毁灭,灭亡; [or]4j;
destructive: [a]/dɪˈstrʌktɪv/; [adj]破坏(性)的,毁灭(性)的; [or]4j;
detail: [a]/ˈdiːteɪl/; [n]细节;详情;特遣队; [vt]详述;派遣; [or]4j;
detect: [a]/dɪˈtekt/; [v]发现,发觉;侦察,探测; [or]4j;
detection: [a]/dɪˈtekʃn/; [n]察觉;侦察;检测,检验; [or]4j;
detective: [a]/dɪˈtektɪv/; [n]侦探,私人侦探; [adj]侦探的; [or]4j;
determination: [a]/dɪˌtɜːrmɪˈneɪʃn/; [n]决定;确定;决心; [or]4j;
determine: [a]/dɪˈtɜːrmɪn/; [v]确定,决定; [or]4j;
develop: [a]/dɪˈveləp/; [v]生长,发育,发展,开发,显影; [or]4j;
device: [a]/dɪˈvaɪs/; [n]器械,装置,设备;手段,策略; [or]4j;
devise: [a]/dɪˈvaɪz/; [v]设计,想出;密谋;遗赠(不动产); [n]设计,发明,遗赠; [or]4j;
devote: [a]/dɪˈvoʊt/; [vt]奉献;献身于,专心致力于; [or]4j;
diagram: [a]/ˈdaɪəɡræm/; [n]图解,图表; [or]4j;
dial: [a]/ˈdaɪəl/; [v]拨(电话号码);打电话; [n]钟面;仪表盘;拨号盘; [or]4j;
dialect: [a]/ˈdaɪəlekt/; [n]方言;语调; [adj]方言的; [or]4j;
dialog: [a]/ˈdaɪəlɑːɡ/; [n]对话,对白; [v]对话;用对话表达; [or]4j;
diameter: [a]/daɪˈæmɪtər/; [n]直径; [or]4j;
diamond: [a]/ˈdaɪəmənd/; [n]钻石,金刚石;方块牌;菱形;棒球内场; [or]4j;
diary: [a]/ˈdaɪəri/; [n]日记,日志;工作日程登记簿(或台历); [or]4j;
dictate: [a]/ˈdɪkteɪt/; [v]规定;命令;口授;听写; [n]命令;指令; [or]4j;
dictation: [a]/dɪkˈteɪʃn/; [n]口授,口述;听写; [or]4j;
diet: [a]/ˈdaɪət/; [n]日常饮食;(病人或减肥者的)特种饮食;大量; [v]节食; [or]4j;
differ: [a]/ˈdɪfər/; [v]相异,不同;持不同看法,不同意; [or]4j;
different: [a]/ˈdɪfrənt/; [adj]不同的,有差异的;各种的; [or]4j;
difficulty: [a]/ˈdɪfɪkəlti/; [n]困难;难事,难点;经济拮据;障碍;麻烦; [or]4j;
dig: [a]/dɪɡ/; [n]挖,掘; [v]挖掘,翻土; [or]4j;
digest: [a]/daɪˈdʒest/; [v]消化;领会,理解; [n]摘要; [or]4j;
digital: [a]/ˈdɪdʒɪtl/; [adj]数字显示的;数字的,数码的; [n]键;数字仪表,时钟; [or]4j;
diligent: [a]/ˈdɪlɪdʒənt/; [adj]勤奋的;用功的; [or]4j;
dim: [a]/dɪm/; [adj]暗淡的;模糊的;朦胧的; [v]变暗淡; [or]4j;
dimension: [a]/dɪˈmenʃn/; [n]维度;尺寸;尺度;方面; [or]4j;
dine: [a]/daɪn/; [v]吃饭,用餐;招待..吃饭;用正餐(晚餐); [or]4j;
dip: [a]/dɪp/; [v]浸,蘸; [n]倾斜,下降;调味汁; [or]4j;
diplomatic: [a]/ˌdɪpləˈmætɪk/; [adj]外交的,从事外交的;老练的,圆滑的; [or]4j;
direct: [a]/dəˈrekt/; [adj]直达的;笔直的;直接的;率直的; [vt]指导,引导;管理;引路,当向导;导演; [vi]指导;导演;领唱; [adv]直接地,径直地; [or]4j;
direction: [a]/dəˈrekʃn/; [n]方向,方位;指令,说明; [or]4j;
director: [a]/dəˈrektər/; [n]导演;指导者;主管;董事; [or]4j;
dirt: [a]/dɜːrt/; [n]灰尘,泥土,污垢;丑事,丑行; [or]4j;
disadvantage: [a]/ˌdɪsədˈvæntɪdʒ/; [n]不利,不利地位;弱点;弊端; [v]使不利; [or]4j;
disagree: [a]/ˌdɪsəˈɡriː/; [v]不同意,反对,(意见)有分歧;(有关同一事件或形势的陈述,数字或报道)不一致,不相符; [or]4j;
disappear: [a]/ˌdɪsəˈpɪr/; [v]消失,失踪;灭绝,消亡; [or]4j;
disappoint: [a]/ˌdɪsəˈpɔɪnt/; [v]使失望,使扫兴,使受挫折; [or]4j;
disaster: [a]/dɪˈzæstər/; [n]灾难,天灾; [or]4j;
disastrous: [a]/dɪˈzæstrəs/; [adj]灾难性的; [or]4j;
disc: [a]/dɪsk/; [n]唱片;<计> 磁盘,磁碟片;椎间盘;圆盘,盘状物; [or]4j;
discard: [a]/dɪsˈkɑːrd/; [v]丢弃;抛弃;遗弃; [or]4j;
discharge: [a]/dɪsˈtʃɑːrdʒ/; [n]发射;释放;解雇;放电; [v]卸掉负担;发射;放电;卸(货);使爆炸;履行;解雇;允许.离开;排出,放出;清偿(债务); [or]4j;
discipline: [a]/ˈdɪsəplɪn/; [n]纪律;学科;训练; [v]训练;惩罚;管制; [or]4j;
disclose: [a]/dɪsˈkloʊz/; [v]公开,揭露,泄露; [or]4j;
discount: [a]/ˈdɪskaʊnt/; [n](价格,债款等)折扣; [v]打折扣,不全信,怀疑地看待; [or]4j;
discourage: [a]/dɪsˈkɜːrɪdʒ/; [v]阻止;使泄气,使失去信心; [or]4j;
discovery: [a]/dɪˈskʌvəri/; [n]发现;被发现的事物; [or]4j;
discuss: [a]/dɪˈskʌs/; [v]讨论;论述; [or]4j;
discussion: [a]/dɪˈskʌʃn/; [n]讨论,谈论;论述; [or]4j;
disease: [a]/dɪˈziːz/; [n]疾病; [or]4j;
disguise: [a]/dɪsˈɡaɪz/; [v]伪装;掩饰; [n]伪装物;伪装; [or]4j;
disgust: [a]/dɪsˈɡʌst/; [v]使作呕,使厌恶; [n]恶心; [or]4j;
dishonour: [a]/dɪsˈɑːnər/; [n]失去名誉;不光彩,耻辱;丢脸的人;无礼; [v]使受耻辱;不遵守;奸污; [or]4j;
disk: [a]/dɪsk/; [n]圆盘,唱片;磁盘; [or]4j;
dislike: [a]/dɪsˈlaɪk/; [v]不喜欢,厌恶; [n]不喜欢,厌恶; [or]4j;
dismiss: [a]/dɪsˈmɪs/; [v]开除;解散;摒除,不再考虑; [or]4j;
disorder: [a]/dɪsˈɔːrdər/; [n]混乱;紊乱;动乱; [vt]使混乱;使紊乱; [or]4j;
display: [a]/dɪˈspleɪ/; [v]展示;显示;陈列; [n]表现,流露,展示;显示,显示器;陈列品; [or]4j;
displease: [a]/dɪsˈpliːz/; [v]使不愉快,使生气; [or]4j;
disposal: [a]/dɪˈspoʊzl/; [n]销毁,丢掉,处理; [adj]处理(或置放)废品的; [or]4j;
dispose: [a]/dɪˈspoʊz/; [v]处理,处置,除去;使愿意; [or]4j;
dispute: [a]/dɪˈspjuːt/; [n]争论,争端; [v]争执,驳斥; [or]4j;
dissatisfy: [a]/dɪsˈsætɪsˌfaɪ/; [v]使不满; [or]4j;
dissolve: [a]/dɪˈzɑːlv/; [v]使溶解;废除,使解散; [or]4j;
distance: [a]/ˈdɪstəns/; [n]距离;间距;远处; [or]4j;
distant: [a]/ˈdɪstənt/; [adj]遥远的;远方的;疏远的; [or]4j;
distinct: [a]/dɪˈstɪŋkt/; [adj]截然不同的;独特的;明显的;清晰的; [or]4j;
distinction: [a]/dɪˈstɪŋkʃn/; [n]差别,区分;优秀,卓越,杰出;特性,独特,不同凡响;优等评分,荣誉分数,殊荣; [or]4j;
distinguish: [a]/dɪˈstɪŋɡwɪʃ/; [v]区别,识别,辨别,使显著; [or]4j;
distract: [a]/dɪˈstrækt/; [v]使分心,转移(注意力),分散(思想); [or]4j;
distress: [a]/dɪˈstres/; [n]悲伤,疼痛;痛苦,焦虑;困难,困境; [adj]受灾的;受灾造成的,焦虑的; [v]使痛苦,使焦急;因紧张而困恼;使困苦;迫使; [or]4j;
distribute: [a]/dɪˈstrɪbjuːt/; [v]分发,分配,配送;散布; [or]4j;
distribution: [a]/ˌdɪstrɪˈbjuːʃn/; [n]分布;分配;分发;散布; [or]4j;
district: [a]/ˈdɪstrɪkt/; [n]地区;区域; [vt]把..划分成区; [or]4j;
disturb: [a]/dɪˈstɜːrb/; [v]打扰,妨碍;弄乱;使烦恼; [or]4j;
ditch: [a]/dɪtʃ/; [n]沟,沟渠; [v]迫降海上; [vt]丢弃;旷课; [or]4j;
dive: [a]/daɪv/; [n]跳水;潜水;俯冲;骤降; [vi]跳水;潜水;俯冲;急剧下降; [or]4j;
diverse: [a]/daɪˈvɜːrs/; [adj]不同的,差异的,多种多样的; [or]4j;
divide: [a]/dɪˈvaɪd/; [v]分开,划分;分配;除;产生分歧;分岔;分裂; [n]差异;分水岭; [or]4j;
divine: [a]/dɪˈvaɪn/; [adj]神的,神圣的;极好的; [v](凭直觉)发现,猜到; [n]神学家;圣职人员;教士;上帝; [or]4j;
division: [a]/dɪˈvɪʒn/; [n]分,分配,除法,部门,分裂; [or]4j;
divorce: [a]/dɪˈvɔːrs/; [n]离婚,离异; [v]离婚; [or]4j;
dock: [a]/dɑːk/; [n]码头;船埠;被告席; [v](船)进港;扣工资;剪短(动物的尾巴); [or]4j;
document: [a]/ˈdɑːkjumənt/; [n]文件,公文;(计算机的)文档; [v]记录;证明; [or]4j;
dog: [a]/dɔːɡ/; [n]狗,犬,犬科动物; [v](灾难等)缠住;跟踪;尾随; [or]4j;
doll: [a]/dɑːl/; [n]玩具娃娃,玩偶; [or]4j;
domestic: [a]/dəˈmestɪk/; [adj]国产的;国内的;家庭的;驯养的; [n]家仆;家庭纷争; [or]4j;
dominant: [a]/ˈdɑːmɪnənt/; [adj]主要的,占优势的,支配的,统治的;显性基因的; [or]4j;
dominate: [a]/ˈdɑːmɪneɪt/; [v]在.中占首要地位;支配,统治,控制;耸立于,俯视;处于支配地位,拥有优势; [or]4j;
donate: [a]/ˈdoʊneɪt/; [v]捐献;捐赠; [vi]捐献;捐赠; [or]4j;
donation: [a]/doʊˈneɪʃn/; [n]捐款;捐赠物; [or]4j;
donkey: [a]/ˈdɔːŋki/; [n]驴;傻瓜; [or]4j;
door: [a]/dɔːr/; [n]门;门口,通道;建筑物; [or]4j;
dorm: [a]/dɔːrm/; [n](集体)宿舍; [or]4j;
dormitory: [a]/ˈdɔːrmətɔːri/; [n]宿舍楼 <美国英语>;宿舍,学生宿舍; [adj]住宅区的; [or]4j;
dose: [a]/doʊs/; [n](药)剂量,用量,一剂; [vt]给..服药; [or]4j;
dot: [a]/dɑːt/; [n]点,圆点; [v]点缀,作小点记号; [or]4j;
doubt: [a]/daʊt/; [n]怀疑;疑虑; [v]怀疑; [or]4j;
doubtful: [a]/ˈdaʊtfl/; [adj]怀疑的,疑惑的; [or]4j;
doubtless: [a]/ˈdaʊtləs/; [adv]无疑地;肯定地; [adj]无疑的;肯定的; [or]4j;
downtown: [a]/ˈdaʊntaʊn/; [adj]商业区的,闹市区的; [adv]在商业区,在市中心; [n]市中心区,市中心; [or]4j;
downward: [a]/ˈdaʊnwərd/; [adv]向下; [adj]向下的,下降的; [or]4j;
dozen: [a]/ˈdʌzn/; [n]一打,十二个;一打的;十二个的; [or]4j;
draft: [a]/dræft/; [n]气流;通风,通风装置;草稿;汇票;征兵; [v]起草;征兵; [or]4j;
drag: [a]/dræɡ/; [v]拉,拽,拖着(沉重的步伐或疲惫的身躯);拖动,拖沓; [n]拖,拖累物; [adj]女穿男服的;男穿女服的; [adv]带有女伴; [or]4j;
dragon: [a]/ˈdræɡən/; [n]龙,凶恶的女人; [or]4j;
drain: [a]/dreɪn/; [vi]排出,排水; [v]流干,沥干;喝光,耗尽,减少,消逝; [vt]使流出,排掉水; [n]下水道,排水管;消耗,排水; [or]4j;
drama: [a]/ˈdrɑːmə/; [n]戏剧,戏剧性场面(情景);激情; [or]4j;
dramatic: [a]/drəˈmætɪk/; [adj]戏剧的,戏剧性的;引人注目的;逼真的,刺激的; [or]4j;
draught: [a]/dræft/; [n]气流,通风,穿堂风;药水; [v]起草;选派; [adj]桶装的;驮物的; [or]4j;
draw: [a]/drɔː/; [v]画;拉;吸引; [n]平局; [or]4j;
drawer: [a]/drɔːr/; [n]抽屉; [or]4j;
drawing: [a]/ˈdrɔːɪŋ/; [n]绘图,图样; [or]4j;
dread: [a]/dred/; [v]惧怕,害怕; [n]畏惧,恐惧; [adj]恐怖的,使人敬畏的; [or]4j;
drift: [a]/drɪft/; [v]漂流;游荡;使漂流;使堆积; [n]漂流;漂流物;趋势;主旨;漂移; [or]4j;
drill: [a]/drɪl/; [n]训练;反复操练;钻头; [v]在..上钻孔;钻孔; [or]4j;
drip: [a]/drɪp/; [v]滴水,溢出; [n]水滴,滴水声; [or]4j;
drive: [a]/draɪv/; [v]驾车;驱使; [n]驾车旅行;驾车路程;强烈欲望;动力,干劲;驱动器; [or]4j;
drop: [a]/drɑːp/; [v]使落下;降低,落下; prep. 顺道拜访(drop by); [n]下降;滴剂;滴状物;下落物;随口说出;写;略去;放弃;输掉; [or]4j;
drought: [a]/draʊt/; [n]干旱,旱灾; [or]4j;
drown: [a]/draʊn/; [v]淹死;淹没; [or]4j;
drum: [a]/drʌm/; [v]击鼓;连续敲击; [n]鼓;圆桶; [or]4j;
drunk: [a]/drʌŋk/; [adj]喝醉了的;陶醉的,兴奋的; [n]酗酒者;醉酒;狂欢; [or]4j;
due: [a]/duː/; [adv]直接地,确切地; [adj]拖欠的;到期的,预期的;应得的;由于;适当的; [n]会费;应有的权利,应得到的东西; [or]4j;
dull: [a]/dʌl/; [adj]愚笨的,迟钝的;枯燥的,沉闷的;不清晰的,吵闹的; [v]缓和;减轻;使阴暗; [or]4j;
dumb: [a]/dʌm/; [adj]哑的,暂不说话的,愚笨的; [v]使沉默; [or]4j;
dump: [a]/dʌmp/; [v]倾倒,丢弃;抛弃(某人); [n]垃圾场,废物堆;军需品临时堆放的地方; [or]4j;
durable: [a]/ˈdʊrəbl/; [adj]耐用的,长久的; [n]耐用品; [or]4j;
duration: [a]/duˈreɪʃn/; [n]持续;持续期间;持续的时间; [or]4j;
during: [a]/ˈdʊrɪŋ/; prep. 在.期间,在.过程中; [or]4j;
dusk: [a]/dʌsk/; [n]薄暮,黄昏; [v](天)变黑;变暗; [or]4j;
dust: [a]/dʌst/; [n]尘土,灰尘; [vi]掸尘;涂上粉末; [vt]掸掉,擦去;使成粉末; [v]擦去.的灰尘; [or]4j;
dwelling: [a]/ˈdwelɪŋ/; [n]住所; [or]4j;
dye: [a]/daɪ/; [v]染,染色; [n]染料,染色; [or]4j;
dying: [a]/ˈdaɪɪŋ/; [adj]垂死的,临终的; [n]垂死者;临终者; [or]4j;
dynamic: [a]/daɪˈnæmɪk/; [adj]有活力的,有生气的;不断变化的;动态的; [n]活力,动力; [or]4j;
eager: [a]/ˈiːɡər/; [adj]热切的,渴望的,急不可耐的; [or]4j;
eagle: [a]/ˈiːɡl/; [n]鹰,老鹰;鹰状标志;(高尔夫球赛中)少击两棒入穴的成绩; [vt](高尔夫球赛中)比标准杆数少击两杆入; [or]4j;
ear: [a]/ɪr/; [n]耳朵;听力,听觉;穗; [or]4j;
earn: [a]/ɜːrn/; [v]赚得,挣得,获得; [or]4j;
earnest: [a]/ˈɜːrnɪst/; [adj]真诚的,诚挚的,认真的; [n]认真,严肃; [or]4j;
earthquake: [a]/ˈɜːrθkweɪk/; [n]地震; [or]4j;
ease: [a]/iːz/; [n]安逸;容易;不拘束; [v]解除痛苦;缓解;顺利进出; [or]4j;
eastern: [a]/ˈiːstərn/; [adj]东方的,东部的,朝东的; [n]东方人;(美国)东部地区的人;东正教信徒; [or]4j;
eastward: [a]/ˈiːstwərd/; [adv]向东; [adj]向东的; [or]4j;
economic: [a]/ˌekəˈnɑːmɪk/; [adj]经济上的,经济学的;合算的;有利可图的; [or]4j;
economical: [a]/ˌekəˈnɑːmɪkl/; [adj]节约的;经济的;合算的; [or]4j;
economics: [a]/ˌekəˈnɑːmɪks/; [n]经济学;经济情况;经济; [or]4j;
economy: [a]/ɪˈkɑːnəmi/; [n]经济,经济制度;节约; [or]4j;
edge: [a]/edʒ/; [n](悬崖,峭壁的)边缘;边缘;锋利,尖锐;刀口,刃;优势; [v]徐徐移动;给.开刃,使锐利; [or]4j;
edit: [a]/ˈedɪt/; [v]剪辑;编辑;校订; [n]编辑<校订>工作; [or]4j;
edition: [a]/ɪˈdɪʃn/; [n]版,版本,版次; [or]4j;
editor: [a]/ˈedɪtər/; [n]编辑;主编; [or]4j;
editorial: [a]/ˌedɪˈtɔːriəl/; [adj]编辑的,编者的; [n](报刊的)社论; [or]4j;
educate: [a]/ˈedʒukeɪt/; [v]教育,培养,训练; [or]4j;
effect: [a]/ɪˈfekt/; [n]效果;影响;印象;所有物; [v]使发生,引起;产生; [or]4j;
effective: [a]/ɪˈfektɪv/; [adj]有效的,有影响的;实际的;生效的; [or]4j;
efficiency: [a]/ɪˈfɪʃnsi/; [n]效率;功效;功率;性能; [or]4j;
efficient: [a]/ɪˈfɪʃnt/; [adj]效率高的;有能力的;能胜任的; [or]4j;
effort: [a]/ˈefərt/; [n]努力;成就; [or]4j;
egg: [a]/eɡ/; [n]蛋;鸡蛋;卵; [vt]用蛋覆盖;向..扔蛋; [or]4j;
eight: [a]/eɪt/; [num]八;八个; [n]八个;八点; [or]4j;
eighteen: [a]/ˌeɪˈtiːn/; [num]十八,十八个;十八; [or]4j;
eighth: [a]/eɪtθ/; [num]第八; [n]八分之一; [or]4j;
eighty: [a]/ˈeɪti/; [num]八十,八十个; [adj]八十的; [n]八十; [or]4j;
elaborate: [a]/ɪˈlæbəreɪt/; [adj]精心设计的,精巧的;复杂的; [v]详细说明,详尽阐述; [vt]变得复杂; [or]4j;
elastic: [a]/ɪˈlæstɪk/; [adj]有弹性的;可伸缩的,(系统或计划)灵活的;弹力材料制成的; [n]松紧带,橡皮圈; [or]4j;
elbow: [a]/ˈelboʊ/; [n]手肘;衣服肘部; [v]用肘推,挤; [or]4j;
elderly: [a]/ˈeldərli/; [adj]年老的,年长的;上年纪的人; [or]4j;
elect: [a]/ɪˈlekt/; [v]选举,推选;选择; [adj]精选的,选出的;当选的; [n]被选的人;上帝的选民; [or]4j;
election: [a]/ɪˈlekʃn/; [n]选举,选择权;当选; [or]4j;
electric: [a]/ɪˈlektrɪk/; [adj]电的,电动的,带电的;刺激的; [n]供电; [or]4j;
electrical: [a]/ɪˈlektrɪkl/; [adj]有关电的;电气科学的; [or]4j;
electricity: [a]/ɪˌlekˈtrɪsəti/; [n]电,电力;电流;电学; [or]4j;
electron: [a]/ɪˈlektrɑːn/; [n]电子; [or]4j;
electronic: [a]/ɪˌlekˈtrɑːnɪk/; [adj]电子的;电子学的;电子操控的;电子设备的; [or]4j;
elegant: [a]/ˈelɪɡənt/; [adj]优美的,文雅的,漂亮雅致的,陈设讲究的; [or]4j;
element: [a]/ˈelɪmənt/; [n]元素;成分;要素;电炉,热水器等的电热元件,电热丝; [or]4j;
elementary: [a]/ˌelɪˈmentri/; [adj]基本的;初级的;非常简单的; [or]4j;
elevator: [a]/ˈelɪveɪtər/; [n]电梯;起重机;升降舵;粮库; [or]4j;
eleven: [a]/ɪˈlevn/; [num]十一,十一个; [n]由十一人组成的足球队,棒球队等;十一个一组; [adj]十一的; pro[n]十一个; [or]4j;
eliminate: [a]/ɪˈlɪmɪneɪt/; [v]消灭,铲除;消除,根除;(在比赛中)淘汰; [or]4j;
else: [a]/els/; [adv]别的;其他的; [n]<女名>女子名; [or]4j;
elsewhere: [a]/ˌelsˈwer/; [adv]在别处,向别处; [or]4j;
email: [a]/ˈiːmeɪl/; [n]电子信函; [or]4j;
embarrass: [a]/ɪmˈbærəs/; [vt]使窘迫,使尴尬(尤指在社交场合);困窘,困扰; [or]4j;
embassy: [a]/ˈembəsi/; [n]大使馆;大使馆全体人员; [or]4j;
embrace: [a]/ɪmˈbreɪs/; [v]拥抱;包含;欣然接受,乐意采纳; [n]拥抱;接受;领会; [or]4j;
emerge: [a]/iˈmɜːrdʒ/; [v]冲出,冒出;浮现;出现; [or]4j;
emergency: [a]/iˈmɜːrdʒənsi/; [n]紧急情况;突发事件; [or]4j;
emit: [a]/iˈmɪt/; [v]发表;散发;发射,发出; [or]4j;
emotion: [a]/ɪˈmoʊʃn/; [n]感情;情绪;强烈的感情;激动; [or]4j;
emotional: [a]/ɪˈmoʊʃənl/; [adj]感情的,情绪的;沮丧的,哀伤的;令人激动的; [or]4j;
emperor: [a]/ˈempərər/; [n]皇帝; [or]4j;
emphasis: [a]/ˈemfəsɪs/; [n]强调;重点;重要性; [or]4j;
emphasise: [a]/ˈemfəsaɪz/; [v]强调;着重,重读(单词或短语);使突出,使明显; [or]4j;
emphasize: [a]/ˈemfəsaɪz/; [v]强调;着重;使突出; [or]4j;
empire: [a]/ˈempaɪər/; [n]帝国,(由个人或集团控制的)大企业; [adj]新古典风格的; [or]4j;
employ: [a]/ɪmˈplɔɪ/; [v]雇用;雇佣;使忙于;使用;用于.; [n]受雇;职业;使用; [or]4j;
employee: [a]/ɪmˈplɔɪiː/; [n]受雇者,雇员,雇工,职员; [or]4j;
employer: [a]/ɪmˈplɔɪər/; [n]雇主,老板; [or]4j;
employment: [a]/ɪmˈplɔɪmənt/; [n]职业;雇佣;就业;运用; [or]4j;
empty: [a]/ˈempti/; [adj]空的,空洞的; [v]倒空,使成为空的; [or]4j;
enable: [a]/ɪˈneɪbl/; [v]使能够,使可能; [or]4j;
enclose: [a]/ɪnˈkloʊz/; [v]围住;圈起;装入信封;附有; [or]4j;
encounter: [a]/ɪnˈkaʊntər/; [v]邂逅,遭遇,偶遇; [n]偶然碰见,遭遇; [or]4j;
encourage: [a]/ɪnˈkɜːrɪdʒ/; [v]鼓励,支持;促使;怂恿; [or]4j;
ending: [a]/ˈendɪŋ/; [n]结尾,结局,末尾; [or]4j;
endless: [a]/ˈendləs/; [adj]无止境的;没完没了的;连续的;循环的;漫无目的的; [or]4j;
endurance: [a]/ɪnˈdʊrəns/; [n]忍耐力,耐性,耐用度; [or]4j;
endure: [a]/ɪnˈdʊr/; [v]忍受;持久;持续;容忍; [or]4j;
enemy: [a]/ˈenəmi/; [n]敌人;敌国;敌军;危害物; [or]4j;
energetic: [a]/ˌenərˈdʒetɪk/; [adj]精力充沛的,充满活力的;有力的,积极的; [or]4j;
enforce: [a]/ɪnˈfɔːrs/; [v]实施;执行;强制; [or]4j;
engage: [a]/ɪnˈɡeɪdʒ/; [vt]吸引住(注意力,兴趣);雇,聘; [vi]使加入,使融入;订婚; [v](军队)交战;啮合; [or]4j;
engine: [a]/ˈendʒɪn/; [n]引擎;发动机; [v]给..装引擎; [or]4j;
engineer: [a]/ˌendʒɪˈnɪr/; [n]工程师;技师;火车司机;技工; [v]设计;建造;当工程师;计划; [or]4j;
engineering: [a]/ˌendʒɪˈnɪrɪŋ/; [n]工程,工程方面;工程学;工程;工程师行业;管理,操纵; [or]4j;
enhance: [a]/ɪnˈhæns/; [v]提高(强度,力量,数量等);增加,加强; [or]4j;
enlarge: [a]/ɪnˈlɑːrdʒ/; [v]扩大,扩展,放大; [or]4j;
enormous: [a]/ɪˈnɔːrməs/; [adj]极大的,极大量的;巨大的;庞大的; [or]4j;
enrich: [a]/ɪnˈrɪtʃ/; [v]使丰富;使富裕; [or]4j;
enroll: [a]/ɪnˈroʊl/; [v]入学,加入,登记,入伍; [or]4j;
ensure: [a]/ɪnˈʃʊr/; [v]确保,保证; [or]4j;
enterprise: [a]/ˈentərpraɪz/; [n]企业(或事业)单位,公司;事业;事业心; [or]4j;
entertain: [a]/ˌentərˈteɪn/; [v]招待,款待;使娱乐;使欢乐;考虑,准备考虑;心存; [or]4j;
entertainment: [a]/ˌentərˈteɪnmənt/; [n]娱乐;招待,款待; [or]4j;
enthusiasm: [a]/ɪnˈθuːziæzəm/; [n]热情,热心,热忱;热衷的活动,热爱的事物; [or]4j;
enthusiastic: [a]/ɪnˌθuːziˈæstɪk/; [adj]狂热的,极感兴趣的,热情的; [or]4j;
entire: [a]/ɪnˈtaɪər/; [adj]全部的,完整的,整个的; [n]全部,整体; [or]4j;
entitle: [a]/ɪnˈtaɪtl/; [v]给(书)题名;给予.权利; [or]4j;
entrance: [a]/ˈentrəns/; [n]入口,通道,大门口;出场,登场;进入权; [v]使出神,使入迷; [or]4j;
entry: [a]/ˈentri/; [n]入口处;登记;进入; [or]4j;
envelope: [a]/ˈenvəloʊp/; [n]信封;包装物,外壳,膜;气囊; [or]4j;
environment: [a]/ɪnˈvaɪrənmənt/; [n]环境;外界;工作平台; [or]4j;
envy: [a]/ˈenvi/; [n]妒忌;妒忌的对象; [v]嫉妒,羡慕; [or]4j;
episode: [a]/ˈepɪsoʊd/; [n]插曲,片断;连续剧的一集;一段经历; [or]4j;
equal: [a]/ˈiːkwəl/; [adj]相等的;平等的; [v]等于;比得上; [n]对手; [or]4j;
equality: [a]/iˈkwɑːləti/; [n]同等,平等;<数>等式; [or]4j;
equation: [a]/ɪˈkweɪʒn/; [n]方程(式),等式;相等,均衡; [or]4j;
equip: [a]/ɪˈkwɪp/; [v]装备;具备; [or]4j;
equipment: [a]/ɪˈkwɪpmənt/; [n]设备;装备,装置; [or]4j;
equivalent: [a]/ɪˈkwɪvələnt/; [adj]相等的;等值的; [n]同义词;等价物; [or]4j;
era: [a]/ˈɪrə/; [n]时代,年代;纪元; [or]4j;
erect: [a]/ɪˈrekt/; [v]搭建,竖起;建造,建立; [adj]直立的,垂直的; [or]4j;
erosion: [a]/ɪˈroʊʒn/; [n]侵蚀;腐蚀;磨损;削弱;减少; [or]4j;
error: [a]/ˈerər/; [n]错误,过失; [or]4j;
escape: [a]/ɪˈskeɪp/; [v]逃跑,避开,避免;泄露; [n]逃跑,逃脱; [or]4j;
essay: [a]/ˈeseɪ/; [n]文章;论文;尝试;随笔; [v]尝试; [or]4j;
essential: [a]/ɪˈsenʃl/; [adj]必不可少的,必要的;本质的;重要的;基本的; [n]要素;必需品; [or]4j;
establish: [a]/ɪˈstæblɪʃ/; [v]建立;确立;使安全;使成为; [or]4j;
establishment: [a]/ɪˈstæblɪʃmənt/; [n]团体,公司;权威人士;建立,创立,确立; [or]4j;
estate: [a]/ɪˈsteɪt/; [n]地产,(上有大片建筑物的)土地,住宅,财产,遗产; [or]4j;
estimate: [a]/ˈestɪmət/; [v]估价,估计,评价; [n]估计,评价; [or]4j;
eternal: [a]/ɪˈtɜːrnl/; [adj]永恒的,永不改变的; [or]4j;
ethnic: [a]/ˈeθnɪk/; [adj]种族的,少数民族的; [n]少数民族成员;人种学; [or]4j;
evaluate: [a]/ɪˈvæljueɪt/; [v]评价;评估; [or]4j;
evaporate: [a]/ɪˈvæpəreɪt/; [v]蒸发,失去水分;消失; [or]4j;
eve: [a]/iːv/; [n](节日等的)前夜,前夕; [or]4j;
event: [a]/ɪˈvent/; [n]事件,大事;社交活动;比赛项目; [or]4j;
eventually: [a]/ɪˈventʃuəli/; [adv]终于,最后; [or]4j;
everybody: [a]/ˈevribɑːdi/; pro[n]每人,人人; [or]4j;
everyday: [a]/ˈevrideɪ/; [adj]日常的,每天的; [or]4j;
everyone: [a]/ˈevriwʌn/; pro[n]每个人,人人; [n]每个人,人人; [or]4j;
everywhere: [a]/ˈevriwer/; [adv]到处,处处; [n]每个地方; [or]4j;
evidence: [a]/ˈevɪdəns/; [v]证明; [n]证据,证明;证物,证词; [or]4j;
evident: [a]/ˈevɪdənt/; [adj]显然的,明显的,明白的; [or]4j;
evidently: [a]/ˈevɪdəntli/; [adv]显然地;证据确凿地; [or]4j;
evil: [a]/ˈiːvl/; [adj]邪恶的,罪恶的; [n]邪恶,罪恶; [or]4j;
evolution: [a]/ˌevəˈluːʃn/; [n]进化,演变;发展; [or]4j;
evolve: [a]/iˈvɑːlv/; [v]使进化;使发展; [or]4j;
exact: [a]/ɪɡˈzækt/; [adj]确切的,精密严谨的; [v]强求; [or]4j;
exaggerate: [a]/ɪɡˈzædʒəreɪt/; [vi]夸张; [vt]夸大,夸张;使扩大; [or]4j;
examine: [a]/ɪɡˈzæmɪn/; [v]检查,细查;对..进行考试; [or]4j;
exceed: [a]/ɪkˈsiːd/; [v]超过;胜过;超出; [or]4j;
exceedingly: [a]/ɪkˈsiːdɪŋli/; [adv]过分地;非常; [or]4j;
except: [a]/ɪkˈsept/; prep. 除..之外; [v]把..除外; [conj]除.以外; [or]4j;
exception: [a]/ɪkˈsepʃn/; [n]例外(的人或事),除外; [or]4j;
excess: [a]/ɪkˈses/; [adj]额外的,过量的,过度的,附加的; [n]超越,超过,过度; [or]4j;
excessive: [a]/ɪkˈsesɪv/; [adj]过多的; [or]4j;
exchange: [a]/ɪksˈtʃeɪndʒ/; [v]交换,互换;交流;进行易货贸易; [n]交换;交易所;(货币的)兑换; [or]4j;
excite: [a]/ɪkˈsaɪt/; [v]使激动,使兴奋;引起,激起; [or]4j;
excitement: [a]/ɪkˈsaɪtmənt/; [n]刺激,激动; [or]4j;
exciting: [a]/ɪkˈsaɪtɪŋ/; [adj]令人兴奋的;使人激动的; [or]4j;
exclaim: [a]/ɪkˈskleɪm/; [v]呼叫,惊叫; [or]4j;
exclude: [a]/ɪkˈskluːd/; [vt]不包括;排挤;排除;驱逐,赶出; [or]4j;
exclusive: [a]/ɪkˈskluːsɪv/; [adj]独有的;奢华的;排外的; [n]独家新闻; [or]4j;
exclusively: [a]/ɪkˈskluːsɪvli/; [adv]专门地;特定地;排外地;仅仅; [or]4j;
excursion: [a]/ɪkˈskɜːrʒn/; [n]远足;短途旅行; [or]4j;
execute: [a]/ˈeksɪkjuːt/; [v]处决;完成(动作);实行;执行(计划); [or]4j;
executive: [a]/ɪɡˈzekjətɪv/; [n]执行者;经理;行政人员; [adj]执行的; [or]4j;
exercise: [a]/ˈeksərsaɪz/; [v]运动;锻炼;行使,运用; [n]操练,运动;习题; [or]4j;
exert: [a]/ɪɡˈzɜːrt/; [v]尽(力),运用,发挥; [or]4j;
exhaust: [a]/ɪɡˈzɔːst/; [v]使筋疲力尽;耗尽;详尽论述; [n]排气装置;废气; [or]4j;
exhibit: [a]/ɪɡˈzɪbɪt/; [n]展览会,陈列品; [v]展览,陈列; [or]4j;
exhibition: [a]/ˌeksɪˈbɪʃn/; [n]展览,展览会;陈列;奖学金; [or]4j;
exist: [a]/ɪɡˈzɪst/; [v]生存,生活;存在; [or]4j;
existence: [a]/ɪɡˈzɪstəns/; [n]存在;生活方式; [or]4j;
exit: [a]/ˈeksɪt/; [n]出口;退场; [v]退出; [or]4j;
expand: [a]/ɪkˈspænd/; [v]膨胀;扩大; [vt]详细展开; [or]4j;
expansion: [a]/ɪkˈspænʃn/; [n]扩大,扩充,扩张,膨胀; [or]4j;
expect: [a]/ɪkˈspekt/; [v]期待;指望;预计; [or]4j;
expectation: [a]/ˌekspekˈteɪʃn/; [n]期望;预期,期待;可能性; [or]4j;
expedition: [a]/ˌekspəˈdɪʃn/; [n]远征队;探险;短途旅行;迅速; [or]4j;
expense: [a]/ɪkˈspens/; [n]开销,开支;花费,费用;代价; [or]4j;
experience: [a]/ɪkˈspɪriəns/; [n]经历,感受,体验,经验; [v]体验,感受;经历; [or]4j;
experiment: [a]/ɪkˈsperɪmənt/; [n]试验; [v](on)进行实验; [or]4j;
experimental: [a]/ɪkˌsperɪˈmentl/; [adj]实验的,试验的;科学实验的; [or]4j;
expert: [a]/ˈekspɜːrt/; [n]专家; [adj]熟练的,专业的; [or]4j;
explain: [a]/ɪkˈspleɪn/; [v]解释;说明; [or]4j;
explanation: [a]/ˌekspləˈneɪʃn/; [n]解释,说明; [or]4j;
explode: [a]/ɪkˈsploʊd/; [v]爆炸;激增;爆发;使爆炸;驳倒; [or]4j;
exploit: [a]/ɪkˈsplɔɪt/; [v]剥削,利用;开发,开拓; [n]辉煌功绩; [or]4j;
explore: [a]/ɪkˈsplɔːr/; [v]探险,探索,尝试; [or]4j;
explosion: [a]/ɪkˈsploʊʒn/; [n]爆炸;爆发;激增; [or]4j;
explosive: [a]/ɪkˈsploʊsɪv/; [adj]爆炸的,引起爆炸的;爆炸性的(局势);剧增的;暴躁的; [n]炸药; [or]4j;
export: [a]/ˈekspɔːrt/; [v]出口,输出; [n]输出,出口,输出品; [or]4j;
expose: [a]/ɪkˈspoʊz/; [v]暴露;揭露;使遭受; [or]4j;
exposure: [a]/ɪkˈspoʊʒər/; [n]暴露,受寒;揭露,揭发;亮相,报道;曝光,曝光时间; [or]4j;
express: [a]/ɪkˈspres/; [adj]特定的;明确的;快速的; [n]快递;快车; [v]表达;用快递邮出;挤,榨; [adv]使用快速服务; [or]4j;
expression: [a]/ɪkˈspreʃn/; [n]表情,神情;表达,表述;措辞; [or]4j;
extend: [a]/ɪkˈstend/; [v]伸展,展开;延伸;涉及;扩展;提供;使.竭尽全力; [or]4j;
extension: [a]/ɪkˈstenʃn/; [n](建筑物的)扩建部分,延长部分,扩大,扩展;分机; [or]4j;
extensive: [a]/ɪkˈstensɪv/; [adj]广阔的;广泛的; [or]4j;
extent: [a]/ɪkˈstent/; [n]范围;程度;宽度;长度; [or]4j;
exterior: [a]/ɪkˈstɪriər/; [n]外表;外貌,外观; [adj]外部的;外界的;位于外边的;外交上的; [or]4j;
external: [a]/ɪkˈstɜːrnl/; [adj]外面的,外部的;外国的; [or]4j;
extra: [a]/ˈekstrə/; [adj]额外的,附加的;特优的; [adv]额外地; [n]附加物品;临时演员;(报纸)号外; [or]4j;
extraordinary: [a]/ɪkˈstrɔːrdəneri/; [adj]非同寻常的;特别的; [or]4j;
extreme: [a]/ɪkˈstriːm/; [adj]极端的;极远的;极限的;极度的;偏激的; [n]极端;极度(状态),最大程度; [or]4j;
eye: [a]/aɪ/; [n]眼睛;眼球;眼圈;眼神;注意;判断力;眼状物;视角; [v]向.送秋波;注视;考虑; [or]4j;
eyesight: [a]/ˈaɪsaɪt/; [n]视力,目力; [or]4j;
fabric: [a]/ˈfæbrɪk/; [n]布料,织物;质地,结构; [or]4j;
facility: [a]/fəˈsɪləti/; [n]设施(车间等),设备;灵巧;才能,资质; [or]4j;
factor: [a]/ˈfæktər/; [n]因素;<数>因子,商; [or]4j;
faculty: [a]/ˈfæklti/; [n]教职工,全体教员;系;科;能力; [or]4j;
fade: [a]/feɪd/; [vi]褪色,褪去;失去;逐渐消失; [vt]使褪色; [n]淡入,淡出; [adj]乏味的; [or]4j;
failure: [a]/ˈfeɪljər/; [n]失败;失败者;破产; [or]4j;
faint: [a]/feɪnt/; [vi]昏倒,晕厥;变得模糊; [n]晕厥,昏倒; [adj]虚弱的;微弱的;眩晕的; [or]4j;
fairly: [a]/ˈferli/; [adv]相当地;公正地,公平地,正当地;清楚地;完全,简直; [or]4j;
fairy: [a]/ˈferi/; [n]小精灵,小仙子; [or]4j;
faith: [a]/feɪθ/; [n]信任;信心;信仰; [int]实在,确实; [or]4j;
faithful: [a]/ˈfeɪθfl/; [adj]忠诚的;如实的; [n]信徒; [or]4j;
fake: [a]/feɪk/; [adj]假的,伪造的; [n]骗子;假货,赝品; [v]假造,杜撰;伪造;冒充,假装;假装; [or]4j;
false: [a]/fɔːls/; [adj]错误的;假的;虚伪的; [or]4j;
fame: [a]/feɪm/; [n]名望,名声,声誉; [vt]使有名,使著名; [or]4j;
familiar: [a]/fəˈmɪliər/; [adj]熟悉的;不拘礼节的;亲密的;随便的; [n]密友;常客;高级官吏的家属; [or]4j;
famine: [a]/ˈfæmɪn/; [n]饥荒;严重的缺乏; [or]4j;
fancy: [a]/ˈfænsi/; [adj]华丽装饰的,别致的,引人注目的;昂贵的,阔气的; [n]喜爱,幻想,想像力; [vt]想象,幻想;迷恋; [or]4j;
fantastic: [a]/fænˈtæstɪk/; [adj]极好的;极大的;不真实的;荒诞离奇的;不可思议的; [n]〈古〉古怪的人; [or]4j;
fantasy: [a]/ˈfæntəsi/; [n]幻想,想象;幻想作品; [vi]奏幻想曲; [vt]想像;幻想; [adj]虚幻的; [or]4j;
fare: [a]/fer/; [n]交通费;票价;食物;出租车乘客; [v](事情)进行得(好或坏); [or]4j;
farewell: [a]/ˌferˈwel/; [adj]告别的; [n]再见;告别,离别; [or]4j;
farmer: [a]/ˈfɑːrmər/; [n]农民,农夫;农场主; [or]4j;
farther: [a]/ˈfɑːrðər/; [adv]更远地,再往前地; [adj]更远的; [or]4j;
fascinating: [a]/ˈfæsɪneɪtɪŋ/; [adj]迷人的,有极大吸引力的; [or]4j;
fashion: [a]/ˈfæʃn/; [n]时髦,风尚,方式; [v]把..塑造成,制作,改革; [or]4j;
fashionable: [a]/ˈfæʃnəbl/; [adj]流行的,时髦的; [n]时髦的人; [or]4j;
fasten: [a]/ˈfæsn/; [v]系;扎牢;扣住;固定; [or]4j;
fatal: [a]/ˈfeɪtl/; [adj]致命的;毁灭性的;决定性的; [or]4j;
fate: [a]/feɪt/; [n]命运; [or]4j;
father: [a]/ˈfɑːðər/; [n]父亲;神父;创始人; [v]发明,创立; [or]4j;
fatigue: [a]/fəˈtiːɡ/; [n]疲乏,劳累; [or]4j;
fault: [a]/fɔːlt/; [n]过失,过错;弱点,缺点;故障,缺陷;(地质学)断层;发球失误; [v]责备,挑错; [or]4j;
faulty: [a]/ˈfɔːlti/; [adj]有缺陷的,有错误的,有缺点的,不合格的; [or]4j;
favor: [a]/ˈfeɪvər/; [n]偏爱,帮助,特权,赞成; [vt]偏爱,支持,利于,长得像; [or]4j;
favorable: [a]/ˈfeɪvərəbl/; [adj]赞同的,称赞的;有利的,顺利的; [or]4j;
favorite: [a]/'feɪvərɪt/; [adj]最爱的; [n]最喜爱的人或物,有希望获胜的选手; [or]4j;
favourable: [a]/ˈfeɪvərəbl/; [adj]赞许的,称赞的,肯定的;有利的,顺利的,良好的;讨人喜欢的,赢得赞许的;好而不贵的; [or]4j;
fearful: [a]/ˈfɪrfl/; [adj]吓人的,可怕的;害怕的,担心的;胆怯的; [or]4j;
feasible: [a]/ˈfiːzəbl/; [adj]可行的,行得通的; [or]4j;
feather: [a]/ˈfeðər/; [n]羽毛; [or]4j;
feature: [a]/ˈfiːtʃər/; [n]面貌,相貌;特征,特点;特辑; [vt]使突出,以.为特色; [vi]起重要作用,作为主要角色; [or]4j;
federal: [a]/ˈfedərəl/; [adj]联邦制的;联邦政府的; [or]4j;
fee: [a]/fiː/; [n]费用,酬金; [or]4j;
feedback: [a]/ˈfiːdbæk/; [n]反馈,反馈意见; [or]4j;
fellow: [a]/ˈfeloʊ/; [n]家伙,男人;同伴; [adj]同事的,同伴的;处于相同情况的,同类的; [vt]使.与另一个对等,使.与另一个匹敌; [or]4j;
female: [a]/ˈfiːmeɪl/; [adj]女性的;雌性的; [n]女子;雌性动物;雌性植物; [or]4j;
fence: [a]/fens/; [n]篱笆,围栏,栅栏; [v]击剑;用篱笆围住;束缚; [or]4j;
fertile: [a]/ˈfɜːrtl/; [adj]肥沃的;多产的; [or]4j;
fertilizer: [a]/ˈfɜːrtəlaɪzər/; [n]肥料,化肥; [or]4j;
festival: [a]/ˈfestɪvl/; [n]节日;欢宴,庆祝; [or]4j;
fetch: [a]/fetʃ/; [v]取来;接来;使发出;售得;带来;接住; [n]拿来,取来;诡计;风浪区; [or]4j;
fiber: [a]/ˈfaɪbər/; [n]纤维(物质);纤维组织;(植物) 纤维; [or]4j;
fiction: [a]/ˈfɪkʃn/; [n]虚构;想象;小说; [or]4j;
fierce: [a]/fɪrs/; [adj]凶猛的;激烈的;猛烈的; [or]4j;
fifteen: [a]/ˌfɪfˈtiːn/; [num]十五,十五个; [n]十五人制英式橄榄球队; [or]4j;
fifth: [a]/fɪfθ/; [n]五分之一; [num]第五; [or]4j;
fifty: [a]/ˈfɪfti/; [n]五十,五十个; [num]五十,五十个;五十的,五十个的; [or]4j;
figure: [a]/ˈfɪɡjər/; [n]体型;人物,人影;形状;数字; [v]想出,估计,计算出; [or]4j;
file: [a]/faɪl/; [n]文件夹,档案,文件; [vi]把文件归档,提交(申请等); [vt]把(文件等)归档; [or]4j;
filter: [a]/ˈfɪltər/; [n]过滤器,滤纸; [v]过滤,渗透; [or]4j;
finally: [a]/ˈfaɪnəli/; [adv]最终,终于;最后; [or]4j;
finance: [a]/ˈfaɪnæns/; [v]资金供给,筹措资金; [n]金融,财政,资金; [or]4j;
financial: [a]/faɪˈnænʃl/; [adj]金融的;财政的;财务的; [or]4j;
finding: [a]/ˈfaɪndɪŋ/; [n]发现,调查的结果; [or]4j;
fisherman: [a]/ˈfɪʃərmən/; [n]渔民,渔夫,打渔人; [or]4j;
five: [a]/faɪv/; [num]五,五个; [adj]五个的; [n]五,五个; [or]4j;
flame: [a]/fleɪm/; [v]脸变红;燃烧; [n]火焰;热情; [or]4j;
flash: [a]/flæʃ/; [n]闪光;刹那; [v]闪光,掠过;发火花;快速发送; [adj]炫耀的;浮夸的;一闪而过的; [or]4j;
flat: [a]/flæt/; [adj]平坦的;浅的;平面的;单调的; [n]平面;公寓; [adv]平直地; [or]4j;
flavor: [a]/ˈfleɪvər/; [n]味,风味;调味品; [v]给..调味; [or]4j;
flaw: [a]/flɔː/; [n]瑕疵;缺点; [v]使有缺陷;使不完美;有瑕疵; [or]4j;
flee: [a]/fliː/; [v]逃走,(时间)飞逝;逃离;避开; [or]4j;
fleet: [a]/fliːt/; [n]舰队,船队;车队; [adj]迅速的; [or]4j;
flesh: [a]/fleʃ/; [n]肉,肉体;果肉; [or]4j;
flexible: [a]/ˈfleksəbl/; [adj]易曲的,柔软的,灵活的; [or]4j;
flight: [a]/flaɪt/; [n]楼梯的一段;飞机的航程;航班;飞行;逃跑; [v]使球在空中飞行; [or]4j;
float: [a]/floʊt/; [vi]漂浮,飘浮,浮现;散布;漂泊; [vt]使漂浮;散布; [n]浮标,漂浮物,漂浮; [or]4j;
flock: [a]/flɑːk/; [n](鸟兽)群;一群人;(对牧师而言的)教徒; [v]聚集,成群而行; [or]4j;
flood: [a]/flʌd/; [n]洪水;大量; [v]淹没,充满;(河)溢出; [or]4j;
flour: [a]/ˈflaʊər/; [n]面粉;粉状物质; [v]撒上粉; [or]4j;
flourish: [a]/ˈflɜːrɪʃ/; [vi]繁荣,茂盛,兴旺; [vt]挥舞;夸耀; [n]兴旺;茂盛;炫耀;挥舞; [or]4j;
flow: [a]/floʊ/; [v]流动;飘垂;涨潮;来自..的结果;流畅; [n]流动;流畅; [or]4j;
fluent: [a]/ˈfluːənt/; [adj]流畅的,(说话)流利的;顺畅的,流畅熟练的; [or]4j;
fluid: [a]/ˈfluːɪd/; [n]流体,液体; [adj]流动的;易变的;流畅的; [or]4j;
focus: [a]/ˈfoʊkəs/; [n]焦点,聚焦;焦距;关注; [v]使聚焦,集中注意力; [or]4j;
fog: [a]/fɔːɡ/; [n]雾;烟雾,尘雾; [v]以雾笼罩,使模糊,迷惑; [or]4j;
fold: [a]/foʊld/; [v]折叠;彻底失败;合拢; [n]折叠;褶; [or]4j;
folk: [a]/foʊk/; [adj]民间的,民俗的; [n]人们;亲人,家人;民间音乐; [or]4j;
following: [a]/ˈfɑːloʊɪŋ/; [adj]接着的;下列的; [n]下列事物;一批追随者; prep. 随后,在.以后; [or]4j;
fond: [a]/fɑːnd/; [adj]喜欢的,喜爱的,溺爱的,精神错乱的; [v]显出钟爱之情; [or]4j;
food: [a]/fuːd/; [n]食物,食品,养料; [or]4j;
fool: [a]/fuːl/; [n]笨蛋,傻瓜; [v]玩弄,愚弄; [or]4j;
foolish: [a]/ˈfuːlɪʃ/; [adj]愚蠢的;傻乎乎的; [or]4j;
foot: [a]/fʊt/; [n]脚;最下部;英尺; [vi]步行; [vt]步行;走在..之上; [or]4j;
football: [a]/ˈfʊtbɔːl/; [n]<英>足球,<美>橄榄球; [v]踢足球,打橄榄球; [or]4j;
footstep: [a]/ˈfʊtstep/; [n]脚步;脚步声;一步的距离;足迹; [or]4j;
forbid: [a]/fərˈbɪd/; [v]禁止;不许; [or]4j;
force: [a]/fɔːrs/; [v]强迫;推动;凭借武力前进; [n]力量;武力;势力; [or]4j;
forecast: [a]/ˈfɔːrkæst/; [n]预测;预报; [v]预报,预测; [or]4j;
forefinger: [a]/ˈfɔːrfɪŋɡər/; [n]食指; [or]4j;
forehead: [a]/ˈfɔːrhed/; [n]前额,前部; [or]4j;
forever: [a]/fərˈevər/; [adv]永远;总是,老是; [or]4j;
forge: [a]/fɔːrdʒ/; [n]熔炉;锻工车间;铁匠店; [v]锻造;经锻炼而形成;伪造;推进,加强; [or]4j;
forgive: [a]/fərˈɡɪv/; [v]原谅,饶恕,宽恕;(国家,银行等)免除(债务); [or]4j;
fork: [a]/fɔːrk/; [n]叉,餐叉;耙子;分叉,分岔处,岔路; [or]4j;
formal: [a]/ˈfɔːrml/; [adj]正式的;正规的;规范的,合乎规矩的;形式上的;礼节上的; [n]<美>须穿礼服的社交集会;<口>夜礼服; [or]4j;
format: [a]/ˈfɔːrmæt/; [n]版式;设计;格式; [v]设计一个版式;使格式化;设计.的版面; [or]4j;
formation: [a]/fɔːrˈmeɪʃn/; [n]队形;形成;编队;构造;<地>地层; [or]4j;
former: [a]/ˈfɔːrmər/; [adj]前任的,前者的,以前的; [n]创造者;(两者中的)前者; [or]4j;
formula: [a]/ˈfɔːrmjələ/; [n]公式,方程式;配方;方案;方法;配方奶; [or]4j;
forth: [a]/fɔːrθ/; [adv]向前;向外;离去; prep. 出自,从.离开; [or]4j;
fortnight: [a]/ˈfɔːrtnaɪt/; [n]两星期,十四日; [or]4j;
fortunate: [a]/ˈfɔːrtʃənət/; [adj]幸运的; [or]4j;
fortunately: [a]/ˈfɔːrtʃənətli/; [adv]幸运地,幸亏; [or]4j;
fortune: [a]/ˈfɔːrtʃən/; [n]运气;命运,时运;财产; [or]4j;
forty: [a]/ˈfɔːrti/; [num]四十,第四十;四十的;四十(个);四十个的; [n]四十年代; [or]4j;
foster: [a]/ˈfɔːstər/; [adj]收养的; [vt]养育;培养,促进; [or]4j;
foundation: [a]/faʊnˈdeɪʃn/; [n]地基;基础;基金(会);建立;粉底; [or]4j;
fountain: [a]/ˈfaʊntn/; [n]泉水,喷泉;源泉;人造喷泉装置; [or]4j;
four: [a]/fɔːr/; [num]四; [n]四个;板球中得四分的一击; [or]4j;
fourteen: [a]/ˌfɔːrˈtiːn/; [num]十四; [or]4j;
fox: [a]/fɑːks/; [n]狐狸;狡猾的人;时髦女郎; [v]用诡计,假装;欺骗,迷惑; [or]4j;
fraction: [a]/ˈfrækʃn/; [n]部分,片断,碎片;分数; [or]4j;
fragment: [a]/ˈfræɡmənt/; [n]片段;碎片; [v]使成碎片; [or]4j;
frame: [a]/freɪm/; [n]构架,框,结构,体格; [v]表达;制定;拟订;陷害;构成,制定,给..装框架;使..适合; [or]4j;
framework: [a]/ˈfreɪmwɜːrk/; [n]构架,框架,结构;体制,体系; [or]4j;
frank: [a]/fræŋk/; [adj]坦白的;直率的; [n]弗兰克;免费邮寄权;免费邮戳或签名;免费邮寄的信件; [vt]免费寄(邮件);盖免费邮寄公章;盖邮戳;便于使(人)自由地来往; [or]4j;
freedom: [a]/ˈfriːdəm/; [n]自由;自主; [or]4j;
freeze: [a]/friːz/; [v]冻结;使冻僵; [n]严寒,冻结; [or]4j;
freight: [a]/freɪt/; [n]货运;货物;运费; [v]运送; [or]4j;
frequency: [a]/ˈfriːkwənsi/; [n]频繁;屡次,经常发生;次数;频率; [or]4j;
frequent: [a]/ˈfriːkwənt/; [adj]时常的,频繁的; [v]常去,常到; [or]4j;
friction: [a]/ˈfrɪkʃn/; [n]摩擦,摩擦力;争执,冲突; [or]4j;
friend: [a]/frend/; [n]朋友,友人;支持者; [or]4j;
frighten: [a]/ˈfraɪtn/; [v]使惊恐,使害怕; [or]4j;
frog: [a]/frɔːɡ/; [n]蛙; [or]4j;
frontier: [a]/frʌnˈtɪr/; [n]边境,边疆;新领域;<美>边远地区,边界地区; [adj]开拓的; [or]4j;
frost: [a]/frɔːst/; [n]霜冻,严寒; [v]结霜,冻死; [or]4j;
frown: [a]/fraʊn/; [n]皱眉;不悦; [v]皱眉;不赞成;使哑口无言; [or]4j;
fruitful: [a]/ˈfruːtfl/; [adj]硕果累累的,多产的;富有成效的; [or]4j;
frustrate: [a]/ˈfrʌstreɪt/; [v]使灰心;挫败;阻挠; [or]4j;
fry: [a]/fraɪ/; [v]油煎;油炸; [n]鱼苗,鱼秧;弗赖伊(姓氏);油炸食物;(口语)烦恼,愤激; [adj]油炸的,油煎的(fried); [or]4j;
fuel: [a]/ˈfjuːəl/; [v]给.加燃料; [n]燃料;刺激因素; [or]4j;
fulfill: [a]/fʊl'fɪl/; [v]履行,实现,完成;满足(愿望,要求等),使满意; [or]4j;
function: [a]/ˈfʌŋkʃn/; [n]功能,作用;函数;应变量;盛大聚会;职务,职责; [v]起作用;正常运转; [or]4j;
fund: [a]/fʌnd/; [n]资金,基金;存款; [v]拨款,提供基金; [or]4j;
fundamental: [a]/ˌfʌndəˈmentl/; [adj]基本的,根本的;重要的;基础的; [n]基本原理;基本原则; [or]4j;
funeral: [a]/ˈfjuːnərəl/; [n]丧葬,葬礼; [or]4j;
fur: [a]/fɜːr/; [n]毛皮,毛皮外套,人造毛; [or]4j;
furnace: [a]/ˈfɜːrnɪs/; [n]炉子,熔炉; [or]4j;
furnish: [a]/ˈfɜːrnɪʃ/; [v](用家具等)布置(房间,公寓等);供应,提供; [or]4j;
furniture: [a]/ˈfɜːrnɪtʃər/; [n]家具;装置;设备; [or]4j;
further: [a]/ˈfɜːrðər/; [adj]更进一步的;更远的; [v]促进,推动;增进; [adv]更远地; [or]4j;
fuss: [a]/fʌs/; [n]大惊小怪,小题大做; [v](为小事)烦恼,过于忧虑; [or]4j;
gain: [a]/ɡeɪn/; [v]获得;增加;从中受益;增值; [n]获得;增加(财富,重量);利益; [or]4j;
gallery: [a]/ˈɡæləri/; [n]美术馆,画廊;(大厅的)旁听席,边座; [or]4j;
gallon: [a]/ˈɡælən/; [n]加仑; [or]4j;
gang: [a]/ɡæŋ/; [n]以某种方式结合的一群人;帮派; [v]成帮结伙;使集合成一群;使成套排列; [or]4j;
gap: [a]/ɡæp/; [n]间隙,缺口,差距; [or]4j;
garage: [a]/ɡəˈrɑːʒ/; [n]车库;修车厂; [or]4j;
garbage: [a]/ˈɡɑːrbɪdʒ/; [n]垃圾桶;垃圾; [or]4j;
gardener: [a]/ˈɡɑːrdnər/; [n]园丁,花匠; [or]4j;
garlic: [a]/ˈɡɑːrlɪk/; [n]大蒜; [or]4j;
gas: [a]/ɡæs/; [n]煤气;气体;汽油; [v]使吸入毒气;毒(死);给 ... 加汽油;空谈;加汽油; [adj]〈美俚〉喝醉酒的; [or]4j;
gaseous: [a]/ˈɡæsiəs/; [adj]气体的,气态的; [or]4j;
gasoline: [a]/ˈɡæsəliːn/; [n](美)汽油; [or]4j;
gather: [a]/ˈɡæðər/; [v]聚集,集合;收集,采集;推测;缝紧,拉紧;拥抱; [n]聚集,衣服的褶子; [or]4j;
gauge: [a]/ɡeɪdʒ/; [n]测量仪;尺度,标准; [v]估计,判断;计量; [or]4j;
gay: [a]/ɡeɪ/; [n]同性恋者; [adj]同性恋的;快乐的;鲜艳的;装饰华丽的;生机勃勃的; [or]4j;
gaze: [a]/ɡeɪz/; [v]凝视,注视; [n]凝视,注视; [or]4j;
gear: [a]/ɡɪr/; [n]档位;齿轮;装备;衣物; [v]使适合; [or]4j;
gene: [a]/dʒiːn/; [n]基因; [or]4j;
generally: [a]/ˈdʒenrəli/; [adv]一般地;通常地;通常强调普遍性; [or]4j;
generate: [a]/ˈdʒenəreɪt/; [v]产生(热,电等能量),创造; [or]4j;
generation: [a]/ˌdʒenəˈreɪʃn/; [n]一代;一代人;生育;产生;拷贝; [or]4j;
generator: [a]/ˈdʒenəreɪtər/; [n]发电机;电力公司;产生者; [or]4j;
generous: [a]/ˈdʒenərəs/; [adj]慷慨的;充裕的,宽厚的;肥沃的; [or]4j;
genius: [a]/ˈdʒiːniəs/; [n]天才;天资,天赋;才华; [or]4j;
gentle: [a]/ˈdʒentl/; [adj]温和的,轻柔的,文雅的; [or]4j;
genuine: [a]/ˈdʒenjuɪn/; [adj]真正的;真的;真诚的; [or]4j;
geometry: [a]/dʒiˈɑːmətri/; [n]几何学;几何形状; [or]4j;
germ: [a]/dʒɜːrm/; [n]微生物,细菌;(某事的)发端,萌芽; [v]萌芽;发生; [or]4j;
gesture: [a]/ˈdʒestʃər/; [n]手势,表情;姿态; [v]做手势,用动作示意; [vt]用手势表达; [or]4j;
ghost: [a]/ɡoʊst/; [n]鬼,鬼魂,幽灵; [vt]悄悄地行进; [vi]替人代笔; [or]4j;
giant: [a]/ˈdʒaɪənt/; [adj]巨大的;卓越的; [n]巨人;伟人,庞然大物; [or]4j;
girl: [a]/ɡɜːrl/; [n]少女;女孩; [or]4j;
glance: [a]/ɡlæns/; [v]看一下; [n]一瞥,扫视; [or]4j;
glimpse: [a]/ɡlɪmps/; [n]一瞥;初步的感受; [v]一瞥,瞥见; [or]4j;
global: [a]/ˈɡloʊbl/; [adj]全球的;全面的; [or]4j;
globe: [a]/ɡloʊb/; [n]球体,地球仪;地球,世界;(使)成球状; [or]4j;
glorious: [a]/ˈɡlɔːriəs/; [adj]辉煌的,壮丽的;光荣的,荣耀的; [or]4j;
glory: [a]/ˈɡlɔːri/; [vi]因某事而喜悦,为某事而欣喜; [n]光荣,荣誉; [or]4j;
glove: [a]/ɡlʌv/; [n]手套; [or]4j;
glow: [a]/ɡloʊ/; [n]光辉,红光,热情; [v]发光,发红光,发热; [or]4j;
glue: [a]/ɡluː/; [n]胶水; [v]用胶粘; [or]4j;
goal: [a]/ɡoʊl/; [n]目标;球门;(进球)得分; [or]4j;
goat: [a]/ɡoʊt/; [n]山羊; [or]4j;
golf: [a]/ɡɑːlf/; [n]高尔夫球运动; [or]4j;
goodness: [a]/ˈɡʊdnəs/; [n]善良;仁慈;优良;精髓; [int]天哪,哎呀; [or]4j;
goods: [a]/ɡʊdz/; [n]货物,商品; [or]4j;
govern: [a]/ˈɡʌvərn/; [v]统治,管理; [vt]决定,影响;<语>支配(如动词决定它后面的代词的语法形式);调节; [vi]进行统治;居支配地位; [or]4j;
governor: [a]/ˈɡʌvərnər/; [n]统治者;总督;主管负责人;限速器;州长; [or]4j;
grab: [a]/ɡræb/; [v]攫取,抓取,掠夺;赶紧做;吸引; [n]抓取,非法所得; [or]4j;
graceful: [a]/ˈɡreɪsfl/; [adj]优雅的,优美的,得体的; [or]4j;
grade: [a]/ɡreɪd/; [n]等级,成绩; [v]给(试卷或作业)评分;给..分等级; [or]4j;
gradual: [a]/ˈɡrædʒuəl/; [adj]逐渐的,逐步的,平缓的; [or]4j;
graduate: [a]/ˈɡrædʒuət/; [v]毕业;渐变;渐渐变为;取得资格;授予.学位; [n]大学毕业生;学位获得者; [adj]毕业的;研究生的; [or]4j;
grain: [a]/ɡreɪn/; [n]谷物种子,谷物,少量;格令;颗粒;纹理; [v]使成粒状; [or]4j;
gram: [a]/ɡræm/; [n]克;写出或画出的东西; [or]4j;
grammar: [a]/ˈɡræmər/; [n]语法,语法书; [or]4j;
grand: [a]/ɡrænd/; [adj]壮丽的,宏伟的,重大的;傲慢的;极好的; [n]一千美元;大钢琴; [or]4j;
grandfather: [a]/ˈɡrænfɑːðər/; [n]祖父,外祖父;祖先; [or]4j;
grandmother: [a]/ˈɡrænmʌðər/; [n]祖母,外祖母; [v]当祖母;当..的祖母; [or]4j;
grant: [a]/ɡrænt/; [v]给予,许可,授予;承认; [n]许可;拨款,补助金; [or]4j;
grape: [a]/ɡreɪp/; [n]葡萄;葡萄藤; [or]4j;
graph: [a]/ɡræf/; [n](曲线)图,图表; [vt]用曲线图表示,把.绘入图表;用胶版印刷; [or]4j;
grasp: [a]/ɡræsp/; [v]抓住;领会;理解; [n]紧握;理解;把手; [or]4j;
grateful: [a]/ˈɡreɪtfl/; [adj]感激的;感谢的; [or]4j;
gratitude: [a]/ˈɡrætɪtuːd/; [n]感激,感谢; [or]4j;
grave: [a]/ɡreɪv/; [adj]严重的;严肃的,庄重的; [n]墓; [adv]沉重地,庄重地;极慢地; [vt]雕刻;铭记; [or]4j;
gravity: [a]/ˈɡrævəti/; [n]重力,引力;严重性;庄重,严肃; [or]4j;
gray: [a]/ɡreɪ/; [adj]灰色的;暗淡的; [n]灰色,暗淡; [v]变灰色,使..变灰色; [or]4j;
greedy: [a]/ˈɡriːdi/; [adj]贪婪的,贪心的,贪吃的; [or]4j;
green: [a]/ɡriːn/; [adj]绿色的,青的,草绿色的;缺乏经验的;嫉妒的,眼红的;(赞成)环境保护的;生的,未熟的; [n]绿色;草地,草坪,公共绿地;绿色蔬菜,绿叶蔬菜; [v]使成为绿色,成为绿色,变绿;使..恢复活力; [or]4j;
greenhouse: [a]/ˈɡriːnhaʊs/; [n]温室;花房;镶有玻璃的座舱; [or]4j;
greet: [a]/ɡriːt/; [v]问候,招呼;对..作出反应; [or]4j;
grim: [a]/ɡrɪm/; [adj]严酷的,无情的;令人沮丧的,令人失望的;讨厌的,糟糕的; [or]4j;
grind: [a]/ɡraɪnd/; [v]磨碎,碾碎;折磨;摩擦得吱吱作响; [n]苦差事,苦活儿;磨; [or]4j;
grip: [a]/ɡrɪp/; [v]握紧,抓牢; [n]紧握,握力; [or]4j;
grocer: [a]/ˈɡroʊsər/; [n]食品杂货店主,食品杂货店员; [or]4j;
gross: [a]/ɡroʊs/; [adj]总的,毛重的;恶心的;粗鲁的; [n]总量,总额; [adv]总共地; [vt]总共赚得; [or]4j;
growth: [a]/ɡroʊθ/; [n]生长,发展;增长;肿瘤; [or]4j;
guarantee: [a]/ˌɡærənˈtiː/; [v]保证;担保;提供保修; [n]保证;担保;保修单;保证金; [or]4j;
guard: [a]/ɡɑːrd/; [n]警卫员,哨兵,守卫,护卫队; [vi]警惕; [vt]保卫,守护,保护;看守,监视; [or]4j;
guidance: [a]/ˈɡaɪdns/; [n]引导,指导; [or]4j;
guide: [a]/ɡaɪd/; [n]导游;指南; [v]引导,指导;给.领路;给.导游,带领; [or]4j;
guideline: [a]/ˈɡaɪdlaɪn/; [n]指导路线,准则; [or]4j;
guilty: [a]/ˈɡɪlti/; [adj]内疚的;有罪的; [or]4j;
guitar: [a]/ɡɪˈtɑːr/; [n]吉他,六弦琴; [or]4j;
gulf: [a]/ɡʌlf/; [n]海湾; [or]4j;
gum: [a]/ɡʌm/; [n]树胶;口香糖;牙龈; [v]在..涂树胶; [or]4j;
guy: [a]/ɡaɪ/; [n]男人;家伙; [or]4j;
gym: [a]/dʒɪm/; [n]体育馆,健身房;体育; [or]4j;
gymnasium: [a]/dʒɪmˈneɪziəm/; [n]体育馆,健身房; [or]4j;
hair: [a]/her/; [n]头发,毛发;毛; [or]4j;
halt: [a]/hɔːlt/; [v]停止,止步,暂停; [n]停住,终止; [or]4j;
hammer: [a]/ˈhæmər/; [n]锤; [v]锤击; [or]4j;
handbag: [a]/ˈhændbæɡ/; [n](女用)手提包; [or]4j;
handful: [a]/ˈhændfʊl/; [n]一把;少数;难管的人(尤指孩子); [or]4j;
handkerchief: [a]/ˈhæŋkərtʃɪf/; [n]手帕;头巾;方巾; [or]4j;
handle: [a]/ˈhændl/; [n]柄,把手; [v]处理,解决;操纵; [or]4j;
handwriting: [a]/ˈhændraɪtɪŋ/; [n]笔迹,字迹;书写;亲手写; [or]4j;
handy: [a]/ˈhændi/; [adj]便利的,方便的;手巧的;伸手可及的; [or]4j;
hang: [a]/hæŋ/; [v]吊死,悬挂,悬浮;垂下; [n]悬挂;绞刑; [or]4j;
happen: [a]/ˈhæpən/; [v]发生,碰巧,出现,偶遇;碰巧;恰好; [or]4j;
harbor: [a]/'hɑːbə/; [n]海港;港口;避风港; [v]庇护;藏匿;心怀(怨恨等); [or]4j;
harden: [a]/ˈhɑːrdn/; [v](使)变硬;(使)坚强; [or]4j;
hardship: [a]/ˈhɑːrdʃɪp/; [n]艰难,困苦; [or]4j;
hardware: [a]/ˈhɑːrdwer/; [n]五金器具,(总称)金属器材;硬件; [or]4j;
harm: [a]/hɑːrm/; [n]伤害,损害; [v]伤害; [or]4j;
harmful: [a]/ˈhɑːrmfl/; [adj]有害的; [or]4j;
harmony: [a]/ˈhɑːrməni/; [n]和谐;和声;和睦;协调; [or]4j;
harness: [a]/ˈhɑːrnɪs/; [n]挽具,马具,降落伞背带; [v]上挽具;治理(河流等);利用; [or]4j;
harsh: [a]/hɑːrʃ/; [adj]严厉的;刺耳的;条件艰苦的; [or]4j;
harvest: [a]/ˈhɑːrvɪst/; [v]收割; [n]收获; [or]4j;
haste: [a]/heɪst/; [n]匆忙;草率; [v]赶快;匆忙; [or]4j;
hatred: [a]/ˈheɪtrɪd/; [n]憎恨;怨恨; [or]4j;
hay: [a]/heɪ/; [n]干草; [or]4j;
hazard: [a]/ˈhæzərd/; [n]公害;危险;危险的事物;机会; [v]使冒危险;冒险做; [or]4j;
heading: [a]/ˈhedɪŋ/; [n]标题; [or]4j;
headline: [a]/ˈhedlaɪn/; [n]大字标题;新闻摘要; [v]给..加标题;担当主角; [or]4j;
headmaster: [a]/ˌhedˈmæstər/; [n]男校长(尤指私立学校); [or]4j;
headquarters: [a]/ˈhedkwɔːrtərz/; [n]司令部,指挥部;总部,总局; [or]4j;
heal: [a]/hiːl/; [v]治愈,治疗;痊愈;恢复; [or]4j;
heap: [a]/hiːp/; [n](一)堆;大量; [v]堆;堆积; [or]4j;
hearing: [a]/ˈhɪrɪŋ/; [n]听觉;听距;听证会;申辩的机会; [v]听到; [or]4j;
heave: [a]/hiːv/; [v]用力举起;掷扔;发出叹息;恶心; [n]举起,升降; [or]4j;
hedge: [a]/hedʒ/; [v]防范,规避;避免直接答复,避免直接回答;围住;用树篱围起; [n]篱笆,树篱;保障; [or]4j;
heel: [a]/hiːl/; [n]脚后跟;(鞋)后跟; [v]给(鞋)钉后掌,倾侧,紧跟; [or]4j;
heighten: [a]/ˈhaɪtn/; [v]加强,增加,提高; [or]4j;
heir: [a]/er/; [n]继承人;后继者; [or]4j;
helicopter: [a]/ˈhelɪkɑːptər/; [n]直升机; [v]用直升飞机载送,乘直升机; [or]4j;
hell: [a]/hel/; [n]地狱,阴间;苦境,极大的痛苦; [or]4j;
hello: [a]/həˈloʊ/; [int]喂(打电话时的招呼语);哈啰; [n]你好(打招呼用语);表示问候,惊奇或唤起注意时的用语; [or]4j;
helpful: [a]/ˈhelpfl/; [adj]肯帮忙的,给予帮助的;有用的; [or]4j;
helpless: [a]/ˈhelpləs/; [adj]无助的,不受保护的,无能为力的,无法控制的,无法抑制的; [or]4j;
hen: [a]/hen/; [n]母鸡,雌禽; [or]4j;
herd: [a]/hɜːrd/; [n]兽群,牧群; [v]放牧,群集; [or]4j;
heritage: [a]/ˈherɪtɪdʒ/; [n]遗产;继承物;传统;文化遗产; [or]4j;
heroic: [a]/həˈroʊɪk/; [adj]英勇的;英雄的; [n]史诗;英勇行为;夸张的言行; [or]4j;
hers: [a]/hɜːrz/; pro[n]她的(所有格代词); [or]4j;
herself: [a]/hɜːrˈself/; pro[n]她自己;她本人; [or]4j;
hesitate: [a]/ˈhezɪteɪt/; [v]犹豫,踌躇;含糊,支吾,有顾虑; [or]4j;
hi: [a]/haɪ/; [int]嗨(表示问候等); [or]4j;
highlight: [a]/ˈhaɪlaɪt/; [vt]使突出,强调,高亮; [n]最精彩的部分,最重要的事件; [or]4j;
highway: [a]/ˈhaɪweɪ/; [n]大路,高速公路;公路; [or]4j;
hillside: [a]/ˈhɪlsaɪd/; [n]山坡; [or]4j;
hint: [a]/hɪnt/; [v]作暗示;透露; [n]暗示,示意;建议; [or]4j;
hip: [a]/hɪp/; [n]蔷薇果;臀部,髋部; [or]4j;
hire: [a]/ˈhaɪər/; [v]雇用,出租; [n]租金,雇用,租用; [or]4j;
historic: [a]/hɪˈstɔːrɪk/; [adj]历史上著名的,有历史意义的;历史性的; [or]4j;
hobby: [a]/ˈhɑːbi/; [n]业余爱好,癖好; [or]4j;
hole: [a]/hoʊl/; [n]洞;陷阱; [v]掘洞;钻孔; [or]4j;
hollow: [a]/ˈhɑːloʊ/; [adj]中间空的;空洞的; [v]掏空; [n]洞; [adv]完全地,彻底地; [or]4j;
holy: [a]/ˈhoʊli/; [adj]神圣的,圣洁的;虔诚的;神赐的; [or]4j;
home: [a]/hoʊm/; [n]家,家庭; [adj]家的;主场的;本国的; [adv]在家,到家;到正确的位置; [v]回家,有家,朝向,自动导航; [or]4j;
honey: [a]/ˈhʌni/; [n]蜜,蜂蜜; [or]4j;
honor: [a]/'ɑːnər/; [n]荣誉,荣幸; [v]尊敬,使荣幸,对..表示敬意; [or]4j;
honorable: [a]/ˈɑːnərəbl/; [adj]荣誉的;可敬的;光荣的; [or]4j;
honourable: [a]/ˈɑːnərəbl/; [adj]可敬的,值得钦佩的;荣誉的,光荣的; [or]4j;
hook: [a]/hʊk/; [n]钩;钓钩; [v]钩住;弯成(钩状);引上钩,上钩; [or]4j;
hopeful: [a]/ˈhoʊpfl/; [adj]有希望的;怀有希望的;给人以希望的; [n]希望能成功的人; [or]4j;
hopeless: [a]/ˈhoʊpləs/; [adj]没有希望的,绝望的,不能胜任的,无望的; [or]4j;
horizon: [a]/həˈraɪzn/; [n]地平线;眼界,见识; [or]4j;
horizontal: [a]/ˌhɔːrəˈzɑːntl/; [adj]水平的,与地面平行的,横向的; [n]水平,水平面; [or]4j;
horn: [a]/hɔːrn/; [n](牛,羊的)角,号角;喇叭;角制作而成的东西; [or]4j;
horrible: [a]/ˈhɔːrəbl/; [adj]可怕的,恐怖的;讨厌的,糟糕的;粗鲁的,不友好的; [or]4j;
horror: [a]/ˈhɔːrər/; [n]恐怖,战栗;恐怖片; [or]4j;
horsepower: [a]/ˈhɔːrspaʊər/; [n]马力; [or]4j;
host: [a]/hoʊst/; [n]东道主,主持人;大量; [v]主持,主办; [or]4j;
hostile: [a]/ˈhɑːstl/; [adj]敌对的,敌方的;怀敌意的; [or]4j;
household: [a]/ˈhaʊshoʊld/; [n]同住在一家的人;家务;家常普通的; [adj]家庭的,家内的,一家的;家喻户晓的; [or]4j;
housewife: [a]/ˈhaʊswaɪf/; [n]家庭主妇; [or]4j;
housing: [a]/ˈhaʊzɪŋ/; [n]房屋;供给住宅;掩护;外罩; [or]4j;
hum: [a]/hʌm/; [v]发出嗡嗡声,哼(歌曲); [n]轰鸣声,嗡嗡营营声; [or]4j;
humanity: [a]/hjuːˈmænəti/; [n]人性;人类;人道;慈爱;(复)人文学科; [or]4j;
humble: [a]/ˈhʌmbl/; [adj]卑微的;(级别或地位)低下的,简陋的;谦逊的; [v]使⋯谦逊,使⋯卑下;轻松打败(尤指强大的对手); [or]4j;
humor: [a]/ˈhjuːmər/; [n]幽默,诙谐; [or]4j;
humorous: [a]/ˈhjuːmərəs/; [adj]幽默的,搞笑的,诙谐的; [or]4j;
hunger: [a]/ˈhʌŋɡər/; [n]饥饿;渴望; [v]渴望,饥饿; [or]4j;
hunt: [a]/hʌnt/; [n]打猎;搜寻; [v]打猎;搜索;猎杀,追捕; [or]4j;
hurricane: [a]/ˈhɜːrəkeɪn/; [n]飓风; [or]4j;
hut: [a]/hʌt/; [n]小屋; [or]4j;
hydrogen: [a]/ˈhaɪdrədʒən/; [n]氢,氢气; [or]4j;
iceberg: [a]/ˈaɪsbɜːrɡ/; [n]冰山; [or]4j;
ideal: [a]/aɪˈdiːəl/; [adj]理想的;完美的;空想的;观念的; [n]理想;典范;目标; [or]4j;
identical: [a]/aɪˈdentɪkl/; [adj]相同的,同样的,一模一样的;相似的; [n]完全相同的事物; [or]4j;
identification: [a]/aɪˌdentɪfɪˈkeɪʃn/; [n]识别;鉴定;验明;身份证明; [or]4j;
identify: [a]/aɪˈdentɪfaɪ/; [v]认出,联系;识别;确定,鉴定,发现;认为.等同,认为.关系紧密;表明.的身份;认同,有共鸣,有同感; [or]4j;
identity: [a]/aɪˈdentəti/; [n]身份;特性;一致; [or]4j;
idle: [a]/ˈaɪdl/; [adj]空闲的;懒散的; [v]无所事事;虚度;空转;使空转; [vt]虚度; [or]4j;
ignition: [a]/ɪɡˈnɪʃn/; [n]点火,着火;点火开关; [or]4j;
ignorance: [a]/ˈɪɡnərəns/; [n]不知,不懂;愚昧,无知; [or]4j;
ignorant: [a]/ˈɪɡnərənt/; [adj]无知的,没有学问的,愚昧的; [or]4j;
ignore: [a]/ɪɡˈnɔːr/; [v]忽视;不理; [or]4j;
illegal: [a]/ɪˈliːɡl/; [adj]不合法的,非法的; [n]非法移民,非法劳工;间谍; [or]4j;
illusion: [a]/ɪˈluːʒn/; [n]假象,幻象;幻想;错误观念; [or]4j;
illustrate: [a]/ˈɪləstreɪt/; [v]举例说明,阐明;图解,加插图; [or]4j;
illustration: [a]/ˌɪləˈstreɪʃn/; [n]插图;实例,例证;说明; [or]4j;
imaginary: [a]/ɪˈmædʒɪneri/; [adj]想象的,虚构的,假想的; [or]4j;
imagination: [a]/ɪˌmædʒɪˈneɪʃn/; [n]想象力;想象; [or]4j;
imaginative: [a]/ɪˈmædʒɪnətɪv/; [adj]想象的;富于想象力的;虚构的; [or]4j;
imagine: [a]/ɪˈmædʒɪn/; [v]想象;设想;料想;认为; [or]4j;
imitate: [a]/ˈɪmɪteɪt/; [v]模仿; [or]4j;
imitation: [a]/ˌɪmɪˈteɪʃn/; [n]模仿;仿制品;赝品; [adj]伪造的;仿制的; [or]4j;
immediate: [a]/ɪˈmiːdiət/; [adj]直系的;立即的,立刻的;紧邻的; [or]4j;
immediately: [a]/ɪˈmiːdiətli/; [adv]立即,马上;直接地;靠近地; [conj]一..(就); [or]4j;
immense: [a]/ɪˈmens/; [adj]巨大的,广大的; [or]4j;
immigrant: [a]/ˈɪmɪɡrənt/; [n]移民; [adj]移民的;迁入的; [or]4j;
immune: [a]/ɪˈmjuːn/; [adj]免疫的,有免疫力的;不受影响的;免除的; [or]4j;
impact: [a]/ˈɪmpækt/; [n]碰撞,冲击;冲击力;影响; [v]冲击;压紧;产生影响;塞满; [or]4j;
impatient: [a]/ɪmˈpeɪʃnt/; [adj]不耐烦的,没有耐心的;急躁的; [or]4j;
imperative: [a]/ɪmˈperətɪv/; [adj]必要的;祈使的;急需的; [n]命令;必要的事;义务;驱使; [or]4j;
implement: [a]/ˈɪmplɪment/; [n]工具;器具; [v]实施,执行;执行; [or]4j;
implication: [a]/ˌɪmplɪˈkeɪʃn/; [n]暗示;含意;牵连;卷入;可能的后果; [or]4j;
imply: [a]/ɪmˈplaɪ/; [vt]暗示;暗指;意味着; [or]4j;
import: [a]/ɪmˈpɔːrt/; [v]进口;输入; [n]进口,进口货;含义,意义;重要性; [or]4j;
importance: [a]/ɪmˈpɔːrtns/; [n]重要;重要性; [or]4j;
impose: [a]/ɪmˈpoʊz/; [v]把.强加;强制实行,强迫接受; [or]4j;
impossible: [a]/ɪmˈpɑːsəbl/; [adj]不可能的; [n]不可能的事; [or]4j;
impress: [a]/ɪmˈpres/; [v]使有印象,使铭记; [or]4j;
impression: [a]/ɪmˈpreʃn/; [n]印记;印象,感觉,感想;压痕; [or]4j;
impressive: [a]/ɪmˈpresɪv/; [adj]给人深刻印象的;引人注目的; [or]4j;
improve: [a]/ɪmˈpruːv/; [v]改进,改善,提高; [or]4j;
improvement: [a]/ɪmˈpruːvmənt/; [n]改进,改善,进步; [or]4j;
incident: [a]/ˈɪnsɪdənt/; [n]事件;事变,军事冲突,冲突;事故; [adj]<法>附带的;<光>入射的;易发生的,伴随而来的; [or]4j;
incline: [a]/ɪnˈklaɪn/; [n]倾斜,斜坡,斜面; [v](使)倾斜,(使)倾向于; [or]4j;
include: [a]/ɪnˈkluːd/; [v]包括,包含,列入; [or]4j;
income: [a]/ˈɪnkʌm/; [n]收入; [or]4j;
increase: [a]/ɪnˈkriːs/; [v]增加,提高; [n]增加,增强,提高; [or]4j;
increasingly: [a]/ɪnˈkriːsɪŋli/; [adv]日益,越来越多地; [or]4j;
incredible: [a]/ɪnˈkredəbl/; [adj]不可相信的;惊人的,不可思议的; [or]4j;
indeed: [a]/ɪnˈdiːd/; [adv]的确,真正地,事实上; [or]4j;
independence: [a]/ˌɪndɪˈpendəns/; [n](国家的)独立;(人的)自立,独立; [or]4j;
independent: [a]/ˌɪndɪˈpendənt/; [adj]独立自主的,独自的,无偏见的; [n]无党派者,独立派人士; [or]4j;
index: [a]/ˈɪndeks/; [n]索引;指标,标志;指数; [v]附以索引,编入索引; [or]4j;
indicate: [a]/ˈɪndɪkeɪt/; [vt]指出,指示,标示;表明,表示,显示; [or]4j;
indication: [a]/ˌɪndɪˈkeɪʃn/; [n]指示;迹象; [or]4j;
indicative: [a]/ɪnˈdɪkətɪv/; [adj]指示的;暗示的;陈述的; [n]陈述语气; [or]4j;
indifferent: [a]/ɪnˈdɪfrənt/; [adj]不感兴趣的,不关心的;平庸的;冷漠的; [or]4j;
indirect: [a]/ˌɪndəˈrekt/; [adj]迂回的,间接的,不坦率的; [or]4j;
indispensable: [a]/ˌɪndɪˈspensəbl/; [adj]必不可少的;必需的; [or]4j;
individual: [a]/ˌɪndɪˈvɪdʒuəl/; [adj]个别的,独特的;单独的; [n]独立的个体; [or]4j;
indoor: [a]/ˈɪndɔːr/; [adj]室内的; [or]4j;
indoors: [a]/ˌɪnˈdɔːrz/; [adv]在室内,在屋里; [or]4j;
induce: [a]/ɪnˈduːs/; [v]引导,劝诱,诱导; [or]4j;
industrial: [a]/ɪnˈdʌstriəl/; [adj]工业的;产业的; [n]产业工人;工业公司;<商>工业股票; [or]4j;
industry: [a]/ˈɪndəstri/; [n]工业,产业;勤劳;专题研究; [or]4j;
inevitable: [a]/ɪnˈevɪtəbl/; [adj]不可避免的,必然的; [n]必然发生的事; [or]4j;
infant: [a]/ˈɪnfənt/; [n]幼儿,婴儿; [adj]婴儿的;初期的,初创的; [or]4j;
infect: [a]/ɪnˈfekt/; [v]传染,感染;使受影响; [or]4j;
infer: [a]/ɪnˈfɜːr/; [vt]做出推论,推断;推理;暗示; [vi]推断; [or]4j;
inference: [a]/ˈɪnfərəns/; [n]推断,推断的结果; [or]4j;
inferior: [a]/ɪnˈfɪriər/; [adj](等级,地位等)下等的,低等的;低劣的; [n]部下,地位低的人;次品; [or]4j;
infinite: [a]/ˈɪnfɪnət/; [adj]无限的,无穷的;无数的; [n]无穷,无限大; [or]4j;
inflation: [a]/ɪnˈfleɪʃn/; [n]通货膨胀;(充气后)膨胀;自负; [or]4j;
influence: [a]/ˈɪnfluəns/; [n]影响,势力;有影响的人或事; [v]影响; [or]4j;
influential: [a]/ˌɪnfluˈenʃl/; [adj]有影响的,有影响力的; [or]4j;
inform: [a]/ɪnˈfɔːrm/; [v]通知,向.报告;赋特征于;告发; [or]4j;
ingredient: [a]/ɪnˈɡriːdiənt/; [n](烹调的)原料;(构成的)要素,因素; [or]4j;
inhabitant: [a]/ɪnˈhæbɪtənt/; [n]居民,住户; [or]4j;
inherit: [a]/ɪnˈherɪt/; [v]经遗传而得(特性等);接受遗产;沿袭;继任; [or]4j;
initial: [a]/ɪˈnɪʃl/; [adj]第一的;最初的;开始的; [n]首字母; [or]4j;
initiative: [a]/ɪˈnɪʃətɪv/; [n]主动权,主动性;首创精神;(重要的)法案,倡议; [or]4j;
injection: [a]/ɪnˈdʒekʃn/; [n]打针;注射,注入;充满; [or]4j;
injure: [a]/ˈɪndʒər/; [v]伤害;损害,损伤; [or]4j;
injury: [a]/ˈɪndʒəri/; [n]损害,伤害;受伤; [or]4j;
inland: [a]/ˈɪnlænd/; [adv]在内陆地; [adj]内陆的,国内的; [n]内陆; [or]4j;
inn: [a]/ɪn/; [n]客栈,小旅馆; [or]4j;
inner: [a]/ˈɪnər/; [adj]内部的;内心的,秘密的;精神的; [n]内部,里面; [or]4j;
innocent: [a]/ˈɪnəsnt/; [adj]天真的,单纯的;无辜的,清白的;无恶意的; [n]天真无邪的人; [or]4j;
input: [a]/ˈɪnpʊt/; [n]投入;[电学,计算机]输入; [vt]输入; [or]4j;
inquire: [a]/ɪn'kwaɪər/; [v]打听,询问;调查; [or]4j;
inquiry: [a]/ˈɪnkwəri/; [n]调查;询问;打听; [or]4j;
insect: [a]/ˈɪnsekt/; [n]昆虫; [or]4j;
insert: [a]/ɪnˈsɜːrt/; [vt]插入,嵌入; [n]插入物;插页; [or]4j;
insight: [a]/ˈɪnsaɪt/; [n]深刻的理解,洞察力,见识; [or]4j;
insist: [a]/ɪnˈsɪst/; [v]坚持;坚持要求;坚持认为; [or]4j;
inspect: [a]/ɪnˈspekt/; [v]检查,审查; [or]4j;
inspire: [a]/ɪnˈspaɪər/; [v]使生灵感;启示;激发,激励; [or]4j;
install: [a]/ɪnˈstɔːl/; [v]安装,安置,使就职; [or]4j;
installation: [a]/ˌɪnstəˈleɪʃn/; [n]安装,装置;就职; [or]4j;
instant: [a]/ˈɪnstənt/; [n]瞬间; [adj]立即的;即食的;紧急的; [or]4j;
instead: [a]/ɪnˈsted/; [adv]代替,顶替,反而; [or]4j;
instinct: [a]/ˈɪnstɪŋkt/; [n]天性;本能;直觉; [adj]充满的; [or]4j;
institute: [a]/ˈɪnstɪtuːt/; [n]学会;学院,专科学院,研究院; [vt]建立,设立,制定; [or]4j;
institution: [a]/ˌɪnstɪˈtuːʃn/; [n]机构;制度;惯例;习俗;建立,设立,制定; [or]4j;
instruct: [a]/ɪnˈstrʌkt/; [v]指导;教;指示;通知; [or]4j;
instruction: [a]/ɪnˈstrʌkʃn/; [n]说明;指令,命令;指示;指导,讲授; [adj]说明用法的;操作指南的; [or]4j;
instrument: [a]/ˈɪnstrəmənt/; [n]仪器;工具;乐器;手段; [or]4j;
instrumental: [a]/ˌɪnstrəˈmentl/; [adj]乐器的;重要的;有帮助的;仪器的; [n]工具词;器乐曲;工具格; [or]4j;
insult: [a]/ɪnˈsʌlt/; [v]侮辱,凌辱; [n]侮辱的言词或行为; [or]4j;
insurance: [a]/ɪnˈʃʊrəns/; [n]保险;保险费;保险业;安全保证; [or]4j;
insure: [a]/ɪnˈʃʊr/; [v]买保险;为..投保,保险; [or]4j;
intellectual: [a]/ˌɪntəˈlektʃuəl/; [n]知识分子; [adj]智力的;理智的;需用智力的;聪明的; [or]4j;
intelligence: [a]/ɪnˈtelɪdʒəns/; [n]智力;情报;理解力; [or]4j;
intelligent: [a]/ɪnˈtelɪdʒənt/; [adj]聪明的;智能的; [or]4j;
intend: [a]/ɪnˈtend/; [v]想要,打算;企图,意指; [or]4j;
intense: [a]/ɪnˈtens/; [adj]强烈的,激烈的;紧张的;认真的;热情的; [or]4j;
intensity: [a]/ɪnˈtensəti/; [n]强度;强烈,剧烈; [or]4j;
intensive: [a]/ɪnˈtensɪv/; [adj]加强的,强调的;精耕细作的;密集的; [n]加强器;<语>强义词,强调成份; [or]4j;
intention: [a]/ɪnˈtenʃn/; [n]意图,意向,目的,打算; [or]4j;
interact: [a]/ˌɪntərˈækt/; [v]交流,沟通,互动;互相作用,互相影响; [or]4j;
interaction: [a]/ˌɪntərˈækʃn/; [n]互动;相互作用,相互影响; [or]4j;
interest: [a]/ˈɪntrəst/; [n]兴趣;利息;利益; [v]使感兴趣; [or]4j;
interfere: [a]/ˌɪntərˈfɪr/; [v]干涉,妨碍;妨碍;干涉; [vi]妨碍; [or]4j;
interior: [a]/ɪnˈtɪriər/; [adj]内部的; [n]内部,内心; [or]4j;
intermediate: [a]/ˌɪntərˈmiːdiət/; [adj]中间的,居间的;中级的; [n]中间体,媒介物; [v]调解,干涉; [or]4j;
international: [a]/ˌɪntərˈnæʃnəl/; [adj]国际的,世界的; [n]国际比赛,参加国际运动或体育比赛的选手,外国人; [or]4j;
interpret: [a]/ɪnˈtɜːrprɪt/; [v]口译;解释;把..理解为; [or]4j;
interpretation: [a]/ɪnˌtɜːrprɪˈteɪʃn/; [n]理解,解释;口译; [or]4j;
interrupt: [a]/ˌɪntəˈrʌpt/; [v]打扰;打断,中断;插嘴;妨碍; [or]4j;
interval: [a]/ˈɪntərvl/; [n]间隔;中场休息,幕间休息;间距; [or]4j;
interview: [a]/ˈɪntərvjuː/; [n]面谈,面试,采访; [v]面试,采访; [or]4j;
intimate: [a]/ˈɪntɪmət/; [adj]亲密的,密切的;详细的; [v]暗示;宣布,通知; [n]密友,知己; [or]4j;
introduce: [a]/ˌɪntrəˈduːs/; [v]介绍;传入,引进;提出;采用; [or]4j;
introduction: [a]/ˌɪntrəˈdʌkʃn/; [n]介绍;引进;引言; [or]4j;
invade: [a]/ɪnˈveɪd/; [v]侵略;侵犯;侵害;涌入;渗透;侵略,侵犯; [or]4j;
invariably: [a]/ɪnˈveriəbli/; [adv]总是;不变地,永恒地; [or]4j;
invasion: [a]/ɪnˈveɪʒn/; [n]侵略,入侵;侵犯;侵袭;大批涌入; [or]4j;
invent: [a]/ɪnˈvent/; [v]发明;编造; [or]4j;
invention: [a]/ɪnˈvenʃn/; [n]发明,发明物;虚构;发明才能; [or]4j;
inventor: [a]/ɪnˈventər/; [n]发明家; [or]4j;
invest: [a]/ɪnˈvest/; [v]投资,投入;赋予,给予; [or]4j;
investigate: [a]/ɪnˈvestɪɡeɪt/; [v]调查,研究; [or]4j;
investment: [a]/ɪnˈvestmənt/; [n]投资,投资额;投入; [or]4j;
invisible: [a]/ɪnˈvɪzəbl/; [adj]看不见的,无形的; [or]4j;
invitation: [a]/ˌɪnvɪˈteɪʃn/; [n]请柬;邀请;招致; [or]4j;
invite: [a]/ɪnˈvaɪt/; [v]邀请;招待;招致; [or]4j;
involve: [a]/ɪnˈvɑːlv/; [v]牵涉,涉及;卷入,使参与;吸引;包含,需要,影响; [or]4j;
involved: [a]/ɪnˈvɑːlvd/; [adj]有关的;卷入的;复杂的; [or]4j;
inward: [a]/ˈɪnwərd/; [adv]内向;内心里; [adj]里面的;向内的;本来的;亲密的; [n]内部;内脏; [or]4j;
iron: [a]/ˈaɪərn/; [v]烫(衣),熨; [n]铁;熨斗; [adj]铁的;刚强的;严酷的; [or]4j;
irrigation: [a]/ˌɪrɪˈɡeɪʃn/; [n]灌溉; [or]4j;
isolate: [a]/ˈaɪsəleɪt/; [v]使隔离;使孤立; [adj]孤立的;单独的; [or]4j;
issue: [a]/ˈɪʃuː/; [n]问题;议题;发行物;子女; [v]发行;发布;分配,分发,给; [or]4j;
item: [a]/ˈaɪtəm/; [n]物品;条,条款,项目; [or]4j;
jail: [a]/dʒeɪl/; [n]监狱;看守所; [v]监禁;拘留; [or]4j;
jam: [a]/dʒæm/; [n]果酱;阻塞; [v](使)阻塞,使塞满; [or]4j;
jar: [a]/dʒɑːr/; [n]罐坛,广口瓶,坛子,刺耳声,震动; [v]冲突,震动,刺激,发出刺耳声;刺激(神经);给.不快之感(神经); [or]4j;
jaw: [a]/dʒɔː/; [n]颌,颚,下巴; [v]唠唠叨叨,喋喋不休; [or]4j;
jazz: [a]/dʒæz/; [n]爵士乐; [or]4j;
jealous: [a]/ˈdʒeləs/; [adj]妒忌的,妒羡的; [or]4j;
jeans: [a]/dʒiːnz/; [n]牛仔裤;工装裤; [or]4j;
jet: [a]/dʒet/; [n]喷气式飞机;黑玉; [v]乘坐喷气式飞机; [adj]喷气式(发动机)推进的;黑色大理石制的; [or]4j;
jewel: [a]/ˈdʒuːəl/; [n]宝石;宝石饰物; [v]镶嵌; [or]4j;
joint: [a]/dʒɔɪnt/; [n]骨关节,接合处,廉价酒馆; [adj]连接的,共同的,联合的; [v]结合,联合;为.装上接头,使.有接缝; [or]4j;
journal: [a]/ˈdʒɜːrnl/; [n]定期刊物,杂志;日报;日记; [or]4j;
journalist: [a]/ˈdʒɜːrnəlɪst/; [n]记者,新闻工作者; [or]4j;
journey: [a]/ˈdʒɜːrni/; [n]旅行,旅程; [v]旅行; [or]4j;
judge: [a]/dʒʌdʒ/; [v]判决,审判,评价; [n]裁判员;法官;鉴赏者; [or]4j;
judgment: [a]/'dʒʌdʒmənt/; [n]审判,宣判;意见,看法;判断力; [or]4j;
jungle: [a]/ˈdʒʌŋɡl/; [n]丛林,密林;危险地带;丛林音乐; [or]4j;
junior: [a]/ˈdʒuːniər/; [adj]年少的;下级的;低年级的; [n]年少者,晚辈;(美国四年制大学)三年级学生;职位较低者; [or]4j;
jury: [a]/ˈdʒʊri/; [n]陪审团;全体评审员,评判委员会; [or]4j;
justice: [a]/ˈdʒʌstɪs/; [n]正义;公平;合理;妥当;应得的赏罚;审判;审判员; [or]4j;
keen: [a]/kiːn/; [adj]敏锐的;热衷的,热心的;强烈的,渴望的; [v]恸哭; [n]〈英〉号哭,恸哭; [adv]如饥似渴地; [or]4j;
kettle: [a]/ˈketl/; [n]茶壶; [or]4j;
keyboard: [a]/ˈkiːbɔːrd/; [n]键盘;琴键; [v]录入信息; [or]4j;
kid: [a]/kɪd/; [n]小孩,儿童;年轻人;小山羊; [v]开玩笑,欺骗; [adj]年幼的;小山羊皮制的; [or]4j;
kilogram: [a]/ˈkɪləɡræm/; [n]千克,公斤; [or]4j;
kilometer: [a]/kɪˈlɑːmɪtər/; [n]千米,公里; [or]4j;
kindergarten: [a]/ˈkɪndərɡɑːrtn/; [n]幼儿园; [or]4j;
kindness: [a]/ˈkaɪndnəs/; [n]仁慈,亲切;好意;友好行为; [or]4j;
kingdom: [a]/ˈkɪŋdəm/; [n]王国,领域; [or]4j;
kiss: [a]/kɪs/; [v]吻,接吻; [n]吻; [or]4j;
kit: [a]/kɪt/; [n]成套工具;工具箱;装备; [vt]装备; [or]4j;
kneel: [a]/niːl/; [v]跪,跪下,跪着; [or]4j;
knot: [a]/nɑːt/; [n]绳结,结合,树的节; [v]打结; [or]4j;
label: [a]/ˈleɪbl/; [n]标签;称号;唱片公司; [v]把..称为,贴标签于..; [or]4j;
labor: [a]/'leɪbər/; [n]劳动,劳力,劳工; [v]劳动,苦干; [adj]劳动的; [or]4j;
lack: [a]/læk/; [n]欠缺;不足; [v]缺乏,不足; [or]4j;
lad: [a]/læd/; [n]小伙子; [or]4j;
ladder: [a]/ˈlædər/; [n]梯子,阶梯; [vi](长筒袜等)抽丝; [or]4j;
lag: [a]/læɡ/; [n]落后,延迟; [v]落后;缓慢进行,减退; [or]4j;
lamb: [a]/læm/; [n]小羊;羊羔肉; [or]4j;
landlord: [a]/ˈlændlɔːrd/; [n]房东,地主,老板; [or]4j;
landscape: [a]/ˈlændskeɪp/; [n]风景;风景画;景观;横向打印格式; [v]美化环境; [or]4j;
lane: [a]/leɪn/; [n]小径,巷,行车道; [or]4j;
lap: [a]/læp/; [n]腰以下及大腿的前面部分;(跑道的)一圈; [v](赛跑中)比(某人)领先一圈;轻拍; [or]4j;
largely: [a]/ˈlɑːrdʒli/; [adv]大部分,大量地,主要地; [or]4j;
laser: [a]/ˈleɪzər/; [n]激光,激光器; [or]4j;
lately: [a]/ˈleɪtli/; [adv]最近; [or]4j;
later: [a]/ˈleɪtər/; [adv]后来;过一会儿; [adj]后来的;以后的;接近末期的; [or]4j;
latter: [a]/ˈlætər/; [n]后者; [adj]后面的; [or]4j;
laughter: [a]/ˈlæftər/; [n]笑,笑声; [or]4j;
launch: [a]/lɔːntʃ/; [v]发射;出海;创办,开始从事; [n]发射,投放市场;(游艇,汽艇)下水;发行; [or]4j;
laundry: [a]/ˈlɔːndri/; [n]洗衣;送洗的衣物;洗衣店;洗衣房; [or]4j;
lavatory: [a]/ˈlævətɔːri/; [n]厕所,盥洗室; [or]4j;
lawn: [a]/lɔːn/; [n]草地;草坪;(衣服用)细麻; [or]4j;
lawyer: [a]/ˈlɔːjər/; [n]律师; [or]4j;
layer: [a]/ler/; [n]层;层次;阶层; [v]把.分层堆放;借助压条法;将(头发)剪成不同层次; [or]4j;
layout: [a]/ˈleɪaʊt/; [n]布局;(版面)设计; [or]4j;
lazy: [a]/ˈleɪzi/; [adj]懒惰的;懒散的;慢吞吞的; [or]4j;
leader: [a]/ˈliːdər/; [n]领导,领袖,指挥者,领先的人; [or]4j;
leadership: [a]/ˈliːdərʃɪp/; [n]领导,领导地位;领导能力;领导层; [or]4j;
leading: [a]/ˈliːdɪŋ/; [adj]首位的,居前的;卓著的,显赫的;主角的; [n]行距(相邻两个文本行之间的距离); [or]4j;
league: [a]/liːɡ/; [n]联盟;社团;里格(=3.18海里); [v]使..结盟,与..联合; [or]4j;
leak: [a]/liːk/; [v]漏;泄露; [n]漏洞;泄漏,裂缝; [or]4j;
lean: [a]/liːn/; [v]倾斜,斜靠; [adj]瘦骨嶙峋的;无脂肪的; [or]4j;
leap: [a]/liːp/; [v]跳跃;暴涨; [n]跳跃;跳动;上涨; [or]4j;
learned: [a]/ˈlɜːrnɪd/; [adj]有学问的;博学的; [or]4j;
learning: [a]/ˈlɜːrnɪŋ/; [n]学习;知识; [or]4j;
lease: [a]/liːs/; [v]出租,租得; [n]租约,租契; [or]4j;
leather: [a]/ˈleðər/; [n]皮革;皮制品; [vt]用皮鞭抽打;用皮革覆盖; [or]4j;
lecture: [a]/ˈlektʃər/; [n]讲演;讲课;讲座;训斥; [v]讲演;向.讲演;教训; [or]4j;
legal: [a]/ˈliːɡl/; [adj]合法的,法定的;法律的; [or]4j;
leisure: [a]/ˈliːʒər/; [n]闲暇,空暇,休闲时间; [adj]空闲的; [or]4j;
lemon: [a]/ˈlemən/; [n]柠檬;柠檬黄;柠檬汁; [adj]浅黄色的; [or]4j;
length: [a]/leŋθ/; [n]长,长度,持续时间;一段 (绳子,布,木头等); [or]4j;
lens: [a]/lenz/; [n]镜头;透镜;镜片;晶状体; [or]4j;
lessen: [a]/ˈlesn/; [v]减少;减轻; [or]4j;
lever: [a]/ˈlevər/; [n]杠杆;控制杆;施加影响的手段; [v]用杠杆移动;撬开; [or]4j;
liable: [a]/ˈlaɪəbl/; [adj](for)有责任的;有义务的;(to)有.倾向的;易于.的,有可能.; [or]4j;
liar: [a]/ˈlaɪər/; [n]说谎的人; [or]4j;
liberate: [a]/ˈlɪbəreɪt/; [v]解放,释放; [or]4j;
liberty: [a]/ˈlɪbərti/; [n]自由; [or]4j;
librarian: [a]/laɪˈbreriən/; [n]图书管理员,图书馆馆长; [or]4j;
license: [a]/ˈlaɪsns/; [n]许可;执照; [v]许可,准许;发许可证; [or]4j;
lick: [a]/lɪk/; [v]舔;卷烧;战胜;使无法理解;轻轻拍打; [vi]舔; [n]舔;舌头一次舔的量;狠揍; [or]4j;
lid: [a]/lɪd/; [n]盖,盖子; [or]4j;
lifetime: [a]/ˈlaɪftaɪm/; [n]寿命,一生,终身;使用期,有效期限; [adj]一生的,终生的; [or]4j;
lightning: [a]/ˈlaɪtnɪŋ/; [n]闪电;意外的好运; [vi]闪电; [adj]闪电的;闪电般的,迅速的; [or]4j;
likelihood: [a]/ˈlaɪklihʊd/; [n]可能;可能性; [or]4j;
likely: [a]/ˈlaɪkli/; [adj]有可能;可信的;适合的; [adv]很可能; [or]4j;
likewise: [a]/ˈlaɪkwaɪz/; [adv]同样地,此外; [or]4j;
limb: [a]/lɪm/; [n]肢体;臂;枝干;树枝; [v]肢解; [or]4j;
lime: [a]/laɪm/; [n]酸橙;(生)石灰,氧化钙;<植>椴树,菩提树; [v]用石灰处理;撒(刷,涂上,加)石灰; [adj]石灰的;绿黄色的; [or]4j;
limitation: [a]/ˌlɪmɪˈteɪʃn/; [n]限制,局限性; [or]4j;
limited: [a]/ˈlɪmɪtɪd/; [adj]有限的;被限制的; [or]4j;
link: [a]/lɪŋk/; [n]链接,联系,交通路线; [v]连接,结合; [or]4j;
lip: [a]/lɪp/; [n]嘴唇;唇状物; [v]接吻;说话;拍打; [adj]唇的;口头上的; [or]4j;
liquid: [a]/ˈlɪkwɪd/; [n]液体; [adj]液体的;清脆的; [or]4j;
liquor: [a]/ˈlɪkər/; [n]酒;烈性酒;液剂; [or]4j;
liter: [a]/ˈliːtər/; [n](=litre)升,公升; [or]4j;
literacy: [a]/ˈlɪtərəsi/; [n]读写能力;识字;有文化;教养; [or]4j;
literary: [a]/ˈlɪtəreri/; [adj]文学的,文学上的;精通文学的;以写作为职业的;书本上的;书面的;书面语的; [or]4j;
literature: [a]/ˈlɪtrətʃər/; [n]文学;宣传册;文献; [or]4j;
lively: [a]/ˈlaɪvli/; [adj]活泼的,生动的;轻快的,富有活力的;生机勃勃的; [or]4j;
liver: [a]/ˈlɪvər/; [n]肝脏;(供食用的动物)肝脏; [or]4j;
load: [a]/loʊd/; [v]使担负;装载;加载;填装; [vi]装货; [n]负载;负荷;工作量;装载量; [or]4j;
loaf: [a]/loʊf/; [n](一条)面包; [v]虚度光阴; [or]4j;
loan: [a]/loʊn/; [n]贷款;暂借; [v]借贷; [or]4j;
local: [a]/ˈloʊkl/; [adj]当地的,本地的;(身体)局部的; [n]当地人; [or]4j;
locality: [a]/loʊˈkæləti/; [n]地区;地点;位置;方位; [or]4j;
locate: [a]/ˈloʊkeɪt/; [v]使.坐落于,位于,处于;找出.的位置;设立,建立; [or]4j;
location: [a]/loʊˈkeɪʃn/; [n]位置,地点;定位;外景拍摄地; [or]4j;
lodge: [a]/lɑːdʒ/; [v]住宿;存放,保管; [n]小屋;兽穴; [or]4j;
log: [a]/lɔːɡ/; [n]原木;航海日志; [v]伐木;航行;记录;登录; [or]4j;
logic: [a]/ˈlɑːdʒɪk/; [n]逻辑,推理;逻辑性;逻辑学; [or]4j;
logical: [a]/ˈlɑːdʒɪkl/; [adj]有逻辑的;合情合理的;推理正确的; [or]4j;
loop: [a]/luːp/; [n](用线,绳,带等打成的)环;环状物;环线; [vi]成圈; [vt]打成环状; [or]4j;
loose: [a]/luːs/; [adj]宽松的;(指言行等)不严谨的; [v]放松; [n]自由; [adv]松散地;不严格地; [or]4j;
loosen: [a]/ˈluːsn/; [v]松开; [vt]放松;放宽;变松; [vi]松弛; [or]4j;
lord: [a]/lɔːrd/; [n]君主;有爵位的贵族;阁下;上帝; [v]逞威风; [vt]称.为勋爵; [or]4j;
lorry: [a]/ˈlɔːri/; [n]卡车;运货汽车; [or]4j;
loss: [a]/lɔːs/; [n]遗失;失败;失去;伤亡及被俘人员; [or]4j;
lot: [a]/lɑːt/; pro[n]大量,许多;场地;一批;某一类人; [adv](与形容词和副词连用)很;非常;(与动词连用)非常; [v]分组;把.划分(常与out连用);把(土地)划分成块;抽签;拈阄; [or]4j;
lounge: [a]/laʊndʒ/; [n]候机室,休息室,酒吧间;沙发,躺椅;懒散的步子; [v](懒散地)倚,躺;闲逛; [or]4j;
lover: [a]/ˈlʌvər/; [n]情人;恋人,爱人;爱好者; [or]4j;
lower: [a]/ˈloʊər/; [v]降低,降落; [adj]较低的,下级的; [or]4j;
loyal: [a]/ˈlɔɪəl/; [adj]忠心的;忠诚的; [n]效忠(君主)的臣民; [or]4j;
loyalty: [a]/ˈlɔɪəlti/; [n]忠诚;忠心耿耿; [or]4j;
lucky: [a]/ˈlʌki/; [adj]幸运的;吉祥的,带来好运的; [or]4j;
luggage: [a]/ˈlʌɡɪdʒ/; [n]行李箱,行李;衣箱;皮箱; [or]4j;
lump: [a]/lʌmp/; [n]团;肿块;粗笨的人;一小方块 (糖); [v]成团,成堆;使成块; [or]4j;
lung: [a]/lʌŋ/; [n]肺; [or]4j;
luxury: [a]/ˈlʌkʃəri/; [adj]奢侈的,豪华的; [n]奢侈,奢华; [or]4j;
machinery: [a]/məˈʃiːnəri/; [n]机器,机关;机构,机制; [or]4j;
mad: [a]/mæd/; [adj]异常狂暴的;蠢笨的;精神错乱的;疯狂的;狂热的;生气的,狂怒的; [n]狂怒; [or]4j;
magazine: [a]/ˈmæɡəziːn/; [n]杂志,期刊;弹夹;弹药库; [or]4j;
magic: [a]/ˈmædʒɪk/; [n]魔术,戏法;魔法; [adj]有魔力的,魔术的; [or]4j;
magnet: [a]/ˈmæɡnət/; [n]磁体,磁铁; [or]4j;
magnetic: [a]/mæɡˈnetɪk/; [adj]有磁性的;有吸引力的; [or]4j;
magnificent: [a]/mæɡˈnɪfɪsnt/; [adj]华丽的,宏伟的,壮丽的; [or]4j;
maid: [a]/meɪd/; [n]女仆,少女;未婚女子; [or]4j;
mainland: [a]/ˈmeɪnlænd/; [n]大陆; [adj]大陆的; [or]4j;
maintain: [a]/meɪnˈteɪn/; [v]维持,保持;断言,宣称;供养,赡养; [or]4j;
maintenance: [a]/ˈmeɪntənəns/; [n]维护;生活费;赡养费,抚养费;维修;保持;保养; [or]4j;
major: [a]/ˈmeɪdʒər/; [adj]主要的,较多的,严重的; [n]成年人,主修(科目),陆军少校; [vi]专攻; [or]4j;
majority: [a]/məˈdʒɔːrəti/; [n]多数,大多数,多数票;法定成年年龄; [or]4j;
male: [a]/meɪl/; [n]男性,雄性; [adj]男性的,雄性的; [or]4j;
manage: [a]/ˈmænɪdʒ/; [v]管理;控制;设法做成;有时间做,安排(时间)做;应付过去,设法对付过去; [n]马术练习所; [or]4j;
management: [a]/ˈmænɪdʒmənt/; [n]经营,管理,处理;管理者; [or]4j;
mankind: [a]/mænˈkaɪnd/; [n]人类;男人; [or]4j;
manner: [a]/ˈmænər/; [n]态度;举止;方式,方法;(pl.)风俗,习惯; [or]4j;
manual: [a]/ˈmænjuəl/; [n]手册;指南; [adj]手的;手制的;手工的;体力的; [or]4j;
manufacture: [a]/ˌmænjuˈfæktʃər/; [v]生产;制造; [n]制造,生产;制造业;(复)产品; [or]4j;
manufacturer: [a]/ˌmænjuˈfæktʃərər/; [n]制造商;制造厂; [or]4j;
margin: [a]/ˈmɑːrdʒən/; [n]页边的空白,边缘;优势;利润; [or]4j;
marine: [a]/məˈriːn/; [adj]海洋的,航海的,海产的,海军的; [n]海军士兵; [or]4j;
mark: [a]/mɑːrk/; [v]打分数; [vt]在..上作记号,标记出; [n]分数;污点,痕迹;记号,符号,标志; [or]4j;
market: [a]/ˈmɑːrkɪt/; [n]市场;行情;销路; [v]销售;出售; [or]4j;
marriage: [a]/ˈmærɪdʒ/; [n]结婚;婚姻;婚礼;密切结合; [or]4j;
married: [a]/ˈmærid/; [adj]已婚的,夫妇的;密切结合的; [or]4j;
marry: [a]/ˈmæri/; [v]娶,嫁,结婚; [or]4j;
marvelous: [a]/ˈmɑːrvələs/; [adj]非凡的;叹为观止的,令人惊奇的; [n]怪事; [or]4j;
mask: [a]/mæsk/; [n]面具;遮蔽物;伪装; [v]隐藏(感情);掩盖,掩饰,掩护;伪装; [or]4j;
mass: [a]/mæs/; [n]众多;大多数;<物>质量;群众; [adj]大量的,大规模的; [v]聚集; [or]4j;
massive: [a]/ˈmæsɪv/; [adj]巨大的;大规模的;大量的; [or]4j;
master: [a]/ˈmæstər/; [n]主人;大师;硕士; [adj]精通的,主要的; [v]掌握,精通; [or]4j;
mat: [a]/mæt/; [n]席子;草席;垫子; [adj]暗淡的,无光泽的;粗糙的; [v]遮盖,用垫子作装饰;使.缠结;给(照片)镶框;使.表面无光;缠结; [or]4j;
match: [a]/mætʃ/; [n]比赛;敌手;伙伴,搭档;婚姻,配偶;火柴; [v]使相配,使对抗; [or]4j;
mate: [a]/meɪt/; [n]伙伴;同事;配偶; [v](使)成配偶,(使)成伙伴,交配; [or]4j;
material: [a]/məˈtɪriəl/; [n]材料,原料,资料; [adj]物质的,实体的; [or]4j;
math: [a]/mæθ/; [n]数学;计算过程; [or]4j;
mathematical: [a]/ˌmæθəˈmætɪkl/; [adj]数学的;精确的,复杂的;概率低的; [or]4j;
mathematics: [a]/ˌmæθəˈmætɪks/; [n]数学; [or]4j;
matter: [a]/ˈmætər/; [v]要紧;有关系; [n]问题,事件,物质; [or]4j;
mature: [a]/məˈtʃʊr/; [adj]成熟的;到期的; [vt]使成熟; [vi]成熟; [or]4j;
maximum: [a]/ˈmæksɪməm/; [n]最大值;最大限度; [adj]最大的; [or]4j;
maybe: [a]/ˈmeɪbi/; [adv]可能,大概,也许; [n]不确定性; [or]4j;
mayor: [a]/ˈmeɪər/; [n]市长; [or]4j;
meaning: [a]/ˈmiːnɪŋ/; [n]意义,意思;意图; [adj]意味深长的; [or]4j;
means: [a]/miːnz/; [n]方法,手段;工具;财富,收入; [v]意味着(mean的第三人称单数);打算或注定要某人成为或做某事; [or]4j;
meantime: [a]/ˈmiːntaɪm/; [n]同时;其间; [adv]同时;当时;在那当中; [or]4j;
meanwhile: [a]/ˈmiːnwaɪl/; [adv]同时,与此同时;其间,在此期间; [n]其间;其时; [or]4j;
measure: [a]/ˈmeʒər/; [v]测量;估量; [n]措施;方法;尺寸;量度标准; [or]4j;
measurement: [a]/ˈmeʒərmənt/; [n]衡量,测量;尺寸; [or]4j;
mechanic: [a]/məˈkænɪk/; [n]机(械)工; [or]4j;
mechanical: [a]/məˈkænɪkl/; [adj]机械的,机械学的,机械性的; [or]4j;
mechanics: [a]/məˈkænɪks/; [n]力学;机械学;技巧; [or]4j;
mechanism: [a]/ˈmekənɪzəm/; [n]机械装置;机制,机理,原理; [or]4j;
medal: [a]/ˈmedl/; [n]奖牌;勋章; [v]授予奖章; [or]4j;
media: [a]/ˈmiːdiə/; [n]媒体;传播媒介; [or]4j;
medical: [a]/ˈmedɪkl/; [adj]医学的,医疗的;内科的; [n]体格检查; [or]4j;
medicine: [a]/ˈmedɪsn/; [n]内服药,医药,医学,内科学; [or]4j;
medium: [a]/ˈmiːdiəm/; [adj]中等的;适中的; [n]手段;媒介;材料; [or]4j;
melt: [a]/melt/; [v]融化;熔化;溶化; [or]4j;
member: [a]/ˈmembər/; [n]成员,一员;会员; [or]4j;
membership: [a]/ˈmembərʃɪp/; [n]会员资格;成员资格; [or]4j;
memoir: [a]/ˈmemwɑːr/; [n]回忆录,自传(memoirs);传略; [or]4j;
memorial: [a]/məˈmɔːriəl/; [n]纪念像,纪念物,纪念碑,纪念仪式; [adj]纪念的;记忆的; [or]4j;
memorize: [a]/ˈmeməraɪz/; [v]熟记; [or]4j;
memory: [a]/ˈmeməri/; [n]记忆;回忆;存储; [or]4j;
mend: [a]/mend/; [v]修理,缝补;改正,改进;好转;治愈; [n]痊愈;改进; [or]4j;
mental: [a]/ˈmentl/; [adj]精神的;心理的; [or]4j;
mention: [a]/ˈmenʃn/; [v]提及,提名; [n]谈到,提及; [or]4j;
menu: [a]/ˈmenjuː/; [n]菜单,菜谱,菜; [or]4j;
merchant: [a]/ˈmɜːrtʃənt/; [n]商人;批发商; [or]4j;
mercury: [a]/ˈmɜːrkjəri/; [n]水银,汞;水星(Mercury); [or]4j;
mercy: [a]/ˈmɜːrsi/; [n]宽恕,仁慈,怜悯,恩惠; [or]4j;
mere: [a]/mɪr/; [adj]仅仅的;纯粹的; [n]小湖,池塘;〈英〉边境(线); [or]4j;
merely: [a]/ˈmɪrli/; [adv]仅仅;仅仅,只不过; [or]4j;
merit: [a]/ˈmerɪt/; [n]优点;价值;功绩; [v]值得;应得; [or]4j;
merry: [a]/ˈmeri/; [adj]欢乐的,愉快的;<口>微醉的; [or]4j;
mess: [a]/mes/; [n]凌乱状态,混乱状态;肮脏,污秽;困境;食堂;大量某物; [v]弄脏,弄乱;浪费时间,瞎闹; [or]4j;
meter: [a]/ˈmiːtər/; [n]计,表,仪表;米; [v]用仪表测量; [or]4j;
method: [a]/ˈmeθəd/; [n]办法,方法;秩序,规律; [or]4j;
metric: [a]/ˈmetrɪk/; [adj]米制的,公制的; [n]度量标准;<数学>度量;诗体,韵文,诗韵; [or]4j;
microphone: [a]/ˈmaɪkrəfoʊn/; [n]话筒,麦克风; [or]4j;
microscope: [a]/ˈmaɪkrəskoʊp/; [n]显微镜; [or]4j;
midday: [a]/ˌmɪdˈdeɪ/; [n]中午,正午; [adj]正午的; [or]4j;
midnight: [a]/ˈmɪdnaɪt/; [n]午夜,半夜;午夜蓝; [or]4j;
mild: [a]/maɪld/; [adj]味淡的;温暖的;轻微的;温和的; [n]淡味啤酒; [or]4j;
military: [a]/ˈmɪləteri/; [n]军队; [adj]军事的; [or]4j;
mill: [a]/mɪl/; [n]磨坊,碾磨机,制造厂; [v]碾,磨,(毫无目的地)乱转; [or]4j;
millimeter: [a]/ˈmɪlimiːtər/; [n]毫米; [or]4j;
million: [a]/ˈmɪljən/; [num]百万,许多; [or]4j;
mine: [a]/maɪn/; [n]矿,矿山;地雷; [v]开采,采矿;埋设地雷; pro[n]我的(所有物); [or]4j;
mineral: [a]/ˈmɪnərəl/; [adj]矿物的; [n]矿物,矿物质; [or]4j;
minimum: [a]/ˈmɪnɪməm/; [adj]最少的,最低程度的; [n]最低限度,最小量; [or]4j;
minister: [a]/ˈmɪnɪstər/; [v]给予援助,救助;照料,服侍; [n]部长,大臣;公使,外交使节;牧师; [or]4j;
ministry: [a]/ˈmɪnɪstri/; [n](政府的)部,内阁,(全体)牧师; [or]4j;
minority: [a]/maɪˈnɔːrəti/; [n]少数;少数民族;未成年; [adj]构成少数的; [or]4j;
minus: [a]/ˈmaɪnəs/; prep. 减(去); [adj]负的; [n]减号;劣势; [or]4j;
miracle: [a]/ˈmɪrəkl/; [n]奇迹; [or]4j;
mirror: [a]/ˈmɪrər/; [n]镜子;真实的写照,反映; [v]反射,反映; [or]4j;
miserable: [a]/ˈmɪzrəbl/; [adj]悲惨的,痛苦的;使人难受的;不快乐的,不友善的,暴躁的(人);极少的; [or]4j;
mislead: [a]/ˌmɪsˈliːd/; [v]把..带错路;使误入歧途; [or]4j;
missile: [a]/ˈmɪsl/; [n]导弹;投射出的物体或武器; [adj]导弹的;可投掷的;用以发射导弹的; [or]4j;
missing: [a]/ˈmɪsɪŋ/; [adj]失踪的;缺少的; [or]4j;
mission: [a]/ˈmɪʃn/; [n]任务,使命;代表团,使团; [vi]派遣..执行任务; [or]4j;
mist: [a]/mɪst/; [n]薄雾,朦胧; [v]使模糊,下雾; [or]4j;
mister: [a]/ˈmɪstər/; [n]先生; [or]4j;
misunderstand: [a]/ˌmɪsʌndərˈstænd/; [v]误解,误会; [or]4j;
mix: [a]/mɪks/; [v]混合;使结合; [n]混合;结合;配料;混杂; [or]4j;
mixture: [a]/ˈmɪkstʃər/; [n]混合;混合物,混合剂(液); [or]4j;
mobile: [a]/ˈmoʊbl/; [n]风铃,悬挂饰物;手机,移动电话; [adj]可移动的;行动方便的; [or]4j;
mode: [a]/moʊd/; [n]模式;方式; [or]4j;
model: [a]/ˈmɑːdl/; [n]模型;模特; [v]模仿;当模特;(用黏土,木头等)做..的造型,塑造;当模特展示服装; [adj]模范的;典型的; [or]4j;
moderate: [a]/ˈmɑːdərət/; [adj]适度的,适中的,温和的,稳健的,中等的; [v]使减轻,使缓和; [n]温和主义者;稳健的人; [or]4j;
modest: [a]/ˈmɑːdɪst/; [adj]谦虚的,谦逊的;端庄的,羞怯的;不太大(或太贵,太重要)的,适度的; [or]4j;
modify: [a]/ˈmɑːdɪfaɪ/; [v]改装,修改,更改;修饰,限定; [or]4j;
moist: [a]/mɔɪst/; [adj](表面)潮湿的,湿润的; [or]4j;
moisture: [a]/ˈmɔɪstʃər/; [n]水分;潮湿;湿度;湿气; [or]4j;
mold: [a]/moʊld/; [vt]塑造;使形成; [v]把..塑造成; [n]霉菌;模子;气质; [or]4j;
molecule: [a]/ˈmɑːlɪkjuːl/; [n]分子,微粒; [or]4j;
monetary: [a]/ˈmɑːnɪteri/; [adj]货币的,金融的;金钱的; [or]4j;
monitor: [a]/ˈmɑːnɪtər/; [n]显示器;监视器;班长; [v]监视;监督;监测; [or]4j;
monopoly: [a]/məˈnɑːpəli/; [n]垄断;专卖;垄断商品;专卖商品; [or]4j;
monthly: [a]/ˈmʌnθli/; [adj]每月的; [adv]每月一次,按月; [n]月刊; [or]4j;
monument: [a]/ˈmɑːnjumənt/; [n]纪念碑;遗迹,遗址; [or]4j;
mood: [a]/muːd/; [n]情绪,心情;氛围;语气; [or]4j;
moral: [a]/ˈmɔːrəl/; [adj]道德(上)的,道义的; [n]道德,品行;寓意; [or]4j;
morality: [a]/məˈræləti/; [n]道德,道德观;道德规范,伦理体系; [or]4j;
moreover: [a]/mɔːrˈoʊvər/; [adv]此外,而且; [or]4j;
mosquito: [a]/məˈskiːtoʊ/; [n]蚊子; [or]4j;
mother: [a]/ˈmʌðər/; [n]母亲,妈妈; [adj]母亲的;母体的; [v]生育;像母亲一样关爱; [or]4j;
motion: [a]/ˈmoʊʃn/; [n]运动,移动;手势;提议; [v]示意; [or]4j;
motivate: [a]/ˈmoʊtɪveɪt/; [vt]激励;使有动机;促进;促动;激发..的积极性; [or]4j;
motive: [a]/ˈmoʊtɪv/; [n]动机,目的; [adj]发动的,运动的,动机的; [v]引发,促进,激发; [or]4j;
motor: [a]/ˈmoʊtər/; [n]发动机,马达;车; [or]4j;
mount: [a]/maʊnt/; [v]登上;爬上;骑上;增长;组织,安排; [n]山;峰; [or]4j;
mountain: [a]/ˈmaʊntn/; [n]山,山脉;大堆; [or]4j;
movement: [a]/ˈmuːvmənt/; [n]动作,移动;运动;(交响乐)乐章; [or]4j;
mud: [a]/mʌd/; [n]泥; [or]4j;
mug: [a]/mʌɡ/; [n](有柄)大杯,嘴脸; [v]对.行抢劫; [or]4j;
multiple: [a]/ˈmʌltɪpl/; [adj]多重的,复合的,倍数的; [n]倍数; [or]4j;
multiply: [a]/ˈmʌltɪplaɪ/; [v]乘;繁殖;增加; [or]4j;
murder: [a]/ˈmɜːrdər/; [n]谋杀,凶杀,谋杀罪;遭罪的经历; [v]谋杀,凶杀; [or]4j;
muscle: [a]/ˈmʌsl/; [n]肌肉,肌;体力; [v]用强迫手段获得; [or]4j;
muscular: [a]/ˈmʌskjələr/; [adj]肌肉的;肌肉发达的;强有力的; [or]4j;
museum: [a]/mjuˈziːəm/; [n]博物馆,展览馆; [or]4j;
mushroom: [a]/ˈmʌʃrʊm/; [n]蘑菇; [vi]迅速发展;采蘑菇; [or]4j;
musical: [a]/ˈmjuːzɪkl/; [adj]音乐的;悦耳的;有音乐才能的,喜欢音乐的; [n]音乐片;音乐喜剧; [or]4j;
musician: [a]/mjuˈzɪʃn/; [n]音乐家,作曲家; [or]4j;
mutual: [a]/ˈmjuːtʃuəl/; [adj]互相的;彼此的;共同的; [or]4j;
myself: [a]/maɪˈself/; pro[n]我亲自;我自己; [or]4j;
mysterious: [a]/mɪˈstɪriəs/; [adj]神秘的; [or]4j;
mystery: [a]/ˈmɪstri/; [n]神秘,奥秘;神秘的事物; [or]4j;
myth: [a]/mɪθ/; [n]神话;虚构的信念(或观念,理论);杜撰出来的人(或事物); [or]4j;
nail: [a]/neɪl/; [n]指甲,爪;钉; [v]将..钉牢,钉住; [or]4j;
naked: [a]/ˈneɪkɪd/; [adj]裸体的,无遮蔽的; [or]4j;
narrow: [a]/ˈnæroʊ/; [adj]狭窄的;差距小的,微小的; [n]海峡;狭窄部分; [v]使变窄,缩小; [or]4j;
nation: [a]/ˈneɪʃn/; [n]民族,国家;国民; [or]4j;
nationality: [a]/ˌnæʃəˈnæləti/; [n]国籍;民族; [or]4j;
native: [a]/ˈneɪtɪv/; [adj]本地的,本国的;与生俱来的; [n]本地人;土著;当地动植物; [or]4j;
naturally: [a]/ˈnætʃrəli/; [adv]自然地,天然地; [or]4j;
nature: [a]/ˈneɪtʃər/; [n]大自然;性质;天性; [or]4j;
naval: [a]/ˈneɪvl/; [adj]海军的,军舰的; [or]4j;
navigation: [a]/ˌnævɪˈɡeɪʃn/; [n]导航,航行,航海; [or]4j;
navy: [a]/ˈneɪvi/; [n]海军; [or]4j;
nearby: [a]/ˌnɪrˈbaɪ/; [adj]附近的; [adv]在附近; [or]4j;
nearly: [a]/ˈnɪrli/; [adv]将近,几乎;接近地; [or]4j;
neat: [a]/niːt/; [adj]整洁的;灵巧的;纯的;不掺水的;干净利索的 (行动); [or]4j;
necessary: [a]/ˈnesəseri/; [adj]必要的,必需的;必然的,势必的; [n]必需品; [or]4j;
necessity: [a]/nəˈsesəti/; [n]必需品,需要;必要性,必然性; [or]4j;
needle: [a]/ˈniːdl/; [n]针;针状物;指针; [v]刺激; [or]4j;
negative: [a]/ˈneɡətɪv/; [adj]消极的,负面的;否定的; [n]否定,否定词;底片; [or]4j;
neglect: [a]/nɪˈɡlekt/; [v]忽视;忽略;疏忽; [n]疏忽;忽视; [or]4j;
negotiate: [a]/nɪˈɡoʊʃieɪt/; [v]谈判,交涉,商议;成功越过,渡过; [or]4j;
negotiation: [a]/nɪˌɡoʊʃiˈeɪʃn/; [n]谈判; [or]4j;
neighbor: [a]/'neɪbə/; [n]邻居,邻人;邻国; [adj]邻近的,邻接的; [vi]友好;毗邻而居; [vt]邻接; [or]4j;
neighborhood: [a]/ˈneɪbərhʊd/; [n]社区,临近地区; [or]4j;
nephew: [a]/ˈnefjuː/; [n]侄子,外甥; [or]4j;
nerve: [a]/nɜːrv/; [n]神经;胆量,勇气; [v]给.以力量,使振作; [or]4j;
nervous: [a]/ˈnɜːrvəs/; [adj]紧张的,焦虑不安的;害怕的;神经系统的,神经方面的; [or]4j;
nest: [a]/nest/; [n]巢;温床; [v]筑巢;嵌入; [or]4j;
net: [a]/net/; [n]网,网状物; [adj]纯利的,净值的,净的; [v]用网捕;捕获;净赚;踢入球门; [or]4j;
network: [a]/ˈnetwɜːrk/; [n]广播网,电视网;网络; [vi]建立关系网; [vt]联播;使联网; [or]4j;
neutral: [a]/ˈnuːtrəl/; [adj]中立的;中性的; [n]中立国;中性色; [or]4j;
nevertheless: [a]/ˌnevərðəˈles/; [adv]然而,不过;尽管如此,不过,仍然; [or]4j;
newly: [a]/ˈnuːli/; [adv]最近,新近,重新; [or]4j;
niece: [a]/niːs/; [n]侄女,外甥女; [or]4j;
nightmare: [a]/ˈnaɪtmer/; [n]噩梦;可怕的情景; [adj]可怕的,噩梦似的; [or]4j;
nine: [a]/naɪn/; [num]九;九个; [or]4j;
nineteen: [a]/ˌnaɪnˈtiːn/; [num]十九,十九个; [n]十九点;十九岁; [or]4j;
ninety: [a]/ˈnaɪnti/; [num]九十; [or]4j;
ninth: [a]/naɪnθ/; [num]第九; [n]九分之一; [or]4j;
noble: [a]/ˈnoʊbl/; [adj]高尚的;贵族的,高贵的; [n]贵族; [or]4j;
noisy: [a]/ˈnɔɪzi/; [adj]嘈杂的;喧闹的; [or]4j;
nonsense: [a]/ˈnɑːnsens/; [n]胡说,废话; [or]4j;
normal: [a]/ˈnɔːrml/; [adj]正常的; [or]4j;
northwest: [a]/ˌnɔːrθˈwest/; [n]西北方;西北; [adj]在西北的;向西北的;来自西北的; [adv]在西北;向西北;自西北; [or]4j;
nose: [a]/noʊz/; [n]鼻子;前部;嗅觉; [v]小心探索着前进;嗅; [or]4j;
notice: [a]/ˈnoʊtɪs/; [n]通知,告示;注意; [v]注意,察觉; [or]4j;
noticeable: [a]/ˈnoʊtɪsəbl/; [adj]引人注目的;明显的,显而易见的,显著的;值得注意的; [or]4j;
notify: [a]/ˈnoʊtɪfaɪ/; [v]通知,告知;报告; [or]4j;
notion: [a]/ˈnoʊʃn/; [n]概念,观念;观点,看法;突然的念头;意图; [or]4j;
notwithstanding: [a]/ˌnɑːtwɪθˈstændɪŋ/; prep. 尽管,虽然; [adv]尽管,虽然; [conj]尽管,虽然; [or]4j;
novel: [a]/ˈnɑːvl/; [n]小说,长篇故事; [adj]新奇的,新颖的,不同的; [or]4j;
nowadays: [a]/ˈnaʊədeɪz/; [adv]现今,现在; [n]当今,现代; [or]4j;
nowhere: [a]/ˈnoʊwer/; [adv]任何地方都不;没有任何地方,无处;找不到;在不重要的地方;突然(发生); [n]无名之地;任何地方; [or]4j;
nuclear: [a]/ˈnuːkliər/; [adj]原子核的;原子能的;细胞核的; [or]4j;
nucleus: [a]/ˈnuːkliəs/; [n]原子核,核心,细胞核; [or]4j;
nuisance: [a]/ˈnuːsns/; [n]讨厌的人;麻烦事;伤害; [or]4j;
numerous: [a]/ˈnuːmərəs/; [adj]为数众多的,许多的; [or]4j;
nursery: [a]/ˈnɜːrsəri/; [n]托儿所;保育室;苗圃; [or]4j;
nurture: [a]/ˈnɜːrtʃər/; [v]养育,培育;培植; [n]养育,培养;教养;营养物; [or]4j;
nut: [a]/nʌt/; [n]坚果;疯子,怪人; [or]4j;
nutritious: [a]/nuˈtrɪʃəs/; [adj]有营养的,滋养的; [or]4j;
nylon: [a]/ˈnaɪlɑːn/; [n]尼龙,尼龙长袜; [or]4j;
o'clock: [a]/əˈklɑːk/; [adv].点钟; [or]4j;
obey: [a]/oʊˈbeɪ/; [v]服从,听从,遵从;顺从,听从摆布; [or]4j;
object: [a]/ˈɑːbdʒekt/; [n]物体;宾语;目标; [v]提出..作为反对的理由;反对; [or]4j;
objection: [a]/əbˈdʒekʃn/; [n]反对,异议; [or]4j;
objective: [a]/əbˈdʒektɪv/; [n]目标;目的; [adj]客观的; [or]4j;
obligation: [a]/ˌɑːblɪˈɡeɪʃn/; [n]义务,责任; [or]4j;
oblige: [a]/əˈblaɪdʒ/; [v]迫使,使感激,施恩于,帮忙,使.成为必要; [or]4j;
observation: [a]/ˌɑːbzərˈveɪʃn/; [n]观察;评论;注意;遵守; [or]4j;
observe: [a]/əbˈzɜːrv/; [v]观察;注意,遵守;说,评论;庆祝,纪念; [or]4j;
observer: [a]/əbˈzɜːrvər/; [n]观察者; [or]4j;
obstacle: [a]/ˈɑːbstəkl/; [n]障碍;障碍物;妨碍; [or]4j;
obtain: [a]/əbˈteɪn/; [v]获得,赢得,取得;存在,流行,适用; [or]4j;
obvious: [a]/ˈɑːbviəs/; [adj]明显的,显然的;了无新意的;显而易见的; [or]4j;
occasion: [a]/əˈkeɪʒn/; [n]场合,时候;活动;时机,机会; [v]导致;引起; [or]4j;
occasional: [a]/əˈkeɪʒənl/; [adj]偶尔的;临时的;偶然的; [or]4j;
occupation: [a]/ˌɑːkjuˈpeɪʃn/; [n]占领,占据;占用,居住;职业,工作;消遣; [or]4j;
occupy: [a]/ˈɑːkjupaɪ/; [v]占领,占据,侵占;住在,居住,住进;担任(职务),任职;占用(时间,空间等),占有;使用(房屋,建筑); [or]4j;
occur: [a]/əˈkɜːr/; [vi]发生;出现,存在; [or]4j;
odd: [a]/ɑːd/; [adj]奇怪的;古怪的;奇数的;多种多样的;临时的; [n]奇特的事物;怪人;<高尔夫球>多于对方的一次击球; [adv](用于数字后)大约,左右,略多; [or]4j;
offend: [a]/əˈfend/; [v]冒犯,得罪,伤害.的感情; [or]4j;
offense: [a]/əˈfens/; [n]犯罪,冒犯,过错,触怒,犯规,进攻; [or]4j;
offensive: [a]/əˈfensɪv/; [adj]冒犯的,进攻的,无礼的,令人不快的,得罪人的; [n]进攻; [or]4j;
offer: [a]/ˈɔːfər/; [n]提供;特价;出价;录取(用)通知书;提议; [vt]给予,奉上;表示愿意 (做某事);提供;出价; [or]4j;
official: [a]/əˈfɪʃl/; [n]官员;行政官员;裁判; [adj]官方的,正式的,公务的; [or]4j;
olive: [a]/ˈɑːlɪv/; [n]橄榄;橄榄树;橄榄色; [adj]橄榄色的; [or]4j;
omit: [a]/əˈmɪt/; [v]删去,省去,忽略;遗漏; [or]4j;
oneself: [a]/wʌnˈself/; pro[n]亲自;自己; [or]4j;
onion: [a]/ˈʌnjən/; [n]洋葱,洋葱头; [or]4j;
online: [a]/ˌɑːnˈlaɪn/; [adj](活动,服务)在线的,网上的,受电脑控制的,联机的; [adv]联机地,在运行,开始运行; [n]在线;联机; [or]4j;
onto: [a]/ˈɑːntə/; prep. 到..上;面向; [or]4j;
opening: [a]/ˈoʊpnɪŋ/; [n]开口;孔;开始;开幕;职位空缺; [adj]开始的,开场的; [or]4j;
opera: [a]/ˈɑːprə/; [n]歌剧,歌剧艺术;歌剧团;歌剧院; [or]4j;
operate: [a]/ˈɑːpəreɪt/; [v]操作;运转;施行手术;运营;(军队)在某一地区作战,执行任务; [or]4j;
operation: [a]/ˌɑːpəˈreɪʃn/; [n]运转;操作;手术; [or]4j;
operational: [a]/ˌɑːpəˈreɪʃənl/; [adj]操作的,运转的; [or]4j;
operator: [a]/ˈɑːpəreɪtər/; [n](电话)接线员,操作人员;经营者;善于钻营的人;算子; [or]4j;
opinion: [a]/əˈpɪnjən/; [n]意见,看法,主张; [or]4j;
opponent: [a]/əˈpoʊnənt/; [n]对手,敌手,对抗者; [adj]对立的;敌对的; [or]4j;
opportunity: [a]/ˌɑːpərˈtuːnəti/; [n]机会,良机; [or]4j;
oppose: [a]/əˈpoʊz/; [v]反对;反抗; [or]4j;
opposite: [a]/ˈɑːpəzɪt/; [adj]相反的;对立的;对面的; [adv]对立地;反面地; [n]对立物;反义词; prep. 与.相对;在.对面;与.合演;与.联袂演出; [or]4j;
optimistic: [a]/ˌɑːptɪˈmɪstɪk/; [adj]乐观的,乐观主义的; [or]4j;
optimum: [a]/ˈɑːptɪməm/; [adj]最适宜的;最佳的; [n]最适条件;最适宜; [or]4j;
option: [a]/ˈɑːpʃn/; [n]选择;选择权;选修课; [v]得到或获准进行选择;调动球员; [or]4j;
optional: [a]/ˈɑːpʃənl/; [adj]可选择的; [or]4j;
oral: [a]/ˈɔːrəl/; [adj]口腔的,口头的,口语的; [n]口试; [or]4j;
orbit: [a]/ˈɔːrbɪt/; [v]环绕..的轨道运行; [n]轨道; [vi]环绕..的轨道运行; [or]4j;
orchestra: [a]/ˈɔːrkɪstrə/; [n]管弦乐队; [adj]管弦乐队的; [or]4j;
orderly: [a]/ˈɔːrdərli/; [adj]有秩序的,整齐的,有条不紊的; [or]4j;
ordinary: [a]/ˈɔːrdneri/; [adj]普通的,平常的,平凡的;平淡的,平庸的; [or]4j;
ore: [a]/ɔːr/; [n]矿石;矿砂;矿,矿石; [or]4j;
organ: [a]/ˈɔːrɡən/; [n]器官;风琴; [or]4j;
organic: [a]/ɔːrˈɡænɪk/; [adj]有机的,器官的,组织的; [n]有机物质; [or]4j;
organism: [a]/ˈɔːrɡənɪzəm/; [n]生物,有机体;有机的组织; [or]4j;
organization: [a]/ˌɔːrɡənəˈzeɪʃn/; [n]组织,体制,团体,机构; [or]4j;
organize: [a]/ˈɔːrɡənaɪz/; [v]组织;安排;筹办;整理; [or]4j;
origin: [a]/ˈɔːrɪdʒɪn/; [n]起源;由来,来源;出身; [or]4j;
original: [a]/əˈrɪdʒənl/; [adj]有独创性的,原始的,最初的,新颖的; [n]原件;怪人; [or]4j;
otherwise: [a]/ˈʌðərwaɪz/; [adv]否则,要不然;除此之外; [conj]否则,不然; [or]4j;
ought: [a]/ɔːt/; [v]应该,应当,本该;应该(指道义上有责任);(表示可能性,希望) 该,可能会;(表示推测)预料会做(某事); [or]4j;
ounce: [a]/aʊns/; [n]盎司;一点点; [or]4j;
ours: [a]/ɑːrz/; pro[n]我们的;我们的家; [or]4j;
ourselves: [a]/ɑːrˈselvz/; pro[n]我们自己; [or]4j;
outcome: [a]/ˈaʊtkʌm/; [n]结果,后果; [or]4j;
outdoors: [a]/ˌaʊtˈdɔːrz/; [adv]在户外,在野外; [n]户外(活动),野外(活动); [adj]在户外的; [or]4j;
outer: [a]/ˈaʊtər/; [adj]外部的,外面的,外层的; [n]靶子环外的部分;环外命中; [or]4j;
outlet: [a]/ˈaʊtlet/; [n]出口;插座;表现机会,发泄方法;廉价经销店; [or]4j;
outline: [a]/ˈaʊtlaɪn/; [n]外形,轮廓;大纲,概要; [v]描绘,画出..的轮廓; [or]4j;
outlook: [a]/ˈaʊtlʊk/; [n]景色,风光;观点,看法;前景; [or]4j;
output: [a]/ˈaʊtpʊt/; [n]产量,输出; [vt]生产,出产,制造;输出; [vi]生产,出产,制造;输出; [or]4j;
outset: [a]/ˈaʊtset/; [n]开始,开端; [or]4j;
outside: [a]/ˌaʊtˈsaɪd/; [adv]在户外,在外面,向外面; [n]外部;外表; [adj]外部的; prep. 在..外面,不在..范围内; [or]4j;
outstanding: [a]/aʊtˈstændɪŋ/; [adj]杰出的,突出的,显著的;尚未偿还的; [or]4j;
outward: [a]/ˈaʊtwərd/; [adj]外面的;向外的; [adv]外面地,向外地; [n]外表;外在事务;周围世界;〈罕〉外部; [or]4j;
oval: [a]/ˈoʊvl/; [adj]椭圆形的; [n]椭圆形; [or]4j;
overall: [a]/ˌoʊvərˈɔːl/; [adj]全面的,全部的; [n]罩衫,工装裤; [adv]总的来说;总共; [or]4j;
overcome: [a]/ˌoʊvərˈkʌm/; [v]战胜;克服;压倒;得胜,征服; [or]4j;
overhead: [a]/ˌoʊvərˈhed/; [adj]在头顶上的,上面的,架空的; [adv]在上面;在头顶,在上面; [n]吊顶,天花板,屋顶;企业运营的一般费用(如房租,电费等); [or]4j;
overlook: [a]/ˌoʊvərˈlʊk/; [v]忽视,未注意到;眺望,俯视; [n]忽视,远眺; [or]4j;
overnight: [a]/ˌoʊvərˈnaɪt/; [adv]整夜;一夜之间,突然; [adj]晚上的,通宵的;突然的; [n]头天晚上;一夜的逗留; [v]过夜; [or]4j;
overseas: [a]/ˌoʊvərˈsiːz/; [adv]在海外; [adj]外国的;海外的; [or]4j;
overtake: [a]/ˌoʊvərˈteɪk/; [v]超过,赶上;突然降临; [or]4j;
owe: [a]/oʊ/; [v]感谢;欠;把.归于;占有;欠钱; [or]4j;
owl: [a]/aʊl/; [n]猫头鹰; [or]4j;
owner: [a]/ˈoʊnər/; [n]所有者,物主; [or]4j;
ownership: [a]/ˈoʊnərʃɪp/; [n]所有权; [or]4j;
ox: [a]/ɑːks/; [n]牛,公牛; [or]4j;
oxygen: [a]/ˈɑːksɪdʒən/; [n]氧气; [or]4j;
pace: [a]/peɪs/; [n]速度;步,步伐; [v]踱步; [or]4j;
pacific: [a]/pəˈsɪfɪk/; [adj]太平洋的;与太平洋有关的;爱好和平的,温和的; [n]太平洋; [or]4j;
pack: [a]/pæk/; [v]打包;包装;塞满; [n]行李;背包;一群;一伙; [adj]包装用的;搬运用的;由驮运牲畜组成的;填满了的; [or]4j;
package: [a]/ˈpækɪdʒ/; [n]包裹;一揽子,一整套; [or]4j;
packet: [a]/ˈpækɪt/; [n]小袋; [vt]包装,打包;用邮船运送; [or]4j;
pad: [a]/pæd/; [n]衬垫;护具;便笺簿;(动物的)脚;浮叶; [v]填塞; [or]4j;
pain: [a]/peɪn/; [n]痛,痛苦;努力,劳苦; [or]4j;
painful: [a]/ˈpeɪnfl/; [adj]疼痛的;痛苦的;费力的; [or]4j;
painter: [a]/ˈpeɪntər/; [n]画家,油漆匠; [or]4j;
painting: [a]/ˈpeɪntɪŋ/; [n]画作,绘画;将(画作)挂起来; [or]4j;
palace: [a]/ˈpæləs/; [n]宫殿,豪华住宅; [or]4j;
pale: [a]/peɪl/; [adj]苍白的,灰白的,暗淡的,无力的; [vi]变苍白; [n]栅栏; [vt]用栅栏围;使失色;使变苍白; [or]4j;
palm: [a]/pɑːm/; [n]手掌,手心,棕榈树; [or]4j;
pan: [a]/pæn/; [n]平底锅; [v]严厉批评;淘金; [or]4j;
panel: [a]/ˈpænl/; [n]讨论小组;仪表板;面,板; [v]嵌镶; [or]4j;
panic: [a]/ˈpænɪk/; [n]恐慌;惊慌;慌乱; [v](使)恐慌;使..惊慌失措; [adj]恐慌的,惊慌的; [or]4j;
pants: [a]/pænts/; [n]裤子,短裤; [or]4j;
paperback: [a]/ˈpeɪpərbæk/; [n]平装书,平装本,简装本; [adj]纸面装订的,平装本的; [v]以平装本(或纸面本)出版; [or]4j;
parade: [a]/pəˈreɪd/; [n]游行,检阅; [v]游行,(使)列队行进,炫耀; [or]4j;
paragraph: [a]/ˈpærəɡræf/; [n](文章的)段,节; [or]4j;
parallel: [a]/ˈpærəlel/; [adj]平行的;相似的; [n]相似物;平行线; [v]与..相似;与..匹配; [adv]并行地,平行地; [or]4j;
parcel: [a]/ˈpɑːrsl/; [n]包裹;一片,一块; [v]打包; [or]4j;
parliament: [a]/ˈpɑːrləmənt/; [n]议会;国会; [or]4j;
partial: [a]/ˈpɑːrʃl/; [adj]偏爱的,特别喜欢的;偏袒的,不公平的,有偏见的;部分的;不完全的; [n]<数学>偏微商; [or]4j;
participate: [a]/pɑːrˈtɪsɪpeɪt/; [v]参与,加入; [or]4j;
particle: [a]/ˈpɑːrtɪkl/; [n]粒子,微粒;<语>小品词; [or]4j;
particular: [a]/pərˈtɪkjələr/; [adj]特殊的;特定的;特别的;不寻常的;挑剔的; [n]详细情况; [or]4j;
particularly: [a]/pərˈtɪkjələrli/; [adv]格外地;特别地,尤其地;具体地; [or]4j;
partly: [a]/ˈpɑːrtli/; [adv]部分地,在一定程度上; [or]4j;
partner: [a]/ˈpɑːrtnər/; [n]伙伴,搭档;配偶,伴侣;合伙人; [v]成为..的合伙人; [or]4j;
passion: [a]/ˈpæʃn/; [n]激情; [or]4j;
passive: [a]/ˈpæsɪv/; [adj]被动的;消极的; [n]被动语态; [or]4j;
passport: [a]/ˈpæspɔːrt/; [n]护照;途径,手段; [or]4j;
paste: [a]/peɪst/; [v]粘贴,裱糊; [n]糊状物,浆糊,糊;面团; [or]4j;
pat: [a]/pæt/; [v]轻拍,抚摸; [n]轻拍,抚摸; [or]4j;
patch: [a]/pætʃ/; [n]补丁;眼罩;斑点; [v]打补丁;修补;匆忙拼凑; [or]4j;
path: [a]/pæθ/; [n]路,小道,道路; [or]4j;
patience: [a]/ˈpeɪʃns/; [n]耐心,忍耐;毅力; [or]4j;
patient: [a]/ˈpeɪʃnt/; [n]病人,患者; [adj]有耐心的,能忍耐的; [or]4j;
pattern: [a]/ˈpætərn/; [n]模型,模式;典型;图案;版式;样品; [vi]形成图案; [vt]用图案装饰; [or]4j;
pause: [a]/pɔːz/; [vi]暂停,中止,停顿; [vt]暂停播放; [n]中止,暂停;暂停键; [or]4j;
paw: [a]/pɔː/; [n]爪; [vt]盘弄; [v]用爪子抓; [or]4j;
payment: [a]/ˈpeɪmənt/; [n]付钱;报酬; [or]4j;
pea: [a]/piː/; [n]豌豆; [or]4j;
peaceful: [a]/ˈpiːsfl/; [adj]和平的;平静的,安宁的,宁静的; [or]4j;
peach: [a]/piːtʃ/; [n]桃子,桃树;极可爱的(人或事物),非常迷人的(人或事物);桃红色; [adj]桃红色的,用桃子制成的; [or]4j;
peak: [a]/piːk/; [n]顶峰;山顶;尖端; [v]达到最高点; [adj]最高度的;高峰时期的;巅峰状态的; [or]4j;
peasant: [a]/ˈpeznt/; [n]农民;农夫;庄稼人;小耕农;乡下人;粗野的人;没教养的人; [or]4j;
peculiar: [a]/pɪˈkjuːliər/; [adj]奇怪的,古怪的;特有的,特别的; [or]4j;
pedestrian: [a]/pəˈdestriən/; [n]步行者,行人; [adj]步行的;平庸无奇的,无聊的; [or]4j;
peer: [a]/pɪr/; [n]同龄人,同等地位的人;贵族; [v]仔细看,费力地看; [or]4j;
pen: [a]/pen/; [n]笔,钢笔;围栏,畜栏; [v]书写;关押,监禁; [or]4j;
penalty: [a]/ˈpenəlti/; [n]惩罚,处罚,不利,罚球; [adj]处罚的; [or]4j;
pencil: [a]/ˈpensl/; [n]铅笔; [vt]用铅笔写; [or]4j;
penetrate: [a]/ˈpenətreɪt/; [v]刺穿,穿透;进入;了解; [or]4j;
pension: [a]/ˈpenʃn/; [n]养老金,抚恤金;廉租屋; [v]发给..养老金; [or]4j;
pepper: [a]/ˈpepər/; [n]胡椒粉,胡椒;辣椒; [v]使布满;加胡椒粉于; [or]4j;
per cent: [a]/pər ˈsent/; [n]百分数; [or]4j;
per: [a]/pər/; prep. 每,每一;按照; [or]4j;
perceive: [a]/pərˈsiːv/; [v]意识到,察觉,发觉;看待,理解; [or]4j;
percentage: [a]/pərˈsentɪdʒ/; [n]百分比,百分率; [or]4j;
perception: [a]/pərˈsepʃn/; [n]洞察力,理解力;洞察力,理解力,认识,观念,看法; [or]4j;
perfect: [a]/ˈpɜːrfɪkt/; [adj]完美的;极好的;精通的; [v]使完美; [n]<语>完成时; [or]4j;
perform: [a]/pərˈfɔːrm/; [v]表演;执行;表现; [vi]运行;(驯兽)玩把戏; [or]4j;
performance: [a]/pərˈfɔːrməns/; [n]表演,演出;表现;执行;性能; [or]4j;
permanent: [a]/ˈpɜːrmənənt/; [adj]永久的,持久的; [n]电烫发; [or]4j;
permissible: [a]/pərˈmɪsəbl/; [adj]容许的;许可的; [or]4j;
permission: [a]/pərˈmɪʃn/; [n]允许,同意; [or]4j;
permit: [a]/pərˈmɪt/; [vt]允许,许可; [n]执照; [v]使可能; [or]4j;
persist: [a]/pərˈsɪst/; [v]坚持,固执;继续存留; [or]4j;
personality: [a]/ˌpɜːrsəˈnæləti/; [n]个性,性格;个性鲜明的人;(娱乐界或体育界的)名人; [or]4j;
personnel: [a]/ˌpɜːrsəˈnel/; [n]人事部门,员工,人员; [or]4j;
perspective: [a]/pərˈspektɪv/; [n]角度,视角,观点,想法;(对事物的)合理判断,正确认识;远景;透视图,透视法,透视效果; [adj]透视的; [or]4j;
persuade: [a]/pərˈsweɪd/; [v]说服,劝说;使相信; [or]4j;
pessimistic: [a]/ˌpesɪˈmɪstɪk/; [adj]悲观(主义)的; [or]4j;
pest: [a]/pest/; [n]讨厌的人(或东西);害虫; [or]4j;
petrol: [a]/ˈpetrəl/; [n](英)汽油; [or]4j;
petroleum: [a]/pəˈtroʊliəm/; [n]石油; [or]4j;
phase: [a]/feɪz/; [n](月等的)变相;盈亏;方面;阶段; [or]4j;
phenomenon: [a]/fəˈnɑːmɪnən/; [n]现象;奇迹,奇事,奇才; [or]4j;
philosopher: [a]/fəˈlɑːsəfər/; [n]哲学家;思想家; [or]4j;
philosophy: [a]/fəˈlɑːsəfi/; [n]哲学,哲学体系;哲学思想; [or]4j;
photograph: [a]/ˈfoʊtəɡræf/; [n]照片; [vi]拍照; [vt]为..拍照; [or]4j;
phrase: [a]/freɪz/; [n]简短的警句;短语,习语;措辞,乐句; [v]措辞,将(乐曲)分成乐句; [or]4j;
physical: [a]/ˈfɪzɪkl/; [adj]自然的,符合自然法则的;物质的;物理的;身体的,肉体的; [n]体格检查; [or]4j;
physician: [a]/fɪˈzɪʃn/; [n]内科医生; [or]4j;
physicist: [a]/ˈfɪzɪsɪst/; [n]物理学者,物理学家; [or]4j;
physiological: [a]/ˌfɪziəˈlɑːdʒɪkl/; [adj]生理的,生理学的; [or]4j;
pierce: [a]/pɪrs/; [v]穿(孔);贯穿;突破; [or]4j;
pig: [a]/pɪɡ/; [n]猪;小猪,野猪; [vi]生小猪;像猪一样过活; [vt]贪婪地吃; [or]4j;
pigeon: [a]/ˈpɪdʒɪn/; [n]鸽子; [or]4j;
pile: [a]/paɪl/; [n]一堆; [v]堆积,累积; [or]4j;
pill: [a]/pɪl/; [n]药丸; [or]4j;
pillar: [a]/ˈpɪlər/; [n]柱,台柱,栋梁; [or]4j;
pillow: [a]/ˈpɪloʊ/; [n]枕头; [v]垫,枕着; [or]4j;
pilot: [a]/ˈpaɪlət/; [n]领航员;飞行员; [adj]试验性的; [v]给..领航,驾驶;试验; [or]4j;
pin: [a]/pɪn/; [v]别住,钉住,固定住; [n]别针,饰针; [or]4j;
pinch: [a]/pɪntʃ/; [v]捏,掐,夹痛; [n]捏;少量,一撮;困苦; [or]4j;
pine: [a]/paɪn/; [n]松树; [v](因死亡,离别等)难过,悲伤; [or]4j;
pint: [a]/paɪnt/; [n]品脱(液量,干量名〈美〉液量=0.47升,干量=0.55升); [or]4j;
pioneer: [a]/ˌpaɪəˈnɪr/; [n]先驱,先锋,开拓者; [v]开辟,首倡; [or]4j;
pipe: [a]/paɪp/; [n]管子,导管;烟斗;笛; [v]安静下来(pipe down);用管子输送;用管乐器演奏; [or]4j;
pit: [a]/pɪt/; [n]大坑,矿井;(赛车道旁的) 检修加油站; [v]除去(水果的)核;使凹陷; [or]4j;
pitch: [a]/pɪtʃ/; [v]投掷;用沥青覆盖;<音>为...定音高;扎营;搭帐篷; [n]投掷;球场;沥青;音高; [or]4j;
plague: [a]/pleɪɡ/; [n]瘟疫;灾难;麻烦; [v]折磨;烦扰;造成麻烦; [or]4j;
plain: [a]/pleɪn/; [adj]平凡的;明白的;坦率的;朴素的;不尚修饰的(尤指女人); [n]大平原; [or]4j;
planet: [a]/ˈplænɪt/; [n]行星; [or]4j;
plantation: [a]/plænˈteɪʃn/; [n]农场;种植园;栽植; [or]4j;
plastic: [a]/ˈplæstɪk/; [n]塑料,塑料制品; [adj]塑料的;塑性的,可塑的; pl. 塑料,塑料制品(plastics); [or]4j;
platform: [a]/ˈplætfɔːrm/; [n]站台;平台;讲台;舞台;论坛; [or]4j;
player: [a]/ˈpleɪər/; [n]演奏者;选手,队员;重要参与者;播放器; [or]4j;
playground: [a]/ˈpleɪɡraʊnd/; [n]操场,游乐区;活动场所; [or]4j;
pledge: [a]/pledʒ/; [v]发誓,保证,以.抵押,向.祝酒; [n]保证,誓言; [or]4j;
plentiful: [a]/ˈplentɪfl/; [adj]富裕的,丰富的; [or]4j;
plot: [a]/plɑːt/; [n]情节,阴谋,小块土地; [v]密谋,计划,为小说写情节; [or]4j;
plow: [a]/plau/; [v]犁,耕; [n]犁; [or]4j;
plug: [a]/plʌɡ/; [vi]堵塞;插入(插头); [vt]塞; [n]塞子;插头; [or]4j;
plunge: [a]/plʌndʒ/; [v]跳进,(使)投入;使陷入;暴跌; [n]卷入,参与;暴跌,骤减; [or]4j;
plural: [a]/ˈplʊrəl/; [adj]复数的; [n]复数; [or]4j;
plus: [a]/plʌs/; prep. 加,加上; [n]加号;有利因素; [adj]正的,多的;有利的;阳性的; [conj]此外,而且,况且; [or]4j;
pocket: [a]/ˈpɑːkɪt/; [n]衣袋;钱; [adj]袖珍的; [v]把..装入口袋; [or]4j;
poem: [a]/ˈpoʊəm/; [n]诗,韵文,诗体文; [or]4j;
poet: [a]/ˈpoʊət/; [n]诗人; [or]4j;
poetry: [a]/ˈpoʊətri/; [n]诗,诗歌,诗作;诗意; [or]4j;
poison: [a]/ˈpɔɪzn/; [n]毒物,毒药; [v]放毒,毒害; [or]4j;
poisonous: [a]/ˈpɔɪzənəs/; [adj]有毒的; [or]4j;
pole: [a]/poʊl/; [n]杆,竿极(点);磁极;电极; [or]4j;
policy: [a]/ˈpɑːləsi/; [n]保险单;政策,方针;原则,策略; [or]4j;
polish: [a]/ˈpɑːlɪʃ/; [v]磨光,擦亮;润饰,使优美; [n]擦光剂;优美,完善; [adj]波兰的;波兰人的;波兰语的; [or]4j;
polite: [a]/pəˈlaɪt/; [adj]有礼貌的,客气的,文雅的;高雅的,上流的; [or]4j;
politician: [a]/ˌpɑːləˈtɪʃn/; [n]政治家,政客; [or]4j;
politics: [a]/ˈpɑːlətɪks/; [n]政治,政治学;政纲,政见; [or]4j;
poll: [a]/poʊl/; [n]投票,投票数;投票站;民意测验; [v]获得(票数); [adj]<法>当事人一方作成的; [or]4j;
pollute: [a]/pəˈluːt/; [v]弄脏,污染,沾污; [or]4j;
pollution: [a]/pəˈluːʃn/; [n]污染;噪音污染,光污染;污染物; [or]4j;
pond: [a]/pɑːnd/; [n]池塘; [or]4j;
pop: [a]/pɑːp/; [v]发出(砰的响声),突然出现,爆开,开枪; [n]砰的一声爆破声;流行音乐;汽水; [adj]流行的,大众的; [or]4j;
popular: [a]/ˈpɑːpjələr/; [adj]受欢迎的;大众的; [or]4j;
population: [a]/ˌpɑːpjuˈleɪʃn/; [n]人口,全体居民; [or]4j;
port: [a]/pɔːrt/; [n]舷窗;舱门;港口城市;葡萄酒;港,港口; [or]4j;
portable: [a]/ˈpɔːrtəbl/; [adj]轻便的,手提的,便携式的; [n]便携机;(尤指)手提电脑; [or]4j;
porter: [a]/ˈpɔːrtər/; [n]行李员;搬运工人;门房; [or]4j;
portion: [a]/ˈpɔːrʃn/; [n]一部分,份额,分担的责任; [v]把.分成份额,分配; [or]4j;
portrait: [a]/ˈpɔːrtrət/; [n]肖像,(人物)描写,标本; [or]4j;
pose: [a]/poʊz/; [n]姿势;装腔作势,伪装; [vi]摆造型; [vt]主张,提出;引起,导致; [or]4j;
positive: [a]/ˈpɑːzətɪv/; [adj]积极的;肯定的,明确的;正面的;阳性的; [n]正面;肯定;优点;正数; [or]4j;
possess: [a]/pəˈzes/; [v]拥有,占有;缠住,迷住;支配; [or]4j;
possession: [a]/pəˈzeʃn/; [n]财产,所有物,拥有;控球; [or]4j;
possibility: [a]/ˌpɑːsəˈbɪləti/; [n]可能,可能性;可能的事,几率; [or]4j;
possible: [a]/ˈpɑːsəbl/; [adj]可能的; [n]可能性,潜在性,可能的人物,可能有的事,最高分; [or]4j;
postage: [a]/ˈpoʊstɪdʒ/; [n]邮费,邮资; [or]4j;
postpone: [a]/poʊˈspoʊn/; [v]延迟,推迟,延缓; [or]4j;
pot: [a]/pɑːt/; [n]罐,壶,锅,盆; [or]4j;
potential: [a]/pəˈtenʃl/; [n]潜力,潜能; [adj]潜在的,可能的; [or]4j;
pour: [a]/pɔːr/; [v]注,倒,灌;下(雨);不断地大量投入,倾注; [n]倾泻;倾盆大雨; [or]4j;
poverty: [a]/ˈpɑːvərti/; [n]贫困;贫穷; [or]4j;
powder: [a]/ˈpaʊdər/; [n]粉;火药; [v]抹粉; [or]4j;
powerful: [a]/ˈpaʊərfl/; [adj]强有力的;有权威的; [adv]很;非常; [or]4j;
practical: [a]/ˈpræktɪkl/; [adj]实际的,实用的,实践的,切合实际的;〔人〕注重实际的,务实的;〔计划,方法等〕有效的,切实可行的;心灵手巧的; [n]实习课;实践课;实验考核; [or]4j;
practice: [a]/ˈpræktɪs/; [v]练习,实践; [n]练习;习惯;业务;实践,实行; [or]4j;
pray: [a]/preɪ/; [v]请求,恳求;祈祷,祈求; [or]4j;
prayer: [a]/prer/; [n]祈祷,祷告;祷文; [or]4j;
preach: [a]/priːtʃ/; [v]传教,布道;说教;宣扬; [or]4j;
precaution: [a]/prɪˈkɔːʃn/; [n]预防措施; [or]4j;
preceding: [a]/prɪˈsiːdɪŋ/; [adj]在前的,在先的; [or]4j;
precious: [a]/ˈpreʃəs/; [n]<口>宝贝,心爱的人; [adv]强调极少或太少; [adj]珍贵的,宝贵的; [or]4j;
precise: [a]/prɪˈsaɪs/; [adj]精确的;恰好的; [or]4j;
precision: [a]/prɪˈsɪʒn/; [n]精确,精密度; [or]4j;
predict: [a]/prɪˈdɪkt/; [v]预言,预告,预测; [or]4j;
preface: [a]/ˈprefəs/; [n]序言,前言,开端; [or]4j;
prefer: [a]/prɪˈfɜːr/; [v]更喜欢,宁愿;提出; [or]4j;
preferable: [a]/ˈprefrəbl/; [adj]更可取的,更好的,更合适的(to); [or]4j;
preference: [a]/ˈprefrəns/; [n]偏爱;喜爱物; [or]4j;
pregnant: [a]/ˈpreɡnənt/; [adj]怀孕的;充满的,意味深长的; [or]4j;
prejudice: [a]/ˈpredʒudɪs/; [n]偏见;成见;损害;侵害; [vt]使抱偏见; [or]4j;
preliminary: [a]/prɪˈlɪmɪneri/; [adj]初步的,预备的; [n]预赛;预考,初试;初步措施; [or]4j;
premature: [a]/ˌpriːməˈtʃʊr/; [adj]早产的,过早的,早熟的; [n]早产儿; [or]4j;
preparation: [a]/ˌprepəˈreɪʃn/; [n]准备,预备;准备工作; [or]4j;
prepare: [a]/prɪˈper/; [v]准备,预备;做好准备; [or]4j;
preposition: [a]/ˌprepəˈzɪʃn/; [n]前置词,介词; [or]4j;
prescribe: [a]/prɪˈskraɪb/; [v]给..开药;命令,指示; [or]4j;
prescription: [a]/prɪˈskrɪpʃn/; [n]处方,药方;(医生开)的药;开处方,开药方; [or]4j;
presence: [a]/ˈprezns/; [n]出席,到场;存在;风度,仪态; [or]4j;
presentation: [a]/ˌpriːzenˈteɪʃn/; [n]演讲;报告;介绍;颁奖仪式; [or]4j;
preserve: [a]/prɪˈzɜːrv/; [v]贮鲜,保鲜;保存;保护; [n]独揽之事,独占的活动; [or]4j;
press: [a]/pres/; [v]按,压,逼迫; [n]新闻界,出版社,报刊; [or]4j;
pressure: [a]/ˈpreʃər/; [n]压力;压迫,<物> 压强;迫使; [v]对..施加压力;密封; [or]4j;
prestige: [a]/preˈstiːʒ/; [n]威望,声望; [or]4j;
pretend: [a]/prɪˈtend/; [v]假装,装扮; [adj]假装的,仿制的; [or]4j;
pretty: [a]/ˈprɪti/; [adj]漂亮的,标致的,可爱的; [adv]相当地,很; [n]漂亮的东西,美人; [or]4j;
prevail: [a]/prɪˈveɪl/; [v]流行,盛行;战胜,压倒; [or]4j;
prevalent: [a]/ˈprevələnt/; [adj]普遍的,流行的; [or]4j;
prevent: [a]/prɪˈvent/; [v]预防,阻止; [or]4j;
previous: [a]/ˈpriːviəs/; [adj]以前的;早先的;过早的; [or]4j;
pride: [a]/praɪd/; [v]使得意,以.自豪; [n]自豪;骄傲; [or]4j;
priest: [a]/priːst/; [n]教士,神父; [or]4j;
primarily: [a]/praɪˈmerəli/; [adv]首先;主要地; [or]4j;
primary: [a]/ˈpraɪmeri/; [adj]初等教育的;初级的;基本的;首要的;主要的; [n]首选;(美)初选; [or]4j;
prime: [a]/praɪm/; [adj]首要的,主要的;最好的,第一流的; [n]青春,全盛期,青壮年时期; [v]使准备好; [or]4j;
primitive: [a]/ˈprɪmətɪv/; [adj]原始的;简陋的; [n]原始人; [or]4j;
prince: [a]/prɪns/; [n]王子,亲王;(小国的)君王; [or]4j;
princess: [a]/ˌprɪnˈses/; [n]公主;王妃; [or]4j;
principal: [a]/ˈprɪnsəpl/; [n]校长,负责人;本金,资本; [adj]主要的,首要的; [or]4j;
principle: [a]/ˈprɪnsəpl/; [n]原则,原理;理由,信条; [or]4j;
prior: [a]/ˈpraɪər/; [adj]在先的;优先的; [n]上司; [or]4j;
priority: [a]/praɪˈɔːrəti/; [n]优先;优先权;优先考虑的事;重要事项; [or]4j;
private: [a]/ˈpraɪvət/; [adj]私人的;私密的;私下的; [n]士兵; [or]4j;
privilege: [a]/ˈprɪvəlɪdʒ/; [n]特权,优待;荣幸; [v]给..特权; [or]4j;
probability: [a]/ˌprɑːbəˈbɪləti/; [n]可能性;几率,概率; [or]4j;
probable: [a]/ˈprɑːbəbl/; [adj]可能的;大概的; [n]很可能的事物;很有希望被选中的人; [or]4j;
procedure: [a]/prəˈsiːdʒər/; [n]步骤,过程;程序;手续; [or]4j;
proceed: [a]/proʊˈsiːd/; [v]前进(尤指停止后继续进行);继续进行,继续做; [n]收入,获利; [or]4j;
process: [a]/ˈprɑːses/; [v]加工;处理; [n]过程,进程;工序,程序;传票; [or]4j;
procession: [a]/prəˈseʃn/; [n]队伍,行列,列队行进; [or]4j;
produce: [a]/prəˈduːs/; [v]生产;创作;产生; [vi]创作;生产;产生; [n]农产品; [or]4j;
product: [a]/ˈprɑːdʌkt/; [n]产品,产物;(乘)积; [or]4j;
production: [a]/prəˈdʌkʃn/; [n]生成,产生;产量;生产;(戏剧,电影等的)制作; [or]4j;
productive: [a]/prəˈdʌktɪv/; [adj]多产的;产生..的;富有成效的; [or]4j;
productivity: [a]/ˌprɑːdʌkˈtɪvəti/; [n]生产力;生产率;多产; [or]4j;
profess: [a]/prəˈfes/; [v]表示,承认;宣称; [or]4j;
profession: [a]/prəˈfeʃn/; [n]职业;行业;声明;立誓信教; [or]4j;
professional: [a]/prəˈfeʃənl/; [adj]职业的;专业的; [n]专业人员; [or]4j;
professor: [a]/prəˈfesər/; [n]教授; [or]4j;
profile: [a]/ˈproʊfaɪl/; [n]侧面像;外形,轮廓; [v]描绘..的轮廓,扼要描述; [or]4j;
profit: [a]/ˈprɑːfɪt/; [n]利润,盈利;益处; [v]得益,有益于; [or]4j;
program: [a]/ˈproʊɡræm/; [n]程序;节目;计划; [v]给..编写程序; [or]4j;
progress: [a]/ˈprɑːɡres/; [n]进步;前进,进展; [v]进步,发展; [or]4j;
progressive: [a]/prəˈɡresɪv/; [adj]进步的;逐步的,渐进的; [n]进步人士; [or]4j;
prohibit: [a]/prəˈhɪbɪt/; [v]禁止; [or]4j;
project: [a]/ˈprɑːdʒekt/; [n]项目,工程;专题研究;课题方案; [v]映射,放映;计划,设计,打算,拟订方案;投掷,发射,喷射;表明..的特性,使呈现特性;阐述;突出,伸出;估计,预估; [or]4j;
prominent: [a]/ˈprɑːmɪnənt/; [adj]突起的,显眼的;突出的,杰出的; [or]4j;
promise: [a]/ˈprɑːmɪs/; [n]诺言;有成功希望的预示;允诺的事; [vt]保证,允诺; [vi]有指望;允诺,保证; [or]4j;
promote: [a]/prəˈmoʊt/; [v]提升;促进;发扬;促销; [or]4j;
prompt: [a]/prɑːmpt/; [v]提示;激起;促进,推动;敦促; [adj]迅速的,及时的; [n]提示; [or]4j;
pronoun: [a]/ˈproʊnaʊn/; [n]代词; [or]4j;
proof: [a]/pruːf/; [n]证据,证明,校样; [v]校对;试验; [adj]防.的;能抵御;能防范; [or]4j;
proper: [a]/ˈprɑːpər/; [adj]适合的,适用的;独特的;真正的;正确的;得体的;完全的; [or]4j;
property: [a]/ˈprɑːpərti/; [n]房产;财产;特性;性能; [or]4j;
prophecy: [a]/ˈprɑːfəsi/; [n]预言书;预言,预言能力; [or]4j;
proportion: [a]/prəˈpɔːrʃn/; [n]比例;部分;相称; [v]使成比例;分配; [or]4j;
proportional: [a]/prəˈpɔːrʃənl/; [adj]成比例的,相称的; [n]<数>比例项,比例量; [or]4j;
proposal: [a]/prəˈpoʊzl/; [n]建议;提议;求婚; [or]4j;
propose: [a]/prəˈpoʊz/; [v]提议;求婚; [or]4j;
prospect: [a]/ˈprɑːspekt/; [n]前景,展望;视野;景象; [v]勘察;有前途;勘探;对..进行仔细调查; [or]4j;
prospective: [a]/prəˈspektɪv/; [adj]未来的;预期的; [n]预期; [or]4j;
prosperity: [a]/prɑːˈsperəti/; [n]繁荣,兴旺,发达; [or]4j;
prosperous: [a]/ˈprɑːspərəs/; [adj]富裕的;繁荣的;茂盛的;茁壮生长的; [or]4j;
protect: [a]/prəˈtekt/; [v]保护;警戒; [or]4j;
protection: [a]/prəˈtekʃn/; [n]保护,防卫,警戒; [or]4j;
protective: [a]/prəˈtektɪv/; [adj]保护的,防护的; [or]4j;
protein: [a]/ˈproʊtiːn/; [n]蛋白质; [adj]蛋白质的; [or]4j;
protest: [a]/ˈproʊtest/; [v]抗议;反对; [n]声明,反对; [or]4j;
prove: [a]/pruːv/; [v]证实; [or]4j;
provide: [a]/prəˈvaɪd/; [v]提供,供给; [or]4j;
provided: [a]/prəˈvaɪdɪd/; [conj]假如,如果,以..为条件; [adj]预备好的,提供的; [or]4j;
province: [a]/ˈprɑːvɪns/; [n]省;领域,部门; [or]4j;
provision: [a]/prəˈvɪʒn/; [n](法律等)条款;供应;预备,存粮;必需品; [v]为..提供必需品; [or]4j;
provoke: [a]/prəˈvoʊk/; [v]激怒;对.挑衅;引起; [or]4j;
psychological: [a]/ˌsaɪkəˈlɑːdʒɪkl/; [adj]心理的,心理学的; [or]4j;
pub: [a]/pʌb/; [n]酒吧,酒馆; [or]4j;
publication: [a]/ˌpʌblɪˈkeɪʃn/; [n]出版,发行,印刷;出版物;公布; [or]4j;
publicity: [a]/pʌbˈlɪsəti/; [n]公开(性),公众的关注;宣传;名声; [or]4j;
publish: [a]/ˈpʌblɪʃ/; [v]出版,刊印;公布,发布; [or]4j;
pull: [a]/pʊl/; [v]拉,拖,扯,拔;得到;驾驶; [n]拉力,吸引力,影响力; [or]4j;
pulse: [a]/pʌls/; [n]脉搏;(电子)脉冲;拍子,节奏;可食用的豆子; [v](使)跳动,搏动,震动;(感情等)洋溢,充满; [or]4j;
pump: [a]/pʌmp/; [v]抽水,抽取;用泵输送;向.灌注;盘问; [n]打气筒;泵,抽水(机);胶底帆布鞋; [or]4j;
pumpkin: [a]/ˈpʌmpkɪn/; [n]南瓜,倭瓜; [or]4j;
punch: [a]/pʌntʃ/; [v]以拳猛击;打洞;用力按; [n]拳打;力量;潘趣酒;打孔机; [or]4j;
punctual: [a]/ˈpʌŋktʃuəl/; [adj]准时的,守时的; [or]4j;
punish: [a]/ˈpʌnɪʃ/; [v]惩罚,处罚; [or]4j;
purchase: [a]/ˈpɜːrtʃəs/; [v]购买; [n]购买;所购之物; [or]4j;
pure: [a]/pjʊr/; [adj]纯净的,纯粹的,纯洁的; [or]4j;
purity: [a]/ˈpjʊrəti/; [n]纯洁;纯净;纯正;纯粹; [or]4j;
purple: [a]/ˈpɜːrpl/; [adj]紫色的; [n]紫色; [or]4j;
purse: [a]/pɜːrs/; [n]钱包(尤指女用的),小钱袋,手袋; [v]使皱起,噘起; [or]4j;
pursue: [a]/pərˈsuː/; [v]进行,从事;追求,追赶; [or]4j;
pursuit: [a]/pərˈsuːt/; [n]追求,寻找;追赶,跟踪;事业,消遣; [v]追踪,追击; [or]4j;
puzzle: [a]/ˈpʌzl/; [n]拼图;谜;迷惑;难题; [v]使迷惑; [or]4j;
qualification: [a]/ˌkwɑːlɪfɪˈkeɪʃn/; [n]资格证明;条件;合格证书;资格;限制性条件; [or]4j;
qualify: [a]/ˈkwɑːlɪfaɪ/; [v]胜任,使具有资格;描述,形容; [or]4j;
quality: [a]/ˈkwɑːləti/; [n]特性;品性;质量; [adj]优质的; [or]4j;
quantity: [a]/ˈkwɑːntəti/; [n]数量,数目;大量,许多; [or]4j;
quarrel: [a]/ˈkwɔːrəl/; [v]争吵,争论; [n]争吵,口角; [or]4j;
quarter: [a]/ˈkwɔːrtər/; [v]驻扎,扎营;把..四等分; [n]四分之一;季度;一刻钟; [or]4j;
quest: [a]/kwest/; [n]探索,寻求; [v]寻找,搜索; [or]4j;
queue: [a]/kjuː/; [v]排队等候; [n]行列; [or]4j;
quit: [a]/kwɪt/; [vt]辞职;停止;离开; [adj]被释放的;自由的;摆脱了.的;了清债务的; [or]4j;
quite: [a]/kwaɪt/; [adv]相当,十分; [or]4j;
quiz: [a]/kwɪz/; [n]问答比赛,智力竞赛;小测验,小考; [v]考查,盘问; [or]4j;
quotation: [a]/kwoʊˈteɪʃn/; [n]引文,语录;行情,行市;报价,牌价; [or]4j;
quote: [a]/kwoʊt/; [v]报价;引用,援引; [n]引用; [or]4j;
race: [a]/reɪs/; [n](速度上的)比赛;人种,种族;属,种; [v]全速行进;参加竞赛;(使)比速度; [or]4j;
racial: [a]/ˈreɪʃl/; [adj]种族的;人种的; [or]4j;
rack: [a]/ræk/; [n]挂架,搁架; [v]使痛苦; [or]4j;
radar: [a]/ˈreɪdɑːr/; [n]雷达,无线电探测器; [or]4j;
radiation: [a]/ˌreɪdiˈeɪʃn/; [n]放射物;辐射物; [or]4j;
radical: [a]/ˈrædɪkl/; [n]激进分子;基础;原子团;根数,根式; [adj]重大的,彻底的;激进的; [or]4j;
radioactive: [a]/ˌreɪdioʊˈæktɪv/; [adj]放射性的; [or]4j;
radius: [a]/ˈreɪdiəs/; [n]半径;范围; [or]4j;
rag: [a]/ræɡ/; [n]抹布,破布,碎布; [v]和..开玩笑,对..恶作剧; [or]4j;
rage: [a]/reɪdʒ/; [n]极怒;盛怒; [v]迅速蔓延,快速扩散;(战争等)激烈地进行; [or]4j;
raid: [a]/reɪd/; [n]突袭;袭击; [v]袭击;劫掠;攫取;突然搜捕; [or]4j;
rail: [a]/reɪl/; [n]铁轨;扶手,栏杆; [v]咒骂; [or]4j;
railroad: [a]/ˈreɪlroʊd/; [n]铁路; [v]迫使某人做某事; [or]4j;
railway: [a]/ˈreɪlweɪ/; [n]铁路,铁道; [vi]乘火车旅行;在.铺设铁路; [or]4j;
rainbow: [a]/ˈreɪnboʊ/; [n]彩虹;呈彩虹状;彩虹状的;使呈彩虹状; [or]4j;
raincoat: [a]/ˈreɪnkoʊt/; [n]雨衣; [or]4j;
raise: [a]/reɪz/; [v]养殖;养育;筹集(资金);举起;竖起,扶起;站直;提拔;唤起;和.取得联系; [n]加薪;提高; [or]4j;
rally: [a]/ˈræli/; [n]集会;公路汽车赛; [v]集合;恢复(健康等),重新振作; [or]4j;
random: [a]/ˈrændəm/; [adj]随机的;任意的;胡乱的; [or]4j;
range: [a]/reɪndʒ/; [n]排;变动范围;山脉;放牧场;射程;范围; [vi]排成一排; [vt]排列; [adj]牧场的; [or]4j;
rank: [a]/ræŋk/; [v]排名;把.分等级;列队; [n]等级;军队中的官阶; [adj]繁茂的,讨厌的,难闻的; [or]4j;
rap: [a]/ræp/; [n]饶舌歌; [v]轻敲;表演说唱;严厉批评; [or]4j;
rapid: [a]/ˈræpɪd/; [adj]迅速的;急促的; [or]4j;
rare: [a]/rer/; [adj]罕见的,稀有的,难得的;半熟的;不寻常的;美好的; [or]4j;
rarely: [a]/ˈrerli/; [adv]很少,难得; [or]4j;
rat: [a]/ræt/; [n]老鼠,耗子; [v]揭发; [or]4j;
rate: [a]/reɪt/; [n]比率,率;速率;价格;频率; [v]评估;认为; [or]4j;
rather: [a]/ˈræðər/; [adv]宁愿,宁可,相当; [int]<英口> 好呀; [or]4j;
ratio: [a]/ˈreɪʃioʊ/; [n]比率,比例; [or]4j;
rational: [a]/ˈræʃnəl/; [adj]理性的;理智的;合理的; [or]4j;
raw: [a]/rɔː/; [adj]生的,未煮过的;未加工的;(因皮肤开裂)疼痛的; [or]4j;
ray: [a]/reɪ/; [n]射线;光线;一丝(希望,慰藉等); [v]放射,照射; [or]4j;
react: [a]/riˈækt/; [v]起反应,有影响,对..做出反应;有不良反应;起化学反应; [or]4j;
reaction: [a]/riˈækʃn/; [n]反应能力;反应;生理反应; [or]4j;
reader: [a]/ˈriːdər/; [n]读者;读物,读本; [or]4j;
readily: [a]/ˈredɪli/; [adv]容易地;乐意地;欣然地; [or]4j;
reading: [a]/ˈriːdɪŋ/; [n]阅读;读物;读数; [or]4j;
realistic: [a]/ˌriːəˈlɪstɪk/; [adj]现实(主义)的;现实可行的;逼真的,栩栩如生的; [or]4j;
reality: [a]/riˈæləti/; [n]现实,实际;真实; [or]4j;
realize: [a]/ˈriːəlaɪz/; [v]认识到,体会到;实现; [or]4j;
really: [a]/ˈriːəli/; [adv]真正地,事实上;确实;非常,极其; [or]4j;
realm: [a]/relm/; [n]王国;领域;国土; [or]4j;
reasonable: [a]/ˈriːznəbl/; [adj]适当的;合理的;通情达理的;(价格)公道的; [or]4j;
rebel: [a]/ˈrebl/; [v]造反,反抗,反叛; [n]造反者;反叛者;叛逆者; [adj]反抗的;造反的; [or]4j;
recall: [a]/rɪˈkɔːl/; [v]回想起,记起,回忆;召回; [n]召回(有问题的产品); [or]4j;
receipt: [a]/rɪˈsiːt/; [n]收据,收条;收入;收到; [or]4j;
receive: [a]/rɪˈsiːv/; [vt]收到;遭受;对.作出反应;接待,会客,接见,招待;获得;接受,容纳;<电子学> 接收; [v]接球; [or]4j;
receiver: [a]/rɪˈsiːvər/; [n]听筒;收受人,接待者,尤指收款员;接收器;收件人,收款人;〔破产企业或公司的〕管理人,接管人;买卖赃物者; [or]4j;
recently: [a]/ˈriːsntli/; [adv]最近地,新近地; [or]4j;
reception: [a]/rɪˈsepʃn/; [n]前台,接待处,接收,欢迎,招待会; [or]4j;
recession: [a]/rɪˈseʃn/; [n](经济)衰退,不景气;后退,撤回;凹处; [or]4j;
recite: [a]/rɪˈsaɪt/; [vi]背诵;朗诵; [vt]背诵;朗诵;叙述;列举; [or]4j;
reckon: [a]/ˈrekən/; [vt]计算;想,指望;把.看做; [v]认为; [vi]计算;估计; [or]4j;
recognition: [a]/ˌrekəɡˈnɪʃn/; [n]承认,认可;认出;认识; [or]4j;
recognize: [a]/ˈrekəɡnaɪz/; [v]辨别,认出;赏识,表彰;承认;赞成; [or]4j;
recommend: [a]/ˌrekəˈmend/; [v]推荐,介绍;劝告,建议; [or]4j;
recommendation: [a]/ˌrekəmenˈdeɪʃn/; [n]推荐,建议,介绍,推荐信; [or]4j;
reconcile: [a]/ˈrekənsaɪl/; [v]和解;调解;调和; [or]4j;
record: [a]/rɪˈkɔːrd/; [v]记录,把(声音,图像)录下; [n]档案,记录; [or]4j;
recorder: [a]/rɪˈkɔːrdər/; [n]记录员;录音机; [or]4j;
recover: [a]/rɪˈkʌvər/; [v]恢复;痊愈,恢复健康;收回;换回;重新获得;重新找到; [or]4j;
recovery: [a]/rɪˈkʌvəri/; [n]痊愈;恢复,复苏;重获; [or]4j;
recreation: [a]/ˌrekriˈeɪʃn/; [n]娱乐活动,消遣; [or]4j;
recruit: [a]/rɪˈkruːt/; [v]招募(新兵),招收(新成员); [n]新兵,新成员; [or]4j;
recycle: [a]/ˌriːˈsaɪkl/; [v]回收利用;改建; [n]再循环; [or]4j;
red: [a]/red/; [adj]红色的; [n]红色; [or]4j;
reduce: [a]/rɪˈduːs/; [v]减少,减小,降低,精简; [or]4j;
reduction: [a]/rɪˈdʌkʃn/; [n]减少,折扣,缩减,削减; [or]4j;
refer: [a]/rɪˈfɜːr/; [v]参考,查看;涉及;归因于;托付;提交;介绍;提到,谈及; [or]4j;
referee: [a]/ˌrefəˈriː/; [n]裁判员,仲裁者; [v]裁判,仲裁; [or]4j;
reference: [a]/ˈrefrəns/; [n]参考书;提及;推荐人;参考;证明;推荐信; [v]附.以供参考;引用; [or]4j;
refine: [a]/rɪˈfaɪn/; [v]精炼,改进; [or]4j;
reflect: [a]/rɪˈflekt/; [v]倒映;反映,反射;仔细思考;反省; [or]4j;
reflection: [a]/rɪˈflekʃn/; [n]反射;映象;反映;反省,沉思; [or]4j;
refresh: [a]/rɪˈfreʃ/; [v](使)恢复精神,提神;刷新; [or]4j;
refrigerator: [a]/rɪˈfrɪdʒəreɪtər/; [n]冰箱,冷藏库; [or]4j;
refugee: [a]/ˌrefjuˈdʒiː/; [n]避难者,难民; [v]避难; [adj]避难的; [or]4j;
refusal: [a]/rɪˈfjuːzl/; [n]拒绝,回绝; [or]4j;
refuse: [a]/rɪˈfjuːz/; [v]拒绝;抵制; [n]废料;垃圾; [adj]无价值的; [or]4j;
regard: [a]/rɪˈɡɑːrd/; [n]尊敬;问候,关心; [v]尊敬;把..视为; [or]4j;
regardless: [a]/rɪˈɡɑːrdləs/; [adj]不顾的,不注意的; [adv]不顾一切地; [or]4j;
region: [a]/ˈriːdʒən/; [n]地区,区域;范围;行政区;身体部位; [or]4j;
register: [a]/ˈredʒɪstər/; [v]登记,注册;(仪表等)显示;留意; [n]登记,注册;现金收纳机; [or]4j;
regret: [a]/rɪˈɡret/; [n]后悔,遗憾; [vt]懊悔,后悔;抱歉; [vi]感到后悔,感到抱歉; [or]4j;
regular: [a]/ˈreɡjələr/; [adj]有规律的,定期的,经常的,匀称的; [n]常客;正式队员; [or]4j;
regulate: [a]/ˈreɡjuleɪt/; [v]管制,调整,控制; [or]4j;
regulation: [a]/ˌreɡjuˈleɪʃn/; [n]法规,条例,规章;管理; [or]4j;
reinforce: [a]/ˌriːɪnˈfɔːrs/; [v]加固;加强;增援;支持; [or]4j;
reject: [a]/rɪˈdʒekt/; [v]拒绝;抵制; [n]废品;次品;不合格者;被剔除者; [or]4j;
relate: [a]/rɪˈleɪt/; [v]相关,有联系;讲述;涉及,关于; [or]4j;
relation: [a]/rɪˈleɪʃn/; [n]家属,亲属;关系,联系; [or]4j;
relationship: [a]/rɪˈleɪʃnʃɪp/; [n]关系,关联; [or]4j;
relative: [a]/ˈrelətɪv/; [n]亲戚,家人,亲属;相关物,关系词,同类事物; [adj]相对的;有关系的,(语)关系的; [or]4j;
relativity: [a]/ˌreləˈtɪvəti/; [n]相关性;相对性; [or]4j;
relax: [a]/rɪˈlæks/; [v]放松;使..放松;宽慰;放宽; [or]4j;
relay: [a]/ˈriːleɪ/; [n]替班;转播;接力赛跑; [v]转播;传递; [or]4j;
release: [a]/rɪˈliːs/; [v]释放;解放;发行; [n]解除;免除;发表; [or]4j;
relevant: [a]/ˈreləvənt/; [adj]有关的;恰当的;贴切的; [or]4j;
reliability: [a]/rɪˌlaɪəˈbɪləti/; [n]可靠性; [or]4j;
reliable: [a]/rɪˈlaɪəbl/; [adj]可靠的;可信赖的;确实的; [or]4j;
relief: [a]/rɪˈliːf/; [n]安慰;解脱;减轻;浮雕;凸显,起伏;救济金;救济物资;换班人;接替人; [or]4j;
relieve: [a]/rɪˈliːv/; [v]消除,减轻;换班; [or]4j;
religion: [a]/rɪˈlɪdʒən/; [n]宗教;宗教信仰;宗教生活;虔诚的追求; [or]4j;
religious: [a]/rɪˈlɪdʒəs/; [adj]宗教的;虔诚的; [or]4j;
reluctant: [a]/rɪˈlʌktənt/; [adj]不情愿的;勉强的; [or]4j;
rely: [a]/rɪˈlaɪ/; [v]依赖,依靠;信赖; [or]4j;
remain: [a]/rɪˈmeɪn/; [v]剩余;逗留;保持不变;依然,继续; [n]剩余物;遗迹;残骸; [or]4j;
remark: [a]/rɪˈmɑːrk/; [n]评论;谈论;话语,话;备注; [v]议论;评论; [or]4j;
remedy: [a]/ˈremədi/; [v]治疗;恢复;补救; [n]治疗;补救;矫正; [or]4j;
remind: [a]/rɪˈmaɪnd/; [v]提醒,使想起; [or]4j;
remote: [a]/rɪˈmoʊt/; [n]遥控器; [adj]遥远的;偏僻的;关系远的; [or]4j;
removal: [a]/rɪˈmuːvl/; [n]消除,移动;开除,免职;搬运家具; [or]4j;
remove: [a]/rɪˈmuːv/; [v]把..免职;脱下,摘下;除掉,去除;移开; [n]间距; [or]4j;
render: [a]/ˈrendər/; [v]使成为,致使,使处于(某种状态);提供,给予,以.回报;(以某种方式)表达,表现;翻译;粉刷,往(墙上)抹灰;将(脂肪)熬成油,使熔化; [n]粉刷,打底,交纳; [or]4j;
renew: [a]/rɪˈnuː/; [v]更新;重新开始;重申,重新提出;续签,延长.期限; [or]4j;
rent: [a]/rent/; [n]租金; [v]租用,出租; [or]4j;
repair: [a]/rɪˈper/; [v]修理;补救;纠正; [n]修理,修补; [or]4j;
repeat: [a]/rɪˈpiːt/; [v]重复;重做; [n]复制;重奏; [or]4j;
repent: [a]/rɪˈpent/; [v](对某事或行为感到)悔恨;后悔;悔改; [adj]<植>匍匐生根的;<动>爬行的; [or]4j;
repetition: [a]/ˌrepəˈtɪʃn/; [n]重复,反复; [or]4j;
replace: [a]/rɪˈpleɪs/; [v]更换;代替,接替;放回; [or]4j;
replacement: [a]/rɪˈpleɪsmənt/; [n]代替物;接替者;更换; [or]4j;
reporter: [a]/rɪˈpɔːrtər/; [n]报告人,通讯员;记者,报导者; [or]4j;
represent: [a]/ˌreprɪˈzent/; [v]代表;象征;表示;描述;阐明;说明;演绎; [or]4j;
representative: [a]/ˌreprɪˈzentətɪv/; [n]代表;代理; [adj]典型的,有代表性的; [or]4j;
reproduce: [a]/ˌriːprəˈduːs/; [v]生殖;繁殖;再生产;再现;仿造;复制; 复印; [or]4j;
republic: [a]/rɪˈpʌblɪk/; [n]共和国,共和政体; [or]4j;
republican: [a]/rɪˈpʌblɪkən/; [n]共和主义者;共和党员; [adj]共和国的,共和政体的;共和党的; [or]4j;
reputation: [a]/ˌrepjuˈteɪʃn/; [n]名声;声誉; [or]4j;
request: [a]/rɪˈkwest/; [n]请求;要求; [v]请求;要求; [or]4j;
require: [a]/rɪˈkwaɪər/; [v]需要;(of)要求,命令; [or]4j;
requirement: [a]/rɪˈkwaɪərmənt/; [n]需要;必需品;要求; [or]4j;
rescue: [a]/ˈreskjuː/; [v]营救,援救; [n]营救,救援; [or]4j;
resemble: [a]/rɪˈzembl/; [v]像,相像,相似; [or]4j;
reservation: [a]/ˌrezərˈveɪʃn/; [n](住处,席位的)预订;保留态度,保留意见;(美国印第安部落的)居留地; [or]4j;
reserve: [a]/rɪˈzɜːrv/; [n]储备;保留;保护区; [v]保留;预定;储备; [or]4j;
reservoir: [a]/ˈrezərvwɑːr/; [n]水库;贮藏量; [or]4j;
residence: [a]/ˈrezɪdəns/; [n]住宅,居住,居留权; [or]4j;
resident: [a]/ˈrezɪdənt/; [n]居民;住客;住院实习医师; [adj]居住的;住校的;固有的; [or]4j;
residential: [a]/ˌrezɪˈdenʃl/; [adj]居住的,住宅的;寄宿的; [or]4j;
resign: [a]/rɪˈzaɪn/; [v]辞职; [or]4j;
resist: [a]/rɪˈzɪst/; [v]抗拒;抵抗,抵制; [or]4j;
resistance: [a]/rɪˈzɪstəns/; [n]阻力;抵抗;抵制;抵抗力;电阻; [or]4j;
resistant: [a]/rɪˈzɪstənt/; [adj]有抵抗力的,抗..的;反抗的; [or]4j;
resolution: [a]/ˌrezəˈluːʃn/; [n]决心,决定,解决,决议,分辨率; [or]4j;
resolve: [a]/rɪˈzɑːlv/; [n]决心; [v]解决,决定,表决; [or]4j;
resort: [a]/rɪˈzɔːrt/; [vi]采取;求助; [n]求助;凭借;诉诸,采取;度假胜地; [or]4j;
resource: [a]/ˈriːsɔːrs/; [n]资源,财力,办法; [v]向.提供资金(或设备); [or]4j;
respect: [a]/rɪˈspekt/; [n]敬重,尊敬;方面; [v]尊敬,敬重; [or]4j;
respective: [a]/rɪˈspektɪv/; [adj]各自的; [or]4j;
respond: [a]/rɪˈspɑːnd/; [vi]作答;对..有效果;做出反应; [v]回应; [or]4j;
response: [a]/rɪˈspɑːns/; [n]回应;作答;响应,回答; [or]4j;
responsibility: [a]/rɪˌspɑːnsəˈbɪləti/; [n]责任,负担; [or]4j;
responsible: [a]/rɪˈspɑːnsəbl/; [adj]有责任,负责的; [or]4j;
restless: [a]/ˈrestləs/; [adj]烦躁不安的,焦虑的;得不到休息的;不安宁的; [or]4j;
restore: [a]/rɪˈstɔːr/; [v]恢复;修补;归还; [or]4j;
restrain: [a]/rɪˈstreɪn/; [v]制止(做);抑制(愤怒等),控制;监禁; [or]4j;
restrict: [a]/rɪˈstrɪkt/; [v]限制;约束; [or]4j;
result: [a]/rɪˈzʌlt/; [n]结果,成效; [v]导致,..的结果; [or]4j;
resume: [a]/ˈrezəmeɪ/; [n]简历; [v]重新开始;继续; [vt]回到;恢复;重新开始; [or]4j;
retain: [a]/rɪˈteɪn/; [v]保持,保留,保存;聘请; [or]4j;
retire: [a]/rɪˈtaɪər/; [v]退休;退役; [vi]就寝; [or]4j;
retreat: [a]/rɪˈtriːt/; [v]撤退,撤离,(被迫)退却,后退; [n]撤退,退却,隐退;休养所,收容所;躲藏处; [or]4j;
reunion: [a]/ˌriːˈjuːniən/; [n]团聚;再联合;再结合;(亲友等的)重聚; [or]4j;
reveal: [a]/rɪˈviːl/; [v]揭示;透露;显示; [or]4j;
revelation: [a]/ˌrevəˈleɪʃn/; [n]揭露;揭示;(出乎意料的)被揭示的真相; [or]4j;
revenge: [a]/rɪˈvendʒ/; [n]报仇;报复; [v]为.报仇,报.之仇; [or]4j;
revenue: [a]/ˈrevənuː/; [n]收入;财政收入;国家的税收; [or]4j;
reverse: [a]/rɪˈvɜːrs/; [n]失败,挫折,倒退;相反,背面; [v]颠倒,翻转; [adj]相反的,反面的,颠倒的; [or]4j;
review: [a]/rɪˈvjuː/; [v]温习,复习;评论;回顾,反思; [n]复习,回顾;检讨;评审,审查; [or]4j;
revise: [a]/rɪˈvaɪz/; [v]修订;修改;温习(功课); [or]4j;
revolt: [a]/rɪˈvoʊlt/; [v]反抗,叛乱,厌恶;造反;反抗;厌恶; [n]背叛;厌恶;反叛; [or]4j;
revolution: [a]/ˌrevəˈluːʃn/; [n]革命;旋转; [or]4j;
revolutionary: [a]/ˌrevəˈluːʃəneri/; [n]革命者; [adj]革命的;革命性的; [or]4j;
revolve: [a]/rɪˈvɑːlv/; [v](使)旋转;(使)绕转; [or]4j;
reward: [a]/rɪˈwɔːrd/; [n]奖品,报酬,回报;悬赏; [v]报答,酬谢; [or]4j;
rhythm: [a]/ˈrɪðəm/; [n]节奏;韵律;格律; [or]4j;
rib: [a]/rɪb/; [n]肋骨,伞骨; [v]装肋于;用肋状物支撑; [or]4j;
ribbon: [a]/ˈrɪbən/; [n]缎带,丝带,带状物; [or]4j;
rice: [a]/raɪs/; [n]米饭;米;稻; [v]筛选; [or]4j;
rid: [a]/rɪd/; [v]使摆脱;使去掉; [or]4j;
ridge: [a]/rɪdʒ/; [n]脊,岭,山脉,垄; [or]4j;
ridiculous: [a]/rɪˈdɪkjələs/; [adj]可笑的,荒谬的; [or]4j;
rifle: [a]/ˈraɪfl/; [n]步枪; [v]洗劫,抢劫; [or]4j;
rigid: [a]/ˈrɪdʒɪd/; [adj]坚硬的;僵硬的;死板的; [or]4j;
ring: [a]/rɪŋ/; [n]戒指;环;集团;响声; [v]套上环;成环状;敲钟;打电话; [or]4j;
riot: [a]/ˈraɪət/; [v]闹事; [n]骚乱;暴乱;骚动;放纵; [or]4j;
ripe: [a]/raɪp/; [adj]熟的,成熟的; [v]〈诗〉同"ripen"; [or]4j;
risk: [a]/rɪsk/; [n]风险;危险;冒险; [v]冒..的危险,使..冒风险; [or]4j;
rival: [a]/ˈraɪvl/; [n]竞争者,对手; [v]与.竞争,与.匹敌; [adj]竞争的,敌对的; [or]4j;
river: [a]/ˈrɪvər/; [n]河,江; [or]4j;
road: [a]/roʊd/; [n]路,道路;公路,大道; [adj]巡回的; [or]4j;
roar: [a]/rɔːr/; [n]吼叫声,怒号声,轰鸣声; [vi]吼叫;咆哮; [vt]大声呼喊; [or]4j;
roast: [a]/roʊst/; [v]烤,炙,烘;挖苦;逗乐; [n]烤肉; [adj]烤的,烘的; [or]4j;
rob: [a]/rɑːb/; [v]抢劫,盗取,非法剥夺; [or]4j;
rocket: [a]/ˈrɑːkɪt/; [n]火箭;芝麻菜; [vi]飞快地移动;猛涨; [or]4j;
rod: [a]/rɑːd/; [n](船)杆,棒; [v]给...装置避雷针;用杆夯平;把...改装成高速汽车; [or]4j;
roll: [a]/roʊl/; [v]滚动,转动;卷;使摇摆;使平坦,压平; [n]卷;卷状物;隆隆声; [or]4j;
roller: [a]/ˈroʊlər/; [n]滚柱,滚筒,滚轴; [or]4j;
romantic: [a]/roʊˈmæntɪk/; [adj]浪漫的;传奇式的;不切实际的;好幻想的; [or]4j;
roof: [a]/ruːf/; [n]屋顶;顶部; [vt]覆盖,给..盖屋顶; [or]4j;
root: [a]/ruːt/; [v]生根,使固定; [n]根部,根源,词根; [adj]根本的; [or]4j;
rope: [a]/roʊp/; [n]绳,索;一串;绞刑; [v]用绳捆(或扎等); [or]4j;
rotary: [a]/ˈroʊtəri/; [adj]旋转的; [n]旋转运行的机器; [or]4j;
rotate: [a]/ˈroʊteɪt/; [v]以..轴转动,使旋转,使..轮流;轮换; [or]4j;
rotation: [a]/roʊˈteɪʃn/; [n]旋转;循环,轮流; [or]4j;
rotten: [a]/ˈrɑːtn/; [adj]腐烂的,腐朽的;糟糕的; [adv]很大程度上;非常; [or]4j;
rough: [a]/rʌf/; [adj]粗糙的;大致的,粗略的;(海)波涛汹涌的;困难的,令人不快的; [n]草稿; [adv]粗暴地; [v]艰苦生活; [or]4j;
rouse: [a]/raʊz/; [vt]唤醒,唤起;激起; [or]4j;
route: [a]/raʊt/; [n]路线;固定路线;途径;渠道; [vt]按某路线发送;给.规定路线[次序,程序]; [or]4j;
routine: [a]/ruːˈtiːn/; [n]常规,例行公事,一套固定舞步(或动作); [adj]例行的,普通的,惯例的; [or]4j;
royal: [a]/ˈrɔɪəl/; [adj]王室的,皇家的;第一流的,高贵的; [n]王室成员; [or]4j;
rub: [a]/rʌb/; [v]抚摸;摩擦;擦破; [n]蹭;障碍;磨损处; [or]4j;
rude: [a]/ruːd/; [adj]粗鲁的,无礼貌的;猛烈的,狂暴的; [or]4j;
rug: [a]/rʌɡ/; [n](小)地毯;围毯;男子假发; [or]4j;
ruin: [a]/ˈruːɪn/; [v]毁灭,毁坏;(使)破产;(使)堕落; [n]毁灭;废墟; [or]4j;
rule: [a]/ruːl/; [v]统治,控制;支配;裁决; [n]规定,规章,条例;习惯;统治,管辖; [or]4j;
rumor: [a]/'ruːmə/; [n]谣言;传闻; [or]4j;
rural: [a]/ˈrʊrəl/; [adj]乡村的,农村的,田园的; [or]4j;
rush: [a]/rʌʃ/; [v]冲,奔;赶忙做;匆忙; [n]冲,急速行进;繁忙时期;仓促;(交通)繁忙时段; [or]4j;
rust: [a]/rʌst/; [v]生锈;氧化; [n]锈; [or]4j;
sack: [a]/sæk/; [n]一袋;麻袋;开除; [v]开除;劫掠;掠夺; [or]4j;
sacrifice: [a]/ˈsækrɪfaɪs/; [vt]牺牲;祭献; [vi]奉献;做出牺牲; [n]祭品;牺牲; [or]4j;
saddle: [a]/ˈsædl/; [n]鞍;鞍部; [v]给马装鞍具;装鞍具;使负重担; [or]4j;
sailor: [a]/ˈseɪlər/; [n]水手,海员; [or]4j;
saint: [a]/seɪnt/; [n]圣人; [or]4j;
salad: [a]/ˈsæləd/; [n]色拉,沙拉;凉拌菜; [or]4j;
salary: [a]/ˈsæləri/; [n]工资,薪水; [or]4j;
salesman: [a]/ˈseɪlzmən/; [n]售货员,推销员; [or]4j;
sample: [a]/ˈsæmpl/; [n]样品,样本;(用于检验,分析的) 试样; [adj]样品的,作为例子的; [vi]抽样检查; [vt]抽取.的试样; [v]品尝;体验,尝试; [or]4j;
sanction: [a]/ˈsæŋkʃn/; [n]批准;制裁,处罚; [v]批准,支持,对..实施制裁; [or]4j;
satellite: [a]/ˈsætəlaɪt/; [n]卫星;人造卫星;随体; [adj]卫视的; [or]4j;
satisfaction: [a]/ˌsætɪsˈfækʃn/; [n]满足,满意;乐事;补偿; [or]4j;
satisfactory: [a]/ˌsætɪsˈfæktəri/; [adj]令人满意的;良好的; [or]4j;
satisfy: [a]/ˈsætɪsfaɪ/; [v](使)满意,满足;符合.的标准;使确信,说服; [or]4j;
sauce: [a]/sɔːs/; [n]酱,调味汁;莽撞,冒失; [or]4j;
saucer: [a]/ˈsɔːsər/; [n]茶碟,茶托,杯托,浅碟;浅碟形物; [or]4j;
sausage: [a]/ˈsɔːsɪdʒ/; [n]香肠; [or]4j;
saving: [a]/ˈseɪvɪŋ/; [n]节省,储蓄;储蓄金,存款(savings); pl. 储蓄金,存款; [or]4j;
scale: [a]/skeɪl/; [n]天平,磅秤;刻度,尺度,标度;等级,级别, 等级体系;鳞片,鳞状物;规模;水垢,牙垢; [v]攀登;按比例决定;称重;刮鳞,剥落; [or]4j;
scan: [a]/skæn/; [v]细看;浏览;扫描; [n]扫描;浏览; [or]4j;
scandal: [a]/ˈskændl/; [n]丑闻;丢脸;流言蜚语;反感;愤慨; [v]诋毁; [or]4j;
scarce: [a]/skers/; [adj]缺乏的,不足的;稀少的,罕见的; [adv]仅仅,几乎不; [or]4j;
scare: [a]/sker/; [n]惊恐,恐慌; [vt]惊吓,使害怕; [v]受惊吓,感到害怕; [or]4j;
scatter: [a]/ˈskætər/; [v](使)分散,撒开,散播; [or]4j;
scene: [a]/siːn/; [n]景色,景象;舞台,场景;(戏剧的)一场; [or]4j;
scenery: [a]/ˈsiːnəri/; [n]风景;布景; [or]4j;
schedule: [a]/ˈskedʒuːl/; [n]时间表,日程,计划表;清单,节目表; [v]预定,安排; [or]4j;
scheme: [a]/skiːm/; [n]方案,计划;阴谋,诡计; [v]图谋,密谋; [adj]计划的; [or]4j;
scholar: [a]/ˈskɑːlər/; [n]学者;公费生,有奖学金的学生; [or]4j;
scholarship: [a]/ˈskɑːlərʃɪp/; [n]学问;奖学金;学术界;学术成就; [or]4j;
school: [a]/skuːl/; [n]学校;学院;流派;(鱼,海豚的)一群; [v]教育; [or]4j;
science: [a]/ˈsaɪəns/; [n]科学;(科学的) 学科; [or]4j;
scientific: [a]/ˌsaɪənˈtɪfɪk/; [adj]科学的; [or]4j;
scissors: [a]/ˈsɪzərz/; [n]剪刀; [or]4j;
scold: [a]/skoʊld/; [v]怒骂,责骂,训斥; [n]斥责;爱责骂的人; [or]4j;
scope: [a]/skoʊp/; [n]瞄准镜;范围;余地; [or]4j;
score: [a]/skɔːr/; [n]得分;刻痕;二十;配乐; [vi]刻痕; [v]得分; [vt]在.上刻痕; [or]4j;
scout: [a]/skaʊt/; [v]侦察;监视;嘲笑; [n]童子军,侦察员,守卫; [or]4j;
scrape: [a]/skreɪp/; [n]擦伤;刮,擦; [v]刮,擦; [or]4j;
scratch: [a]/skrætʃ/; [n]抓痕,擦伤; [v]划破,擦伤,挠; [or]4j;
scream: [a]/skriːm/; [vi]发出歇斯底里的声音,尖叫; [vt]尖叫着说出; [n]尖叫声; [or]4j;
screen: [a]/skriːn/; [n]屏幕,荧光屏;纱窗; [v]遮蔽;放映;检查; [or]4j;
screw: [a]/skruː/; [n]螺旋;螺丝; [v]拧紧; [vi]敲诈勒索; [vt]用螺钉固定;把.拧紧; [or]4j;
script: [a]/skrɪpt/; [n]剧本,脚本,手稿;文字系统; [v]为电影(或戏剧等)写剧本; [or]4j;
scrutiny: [a]/ˈskruːtəni/; [n]监视,细看,详细检查,仔细观察; [or]4j;
seal: [a]/siːl/; [n]海豹;邮戳;封条;火漆印; [v]封(信封),密封,盖章;封锁;缄口; [or]4j;
search: [a]/sɜːrtʃ/; [v]搜索;搜寻;探查; [n]搜索;搜寻;探求; [or]4j;
secondary: [a]/ˈsekənderi/; [adj]次要的,第二的;(疾病,感染等) 继发性的;中学的; [or]4j;
secret: [a]/ˈsiːkrət/; [n]秘密; [adj]秘密的,机密的; [or]4j;
secretary: [a]/ˈsekrəteri/; [n]秘书;干事,文书;部长,大臣; [or]4j;
section: [a]/ˈsekʃn/; [n]部分;区域;章节;截面;阶层;部门;路段,地段; [v]划分;切开; [or]4j;
sector: [a]/ˈsektər/; [n](经济等)部门,部分;战区,防区;扇形,扇区; [or]4j;
secure: [a]/səˈkjʊr/; [adj]安心的;安全的; [v]使安全;保卫,保护;确保;获得; [or]4j;
security: [a]/sɪˈkjʊrəti/; [n]安全;防护措施;债券;抵押物; [or]4j;
seed: [a]/siːd/; [n]种子,籽;种子选手; [v]播种,结籽; [or]4j;
seek: [a]/siːk/; [v]寻找;探寻;寻求;试图; [or]4j;
seem: [a]/siːm/; [v]似乎,好像; [or]4j;
seemingly: [a]/ˈsiːmɪŋli/; [adv]表面上;看上去;似乎; [or]4j;
segment: [a]/ˈseɡmənt/; [n]部分;片段;(橘子等的)瓣; [v]分割; [or]4j;
seize: [a]/siːz/; [v]抓住,逮捕,夺取; [or]4j;
select: [a]/sɪˈlekt/; [v]选择,挑选; [adj]精选的,选择的; [or]4j;
selection: [a]/sɪˈlekʃn/; [n]挑选,选择;可供选择的东西,被选中者; [or]4j;
self: [a]/self/; [n]自己,自我,自身; [or]4j;
selfish: [a]/ˈselfɪʃ/; [adj]自私的,利己的,自私自利的; [or]4j;
semester: [a]/sɪˈmestər/; [n]一学期;半年; [or]4j;
semiconductor: [a]/ˌsemikənˈdʌktər/; [n]半导体; [or]4j;
seminar: [a]/ˈsemɪnɑːr/; [n]研究班;研讨会; [or]4j;
senate: [a]/ˈsenət/; [n]参议院,上院; [or]4j;
senator: [a]/ˈsenətər/; [n]参议员; [or]4j;
senior: [a]/ˈsiːniər/; [adj]年长的;资格老的,地位较高的; [n](大学或高中)毕业生;长辈;上司; [or]4j;
sense: [a]/sens/; [n]感官,官能;感觉;判断力;见识; [v]觉得,意识到; [or]4j;
sensible: [a]/ˈsensəbl/; [adj]明智的,理智的;可觉察的;实用耐穿的; [or]4j;
sensitive: [a]/ˈsensətɪv/; [adj]敏感的,过敏的;灵敏的;善解人意的,体恤的; [or]4j;
sentence: [a]/ˈsentəns/; [v]判决,宣判; [n]句子;判决; [or]4j;
separate: [a]/ˈsepəreɪt/; [adj]独立的;分开的;单独的; [v]使分开,分离,分割,划分; [or]4j;
sequence: [a]/ˈsiːkwəns/; [n]顺序,次序;连续,继续; [or]4j;
series: [a]/ˈsɪriːz/; [n]系列,系列节目;连续比赛;连续,接连; [or]4j;
serious: [a]/ˈsɪriəs/; [adj]严重的,危急的;重要的,重大的;认真的,严肃的; [or]4j;
serve: [a]/sɜːrv/; [v]为.服务;招待;供应;服役; [n]网球等发球;发球权;所发的球; [or]4j;
session: [a]/ˈseʃn/; [n]一段时间的(活动);(法庭的)开庭;(议会等的)开会;学期;讲习会; [adj]为录音的歌手或乐队伴奏的; [or]4j;
setting: [a]/ˈsetɪŋ/; [n]设置,调整;环境,背景; [or]4j;
settle: [a]/ˈsetl/; [v]安顿;定居;解决;调停;(目光)停留;结算,算清; [n]背长椅,座位;定居,安顿; [or]4j;
settlement: [a]/ˈsetlmənt/; [n]解决;结算;协议;定居; [or]4j;
seven: [a]/ˈsevn/; [num]七,七个; [n]七个,七点; [or]4j;
seventy: [a]/ˈsevnti/; [num]七十,七十个;七十的,七十个的; [n]七十;从七十到七十九的数目,年数或温度; [or]4j;
severe: [a]/sɪˈvɪr/; [adj]严重的;严厉的;严酷的;剧烈的; [or]4j;
sew: [a]/soʊ/; [v]缝,缝纫; [vt]缝补; [or]4j;
sexual: [a]/ˈsekʃuəl/; [adj]性别的;性的;性感的; [or]4j;
shade: [a]/ʃeɪd/; [n]树荫,阴凉处;遮光物;阴影;鬼魂;色度; [v]渐变;遮蔽,使阴暗; [or]4j;
shadow: [a]/ˈʃædoʊ/; [n]阴影;影子; [v]把影子投在..;盯梢; [or]4j;
shallow: [a]/ˈʃæloʊ/; [adj]浅的;肤浅的; [v]变浅;使变浅; [n]浅滩;浅处; [or]4j;
share: [a]/ʃer/; [v]合用;分配,均分;分享;分担; [n]一份,份额;股票,股份; [or]4j;
sharp: [a]/ʃɑːrp/; [adj]锋利的;敏锐的;清晰的; [adv]急剧地;锐利地;突然地;整点; [n](音乐)升半音;磨; [or]4j;
shave: [a]/ʃeɪv/; [v]剃,刮; [n]剃须,修面,剃刀; [or]4j;
shear: [a]/ʃɪr/; [vt]剪羊毛;剪头发; [n](复数)大剪刀; [or]4j;
shed: [a]/ʃed/; [v]流出(眼泪);蜕皮;脱落;使清晰;流下;去除,摆脱; [n]棚屋; [or]4j;
sheer: [a]/ʃɪr/; [adj]陡峭的;纯粹的; [v](off)急转向,偏离; [n]透明薄纱,透明布料的衣服; [adv]完全地,全然;垂直地,陡峭地; [or]4j;
sheet: [a]/ʃiːt/; [n]被单;纸张;薄板; [or]4j;
shell: [a]/ʃel/; [n]炮弹;骨架;壳,外壳;贝壳; [v]剥壳;炮击; [or]4j;
shelter: [a]/ˈʃeltər/; [n]隐蔽处,躲避处(常用来指住处);庇护; [v]遮蔽,掩护,庇护; [or]4j;
shield: [a]/ʃiːld/; [n]盾牌;防护物; [v]保护; [or]4j;
shift: [a]/ʃɪft/; [n]转移;替换;轮值; [v]移动;售卖(难卖的物品);换挡;改换,替换; [or]4j;
ship: [a]/ʃɪp/; [n]船,海船,舰,飞船; [v]装上船;运送,航运; [or]4j;
shiver: [a]/ˈʃɪvər/; [v]颤抖,打战;颤动; [n]颤抖,打战; [or]4j;
shock: [a]/ʃɑːk/; [v](使)震惊,(使)震动; [n]震动,震惊,冲击,休克; [or]4j;
shoe: [a]/ʃuː/; [n]鞋; [v]穿鞋;给(马)钉蹄铁; [or]4j;
shoot: [a]/ʃuːt/; [v]射击,射杀;拍照;射门; [n]发芽; [or]4j;
shore: [a]/ʃɔːr/; [n]岸,滨; [vt]支撑,使稳住;用支柱撑住; [or]4j;
short: [a]/ʃɔːrt/; [adj]矮的,短的,短期的,短缺的,简略的,粗暴无礼的; [adv]缺少,未达到,半中间(打断),过早地(终止); [n]电影短片;少量烈酒; [vt](比平时)快速完成; [v]短路; [or]4j;
shortage: [a]/ˈʃɔːrtɪdʒ/; [n]不足,缺乏,短缺; [or]4j;
shortcoming: [a]/ˈʃɔːrtkʌmɪŋ/; [n]短处,缺点; [or]4j;
shortly: [a]/ˈʃɔːrtli/; [adv]立刻,不久;生气地,不耐烦地; [or]4j;
shot: [a]/ʃɑːt/; [n]发射;炮弹,射击,枪声;射手;击球;少量烈酒;照片,影片,镜头;注射; [v]射击; [adj]用尽的;破旧的;杂色的,闪光的; [or]4j;
shriek: [a]/ʃriːk/; [v]尖叫,发出尖锐的声音,尖声讲; [n]尖叫,尖叫声; [or]4j;
shrink: [a]/ʃrɪŋk/; [v]收缩;缩小;退缩; [n](非正式用法)心理医生,精神病医生; [or]4j;
shrug: [a]/ʃrʌɡ/; [n]耸肩; [v](为表示厌恶,轻漠,冷淡,怀疑等)耸肩;以耸肩表示(厌恶,轻蔑,冷淡,怀疑等); [or]4j;
sideways: [a]/ˈsaɪdweɪz/; [adv]向侧面地;向旁边;斜着地; [adj]旁边的;斜着的;向侧面的; [or]4j;
sigh: [a]/saɪ/; [n]叹气,叹息; [v]叹息,叹气; [or]4j;
sightseeing: [a]/ˈsaɪtsiːɪŋ/; [n]观光;游览; [adj]观光的,浏览的; [or]4j;
sign: [a]/saɪn/; [v]签署;使眼色;做暗号;做手势; [n]记号,符号;标志,手势; [or]4j;
signal: [a]/ˈsɪɡnəl/; [n]信号;预兆; [v]发信号;标志; [adj]显著的,优越的;暗号的,作信号用的; [or]4j;
signature: [a]/ˈsɪɡnətʃər/; [n]签名,署名;识别标志,鲜明特色;个人特色; [or]4j;
significance: [a]/sɪɡˈnɪfɪkəns/; [n]意义,含义;重要性; [or]4j;
significant: [a]/sɪɡˈnɪfɪkənt/; [adj]重大的,有意义的;意味深长的;数量相当大的; [n]象征,标志; [or]4j;
silence: [a]/ˈsaɪləns/; [n]沉默; [v]使沉默; [or]4j;
silicon: [a]/ˈsɪlɪkən/; [n]硅; [or]4j;
silly: [a]/ˈsɪli/; [adj]傻的;愚蠢的; [n](通常指小孩子)淘气鬼;傻孩子; [or]4j;
silver: [a]/ˈsɪlvər/; [n]银,银子;银器;银币;银牌; [adj]银的;银色的;银婚的; [vt]镀银于,使..成银色; [or]4j;
similar: [a]/ˈsɪmələr/; [adj]相似的;类似的; [n]类似物;相像的人;相似物; [or]4j;
similarly: [a]/ˈsɪmələrli/; [adv]类似地,相似地; [or]4j;
simplicity: [a]/sɪmˈplɪsəti/; [n]简单;简易; [or]4j;
simplify: [a]/ˈsɪmplɪfaɪ/; [v]精简,使单纯; [or]4j;
simply: [a]/ˈsɪmpli/; [adv]简单地;仅仅,只不过; [or]4j;
sin: [a]/sɪn/; [n]罪;罪孽;错误; [v]违犯戒律;犯过失; [or]4j;
sincere: [a]/sɪnˈsɪr/; [adj]真诚的,诚恳的; [or]4j;
single: [a]/ˈsɪŋɡl/; [adj]单个的;未婚的;单身的;单人的; [n]单程票; [v]拣出,挑选(现通常与out连用);作一垒手; [or]4j;
singular: [a]/ˈsɪŋɡjələr/; [adj]单独的,单个的;奇怪的;非凡的,卓越的,显著的; [n]单数;单数形式; [or]4j;
sink: [a]/sɪŋk/; [n]水槽,洗碗池; [v](使)下沉,(使)降低;淹没,下落;使沉没; [adj]贫民窟的; [or]4j;
sir: [a]/sɜːr/; [n]先生;敬启者;爵士; [or]4j;
sister: [a]/ˈsɪstər/; [n]姐妹,姐,妹;修女;女会员;女同胞; [or]4j;
site: [a]/saɪt/; [n]场所;地点;网站;现场; [vt]给.造址,坐落于; [or]4j;
six: [a]/sɪks/; [num]六,六个; [or]4j;
sixteen: [a]/ˌsɪksˈtiːn/; [num]十六,十六个;十六岁的,十六年的;十六的; [n]十六,十六个;十六岁;十六点钟;十六的记号; [or]4j;
sixty: [a]/ˈsɪksti/; [num]六十,六十个;六十的; [n]六十,六十个; [or]4j;
sketch: [a]/sketʃ/; [n]梗概,素描; [v]速写,打草稿; [or]4j;
ski: [a]/skiː/; [v]滑雪; [n]滑雪板; [or]4j;
skilled: [a]/skɪld/; [adj]熟练的,有技能的;需要熟练技术的; [or]4j;
skillful: [a]/ˈskɪlfl/; [adj]娴熟的,灵巧的; [or]4j;
skim: [a]/skɪm/; [v]掠过;浏览,略读;抹去; [n]撇去浮沫;脱脂乳;(为逃税)隐匿的部分收入; [adj]撇去奶油的;用脱脂乳做的; [or]4j;
skin: [a]/skɪn/; [n]皮肤;外皮;兽皮; [v]剥皮;去皮; [adj]<俚>色情的; [or]4j;
sky: [a]/skaɪ/; [n]天空; [v]将..击向空中; [or]4j;
slam: [a]/slæm/; [v]砰地关上;猛力拉,扔;砰地放下;猛烈抨击; [n]砰的一声;大满贯; [or]4j;
slap: [a]/slæp/; [v]掌掴,拍打,侮辱; [n]侮辱,掴,拍击声; [adv]猛然;径直;恰好;正好; [or]4j;
slave: [a]/sleɪv/; [n]奴隶,像奴隶般受制的人; [v]奴隶般地工作,苦干; [or]4j;
sleeve: [a]/sliːv/; [n]袖子; [or]4j;
slender: [a]/ˈslendər/; [adj]苗条的,修长的,纤细的; [or]4j;
slice: [a]/slaɪs/; [v]把..切成片;大幅度削减;切开; [n]薄片;份额,部分; [or]4j;
slide: [a]/slaɪd/; [n]滑行;下落;滑面;幻灯片; [v]使滑动;使滑入;滑动;滑倒;滑落;下跌; [or]4j;
slim: [a]/slɪm/; [adj]细长的;苗条的; [v](用运动,节食等)减轻体重,变苗条; [or]4j;
slip: [a]/slɪp/; [v]滑倒,跌落,溜走,疏忽;偷偷地给;被遗忘; [n]溜走;疏忽,错误;纸条; [adj]打有活结的;可拆卸的;滑动的; [or]4j;
slippery: [a]/ˈslɪpəri/; [adj]滑的;易滑脱的;不老实的;不稳定的; [or]4j;
slit: [a]/slɪt/; [n]投币口,裂缝; [v]切开; [or]4j;
slogan: [a]/ˈsloʊɡən/; [n]标语;口号;广告语; [or]4j;
slope: [a]/sloʊp/; [n]山坡,斜坡,倾斜; [v]倾斜; [or]4j;
smart: [a]/smɑːrt/; [adj]时髦的,衣着讲究的;聪明的;干净的,整洁的; [v]剧痛,刺疼; [or]4j;
smash: [a]/smæʃ/; [v]粉碎,猛冲,击溃; [n]破碎(声),猛撞,巨大的成功; [adj]极为成功的; [or]4j;
smell: [a]/smel/; [n]气味,臭味,嗅觉; [v]嗅,闻到; [or]4j;
smooth: [a]/smuːð/; [adj]光滑的;平稳的; [v]使光滑;使平稳; [or]4j;
smuggle: [a]/ˈsmʌɡl/; [v]非法偷运;走私; [or]4j;
snack: [a]/snæk/; [n]零食,小吃,快餐; [or]4j;
snap: [a]/snæp/; [v]使喀嚓一声折断,使发出吧嗒一声(关上或打开); [n]吧嗒声;快照; [adj]仓促的,突然的; [or]4j;
so-called: [a]/ˌsoʊ ˈkɔːld/; [adj]所谓的,号称的; [or]4j;
soak: [a]/soʊk/; [v]浸泡,渗透,吸入; [n]浸泡; [or]4j;
soar: [a]/sɔːr/; [v]高飞,翱翔;飞腾;猛增;高飞越过; [n]高飞;高涨; [or]4j;
soccer: [a]/ˈsɑːkər/; [n]足球; [or]4j;
social: [a]/ˈsoʊʃl/; [adj]社会的;交际的,社交的; [n]联谊会,联欢会;社交聚会; [or]4j;
socialism: [a]/ˈsoʊʃəlɪzəm/; [n]社会主义; [or]4j;
socialist: [a]/ˈsoʊʃəlɪst/; [n]社会主义,社会主义者; [adj]社会主义的; [or]4j;
soda: [a]/ˈsoʊdə/; [n]苏打,汽水; [or]4j;
sofa: [a]/ˈsoʊfə/; [n](长)沙发; [or]4j;
software: [a]/ˈsɔːftwer/; [n]软件; [or]4j;
soil: [a]/sɔɪl/; [n]泥土,土壤;土地,国土; [v]弄脏;污损; [or]4j;
solar: [a]/ˈsoʊlər/; [adj]太阳的;太阳系的;日光的; [n]日光浴室; [or]4j;
sole: [a]/soʊl/; [n]脚底,鞋底,袜底; [adj]唯一的;独有的;单独的; [v]装鞋底; [or]4j;
solemn: [a]/ˈsɑːləm/; [adj]严肃的;庄严的,隆重的;神圣的; [or]4j;
solid: [a]/ˈsɑːlɪd/; [adj]结实的;坚固的;固体的; [n]固体; [or]4j;
solitary: [a]/ˈsɑːləteri/; [adj]孤独的,单独的,隐居的; [n]独居者,隐士;单独禁闭; [or]4j;
soluble: [a]/ˈsɑːljəbl/; [adj]可溶解的;可解决的; [or]4j;
solution: [a]/səˈluːʃn/; [n]解决办法;解答;溶液;溶解; [or]4j;
solve: [a]/sɔːlv/; [v]解决;解释,解答; [or]4j;
somebody: [a]/ˈsʌmbədi/; pro[n]某人;有人;大人物,重要人物; [or]4j;
somehow: [a]/ˈsʌmhaʊ/; [adv]以某种方式,由于某种原因,不知怎么的; [or]4j;
someone: [a]/ˈsʌmwʌn/; pro[n]有人,某人;重要人物; [or]4j;
sometime: [a]/ˈsʌmtaɪm/; [adv]在某一时候; [adj]某一时间的;以前的; [or]4j;
sometimes: [a]/ˈsʌmtaɪmz/; [adv]有时,间或; [or]4j;
somewhat: [a]/ˈsʌmwʌt/; [adv]有点儿,稍微,有些; pro[n]某物;一些; [or]4j;
somewhere: [a]/ˈsʌmwer/; [adv]到某处,在某处; [n]某处; [or]4j;
son: [a]/sʌn/; [n]儿子;(长者对晚辈的爱称)孩子; [or]4j;
song: [a]/sɔːŋ/; [n]歌曲;诗歌,韵文;鸟鸣;低价; [or]4j;
sophisticated: [a]/səˈfɪstɪkeɪtɪd/; [adj](仪器)精密的,复杂的;老于世故的,老练的,富有经验的;高雅的,精致的; [or]4j;
sore: [a]/sɔːr/; [adj]疼痛的,酸痛的;恼火的; [n]疮; [adv]〈古,诗〉同"sorely. a sore throat"; [or]4j;
sorrow: [a]/ˈsɑːroʊ/; [n]苦恼,伤心;痛哭;悲伤;歉疚; [v]感到悲伤;哀痛;为.悲痛; [or]4j;
sort: [a]/sɔːrt/; [v]把..分类,挑选;修理,整理; [n]种类; [or]4j;
soul: [a]/soʊl/; [n]心灵,灵魂;思想;情绪;鬼魂;核心;中心人物;典型; [adj]黑人的;熟悉黑人的; [or]4j;
sour: [a]/ˈsaʊər/; [adj]酸的;(人)尖酸刻薄的,不友好的; [v](友谊,局势,态度等)变坏;使恶化; [or]4j;
source: [a]/sɔːrs/; [n]源(泉),发源地,来源;原始资料,出处; [v]获得; [or]4j;
southeast: [a]/ˌsaʊθˈiːst/; [n]东南(方),东南部; [adv]向东南; [adj]东南方的,东南部的; [or]4j;
southwest: [a]/ˌsaʊθˈwest/; [n]西南; [adj]西南方的; [adv]在西南方,来自西南; [or]4j;
sow: [a]/soʊ/; [v]播种;散布;煽动; [n]母猪; [or]4j;
spacecraft: [a]/ˈspeɪskræft/; [n]航天器,太空船,宇宙飞船; [or]4j;
spade: [a]/speɪd/; [n]铁锹,铲子,黑桃(扑克); [or]4j;
span: [a]/spæn/; [n]跨度;时间段;范围;持续时间; [v]持续;横跨;包括; [or]4j;
spare: [a]/sper/; [adj]备用的;多余的,闲置的;瘦的; [n]零件,备件; [v]抽出,腾出;免去; [or]4j;
spark: [a]/spɑːrk/; [n]火花,火星;丝毫,微量; [v]发出火花;发动;激励; [or]4j;
specialist: [a]/ˈspeʃəlɪst/; [n]专家;专科医生; [adj]专家的;专业的; [or]4j;
specialize: [a]/ˈspeʃəlaɪz/; [v]专门研究,专门从事; [or]4j;
species: [a]/ˈspiːʃiːz/; [n](单复同)物种;种类;人类; [adj]物种上的; [or]4j;
specific: [a]/spəˈsɪfɪk/; [adj]具体的,明确的;特定的;特殊的;针对..的; [n]详情;特性; [or]4j;
specify: [a]/ˈspesɪfaɪ/; [v]详细说明; [or]4j;
specimen: [a]/ˈspesɪmən/; [n]标本,样本,样品; [or]4j;
spectacular: [a]/spekˈtækjələr/; [adj]壮观的,引人入胜的; [n]壮观的场面,精彩的表演; [or]4j;
speculate: [a]/ˈspekjuleɪt/; [vi]推测,猜测;投机,做投机买卖; [vt]推测; [or]4j;
speed: [a]/spiːd/; [n]速度,速率;迅速; [v]加速; [or]4j;
spelling: [a]/ˈspelɪŋ/; [n]拼法;拼写法; [or]4j;
spend: [a]/spend/; [v]花费,用钱;花(时间或精力);度过; [n](为某目的或某段时间内的)花销,花费,开销; [or]4j;
sphere: [a]/sfɪr/; [n]球;球形;领域; [or]4j;
spider: [a]/ˈspaɪdər/; [n]蜘蛛; [or]4j;
spill: [a]/spɪl/; [v]使溢出;使流出;撒;浇(花等); [n]溢出,溅出;溢出量;摔下; [or]4j;
spin: [a]/spɪn/; [v](使)旋转;纺织;疾驰;眩晕; [n]旋转;纺织;眩晕; [or]4j;
spirit: [a]/ˈspɪrɪt/; [n]灵魂,精神;心灵;幽灵;意志,精力;实质;情绪;烈酒(spirits); [v]鼓励;使振作;诱拐; [or]4j;
spiritual: [a]/ˈspɪrɪtʃuəl/; [adj]精神(上)的;宗教(上)的; [or]4j;
spit: [a]/spɪt/; [v]吐(唾沫); [n]唾液,唾沫,叉子; [or]4j;
spite: [a]/spaɪt/; [n]恶意,怨恨; [v]刁难,欺侮; [or]4j;
splendid: [a]/ˈsplendɪd/; [adj]壮观的,辉煌的,华丽的;极好的,出色的; [or]4j;
split: [a]/splɪt/; [n]劈裂;裂缝;碎片;分裂;不和; [adj]分裂的;不一致的; [v]分开;裂开;被撕破;劈开;割开;撕裂;分配;分担;使分裂; [or]4j;
spoil: [a]/spɔɪl/; [v]溺爱;娇惯;(食物)变质;毁坏; [n]溺爱;战利品;犒劳;成功所带来的好处; [or]4j;
spokesman: [a]/ˈspoʊksmən/; [n]发言人; [or]4j;
sponsor: [a]/ˈspɑːnsər/; [n]倡导者;提案人;赞助人;担保人;教父,教母; [vt]发起;倡议;做.的保人;赞助;资助; [or]4j;
sportsman: [a]/ˈspɔːrtsmən/; [n]运动员; [or]4j;
spot: [a]/spɑːt/; [n]斑点;污点;地点,场所;排名位置;困境;滴;节目档; [v]发现,认出;玷污; [or]4j;
spouse: [a]/spaʊs/; [n]配偶,夫妇;夫,妻; [v]和.结婚; [or]4j;
spray: [a]/spreɪ/; [n]浪花;水雾;喷雾; [vi]飞溅,喷; [vt]喷;向..扫射;散布; [or]4j;
spread: [a]/spred/; [v]伸开,伸展,散布,传播,摊开,覆盖; [n]伸开,伸展,散布,传播,摊开,范围; [adj]广大的;大幅的;(宝石)薄而无光泽的; [or]4j;
spur: [a]/spɜːr/; [v]策马,用踢马刺驱马前进;激励,鞭策;推动; [n]踢马刺,靴刺;刺激,鞭策,鼓励;尖坡; [or]4j;
square: [a]/skwer/; [n]正方形;广场; [adj]正方形的;平方的;直角的; [v]把..弄成方形; [adv]直接地; [or]4j;
squeeze: [a]/skwiːz/; [v](常指用手)挤压;挤进,塞进;用力挤压榨取;减少,压缩; [n]榨;压榨;挤,塞; [or]4j;
stability: [a]/stəˈbɪləti/; [n]稳定,稳定性; [or]4j;
stable: [a]/ˈsteɪbl/; [n]马厩; [adj]稳定的;安定的; [v]使(马)入厩; [or]4j;
stack: [a]/stæk/; [n]堆,一大堆;烟囱; [v]堆积,堆放; [or]4j;
stadium: [a]/ˈsteɪdiəm/; [n](周围有看台的)体育场,露天大型运动场; [or]4j;
staff: [a]/stæf/; [n]全体职员,员工;参谋;拐杖;五线谱; [adj]行政工作的;参谋的;职员的;作为正式工作人员的; [v]雇用工作人员;给.配备员工; [or]4j;
stage: [a]/steɪdʒ/; [n]阶段;舞台;戏剧; [v]举行;展现;上演;筹划;适于上演;适合在舞台上演出;乘公交车(或驿车)旅行;<军事>中间集结;扎营; [or]4j;
stain: [a]/steɪn/; [n]污渍,污迹;染色; [v]弄脏;玷污;染色; [or]4j;
stainless: [a]/ˌsteɪnləs/; [adj]不生锈的,不锈钢的; [or]4j;
stake: [a]/steɪk/; [n]木桩;赌注;利害关系;股份,股本;(赛马)奖金; [v]下注,以桩来支撑; [or]4j;
stale: [a]/steɪl/; [adj]不新鲜的;走了味的;陈腐的; [v]变得不新鲜;使陈旧; [n](猎人做掩蔽用的)假马;笑柄;受人愚弄成为笑谈的人;畜尿; [or]4j;
stamp: [a]/stæmp/; [n]印,章;邮票; [v]盖印;贴邮票于;毁掉;标出,表示;跺脚; [or]4j;
standard: [a]/ˈstændərd/; [n]标准,规格;规范; [adj]标准的; [or]4j;
standpoint: [a]/ˈstændpɔɪnt/; [n]立场,观点; [or]4j;
star: [a]/stɑːr/; [n]星,恒星,明星,名角; [adj]用星装饰的; [v]主演; [or]4j;
stare: [a]/ster/; [v]盯,凝视; [n]注视; [or]4j;
starve: [a]/stɑːrv/; [v](使)饿死,挨饿; [or]4j;
statement: [a]/ˈsteɪtmənt/; [n]声明;结算单,报表;陈述; [or]4j;
static: [a]/ˈstætɪk/; [adj]静电的,静态的,静止的; [n]静电,静电干扰; [or]4j;
station: [a]/ˈsteɪʃn/; [n]车站;站,台;身份,地位; [v]安置,驻扎; [or]4j;
stationary: [a]/ˈsteɪʃəneri/; [adj]静止的;固定的; [n]定居者,驻军; [or]4j;
statistic: [a]/stəˈtɪstɪk/; [n]统计;统计数值;统计学; [or]4j;
statistical: [a]/stəˈtɪstɪkl/; [adj]统计的,统计学的; [or]4j;
statistics: [a]/stəˈtɪstɪks/; [n]统计;统计数字,数据;统计学; [or]4j;
statue: [a]/ˈstætʃuː/; [n]塑像;雕像; [or]4j;
status: [a]/ˈsteɪtəs/; [n]地位;状态;身份; [or]4j;
steady: [a]/ˈstedi/; [adj]稳定的,不变的;坚定的,扎实的,镇定的; [v](使)稳固,(使)稳定;使..冷静; [or]4j;
steak: [a]/steɪk/; [n]牛排;肉块;鱼块; [or]4j;
steam: [a]/stiːm/; [n]蒸汽;轮船; [v]蒸发,冒热气;蒸;快速行进; [or]4j;
steamer: [a]/ˈstiːmər/; [n]蒸汽船;蒸锅; [or]4j;
steel: [a]/stiːl/; [n]钢,钢铁,钢制品; [v]使坚强; [adj]钢的,与钢有关的; [or]4j;
steep: [a]/stiːp/; [v]沉浸于..; [adj]陡峭的;急剧的;过高的; [n]陡坡; [or]4j;
steer: [a]/stɪr/; [v]操纵,驾驶,掌舵,引导; [n]公牛,食用牛; [or]4j;
stem: [a]/stem/; [n]茎,(树)干; [v]阻止;起源于;遏制,抑制; [or]4j;
stereo: [a]/ˈsterioʊ/; [n]立体声(装置); [adj]立体声的; [or]4j;
stern: [a]/stɜːrn/; [adj]严厉的;严峻的;苛刻的;坚决的; [n]船尾; [or]4j;
stick: [a]/stɪk/; [v]坚持;粘贴,刺,戳,扎; [n]棍,棒,手杖; [or]4j;
sticky: [a]/ˈstɪki/; [adj]粘的,黏糊糊的;闷热的;困难的;令人不满意的; [n]便利贴; [or]4j;
stiff: [a]/stɪf/; [adj]僵直的,酸痛的;硬的;困难的; [or]4j;
stimulate: [a]/ˈstɪmjuleɪt/; [v]刺激,引起;刺激(身体部位); [or]4j;
sting: [a]/stɪŋ/; [v]叮;刺疼;使苦闷;蜇; [n](因被刺而引起的)疼痛;(警方为抓捕罪犯精心设计的)圈套; [or]4j;
stir: [a]/stɜːr/; [v]搅拌; [n]搅拌;搅动;震动;搅和; [or]4j;
stock: [a]/stɑːk/; [n]股票;股份;存货;储备;家畜; [v]给..装满;储存; [adj]储备的; [or]4j;
stocking: [a]/ˈstɑːkɪŋ/; [n]长(筒)袜; [or]4j;
stoop: [a]/stuːp/; [v]弯腰,俯身;屈从;堕落,沦为; [n]弯腰; [or]4j;
storage: [a]/ˈstɔːrɪdʒ/; [n]储存,贮藏;仓库; [or]4j;
store: [a]/stɔːr/; [n]商店;储存品; [v]贮藏,储存; [or]4j;
story: [a]/ˈstɔːri/; [n]故事,小说;叙述,描述;新闻报道;谎言,假话;楼层; [or]4j;
stove: [a]/stoʊv/; [n]炉,火炉,电炉; [or]4j;
straight: [a]/streɪt/; [adj]直的;正直的; [adv]直接地;不断地,一直地;立即;直地,笔直地; [n]直线;直线部分; [or]4j;
strain: [a]/streɪn/; [n]负担;紧张;拉力;(生物体)品种,种类; [v]拉紧;劳累;过分使用; [or]4j;
strap: [a]/stræp/; [v]捆扎; [n]带子; [or]4j;
strategic: [a]/strəˈtiːdʒɪk/; [adj]战略(上)的,对全局有重要意义的,关键的; [or]4j;
strategy: [a]/ˈstrætədʒi/; [n]谋略,策略,计谋; [or]4j;
straw: [a]/strɔː/; [n]稻草,麦杆;吸管; [adj]稻草(或麦秆)做的; [or]4j;
stream: [a]/striːm/; [n]小河,溪流;流,一股,一串; [v]流(出),涌(出);按能力分班(或分组); [or]4j;
strength: [a]/streŋθ/; [n]体力,力气,力量;意志力;长处;兵力;实力;人手;浓度,效力;力度,速度; [or]4j;
strengthen: [a]/ˈstreŋθn/; [v]加强,变坚固,变强大; [or]4j;
stress: [a]/stres/; [n]强调;节拍;紧迫;压力; [vt]给.加压力;使紧张;强调; [or]4j;
stretch: [a]/stretʃ/; [v]伸展,延伸,张开,夸大,超越; [n]伸展,张开;一段时间;一段路程; [adj]可伸缩的;弹性的; [or]4j;
strict: [a]/strɪkt/; [adj]严厉的;严格的(条例,法规等);恪守信条的;确切的; [or]4j;
strike: [a]/straɪk/; [v]击打;袭击;罢工; [n]罢工;打击;袭击; [or]4j;
striking: [a]/ˈstraɪkɪŋ/; [adj]容貌出众的,吸引人的;显著的,突出的; [n]罢工; [or]4j;
string: [a]/strɪŋ/; [n]弦,线,细绳,一系列;一行; [v]串起;悬挂;使紧张; [adj]线的,线织的;由弦乐器组成的; [or]4j;
strip: [a]/strɪp/; [v]剥;夺去;脱衣服; [n]长条;长条形土地; [adj]脱衣舞的;被剥去外皮的; [or]4j;
stripe: [a]/straɪp/; [n]长条;条纹;类型,类别; [or]4j;
stroke: [a]/stroʊk/; [n]击打;一击,一次,一举;中风;抚摸;笔画; [v]拭去;轻抚; [or]4j;
structural: [a]/ˈstrʌktʃərəl/; [adj]结构的,构造的,建筑的; [or]4j;
structure: [a]/ˈstrʌktʃər/; [n]结构,构造;建筑物; [v]建筑,组织; [or]4j;
struggle: [a]/ˈstrʌɡl/; [n]奋斗;斗争; [v]挣扎,抗争;奋斗; [or]4j;
student: [a]/ˈstuːdnt/; [n]学生;学者; 大学生; [or]4j;
studio: [a]/ˈstuːdioʊ/; [n]摄影棚;工作室;录音室;单间公寓(studio flat);制片公司; [or]4j;
stuff: [a]/stʌf/; [n]东西;材料;原料; [v]塞满;把..装进; [adj]毛织品做的; [or]4j;
style: [a]/staɪl/; [n]风格;样式; [v]称呼;设计; [or]4j;
subject: [a]/ˈsʌbdʒɪkt/; [n]科目;主题;受试者;国民; [adj]易患的,服从的; [vt]使服从,使隶属,使遭遇; [or]4j;
subjective: [a]/səbˈdʒektɪv/; [adj]主观(上)的,个人的; [or]4j;
submarine: [a]/ˈsʌbməriːn/; [n]潜水艇; [adj]水底的,海底的; [or]4j;
submerge: [a]/səbˈmɜːrdʒ/; [v]沉没,淹没;遮掩; [or]4j;
submit: [a]/səbˈmɪt/; [v]提交;屈服,使...服从;建议,主张; [or]4j;
subordinate: [a]/səˈbɔːrdɪnət/; [n]部下;下属; [adj]次要的;从属的;下级的; [v]使从属于;使处于次要地位; [or]4j;
subsequent: [a]/ˈsʌbsɪkwənt/; [adj]随后的; [or]4j;
substance: [a]/ˈsʌbstəns/; [n]物质;实质,本质;药物; [or]4j;
substitute: [a]/ˈsʌbstɪtuːt/; [v]代替; [n]代替者,代用品,替补队员; [or]4j;
subtract: [a]/səbˈtrækt/; [v]减少;减去;扣除; [vt]减去; [or]4j;
suburb: [a]/ˈsʌbɜːrb/; [n]郊区; [or]4j;
subway: [a]/ˈsʌbweɪ/; [n]地铁; [or]4j;
succeed: [a]/səkˈsiːd/; [v]成功;接替;继承; [or]4j;
succession: [a]/səkˈseʃn/; [n]连续,继续;一连串;继承权; [or]4j;
successive: [a]/səkˈsesɪv/; [adj]连续的;接连的; [or]4j;
suck: [a]/sʌk/; [v]啜,吸入,吸收;使卷入;糟糕,差劲; [n]吸吮,吸力; [or]4j;
sue: [a]/suː/; [v]控告,提起诉讼;控告;起诉; [n]女子名(Sue); [or]4j;
suffer: [a]/ˈsʌfər/; [v]遭受,忍受,承受,受苦; [or]4j;
suffering: [a]/ˈsʌfərɪŋ/; [n]受难;苦楚; [or]4j;
sufficient: [a]/səˈfɪʃnt/; [adj]足够的;充分的; [or]4j;
suggest: [a]/səˈdʒest/; [v]建议,提议;使人想起,暗示; [or]4j;
suggestion: [a]/səˈdʒestʃən/; [n]建议,意见;细微的迹象;暗示;联想; [or]4j;
suicide: [a]/ˈsuːɪsaɪd/; [n]自杀;自毁; [or]4j;
suit: [a]/suːt/; [n]服装;诉讼;套装; [v]合适;适宜于;使穿上套服; [or]4j;
suitable: [a]/ˈsuːtəbl/; [adj]合适的,适宜的; [or]4j;
sulfur: [a]/ˈsʌlfər/; [n]硫磺; [or]4j;
sulphur: [a]/ˈsʌlfər/; [n]硫磺;硫; [v]使硫化;用硫磺处理;在.中加硫磺; [or]4j;
summarize: [a]/ˈsʌməraɪz/; [v]作总结;作概括; [or]4j;
summary: [a]/ˈsʌməri/; [n]摘要,总结; [adj]简略的,概要的,即决的; [or]4j;
summit: [a]/ˈsʌmɪt/; [n]山顶,顶点;(政府间的)峰会; [or]4j;
sun: [a]/sʌn/; [n]太阳;阳光;恒星; [v]晒; [or]4j;
sunlight: [a]/ˈsʌnlaɪt/; [n]日光,阳光; [or]4j;
sunny: [a]/ˈsʌni/; [adj]阳光充足的;乐观的,快乐的; [or]4j;
sunrise: [a]/ˈsʌnraɪz/; [n]日出;朝霞; [adj]新兴的; [or]4j;
sunset: [a]/ˈsʌnset/; [n]日落; [adj]日落的; [or]4j;
sunshine: [a]/ˈsʌnʃaɪn/; [n]日光,日照; [or]4j;
super: [a]/ˈsuːpər/; [adj]极好的;超级的; [adv]非常地;十分,非常; [n]警长;(一栋楼的)监管人; [or]4j;
superb: [a]/suːˈpɜːrb/; [adj]极好的;壮丽的; [or]4j;
superficial: [a]/ˌsuːpərˈfɪʃl/; [adj]肤浅的;表面的;微不足道的; [n]表面文章; [or]4j;
superior: [a]/suːˈpɪriər/; [n]上级,高手; [adj]较高级的,上层的,出众的; [or]4j;
supplement: [a]/ˈsʌplɪmənt/; [n]增补,补充物,保健品;附录; [v]补充; [or]4j;
supply: [a]/səˈplaɪ/; [n]供应(量);补给品,用品(supplies); [vt]供应,提供,补充; [or]4j;
support: [a]/səˈpɔːrt/; [v]支撑;支持;拥护;支援;资助;证实; [n]支撑,支持;支撑者,支撑物; [or]4j;
suppose: [a]/səˈpoʊz/; [vt]想,认为; [vi]推测; [v]假定,假设;设想; [or]4j;
supreme: [a]/suːˈpriːm/; [adj]至高的;最重要的;极度的; [or]4j;
sure: [a]/ʃʊr/; [adv]当然,确实地,无疑地; [adj]肯定的;确信的; [or]4j;
surface: [a]/ˈsɜːrfɪs/; [v]浮上水面;显露; [n]表面,面,水面;外表,外观; [adj]表面的;水面的;外观的;(对高架及地下铁路说的)平地上的; [or]4j;
surge: [a]/sɜːrdʒ/; [n]波涛汹涌;波动;激增; [v]波浪般汹涌奔腾;激增; [or]4j;
surgery: [a]/ˈsɜːrdʒəri/; [n]外科手术;外科; [or]4j;
surplus: [a]/ˈsɜːrplʌs/; [adj]过剩的,多余的; [n]过剩,盈余;顺差; [or]4j;
surprise: [a]/sərˈpraɪz/; [n]惊奇,诧异;惊喜; [v]出其不意地袭击;使惊奇,使诧异,使感到意外; [or]4j;
surrender: [a]/səˈrendər/; [v]投降;屈服;放弃;交出;自首; [n]投降;放弃;屈服;(保险的)解约; [or]4j;
surround: [a]/səˈraʊnd/; [v]围绕;包围; [n]围绕物,环绕物; [adj]环绕立体声的; [or]4j;
surrounding: [a]/səˈraʊndɪŋ/; [adj]周围的(事物);周围的;环境的; [n]包围;围绕物; [or]4j;
surroundings: [a]/səˈraʊndɪŋz/; [n]周围的事物,环境; [or]4j;
survey: [a]/ˈsɜːrveɪ/; [n]调查;测量;鉴定; [v]测量,勘测;鉴定;调查; [or]4j;
survival: [a]/sərˈvaɪvl/; [n]存活;生存; [or]4j;
survive: [a]/sərˈvaɪv/; [vi]活下来,幸存; [vt]比..活得长;幸存,存活;幸免于难; [or]4j;
survivor: [a]/sərˈvaɪvər/; [n]生还者;残存物; [or]4j;
suspect: [a]/səˈspekt/; [n]嫌疑犯,可疑分子; [v]怀疑,猜疑;推测; [adj]可疑的; [or]4j;
suspend: [a]/səˈspend/; [v]悬挂,吊;中止;推迟; [or]4j;
suspicion: [a]/səˈspɪʃn/; [n]怀疑,猜疑,疑心;少许; [or]4j;
suspicious: [a]/səˈspɪʃəs/; [adj]可疑的,引起怀疑的;怀疑的,猜疑的; [or]4j;
sustain: [a]/səˈsteɪn/; [v]维持;支撑,承受;供养;忍受;遭受,蒙受; [or]4j;
swallow: [a]/ˈswɑːloʊ/; [n]吞咽;燕子;一次吞咽的量; [vi]做吞咽动作,咽口水; [v]咽下,吞下; [vt]相信; [or]4j;
sway: [a]/sweɪ/; [v]摇摆,摇曳;动摇(某人); [n]摇摆;支配,影响; [or]4j;
swear: [a]/swer/; [v]发誓,郑重地说;咒骂; [or]4j;
sweat: [a]/swet/; [n]汗; [v]出汗; [or]4j;
sweater: [a]/ˈswetər/; [n]毛衣,厚运动衫,羊毛衫; [or]4j;
sweep: [a]/swiːp/; [v]打扫;快速移动; [n]清扫;一挥(手,胳膊等);范围,广度;绵延弯曲的地带; [or]4j;
sweet: [a]/swiːt/; [adj]甜的,可爱的,美好的,芳香的; [n]糖果,甜食;亲爱的(人),宝贝; [or]4j;
swell: [a]/swel/; [v](使)膨胀,(使)鼓起; [n]增大,膨胀,肿胀,汹涌; [adj]时髦的;一流的;很好的; [or]4j;
swift: [a]/swɪft/; [adj]敏捷的,矫健的;快速的,迅速的; [n]雨燕; [or]4j;
swing: [a]/swɪŋ/; [v]摇荡,来回摆动,转动,转向;使摇摆,使转动,使转向; [n]秋千,摇摆,摆幅,转弯,打击,旋律; [or]4j;
switch: [a]/swɪtʃ/; [n]开关;转变;转向;转辙器; [v]转换,转变;调换;转移;打开,关上; [vt]交换; [or]4j;
sword: [a]/sɔːrd/; [n]剑,刀; [or]4j;
symbol: [a]/ˈsɪmbl/; [n]象征;符号,图标;记号;标志; [or]4j;
sympathetic: [a]/ˌsɪmpəˈθetɪk/; [adj]有同情心的,同情的;支持的;称心的; [or]4j;
sympathize: [a]/ˈsɪmpəθaɪz/; [v]同情,同感,共鸣; [or]4j;
sympathy: [a]/ˈsɪmpəθi/; [n]同情;同感; [or]4j;
symptom: [a]/ˈsɪmptəm/; [n]症状;征兆; [or]4j;
synthetic: [a]/sɪnˈθetɪk/; [adj]合成的,人造的;<语>综合型的,综合性的,借助词尾变化表示句法关系的; [n]合成物; [or]4j;
system: [a]/ˈsɪstəm/; [n]系统;体系;身体;制度; [or]4j;
systematic(al): [a]/ˌsɪstəˈmætɪk/; [adj]有系统的;有计划的; [or]4j;
systematic: [a]/ˌsɪstəˈmætɪk/; [adj]有系统的,系统化的,有条理的;有计划有步骤的,有条不紊的; [or]4j;
tackle: [a]/ˈtækl/; [v]对付,处理;(足球等比赛中)阻截; [n]阻截;钓具;滑轮(组); [or]4j;
tag: [a]/tæɡ/; [n]附加语;标签; [v]装包头于(鞋带等);加标签于;连接,合并; [or]4j;
tail: [a]/teɪl/; [n]尾巴,末端;尾随者; [v]紧跟,尾随; [or]4j;
tailor: [a]/ˈteɪlər/; [n]裁缝; [v]修改;使合适;调整使适应; [vt]裁制;剪裁; [or]4j;
talent: [a]/ˈtælənt/; [n]天赋,才能;天才,人才; [or]4j;
tame: [a]/teɪm/; [adj]驯服的,温顺的;顺从的;枯燥的; [v]驯服; [or]4j;
tank: [a]/tæŋk/; [n]坦克;大容器,大罐; [v]彻底失败,快速减少; [or]4j;
tap: [a]/tæp/; [n]塞子;水龙头;轻敲; [v]轻叩,轻敲;监听,窃听 (电话);开发,发掘;利用; [or]4j;
target: [a]/ˈtɑːrɡɪt/; [n]目标;靶子; [v]瞄准; [or]4j;
taste: [a]/teɪst/; [v]品尝,尝起来;品鉴;体验,体会; [n]滋味,味道;鉴赏力;品尝; [or]4j;
tax: [a]/tæks/; [n]税,税款; [v]对..征税;使负重担; [or]4j;
taxi: [a]/ˈtæksi/; [n]出租汽车; [v](飞机) 缓慢滑行; [or]4j;
tea: [a]/tiː/; [n]茶(叶);茶点; [v]给..沏茶;喝茶; [or]4j;
tear: [a]/ter/; [v]撕裂,撕碎; [n]眼泪; [or]4j;
technical: [a]/ˈteknɪkl/; [adj]技术的,工艺的; [or]4j;
technician: [a]/tekˈnɪʃn/; [n]技术员,技师;技术专家; [or]4j;
technique: [a]/tekˈniːk/; [n]技巧,技能;方法;技术; [or]4j;
technology: [a]/tekˈnɑːlədʒi/; [n]科技;技术,工艺; [or]4j;
tedious: [a]/ˈtiːdiəs/; [adj]沉闷的,冗长乏味的; [or]4j;
teenager: [a]/ˈtiːneɪdʒər/; [n](13-19岁的)少年; [or]4j;
telecommunication: [a]/ˌtelikəˌmjuːnɪˈkeɪʃn/; [n]远程通讯; [adj]与电信有关的; [or]4j;
telegram: [a]/ˈtelɪɡræm/; [n]电报; [or]4j;
telegraph: [a]/ˈtelɪɡræf/; [n]电报;电报机; [v]打电报;流露 (要做某事);显示; [or]4j;
telephone: [a]/ˈtelɪfoʊn/; [v]打电话; [n]电话(机); [or]4j;
telescope: [a]/ˈtelɪskoʊp/; [n]望远镜; [vi]套入;缩短; [adj]套筒的,伸缩式的; [vt]使套入; [or]4j;
temper: [a]/ˈtempər/; [n]脾气,性情;调和剂; [v]锻炼,缓和; [or]4j;
temple: [a]/ˈtempl/; [n]庙宇,圣堂,神殿;太阳穴; [or]4j;
temporary: [a]/ˈtempəreri/; [adj]暂时的,临时的; [or]4j;
tempt: [a]/tempt/; [v]诱惑;吸引;冒..的风险,不顾; [or]4j;
temptation: [a]/tempˈteɪʃn/; [n]引诱,诱惑; [or]4j;
ten: [a]/ten/; [num]十,十个; [n]十个人;十点钟;十岁;十元纸币; [or]4j;
tend: [a]/tend/; [v]照料,倾向; [or]4j;
tendency: [a]/ˈtendənsi/; [n]趋向,趋势,倾向;癖好,意向;派别; [or]4j;
tender: [a]/ˈtendər/; [adj]温柔的;嫩的;柔弱的,脆弱的;痛的; [n]煤水车,附属船;投标; [v]提出(希望对方接受的意见等); [or]4j;
tense: [a]/tens/; [adj]拉紧的;(神经)紧张的; [v]使拉紧;拉紧; [n]时态; [or]4j;
tension: [a]/ˈtenʃn/; [n](精神上的)紧张,不安;紧张局面;拉紧;张力;电压; [v]绷紧; [or]4j;
terminal: [a]/ˈtɜːrmɪnl/; [n]终点,终端;航站楼;终点站; [adj]末端的;晚期的; [or]4j;
territory: [a]/ˈterətɔːri/; [n]地区,领土;版图;领域;范围;属地; [or]4j;
terror: [a]/ˈterər/; [n]恐怖,惊骇; [or]4j;
textbook: [a]/ˈtekstbʊk/; [n]教科书; [or]4j;
textile: [a]/ˈtekstaɪl/; [n]纺织品; [adj]纺织的; [or]4j;
thank: [a]/θæŋk/; [v]感谢; [n]谢意,感谢; [or]4j;
theater: [a]/'θɪətə/; [n]剧场,戏院,电影院;戏剧,戏剧事业;阶梯教室;战区,战场; [or]4j;
theme: [a]/θiːm/; [n]主题;主旨;主旋律; [adj]主题的; [v]赋予.某种主题; [or]4j;
theoretical: [a]/ˌθiːəˈretɪkl/; [adj]理论(上)的; [or]4j;
theory: [a]/ˈθɪri/; [n]理论,原理;学说;推测;想法; [or]4j;
therapy: [a]/ˈθerəpi/; [n]治疗,理疗;疗法; [or]4j;
therefore: [a]/ˈðerfɔːr/; [adv]因此,所以; [or]4j;
thermometer: [a]/θərˈmɑːmɪtər/; [n]温度计; [or]4j;
thick: [a]/θɪk/; [adj]厚的,粗的;稠的,浓的; [or]4j;
thickness: [a]/ˈθɪknəs/; [n]厚(度),密(度); [or]4j;
thief: [a]/θiːf/; [n]小偷,贼; [or]4j;
thing: [a]/θɪŋ/; [n]东西,事物;事件,事态; [or]4j;
thinking: [a]/ˈθɪŋkɪŋ/; [n]思维,思考;想法,见解; [adj]用智慧思考的,能用智慧思考的;思考的,能思考的;有智慧的; [or]4j;
thirsty: [a]/ˈθɜːrsti/; [adj]口渴的,口干的;渴望的,渴求的; [or]4j;
thirty: [a]/ˈθɜːrti/; [num]三十; [adj]三十的;三十个的; [n]三十,三十个; [or]4j;
thorough: [a]/ˈθɜːroʊ/; [adj]彻底的,完全的;详尽的,细致深入的; [or]4j;
thoughtful: [a]/ˈθɔːtfl/; [adj]体贴的;沉思的; [or]4j;
threat: [a]/θret/; [n]恐吓;威胁;凶兆; [or]4j;
threaten: [a]/ˈθretn/; [vt]威胁;危及;恐吓;预示..的恶兆; [v]恐吓; [or]4j;
thrive: [a]/θraɪv/; [v]茁壮成长;繁荣,兴旺; [or]4j;
throat: [a]/θroʊt/; [n]咽喉,嗓子;口子; [or]4j;
throughout: [a]/θruːˈaʊt/; prep. 在..期间,贯穿;遍及; [adv]自始至终;到处; [or]4j;
thrust: [a]/θrʌst/; [v]猛冲,猛推;刺,戳; [n]猛冲,推进;推力;主要观点; [or]4j;
thumb: [a]/θʌm/; [n]拇指; [vt]以拇指示意;迅速翻阅; [vi]<口语>作手势要求搭车; [or]4j;
thunder: [a]/ˈθʌndər/; [n]雷,雷声;轰隆声; [v]打雷;大声抱怨,吼叫; [or]4j;
thus: [a]/ðʌs/; [adv]因此;这样,如此; [or]4j;
tide: [a]/taɪd/; [n]潮,潮汐;潮流; [vi]随潮漂浮; [or]4j;
tidy: [a]/ˈtaɪdi/; [adj]整洁的,整齐的; [v]整理,收拾; [n]盛零碎物品的容器; [or]4j;
tie: [a]/taɪ/; [n]领带;关系;束缚; [v]系;打结;打成平局;绑,捆;打,打结; [or]4j;
tight: [a]/taɪt/; [adj]紧身的,紧的;紧贴的,牢固的;紧张的;挤满的;密封的;小气的;难对付的; [adv]紧紧地,牢牢地; [or]4j;
tile: [a]/taɪl/; [n]瓦;瓷砖; [v]贴砖于;用瓦盖; [or]4j;
till: [a]/tɪl/; [v]翻地,耕地; [conj]直到⋯⋯才; prep. 直到⋯⋯才; [n]放钱的抽屉,冰碛物; [or]4j;
timber: [a]/ˈtɪmbər/; [n]木料;树木;性格,素质; [int]树要倒啦!; [adj]木材的,木制的; [v]用木材作骨架;以林木覆盖; [or]4j;
timely: [a]/ˈtaɪmli/; [adj]适时的,及时的; [adv]及时地; [or]4j;
timetable: [a]/ˈtaɪmteɪbl/; [n]时间表,时刻表; [or]4j;
tin: [a]/tɪn/; [n]罐头;锡; [or]4j;
tiny: [a]/ˈtaɪni/; [adj]很少的;微小的;矮小的; [n]小孩子;<医>癣;<女名>女子名; [or]4j;
tip: [a]/tɪp/; [n]小费;尖端;提示; [v]轻击;倾斜;给小费;翻倒; [or]4j;
tire: [a]/ˈtaɪər/; [v](使)疲倦,(使)厌倦; [n]轮胎,车胎; [or]4j;
tissue: [a]/ˈtɪʃuː/; [n]面巾纸,(动植物的)组织,纱布; [or]4j;
title: [a]/ˈtaɪtl/; [n]标题;头衔;权利; [vt]加标题于;授予.称号; [adj]标题的,题目的;称呼的; [or]4j;
toast: [a]/toʊst/; [n]敬酒;烤面包,吐司; [v]为..祝酒;烤;烘; [or]4j;
tobacco: [a]/təˈbækoʊ/; [n]烟草,烟叶; [or]4j;
today: [a]/təˈdeɪ/; [n]今天;现今; [adv]现在;在今天; [or]4j;
toe: [a]/toʊ/; [n]脚趾; [v]用脚尖走; [or]4j;
token: [a]/ˈtoʊkən/; [n]象征;礼券,代金券;筹码,代币; [adj]象征性的; [or]4j;
tolerance: [a]/ˈtɑːlərəns/; [n]容忍,宽恕;忍耐力; [or]4j;
tolerant: [a]/ˈtɑːlərənt/; [adj]容忍的,宽容的; [or]4j;
tolerate: [a]/ˈtɑːləreɪt/; [v]忍受,容忍;容许,允许; [or]4j;
toll: [a]/toʊl/; [n]伤亡人数;(道路等的)通行费;钟声; [v]敲钟; [or]4j;
tomorrow: [a]/təˈmɔːroʊ/; [n]明天,未来; [adv]在明天,在明日; [or]4j;
tone: [a]/toʊn/; [n]音调;语调,语气;色调; [vt]使更健壮; [vi]给..上色; [or]4j;
topic: [a]/ˈtɑːpɪk/; [n]话题,题目,主题; [or]4j;
torch: [a]/tɔːrtʃ/; [n]手电筒;火把,火炬; [v]放火烧,纵火烧(建筑物或汽车); [or]4j;
torture: [a]/ˈtɔːrtʃər/; [v]对.施以酷刑,拷问,折磨; [n]酷刑,折磨; [adj]遭受重创的;饱受煎熬的; [or]4j;
total: [a]/ˈtoʊtl/; [adj]完全的;整个的,总体的; [n]总数,总额; [or]4j;
tough: [a]/tʌf/; [adj]坚韧的;健壮的;嚼不动的;棘手的;困难的; [adv]强硬地,顽强地; [n]暴徒,恶棍; [v]坚持,忍受; [or]4j;
tour: [a]/tʊr/; [n]旅游;巡游; [v]旅游;做巡回演出; [or]4j;
toward(s): [a]/tɔːrd(z)/; prep. 向,朝(着); [or]4j;
towel: [a]/ˈtaʊəl/; [n]毛巾,手巾; [v]用毛巾擦; [or]4j;
town: [a]/taʊn/; [n]城镇,市镇;闹市区;(市镇)居民; [adj]城镇的; [or]4j;
toy: [a]/tɔɪ/; [n]玩具; [v]不认真考虑,玩弄; [adj]作为玩具的; [or]4j;
track: [a]/træk/; [v]跟踪追赶;用纤拉船; [n]跑道;小路;行动路线;足迹;轨道; [or]4j;
tract: [a]/trækt/; [n]器官系统;一大片地;短文,小册子; [or]4j;
tractor: [a]/ˈtræktər/; [n]拖拉机,牵引车; [or]4j;
tradition: [a]/trəˈdɪʃn/; [n]传统,惯例; [or]4j;
traffic: [a]/ˈtræfɪk/; [n]交通,车流;交通量;交通运输;非法买卖,非法交易; [v]用.作交换;在.通行;交易;买卖; [or]4j;
tragedy: [a]/ˈtrædʒədi/; [n]悲剧; [or]4j;
trail: [a]/treɪl/; [n]小径,路径;记号,痕迹,线索; [v]拽;跟;落后于;追赶;(烟等)袅袅升起; [or]4j;
train: [a]/treɪn/; [n]火车;行列;一系列; [v]受教育;进行训练;训练,培养; [or]4j;
transfer: [a]/trænsˈfɜːr/; [v]转移;调任;换乘;转变;改编; [n]转让;转移;调任;汇兑; [or]4j;
transform: [a]/trænsˈfɔːrm/; [v]将..变形,改变,转换; [or]4j;
transformation: [a]/ˌtrænsfərˈmeɪʃn/; [n]变化,改造,转变; [or]4j;
transformer: [a]/trænsˈfɔːrmər/; [n]变压器; [or]4j;
transient: [a]/ˈtrænʃnt/; [adj]短暂的,路过的;转瞬即逝的; [n]过客; [or]4j;
transistor: [a]/trænˈzɪstər/; [n]晶体管;半导体收音机; [or]4j;
transition: [a]/trænˈzɪʃn/; [n]转变,过渡时期; [v](从某一状态或活动)转变,过渡(到另一状态或活动); [or]4j;
translate: [a]/trænsˈleɪt/; [v]翻译;转化; [or]4j;
translation: [a]/trænsˈleɪʃn/; [n]翻译;译本;转变;调任; [or]4j;
transmission: [a]/trænsˈmɪʃn/; [n]发射,转播,传播,变速器; [or]4j;
transmit: [a]/trænsˈmɪt/; [v]传送;传播,传导;发射; [or]4j;
transparent: [a]/trænsˈpærənt/; [adj]透明的,清澈的,明净的;易识破的,显而易见的; [or]4j;
transport: [a]/ˈtrænspɔːrt/; [v]运输;使狂喜;流放; [n]运输;运输工具;流放犯; [or]4j;
transportation: [a]/ˌtrænspɔːrˈteɪʃn/; [n]运输,运输工具; [or]4j;
trap: [a]/træp/; [n]陷阱;捕兽夹;圈套,诡计;双轮轻便马车;嘴; [v]诱骗;困住; [or]4j;
trash: [a]/træʃ/; [n]废物;垃圾;拙劣的文学(或艺术)作品; [v]捣毁;丢弃;贬低; [or]4j;
tray: [a]/treɪ/; [n]盘,碟,托盘; [or]4j;
treasure: [a]/ˈtreʒər/; [n]金银财宝;财富;珍宝;不可多得的人才; [v]珍藏;储藏;珍视; [or]4j;
treat: [a]/triːt/; [v]对待;治疗;讨论;请客; [n]请客; [or]4j;
treatment: [a]/ˈtriːtmənt/; [n]对待;治疗,疗法; [or]4j;
treaty: [a]/ˈtriːti/; [n]条约;协议;协定; [or]4j;
tree: [a]/triː/; [n]树; [or]4j;
tremble: [a]/ˈtrembl/; [v]发抖;哆嗦;摇动; [n]发抖;震颤; [or]4j;
tremendous: [a]/trəˈmendəs/; [adj]巨大的;极大的;惊人的; [or]4j;
trend: [a]/trend/; [n]趋势;倾向;时尚; [v]倾向;走向;转向;使趋向; [or]4j;
trial: [a]/ˈtraɪəl/; [n]审判,审理;试验;试用;磨炼,苦难; [adj]试验的,试验性的;考验的;审判的; [v]测试; [or]4j;
triangle: [a]/ˈtraɪæŋɡl/; [n]三角形; [or]4j;
trick: [a]/trɪk/; [v]哄骗;捉弄,戏弄; [n]恶作剧,诡计;技艺,戏法; [adj]虚弱的; [or]4j;
trim: [a]/trɪm/; [n]修剪;整齐;装饰; [v]修剪;整理;装饰; [adj](人)苗条的;整洁的; [adv]整齐<整洁>地; [or]4j;
triumph: [a]/ˈtraɪʌmf/; [n]喜悦,狂喜;凯旋,胜利; [v]成功,获胜; [or]4j;
troop: [a]/truːp/; [n]部队;群; [v]群集,集合; [or]4j;
tropical: [a]/ˈtrɑːpɪkl/; [adj]热带的; [or]4j;
troublesome: [a]/ˈtrʌblsəm/; [adj]令人烦恼的,讨厌的; [or]4j;
trousers: [a]/ˈtraʊzərz/; [n]裤子; [or]4j;
truly: [a]/ˈtruːli/; [adv]完全地,非常;真心地,真实地; [or]4j;
trumpet: [a]/ˈtrʌmpɪt/; [n]喇叭,小号;小号声;小号手;传声筒; [v]吹喇叭;发出喇叭般的声音;用喇叭吹出;发喇叭似的声音;大声宣布;宣扬; [or]4j;
trunk: [a]/trʌŋk/; [n]树干;象鼻;(人)躯干;大衣箱;主体;(车的)后备箱;汽车车尾的行李箱; [or]4j;
trust: [a]/trʌst/; [v]信任;盼望,希望;委托; [n]信任;委托; [or]4j;
tube: [a]/tuːb/; [n]隧道;管子,管道;地铁;电视; [or]4j;
tuition: [a]/tuˈɪʃn/; [n]学费,教学,讲授; [or]4j;
tune: [a]/tuːn/; [n]曲调,旋律,协调,调动; [v]<电子><通信>调谐;协调; [or]4j;
tunnel: [a]/ˈtʌnl/; [n]隧道; [v]挖地道; [or]4j;
turbine: [a]/ˈtɜːrbaɪn/; [n]汽轮机,叶轮机; [or]4j;
tutor: [a]/ˈtuːtər/; [n]家庭教师,指导教师; [v]个别指导;当.家庭教师; [or]4j;
twelfth: [a]/twelfθ/; [num]第十二;第十二的;十二分之一的; [n]第十二;十二日;第十二音; [or]4j;
twelve: [a]/twelv/; [num]十二;十二个的; [n]十二个;十二点钟; [or]4j;
twentieth: [a]/ˈtwentiəθ/; [num]第二十;第二十的;二十分之一的; [n]二十分之一;第二十日; [or]4j;
twenty: [a]/ˈtwenti/; [num]二十;二十个; [adj]二十的; [or]4j;
twin: [a]/twɪn/; [adj]孪生的; [n]孪生儿; [or]4j;
twist: [a]/twɪst/; [v]捻,搓;扭;歪曲; [n]搓,扭拧;意外进展;弯曲处; [or]4j;
type: [a]/taɪp/; [n]类型,种类; [v]打字;<医学>测定(血型);按类型把.归类;成为.的典型;<印刷>浇铸(铅字等); [or]4j;
typewriter: [a]/ˈtaɪpraɪtər/; [n]打字机; [or]4j;
typical: [a]/ˈtɪpɪkl/; [adj]典型的;代表性的; [or]4j;
typist: [a]/ˈtaɪpɪst/; [n](尤指专职)打字员; [or]4j;
ugly: [a]/ˈʌɡli/; [adj]丑陋的;险恶的; [n](十九世纪流行的)女帽(上的丝质)遮阳; [or]4j;
ultimate: [a]/ˈʌltɪmət/; [adj]根本的;最后的,最终的; [or]4j;
umbrella: [a]/ʌmˈbrelə/; [n]伞,雨伞; [or]4j;
uncle: [a]/ˈʌŋkl/; [n]伯父,叔父,舅夫,姑父;叔叔; [or]4j;
uncomfortable: [a]/ʌnˈkʌmfərtəbl/; [adj]不舒服的,不自在的,尴尬的; [or]4j;
unconscious: [a]/ʌnˈkɑːnʃəs/; [adj]不省人事的;无意识的;未察觉的; [or]4j;
uncover: [a]/ʌnˈkʌvər/; [v]移去..的覆盖物,发现;揭露; [or]4j;
undergo: [a]/ˌʌndərˈɡoʊ/; [v]经历;遭受; [or]4j;
undergraduate: [a]/ˌʌndərˈɡrædʒuət/; [n](本科)学生; [or]4j;
underground: [a]/ˌʌndərˈɡraʊnd/; [adj]地下的,秘密的; [adv]在地下,秘密地; [n]地铁;地下; [or]4j;
underline: [a]/ˌʌndərˈlaɪn/; [v]划线于.之下;突出显示;强调; [n]下划线;下期节目预告;图下说明文字; [or]4j;
underneath: [a]/ˌʌndərˈniːθ/; [adv]在.下面,在.底下; prep. 在下面; [or]4j;
understanding: [a]/ˌʌndərˈstændɪŋ/; [n]理解;(非正式)协议; [adj]谅解的,体谅的; [or]4j;
undertake: [a]/ˌʌndərˈteɪk/; [v]保证;承担,承包; [or]4j;
undo: [a]/ʌnˈduː/; [v]松开,解开;取消; [or]4j;
uneasy: [a]/ʌnˈiːzi/; [adj]心神不安,不稳定的,不舒服; [or]4j;
unemployment: [a]/ˌʌnɪmˈplɔɪmənt/; [n]失业;失业人数; [or]4j;
unexpected: [a]/ˌʌnɪkˈspektɪd/; [adj]想不到的,意外的; [or]4j;
unfair: [a]/ˌʌnˈfer/; [adj]不公正的,不公平的; [or]4j;
unfortunate: [a]/ʌnˈfɔːrtʃənət/; [adj]不幸的,令人遗憾的; [n]不幸的人; [or]4j;
unfortunately: [a]/ʌnˈfɔːrtʃənətli/; [adv]遗憾的是,可惜的是,不幸的是; [or]4j;
unhappy: [a]/ʌnˈhæpi/; [adj]不幸福的,不快乐的,不幸的; [or]4j;
uniform: [a]/ˈjuːnɪfɔːrm/; [n]制服,军服; [adj]相同的,一致的,统一的; [or]4j;
unify: [a]/ˈjuːnɪfaɪ/; [v]使联合,统一;使相同,使一致; [or]4j;
union: [a]/ˈjuːniən/; [n]工会;联合;合并;协会;同盟;一致;融洽; [or]4j;
unique: [a]/juˈniːk/; [adj]独特的,独一无二的;(唯一的)特有的;不同寻常的; [or]4j;
unit: [a]/ˈjuːnɪt/; [n]整体,单位;部门;课本单元;(机器)一部分的装置,设备,部件; [or]4j;
unite: [a]/juˈnaɪt/; [v]团结,联合,统一,合并; [or]4j;
unity: [a]/ˈjuːnəti/; [n]联合,统一;统一体;团结,一致; [or]4j;
universal: [a]/ˌjuːnɪˈvɜːrsl/; [adj]普遍存在的;全体的;通用的;宇宙的; [n]普遍原则; [or]4j;
universe: [a]/ˈjuːnɪvɜːrs/; [n]宇宙,万物,世界,领域,范围; [or]4j;
unjust: [a]/ˌʌnˈdʒʌst/; [adj]不公平的; [or]4j;
unknown: [a]/ˌʌnˈnoʊn/; [adj]不知道的,未知的,不知名的; [n]未知的事物,未知的东西,未知的情况,未知的因素; [or]4j;
unlike: [a]/ˌʌnˈlaɪk/; [adj]不同的; prep. 不像;和..不同; [or]4j;
unload: [a]/ˌʌnˈloʊd/; [v]卸(货); [or]4j;
unpleasant: [a]/ʌnˈpleznt/; [adj]令人不快的,讨厌的; [or]4j;
unusual: [a]/ʌnˈjuːʒuəl/; [adj]不寻常的,不常见的;与众不同的; [or]4j;
up-to-date: [a]/ˌʌp tə ˈdeɪt/; [adj]时新的,新式的;跟上时代的; [or]4j;
upbringing: [a]/ˈʌpbrɪŋɪŋ/; [n]抚育,抚养,教养; [or]4j;
upon: [a]/əˈpɑːn/; prep. 在..上面; [or]4j;
upper: [a]/ˈʌpər/; [adj]较高的,上面的,上部的; [n]鞋帮; [or]4j;
upright: [a]/ˈʌpraɪt/; [adj]垂直的;正直的; [adv]直立地; [n]立柱; [or]4j;
upset: [a]/ʌpˈset/; [adj]心烦的,苦恼的,不安的,不适的; [v]推翻,打乱,使心烦; [n]混乱,推翻; [or]4j;
upward: [a]/ˈʌpwərd/; [adj]向上的;上升的; [adv]向上地; [or]4j;
urban: [a]/ˈɜːrbən/; [adj]城市的,城镇的,都市的; [or]4j;
urge: [a]/ɜːrdʒ/; [v]力劝,敦促;驱策;力荐; [vi]驱策; [n]冲动,欲望; [or]4j;
urgent: [a]/ˈɜːrdʒənt/; [adj]急迫的,紧迫的; [or]4j;
usage: [a]/ˈjuːsɪdʒ/; [n]使用,用法,惯用法; [or]4j;
use: [a]/juːz/; [v]使用,利用,对待; [n]使用,运用;用法;使用权;; [or]4j;
useful: [a]/ˈjuːsfl/; [adj]有用的,有益的; [or]4j;
useless: [a]/ˈjuːsləs/; [adj]无用的,无价值的,无效的; [or]4j;
user: [a]/ˈjuːzər/; [n]用户,使用者; [or]4j;
usually: [a]/ˈjuːʒuəli/; [adv]通常,平常; [or]4j;
utility: [a]/juːˈtɪləti/; [n]功用,用途,公用事业,物业; [adj]实用的;通用性的; [or]4j;
utilize: [a]/ˈjuːtəlaɪz/; [v]利用;使用; [or]4j;
utmost: [a]/ˈʌtmoʊst/; [adj]最大的;极度的;最远的; [n]极限; [or]4j;
utter: [a]/ˈʌtər/; [v]说,发出;发射; [adj]完全的;彻底的;无条件的; [or]4j;
vacant: [a]/ˈveɪkənt/; [adj]空的,未被占用的;闲置的;空缺的;茫然的; [or]4j;
vacation: [a]/veɪˈkeɪʃn/; [n]休假,假期; [v]休假,度假; [or]4j;
vacuum: [a]/ˈvækjuəm/; [n]真空吸尘器;真空;空虚,茫然若失; [v]用吸尘器打扫; [or]4j;
vague: [a]/veɪɡ/; [adj]含糊的,模糊的,不明确的,茫然的; [n]模糊不定状态; [or]4j;
vain: [a]/veɪn/; [adj]爱虚荣的;徒劳的;没有真正意义的,没有真正价值的,无关紧要的;自负的,自高自大的;无益的; [or]4j;
valid: [a]/ˈvælɪd/; [adj]有效的,正式认可的;合理的,有根据的; [or]4j;
valley: [a]/ˈvæli/; [n]山谷,溪谷,低谷; [or]4j;
valuable: [a]/ˈvæljuəbl/; [adj]贵重的,有价值的; pl. 贵重物品(valuables); [or]4j;
value: [a]/ˈvæljuː/; [v]给.定价,评价;重视,珍视,尊重; [n]价值;有用性; [or]4j;
van: [a]/væn/; [n]厢式货车;面包车;(火车的)货车车厢;先锋; [or]4j;
vanish: [a]/ˈvænɪʃ/; [vi]消失;突然不见;消灭; [v]使消失;使不见; [n]<语音学>消失音,弱化音; [or]4j;
vapor: [a]/ˈveɪpər/; [n](水)蒸汽; [v]蒸发,汽化; [or]4j;
variable: [a]/ˈveriəbl/; [adj]易变的,可变的; [n]变量,可变物; [or]4j;
variation: [a]/ˌveriˈeɪʃn/; [n]变异,变化,变奏曲;<生物> 变异,变种;差异; [or]4j;
variety: [a]/vəˈraɪəti/; [n]品种,种类;变化,多样性,多样化; [or]4j;
various: [a]/ˈveriəs/; [adj]各种各样的;不同的; [or]4j;
vary: [a]/ˈveri/; [v]相异;改变,变化;使多样化; [or]4j;
vast: [a]/væst/; [adj]辽阔的;巨大的; [or]4j;
vehicle: [a]/ˈviːəkl/; [n]交通工具,机动车;传播媒介;工具,手段; [or]4j;
velocity: [a]/vəˈlɑːsəti/; [n]速度;迅速,快速; [or]4j;
venture: [a]/ˈventʃər/; [n]企业;(商业)冒险;投机,风险投资; [vi]冒险前进; [vt]冒.的危险;以.做赌注; [or]4j;
verb: [a]/vɜːrb/; [n]动词; [or]4j;
verify: [a]/ˈverɪfaɪ/; [v]查证,证明,证实; [or]4j;
version: [a]/ˈvɜːrʒn/; [n]版本;译文;(某人对于某件事不同于其他人的)描述,说法; [or]4j;
versus: [a]/ˈvɜːrsəs/; prep. 以..为对手;与..相对,与..相比; [or]4j;
vertical: [a]/ˈvɜːrtɪkl/; [adj]垂直的;顶点的; [n]垂直线,垂直面; [or]4j;
vessel: [a]/ˈvesl/; [n]船,容器,血管; [or]4j;
veteran: [a]/ˈvetərən/; [n]老兵;退役军人; [adj]经验丰富的;老练的; [or]4j;
via: [a]/ˈvaɪə/; prep. 经过,通过; [or]4j;
vice: [a]/vaɪs/; [n]缺点;恶习;邪恶;罪行;生理缺陷; [adj]副的;代理的; pref. 代理的; [vt]用老虎钳夹紧;钳制; [or]4j;
vicious: [a]/ˈvɪʃəs/; [adj]罪恶的;恶意的;凶猛的,残忍的; [or]4j;
victim: [a]/ˈvɪktɪm/; [n]牺牲品,受害者,替罪羊; [or]4j;
video: [a]/ˈvɪdioʊ/; [n]视频,录像;录像带; [v]制作..的录像; [or]4j;
view: [a]/vjuː/; [n]风景;视野;见解; [v]观看,看,望;查看,察看,视察,检查;看待,将..看成是,把..视为,认为; [or]4j;
viewpoint: [a]/ˈvjuːpɔɪnt/; [n]观点,视点,见解,角度; [or]4j;
vigor: [a]/ˈvɪɡər/; [n]生命力,活力; [or]4j;
vigorous: [a]/ˈvɪɡərəs/; [adj]精力充沛的;强有力的,有活力的;强健的; [or]4j;
violate: [a]/ˈvaɪəleɪt/; [v]违反,违背;侵犯,妨碍;亵渎; [or]4j;
violence: [a]/ˈvaɪələns/; [n]暴力;激烈; [or]4j;
violent: [a]/ˈvaɪələnt/; [adj]强烈的,猛烈的;暴力的,粗暴的; [or]4j;
violet: [a]/ˈvaɪələt/; [n]紫罗兰;紫罗兰色; [adj]紫色的,紫罗兰色的; [or]4j;
violin: [a]/ˌvaɪəˈlɪn/; [n]小提琴; [or]4j;
virtual: [a]/ˈvɜːrtʃuəl/; [adj](计算机)虚拟的;十分接近的;实质上的; [or]4j;
virtually: [a]/ˈvɜːrtʃuəli/; [adv]几乎;虚拟地;整个;实际上; [or]4j;
virtue: [a]/ˈvɜːrtʃuː/; [n]正直,善良;美德,德行;好处,优点; [or]4j;
virus: [a]/ˈvaɪrəs/; [n]病毒;(计算机) 病毒;病毒性疾病; [or]4j;
visible: [a]/ˈvɪzəbl/; [adj]看得见的,可见的;显然的,明显的; [or]4j;
vision: [a]/ˈvɪʒn/; [n]视力;视野;视觉;景象;想象;洞察; [v]幻想,设想; [or]4j;
visitor: [a]/ˈvɪzɪtər/; [n]访问者,来宾,游客; [or]4j;
visual: [a]/ˈvɪʒuəl/; [adj]看的,视觉的; [n]视觉资料(指说明性的图片,影片等); [or]4j;
vital: [a]/ˈvaɪtl/; [adj]生命所必需的;必不可少的;至关重要的;有活力的;生命攸关的; [n]要害;重要部分; [or]4j;
vitamin: [a]/ˈvaɪtəmɪn/; [n]维生素; [or]4j;
vivid: [a]/ˈvɪvɪd/; [adj](颜色)鲜艳的,强烈的(颜色,光);生动的,清晰的(记忆,描述); [or]4j;
vocabulary: [a]/vəˈkæbjəleri/; [n]词汇(量);词(汇)表; [or]4j;
vocal: [a]/ˈvoʊkl/; [n]声乐作品; [adj]畅言无忌的;声音的; [or]4j;
volcano: [a]/vɑːlˈkeɪnoʊ/; [n]火山; [or]4j;
volt: [a]/voʊlt/; [n]伏特(电压单位); [or]4j;
voltage: [a]/ˈvoʊltɪdʒ/; [n]电压; [or]4j;
volume: [a]/ˈvɑːljuːm/; [n]音量;数量;容量;册,卷; [or]4j;
voluntary: [a]/ˈvɑːlənteri/; [adj]自愿的;无偿的;志愿的; [n]即兴曲; [or]4j;
volunteer: [a]/ˌvɑːlənˈtɪr/; [n]志愿者;志愿兵;志愿者,义务工作者; [v]自愿做;自愿加入;主动要求;主动提供 (信息); [or]4j;
vote: [a]/voʊt/; [v]选举,表决,投票; [n]投票,选举权,选举,投票结果; [or]4j;
voyage: [a]/ˈvɔɪɪdʒ/; [n]航海,航行; [v]航海; [or]4j;
vulnerable: [a]/ˈvʌlnərəbl/; [adj]易受伤的;脆弱的;易受攻击的; [or]4j;
wage: [a]/weɪdʒ/; [n]薪水,报酬; [v]开展,进行(战争,运动); [or]4j;
wagon: [a]/ˈwæɡən/; [n]运货马车,运货车;敞蓬车厢; [or]4j;
waist: [a]/weɪst/; [n]腰; [or]4j;
waiter: [a]/ˈweɪtər/; [n]侍者,服务员; [or]4j;
wake: [a]/weɪk/; [v]醒来,使觉醒;激发,引起; [n]守灵,守夜;(船航过时的)尾波;年度假期; [or]4j;
waken: [a]/ˈweɪkən/; [v]唤醒;弄醒; [or]4j;
wallet: [a]/ˈwɑːlɪt/; [n]皮夹,钱包; [or]4j;
wander: [a]/ˈwɑːndər/; [v]漫游;蜿蜒;迷路;离题; [n]游荡;闲逛;失散; [or]4j;
wardrobe: [a]/ˈwɔːrdroʊb/; [n]衣橱;全部服装;剧服; [or]4j;
warfare: [a]/ˈwɔːrfer/; [n]战争;斗争,冲突; [or]4j;
warmth: [a]/wɔːrmθ/; [n]暖和,温暖;热烈,热情; [or]4j;
waste: [a]/weɪst/; [n]浪费;废物; [v]浪费;消耗;未充分利用; [adj]无用的;废弃的; [or]4j;
waterproof: [a]/ˈwɔːtərpruːf/; [adj]不透水的,防水的; [v]作防水处理; [n]防水物,防水材料,雨衣; [or]4j;
wave: [a]/weɪv/; [n]波浪;(挥手)示意;起伏;涌现的人,涌现的事物;卷发,卷曲; [v](挥手)示意,波动,飘动波浪; [or]4j;
wax: [a]/wæks/; [n]蜡;蜡状物; [v]给.上蜡;给.打蜡,给.上蜡;渐渐变大;变为;(月亮)渐圆,渐盈; [adj]蜡制的; [or]4j;
weaken: [a]/ˈwiːkən/; [v]削弱,稀释,使虚弱;使变淡; [or]4j;
weakness: [a]/ˈwiːknəs/; [n](性格,系统)弱点,虚弱;(对人或事物的迷恋)无法抗拒; [or]4j;
wealth: [a]/welθ/; [n]财富;财产;大量; [or]4j;
wealthy: [a]/ˈwelθi/; [n]富人; [adj]富有的;充分的; [or]4j;
weapon: [a]/ˈwepən/; [n]武器;手段; [v]武装,提供武器; [or]4j;
weave: [a]/wiːv/; [v]织;编织;编进;织布; [n]织法;织物; [or]4j;
wedding: [a]/ˈwedɪŋ/; [n]婚礼,婚宴; [or]4j;
weed: [a]/wiːd/; [n]杂草;野草; [v]除杂草; [or]4j;
weekly: [a]/ˈwiːkli/; [adv]一周一次地; [adj]每周的,一周一次的; [n]周报,周刊; [or]4j;
weep: [a]/wiːp/; [v]哭泣;(伤口)化脓; [n]哭泣; [or]4j;
weld: [a]/weld/; [v]焊接;使结合,使成整体; [n]焊接; [or]4j;
welfare: [a]/ˈwelfer/; [n]福利;幸福,健康; [or]4j;
well-known: [a]/ˌwel ˈnoʊn/; [adj]有名的,著名的; [or]4j;
western: [a]/ˈwestərn/; [adj]西的,西方的,来自西方的人,有西方特征的; [n]西方人,西部片,西部小说; [or]4j;
whale: [a]/weɪl/; [n]鲸; [or]4j;
whatsoever: [a]/ˌwʌtsoʊˈevər/; [adv]无论什么,任何;无论什么的; pro[n]无论什么;任何; [or]4j;
whenever: [a]/wenˈevər/; [conj]每当,无论何时; [adv]不论何时;随便什么时候; [or]4j;
wherever: [a]/werˈevər/; [conj]无论在哪里; [adv]无论在什么地方; [or]4j;
whichever: [a]/wɪtʃˈevər/; pro[n]无论哪个;无论哪些; [adv](表示什么特征或品质在作决定时重要).的那个; [adj]无论哪一个; [or]4j;
whilst: [a]/waɪlst/; [conj]当..的时候; [n]一会儿;一段时间; [or]4j;
whip: [a]/wɪp/; [vt]鞭打,抽打;突然拿取,猛然抓住;痛责;驱使;怂恿; [v]一下子猛地移动,急走,急冲; [n]鞭子;抽打;组织秘书;蛋奶水果甜点心; [or]4j;
whisper: [a]/ˈwɪspər/; [v]耳语,密谈; [vt]低声低语地讲,悄悄地说;私下说; [n]私语,谣传;沙沙声,飒飒声; [or]4j;
whistle: [a]/ˈwɪsl/; [n]口哨; [v]吹口哨;呼啸; [or]4j;
whoever: [a]/huːˈevər/; pro[n]无论是谁,不管谁,任何人; [or]4j;
wicked: [a]/ˈwɪkɪd/; [adj]邪恶的,恶毒的;淘气的,恶作剧的; [n]恶人;邪恶的人; [adv]用作加强语气用; [or]4j;
widen: [a]/ˈwaɪdn/; [v]加宽;变宽; [or]4j;
widespread: [a]/ˈwaɪdspred/; [adj]分布广的;普遍的,广泛的; [or]4j;
widow: [a]/ˈwɪdoʊ/; [n]寡妇,遗孀; [v]使成寡妇; [or]4j;
width: [a]/wɪdθ/; [n]宽度,广度,宽阔; [or]4j;
wild: [a]/waɪld/; [adj]野性的;野生的;狂热的;荒芜的;疯狂的; [or]4j;
willing: [a]/ˈwɪlɪŋ/; [adj]愿意的,心甘情愿的;乐意的; [or]4j;
win: [a]/wɪn/; [v](获)胜,赢得; [n]赢,胜利; [or]4j;
wing: [a]/wɪŋ/; [n]翅膀;机翼;门厅; [v]飞过,空运; [or]4j;
wipe: [a]/waɪp/; [v]擦,揩;擦去; [or]4j;
wire: [a]/ˈwaɪər/; [n]电线,电缆,导线,金属丝; [vi]拍电报; [vt]拍电报;给.装电线; [or]4j;
wisdom: [a]/ˈwɪzdəm/; [n]智慧,学问;明智,正确判断; [or]4j;
wit: [a]/wɪt/; [n]富有机智的人;智力,才智;机智;风趣,措辞巧妙的能力; [or]4j;
withdraw: [a]/wɪðˈdrɔː/; [v]取款;撤退,收回,撤离; [or]4j;
withstand: [a]/wɪðˈstænd/; [v]忍受;抵挡; [or]4j;
witness: [a]/ˈwɪtnəs/; [n]目击者,证人; [v]目击,亲眼看见;为..作证; [or]4j;
wolf: [a]/wʊlf/; [n]狼;贪婪的人; [v]狼吞虎咽地吃; [or]4j;
woman: [a]/ˈwʊmən/; [n]女人,妇女;女仆; [adj]女人的,女性的,妇女的; [vt]为..配备妇女,使成女人腔; [or]4j;
wonder: [a]/ˈwʌndər/; [v]想知道;感到惊讶; [n]奇迹,奇观;惊奇,惊异; [or]4j;
wooden: [a]/ˈwʊdn/; [adj]木制的,木质的;呆笨的,死板的; [or]4j;
wool: [a]/wʊl/; [n]羊毛;毛线;毛织品; [or]4j;
worker: [a]/ˈwɜːrkər/; [n]工人; [or]4j;
workman: [a]/ˈwɜːrkmən/; [n]工人,工匠; [or]4j;
workshop: [a]/ˈwɜːrkʃɑːp/; [n]车间,工场,工作室;研讨会; [or]4j;
world-wide: [a]/ˈwɜːrld waɪd/; [adj]遍及全球的; [or]4j;
worm: [a]/wɜːrm/; [n]虫,蠕虫; [v]蠕动;捕捉蠕虫; [or]4j;
worse: [a]/wɜːrs/; [n]更坏的事,更恶劣的事; [adj]更坏的,更恶劣的; [adv]更坏地,更恶劣地; [or]4j;
worship: [a]/ˈwɜːrʃɪp/; [v]崇拜,爱戴;做礼拜,拜神; [n]礼拜,礼拜仪式;崇拜,敬仰; [or]4j;
worst: [a]/wɜːrst/; [n]最坏的事; [adj]最坏的,最差的; [v]打击,胜过; [adv]最坏地; [or]4j;
worth: [a]/wɜːrθ/; [adj]值..钱;有..价值; [n]价值,财产; [or]4j;
worthless: [a]/ˈwɜːrθləs/; [adj]无价值的;无用的; [or]4j;
worthwhile: [a]/ˌwɜːrθˈwaɪl/; [adj]值得(花时间,精力)的,有意义的; [or]4j;
worthy: [a]/ˈwɜːrði/; [adj](of)值得..的,配得上..的,可尊敬的,有价值的; [n]知名人士;杰出人物; [or]4j;
wrap: [a]/ræp/; [v]裹,包,捆;覆盖; [n]包裹物,覆盖物;外衣; [or]4j;
wreck: [a]/rek/; [n]沉船,失事船;失事;(事故中)遭严重损坏的汽车(飞机等); [v]破坏,使毁灭; [or]4j;
wrinkle: [a]/ˈrɪŋkl/; [n]皱纹,褶皱;窍门;转折,改变; [v](使)起褶皱; [or]4j;
wrist: [a]/rɪst/; [n]腕部; [or]4j;
writer: [a]/ˈraɪtər/; [n]作家;文书;作曲者; [or]4j;
writing: [a]/ˈraɪtɪŋ/; [n]写作;著作;书面形式; [or]4j;
yawn: [a]/jɔːn/; [v]打呵欠;裂开;打着呵欠说; [n]呵欠;乏味或枯燥的事物; [or]4j;
yearly: [a]/ˈjɪrli/; [adj]一年的,每年的,一年一度的; [adv]每年,一年一度; [n]年刊;年鉴; [or]4j;
yeast: [a]/jiːst/; [n]酵母,发酵物;兴奋; [or]4j;
yellow: [a]/ˈjeloʊ/; [adj]黄色的,胆小的; [n]黄色; [v](使某物)变黄或发黄; [or]4j;
yes: [a]/jes/; [n]是;肯定; [int]答话时表示正确或真实;是; [or]4j;
yesterday: [a]/ˈjestərdeɪ/; [n]昨天;往昔; [adv]昨天; [adj]过时的; [or]4j;
yield: [a]/jiːld/; [v]出产;屈服;弯曲;让行; [n]收益; [or]4j;
youngster: [a]/ˈjʌŋstər/; [n]年轻人,少年; [or]4j;
yours: [a]/jɔːrz/; pro[n]你的,你们的(所属物);信末署名前用语; [or]4j;
youth: [a]/juːθ/; [n]青年;青年时期;青年们;青春; [or]4j;
youthful: [a]/ˈjuːθfl/; [adj]年轻的;富于青春活力的; [or]4j;
zeal: [a]/ziːl/; [n]热情,热心; [or]4j;
zealous: [a]/ˈzeləs/; [adj]热情的,狂热的,热心的; [or]4j;
zebra: [a]/ˈziːbrə/; [n]斑马; [or]4j;
zero: [a]/ˈzɪroʊ/; [num]零; [n]零,零度; [adj]零的;无价值的;零视度的; [v]把 ... 调零;瞄准;集中注意;迫近; [or]4j;
zone: [a]/zoʊn/; [n]地带,空间,地区,区域,范围; [or]4j;
zoo: [a]/zuː/; [n]动物园; [or]4j;
