Antarctic: [a]/ænˈtɑːrktɪk/; [adj]南极的;  [n]南极区; [or]6j;
Arctic: [a]/ˈɑːrktɪk/; [n]北极;  [adj]北极的,极寒的; [or]6j;
Buddhism: [a]/ˈbʊdɪzəm/; [n]佛教; [or]6j;
Catholic: [a]/ˈkæθlɪk/; [adj](兴趣等)广泛的,(C大写)天主教的;  [n](C大写)天主教徒; [or]6j;
Easter: [a]/ˈiːstər/; [n]复活节; [or]6j;
Egyptian: [a]/iˈdʒɪpʃn/; [n]埃及人; [or]6j;
Jesus: [a]/ˈdʒiːzəs/; [n]耶稣;  [int]天哪;岂有此理; [or]6j;
Jupiter: [a]/ˈdʒuːpɪtər/; [n]木星; [or]6j;
Mars: [a]/mɑːrz/; [n]火星; [or]6j;
Pope: [a]/poʊp/; [n]教皇; [or]6j;
Saturn: [a]/ˈsætɜːrn/; [n]<天>土星; [or]6j;
Thanksgiving: [a]/ˌθæŋksˈɡɪvɪŋ/; [n]感恩节; [or]6j;
Turkey: [a]/ˈtɜːrki/; [n]土耳其; [or]6j;
Venus: [a]/ˈviːnəs/; [n]金星; [or]6j;
abandon: [a]/əˈbændən/; [v]抛弃;放弃;放纵; [or]6j;
abbreviation: [a]/əˌbriːviˈeɪʃn/; [n]缩短;缩写词;省略号; [or]6j;
abide: [a]/əˈbaɪd/; [v]遵守;忍受;居住; [or]6j;
abnormal: [a]/æbˈnɔːrml/; [adj]反常的;畸形的; [or]6j;
abolish: [a]/əˈbɑːlɪʃ/; [v]废除,废止;取消,革除; [or]6j;
abrupt: [a]/əˈbrʌpt/; [adj]突然的;唐突的;鲁莽的; [or]6j;
absence: [a]/ˈæbsəns/; [n]缺席;缺勤;缺乏;缺席,心不在焉; [or]6j;
absorb: [a]/əbˈzɔːrb/; [vt]吸收;汲取;吸引..的注意;理解,掌握;承受; [or]6j;
absorption: [a]/əbˈsɔːrpʃn/; [n]吸收;全神贯注;合并; [or]6j;
abstract: [a]/ˈæbstrækt/; [adj]抽象的;  [n]摘要,抽象;  [v]提取; [or]6j;
absurd: [a]/əbˈsɜːrd/; [adj]荒唐的;可笑的;不合理的;  [n]荒唐; [or]6j;
abundance: [a]/əˈbʌndəns/; [n]丰富;大量; [or]6j;
abundant: [a]/əˈbʌndənt/; [adj]丰富的;大量的; [or]6j;
abuse: [a]/əˈbjuːs/; [v]虐待;辱骂;(对麻醉毒品,兴奋剂等的)非法服用;滥用;  [n]滥用;虐待;辱骂; [or]6j;
abut: [a]/əˈbʌt/; [v]紧靠; [or]6j;
academic: [a]/ˌækəˈdemɪk/; [adj]学术的;学院的,大学的;理论的;  [n]学者; [or]6j;
academy: [a]/əˈkædəmi/; [n]学院; [or]6j;
accelerate: [a]/əkˈseləreɪt/; [v]加速,增长;使增速,促进; [or]6j;
access: [a]/ˈækses/; [n]进入;使用权;通道;  [v]进入;访问; [or]6j;
accessible: [a]/əkˈsesəbl/; [adj]可使用的;可到达的;可进入的;易懂的; [or]6j;
accessory: [a]/əkˈsesəri/; [n](妇女的)装饰品;附件;附属物;同谋;  [adj]附属的;辅助的;同谋的; [or]6j;
accident: [a]/ˈæksɪdənt/; [n]事故;意外;偶然; [or]6j;
accommodate: [a]/əˈkɑːmədeɪt/; [v]向.提供住处(或膳宿);给.提供方便;容纳;使适应,顺应; [or]6j;
accommodation: [a]/əˌkɑːməˈdeɪʃn/; [n]住宿,食宿;调解;住处; [or]6j;
accomplish: [a]/əˈkɑːmplɪʃ/; [v]完成,做到;实现; [or]6j;
accord: [a]/əˈkɔːrd/; [n]协议;  [v]授予; [or]6j;
accordance: [a]/əˈkɔːrdns/; [n]符合;一致;授予; [or]6j;
account: [a]/əˈkaʊnt/; [n]账户;原因,理由;叙述;  [v]报账,做出说明(或解释),为.负责,受罚;认为,考虑; [or]6j;
accumulate: [a]/əˈkjuːmjəleɪt/; [vi]聚积,堆积;  [vt]积攒,积累; [or]6j;
accurate: [a]/ˈækjərət/; [adj]精确的;正确的;符合标准的; [or]6j;
accusation: [a]/ˌækjuˈzeɪʃn/; [n]谴责;<律>指控; [or]6j;
accuse: [a]/əˈkjuːz/; [v]指责;控告;把..归咎于; [or]6j;
accustomed: [a]/əˈkʌstəmd/; [adj]通常的,惯常的;独特的;习惯的,适应了的(to); [or]6j;
achievement: [a]/əˈtʃiːvmənt/; [n]成绩,成就;实现,完成; [or]6j;
acid: [a]/ˈæsɪd/; [n]<化学>酸;酸性物质;尖酸;  [adj]尖刻的;敏锐的;含酸过多的;酸的;酸味的; [or]6j;
acknowledge: [a]/əkˈnɑːlɪdʒ/; [v]告知收到;对(人)打招呼,招呼(某人)以示相识,致意;就..表示谢忱,鸣谢,感谢,感激,答谢,对..表示感谢;承认(属实),承认(权威,地位); [or]6j;
acquaint: [a]/əˈkweɪnt/; [v]使熟悉;使认识;介绍; [or]6j;
acquaintance: [a]/əˈkweɪntəns/; [n]认识;对..有了解,熟知;熟人,相识的人; [or]6j;
acquire: [a]/əˈkwaɪər/; [v](尤指靠自己的努力或行动或经过一个过程)获得;学到;取得; [or]6j;
acquisition: [a]/ˌækwɪˈzɪʃn/; [n]并购;获得;掌握;获得物;取得物; [or]6j;
activate: [a]/ˈæktɪveɪt/; [v]使活动起来;使开始起作用; [or]6j;
acute: [a]/əˈkjut/; [adj](疼痛,妒忌等)剧烈的,严重的;敏锐的;急性的;尖声的; [or]6j;
adapt: [a]/əˈdæpt/; [vi]适应不同情况;  [vt]使适合;改编; [or]6j;
addict: [a]/ˈædɪkt/; [n]上瘾的人;入迷的人;  [v]使沉迷,使上瘾; [or]6j;
addition: [a]/əˈdɪʃn/; [n]加法;添加;附加物; [or]6j;
additional: [a]/əˈdɪʃənl/; [adj]增加的;附加的; [or]6j;
adequate: [a]/ˈædɪkwət/; [adj]充足的,充分的,足够的;尚可的,过得去的; [or]6j;
adhere: [a]/ədˈhɪr/; [v]遵守;坚持;粘附;附着,粘在..上; [or]6j;
adjacent: [a]/əˈdʒeɪsnt/; [adj]邻接的,毗连的;邻近的; [or]6j;
adjoin: [a]/əˈdʒɔɪn/; [v]与.毗连;贴近; [or]6j;
adjust: [a]/əˈdʒʌst/; [v]调整,调节;校正;改变.以适应; [or]6j;
adjustable: [a]/əˈdʒʌstəbl/; [adj]可调整的; [or]6j;
administer: [a]/ədˈmɪnɪstər/; [v]管理;执行;实施;给予;用(药); [or]6j;
administration: [a]/ədˌmɪnɪˈstreɪʃn/; [n]管理;管理层,管理部门;政府;(药的)配给; [or]6j;
admiration: [a]/ˌædməˈreɪʃn/; [n]钦佩;仰慕; [or]6j;
admit: [a]/ədˈmɪt/; [v]承认;准许.进入,允许.加入;容许,可容纳; [or]6j;
adolescent: [a]/ˌædəˈlesnt/; [adj]青春期的;青少年的;  [n]青少年; [or]6j;
adopt: [a]/əˈdɑːpt/; [v]收养;采纳,采用; [or]6j;
adoption: [a]/əˈdɑːpʃn/; [n]收养,采用,采纳; [or]6j;
adore: [a]/əˈdɔːr/; [v]很喜欢,极喜爱;崇拜;爱慕; [or]6j;
advantage: [a]/ədˈvæntɪdʒ/; [v]使处于有利地位;有利于;有助于;  [n]优势,利益,有利条件; [or]6j;
advantageous: [a]/ˌædvənˈteɪdʒəs/; [adj]有利的; [or]6j;
advent: [a]/ˈædvent/; [n]来临;到来;出现; [or]6j;
adverse: [a]/ˈædvɜːrs/; [adj]不利的;(方向上)逆的;在相反的方向上移动(或运转);相反的; [or]6j;
advertise: [a]/ˈædvərtaɪz/; [v]为..做广告;公告;公布; [or]6j;
advocate: [a]/ˈædvəkeɪt/; [v]提倡;主张;为.辩护;  [n]辩护者;提倡者;律师; [or]6j;
aerial: [a]/ˈeriəl/; [adj]飞机的,航空的,由飞机进行的;空中的,架空的;  [n]天线; [or]6j;
aerospace: [a]/ˈeroʊspeɪs/; [n]宇宙空间;航空航天(业);  [adj]航空与航天的,宇宙空间的; [or]6j;
aesthetic: [a]/esˈθetɪk/; [n]美感;审美观;  [adj]美学的;审美的;悦目的;雅致的; [or]6j;
affection: [a]/əˈfekʃn/; [n]关爱,爱慕;感情;作用,影响;疾病; [or]6j;
affirm: [a]/əˈfɜːrm/; [v]肯定;断定;坚持声称; [or]6j;
afflict: [a]/əˈflɪkt/; [v]使痛苦;使苦恼; [or]6j;
affluent: [a]/ˈæfluənt/; [adj]富裕的,丰富的; [or]6j;
afford: [a]/əˈfɔːrd/; [v]买得起;抽得出时间;担负得起;提供;产生;赐予;  [vi]担负得起;买得起; [or]6j;
agenda: [a]/əˈdʒendə/; [n]议事日程; [or]6j;
agent: [a]/ˈeɪdʒənt/; [n]政府特工;代理商,代理人; [or]6j;
aggravate: [a]/ˈæɡrəveɪt/; [v]使恶化,加重;使气恼,激怒; [or]6j;
aggregate: [a]/ˈæɡrɪɡət/; [n]合计;总数;混凝料;总计;  [v]集合;聚集;合计;  [adj]总的,总数的;集合的; [or]6j;
aggressive: [a]/əˈɡresɪv/; [adj]好斗的,挑衅性的;有闯劲的,积极进取的; [or]6j;
agitation: [a]/ˌædʒɪˈteɪʃn/; [n]摇动;焦虑,忧虑;煽动; [or]6j;
agony: [a]/ˈæɡəni/; [n]极大痛苦; [or]6j;
agreeable: [a]/əˈɡriːəbl/; [adj](欣然)同意的;愉快的;可以接受的; [or]6j;
aid: [a]/eɪd/; [n]帮助;救护,援助;帮助者,助手;  [v]帮助;援助,帮助,有助于; [or]6j;
aisle: [a]/aɪl/; [n](席位间的)通道,过道; [or]6j;
alarm: [a]/əˈlɑːrm/; [n]警报器,警报;闹钟;惊恐,忧虑;  [v]使惊恐,使忧虑; [or]6j;
alas: [a]/əˈlæs/; [int]唉;  [adv]不幸地; [or]6j;
album: [a]/ˈælbəm/; [n]相册;唱片集,专辑;集邮册; [or]6j;
alcohol: [a]/ˈælkəhɔːl/; [n]酒;酒精,乙醇; [or]6j;
alert: [a]/əˈlɜːrt/; [adj]警惕的;充分意识到的;  [n]警觉(状态),戒备(状态);警报;  [v]向.报警,使警惕;使意识到; [or]6j;
algebra: [a]/ˈældʒɪbrə/; [n]代数; [or]6j;
alien: [a]/ˈeɪliən/; [n]外国人;外星人;  [adj]陌生的;外国的,外星(人)的;异己的,不相容的; [or]6j;
alienate: [a]/ˈeɪliəneɪt/; [v]疏远;挑拨; [or]6j;
allege: [a]/əˈledʒ/; [v]断言;硬说; [or]6j;
allegiance: [a]/əˈliːdʒəns/; [n]忠诚,拥护; [or]6j;
alleviate: [a]/əˈliːvieɪt/; [v]减轻;缓解;缓和; [or]6j;
alliance: [a]/əˈlaɪəns/; [n]联盟,同盟;盟约;盟国,同盟者;类同; [or]6j;
allocate: [a]/ˈæləkeɪt/; [v]分配,配给; [or]6j;
allowance: [a]/əˈlaʊəns/; [v]定量供应(食物,饮料等物品);配给;  [n]零用钱;津贴,补贴;限额;免税额;允许,容忍,让步;考虑; [or]6j;
alloy: [a]/ˈælɔɪ/; [n]合金;  [v]使成合金; [or]6j;
ally: [a]/ˈælaɪ/; [n]盟友;同盟国;(二战时的) 同盟国;  [v]结盟; [or]6j;
alongside: [a]/əˌlɔːŋˈsaɪd/; [adv]在旁边,并排地,并肩地;  prep. 在.旁边,和.并排;和.一起; [or]6j;
alter: [a]/ˈɔːltər/; [v]改变;改动,使变样;改做; [or]6j;
alternate: [a]/ˈɔːltərnət/; [adj]交替的,轮流的,间隔的;  [v](使)交替,(使)轮流;  [n]代替者; [or]6j;
alternative: [a]/ɔːlˈtɜːrnətɪv/; [adj]可供选择的;替代的;不寻常的;  [n]可供选择的事物; [or]6j;
amateur: [a]/ˈæmətʃər/; [n]业余爱好者;外行;  [adj]外行的;业余爱好的,业余(身份)的; [or]6j;
ambassador: [a]/æmˈbæsədər/; [n](特命全权)大使;代表; [or]6j;
ambition: [a]/æmˈbɪʃn/; [n]雄心,强烈欲望,抱负;(具体的)追求目标;  [vt]追求;有.野心; [or]6j;
ambitious: [a]/æmˈbɪʃəs/; [adj]有抱负的;雄心勃勃的;(计划,想法等)宏大的,艰巨的; [or]6j;
amend: [a]/əˈmend/; [v]改进;修订;修正; [or]6j;
amends: [a]/əˈmendz/; [n]赔偿;赔罪; [or]6j;
ammunition: [a]/ˌæmjuˈnɪʃn/; [n]弹药;炮弹; [or]6j;
ample: [a]/ˈæmpl/; [adj]富足的,丰满的,宽敞的; [or]6j;
amplify: [a]/ˈæmplɪfaɪ/; [v]放大(声音等);扩大;增强;详述;进一步阐述; [or]6j;
amplitude: [a]/ˈæmplɪtuːd/; [n]振幅;广阔;幅度; [or]6j;
amusement: [a]/əˈmjuːzmənt/; [n]娱乐,消遣;乐趣; [or]6j;
analog: [a]/ˈænəlɑːɡ/; [adj]有长短针的;模拟的;  [n]类似物;模拟; [or]6j;
analogy: [a]/əˈnælədʒi/; [n]比拟,比喻;类比;相似;类似; [or]6j;
analyst: [a]/ˈænəlɪst/; [n]分析员; [or]6j;
analytic(al): [a]/ˌænə'lɪtɪkl/; [adj]分析的;分解的; [or]6j;
analytic: [a]/ˌænəˈlɪtɪk/; [adj]分析的;分析法的; [or]6j;
analytical: [a]/ˌænəˈlɪtɪkl/; [adj]分析的;分析法的; [or]6j;
analyze: [a]/ˈænəlaɪz/; [v]分析;细察; [or]6j;
ancestor: [a]/ˈænsestər/; [n]祖宗;祖先;原型; [or]6j;
ancient: [a]/ˈeɪnʃənt/; [adj]远古的,古代的,古老的;  [n]古代人;古文明国的国民; [or]6j;
angel: [a]/ˈeɪndʒl/; [n]天使;可爱的人;善人,好人(感激某人时所说); [or]6j;
anniversary: [a]/ˌænɪˈvɜːrsəri/; [n]周年纪念日;  [adj]周年的,(有关)周年纪念的; [or]6j;
announcement: [a]/əˈnaʊnsmənt/; [n]宣告,发表,一项公告; [or]6j;
annoy: [a]/əˈnɔɪ/; [v]使烦恼,使生气;  [n]烦恼(等于annoyance); [or]6j;
annual: [a]/ˈænjuəl/; [adj]一年一次的,年度的;  [n]年鉴,一年生植物,一年一度的事件; [or]6j;
annually: [a]/ˈænjuəli/; [adv]一年一次;每年; [or]6j;
anode: [a]/ˈænoʊd/; [n](电)阳极,负极; [or]6j;
anonymous: [a]/əˈnɑːnɪməs/; [adj]匿名的;无名的;不具名的;无特色的;无个性特征; [or]6j;
antenna: [a]/ænˈtenə/; [n]天线,触角; [or]6j;
anticipate: [a]/ænˈtɪsɪpeɪt/; [v]预测;期待;提早(做); [or]6j;
antique: [a]/ænˈtiːk/; [n]古董;古玩;古物;  [adj]古代的;古董的; [or]6j;
anxiety: [a]/æŋˈzaɪəti/; [n]焦虑;忧虑;担心; [or]6j;
apartment: [a]/əˈpɑːrtmənt/; [n](美)公寓,一套房间; [or]6j;
apology: [a]/əˈpɑːlədʒi/; [n]道歉,(表达)歉意; [or]6j;
apparatus: [a]/ˌæpəˈrætəs/; [n]装置,仪器;设备;组织,机构; [or]6j;
appeal: [a]/əˈpiːl/; [vi]呼吁,请求;申诉;有吸引力;  [n]呼吁;恳求;(为慈善或好的事业所做的) 筹款努力;(人或物的)吸引力; [or]6j;
appearance: [a]/əˈpɪrəns/; [n]外貌,外表;到达,抵达;公开露面;出版,发表,刊登; [or]6j;
appease: [a]/əˈpiːz/; [v]抚慰;平息; [or]6j;
appendix: [a]/əˈpendɪks/; [n]附录;阑尾;附属物; [or]6j;
applaud: [a]/əˈplɔːd/; [v]鼓掌;  [vi]喝彩;  [vt]向.鼓掌表示赞赏;给.捧场; [or]6j;
appliance: [a]/əˈplaɪəns/; [n]家用器具;家用电器;装置;应用; [or]6j;
application: [a]/ˌæplɪˈkeɪʃn/; [n]运用;申请(书);应用程序; [or]6j;
apply: [a]/əˈplaɪ/; [v]涂,敷;应用;申请; [or]6j;
appraisal: [a]/əˈpreɪzl/; [n]评估;估价;评价; [or]6j;
appreciable: [a]/əˈpriːʃəbl/; [adj]很可观的;可感知的;可察觉的;可评估的; [or]6j;
appreciation: [a]/əˌpriːʃiˈeɪʃn/; [n]感激;欣赏,鉴识,评价;增值;理解,了解; [or]6j;
apprehension: [a]/ˌæprɪˈhenʃn/; [n]忧虑,担心,疑惧;逮捕;理解; [or]6j;
approach: [a]/əˈproʊtʃ/; [v]接近;靠近;着手处理;  [n]接近;途径;方法; [or]6j;
appropriate: [a]/əˈproʊpriət/; [adj]合适的;适当的;  [v]挪用;拨款;私占; [or]6j;
approve: [a]/əˈpruːv/; [v]称许,赞成,批准; [or]6j;
apt: [a]/æpt/; [adj]恰当的;有(做某事的)倾向; [or]6j;
arbitrary: [a]/ˈɑːrbətreri/; [adj]随意的,任性的,随心所欲的;霸道的,专制的,专横的;主观的,武断的; [or]6j;
arc: [a]/ɑːrk/; [n]弧形物,弧;弧光;电弧; [or]6j;
arch: [a]/ɑːrtʃ/; [n]拱洞;拱门;拱起;  [v]做成拱形;  [adj]调皮的,淘气的; [or]6j;
architect: [a]/ˈɑːrkɪtekt/; [n]设计师;建筑师; [or]6j;
arena: [a]/əˈriːnə/; [n]竞技场,角斗场;(活动,斗争或竞争的)场所,战场,(竞争)舞台; [or]6j;
argue: [a]/ˈɑːrɡjuː/; [v]争吵;主张,认为;提供.证据,提出证明;表明(原因等); [or]6j;
armor: [a]/ˈɑrmər/; [n]盔甲;装甲; [or]6j;
aroma: [a]/əˈroʊmə/; [n]芳香,香气; [or]6j;
arrange: [a]/əˈreɪndʒ/; [v]整理;改编(乐曲);筹备,安排;达成;达成协议;做安排; [or]6j;
arrangement: [a]/əˈreɪndʒmənt/; [n]布置;排列;组合体;整齐;调解;办法;协议;计划; [or]6j;
array: [a]/əˈreɪ/; [n]一系列;陈列;编队;  [v]排列;部署; [or]6j;
arrest: [a]/əˈrest/; [v]逮捕,拘留;吸引;  [n]逮捕,拘留; [or]6j;
arrogant: [a]/ˈærəɡənt/; [adj]傲慢的,妄自尊大的; [or]6j;
arson: [a]/ˈɑːrsn/; [n]<法律>纵火,纵火罪; [or]6j;
artery: [a]/ˈɑːrtəri/; [n]动脉;干线; [or]6j;
articulate: [a]/ɑːrˈtɪkjuleɪt/; [adj]善于表达的;发音清晰的;  [v]清晰地发音;清楚地讲话;连接,接合;与.合成整体 ,使相互连贯; [or]6j;
artificial: [a]/ˌɑːrtɪˈfɪʃl/; [adj]人造的,人工的,假的;假装的,虚伪的;  [n]人造肥料;<美>假花; [or]6j;
artillery: [a]/ɑːrˈtɪləri/; [n]大炮,炮兵; [or]6j;
ascend: [a]/əˈsend/; [v]沿着.上升,攀登; [or]6j;
ascertain: [a]/ˌæsərˈteɪn/; [v]探知,弄清,查明(真相等); [or]6j;
ascribe: [a]/əˈskraɪb/; [v]把.归因于;把.归属于; [or]6j;
ashore: [a]/əˈʃɔːr/; [adv]在岸上,上岸; [or]6j;
aspect: [a]/ˈæspekt/; [n]外表,面貌;(问题等的)方面; [or]6j;
aspiration: [a]/ˌæspəˈreɪʃn/; [n]抱负,志向;发 h 音; [or]6j;
aspire: [a]/əˈspaɪər/; [vi]渴望,有志于(与to,for,after连用或后接不定式); [or]6j;
assassination: [a]/əˌsæsəˈneɪʃn/; [n]暗杀; [or]6j;
assault: [a]/əˈsɔːlt/; [n]攻击,袭击;  [v]攻击,袭击,殴打; [or]6j;
assemble: [a]/əˈsembl/; [v]装配(机器等);集合;召集; [or]6j;
assert: [a]/əˈsɜːrt/; [v]断言;肯定地说;坚持;维护; [or]6j;
assess: [a]/əˈses/; [v]评估;估值; [or]6j;
assessment: [a]/əˈsesmənt/; [n]评估;评价;估价; [or]6j;
asset: [a]/ˈæset/; [n]财产,资产,有价值的东西或人; [or]6j;
assign: [a]/əˈsaɪn/; [v]布置;分配;指定;指派;归因;确定; [or]6j;
assignment: [a]/əˈsaɪnmənt/; [n]任务,(课外)作业;分配,委派; [or]6j;
assimilate: [a]/əˈsɪməleɪt/; [v]使同化;吸收;消化; [or]6j;
assistance: [a]/əˈsɪstəns/; [n]援助;帮助;补助; [or]6j;
associate: [a]/əˈsoʊʃieɪt/; [v]联想;联合;联系,交往;  [n]伙伴;同事;  [adj]副的; [or]6j;
association: [a]/əˌsəʊsiˈeɪʃn/; [n]结合;伙伴,关系;协会,联盟,社团;联想; [or]6j;
assume: [a]/əˈsuːm/; [v]猜想;以为,假设;呈现;就职;(想当然地)认为;承担(责任); [or]6j;
assumption: [a]/əˈsʌmpʃn/; [n]假定,设想;采取;承担; [or]6j;
assurance: [a]/əˈʃʊrəns/; [n]信心,自信;保证;保险; [or]6j;
assure: [a]/əˈʃʊr/; [v]向..保证,使确信;保证,确保; [or]6j;
astonishment: [a]/əˈstɑːnɪʃmənt/; [n]惊讶; [or]6j;
astronomer: [a]/əˈstrɑːnəmər/; [n]天文学家; [or]6j;
astronomy: [a]/əˈstrɑːnəmi/; [n]天文学; [or]6j;
athlete: [a]/ˈæθliːt/; [n]运动员,体育家,强壮的人; [or]6j;
atlas: [a]/ˈætləs/; [n]地图集; [or]6j;
atmosphere: [a]/ˈætməsfɪr/; [n]大气层;大气;空气;气氛; [or]6j;
attach: [a]/əˈtætʃ/; [v]系;贴;附上;附加;缚; [or]6j;
attachment: [a]/əˈtætʃmənt/; [n]依恋;(机器的,通过邮件发送的)附件;连接物; [or]6j;
attack: [a]/əˈtæk/; [n](病)发作,攻击;  [v]攻击,进攻,抨击;毁坏; [or]6j;
attain: [a]/əˈteɪn/; [v]获得;达到(某个年纪,水平,条件);实现;  [n]成就; [or]6j;
attempt: [a]/əˈtempt/; [n]尝试;企图;  [vt]努力去做;试图,尝试; [or]6j;
attendance: [a]/əˈtendəns/; [n]出席人数;出席;出席者;随员; [or]6j;
attendant: [a]/əˈtendənt/; [n]服务员,侍者,随从;  [adj]伴随的,随之而产生的; [or]6j;
attitude: [a]/ˈætɪtuːd/; [n]态度;看法;姿势; [or]6j;
attorney: [a]/əˈtɜːrni/; [n](辩护)律师; [or]6j;
attract: [a]/əˈtrækt/; [v]吸引,引诱; [or]6j;
attractive: [a]/əˈtræktɪv/; [adj]有魅力的;吸引人的;引起兴趣的; [or]6j;
auction: [a]/ˈɔːkʃn/; [n]拍卖;  [v]拍卖; [or]6j;
audible: [a]/ˈɔːdəbl/; [adj]听得见的; [or]6j;
audience: [a]/ˈɔːdiəns/; [n](演讲,音乐会等的)听众,观众;正式会见;拥护者; [or]6j;
audit: [a]/ˈɔːdɪt/; [v]审计,查账;旁听;  [n]审计;查帐; [or]6j;
auditorium: [a]/ˌɔːdɪˈtɔːriəm/; [n]〈美〉讲堂;听众席; [or]6j;
auditory: [a]/ˈɔːdətɔːri/; [adj]听觉的; [or]6j;
augment: [a]/ɔːɡˈment/; [v]增加;助长; [or]6j;
authentic: [a]/ɔːˈθentɪk/; [adj]真实的;真正的;可靠的; [or]6j;
author: [a]/ˈɔːθər/; [n]作者;发起人;  [v]成为作家; [or]6j;
authoritative: [a]/əˈθɔːrəteɪtɪv/; [adj]权威性的;可信的;命令式的,专断的; [or]6j;
authority: [a]/əˈθɔːrəti/; [n]权威;威信;当局,官方;权力,职权; [or]6j;
authorize: [a]/ˈɔːθəraɪz/; [v]批准;授权; [or]6j;
automated: [a]/ˈɔtəˌmeɪtəd/; [adj]机械化的;自动化的; [or]6j;
automation: [a]/ˌɔːtəˈmeɪʃn/; [n]自动化; [or]6j;
autonomous: [a]/ɔːˈtɑːnəməs/; [adj]自动驾驶的;自治的,独立自主的;自主的; [or]6j;
autonomy: [a]/ɔːˈtɑːnəmi/; [n]人身自由;自治;自治权; [or]6j;
availability: [a]/əˌveɪləˈbɪləti/; [n]可得到的人(或物);可用性; [or]6j;
available: [a]/əˈveɪləbl/; [adj]可得到的,可利用的,有空的,有效的; [or]6j;
avert: [a]/əˈvɜːrt/; [v]转移(目光,注意力等);防止;避开; [or]6j;
aviation: [a]/ˌeɪviˈeɪʃn/; [n]航空,航空学;飞机制造业; [or]6j;
avoid: [a]/əˈvɔɪd/; [v]躲开,避开;避免,防止; [or]6j;
award: [a]/əˈwɔːrd/; [n]奖品;奖学金;判决;  [vt]授予;给予; [or]6j;
aware: [a]/əˈwer/; [adj]意识到的,知道的; [or]6j;
awkward: [a]/ˈɔːkwərd/; [adj]尴尬的;笨拙的;棘手的;不雅观的;不方便的;困难的,危险的; [or]6j;
axis: [a]/ˈæksɪs/; [n]轴;中心线;坐标轴;基准线; [or]6j;
bachelor: [a]/ˈbætʃələr/; [n]单身汉;学士学位; [or]6j;
background: [a]/ˈbækɡraʊnd/; [n]图片背景,底色;出身;背景;时代背景; [or]6j;
bacteria: [a]/bækˈtɪriə/; [n]细菌(复数); [or]6j;
bacterium: [a]/bæk'tɪriəm/; [n]细菌; [or]6j;
badge: [a]/bædʒ/; [n]徽章;象征;标记;  [vt]给予.标记;授予.徽章; [or]6j;
baffle: [a]/ˈbæfl/; [v]使困惑;难住;阻碍;  [n]挡板; [or]6j;
bald: [a]/bɔːld/; [adj]秃头的; [or]6j;
ballet: [a]/bæˈleɪ/; [n]芭蕾舞,芭蕾舞剧;芭蕾舞团; [or]6j;
bamboo: [a]/ˌbæmˈbuː/; [n]竹,竹子; [or]6j;
ban: [a]/bæn/; [vt]禁止;查禁;  [n]禁止,禁令; [or]6j;
band: [a]/bænd/; [n]乐队;帮伙;带;  [v]用带捆扎;联合; [or]6j;
bandage: [a]/ˈbændɪdʒ/; [n]绷带;  [v]用绷带绑扎; [or]6j;
bandit: [a]/ˈbændɪt/; [n]强盗,土匪; [or]6j;
bang: [a]/bæŋ/; [n]巨响;重击;刘海;  [adv]准确地,完全地;  [v]发出砰的一声;重击;猛敲;砰地关上; [or]6j;
bankrupt: [a]/ˈbæŋkrʌpt/; [adj]破产的;彻底失败的;彻底缺乏的;  [n]破产者;  [v]使破产;使枯竭; [or]6j;
banquet: [a]/ˈbæŋkwɪt/; [n](正式的)宴会;盛宴;  [adj]宴会的; [or]6j;
barely: [a]/ˈberli/; [adv]几乎不;仅仅;只不过; [or]6j;
bargain: [a]/ˈbɑːrɡən/; [n]交易,特价商品;便宜货;契约;  [vi]讨价还价,讲价;成交;  [vt]经讨价还价成交;用.交换;  [adj](价格),低廉的; [or]6j;
barge: [a]/bɑːrdʒ/; [n]平底货船,驳船;  [v]猛撞; [or]6j;
barley: [a]/ˈbɑːrli/; [n]大麦; [or]6j;
barometer: [a]/bəˈrɑːmɪtər/; [n]晴雨表;气压表; [or]6j;
baron: [a]/ˈbærən/; [n]男爵(英国世袭的最低级的贵族爵位),大财主; [or]6j;
barren: [a]/ˈbærən/; [adj]贫瘠的,不孕的;  [n]荒原,不毛之地; [or]6j;
barricade: [a]/ˌbærɪˈkeɪd/; [n]路障;障碍物;栅栏;  [v]设路障;挡住; [or]6j;
barrier: [a]/ˈbæriər/; [n]障碍;屏障;隔阂;壁垒;  [v]用栅栏围住; [or]6j;
basement: [a]/ˈbeɪsmənt/; [n]<建筑学>地下室;根基; [or]6j;
basis: [a]/ˈbeɪsɪs/; [n]基础,根据;原因,缘由;基准; [or]6j;
batch: [a]/bætʃ/; [n]一批(人或物);一批生产量; [or]6j;
batter: [a]/ˈbætər/; [n](用鸡蛋,牛奶等调制的)面糊;  [v]连续猛击; [or]6j;
bazaar: [a]/bəˈzɑːr/; [n]集市,商店集中区; [or]6j;
bead: [a]/biːd/; [n]珠子;水珠; [or]6j;
beam: [a]/biːm/; [n]光线;(房屋等)大梁;(横)梁;  [v]发光;照射;发射,播送;微笑;用梁支撑; [or]6j;
bearing: [a]/ˈberɪŋ/; [n]方向;举止;轴承; [or]6j;
beetle: [a]/ˈbiːtl/; [n]甲虫;  [v]快速移动; [or]6j;
behave: [a]/bɪˈheɪv/; [v]举动;举止端正(或良好,适当); [or]6j;
behavior: [a]/bɪ'heɪvjə/; [n]行为;举止;态度; [or]6j;
belly: [a]/ˈbeli/; [n]圆形或凸起部分;肚子; [or]6j;
beneficial: [a]/ˌbenɪˈfɪʃl/; [adj]有益的,有利的; [or]6j;
benefit: [a]/ˈbenɪfɪt/; [v]受益,有助于,使受益;  [n]好处,益处;救济金; [or]6j;
benevolent: [a]/bəˈnevələnt/; [adj]慈爱的,仁慈的;乐善好施的;慈善的; [or]6j;
benign: [a]/bɪˈnaɪn/; [adj]仁慈的;慈祥的;(病)良性的; [or]6j;
bestow: [a]/bɪˈstoʊ/; [v]给予; [or]6j;
betray: [a]/bɪˈtreɪ/; [v]背叛;失信于;泄露(秘密等);(非故意地)暴露; [or]6j;
betrayal: [a]/bɪˈtreɪəl/; [n]背叛;辜负;暴露; [or]6j;
beware: [a]/bɪˈwer/; [v]当心,谨防; [or]6j;
bewilder: [a]/bɪˈwɪldər/; [v]使不知所措;使迷惑;使变糊涂,弄糊涂; [or]6j;
beyond: [a]/bɪˈjɑːnd/; [adv]更远处,更多,以后;  prep. 超过;在能力,理解力之外;除..之外; [or]6j;
bias: [a]/ˈbaɪəs/; [n]倾斜;偏心;偏见;  [v]使有偏见; [or]6j;
bibliography: [a]/ˌbɪbliˈɑːɡrəfi/; [n]参考书目;文献学; [or]6j;
bid: [a]/bɪd/; [n]出价;投标;努力争取;  [v]出价;投标;问候;道别;吩咐; [or]6j;
biography: [a]/baɪˈɑːɡrəfi/; [n]传记文学,传记; [or]6j;
bishop: [a]/ˈbɪʃəp/; [n]主教; [or]6j;
bitterness: [a]/ˈbɪtərnəs/; [n]苦味;辛酸;苦难; [or]6j;
bizarre: [a]/bɪˈzɑːr/; [adj]稀奇古怪的; [or]6j;
blacksmith: [a]/ˈblæksmɪθ/; [n]锻工;铁匠; [or]6j;
blank: [a]/blæŋk/; [adj](纸等)空白的,茫然的;  [n]空白,空白处;  [v]忽视; [or]6j;
blaze: [a]/bleɪz/; [vi]熊熊燃烧;闪耀;怒视;连续射击;  [vt]大肆宣扬;  [n]火焰; [or]6j;
bleach: [a]/bliːtʃ/; [v]漂白;  [n]漂白剂; [or]6j;
bleak: [a]/bliːk/; [adj]凄凉的;萧瑟的;阴郁的;无希望的; [or]6j;
bleed: [a]/bliːd/; [vi]流血;散开;  [vt]榨取,敲诈;使流血;使..排出液体;  [n]出血;  [adj]<印>出血版的; [or]6j;
bless: [a]/bles/; [v]保佑,祝福,赐福,有幸具有; [or]6j;
blink: [a]/blɪŋk/; [v]眨眼睛;闪亮;闪烁;  [n]眨眼睛; [or]6j;
blond: [a]/blɑnd/; [adj]金色的,亚麻色的(头发);白皙的,金发碧眼的(人); [or]6j;
blossom: [a]/ˈblɑːsəm/; [v]开花,兴旺,长成;  [n](果树的)花; [or]6j;
blunder: [a]/ˈblʌndər/; [n]愚蠢之举;大错;  [vi]犯大错;  [v]失策;绊倒; [or]6j;
blunt: [a]/blʌnt/; [adj]钝的;直率的;  [v]使情感,感觉,需求减弱;变钝; [or]6j;
blur: [a]/blɜːr/; [n]污点,模糊;  [v]使.模糊;弄脏;变模糊; [or]6j;
blush: [a]/blʌʃ/; [v]脸红;害臊;  [n]脸红; [or]6j;
boiler: [a]/ˈbɔɪlər/; [n]热水器,锅炉; [or]6j;
bonus: [a]/ˈboʊnəs/; [n]奖金,额外津贴; [or]6j;
booklet: [a]/ˈbʊklət/; [n]小册子; [or]6j;
boom: [a]/buːm/; [n]隆隆声;繁荣;景气;激增;  [v]发出低沉有回响的声音;迅速发展,蓬勃发展;以低沉有回响的声音发出; [or]6j;
boost: [a]/buːst/; [v]增加;偷盗;  [n]提高;激励;后推;助推发动机; [or]6j;
booth: [a]/buːθ/; [n]小舍;隔开的小间;公用电话亭;有篷的售货摊;窝棚; [or]6j;
border: [a]/ˈbɔːrdər/; [n]边界;花坛;滚边,边沿,包边;  [v]近似;毗邻;与..接壤;为..镶边; [or]6j;
boring: [a]/ˈbɔːrɪŋ/; [adj]令人厌烦的;单调的;无聊的,乏味的; [or]6j;
bounce: [a]/baʊns/; [vi]弹起,蹦跳;  [vt]使弹起;  [v]拒付 (支票);  [n]弹跳,弹力,活力; [or]6j;
bound: [a]/baʊnd/; [adj]受约束的;有义务的;一定的;  [v]束缚;跳跃着前行;  [n]跳跃;范围;界限; [or]6j;
bourgeois: [a]/ˌbʊrˈʒwɑː/; [n]中产阶级;资产阶级;  [adj]中产阶级的; [or]6j;
bowel: [a]/ˈbaʊəl/; [n]肠;内部; [or]6j;
boycott: [a]/ˈbɔɪkɑːt/; [vt]抵制;  [n]抵制; [or]6j;
brace: [a]/breɪs/; [n]<医学>牙齿定位器;  [v]支柱;支撑;加固;使绷紧; [or]6j;
bracket: [a]/ˈbrækɪt/; [n]括号;(年龄,收入等的)等级段,档次;壁架,支架;  [v]把.置于括号内;把.归入同一类; [or]6j;
brand: [a]/brænd/; [n]商标,品牌;烙印;  [v]给..打上烙印;归为 (不好的事物); [or]6j;
breach: [a]/briːtʃ/; [n]破裂;裂痕;冲击;违反;  [v]使有裂口;破坏; [or]6j;
breakdown: [a]/ˈbreɪkdaʊn/; [n]损坏;故障;分类,明细;倒塌,崩溃;衰退; [or]6j;
breakthrough: [a]/ˈbreɪkθruː/; [n]突破,突破性进展,重要的新发现;  [adj]突破性的; [or]6j;
breed: [a]/briːd/; [n]血统;种类;  [v]产仔;繁殖;使繁殖; [or]6j;
brew: [a]/bruː/; [v]调制;酿造;冲泡 (茶,咖啡等);酝酿;筹划;  [n]酝酿的饮料;啤酒; [or]6j;
bribe: [a]/braɪb/; [v]向.行贿;买通;  [n]贿赂;行贿物; [or]6j;
bridegroom: [a]/ˈbraɪdɡruːm/; [n]新郎; [or]6j;
bridle: [a]/ˈbraɪdl/; [n]马笼头,缰绳;  [v]上笼头;昂首(表傲慢,愤怒等);抑制,控制; [or]6j;
brief: [a]/briːf/; [adj]简短的,扼要的,短暂的,短时间的;  [n]摘要,概要,简短声明,诉讼要点;职责;  [v]作.的摘要,向.通报情况; [or]6j;
briefcase: [a]/ˈbriːfkeɪs/; [n]公文包; [or]6j;
brightness: [a]/ˈbraɪtnəs/; [n]明亮;聪明,智慧;<光>亮度; [or]6j;
brilliant: [a]/ˈbrɪliənt/; [adj]聪颖的;卓越的,有才气的;明亮的; [or]6j;
brink: [a]/brɪŋk/; [n](尤指崖边)边缘; [or]6j;
brisk: [a]/brɪsk/; [adj]轻快的;活跃的;寒冷而清新的; [or]6j;
brittle: [a]/ˈbrɪtl/; [adj]易碎的;脆弱的;靠不住的;  [n]薄片脆糖; [or]6j;
brood: [a]/bruːd/; [n]一窝,同窝幼崽;  [vi]冥思苦想;  [vt]孵;默想;  [adj]传种用的;(母鸡等)抱窝的;(昆虫等)产卵的; [or]6j;
browse: [a]/braʊz/; [v]浏览;随意翻阅;(牛,羊等)吃草; [or]6j;
bruise: [a]/bruːz/; [n](人体组织或表皮等跌,碰撞后产生的)青肿,挫伤;碰伤;  [v]撞伤,碰伤,(使)挫伤,擦伤(表皮,表面);打击;擦伤; [or]6j;
brutal: [a]/ˈbruːtl/; [adj]残忍的,粗鲁的;严酷的,难以忍受的;严峻的; [or]6j;
buck: [a]/bʌk/; [n]雄鹿;年轻男士;美元;  [v]反对;马弓背踢后腿挑起; [or]6j;
bud: [a]/bʌd/; [n]蓓蕾,芽;  [v]使发芽; [or]6j;
budge: [a]/bʌdʒ/; [v]移动一点;妥协; [or]6j;
budget: [a]/ˈbʌdʒɪt/; [n]预算;  [v]预算,安排;  [adj]廉价的; [or]6j;
buffer: [a]/ˈbʌfər/; [n]缓冲,缓冲区;  [v]缓冲; [or]6j;
bug: [a]/bʌɡ/; [n]<计算机>(制作软件程序所产生的意料不到的)错误,故障;窃听器;热衷于(某事)者;臭虫,小虫子;  [v]使厌烦,打扰;窃听;  [vt]使烦恼,纠缠; [or]6j;
bugle: [a]/ˈbjuːɡl/; [n]军号,喇叭;  [vi]吹号;  [vt]吹冲锋号; [or]6j;
bulk: [a]/bʌlk/; [n]大批;容量;体积;大块;  [adj]大量的;散装的;  [v]膨胀;显得重要; [or]6j;
bull: [a]/bʊl/; [n]公牛,雄性的鲸,象等大动物; [or]6j;
bulletin: [a]/ˈbʊlətɪn/; [n]公告;公报;公告牌; [or]6j;
bully: [a]/ˈbʊli/; [n]恃强欺弱者;  [v]欺负; [or]6j;
bump: [a]/bʌmp/; [n]隆起物;撞击;(碰撞造成的)肿块;  [v]撞击;颠簸地行驶;凹凸不平;除名,撵走; [or]6j;
bunch: [a]/bʌntʃ/; [n]束;串;群,伙;  [v]集中,挤在一起;使成一束(或一群等); [or]6j;
burden: [a]/ˈbɜːrdn/; [n]负担,重担;  [v]使负重,装载;烦扰; [or]6j;
bureaucracy: [a]/bjʊˈrɑːkrəsi/; [n]官僚主义;政府机构; [or]6j;
burglar: [a]/ˈbɜːrɡlər/; [n]窃贼; [or]6j;
burial: [a]/ˈberiəl/; [n]埋葬,葬礼;掩埋; [or]6j;
burner: [a]/ˈbɜːrnər/; [n]火炉;燃烧嘴;烧火的人; [or]6j;
bushel: [a]/ˈbʊʃl/; [n](pl.)大量;蒲式耳(容量等于八加仑); [or]6j;
bust: [a]/bʌst/; [n]半身塑像;胸部;  [v]打碎;搜捕;降级;终止;  [adj]破产的;打碎的; [or]6j;
butt: [a]/bʌt/; [n]底部,屁股;  [v](人)用头顶撞;(动物)用头(或角)顶;  [adv]猛撞;用头撞; [or]6j;
buzz: [a]/bʌz/; [v]发出嗡嗡声;  [n]嗡嗡声;低沉嘈杂的谈话声; [or]6j;
bypass: [a]/ˈbaɪpæs/; [v]绕过;回避;  [n]旁路;心脏分流手术; [or]6j;
cabin: [a]/ˈkæbɪn/; [n](简陋的)小屋;船舱;客舱,机舱;  [v]住在小屋里; [or]6j;
cabinet: [a]/ˈkæbɪnət/; [n]橱;柜;内阁; [or]6j;
cable: [a]/ˈkeɪbl/; [n]电缆,缆,索;  [v]拍电报; [or]6j;
cafeteria: [a]/ˌkæfəˈtɪriə/; [n]自助食堂;自助餐馆; [or]6j;
calcium: [a]/ˈkælsiəm/; [n]钙; [or]6j;
calculus: [a]/ˈkælkjələs/; [n](数)微积分学; [or]6j;
calibration: [a]/ˌkælɪˈbreɪʃn/; [n]校准刻度;校正;口径测定; [or]6j;
calorie: [a]/ˈkæləri/; [n]卡(热量单位); [or]6j;
cancel: [a]/ˈkænsl/; [v]取消;撤消;删去; [or]6j;
cancer: [a]/ˈkænsər/; [n]癌,癌症;迅速蔓延的恶劣的或危险的事物; [or]6j;
candidate: [a]/ˈkændɪdət/; [n](官职,获奖资格等的)候选人;投考人;申请求职者; [or]6j;
cane: [a]/keɪn/; [n]手杖;茎;藤条;甘蔗; [or]6j;
cannon: [a]/ˈkænən/; [n]大炮;机关炮;  [v]相撞;开炮; [or]6j;
canteen: [a]/kænˈtiːn/; [n]食堂,小卖部;水壶; [or]6j;
canvas: [a]/ˈkænvəs/; [n]帆布,(帆布)油画; [or]6j;
capability: [a]/ˌkeɪpəˈbɪləti/; [n](实际)能力,性能,容量,接受力; [or]6j;
capable: [a]/ˈkeɪpəbl/; [adj]有本领的,有能力的;有才能的,能干的; [or]6j;
capacitor: [a]/kəˈpæsɪtər/; [n]电容器; [or]6j;
capacity: [a]/kəˈpæsəti/; [n]产能;容量;本领;才能;负载量;职位; [or]6j;
cape: [a]/keɪp/; [n]斗篷;披肩;岬,海岬,海角; [or]6j;
capsule: [a]/ˈkæpsl/; [n]胶囊;航天舱,密封舱; [or]6j;
caption: [a]/ˈkæpʃn/; [n](报刊的)标题;(插图,照片等的)说明文字;  [v]给(图片,照片等)加说明文字; [or]6j;
captive: [a]/ˈkæptɪv/; [adj]被捕获的;被俘虏的;  [n]俘虏; [or]6j;
cardinal: [a]/ˈkɑːrdɪnl/; [adj]主要的;基本的;  [n]<天主教>枢机主教,红衣主教;基数; [or]6j;
cartoon: [a]/kɑːrˈtuːn/; [n]卡通(片),动画片;(尤指报刊上讽刺政客或时事的)漫画,幽默画; [or]6j;
cartridge: [a]/ˈkɑːrtrɪdʒ/; [n]墨盒;弹药筒,弹药;墨水,笔芯; [or]6j;
carve: [a]/kɑːrv/; [v]雕刻;(把肉等)切成片;开创,开拓; [or]6j;
cast: [a]/kæst/; [v]投;抛下,投射(光线和阴影);瞥,飞快看(一眼),扫视;掷;放钓;投票;选定演员;  [n]投掷物;铸件;演员表,演员阵容; [or]6j;
casual: [a]/ˈkæʒuəl/; [adj]偶然的;临时的;随便的;  [n]临时工;便服; [or]6j;
casualty: [a]/ˈkæʒuəlti/; [n]伤亡人员,死伤者,受害人;急诊室(英); [or]6j;
catalyst: [a]/ˈkætəlɪst/; [n]催化剂;造成变化的人或事; [or]6j;
catastrophe: [a]/kəˈtæstrəfi/; [n]大灾难; [or]6j;
category: [a]/ˈkætəɡɔːri/; [n]类别;范畴; [or]6j;
cater: [a]/ˈkeɪtər/; [v]供应伙食;为(集会,婚礼等)承办酒席; [or]6j;
cathedral: [a]/kəˈθiːdrəl/; [n]大教堂;  [adj]有权威的;大教堂的; [or]6j;
caution: [a]/ˈkɔːʃn/; [n]小心;警告;告诫;  [v]劝.谨慎小心;警告; [or]6j;
cautious: [a]/ˈkɔːʃəs/; [adj]小心的,谨慎的; [or]6j;
cavity: [a]/ˈkævəti/; [n]洞;龋洞; [or]6j;
cellar: [a]/ˈselər/; [n]地窖;地下室;酒窖; [or]6j;
cemetery: [a]/ˈseməteri/; [n]公墓;墓地; [or]6j;
census: [a]/ˈsensəs/; [n]人口普查,人口调查;统计;  [v]调查(某地区等的)人口数字;统计.的数字; [or]6j;
cereal: [a]/ˈsɪriəl/; [n]谷物;谷类食物;谷类食品;  [adj]谷类的;谷类制成的; [or]6j;
certainty: [a]/ˈsɜːrtnti/; [n]必然;确信;必然的事; [or]6j;
certify: [a]/ˈsɜːrtɪfaɪ/; [v](发给证书)证明;证实; [or]6j;
challenge: [a]/ˈtʃælɪndʒ/; [n]挑战;质疑;  [v]挑战;质疑; [or]6j;
champagne: [a]/ʃæmˈpeɪn/; [n]香槟酒; [or]6j;
champion: [a]/ˈtʃæmpiən/; [n]冠军;拥护者,战士;  [v]拥护;保卫;为..而斗争;  [adj]夺得第一名的;优胜的; [or]6j;
chant: [a]/tʃænt/; [v]吟唱;诵扬;  [n]圣歌;赞美诗;旋律; [or]6j;
chaos: [a]/ˈkeɪɑːs/; [n]混沌;混乱,纷乱; [or]6j;
chapel: [a]/ˈtʃæpl/; [n]小教堂;私人祈祷室; [or]6j;
character: [a]/ˈkærəktər/; [n]人物,角色;性格;(书写或印刷)符号,(汉)字;特点;人格,品性; [or]6j;
characteristic: [a]/ˌkærəktəˈrɪstɪk/; [n]特点;特性;特色;  [adj]典型的;特有的;独特的; [or]6j;
characterize: [a]/ˈkærəktəraɪz/; [v]表示..的特性;描述..特性; [or]6j;
charcoal: [a]/ˈtʃɑːrkoʊl/; [n]木炭; [or]6j;
charge: [a]/tʃɑːrdʒ/; [v]充电,充值;索价;控告;向.冲去;  [n]费用;主管;控告; [or]6j;
charity: [a]/ˈtʃærəti/; [n]慈善团体;慈善;仁慈;施舍; [or]6j;
charm: [a]/tʃɑːrm/; [n]魅力,吸引力,符咒;  [v](使)着迷,施魔法; [or]6j;
charter: [a]/ˈtʃɑːrtər/; [n]宪章;特权,豁免权;契约,证书;租赁;  [v]包,租(飞机,汽车等);  [adj]包租的,租用的; [or]6j;
chase: [a]/tʃeɪs/; [v]追赶;驱逐;追求;  [n]追逐;追求; [or]6j;
chat: [a]/tʃæt/; [v]闲谈,聊天;  [n]闲谈,聊天; [or]6j;
chatter: [a]/ˈtʃætər/; [n]喋喋不休;吱吱声;啁啾声;  [vi]吱吱叫;唠叨;(使)打颤,打战,发颤;喋喋不休地说; [or]6j;
cherish: [a]/ˈtʃerɪʃ/; [v]珍爱,珍视;抱有(希望); [or]6j;
chestnut: [a]/ˈtʃesnʌt/; [n]栗子,栗树;  [adj]栗色的; [or]6j;
chief: [a]/tʃiːf/; [n]老板,头子;主管;(部落) 首领;酋长;长官;  [adj]主要的;首席的; [or]6j;
chip: [a]/tʃɪp/; [n]木屑,碎片;缺口;圆形筹码;芯片;炸薯条,炸薯片;  [v]碎裂;削,凿;将.削成,凿成; [or]6j;
cholesterol: [a]/kəˈlestərɔːl/; [n]胆固醇; [or]6j;
chord: [a]/kɔːrd/; [n]和弦;和音;心弦;(数学)弦; [or]6j;
chorus: [a]/ˈkɔːrəs/; [n]副歌部分;合唱团;合唱曲,合唱句;  [v]合唱,齐声说;齐声说; [or]6j;
chronic: [a]/ˈkrɑːnɪk/; [adj](疾病)慢性的;长期的;(人)久病的;积习难改的;严重的; [or]6j;
chuck: [a]/tʃʌk/; [v]轻轻地扔;抛;丢弃; [or]6j;
chunk: [a]/tʃʌŋk/; [n]大块;矮而厚的木块;大量; [or]6j;
circulation: [a]/ˌsɜːrkjəˈleɪʃn/; [n]流传,传播;发行,发行量;(体液的)循环;(水,空气等的)流通;(货币等的)流通; [or]6j;
circumstance: [a]/ˈsɜːrkəmstæns/; [n]条件;情况;命运;客观环境; [or]6j;
circus: [a]/ˈsɜːrkəs/; [n]马戏团;杂技团;环形广场;闹剧(表示不满); [or]6j;
cite: [a]/saɪt/; [v]引用,引证;传唤,传讯;表彰,嘉奖; [or]6j;
civilian: [a]/səˈvɪliən/; [n]平民,百姓;  [adj]平民的,百姓的,民用的; [or]6j;
claim: [a]/kleɪm/; [v]声称;要求;断言;主张;认领;索赔;  [n]索赔;主张;声称;断言;要求; [or]6j;
clan: [a]/klæn/; [n]家族;氏族;部落;宗派;亲族; [or]6j;
clarity: [a]/ˈklærəti/; [n]清楚;清澈; [or]6j;
clash: [a]/klæʃ/; [vi]发生冲突;发出撞击声;不合,不一致,不调和;  [n]冲突;抵触;撞击声; [or]6j;
clasp: [a]/klæsp/; [v]握紧;扣紧;扣住;抱紧;  [n]扣子;钩子;紧抱;紧握; [or]6j;
classic: [a]/ˈklæsɪk/; [adj]经典的;古典的;高雅的;一流的;  [n]经典著作;文豪;优秀典范; [or]6j;
classical: [a]/ˈklæsɪkl/; [adj]古典的;传统的;正统的;权威的;  [n]古典音乐; [or]6j;
classification: [a]/ˌklæsɪfɪˈkeɪʃn/; [n]分类,归类;(动植物等的)分类学; [or]6j;
clatter: [a]/ˈklætər/; [n]咔嗒;哗啦声;嘈杂的谈笑声;  [v]发出哗啦声;喧闹的谈笑; [or]6j;
clause: [a]/klɔːz/; [n]条款;从句; [or]6j;
cleanliness: [a]/ˈklenlinəs/; [n]清洁;洁癖; [or]6j;
clearance: [a]/ˈklɪrəns/; [n]清除;清理;清空;许可; [or]6j;
clearing: [a]/ˈklɪrɪŋ/; [n]清除,清洁;空旷地; [or]6j;
clerk: [a]/klɜːrk/; [n]店员;职员;办事员;  [vi]当职员; [or]6j;
client: [a]/ˈklaɪənt/; [n]委托人,当事人,主顾,客户;客户端; [or]6j;
cliff: [a]/klɪf/; [n]悬崖;峭壁; [or]6j;
climate: [a]/ˈklaɪmət/; [n]气候;(社会思想等)趋势; [or]6j;
climax: [a]/ˈklaɪmæks/; [n]高潮,最令人兴奋(或感兴趣)的部分;  [v](使)达到顶点,(使)达到高潮; [or]6j;
cling: [a]/klɪŋ/; [v]紧紧抓住;黏着,挨近;依恋,依附;坚持,墨守,忠实于; [or]6j;
clinic: [a]/ˈklɪnɪk/; [n]诊所;门诊(部,室); [or]6j;
clinical: [a]/ˈklɪnɪkl/; [adj]临床的;冷静的; [or]6j;
clip: [a]/klɪp/; [n]回形针,夹子;(电影,广播,电视节目的)片段;  [v]夹住;删剪;剪辑; [or]6j;
cloak: [a]/kloʊk/; [n]斗篷,披风;覆盖物;  [vt]给.披斗篷;掩饰; [or]6j;
clockwise: [a]/ˈklɑːkwaɪz/; [adj]顺时针方向的;  [adv]顺时针方向地; [or]6j;
clone: [a]/kloʊn/; [n]克隆;无性繁殖系个体;复制品;  [v]复制;克隆; [or]6j;
closet: [a]/ˈklɑːzət/; [n]橱,壁橱,小储藏室;  [v]把.引进密室会谈;  [adj]私下的,秘密的; [or]6j;
clown: [a]/klaʊn/; [n]小丑,粗鲁愚蠢的人; [or]6j;
clue: [a]/kluː/; [n]线索;提示;暗示;  [vt]为..提供线索; [or]6j;
cluster: [a]/ˈklʌstər/; [n]一串;一簇;  [v]群集;丛生; [or]6j;
clutch: [a]/klʌtʃ/; [v]抓住;紧握;  [n]抓住;离合器; [or]6j;
coalition: [a]/ˌkoʊəˈlɪʃn/; [n]结合;联盟;联合; [or]6j;
coarse: [a]/kɔːrs/; [adj]粗糙的;粗俗的;粗鲁的; [or]6j;
cocaine: [a]/koʊˈkeɪn/; [n]可卡因,古柯碱; [or]6j;
cocktail: [a]/ˈkɑːkteɪl/; [n]鸡尾酒;餐前开胃小吃;混合物; [or]6j;
coffin: [a]/ˈkɔːfɪn/; [n]棺材; [or]6j;
cognitive: [a]/ˈkɑːɡnətɪv/; [adj]认识能力的;认知的; [or]6j;
coherent: [a]/koʊˈhɪrənt/; [adj]协调一致的;条理清楚的,有条理的;连贯的;有黏性的,黏合在一起的,粘着的; [or]6j;
coincide: [a]/ˌkoʊɪnˈsaɪd/; [v]巧合,一致,相符; [or]6j;
coincidence: [a]/koʊˈɪnsɪdəns/; [n]一致;巧合,巧事;同时发生; [or]6j;
coke: [a]/koʊk/; [n]可乐;焦炭; [or]6j;
collaborate: [a]/kəˈlæbəreɪt/; [v]合作; [or]6j;
collaboration: [a]/kəˌlæbəˈreɪʃn/; [n]合作,协作;勾结; [or]6j;
collapse: [a]/kəˈlæps/; [v](使)倒塌,(使)崩溃,(使)瓦解;  [n]倒塌,崩溃,暴跌; [or]6j;
colleague: [a]/ˈkɑːliːɡ/; [n]同事;同行; [or]6j;
collide: [a]/kəˈlaɪd/; [vi]碰撞;互撞;抵触; [or]6j;
collision: [a]/kəˈlɪʒn/; [n]碰撞;冲突; [or]6j;
colonial: [a]/kəˈloʊniəl/; [adj]殖民地的,关于殖民的;  [n]殖民地居民; [or]6j;
combat: [a]/ˈkɑːmbæt/; [n]战斗,格斗;  [v]与.战斗,与.斗争;  [adj]战斗的; [or]6j;
combination: [a]/ˌkɑːmbɪˈneɪʃn/; [n]结合,联合,组合;(保险锁等的)暗码; [or]6j;
combine: [a]/kəmˈbaɪn/; [v]使混合(结合,组合,联合);结合;联合;组合;  [n]联合体,联合企业;联合收割机; [or]6j;
combustion: [a]/kəmˈbʌstʃən/; [n]燃烧; [or]6j;
comedy: [a]/ˈkɑːmədi/; [n]喜剧,有趣的事情; [or]6j;
comet: [a]/ˈkɑːmət/; [n]彗星; [or]6j;
comic: [a]/ˈkɑːmɪk/; [adj]滑稽的,喜剧的,漫画的;  [n]连环漫画杂志;喜剧演员; [or]6j;
command: [a]/kəˈmænd/; [n]命令,指挥;  [v]发布命令,指挥;掌管,控制;指挥,命令;控制,管理; [or]6j;
commemorate: [a]/kəˈmeməreɪt/; [v]纪念,庆祝; [or]6j;
commence: [a]/kəˈmens/; [v]开始; [or]6j;
commend: [a]/kəˈmend/; [v]称赞;推荐;委托保管; [or]6j;
commentary: [a]/ˈkɑːmənteri/; [n]评述;评论,评论文章;(广播员对球赛等的)实况报道,(电影的)解说词; [or]6j;
commercial: [a]/kəˈmɜːrʃl/; [adj]商业性的,贸易的;  [n]商业广告; [or]6j;
commission: [a]/kəˈmɪʃn/; [n]委员会;任务;权限;委任;销售佣金;  [v]委任; [or]6j;
commit: [a]/kəˈmɪt/; [v]犯(罪);进行 (自杀);调拨 (钱,资源);监禁;送交 (到精神病院,监狱等);承诺,保证; [or]6j;
commitment: [a]/kəˈmɪtmənt/; [n]承诺;许诺;委任;承担的义务;献身;赞助;委托;犯罪;罪行;信奉; [or]6j;
committee: [a]/kəˈmɪti/; [n]委员会;全体委员; [or]6j;
commodity: [a]/kəˈmɑːdəti/; [n]商品,货物; [or]6j;
commonsense: [a]/ˌkɑːmən ˈsens/; [adj]常识的;  [n]常识; [or]6j;
commonwealth: [a]/ˈkɑːmənwelθ/; [n]联邦; [or]6j;
communicate: [a]/kəˈmjuːnɪkeɪt/; [v]沟通,交流;传达,传递;传染;相连,相通;显露; [or]6j;
communication: [a]/kəˌmjuːnɪˈkeɪʃn/; [n]沟通方式;交流,通讯;信息; [or]6j;
community: [a]/kəˈmjuːnəti/; [n]社区;团体;(生)群落;人群,很多个体的集合体; [or]6j;
commute: [a]/kəˈmjuːt/; [n]在两地之间乘车往返;  [v]经常乘车往返于两地之间;  [vt]减免; [or]6j;
compact: [a]/ˈkɑːmpækt/; [adj]小巧的,小型的,袖珍的,体积小的;紧密的,紧凑的,密集的;  [v]把..压紧;变得坚实;  [n]带镜小粉盒;合约,条约; [or]6j;
compactness: [a]/kəmˈpæktnəs/; [n]紧密;小巧;紧凑; [or]6j;
companion: [a]/kəmˈpæniən/; [n]同伴,志同道合的人;参考书; [or]6j;
comparable: [a]/ˈkɑːmpərəbl/; [adj]类似的,比得上的,可比较的; [or]6j;
compare: [a]/kəmˈper/; [v]比较,比作;  [n]比较;对照; [or]6j;
comparison: [a]/kəmˈpærɪsn/; [n]比较;对照;比较等级;比喻; [or]6j;
compassion: [a]/kəmˈpæʃn/; [n]同情;怜悯; [or]6j;
compatible: [a]/kəmˈpætəbl/; [adj]可和谐共存的;兼容的; [or]6j;
compel: [a]/kəmˈpel/; [v]强迫;迫使屈服;(使)不得已; [or]6j;
compensate: [a]/ˈkɑːmpenseɪt/; [v]补偿,赔偿,给..报酬; [or]6j;
compete: [a]/kəmˈpiːt/; [v]参加比赛;竞争,对抗; [or]6j;
competence: [a]/ˈkɑːmpɪtəns/; [n]能力,胜任,称职; [or]6j;
competitive: [a]/kəmˈpetətɪv/; [adj]竞争的;好胜的;有竞争力的; [or]6j;
competitor: [a]/kəmˈpetɪtər/; [n]竞争对手,参赛者; [or]6j;
compile: [a]/kəmˈpaɪl/; [v]收集,汇编; [or]6j;
complain: [a]/kəmˈpleɪn/; [v]抱怨;诉苦;申诉;控诉;诉说;控告;  [vt]申诉;  [n]抱怨,诉苦; [or]6j;
complaint: [a]/kəmˈpleɪnt/; [n]抱怨,怨言;不满的缘由,痛苦根源;控诉;投诉; [or]6j;
complement: [a]/ˈkɑːmplɪment/; [v]补充;与.相配;  [n]补充;互为补充的东西;补语; [or]6j;
completion: [a]/kəmˈpliːʃn/; [n]完成,完满; [or]6j;
complex: [a]/ˈkɑːmpleks/; [adj]复杂的,难解的;复合的;  [n]情结;建筑群;综合体,集合体; [or]6j;
complexion: [a]/kəmˈplekʃn/; [n]肤色;特性; [or]6j;
complexity: [a]/kəmˈpleksəti/; [n]复杂,复杂的事物,复杂性; [or]6j;
complicated: [a]/ˈkɑːmplɪkeɪtɪd/; [adj]复杂的;难解的;  [v]使复杂; [or]6j;
complication: [a]/ˌkɑːmplɪˈkeɪʃn/; [n](新出现的)困难,难题;并发症; [or]6j;
compliment: [a]/ˈkɑːmplɪmənt/; [n]恭维,问候;  [v]赞美,祝贺; [or]6j;
comply: [a]/kəmˈplaɪ/; [vi]依从,服从,遵守; [or]6j;
component: [a]/kəmˈpoʊnənt/; [n]零件;  [adj]组成的; [or]6j;
compose: [a]/kəmˈpoʊz/; [v]创作,作曲,形成,构成; [or]6j;
composer: [a]/kəmˈpoʊzər/; [n]作曲家,设计者,著作者; [or]6j;
composite: [a]/kəmˈpɑːzət/; [adj]合成的,复合的;  [n]合成物,复合材料;  [v]使合成,使混合; [or]6j;
compound: [a]/ˈkɑːmpaʊnd/; [n]复合物;<化学>化合物;  [adj]合成的;复合的;多功能的;  [vi]妥协;和解;  [vt]混合;调和;调停;使恶化; [or]6j;
comprehend: [a]/ˌkɑːmprɪˈhend/; [v]由.组成;了解;领会;包含; [or]6j;
comprehension: [a]/ˌkɑːmprɪˈhenʃn/; [n]测试;理解力; [or]6j;
comprehensive: [a]/ˌkɑːmprɪˈhensɪv/; [adj]综合的;有充分理解力的,悟性好的;全面的,完整的;详尽的;广泛的,无所不包的;广义的;  [n]综合测验;综合学校; [or]6j;
compression: [a]/kəmˈpreʃn/; [n]浓缩;压缩,压紧;<机>(内燃机的)压缩冲程; [or]6j;
compromise: [a]/ˈkɑːmprəmaɪz/; [n]妥协;折中;  [v]妥协;使遭受危害; [or]6j;
compulsory: [a]/kəmˈpʌlsəri/; [adj]强制的,必修的; [or]6j;
compute: [a]/kəmˈpjuːt/; [v]计算,估计; [or]6j;
concede: [a]/kənˈsiːd/; [v]承认;承认失败;让给,让与;让步; [or]6j;
conceit: [a]/kənˈsiːt/; [n]自负;狂妄;想法,观点;构想,幻想; [or]6j;
conceive: [a]/kənˈsiːv/; [v]怀孕;设想,想出; [or]6j;
concentrate: [a]/ˈkɑːnsntreɪt/; [v]全神贯注于,集中于;浓缩;  [n]浓缩物; [or]6j;
concentration: [a]/ˌkɑːnsnˈtreɪʃn/; [n]集中;专注;浓缩; [or]6j;
concept: [a]/ˈkɑːnsept/; [n]设想;想法;概念;观念; [or]6j;
conception: [a]/kənˈsepʃn/; [n]怀孕,构想,设想,思想,观念; [or]6j;
concern: [a]/kənˈsɜːrn/; [n]关心,担忧;  [v]感兴趣,涉及,关心,(使)担忧; [or]6j;
concession: [a]/kənˈseʃn/; [n]让步;特许,特许权;承认; [or]6j;
concise: [a]/kənˈsaɪs/; [adj]简明的,简要的;简洁的,简要的; [or]6j;
conclude: [a]/kənˈkluːd/; [v]使结束;推断出;缔结;结束,总结,作决定,作协议; [or]6j;
condemn: [a]/kənˈdem/; [v]谴责,责备;判(某人某罪); [or]6j;
condemnation: [a]/ˌkɑːndemˈneɪʃn/; [n]谴责,定罪; [or]6j;
condense: [a]/kənˈdens/; [v]压缩;精炼;冷凝; [or]6j;
conduct: [a]/kənˈdʌkt/; [v]指挥;进行;实施;处理;传导(电,热等);护送;  [n]行为,举止;指挥,带领; [or]6j;
confer: [a]/kənˈfɜːr/; [v]授予(奖项,学位,荣誉或权利);商讨,协商; [or]6j;
conference: [a]/ˈkɑːnfərəns/; [n]会议;讨论会; [or]6j;
confession: [a]/kənˈfeʃn/; [n]忏悔;坦白,供认;教派; [or]6j;
confidence: [a]/ˈkɑːnfɪdəns/; [n]自信,信心;信任;有把握; [or]6j;
confident: [a]/ˈkɑːnfɪdənt/; [adj]自信的;确信的,深信的; [or]6j;
confidential: [a]/ˌkɑːnfɪˈdenʃl/; [adj]机密的;表示信任的;悄悄的; [or]6j;
configuration: [a]/kənˌfɪɡjəˈreɪʃn/; [n]配置,布局,构造; [or]6j;
confine: [a]/kənˈfaɪn/; [v]限制;监禁;  [n]范围,界限,约束,限制; [or]6j;
confinement: [a]/kənˈfaɪnmənt/; [n]限制;监禁;分娩; [or]6j;
confirm: [a]/kənˈfɜːrm/; [v]确认;证实;批准; [or]6j;
confirmation: [a]/ˌkɑːnfərˈmeɪʃn/; [n]证实,确认,批准; [or]6j;
conflict: [a]/ˈkɑːnflɪkt/; [n]冲突,(意见)分歧,战斗,斗争;  [v]冲突,抵触,争执; [or]6j;
conform: [a]/kənˈfɔːrm/; [vi]一致;遵照,顺从;符合;  [vt]使一致;使遵照;  [adj]一致的; [or]6j;
confront: [a]/kənˈfrʌnt/; [v]与某人对峙;与..对抗;正视; [or]6j;
confusion: [a]/kənˈfjuːʒn/; [n]困惑;混淆;混乱;窘迫; [or]6j;
congress: [a]/ˈkɑːŋɡrəs/; [n]国会(美);代表大会;议会;立法机关; [or]6j;
conqueror: [a]/ˈkɑːŋkərər/; [n]征服者,胜利者; [or]6j;
conscientious: [a]/ˌkɑːnʃiˈenʃəs/; [adj]勤勤恳恳的;认真的; [or]6j;
conscious: [a]/ˈkɑːnʃəs/; [adj]神志清醒的;自觉的;意识到的;有意的;  [n]意识; [or]6j;
consecutive: [a]/kənˈsekjətɪv/; [adj]连续的,连贯的; [or]6j;
consensus: [a]/kənˈsensəs/; [n]一致同意,合意; [or]6j;
consent: [a]/kənˈsent/; [n]同意,准许;赞成;  [v]同意; [or]6j;
consequence: [a]/ˈkɑːnsɪkwens/; [n]结果,后果;重要性; [or]6j;
consequent: [a]/ˈkɑːnsəkwənt/; [adj]作为结果(或后果)的,随之发生的;  [n]结果,随后的事; [or]6j;
consequently: [a]/ˈkɑːnsəkwentli/; [adv]结果;因此;所以; [or]6j;
conservation: [a]/ˌkɑːnsərˈveɪʃn/; [n]保护;保存;维持; [or]6j;
conservative: [a]/kənˈsɜːrvətɪv/; [adj]保守的;保守估计的;保守党的;  [n]保守主义者;保守党党员; [or]6j;
conserve: [a]/kənˈsɜːrv/; [v]保藏,保存;节约;  [n]蜜饯,果酱; [or]6j;
considerable: [a]/kənˈsɪdərəbl/; [adj]相当大的;重要的;可观的; [or]6j;
considerate: [a]/kənˈsɪdərət/; [adj]考虑周到的;体贴的; [or]6j;
consist: [a]/kənˈsɪst/; [v]由..组成;在于; [or]6j;
consistent: [a]/kənˈsɪstənt/; [adj]始终如一的,持续的,一致的; [or]6j;
console: [a]/kənˈsoʊl/; [v]安慰,慰问;  [n]控制台,仪表板;落地柜; [or]6j;
consolidate: [a]/kənˈsɑːlɪdeɪt/; [v]巩固,加强;把.合为一体; [or]6j;
conspicuous: [a]/kənˈspɪkjuəs/; [adj]显眼的;显著的;显而易见的; [or]6j;
constant: [a]/ˈkɑːnstənt/; [adj]不变的,始终如一的;持续不断的;  [n]常数,恒量; [or]6j;
constituent: [a]/kənˈstɪtʃuənt/; [adj]组成的;有选举权的;  [n]选民;成分; [or]6j;
constitute: [a]/ˈkɑːnstətuːt/; [v]构成,组成;任命; [or]6j;
constitution: [a]/ˌkɑːnstəˈtuːʃn/; [n]宪法,章程;组成,结构;体质,体格; [or]6j;
constrain: [a]/kənˈstreɪn/; [v]约束;限制;强迫; [or]6j;
constraint: [a]/kənˈstreɪnt/; [n]限制;强迫,拘束;强制; [or]6j;
construct: [a]/kənˈstrʌkt/; [v]建造;作(图);构筑;  [n]概念;构筑物;结构体;建造物; [or]6j;
consul: [a]/ˈkɑːnsl/; [n]领事; [or]6j;
consult: [a]/kənˈsʌlt/; [v]请教,咨询;查阅;商量; [or]6j;
consultant: [a]/kənˈsʌltənt/; [n]会诊医师,顾问医生;顾问; [or]6j;
consume: [a]/kənˈsuːm/; [v]消耗,耗尽;  [vt]吃光,喝光;毁灭; [or]6j;
consumer: [a]/kənˈsuːmər/; [n]消费者;用户;消耗者; [or]6j;
consumption: [a]/kənˈsʌmpʃn/; [n]消耗,消费,耗尽;肺痨; [or]6j;
contact: [a]/ˈkɑːntækt/; [v]接触;联系;  [n]接触;联系;  [adj]保持接触的;由接触引起的;<航>可看见地面景物的;  [adv]<航>以目力观察(飞行);  [int]开动; [or]6j;
contaminate: [a]/kənˈtæmɪneɪt/; [v]弄脏,污染; [or]6j;
contamination: [a]/kənˌtæmɪˈneɪʃn/; [n]污染;侵蚀,玷污; [or]6j;
contemplate: [a]/ˈkɑːntəmpleɪt/; [v]沉思;对..周密考虑;注视; [or]6j;
contempt: [a]/kənˈtempt/; [n]轻视,鄙视; [or]6j;
contend: [a]/kənˈtend/; [v]争辩;坚决主张;搏斗; [or]6j;
contention: [a]/kənˈtenʃn/; [n]争夺;争论,辩论;论点; [or]6j;
contest: [a]/ˈkɑːntest/; [n]比赛,竞争;  [v]争夺,争论; [or]6j;
context: [a]/ˈkɑːntekst/; [n]上下文,语境;背景; [or]6j;
continental: [a]/ˌkɑːntɪˈnentl/; [adj]大陆的,大陆性的;  [n]欧洲人; [or]6j;
continual: [a]/kənˈtɪnjuəl/; [adj]不断的;连续的;频繁的; [or]6j;
continuity: [a]/ˌkɑːntəˈnuːəti/; [n]连续性;(电影或电视节目中)镜头的连接,衔接; [or]6j;
contract: [a]/ˈkɑːntrækt/; [n]合同,契约;  [v]感染(疾病);招致;订合同;订立(婚约);缩减; [or]6j;
contradict: [a]/ˌkɑːntrəˈdɪkt/; [v]与..发生矛盾,与..抵触,与..对立; [or]6j;
contrast: [a]/ˈkɑːntræst/; [n]差异,对照,对比;对照;对比;  [v](with)使与..对比; [or]6j;
contribute: [a]/kənˈtrɪbjuːt/; [v]增进,起促成作用;捐献,捐助;..的原因之一;投稿; [or]6j;
contribution: [a]/ˌkɑːntrɪˈbjuːʃn/; [n]贡献,投稿稿件,捐献物; [or]6j;
contrive: [a]/kənˈtraɪv/; [v]发明;设计出;设法做到;谋划;策划; [or]6j;
controversial: [a]/ˌkɑːntrəˈvɜːrʃl/; [adj]引起争论的,有争议的; [or]6j;
controversy: [a]/ˈkɑːntrəvɜːrsi/; [n]争论,辩论; [or]6j;
convene: [a]/kənˈviːn/; [v]集合,召集,召唤; [or]6j;
convenience: [a]/kənˈviːniəns/; [n]方便;便利设施; [or]6j;
convention: [a]/kənˈvenʃn/; [n]会议;习俗;惯例; [or]6j;
conventional: [a]/kənˈvenʃənl/; [adj]普通的,常规的;依照惯例的,依照传统的; [or]6j;
converge: [a]/kənˈvɜːrdʒ/; [v](向某一点)相交,会合;汇集,聚集,集中; [or]6j;
converse: [a]/kənˈvɜːrs/; [v]交谈;  [adj]相反的,颠倒的;  [n]相反的事物; [or]6j;
conversion: [a]/kənˈvɜːrʒn/; [n]转变,转换;宗教,信仰上的转变;<经济学>兑换; [or]6j;
convert: [a]/kənˈvɜːrt/; [v]可转变为,可变换成;改变,转变,转化;使改变信仰;  [n]皈依者;改变宗教信仰者; [or]6j;
convey: [a]/kənˈveɪ/; [v]传送,运送;表达,传达; [or]6j;
convict: [a]/ˈkɑːnvɪkt/; [n]犯人;  [v](经审讯)证明..有罪,使..知罪; [or]6j;
conviction: [a]/kənˈvɪkʃn/; [n]定罪;信服;坚强信念; [or]6j;
convince: [a]/kənˈvɪns/; [v]使确信;使信服; [or]6j;
cooperative: [a]/koʊˈɑːpərətɪv/; [adj]合作的;协作的;  [n]合作社; [or]6j;
cord: [a]/kɔːrd/; [n]细绳,索,(电工学)电绳;索,(电工学)电绳; [or]6j;
cordial: [a]/ˈkɔːrdʒəl/; [adj]热情友好的,衷心的; [or]6j;
cork: [a]/kɔːrk/; [n]软木;  [v]塞住,抑制; [or]6j;
corporate: [a]/ˈkɔːrpərət/; [adj]公司的;全体的;共同的;(法人)团体的; [or]6j;
corps: [a]/kɔːr/; [n](由两个或以上师组成的)军,兵团;一群人;特别小组; [or]6j;
corpse: [a]/kɔːrps/; [n]尸体,被废弃的东西; [or]6j;
correctly: [a]/kəˈrektli/; [adv]恰当地,正确地; [or]6j;
correlation: [a]/ˌkɔːrəˈleɪʃn/; [n]相互关系,相关(性); [or]6j;
correspondence: [a]/ˌkɔːrəˈspɑːndəns/; [n]通信,通信联系;信件,函件;符合,一致;相似; [or]6j;
correspondent: [a]/ˌkɔːrəˈspɑːndənt/; [n]通讯员,记者;通信者; [or]6j;
corresponding: [a]/ˌkɔːrəˈspɑːndɪŋ/; [adj]相应的;符合的,一致的;通信的; [or]6j;
corrode: [a]/kəˈroʊd/; [v]受腐蚀;腐蚀,侵蚀; [or]6j;
corrosion: [a]/kəˈroʊʒn/; [n]侵蚀,腐蚀状态; [or]6j;
corrupt: [a]/kəˈrʌpt/; [v]变腐败,堕落;贿赂,使腐败;  [adj]腐败的;堕落的; [or]6j;
cosmic: [a]/ˈkɑːzmɪk/; [adj]宇宙的;广大无边的; [or]6j;
cosmopolitan: [a]/ˌkɑːzməˈpɑːlɪtən/; [n]游历四方的人;  [adj]见多识广的;多元的;广泛分布的; [or]6j;
costume: [a]/ˈkɑːstuːm/; [n]服装,剧装;  [vt]提供服装;为 ... 设计服装;  [adj]服装打扮的; [or]6j;
couch: [a]/kaʊtʃ/; [n]长沙发;长椅;长榻;  [v]表达; [or]6j;
council: [a]/ˈkaʊnsl/; [n]议会;理事会;委员会; [or]6j;
counsel: [a]/ˈkaʊnsl/; [n]忠告;律师,法律顾问;  [v]劝告,提议; [or]6j;
counter: [a]/ˈkaʊntər/; [n]柜台;回击,反击;  [v]抵消,抗衡;  [adv]相反地; [or]6j;
counterpart: [a]/ˈkaʊntərpɑːrt/; [n]对应的人(物);副本;对手; [or]6j;
coup: [a]/kuː/; [n]政变;出乎意料的行动或胜利; [or]6j;
coupon: [a]/ˈkuːpɑːn/; [n](债券等)息券;赠券;配给券;折扣券; [or]6j;
courageous: [a]/kəˈreɪdʒəs/; [adj]勇敢的,英勇的,有胆量的; [or]6j;
court: [a]/kɔːrt/; [n]法院,法庭;庭院;球场;宫廷;  [v]讨好,取悦;招致危险;追求; [or]6j;
courteous: [a]/ˈkɜːrtiəs/; [adj]有礼貌的,谦恭有礼的; [or]6j;
courtesy: [a]/ˈkɜːrtəsi/; [n]礼貌; [or]6j;
coverage: [a]/ˈkʌvərɪdʒ/; [n]新闻报道;可达范围;覆盖范围; [or]6j;
coward: [a]/ˈkaʊərd/; [n]懦夫,胆小鬼;  [adj]懦弱的,胆怯的; [or]6j;
cozy: [a]/ˈkoʊzi/; [adj]温暖舒适的,安逸的;  [v]取悦; [or]6j;
crab: [a]/kræb/; [n]螃蟹;蟹肉; [or]6j;
cradle: [a]/ˈkreɪdl/; [n]摇篮;策源地,发源地;  [v]轻轻地抱,捧; [or]6j;
crank: [a]/kræŋk/; [n]曲柄;有怪癖的人;脾气坏的人;  [v]装曲柄;转动曲柄;  [adj]脾气暴躁的,易怒的; [or]6j;
crash: [a]/kræʃ/; [n]碰撞,坠落,轰隆声;  [v]碰撞,坠落,崩溃;  [adj]紧急的; [or]6j;
creation: [a]/kriˈeɪʃn/; [n]创造,创作;创造物,作品; [or]6j;
credit: [a]/ˈkredɪt/; [n]信用;荣誉;学分;信贷;称赞;债权;  [v]信赖;归因于;记学分; [or]6j;
crew: [a]/kruː/; [n](飞机,轮船等的)全体工作人员;一群人; [or]6j;
crime: [a]/kraɪm/; [n]罪行;犯罪;违反道德的行为;  [v]判定犯罪;处罚军事犯; [or]6j;
criminal: [a]/ˈkrɪmɪnl/; [n]罪犯;  [adj]犯罪的,违法的,刑法的;可耻的; [or]6j;
cripple: [a]/ˈkrɪpl/; [n]跛子,伤残人(或动物);  [v]使跛;使受伤致残;严重削弱; [or]6j;
crisis: [a]/ˈkraɪsɪs/; [n]危机;存亡之际; [or]6j;
crisp: [a]/krɪsp/; [adj]脆的,易碎的,霜冻的,干脆的;  [n]油炸马铃薯片;  [v](使)发脆; [or]6j;
criterion: [a]/kraɪˈtɪriən/; [n]标准,准则; [or]6j;
critic: [a]/ˈkrɪtɪk/; [n]评论家,批判者;挑剔的人; [or]6j;
critical: [a]/ˈkrɪtɪkl/; [adj]批评的;文艺评论的;爱挑剔的;危急的;关键的,重要的; [or]6j;
criticism: [a]/ˈkrɪtɪsɪzəm/; [n]批评;批判;评论; [or]6j;
criticize: [a]/ˈkrɪtɪsaɪz/; [v]批评,评论,挑剔,责难; [or]6j;
crooked: [a]/ˈkrʊkɪd/; [adj]弯曲的;歪的;不正当的;不正直的; [or]6j;
crowd: [a]/kraʊd/; [n]人群,一群;民众;朋友;  [v]聚集;涌入(脑海);挤满; [or]6j;
crucial: [a]/ˈkruːʃl/; [adj]关键的;决定性的; [or]6j;
cruelty: [a]/ˈkruːəlti/; [n]残忍,残酷(行为); [or]6j;
cruise: [a]/kruːz/; [n]巡航;漫游;旅行;  [v]航游;巡航;(出租车,船等)缓慢巡行; [or]6j;
crumble: [a]/ˈkrʌmbl/; [v]弄碎;使破碎;崩溃;破灭;  [n]碎屑;面包屑; [or]6j;
crush: [a]/krʌʃ/; [vt]压坏;压扁;弄皱;弄碎,压碎;榨出;紧抱;挤入;镇压;欺压;  [n]压扁;极度拥挤;  [vi]被压坏;被揉皱;蜂拥而来; [or]6j;
cuckoo: [a]/ˈkʊkuː/; [n]杜鹃鸟;布谷鸟;  [adj]疯狂的; [or]6j;
cucumber: [a]/ˈkjuːkʌmbər/; [n]黄瓜; [or]6j;
cue: [a]/kjuː/; [n]提示;暗号;球杆;  [v]给.提示; [or]6j;
culminate: [a]/ˈkʌlmɪneɪt/; [v]使达高潮,使结束; [or]6j;
cult: [a]/kʌlt/; [n]异教;风尚,热潮;信徒;  [adj]流行的;风靡一时的; [or]6j;
culture: [a]/ˈkʌltʃər/; [n]文化;文明;修养;栽培;  [v]使有教养;培养; [or]6j;
cumulative: [a]/ˈkjuːmjəleɪtɪv/; [adj]渐增的;累积的; [or]6j;
curb: [a]/kɜːrb/; [v]勒住;抑制;控制;约束;  [n]路缘;控制;约束; [or]6j;
curly: [a]/ˈkɜːrli/; [adj]卷曲的,卷毛的,弯曲的; [or]6j;
currency: [a]/ˈkɜːrənsi/; [n]货币;流通;流行; [or]6j;
current: [a]/ˈkɜːrənt/; [adj]当前的,现在的;流动的;  [n](电,水,气)流; [or]6j;
curriculum: [a]/kəˈrɪkjələm/; [n]课程,(学校或专业的)全部课程; [or]6j;
curse: [a]/kɜːrs/; [n]诅咒;咒骂;祸因;  [v]诅咒;咒骂;使受罪; [or]6j;
curt: [a]/kɜːrt/; [adj]简略的; [or]6j;
customary: [a]/ˈkʌstəmeri/; [adj]合乎习俗的;惯常的; [or]6j;
cute: [a]/kjuːt/; [adj]可爱的;讨人喜爱的;聪明的; [or]6j;
cutter: [a]/ˈkʌtər/; [n]刀具,切割机;小汽艇;独桅纵帆船; [or]6j;
cyber-: [a]/'saɪbə/; pref. 电脑(网络)的;电脑的;网络的; [or]6j;
cycle: [a]/ˈsaɪkl/; [n]自行车;周期,循环;  [v](英)骑自行车;循环; [or]6j;
cylinder: [a]/ˈsɪlɪndər/; [n]圆柱体,圆筒;汽缸,泵(或桶)体; [or]6j;
cynical: [a]/ˈsɪnɪkl/; [adj]愤世嫉俗的;恶意的;悲观的; [or]6j;
damn: [a]/dæm/; [int]该死,讨厌;  [v]诅咒;  [n]诅咒;  [adj]该死的;完全的;  [adv](表示厌烦)该死;非常; [or]6j;
dart: [a]/dɑːrt/; [n]飞镖;猛冲;标枪;  [v]快速投掷;突然移动; [or]6j;
database: [a]/ˈdeɪtəbeɪs/; [n]数据库; [or]6j;
datum: [a]/ˈdeɪtəm/; [n]数据,资料; [or]6j;
dazzle: [a]/ˈdæzl/; [n]光辉;令人赞叹的东西;  [v]使眼花;使赞叹不已; [or]6j;
deadline: [a]/ˈdedlaɪn/; [n]截止期限,最后期限;  [vt]通过设定一时间期限来统治; [or]6j;
deadly: [a]/ˈdedli/; [adj]致命的,致死的,十足的;  [adv]死一般地;非常; [or]6j;
deafen: [a]/ˈdefn/; [v]变聋; [or]6j;
dealer: [a]/ˈdiːlər/; [n]经销商,商人,(俚)毒贩; [or]6j;
dean: [a]/diːn/; [n](大学的)学院院长;系主任;资格最老者,泰斗;牧师; [or]6j;
debate: [a]/dɪˈbeɪt/; [n]辩论;讨论;  [v]辩论;争论;议论; [or]6j;
decade: [a]/ˈdekeɪd/; [n]十年,十年间; [or]6j;
decay: [a]/dɪˈkeɪ/; [v]腐烂;衰退;腐朽;  [n]腐烂;衰退;腐败; [or]6j;
deceive: [a]/dɪˈsiːv/; [v]欺骗,行骗; [or]6j;
decent: [a]/ˈdiːsnt/; [adj]体面的;像样的;合宜的;正直的; [or]6j;
deceptive: [a]/dɪˈseptɪv/; [adj]欺骗性的,骗人的; [or]6j;
decimal: [a]/ˈdesɪml/; [n]小数;  [adj]小数的;十进制的; [or]6j;
decisive: [a]/dɪˈsaɪsɪv/; [adj]决定性的; [or]6j;
declaration: [a]/ˌdekləˈreɪʃn/; [n]宣言,声明书;宣布,宣告;申报; [or]6j;
decline: [a]/dɪˈklaɪn/; [n]下降;衰退;  [v]<语>使发生词尾变化,使变格;下降;拒绝; [or]6j;
decompose: [a]/ˌdiːkəmˈpoʊz/; [v](使)腐烂;分解; [or]6j;
decorate: [a]/ˈdekəreɪt/; [v]装饰,布置;把(勋章)授给(某人); [or]6j;
decorative: [a]/ˈdekəreɪtɪv/; [adj]装饰的; [or]6j;
decrease: [a]/dɪˈkriːs/; [v]减少;减;  [n]减;减少; [or]6j;
decree: [a]/dɪˈkriː/; [v]命令,判决,颁布;  [n]法令,政令; [or]6j;
dedicate: [a]/ˈdedɪkeɪt/; [v]献给,致力于; [or]6j;
deduce: [a]/dɪˈduːs/; [v]演绎;推论,推断; [or]6j;
deduct: [a]/dɪˈdʌkt/; [v]减去; [or]6j;
deed: [a]/diːd/; [n]行为;契约; [or]6j;
deem: [a]/diːm/; [v]认为,视为;知道,相信; [or]6j;
default: [a]/dɪˈfɔːlt/; [n]违约;缺席;缺乏;默认;  [vi]不履行义务;拖欠;  [vt]不履行;不参加; [or]6j;
defeat: [a]/dɪˈfiːt/; [n]挫败;击败,战胜;  [v]打败;战胜; [or]6j;
defect: [a]/ˈdiːfekt/; [n]缺陷,缺点,不足之处;  [v]背叛,逃跑,开小差; [or]6j;
defective: [a]/dɪˈfektɪv/; [adj]有缺陷的; [or]6j;
defendant: [a]/dɪˈfendənt/; [n]被告; [or]6j;
defiance: [a]/dɪˈfaɪəns/; [n]蔑视;反抗;挑战; [or]6j;
deficiency: [a]/dɪˈfɪʃnsi/; [n]缺乏,不足;缺陷; [or]6j;
deficient: [a]/dɪˈfɪʃnt/; [adj]有缺陷的;不足的,不充足的;  [n]有缺陷的人<东西>; [or]6j;
deficit: [a]/ˈdefɪsɪt/; [n]亏损;赤字;不足额; [or]6j;
define: [a]/dɪˈfaɪn/; [v]给(词,短语等)下定义;使明确;规定;下定义,构成释义; [or]6j;
definitely: [a]/ˈdefɪnətli/; [adv]一定地,明确地;当然; [or]6j;
definition: [a]/ˌdefɪˈnɪʃn/; [n](轮廓等)清晰;定义,释义; [or]6j;
definitive: [a]/dɪˈfɪnətɪv/; [adj]可靠的,明确的,权威的;决定性的; [or]6j;
deflect: [a]/dɪˈflekt/; [v](使)偏斜,(使)偏转; [or]6j;
deflection: [a]/dɪˈflekʃn/; [n]转向;偏斜;偏折,折射; [or]6j;
deformation: [a]/ˌdiːfɔːrˈmeɪʃn/; [n]变形;畸形; [or]6j;
defy: [a]/dɪˈfaɪ/; [v]违抗,藐视;使不可能 (理解或解释);违背;赌.也不能;  [n]挑战;对抗; [or]6j;
degenerate: [a]/dɪˈdʒenəreɪt/; [v]堕落,衰减;  [adj]腐化的,颓废的,退化的;变质的;  [n]堕落者; [or]6j;
degradation: [a]/ˌdeɡrəˈdeɪʃn/; [n]降级,降格;退化;恶化; [or]6j;
degrade: [a]/dɪˈɡreɪd/; [v]贬低;降低品格(身价,价值等);分解;降低; [or]6j;
delegate: [a]/ˈdelɪɡət/; [n]代表;  [v]委派..为代表,授权; [or]6j;
deliberate: [a]/dɪˈlɪbərət/; [adj]故意的;深思熟虑的;从容不迫的;  [v]仔细考虑;研讨; [or]6j;
deliberately: [a]/dɪˈlɪbərətli/; [adv]故意地;慢条斯理地; [or]6j;
delicate: [a]/ˈdelɪkət/; [adj]易碎的,易坏的,脆弱的;(人)娇弱的,体弱多病的;精美的,精致的,精巧的;微妙的,需要谨慎处理的;优美的,优雅的;柔和的,清淡的,淡雅的; [or]6j;
demand: [a]/dɪˈmænd/; [n]要求(坚决的),需求;  [v]强烈要求,需要; [or]6j;
demonstrate: [a]/ˈdemənstreɪt/; [vt](用实例,实验)论证;演示,展示;示范;  [vi]示威; [or]6j;
demonstration: [a]/ˌdemənˈstreɪʃn/; [n]示范表演,演示;实物说明;游行;表现; [or]6j;
denial: [a]/dɪˈnaɪəl/; [n]拒绝;否认;拒绝给予; [or]6j;
denote: [a]/dɪˈnoʊt/; [v]是.的标志;指出;  [vt]指示;代表(或表示); [or]6j;
denounce: [a]/dɪˈnaʊns/; [v]谴责,斥责; [or]6j;
dentist: [a]/ˈdentɪst/; [n]牙医; [or]6j;
deny: [a]/dɪˈnaɪ/; [v]否认,拒绝承认,拒绝给予,自制; [or]6j;
dependant: [a]/dɪˈpendənt/; [n](子女等)受抚养者; [or]6j;
depict: [a]/dɪˈpɪkt/; [v]描绘,描写; [or]6j;
deplore: [a]/dɪˈplɔːr/; [v]谴责;对...深感遗憾;悲悼;痛惜; [or]6j;
depress: [a]/dɪˈpres/; [vt]使沮丧;使萧条;压下,压低; [or]6j;
depressed: [a]/dɪˈprest/; [adj]沮丧的;萧条的;低迷的; [or]6j;
depression: [a]/dɪˈpreʃn/; [n]抑郁,沮丧;不景气,萧条(期);洼地,凹陷; [or]6j;
deprive: [a]/dɪˈpraɪv/; [v]使丧失;剥夺;免去.的职务; [or]6j;
depute: [a]/dɪˈpjuːt/; [vt]委派.为代表,指派,.为代理人;把(工作,责任等)交托给; [or]6j;
derivation: [a]/ˌderɪˈveɪʃn/; [n]出处;词源;派生; [or]6j;
derive: [a]/dɪˈraɪv/; [v]获取;得自;起源; [or]6j;
descend: [a]/dɪˈsend/; [vi]走下;降临;  [v]下降,下来;突然访问;下移,下降; [or]6j;
descendant: [a]/dɪˈsendənt/; [n]后代,后裔;派生物; [or]6j;
descent: [a]/dɪˈsent/; [n]下降,下倾;血统,世系;斜坡,坡道; [or]6j;
describe: [a]/dɪˈskraɪb/; [v]描述;形容; [or]6j;
deserve: [a]/dɪˈzɜːrv/; [v]值得,应得;应受; [or]6j;
design: [a]/dɪˈzaɪn/; [vt]设计;  [n]设计;图样;  [vi]设计略图;(为工艺品,装潢项目等)设计;当设计师;构思; [or]6j;
designate: [a]/ˈdezɪɡneɪt/; [adj]已受委派而尚未上任的;  [v]标出,说出;委任,任命,提名;指定; [or]6j;
desirable: [a]/dɪˈzaɪərəbl/; [adj]有吸引力的;性感的;令人向往的;令人满意的; [or]6j;
desire: [a]/dɪˈzaɪər/; [n]渴望;欲望;愿望;要求;  [vi]有希望,期望,愿望;  [vt]希望,渴望;请求,要求; [or]6j;
desolate: [a]/ˈdesələt/; [adj]荒凉的;孤单寂寞的; [or]6j;
despatch: [a]/dɪˈspætʃ/; [v]发送;派遣;打败;  [n](公文)急件;(记者发回的)新闻报道;派遣; [or]6j;
despise: [a]/dɪˈspaɪz/; [vt]轻视,蔑视,看不起; [or]6j;
destination: [a]/ˌdestɪˈneɪʃn/; [n]目的地,终点;  [adj]目的地的; [or]6j;
destine: [a]/'destɪn/; [v]注定;预定; [or]6j;
destined: [a]/ˈdestɪnd/; [adj]命中注定的,预定的;(for)以.为目的地的; [or]6j;
destiny: [a]/ˈdestəni/; [n]命运,天数,天命; [or]6j;
destruction: [a]/dɪˈstrʌkʃn/; [n]破坏,毁灭,灭亡; [or]6j;
destructive: [a]/dɪˈstrʌktɪv/; [adj]破坏(性)的,毁灭(性)的; [or]6j;
detach: [a]/dɪˈtætʃ/; [v]使分开,拆卸;派遣; [or]6j;
detail: [a]/ˈdiːteɪl/; [n]细节;详情;特遣队;  [vt]详述;派遣; [or]6j;
detain: [a]/dɪˈteɪn/; [v]拘留,使延迟; [or]6j;
detect: [a]/dɪˈtekt/; [v]发现,发觉;侦察,探测; [or]6j;
detection: [a]/dɪˈtekʃn/; [n]察觉;侦察;检测,检验; [or]6j;
detective: [a]/dɪˈtektɪv/; [n]侦探,私人侦探;  [adj]侦探的; [or]6j;
detector: [a]/dɪˈtektər/; [n]探测器; [or]6j;
deteriorate: [a]/dɪˈtɪriəreɪt/; [v]恶化;变质;衰退; [or]6j;
devastating: [a]/ˈdevəsteɪtɪŋ/; [adj]毁灭性的;惊人的;令人难受的; [or]6j;
deviate: [a]/ˈdiːvieɪt/; [v]偏离;背离;  [adj]脱离常轨的;  [n]脱离常轨的人; [or]6j;
deviation: [a]/ˌdiːviˈeɪʃn/; [n]偏离,背离; [or]6j;
device: [a]/dɪˈvaɪs/; [n]器械,装置,设备;手段,策略; [or]6j;
devise: [a]/dɪˈvaɪz/; [v]设计,想出;密谋;遗赠(不动产);  [n]设计,发明,遗赠; [or]6j;
devote: [a]/dɪˈvoʊt/; [vt]奉献;献身于,专心致力于; [or]6j;
devotion: [a]/dɪˈvoʊʃn/; [n]奉献,献身于...;热爱;投入;忠诚; [or]6j;
devour: [a]/dɪˈvaʊər/; [v]狼吞虎咽;毁灭;贪婪地看,贪婪地阅读; [or]6j;
diagnose: [a]/ˌdaɪəɡˈnoʊs/; [v]诊断(疾病),对(病人)下诊断结论; [or]6j;
diagnosis: [a]/ˌdaɪəɡˈnoʊsɪs/; [n]诊断; [or]6j;
dictate: [a]/ˈdɪkteɪt/; [v]规定;命令;口授;听写;  [n]命令;指令; [or]6j;
diesel: [a]/ˈdiːzl/; [n]内燃机,柴油机; [or]6j;
diet: [a]/ˈdaɪət/; [n]日常饮食;(病人或减肥者的)特种饮食;大量;  [v]节食; [or]6j;
differentiate: [a]/ˌdɪfəˈrenʃieɪt/; [v]使有差异;区别; [or]6j;
diffuse: [a]/dɪˈfjuːz/; [v]传播;扩散,弥漫;漫射;  [adj]四散的,散开的;不清楚的; [or]6j;
digest: [a]/daɪˈdʒest/; [v]消化;领会,理解;  [n]摘要; [or]6j;
dignity: [a]/ˈdɪɡnəti/; [n]威严,威风;端庄;尊严,高贵; [or]6j;
dilemma: [a]/dɪˈlemə/; [n]进退两难的窘境; [or]6j;
diligent: [a]/ˈdɪlɪdʒənt/; [adj]勤奋的;用功的; [or]6j;
dilute: [a]/daɪˈluːt/; [v]使变淡,稀释;使病弱; [or]6j;
dim: [a]/dɪm/; [adj]暗淡的;模糊的;朦胧的;  [v]变暗淡; [or]6j;
dimension: [a]/dɪˈmenʃn/; [n]维度;尺寸;尺度;方面; [or]6j;
diminish: [a]/dɪˈmɪnɪʃ/; [v]减少;失势,削弱.的权势, 减弱.的权势; [or]6j;
dine: [a]/daɪn/; [v]吃饭,用餐;招待..吃饭;用正餐(晚餐); [or]6j;
dioxide: [a]/daɪˈɑːksaɪd/; [n]二氧化物; [or]6j;
diploma: [a]/dɪˈploʊmə/; [n]毕业文凭,毕业证书;文凭课程; [or]6j;
diplomat: [a]/ˈdɪpləmæt/; [n]外交官,外交家;有交际手腕的人,圆滑的人; [or]6j;
diplomatic: [a]/ˌdɪpləˈmætɪk/; [adj]外交的,从事外交的;老练的,圆滑的; [or]6j;
directory: [a]/dəˈrektəri/; [n]人名地址录,(电话)号码簿;目录; [or]6j;
disagreement: [a]/ˌdɪsəˈɡriːmənt/; [n]分歧,不和;不一致; [or]6j;
disappearance: [a]/ˌdɪsəˈpɪrəns/; [n]失踪,消失;绝迹; [or]6j;
disapprove: [a]/ˌdɪsəˈpruːv/; [v]不同意; [or]6j;
disaster: [a]/dɪˈzæstər/; [n]灾难,天灾; [or]6j;
disastrous: [a]/dɪˈzæstrəs/; [adj]灾难性的; [or]6j;
discard: [a]/dɪsˈkɑːrd/; [v]丢弃;抛弃;遗弃; [or]6j;
discern: [a]/dɪˈsɜːrn/; [v]辨别;识别;看出; [or]6j;
discharge: [a]/dɪsˈtʃɑːrdʒ/; [n]发射;释放;解雇;放电;  [v]卸掉负担;发射;放电;卸(货);使爆炸;履行;解雇;允许.离开;排出,放出;清偿(债务); [or]6j;
discipline: [a]/ˈdɪsəplɪn/; [n]纪律;学科;训练;  [v]训练;惩罚;管制; [or]6j;
disclose: [a]/dɪsˈkloʊz/; [v]公开,揭露,泄露; [or]6j;
disconnect: [a]/ˌdɪskəˈnekt/; [v]断开,拆开,使分离; [or]6j;
discount: [a]/ˈdɪskaʊnt/; [n](价格,债款等)折扣;  [v]打折扣,不全信,怀疑地看待; [or]6j;
discourse: [a]/ˈdɪskɔːrs/; [n]交谈,演讲,论述,讲道;  [v]演讲,谈论; [or]6j;
discreet: [a]/dɪˈskriːt/; [adj]谨慎的;思虑周全的,小心的; [or]6j;
discrepancy: [a]/dɪsˈkrepənsi/; [n]不一致,差异,不符; [or]6j;
discrete: [a]/dɪˈskriːt/; [adj]分开的;不连续的; [or]6j;
discriminate: [a]/dɪˈskrɪmɪneɪt/; [v]区别,辨别;歧视; [or]6j;
discrimination: [a]/dɪˌskrɪmɪˈneɪʃn/; [n]歧视,偏见; [or]6j;
disease: [a]/dɪˈziːz/; [n]疾病; [or]6j;
disgrace: [a]/dɪsˈɡreɪs/; [n]耻辱;不光彩;失宠;  [v]使丢脸,给.带来耻辱;使失宠; [or]6j;
disguise: [a]/dɪsˈɡaɪz/; [v]伪装;掩饰;  [n]伪装物;伪装; [or]6j;
disgust: [a]/dɪsˈɡʌst/; [v]使作呕,使厌恶;  [n]恶心; [or]6j;
disillusion: [a]/ˌdɪsɪˈluːʒn/; [n]幻灭;  [v]给.泼冷水; [or]6j;
dismay: [a]/dɪsˈmeɪ/; [n]失望;沮丧;惊愕;  [v]使惊恐; [or]6j;
dismiss: [a]/dɪsˈmɪs/; [v]开除;解散;摒除,不再考虑; [or]6j;
disorder: [a]/dɪsˈɔːrdər/; [n]混乱;紊乱;动乱;  [vt]使混乱;使紊乱; [or]6j;
dispatch: [a]/dɪˈspætʃ/; [v]派遣,调遣;发送(信件,电报等);结束,摆脱掉;匆匆办完;  [vt]处决;  [n]派遣,调遣;发送;快信,急件;迅速,敏捷; [or]6j;
disperse: [a]/dɪˈspɜːrs/; [v]使散开;分散,散开; [or]6j;
displacement: [a]/dɪsˈpleɪsmənt/; [n]替代;移位,位移,排水量; [or]6j;
display: [a]/dɪˈspleɪ/; [v]展示;显示;陈列;  [n]表现,流露,展示;显示,显示器;陈列品; [or]6j;
disposal: [a]/dɪˈspoʊzl/; [n]销毁,丢掉,处理;  [adj]处理(或置放)废品的; [or]6j;
dispose: [a]/dɪˈspoʊz/; [v]处理,处置,除去;使愿意; [or]6j;
disposition: [a]/ˌdɪspəˈzɪʃn/; [n]性情,性格;意向,倾向;排列,部署; [or]6j;
disproportionate: [a]/ˌdɪsprəˈpɔːrʃənət/; [adj]不成比例的; [or]6j;
disregard: [a]/ˌdɪsrɪˈɡɑːrd/; [v]不理会;漠视;  [n]忽视,漠视; [or]6j;
disrupt: [a]/dɪsˈrʌpt/; [v]扰乱; [or]6j;
dissatisfaction: [a]/ˌdɪsˌsætɪsˈfækʃn/; [n]不满,不平;令人不满的事物; [or]6j;
dissipate: [a]/ˈdɪsɪpeɪt/; [v]消散,消失;浪费; [or]6j;
distill: [a]/dɪˈstɪl/; [v]抽出..的精华;蒸馏; [or]6j;
distinct: [a]/dɪˈstɪŋkt/; [adj]截然不同的;独特的;明显的;清晰的; [or]6j;
distinguish: [a]/dɪˈstɪŋɡwɪʃ/; [v]区别,识别,辨别,使显著; [or]6j;
distort: [a]/dɪˈstɔːrt/; [v]扭曲,使变形;歪曲,曲解; [or]6j;
distortion: [a]/dɪˈstɔːrʃn/; [n]扭曲,变形;曲解;失真; [or]6j;
distract: [a]/dɪˈstrækt/; [v]使分心,转移(注意力),分散(思想); [or]6j;
distribution: [a]/ˌdɪstrɪˈbjuːʃn/; [n]分布;分配;分发;散布; [or]6j;
disturbance: [a]/dɪˈstɜːrbəns/; [n]骚乱,混乱;扰乱,打扰;心神不安,烦恼; [or]6j;
diverge: [a]/daɪˈvɜːrdʒ/; [v]分歧,分开; [or]6j;
diverse: [a]/daɪˈvɜːrs/; [adj]不同的,差异的,多种多样的; [or]6j;
diversion: [a]/daɪˈvɜːrʒn/; [n]绕行路;转移,改变方向;分心,消遣;分水渠; [or]6j;
divert: [a]/daɪˈvɜːrt/; [v]使转向,使改道(或绕道);转移,转移.的注意力;使娱乐,使消遣; [or]6j;
dividend: [a]/ˈdɪvɪdend/; [n](股份的)红利,回报,效益,被除数; [or]6j;
divine: [a]/dɪˈvaɪn/; [adj]神的,神圣的;极好的;  [v](凭直觉)发现,猜到;  [n]神学家;圣职人员;教士;上帝; [or]6j;
divorce: [a]/dɪˈvɔːrs/; [n]离婚,离异;  [v]离婚; [or]6j;
dizzy: [a]/ˈdɪzi/; [adj]眩晕的,头晕目眩的,头昏眼花的;  [vt]使头晕目眩;使困惑; [or]6j;
dock: [a]/dɑːk/; [n]码头;船埠;被告席;  [v](船)进港;扣工资;剪短(动物的尾巴); [or]6j;
doctrine: [a]/ˈdɑːktrɪn/; [n]教条,学说,信条,原则; [or]6j;
documentary: [a]/ˌdɑːkjuˈmentri/; [n]纪录片;  [adj]纪实的;文献的; [or]6j;
dodge: [a]/dɑːdʒ/; [n]托词;躲闪,躲避;  [v]回避,规避;躲避,避开; [or]6j;
dolphin: [a]/ˈdɑːlfɪn/; [n]海豚; [or]6j;
domain: [a]/doʊˈmeɪn/; [n]域名;领土;管区,势力圈; [or]6j;
dome: [a]/doʊm/; [n]圆屋顶,穹顶; [or]6j;
domestic: [a]/dəˈmestɪk/; [adj]国产的;国内的;家庭的;驯养的;  [n]家仆;家庭纷争; [or]6j;
dominant: [a]/ˈdɑːmɪnənt/; [adj]主要的,占优势的,支配的,统治的;显性基因的; [or]6j;
dominate: [a]/ˈdɑːmɪneɪt/; [v]在.中占首要地位;支配,统治,控制;耸立于,俯视;处于支配地位,拥有优势; [or]6j;
donate: [a]/ˈdoʊneɪt/; [v]捐献;捐赠;  [vi]捐献;捐赠; [or]6j;
donation: [a]/doʊˈneɪʃn/; [n]捐款;捐赠物; [or]6j;
doom: [a]/duːm/; [v]注定;命定;  [n]毁灭;厄运;劫数; [or]6j;
doubtless: [a]/ˈdaʊtləs/; [adv]无疑地;肯定地;  [adj]无疑的;肯定的; [or]6j;
dove: [a]/dʌv/; [n]鸽子; [or]6j;
draft: [a]/dræft/; [n]气流;通风,通风装置;草稿;汇票;征兵;  [v]起草;征兵; [or]6j;
drag: [a]/dræɡ/; [v]拉,拽,拖着(沉重的步伐或疲惫的身躯);拖动,拖沓;  [n]拖,拖累物;  [adj]女穿男服的;男穿女服的;  [adv]带有女伴; [or]6j;
drain: [a]/dreɪn/; [vi]排出,排水;  [v]流干,沥干;喝光,耗尽,减少,消逝;  [vt]使流出,排掉水;  [n]下水道,排水管;消耗,排水; [or]6j;
drainage: [a]/ˈdreɪnɪdʒ/; [n]排水;排水系统;污水;下水道; [or]6j;
dramatic: [a]/drəˈmætɪk/; [adj]戏剧的,戏剧性的;引人注目的;逼真的,刺激的; [or]6j;
dramatically: [a]/drəˈmætɪkli/; [adv]显著地,剧烈地,引人注目地;戏剧性地; [or]6j;
drastic: [a]/ˈdræstɪk/; [adj]极端的;猛烈的;激烈的; [or]6j;
drastically: [a]/ˈdræstɪkli/; [adv]大大地;彻底地; [or]6j;
drawback: [a]/ˈdrɔːbæk/; [n]缺点;障碍,不利条件; [or]6j;
dread: [a]/dred/; [v]惧怕,害怕;  [n]畏惧,恐惧;  [adj]恐怖的,使人敬畏的; [or]6j;
dreadful: [a]/ˈdredfl/; [adj]糟透了的,极不合意的;可怕的; [or]6j;
drill: [a]/drɪl/; [n]训练;反复操练;钻头;  [v]在..上钻孔;钻孔; [or]6j;
drought: [a]/draʊt/; [n]干旱,旱灾; [or]6j;
dual: [a]/ˈduːəl/; [adj]双的;双重的; [or]6j;
dub: [a]/dʌb/; [v]授予(称号);为(电影)配音;混录录制(音乐);  [n](西印度群岛的)强节奏音乐; [or]6j;
dubious: [a]/ˈduːbiəs/; [adj]可疑的;怀疑的;无把握的; [or]6j;
duplicate: [a]/ˈduːplɪkeɪt/; [n]复制品;  [v]复制;重复;  [adj]完全一样的; [or]6j;
dwarf: [a]/dwɔːrf/; [n]侏儒;  [v]变矮;发育不全;  [adj]矮生动物或植物的;矮小的;发育不全的;  [vt]使矮小;阻碍.的发育; [or]6j;
dwell: [a]/dwel/; [v](尤指作为常住居民)居住; [or]6j;
dynamo: [a]/ˈdaɪnəmoʊ/; [n]发电机;精力充沛的人; [or]6j;
eagle: [a]/ˈiːɡl/; [n]鹰,老鹰;鹰状标志;(高尔夫球赛中)少击两棒入穴的成绩;  [vt](高尔夫球赛中)比标准杆数少击两杆入; [or]6j;
earnings: [a]/ˈɜːrnɪŋz/; [n]工资;收入;收益; [or]6j;
earthenware: [a]/ˈɜːrθnwer/; [n]<总称>陶器;  [adj]陶制的; [or]6j;
eclipse: [a]/ɪˈklɪps/; [n](日,月)食;黯然失色;  [v]掩盖..的重要性;使暗淡; [or]6j;
ecology: [a]/iˈkɑːlədʒi/; [n]生态,生态学; [or]6j;
economic: [a]/ˌekəˈnɑːmɪk/; [adj]经济上的,经济学的;合算的;有利可图的; [or]6j;
economical: [a]/ˌekəˈnɑːmɪkl/; [adj]节约的;经济的;合算的; [or]6j;
economics: [a]/ˌekəˈnɑːmɪks/; [n]经济学;经济情况;经济; [or]6j;
economy: [a]/ɪˈkɑːnəmi/; [n]经济,经济制度;节约; [or]6j;
edible: [a]/ˈedəbl/; [adj]可食的; [or]6j;
edit: [a]/ˈedɪt/; [v]剪辑;编辑;校订;  [n]编辑<校订>工作; [or]6j;
editorial: [a]/ˌedɪˈtɔːriəl/; [adj]编辑的,编者的;  [n](报刊的)社论; [or]6j;
effective: [a]/ɪˈfektɪv/; [adj]有效的,有影响的;实际的;生效的; [or]6j;
efficiency: [a]/ɪˈfɪʃnsi/; [n]效率;功效;功率;性能; [or]6j;
efficient: [a]/ɪˈfɪʃnt/; [adj]效率高的;有能力的;能胜任的; [or]6j;
ego: [a]/ˈiːɡoʊ/; [n]自我;自负;自尊心; [or]6j;
eject: [a]/iˈdʒekt/; [v](使)弹出;喷射;放逐; [or]6j;
elaborate: [a]/ɪˈlæbəreɪt/; [adj]精心设计的,精巧的;复杂的;  [v]详细说明,详尽阐述;  [vt]变得复杂; [or]6j;
elastic: [a]/ɪˈlæstɪk/; [adj]有弹性的;可伸缩的,(系统或计划)灵活的;弹力材料制成的;  [n]松紧带,橡皮圈; [or]6j;
elbow: [a]/ˈelboʊ/; [n]手肘;衣服肘部;  [v]用肘推,挤; [or]6j;
elderly: [a]/ˈeldərli/; [adj]年老的,年长的;上年纪的人; [or]6j;
electric: [a]/ɪˈlektrɪk/; [adj]电的,电动的,带电的;刺激的;  [n]供电; [or]6j;
electrical: [a]/ɪˈlektrɪkl/; [adj]有关电的;电气科学的; [or]6j;
electrician: [a]/ɪˌlekˈtrɪʃn/; [n]电工;电气技师; [or]6j;
electricity: [a]/ɪˌlekˈtrɪsəti/; [n]电,电力;电流;电学; [or]6j;
electrode: [a]/ɪˈlektroʊd/; [n]电极; [or]6j;
electron: [a]/ɪˈlektrɑːn/; [n]电子; [or]6j;
electronic: [a]/ɪˌlekˈtrɑːnɪk/; [adj]电子的;电子学的;电子操控的;电子设备的; [or]6j;
electronics: [a]/ɪˌlekˈtrɑːnɪks/; [n]电子学,电子工业;电子设备,电子产品; [or]6j;
elegant: [a]/ˈelɪɡənt/; [adj]优美的,文雅的,漂亮雅致的,陈设讲究的; [or]6j;
element: [a]/ˈelɪmənt/; [n]元素;成分;要素;电炉,热水器等的电热元件,电热丝; [or]6j;
elemental: [a]/ˌelɪˈmentl/; [adj]基本的;自然力的; [or]6j;
elementary: [a]/ˌelɪˈmentri/; [adj]基本的;初级的;非常简单的; [or]6j;
elevate: [a]/ˈelɪveɪt/; [v]上升;提高;举起;提拔; [or]6j;
elicit: [a]/iˈlɪsɪt/; [v]引出;诱出;探出; [or]6j;
eligible: [a]/ˈelɪdʒəbl/; [adj]适合被选的,符合条件的;(尤指婚姻等)合适的,合意的; [or]6j;
eliminate: [a]/ɪˈlɪmɪneɪt/; [v]消灭,铲除;消除,根除;(在比赛中)淘汰; [or]6j;
elite: [a]/ɪˈliːt/; [n]精英;  [adj]高级的; [or]6j;
elliptical: [a]/ɪˈlɪptɪkl/; [adj]椭圆的;省略的; [or]6j;
eloquent: [a]/ˈeləkwənt/; [adj]有口才的;雄辩的;演说动人的; [or]6j;
embark: [a]/ɪmˈbɑːrk/; [v]上船或飞机;开始,着手,从事; [or]6j;
embarrass: [a]/ɪmˈbærəs/; [vt]使窘迫,使尴尬(尤指在社交场合);困窘,困扰; [or]6j;
embassy: [a]/ˈembəsi/; [n]大使馆;大使馆全体人员; [or]6j;
embed: [a]/ɪmˈbed/; [v]把.嵌入;使嵌入; [or]6j;
embody: [a]/ɪmˈbɑːdi/; [v]包含;体现,象征; [or]6j;
embroidery: [a]/ɪmˈbrɔɪdəri/; [n]刺绣(品),润色; [or]6j;
embryo: [a]/ˈembrioʊ/; [n]<动物学>胚胎; [or]6j;
emerge: [a]/iˈmɜːrdʒ/; [v]冲出,冒出;浮现;出现; [or]6j;
emergence: [a]/iˈmɜːrdʒəns/; [n]冒出;出现;浮现;发生; [or]6j;
emergency: [a]/iˈmɜːrdʒənsi/; [n]紧急情况;突发事件; [or]6j;
emigrate: [a]/ˈemɪɡreɪt/; [v]移居国外(或外地); [or]6j;
emission: [a]/iˈmɪʃn/; [n]排放物;放射物; [or]6j;
emotion: [a]/ɪˈmoʊʃn/; [n]感情;情绪;强烈的感情;激动; [or]6j;
emphasis: [a]/ˈemfəsɪs/; [n]强调;重点;重要性; [or]6j;
emphasize: [a]/ˈemfəsaɪz/; [v]强调;着重;使突出; [or]6j;
employment: [a]/ɪmˈplɔɪmənt/; [n]职业;雇佣;就业;运用; [or]6j;
enchant: [a]/ɪnˈtʃænt/; [v]施魔法于;吸引; [or]6j;
enclosure: [a]/ɪnˈkloʊʒər/; [n]四周有篱笆(或围墙等)的场所,围场;(信中的)附件; [or]6j;
encounter: [a]/ɪnˈkaʊntər/; [v]邂逅,遭遇,偶遇;  [n]偶然碰见,遭遇; [or]6j;
encourage: [a]/ɪnˈkɜːrɪdʒ/; [v]鼓励,支持;促使;怂恿; [or]6j;
encouragement: [a]/ɪnˈkɜːrɪdʒmənt/; [n]鼓励;激励; [or]6j;
endanger: [a]/ɪnˈdeɪndʒər/; [v]危及,危害; [or]6j;
endeavor: [a]/ɪnˈdevər/; [n]尝试,努力,尽力;  [v]努力,尽力; [or]6j;
endeavour: [a]/ɪnˈdevər/; [n]尝试;  [v]努力; [or]6j;
endurance: [a]/ɪnˈdʊrəns/; [n]忍耐力,耐性,耐用度; [or]6j;
endure: [a]/ɪnˈdʊr/; [v]忍受;持久;持续;容忍; [or]6j;
energetic: [a]/ˌenərˈdʒetɪk/; [adj]精力充沛的,充满活力的;有力的,积极的; [or]6j;
energize: [a]/ˈenərdʒaɪz/; [v]使活跃;给予精力;使兴奋; [or]6j;
enforce: [a]/ɪnˈfɔːrs/; [v]实施;执行;强制; [or]6j;
engage: [a]/ɪnˈɡeɪdʒ/; [vt]吸引住(注意力,兴趣);雇,聘;  [vi]使加入,使融入;订婚;  [v](军队)交战;啮合; [or]6j;
engagement: [a]/ɪnˈɡeɪdʒmənt/; [n]交战,战斗;约会,约定;婚约,订婚; [or]6j;
engine: [a]/ˈendʒɪn/; [n]引擎;发动机;  [v]给..装引擎; [or]6j;
engross: [a]/ɪnˈɡroʊs/; [v]独占;正式誊写;使全神贯注于;用大字体书写; [or]6j;
enhance: [a]/ɪnˈhæns/; [v]提高(强度,力量,数量等);增加,加强; [or]6j;
enlighten: [a]/ɪnˈlaɪtn/; [v]启发,开导; [or]6j;
enormous: [a]/ɪˈnɔːrməs/; [adj]极大的,极大量的;巨大的;庞大的; [or]6j;
enrich: [a]/ɪnˈrɪtʃ/; [v]使丰富;使富裕; [or]6j;
enroll: [a]/ɪnˈroʊl/; [v]入学,加入,登记,入伍; [or]6j;
ensue: [a]/ɪnˈsuː/; [v]跟着发生,接踵而来;因而产生; [or]6j;
enterprise: [a]/ˈentərpraɪz/; [n]企业(或事业)单位,公司;事业;事业心; [or]6j;
entertainment: [a]/ˌentərˈteɪnmənt/; [n]娱乐;招待,款待; [or]6j;
enthusiasm: [a]/ɪnˈθuːziæzəm/; [n]热情,热心,热忱;热衷的活动,热爱的事物; [or]6j;
enthusiastic: [a]/ɪnˌθuːziˈæstɪk/; [adj]狂热的,极感兴趣的,热情的; [or]6j;
entitle: [a]/ɪnˈtaɪtl/; [v]给(书)题名;给予.权利; [or]6j;
entrepreneur: [a]/ˌɑːntrəprəˈnɜːr/; [n]企业家,演出承包人; [or]6j;
envious: [a]/ˈenviəs/; [adj]羡慕的,嫉妒的; [or]6j;
environment: [a]/ɪnˈvaɪrənmənt/; [n]环境;外界;工作平台; [or]6j;
environmental: [a]/ɪnˌvaɪrənˈmentl/; [adj]周围的;环境的; [or]6j;
envisage: [a]/ɪnˈvɪzɪdʒ/; [v]想象,设想; [or]6j;
epidemic: [a]/ˌepɪˈdemɪk/; [adj]流行性的,传染的;  [n]流行病,传染病,(犯罪等的)盛行; [or]6j;
epilogue: [a]/ˈepɪlɔːɡ/; [n]收场白;尾声; [or]6j;
episode: [a]/ˈepɪsoʊd/; [n]插曲,片断;连续剧的一集;一段经历; [or]6j;
epoch: [a]/ˈepək/; [n]时期;新时代; [or]6j;
equality: [a]/iˈkwɑːləti/; [n]同等,平等;<数>等式; [or]6j;
equator: [a]/ɪˈkweɪtər/; [n]赤道; [or]6j;
equilibrium: [a]/ˌiːkwɪˈlɪbriəm/; [n](心态情感等)平静;平衡; [or]6j;
equip: [a]/ɪˈkwɪp/; [v]装备;具备; [or]6j;
equivalent: [a]/ɪˈkwɪvələnt/; [adj]相等的;等值的;  [n]同义词;等价物; [or]6j;
erase: [a]/ɪˈreɪs/; [v](计算机)擦除;抹去;擦掉; [or]6j;
erect: [a]/ɪˈrekt/; [v]搭建,竖起;建造,建立;  [adj]直立的,垂直的; [or]6j;
erosion: [a]/ɪˈroʊʒn/; [n]侵蚀;腐蚀;磨损;削弱;减少; [or]6j;
errand: [a]/ˈerənd/; [n]差使;差事;使命; [or]6j;
erroneous: [a]/ɪˈroʊniəs/; [adj]错误的; [or]6j;
erupt: [a]/ɪˈrʌpt/; [v]爆发;(火山,喷泉,蒸汽等)喷发;使迸发;喷射出; [or]6j;
eruption: [a]/ɪˈrʌpʃn/; [n]喷发;(情绪)爆发;出疹; [or]6j;
escort: [a]/ˈeskɔːrt/; [n]护送者;  [v]护送; [or]6j;
essence: [a]/ˈesns/; [n]本质,实质;精髓,精华; [or]6j;
essential: [a]/ɪˈsenʃl/; [adj]必不可少的,必要的;本质的;重要的;基本的;  [n]要素;必需品; [or]6j;
establish: [a]/ɪˈstæblɪʃ/; [v]建立;确立;使安全;使成为; [or]6j;
estate: [a]/ɪˈsteɪt/; [n]地产,(上有大片建筑物的)土地,住宅,财产,遗产; [or]6j;
esthetic: [a]/esˈθetɪk/; [adj]美学的;悦目的;美的;  [n]审美观,美学;审美家; [or]6j;
estimate: [a]/ˈestɪmət/; [v]估价,估计,评价;  [n]估计,评价; [or]6j;
eternal: [a]/ɪˈtɜːrnl/; [adj]永恒的,永不改变的; [or]6j;
ethical: [a]/ˈeθɪkl/; [adj]伦理的;道德的;凭处方出售的;  [n]处方药; [or]6j;
ethics: [a]/'eθɪks/; [n]行为准则;道德规范; [or]6j;
ethnic: [a]/ˈeθnɪk/; [adj]种族的,少数民族的;  [n]少数民族成员;人种学; [or]6j;
evacuate: [a]/ɪˈvækjueɪt/; [v]撤离,疏散,排清; [or]6j;
evaluate: [a]/ɪˈvæljueɪt/; [v]评价;评估; [or]6j;
evenly: [a]/ˈiːvnli/; [adv]均匀地,平坦地;不偏不倚地; [or]6j;
everlasting: [a]/ˌevərˈlæstɪŋ/; [adj]永恒的,持久的;无止境的;耐用的; [or]6j;
evidence: [a]/ˈevɪdəns/; [v]证明;  [n]证据,证明;证物,证词; [or]6j;
evident: [a]/ˈevɪdənt/; [adj]显然的,明显的,明白的; [or]6j;
evil: [a]/ˈiːvl/; [adj]邪恶的,罪恶的;  [n]邪恶,罪恶; [or]6j;
evoke: [a]/ɪˈvoʊk/; [v]唤起;引起;使人想起; [or]6j;
evolution: [a]/ˌevəˈluːʃn/; [n]进化,演变;发展; [or]6j;
exaggerate: [a]/ɪɡˈzædʒəreɪt/; [vi]夸张;  [vt]夸大,夸张;使扩大; [or]6j;
exceed: [a]/ɪkˈsiːd/; [v]超过;胜过;超出; [or]6j;
excel: [a]/ɪkˈsel/; [vi]胜出;  [vt]优于; [or]6j;
exception: [a]/ɪkˈsepʃn/; [n]例外(的人或事),除外; [or]6j;
exceptional: [a]/ɪkˈsepʃənl/; [adj]优越的,杰出的;异常的; [or]6j;
excerpt: [a]/ˈeksɜːrpt/; [n]摘录,节选;  [v]摘,选;引用; [or]6j;
excess: [a]/ɪkˈses/; [adj]额外的,过量的,过度的,附加的;  [n]超越,超过,过度; [or]6j;
excessive: [a]/ɪkˈsesɪv/; [adj]过多的; [or]6j;
excessively: [a]/ɪkˈsesɪvli/; [adv]过分地,非常地; [or]6j;
exchange: [a]/ɪksˈtʃeɪndʒ/; [v]交换,互换;交流;进行易货贸易;  [n]交换;交易所;(货币的)兑换; [or]6j;
exclaim: [a]/ɪkˈskleɪm/; [v]呼叫,惊叫; [or]6j;
exclamation: [a]/ˌekskləˈmeɪʃn/; [n]感叹,惊叹,惊呼;惊叹词; [or]6j;
exclude: [a]/ɪkˈskluːd/; [vt]不包括;排挤;排除;驱逐,赶出; [or]6j;
exclusive: [a]/ɪkˈskluːsɪv/; [adj]独有的;奢华的;排外的;  [n]独家新闻; [or]6j;
exclusively: [a]/ɪkˈskluːsɪvli/; [adv]专门地;特定地;排外地;仅仅; [or]6j;
excursion: [a]/ɪkˈskɜːrʒn/; [n]远足;短途旅行; [or]6j;
execute: [a]/ˈeksɪkjuːt/; [v]处决;完成(动作);实行;执行(计划); [or]6j;
execution: [a]/ˌeksɪˈkjuːʃn/; [n]死刑;实行,执行,履行;演奏,表演; [or]6j;
executive: [a]/ɪɡˈzekjətɪv/; [n]执行者;经理;行政人员;  [adj]执行的; [or]6j;
exemplify: [a]/ɪɡˈzemplɪfaɪ/; [v]举例说明;例示,是..的典范; [or]6j;
exert: [a]/ɪɡˈzɜːrt/; [v]尽(力),运用,发挥; [or]6j;
exertion: [a]/ɪɡˈzɜːrʃn/; [n]用力;运用; [or]6j;
exhaust: [a]/ɪɡˈzɔːst/; [v]使筋疲力尽;耗尽;详尽论述;  [n]排气装置;废气; [or]6j;
exhausted: [a]/ɪɡˈzɔːstɪd/; [adj]精疲力竭的;耗尽的;用完的; [or]6j;
exhibit: [a]/ɪɡˈzɪbɪt/; [n]展览会,陈列品;  [v]展览,陈列; [or]6j;
existence: [a]/ɪɡˈzɪstəns/; [n]存在;生活方式; [or]6j;
exotic: [a]/ɪɡˈzɑːtɪk/; [adj]奇异的,珍奇的,来自异国的; [or]6j;
expand: [a]/ɪkˈspænd/; [v]膨胀;扩大;  [vt]详细展开; [or]6j;
expanding: [a]/ɪkˈspændɪŋ/; [adj]扩展的;详述的;  [v]扩大;扩展; [or]6j;
expansion: [a]/ɪkˈspænʃn/; [n]扩大,扩充,扩张,膨胀; [or]6j;
expedition: [a]/ˌekspəˈdɪʃn/; [n]远征队;探险;短途旅行;迅速; [or]6j;
expel: [a]/ɪkˈspel/; [v]罚出,开除;排出;开除;驱逐; [or]6j;
expend: [a]/ɪkˈspend/; [v]消费,用尽; [or]6j;
expenditure: [a]/ɪkˈspendɪtʃər/; [n](时间,金钱等的)花费,支出,消耗; [or]6j;
expense: [a]/ɪkˈspens/; [n]开销,开支;花费,费用;代价; [or]6j;
experimentally: [a]/ɪkˌsperɪˈmentəli/; [adv]实验上地;用实验方法; [or]6j;
experimentation: [a]/ɪkˌsperɪmenˈteɪʃn/; [n]实验;试验;实验法; [or]6j;
expert: [a]/ˈekspɜːrt/; [n]专家;  [adj]熟练的,专业的; [or]6j;
expertise: [a]/ˌekspɜːrˈtiːz/; [n]专长,专门的知识或技能; [or]6j;
expire: [a]/ɪkˈspaɪər/; [v]期满,(期限)终止;断气,死亡; [or]6j;
explicit: [a]/ɪkˈsplɪsɪt/; [adj]充分表达清楚的,明确的;直率的,直截了当的;〔描绘性或暴力的语言或画面〕清晰露骨的; [or]6j;
exploit: [a]/ɪkˈsplɔɪt/; [v]剥削,利用;开发,开拓;  [n]辉煌功绩; [or]6j;
exploration: [a]/ˌekspləˈreɪʃn/; [n]探索;研究; [or]6j;
explore: [a]/ɪkˈsplɔːr/; [v]探险,探索,尝试; [or]6j;
expose: [a]/ɪkˈspoʊz/; [v]暴露;揭露;使遭受; [or]6j;
exposition: [a]/ˌekspəˈzɪʃn/; [n]讲解;阐述;展览会,博览会; [or]6j;
expression: [a]/ɪkˈspreʃn/; [n]表情,神情;表达,表述;措辞; [or]6j;
exquisite: [a]/ɪkˈskwɪzɪt/; [adj]精致的,精选的;细腻的;强烈的;  [n]过分讲究穿戴的人; [or]6j;
extensive: [a]/ɪkˈstensɪv/; [adj]广阔的;广泛的; [or]6j;
extent: [a]/ɪkˈstent/; [n]范围;程度;宽度;长度; [or]6j;
external: [a]/ɪkˈstɜːrnl/; [adj]外面的,外部的;外国的; [or]6j;
extinct: [a]/ɪkˈstɪŋkt/; [adj]灭绝的;破灭了的,消亡了的; [or]6j;
extinction: [a]/ɪkˈstɪŋkʃn/; [n]熄灭,灭绝,消失; [or]6j;
extinguish: [a]/ɪkˈstɪŋɡwɪʃ/; [v]熄灭,扑灭;根除,消灭; [or]6j;
extract: [a]/ɪkˈstrækt/; [v]取出;提取;摘录;设法得到;索取;  [n]摘录;提出物; [or]6j;
extraction: [a]/ɪkˈstrækʃn/; [n]抽出,取出;家世,出身;抽出物; [or]6j;
extraordinarily: [a]/ɪkˌstrɔːrdəˈnerəli/; [adv]格外地;非常好地; [or]6j;
extraordinary: [a]/ɪkˈstrɔːrdəneri/; [adj]非同寻常的;特别的; [or]6j;
extravagant: [a]/ɪkˈstrævəɡənt/; [adj]奢侈的,无节制的; [or]6j;
extreme: [a]/ɪkˈstriːm/; [adj]极端的;极远的;极限的;极度的;偏激的;  [n]极端;极度(状态),最大程度; [or]6j;
fabric: [a]/ˈfæbrɪk/; [n]布料,织物;质地,结构; [or]6j;
fabricate: [a]/ˈfæbrɪkeɪt/; [v]建造,制造,伪造(文件等),捏造,编造(谎言,借口等); [or]6j;
fabrication: [a]/ˌfæbrɪˈkeɪʃn/; [n]制作;构成;捏造;伪造物;装配工; [or]6j;
fabulous: [a]/ˈfæbjələs/; [adj]极好的;极妙的;极为巨大的;寓言中的;传说中的; [or]6j;
facet: [a]/ˈfæsɪt/; [n](多面体的)面,小平面;琢面,侧面;  [vt]在.上琢面; [or]6j;
facilitate: [a]/fəˈsɪlɪteɪt/; [v]为他人提供方便;使便利;  [vt]促进; [or]6j;
faction: [a]/ˈfækʃn/; [n]派别,小集团,小派系;派系斗争,内讧; [or]6j;
factor: [a]/ˈfæktər/; [n]因素;<数>因子,商; [or]6j;
factual: [a]/ˈfæktʃuəl/; [adj]事实的;真实的; [or]6j;
faculty: [a]/ˈfæklti/; [n]教职工,全体教员;系;科;能力; [or]6j;
faith: [a]/feɪθ/; [n]信任;信心;信仰;  [int]实在,确实; [or]6j;
fake: [a]/feɪk/; [adj]假的,伪造的;  [n]骗子;假货,赝品;  [v]假造,杜撰;伪造;冒充,假装;假装; [or]6j;
famine: [a]/ˈfæmɪn/; [n]饥荒;严重的缺乏; [or]6j;
fantastic: [a]/fænˈtæstɪk/; [adj]极好的;极大的;不真实的;荒诞离奇的;不可思议的;  [n]〈古〉古怪的人; [or]6j;
fantasy: [a]/ˈfæntəsi/; [n]幻想,想象;幻想作品;  [vi]奏幻想曲;  [vt]想像;幻想;  [adj]虚幻的; [or]6j;
fascinate: [a]/ˈfæsɪneɪt/; [v]使着迷;使神魂颠倒;吸引注意; [or]6j;
fastener: [a]/ˈfæsnər/; [n]纽扣;使系牢之物; [or]6j;
fatal: [a]/ˈfeɪtl/; [adj]致命的;毁灭性的;决定性的; [or]6j;
fatigue: [a]/fəˈtiːɡ/; [n]疲乏,劳累; [or]6j;
fax: [a]/fæks/; [n]传真(机);传真件;  [v]用传真传输; [or]6j;
fearless: [a]/ˈfɪrləs/; [adj]大胆的,勇敢的,无畏的; [or]6j;
feasible: [a]/ˈfiːzəbl/; [adj]可行的,行得通的; [or]6j;
feast: [a]/fiːst/; [n]盛宴;筵席;节日;  [v]尽情地吃; [or]6j;
feat: [a]/fiːt/; [n]绝技,功绩,武艺; [or]6j;
feature: [a]/ˈfiːtʃər/; [n]面貌,相貌;特征,特点;特辑;  [vt]使突出,以.为特色;  [vi]起重要作用,作为主要角色; [or]6j;
federal: [a]/ˈfedərəl/; [adj]联邦制的;联邦政府的; [or]6j;
federation: [a]/ˌfedəˈreɪʃn/; [n]同盟,联盟,联邦; [or]6j;
feeble: [a]/ˈfiːbl/; [adj]虚弱的; [or]6j;
fellowship: [a]/ˈfeloʊʃɪp/; [n]友谊;伙伴关系;交情;团体;奖学金; [or]6j;
feminine: [a]/ˈfemənɪn/; [adj]女性的,娇柔的;  [n]女性;温柔的女性;<语>阴性,阴性词; [or]6j;
ferrous: [a]/ˈferəs/; [adj]含铁的; [or]6j;
ferry: [a]/ˈferi/; [n]渡船,渡轮;渡口;  [v]运送;渡运(人,车或物等); [or]6j;
fertilizer: [a]/ˈfɜːrtəlaɪzər/; [n]肥料,化肥; [or]6j;
feudal: [a]/ˈfjuːdl/; [adj]领地的;封建制度的;封建时代的;世仇的; [or]6j;
fiber: [a]/ˈfaɪbər/; [n]纤维(物质);纤维组织;(植物) 纤维; [or]6j;
fiction: [a]/ˈfɪkʃn/; [n]虚构;想象;小说; [or]6j;
fighter: [a]/ˈfaɪtər/; [n]战士;战斗机,歼击机; [or]6j;
figure: [a]/ˈfɪɡjər/; [n]体型;人物,人影;形状;数字;  [v]想出,估计,计算出; [or]6j;
filth: [a]/fɪlθ/; [n]污秽图片;污物;对警察的冒犯言辞; [or]6j;
fin: [a]/fɪn/; [n]鳍; [or]6j;
finance: [a]/ˈfaɪnæns/; [v]资金供给,筹措资金;  [n]金融,财政,资金; [or]6j;
financial: [a]/faɪˈnænʃl/; [adj]金融的;财政的;财务的; [or]6j;
finely: [a]/ˈfaɪnli/; [adv]细小地;美好地; [or]6j;
finite: [a]/ˈfaɪnaɪt/; [adj]有限的;限定的; [or]6j;
fireplace: [a]/ˈfaɪərpleɪs/; [n]壁炉; [or]6j;
firmness: [a]/ˈfɜːrmnəs/; [n]坚定;稳固;稳定;坚(硬)度; [or]6j;
fission: [a]/ˈfɪʃn/; [n]<原子能>裂变,裂开,<生物学>分裂生殖; [or]6j;
fist: [a]/fɪst/; [n]拳头;笔迹;  [vt]用拳头打;握成拳;紧握; [or]6j;
fitness: [a]/ˈfɪtnəs/; [n]适当,恰当,健康; [or]6j;
fixture: [a]/ˈfɪkstʃər/; [n]固定装置;体育项目; [or]6j;
flake: [a]/fleɪk/; [n]薄片;  [v]使成薄片;剥落;雪片般落下; [or]6j;
flank: [a]/flæŋk/; [v]位于.的侧面;  [n]肋,肋腹,侧翼; [or]6j;
flannel: [a]/ˈflænl/; [n]法兰绒;绒布;法兰绒衣服;花言巧语;托辞;  [adj]法兰绒制的; [or]6j;
flap: [a]/flæp/; [n]慌乱(状态);拍打,挥动;(一端固定,可自由掀动的布或皮的) 垂悬平片;  [v]拍打,挥动; [or]6j;
flare: [a]/fler/; [v]燃烧(摇曳着);突然发怒;  [n]照明弹;摇曳的火焰;闪光信号; [or]6j;
flask: [a]/flæsk/; [n]烧瓶;长颈瓶;扁瓶; [or]6j;
flat: [a]/flæt/; [adj]平坦的;浅的;平面的;单调的;  [n]平面;公寓;  [adv]平直地; [or]6j;
flatten: [a]/ˈflætn/; [v]把..弄平; [or]6j;
flatter: [a]/ˈflætər/; [v]阿谀,使高兴;(肖像等)胜过(真人真物);自鸣得意,自以为是; [or]6j;
flaw: [a]/flɔː/; [n]瑕疵;缺点;  [v]使有缺陷;使不完美;有瑕疵; [or]6j;
flee: [a]/fliː/; [v]逃走,(时间)飞逝;逃离;避开; [or]6j;
flexible: [a]/ˈfleksəbl/; [adj]易曲的,柔软的,灵活的; [or]6j;
fling: [a]/flɪŋ/; [v]掷,抛;猛烈地移动;投入;  [n]尽情欢乐的一阵,一时的放纵; [or]6j;
flip: [a]/flɪp/; [v]把.往上抛;掷;抽打;用指轻弹;空翻;  [adj]轻率的,无礼的; [or]6j;
float: [a]/floʊt/; [vi]漂浮,飘浮,浮现;散布;漂泊;  [vt]使漂浮;散布;  [n]浮标,漂浮物,漂浮; [or]6j;
fluctuate: [a]/ˈflʌktʃueɪt/; [v]波动;起伏;涨落; [or]6j;
fluctuation: [a]/ˌflʌktʃuˈeɪʃn/; [n]波动;起伏; [or]6j;
flush: [a]/flʌʃ/; [v]脸红;清除;赶出;冲掉;  [n]发红;冲掉;脸红;  [adj]挥霍的,浪费的;富有的;完全齐平的; [or]6j;
flutter: [a]/ˈflʌtər/; [n]激动不安,紧张;  [v]飘动,飘扬;(鸟等)振翼,拍翅而飞;  [vi](心脏等)快速跳动; [or]6j;
flux: [a]/flʌks/; [n]流动,不断的变动; [or]6j;
foam: [a]/foʊm/; [n]泡沫;泡沫体;泡沫塑料;  [vi]吐白沫,起泡沫; [or]6j;
focus: [a]/ˈfoʊkəs/; [n]焦点,聚焦;焦距;关注;  [v]使聚焦,集中注意力; [or]6j;
foil: [a]/fɔɪl/; [n]箔;锡箔纸;衬托;  [v]挫败;使受挫折; [or]6j;
fold: [a]/foʊld/; [v]折叠;彻底失败;合拢;  [n]折叠;褶; [or]6j;
follower: [a]/ˈfɑːloʊər/; [n]追随者;信徒; [or]6j;
footpath: [a]/ˈfʊtpæθ/; [n]小路,人行道; [or]6j;
force: [a]/fɔːrs/; [v]强迫;推动;凭借武力前进;  [n]力量;武力;势力; [or]6j;
ford: [a]/fɔːrd/; [v]涉水,渡河;  [n]浅滩; [or]6j;
fore: [a]/fɔːr/; [adj]在前部的,以前的;  [adv]在前面,在船头;  [n]前部,船头;  prep. 在前; [or]6j;
foremost: [a]/ˈfɔːrmoʊst/; [adj](位置或时间),最先的;首要的;  [adv]首先,第一; [or]6j;
forerunner: [a]/ˈfɔːrʌnər/; [n]先驱;祖先;前兆;预兆; [or]6j;
foresee: [a]/fɔːrˈsiː/; [v]预知,预料,预测; [or]6j;
forge: [a]/fɔːrdʒ/; [n]熔炉;锻工车间;铁匠店;  [v]锻造;经锻炼而形成;伪造;推进,加强; [or]6j;
formal: [a]/ˈfɔːrml/; [adj]正式的;正规的;规范的,合乎规矩的;形式上的;礼节上的;  [n]<美>须穿礼服的社交集会;<口>夜礼服; [or]6j;
format: [a]/ˈfɔːrmæt/; [n]版式;设计;格式;  [v]设计一个版式;使格式化;设计.的版面; [or]6j;
formidable: [a]/ˈfɔːrmɪdəbl/; [adj]令人畏惧的;可怕的;难以克服的;难应付的; [or]6j;
formula: [a]/ˈfɔːrmjələ/; [n]公式,方程式;配方;方案;方法;配方奶; [or]6j;
formulate: [a]/ˈfɔːrmjuleɪt/; [v]构想出(计划,方法等);系统地阐述; [or]6j;
formulation: [a]/ˌfɔːrmjuˈleɪʃn/; [n]表述方式;构想,规划;公式化; [or]6j;
forsake: [a]/fərˈseɪk/; [v]放弃;抛弃,离开; [or]6j;
fort: [a]/fɔːrt/; [n]堡垒,要塞; [or]6j;
forthcoming: [a]/ˌfɔːrθˈkʌmɪŋ/; [adj]即将出现的,即将到来的;唾手可得的,可用的;乐于提供信息的; [or]6j;
fortress: [a]/ˈfɔːrtrəs/; [n]堡垒;要塞; [or]6j;
forum: [a]/ˈfɔːrəm/; [n]论坛;讨论会; [or]6j;
fossil: [a]/ˈfɑːsl/; [n]化石;  [adj]从地下发掘出来的;化石的;属于旧时代的;陈腐的; [or]6j;
foster: [a]/ˈfɔːstər/; [adj]收养的;  [vt]养育;培养,促进; [or]6j;
foul: [a]/faʊl/; [adj]难闻的,发臭的;糟透了的;污秽的;犯规的;  [n]犯规;  [vi]犯规;  [vt]弄脏,使污秽;使纠缠; [or]6j;
fowl: [a]/faʊl/; [n]家禽;鸟类; [or]6j;
fraction: [a]/ˈfrækʃn/; [n]部分,片断,碎片;分数; [or]6j;
fracture: [a]/ˈfræktʃər/; [n]骨折;折断;裂口;  [v]使折断;使骨折; [or]6j;
fragile: [a]/ˈfrædʒl/; [adj]易碎的;易损坏的;虚弱的;脆弱的; [or]6j;
fragrance: [a]/ˈfreɪɡrəns/; [n]香水;香味;芳香; [or]6j;
fragrant: [a]/ˈfreɪɡrənt/; [adj]芬芳的;香的; [or]6j;
frantic: [a]/ˈfræntɪk/; [adj]疯狂的;狂乱的;慌乱的; [or]6j;
fraud: [a]/frɔːd/; [n]欺诈,诈骗;骗子; [or]6j;
frequency: [a]/ˈfriːkwənsi/; [n]频繁;屡次,经常发生;次数;频率; [or]6j;
frequent: [a]/ˈfriːkwənt/; [adj]时常的,频繁的;  [v]常去,常到; [or]6j;
freshen: [a]/ˈfreʃn/; [v]使清新,使新鲜,使精神焕发;添(饮料);增强; [or]6j;
fret: [a]/fret/; [v]使烦恼,使焦急;使腐蚀;使磨损;  [n](斑卓琴,吉他,曼陀林琴等弦乐器指板上定音的)档;侵蚀; [or]6j;
friction: [a]/ˈfrɪkʃn/; [n]摩擦,摩擦力;争执,冲突; [or]6j;
fright: [a]/fraɪt/; [n]恐怖,惊吓; [or]6j;
frightful: [a]/ˈfraɪtfl/; [adj]可怕的;惊人的;使惊恐的;讨厌的;非常的; [or]6j;
fringe: [a]/frɪndʒ/; [n]刘海;一排;边缘;穗,流苏;  [v]形成.的边缘; [or]6j;
frock: [a]/frɑːk/; [n]僧袍;(妇女,小儿的连衣裙式)长衣; [or]6j;
frustrate: [a]/ˈfrʌstreɪt/; [v]使灰心;挫败;阻挠; [or]6j;
fuel: [a]/ˈfjuːəl/; [v]给.加燃料;  [n]燃料;刺激因素; [or]6j;
fulfill: [a]/fʊl'fɪl/; [v]履行,实现,完成;满足(愿望,要求等),使满意; [or]6j;
function: [a]/ˈfʌŋkʃn/; [n]功能,作用;函数;应变量;盛大聚会;职务,职责;  [v]起作用;正常运转; [or]6j;
fund: [a]/fʌnd/; [n]资金,基金;存款;  [v]拨款,提供基金; [or]6j;
fundamental: [a]/ˌfʌndəˈmentl/; [adj]基本的,根本的;重要的;基础的;  [n]基本原理;基本原则; [or]6j;
furious: [a]/ˈfjʊriəs/; [adj]狂怒的;愤怒的;猛烈的; [or]6j;
furnish: [a]/ˈfɜːrnɪʃ/; [v](用家具等)布置(房间,公寓等);供应,提供; [or]6j;
furniture: [a]/ˈfɜːrnɪtʃər/; [n]家具;装置;设备; [or]6j;
fury: [a]/ˈfjʊri/; [n]狂怒,暴怒; [or]6j;
fuse: [a]/fjuːz/; [n]导火线,引信,保险丝;  [v](使)因保险丝熔断而中断工作,熔合,合并; [or]6j;
fuss: [a]/fʌs/; [n]大惊小怪,小题大做;  [v](为小事)烦恼,过于忧虑; [or]6j;
galaxy: [a]/ˈɡæləksi/; [n]星系; [or]6j;
gallery: [a]/ˈɡæləri/; [n]美术馆,画廊;(大厅的)旁听席,边座; [or]6j;
gamble: [a]/ˈɡæmbl/; [v]赌博;投机;打赌;  [n]赌博;冒险;  [vt]赌输; [or]6j;
garbage: [a]/ˈɡɑːrbɪdʒ/; [n]垃圾桶;垃圾; [or]6j;
garment: [a]/ˈɡɑːrmənt/; [n]服装;  [vt]给 ... 披上衣服;覆上...; [or]6j;
gasp: [a]/ɡæsp/; [v]喘气;渴望;气喘吁吁地说出;  [n]喘气; [or]6j;
gathering: [a]/ˈɡæðərɪŋ/; [n]聚会,集会; [or]6j;
gauge: [a]/ɡeɪdʒ/; [n]测量仪;尺度,标准;  [v]估计,判断;计量; [or]6j;
gaze: [a]/ɡeɪz/; [v]凝视,注视;  [n]凝视,注视; [or]6j;
gear: [a]/ɡɪr/; [n]档位;齿轮;装备;衣物;  [v]使适合; [or]6j;
gene: [a]/dʒiːn/; [n]基因; [or]6j;
generate: [a]/ˈdʒenəreɪt/; [v]产生(热,电等能量),创造; [or]6j;
generosity: [a]/ˌdʒenəˈrɑːsəti/; [n]慷慨,大方; [or]6j;
generous: [a]/ˈdʒenərəs/; [adj]慷慨的;充裕的,宽厚的;肥沃的; [or]6j;
genetic: [a]/dʒəˈnetɪk/; [adj]遗传的,起源的; [or]6j;
genuine: [a]/ˈdʒenjuɪn/; [adj]真正的;真的;真诚的; [or]6j;
geographical: [a]/ˌdʒiːəˈɡræfɪkl/; [adj]地理的,地理学的; [or]6j;
geology: [a]/dʒiˈɑːlədʒi/; [n]地质学,(某一地区的)地质; [or]6j;
geometrical: [a]/ˌdʒiəˈmetrɪk(ə)l/; [adj]几何学的;几何的; [or]6j;
gigantic: [a]/dʒaɪˈɡæntɪk/; [adj]巨大的; [or]6j;
giggle: [a]/ˈɡɪɡl/; [v]咯咯地笑,傻笑;  [n]咯咯地笑,傻笑; [or]6j;
ginger: [a]/ˈdʒɪndʒər/; [n]生姜;姜黄色;  [v]使有活力,使兴奋;  [adj]姜黄色的; [or]6j;
glamour: [a]/ˈɡlæmər/; [n]魅力;诱惑力; [or]6j;
glance: [a]/ɡlæns/; [v]看一下;  [n]一瞥,扫视; [or]6j;
glare: [a]/ɡler/; [v]怒目而视;发出强光;  [n]眩目的光;瞪眼; [or]6j;
gleam: [a]/ɡliːm/; [vi]闪烁;使发出微光;  [n]闪光;微光;闪现; [or]6j;
glide: [a]/ɡlaɪd/; [v]滑翔;滑动;  [n]滑音,延音;滑行; [or]6j;
glider: [a]/ˈɡlaɪdər/; [n]滑翔机;滑翔伞; [or]6j;
glitter: [a]/ˈɡlɪtər/; [v]闪闪发光,闪耀;  [n]灿烂的光辉,闪光; [or]6j;
global: [a]/ˈɡloʊbl/; [adj]全球的;全面的; [or]6j;
gloom: [a]/ɡluːm/; [n]昏暗,阴暗;忧郁,沮丧;  [v]变忧郁,变忧愁; [or]6j;
gloomy: [a]/ˈɡluːmi/; [adj]愁容满面的,阴暗的,没有希望的; [or]6j;
glorify: [a]/ˈɡlɔːrɪfaɪ/; [v]赞美,赞扬,崇拜(神);美化; [or]6j;
glossary: [a]/ˈɡlɑːsəri/; [n]词汇表,术语汇编; [or]6j;
glow: [a]/ɡloʊ/; [n]光辉,红光,热情;  [v]发光,发红光,发热; [or]6j;
gnaw: [a]/nɔː/; [v]啃,咬,消耗,侵蚀; [or]6j;
goddess: [a]/ˈɡɑːdəs/; [n]女神;绝代佳人; [or]6j;
gorgeous: [a]/ˈɡɔːrdʒəs/; [adj]绚丽的;极好的;令人愉快的; [or]6j;
gossip: [a]/ˈɡɑːsɪp/; [n]流言蜚语,爱传流言的人;  [v]闲聊,传播流言蜚语; [or]6j;
gown: [a]/ɡaʊn/; [n]女礼服;女裙服;长袍; [or]6j;
grab: [a]/ɡræb/; [v]攫取,抓取,掠夺;赶紧做;吸引;  [n]抓取,非法所得; [or]6j;
gracious: [a]/ˈɡreɪʃəs/; [adj]和善的;亲切的;优美的;奢华的; [or]6j;
gradient: [a]/ˈɡreɪdiənt/; [n]斜坡;倾斜度;坡度;渐变;  [adj]倾斜的;渐倾的; [or]6j;
graduate: [a]/ˈɡrædʒuət/; [v]毕业;渐变;渐渐变为;取得资格;授予.学位;  [n]大学毕业生;学位获得者;  [adj]毕业的;研究生的; [or]6j;
grain: [a]/ɡreɪn/; [n]谷物种子,谷物,少量;格令;颗粒;纹理;  [v]使成粒状; [or]6j;
gramophone: [a]/ˈɡræməfoʊn/; [n]留声机; [or]6j;
granite: [a]/ˈɡrænɪt/; [n]花岗岩; [or]6j;
grant: [a]/ɡrænt/; [v]给予,许可,授予;承认;  [n]许可;拨款,补助金; [or]6j;
graphic: [a]/ˈɡræfɪk/; [adj]形象的;图表的;  [n]图,图表; [or]6j;
graphite: [a]/ˈɡræfaɪt/; [n]石墨; [or]6j;
grasshopper: [a]/ˈɡræshɑːpər/; [n]蚱蜢; [or]6j;
grave: [a]/ɡreɪv/; [adj]严重的;严肃的,庄重的;  [n]墓;  [adv]沉重地,庄重地;极慢地;  [vt]雕刻;铭记; [or]6j;
gravel: [a]/ˈɡrævl/; [n]沙砾,小石,砾石;  [adj]粗重而沙哑的,刺耳的;  [vt]用砾石铺;使困惑; [or]6j;
gravitation: [a]/ˌɡrævɪˈteɪʃn/; [n]重力;万有引力;地心吸力; [or]6j;
graze: [a]/ɡreɪz/; [v](牲畜)吃草;放牧;擦过;  [n]擦,擦伤; [or]6j;
grease: [a]/ɡriːs/; [n]油脂;动物脂;润滑脂;  [v]抹油;使润滑; [or]6j;
greed: [a]/ɡriːd/; [n]贪欲,贪婪;贪吃; [or]6j;
grief: [a]/ɡriːf/; [n](因不幸,丧失等而)悲伤,悲痛;悲痛的缘由,伤心事;担心,忧虑; [or]6j;
grieve: [a]/ɡriːv/; [v]伤心,悲痛;  [vi]使悲伤,使伤心; [or]6j;
grill: [a]/ɡrɪl/; [n]烤架;  [v]烤;拷问; [or]6j;
grim: [a]/ɡrɪm/; [adj]严酷的,无情的;令人沮丧的,令人失望的;讨厌的,糟糕的; [or]6j;
grin: [a]/ɡrɪn/; [v]露齿而笑,咧嘴一笑;  [n]龇牙笑; [or]6j;
grip: [a]/ɡrɪp/; [v]握紧,抓牢;  [n]紧握,握力; [or]6j;
groan: [a]/ɡroʊn/; [v]呻吟;抱怨;  [n]呻吟; [or]6j;
groom: [a]/ɡruːm/; [n]新郎;马夫;  [v]修整;装扮;照料; [or]6j;
groove: [a]/ɡruːv/; [n]<建>凹槽;最佳状态;槽;惯例;  [v]开槽于;形成沟槽; [or]6j;
grope: [a]/ɡroʊp/; [v]摸索,探索,动手动脚; [or]6j;
gross: [a]/ɡroʊs/; [adj]总的,毛重的;恶心的;粗鲁的;  [n]总量,总额;  [adv]总共地;  [vt]总共赚得; [or]6j;
grove: [a]/ɡroʊv/; [n]小树林;果园; [or]6j;
growl: [a]/ɡraʊl/; [v](动物)咆哮,吼叫;  [n]咆哮声,怨言,打嗝声; [or]6j;
grumble: [a]/ˈɡrʌmbl/; [v]埋怨;发牢骚;咕哝;  [n]隆隆响声;抱怨,怨言; [or]6j;
grunt: [a]/ɡrʌnt/; [v](猪等)作呼噜声,(表示烦恼,反对,疲劳,轻蔑等)发哼声;  [n]呼噜声,咕哝; [or]6j;
guarantee: [a]/ˌɡærənˈtiː/; [v]保证;担保;提供保修;  [n]保证;担保;保修单;保证金; [or]6j;
guardian: [a]/ˈɡɑːrdiən/; [n]保护人;监护人; [or]6j;
guideline: [a]/ˈɡaɪdlaɪn/; [n]指导路线,准则; [or]6j;
guilt: [a]/ɡɪlt/; [n]内疚;罪行;罪恶感; [or]6j;
gust: [a]/ɡʌst/; [n]阵风,(感情的)迸发,汹涌;  [v]猛吹; [or]6j;
gutter: [a]/ˈɡʌtər/; [n]水槽,檐槽,排水沟;贫民区;  [v](蜡烛)忽明忽暗; [or]6j;
guy: [a]/ɡaɪ/; [n]男人;家伙; [or]6j;
hail: [a]/heɪl/; [n]冰雹;一阵;  [v]下冰雹;歌颂; [or]6j;
halve: [a]/hæv/; [v]二等分;平分; [or]6j;
hamper: [a]/ˈhæmpər/; [v]阻碍,妨碍,牵制;  [n](有盖的)大篮子; [or]6j;
handbook: [a]/ˈhændbʊk/; [n]手册;指南; [or]6j;
handicap: [a]/ˈhændikæp/; [n]障碍,阻碍,不利条件,不利因素;残疾,缺陷,生理缺陷;<高尔夫>给弱者增加的杆数(按击球次数计数,并随参赛者的进步而减少);  [v]使不利,妨碍; [or]6j;
handout: [a]/ˈhændaʊt/; [n]宣传单;施舍物;印刷品;讲义;小册子; [or]6j;
harassment: [a]/həˈræsmənt/; [n]骚扰;扰乱;烦恼事; [or]6j;
harmonious: [a]/hɑːrˈmoʊniəs/; [adj]和谐的,协调的;和睦的;悦耳的; [or]6j;
harmony: [a]/ˈhɑːrməni/; [n]和谐;和声;和睦;协调; [or]6j;
harp: [a]/hɑːrp/; [n]竖琴;  [v]不停地说,喋喋不休; [or]6j;
hasty: [a]/ˈheɪsti/; [adj]匆忙的;仓促完成的;草率的; [or]6j;
hatch: [a]/hætʃ/; [n]船舱盖;  [v]孵出,孵;策划; [or]6j;
hatred: [a]/ˈheɪtrɪd/; [n]憎恨;怨恨; [or]6j;
haughty: [a]/ˈhɔːti/; [adj]傲慢的; [or]6j;
haul: [a]/hɔːl/; [n]一次获得;拖运路程;  [v]硬拖,硬拉,用力拖;拖,拉,拽;强迫(某人)去某处; [or]6j;
haunt: [a]/hɔːnt/; [v]常去,萦绕于..;(鬼,魂)常出没于;(思想)萦绕;  [n]常去的地方; [or]6j;
haven: [a]/ˈheɪvn/; [n]港湾;避难所;  [vt]为.提供庇护所; [or]6j;
hawk: [a]/hɔːk/; [n]鹰;鹰派成员(以强硬态度或手段维护国家民族利益的个人,团体或势力);  [v]叫卖,兜售;散播; [or]6j;
hazard: [a]/ˈhæzərd/; [n]公害;危险;危险的事物;机会;  [v]使冒危险;冒险做; [or]6j;
heal: [a]/hiːl/; [v]治愈,治疗;痊愈;恢复; [or]6j;
heap: [a]/hiːp/; [n](一)堆;大量;  [v]堆;堆积; [or]6j;
hearing: [a]/ˈhɪrɪŋ/; [n]听觉;听距;听证会;申辩的机会;  [v]听到; [or]6j;
hearty: [a]/ˈhɑːrti/; [adj]衷心的;亲切的;精神饱满的;丰盛的;强烈的; [or]6j;
heater: [a]/ˈhiːtər/; [n]加热器;发热器; [or]6j;
heave: [a]/hiːv/; [v]用力举起;掷扔;发出叹息;恶心;  [n]举起,升降; [or]6j;
heel: [a]/hiːl/; [n]脚后跟;(鞋)后跟;  [v]给(鞋)钉后掌,倾侧,紧跟; [or]6j;
heighten: [a]/ˈhaɪtn/; [v]加强,增加,提高; [or]6j;
heir: [a]/er/; [n]继承人;后继者; [or]6j;
helmet: [a]/ˈhelmɪt/; [n]钢盔;头盔;盔形物;  [vt]给.戴头盔; [or]6j;
hemisphere: [a]/ˈhemɪsfɪr/; [n](地球的)半球;大脑半球; [or]6j;
herald: [a]/ˈherəld/; [n]使者;预兆;  [v]预告;为.欢呼; [or]6j;
herb: [a]/ɜːrb/; [n]草本植物;药草; [or]6j;
heritage: [a]/ˈherɪtɪdʒ/; [n]遗产;继承物;传统;文化遗产; [or]6j;
hesitate: [a]/ˈhezɪteɪt/; [v]犹豫,踌躇;含糊,支吾,有顾虑; [or]6j;
hierarchy: [a]/ˈhaɪərɑːrki/; [n]阶层,等级制度; [or]6j;
highlight: [a]/ˈhaɪlaɪt/; [vt]使突出,强调,高亮;  [n]最精彩的部分,最重要的事件; [or]6j;
hike: [a]/haɪk/; [n]远足,徒步旅行;(数量,价格等)增加,上升;  [v]作长途徒步旅行;使高涨,提高(价格); [or]6j;
hinder: [a]/ˈhɪndər/; [v]阻碍,妨碍;  [adj]后面的,后方的; [or]6j;
hindrance: [a]/ˈhɪndrəns/; [n]妨碍;障碍物; [or]6j;
hinge: [a]/hɪndʒ/; [n]铰链;  [v]靠铰链转动; [or]6j;
hiss: [a]/hɪs/; [n]嘶嘶声;发嘘声;  [vi]发出嘶嘶声;  [vt]嘶嘶地发出;发嘘声让(某人)别做声; [or]6j;
historian: [a]/hɪˈstɔːriən/; [n]历史学家,史学工作者; [or]6j;
historic: [a]/hɪˈstɔːrɪk/; [adj]历史上著名的,有历史意义的;历史性的; [or]6j;
hitherto: [a]/ˌhɪðərˈtuː/; [adv]到目前为止,迄今为止; [or]6j;
hoarse: [a]/hɔːrs/; [adj]沙哑的; [or]6j;
hoe: [a]/hoʊ/; [n]锄头;  [v]用锄耕地; [or]6j;
hoist: [a]/hɔɪst/; [v]升起,吊起;向上推;  [n]起重机;举起; [or]6j;
holder: [a]/ˈhoʊldər/; [n]持有者,占有者,(台,架等)支持物; [or]6j;
homely: [a]/ˈhoʊmli/; [adj]不好看的,相貌平平的;朴素的;(如在家一般)舒适自在,家庭的;(女士)热情友好的,和蔼的; [or]6j;
horrible: [a]/ˈhɔːrəbl/; [adj]可怕的,恐怖的;讨厌的,糟糕的;粗鲁的,不友好的; [or]6j;
hose: [a]/hoʊz/; [n]输水软管;  [v]用水管冲洗(汽车等); [or]6j;
hospitality: [a]/ˌhɑːspɪˈtæləti/; [n]好客;款待; [or]6j;
hostage: [a]/ˈhɑːstɪdʒ/; [n]人质; [or]6j;
hostess: [a]/ˈhoʊstəs/; [n]女主人,女主持人,女服务员(乘务员); [or]6j;
hostile: [a]/ˈhɑːstl/; [adj]敌对的,敌方的;怀敌意的; [or]6j;
hostility: [a]/hɑːˈstɪləti/; [n]虐待,敌意;不友善;敌对; [or]6j;
hound: [a]/haʊnd/; [n]猎犬;  [v]追逼;烦扰;纠缠; [or]6j;
household: [a]/ˈhaʊshoʊld/; [n]同住在一家的人;家务;家常普通的;  [adj]家庭的,家内的,一家的;家喻户晓的; [or]6j;
hover: [a]/ˈhʌvər/; [v](鸟,直升机)盘旋,翱翔;(人)逗留在附近,徘徊; [or]6j;
howl: [a]/haʊl/; [v](狼,狗等)嗥叫;(风等)呼啸;(因愤怒,痛苦等)吼叫,哀号;  [n]嚎叫,哀号; [or]6j;
hug: [a]/hʌɡ/; [v]紧抱;拥抱;  [n]拥抱; [or]6j;
hull: [a]/hʌl/; [n](果实等的)外壳,船体;  [v]剥壳; [or]6j;
hum: [a]/hʌm/; [v]发出嗡嗡声,哼(歌曲);  [n]轰鸣声,嗡嗡营营声; [or]6j;
humanitarian: [a]/hjuːˌmænɪˈteriən/; [n]慈善家;人道主义者;博爱主义者;  [adj]人道主义者的;慈善的;博爱的; [or]6j;
humanity: [a]/hjuːˈmænəti/; [n]人性;人类;人道;慈爱;(复)人文学科; [or]6j;
humble: [a]/ˈhʌmbl/; [adj]卑微的;(级别或地位)低下的,简陋的;谦逊的;  [v]使⋯谦逊,使⋯卑下;轻松打败(尤指强大的对手); [or]6j;
humidity: [a]/hjuːˈmɪdəti/; [n]潮湿;湿气;湿度; [or]6j;
hurl: [a]/hɜːrl/; [v]用力投掷;  [n]猛投; [or]6j;
hurrah: [a]/həˈrɑː/; [int]好哇;  [v]欢呼;  [n]欢呼声;骚动;欢乐; [or]6j;
hurricane: [a]/ˈhɜːrəkeɪn/; [n]飓风; [or]6j;
hush: [a]/hʌʃ/; [vi]安静下来;嘘!别做声!别吵!;  [vt]使安静;  [n]安静; [or]6j;
hybrid: [a]/ˈhaɪbrɪd/; [n]杂种,混血儿,混合物;  [adj]混合的;杂种的; [or]6j;
hydraulic: [a]/haɪˈdrɔːlɪk/; [adj]水力的,水压的; [or]6j;
hydrocarbon: [a]/ˌhaɪdrəˈkɑːrbən/; [n]碳氢化合物,烃; [or]6j;
hymn: [a]/hɪm/; [n]赞美诗,圣歌;歌颂某事物的电影; [or]6j;
hypothesis: [a]/haɪˈpɑːθəsɪs/; [n]假说;假设; [or]6j;
hysterical: [a]/hɪˈsterɪkl/; [adj]歇斯底里的,情绪激动的; [or]6j;
iceberg: [a]/ˈaɪsbɜːrɡ/; [n]冰山; [or]6j;
icy: [a]/ˈaɪsi/; [adj]多冰的; [or]6j;
ideal: [a]/aɪˈdiːəl/; [adj]理想的;完美的;空想的;观念的;  [n]理想;典范;目标; [or]6j;
identical: [a]/aɪˈdentɪkl/; [adj]相同的,同样的,一模一样的;相似的;  [n]完全相同的事物; [or]6j;
identification: [a]/aɪˌdentɪfɪˈkeɪʃn/; [n]识别;鉴定;验明;身份证明; [or]6j;
identify: [a]/aɪˈdentɪfaɪ/; [v]认出,联系;识别;确定,鉴定,发现;认为.等同,认为.关系紧密;表明.的身份;认同,有共鸣,有同感; [or]6j;
identity: [a]/aɪˈdentəti/; [n]身份;特性;一致; [or]6j;
ideology: [a]/ˌaɪdiˈɑːlədʒi/; [n]意识形态,思想(体系); [or]6j;
idiom: [a]/ˈɪdiəm/; [n]习语;成语;惯用语法; [or]6j;
idiot: [a]/ˈɪdiət/; [n]愚蠢的人,白痴; [or]6j;
idleness: [a]/ˈaɪdlnəs/; [n]闲散;赋闲无事; [or]6j;
ignite: [a]/ɪɡˈnaɪt/; [v]点燃,发光,燃烧; [or]6j;
ignorance: [a]/ˈɪɡnərəns/; [n]不知,不懂;愚昧,无知; [or]6j;
ignore: [a]/ɪɡˈnɔːr/; [v]忽视;不理; [or]6j;
illegal: [a]/ɪˈliːɡl/; [adj]不合法的,非法的;  [n]非法移民,非法劳工;间谍; [or]6j;
illegible: [a]/ɪˈledʒəbl/; [adj]难读的;难以辨认的; [or]6j;
illiterate: [a]/ɪˈlɪtərət/; [n]文盲,目不识丁者;  [adj]不识字的;缺乏(某方面)知识的;语法错误的; [or]6j;
illuminate: [a]/ɪˈluːmɪneɪt/; [vt]照亮;阐释;说明; [or]6j;
illusion: [a]/ɪˈluːʒn/; [n]假象,幻象;幻想;错误观念; [or]6j;
illustrate: [a]/ˈɪləstreɪt/; [v]举例说明,阐明;图解,加插图; [or]6j;
imaginary: [a]/ɪˈmædʒɪneri/; [adj]想象的,虚构的,假想的; [or]6j;
imaginative: [a]/ɪˈmædʒɪnətɪv/; [adj]想象的;富于想象力的;虚构的; [or]6j;
imitate: [a]/ˈɪmɪteɪt/; [v]模仿; [or]6j;
imitation: [a]/ˌɪmɪˈteɪʃn/; [n]模仿;仿制品;赝品;  [adj]伪造的;仿制的; [or]6j;
immerse: [a]/ɪˈmɜːrs/; [v]沉浸,沉浸于;使陷入; [or]6j;
immigrant: [a]/ˈɪmɪɡrənt/; [n]移民;  [adj]移民的;迁入的; [or]6j;
immigrate: [a]/ˈɪmɪɡreɪt/; [v]移居入境; [or]6j;
immortal: [a]/ɪˈmɔːrtl/; [adj]不朽的; [or]6j;
immune: [a]/ɪˈmjuːn/; [adj]免疫的,有免疫力的;不受影响的;免除的; [or]6j;
impact: [a]/ˈɪmpækt/; [n]碰撞,冲击;冲击力;影响;  [v]冲击;压紧;产生影响;塞满; [or]6j;
impair: [a]/ɪmˈper/; [v]损害;削弱; [or]6j;
impart: [a]/ɪmˈpɑːrt/; [v]传授,给予,将(某性质)给予或赋予某事物; [or]6j;
impartial: [a]/ɪmˈpɑːrʃl/; [adj]公平的,不偏不倚的; [or]6j;
impatient: [a]/ɪmˈpeɪʃnt/; [adj]不耐烦的,没有耐心的;急躁的; [or]6j;
imperative: [a]/ɪmˈperətɪv/; [adj]必要的;祈使的;急需的;  [n]命令;必要的事;义务;驱使; [or]6j;
impetus: [a]/ˈɪmpɪtəs/; [n]推动力;促进; [or]6j;
implement: [a]/ˈɪmplɪment/; [n]工具;器具;  [v]实施,执行;执行; [or]6j;
implication: [a]/ˌɪmplɪˈkeɪʃn/; [n]暗示;含意;牵连;卷入;可能的后果; [or]6j;
implicit: [a]/ɪmˈplɪsɪt/; [adj]隐含的;盲目的;完全的,绝对的;成为一部分的; [or]6j;
implore: [a]/ɪmˈplɔːr/; [v]恳求; [or]6j;
imply: [a]/ɪmˈplaɪ/; [vt]暗示;暗指;意味着; [or]6j;
impose: [a]/ɪmˈpoʊz/; [v]把.强加;强制实行,强迫接受; [or]6j;
imposing: [a]/ɪmˈpoʊzɪŋ/; [adj]壮观的,壮丽的; [or]6j;
improper: [a]/ɪmˈprɑːpər/; [adj]不成体统的,不合礼仪的;不正确的;不道德的; [or]6j;
impulse: [a]/ˈɪmpʌls/; [n]冲动,脉冲,驱使; [or]6j;
impurity: [a]/ɪmˈpjʊrəti/; [n]不洁;杂质;不道德; [or]6j;
inaccessible: [a]/ˌɪnækˈsesəbl/; [adj]达不到的;难达到的; [or]6j;
inaccurate: [a]/ɪnˈækjərət/; [adj]不准确的; [or]6j;
inadequate: [a]/ɪnˈædɪkwət/; [adj]不足够的,不充分的,不适当的; [or]6j;
inaugurate: [a]/ɪˈnɔːɡjəreɪt/; [v]为..揭幕;为.举行就职典礼;开展; [or]6j;
incapable: [a]/ɪnˈkeɪpəbl/; [adj]无能力的,不能的; [or]6j;
incense: [a]/ˈɪnsens/; [n]焚香时的烟,香味;  [v]激怒; [or]6j;
incentive: [a]/ɪnˈsentɪv/; [n]刺激,激励;鼓励; [or]6j;
incidence: [a]/ˈɪnsɪdəns/; [n]发生率,入射角度; [or]6j;
incident: [a]/ˈɪnsɪdənt/; [n]事件;事变,军事冲突,冲突;事故;  [adj]<法>附带的;<光>入射的;易发生的,伴随而来的; [or]6j;
inclination: [a]/ˌɪnklɪˈneɪʃn/; [n]点头;做.的倾向;意愿;倾斜; [or]6j;
incline: [a]/ɪnˈklaɪn/; [n]倾斜,斜坡,斜面;  [v](使)倾斜,(使)倾向于; [or]6j;
inclusive: [a]/ɪnˈkluːsɪv/; [adj]包含..在内的,包罗广泛的; [or]6j;
incomplete: [a]/ˌɪnkəmˈpliːt/; [adj]不完全的;未完成的,未结束的;  [n]未完成,未修毕; [or]6j;
incorporate: [a]/ɪnˈkɔːrpəreɪt/; [v]包含;使并入; [or]6j;
incredible: [a]/ɪnˈkredəbl/; [adj]不可相信的;惊人的,不可思议的; [or]6j;
incur: [a]/ɪnˈkɜːr/; [v]遭受;招致;引起; [or]6j;
indefinite: [a]/ɪnˈdefɪnət/; [adj]模糊的;不确定的;无限的; [or]6j;
independence: [a]/ˌɪndɪˈpendəns/; [n](国家的)独立;(人的)自立,独立; [or]6j;
indicative: [a]/ɪnˈdɪkətɪv/; [adj]指示的;暗示的;陈述的;  [n]陈述语气; [or]6j;
indifferent: [a]/ɪnˈdɪfrənt/; [adj]不感兴趣的,不关心的;平庸的;冷漠的; [or]6j;
indignant: [a]/ɪnˈdɪɡnənt/; [adj]愤慨的,愤愤不平的; [or]6j;
indignation: [a]/ˌɪndɪɡˈneɪʃn/; [n]愤慨; [or]6j;
indispensable: [a]/ˌɪndɪˈspensəbl/; [adj]必不可少的;必需的; [or]6j;
individual: [a]/ˌɪndɪˈvɪdʒuəl/; [adj]个别的,独特的;单独的;  [n]独立的个体; [or]6j;
induce: [a]/ɪnˈduːs/; [v]引导,劝诱,诱导; [or]6j;
indulge: [a]/ɪnˈdʌldʒ/; [v]沉迷于;放纵;满足; [or]6j;
industrial: [a]/ɪnˈdʌstriəl/; [adj]工业的;产业的;  [n]产业工人;工业公司;<商>工业股票; [or]6j;
industrious: [a]/ɪnˈdʌstriəs/; [adj]勤劳的,勤奋的; [or]6j;
inevitable: [a]/ɪnˈevɪtəbl/; [adj]不可避免的,必然的;  [n]必然发生的事; [or]6j;
inevitably: [a]/ɪnˈevɪtəbli/; [adv]必然地;不可避免地; [or]6j;
infant: [a]/ˈɪnfənt/; [n]幼儿,婴儿;  [adj]婴儿的;初期的,初创的; [or]6j;
infection: [a]/ɪnˈfekʃn/; [n]感染;传染病; [or]6j;
infectious: [a]/ɪnˈfekʃəs/; [adj]传染的;感染性的;易传播的; [or]6j;
inference: [a]/ˈɪnfərəns/; [n]推断,推断的结果; [or]6j;
inferior: [a]/ɪnˈfɪriər/; [adj](等级,地位等)下等的,低等的;低劣的;  [n]部下,地位低的人;次品; [or]6j;
infinite: [a]/ˈɪnfɪnət/; [adj]无限的,无穷的;无数的;  [n]无穷,无限大; [or]6j;
infinitely: [a]/ˈɪnfɪnətli/; [adv]无限地,无穷地; [or]6j;
infinity: [a]/ɪnˈfɪnəti/; [n]无限的时间;大宗,大量;无穷; [or]6j;
inflation: [a]/ɪnˈfleɪʃn/; [n]通货膨胀;(充气后)膨胀;自负; [or]6j;
inflict: [a]/ɪnˈflɪkt/; [v]使遭受(损伤,痛苦等);使承担(负担等); [or]6j;
informed: [a]/ɪnˈfɔːrmd/; [adj]了解情况的,消息灵通的; [or]6j;
infrastructure: [a]/ˈɪnfrəstrʌktʃər/; [n]基础设施; [or]6j;
infusion: [a]/ɪnˈfjuːʒn/; [n]灌输;注入物;输入; [or]6j;
ingenious: [a]/ɪnˈdʒiːniəs/; [adj]聪明的;有发明天才的;有独创性的,别出心裁的; [or]6j;
ingenuity: [a]/ˌɪndʒəˈnuːəti/; [n]机灵,心灵手巧,富于创造天赋; [or]6j;
ingredient: [a]/ɪnˈɡriːdiənt/; [n](烹调的)原料;(构成的)要素,因素; [or]6j;
inhabit: [a]/ɪnˈhæbɪt/; [v]居住于; [or]6j;
inhabitant: [a]/ɪnˈhæbɪtənt/; [n]居民,住户; [or]6j;
inherent: [a]/ɪnˈhɪrənt/; [adj]内在的,固有的;生来就有的; [or]6j;
inherit: [a]/ɪnˈherɪt/; [v]经遗传而得(特性等);接受遗产;沿袭;继任; [or]6j;
inhibit: [a]/ɪnˈhɪbɪt/; [v]阻碍;阻止,防止;抑制,约束; [or]6j;
initial: [a]/ɪˈnɪʃl/; [adj]第一的;最初的;开始的;  [n]首字母; [or]6j;
initiate: [a]/ɪˈnɪʃieɪt/; [v]开始,发动;  [n]新加入组织的人; [or]6j;
initiative: [a]/ɪˈnɪʃətɪv/; [n]主动权,主动性;首创精神;(重要的)法案,倡议; [or]6j;
inject: [a]/ɪnˈdʒekt/; [v]给.注射;注入;引入;射入轨道; [or]6j;
inland: [a]/ˈɪnlænd/; [adv]在内陆地;  [adj]内陆的,国内的;  [n]内陆; [or]6j;
inlet: [a]/ˈɪnlet/; [n]水湾,小湾;进口,入口; [or]6j;
innate: [a]/ɪˈneɪt/; [adj]与生俱来的,天生的; [or]6j;
innovation: [a]/ˌɪnəˈveɪʃn/; [n]创新,革新,新设施,新发明; [or]6j;
innovative: [a]/ˈɪnəveɪtɪv/; [adj]创新的,革新的; [or]6j;
innumerable: [a]/ɪˈnuːmərəbl/; [adj]数不清的;无数的; [or]6j;
inorganic: [a]/ˌɪnɔːrˈɡænɪk/; [adj]无机的; [or]6j;
input: [a]/ˈɪnpʊt/; [n]投入;[电学,计算机]输入;  [vt]输入; [or]6j;
insane: [a]/ɪnˈseɪn/; [adj]精神失常的,疯狂的;精神病患者的;荒唐的;  [n]精神失常的人;精神错乱的人; [or]6j;
insanity: [a]/ɪnˈsænəti/; [n]疯狂;精神错乱,精神病;荒谬,愚蠢; [or]6j;
inscribe: [a]/ɪnˈskraɪb/; [v]刻; [or]6j;
insect: [a]/ˈɪnsekt/; [n]昆虫; [or]6j;
insert: [a]/ɪnˈsɜːrt/; [vt]插入,嵌入;  [n]插入物;插页; [or]6j;
insight: [a]/ˈɪnsaɪt/; [n]深刻的理解,洞察力,见识; [or]6j;
insignificant: [a]/ˌɪnsɪɡˈnɪfɪkənt/; [adj]无关紧要的,可忽略的,无意义的; [or]6j;
insist: [a]/ɪnˈsɪst/; [v]坚持;坚持要求;坚持认为; [or]6j;
inspection: [a]/ɪnˈspekʃn/; [n]检查,细看; [or]6j;
inspector: [a]/ɪnˈspektər/; [n]检查员,督察员;视察者,检阅者;(英)查票员; [or]6j;
inspiration: [a]/ˌɪnspəˈreɪʃn/; [n]灵感;鼓舞人心的人(或事物);妙计,好办法; [or]6j;
inspire: [a]/ɪnˈspaɪər/; [v]使生灵感;启示;激发,激励; [or]6j;
inspiring: [a]/ɪnˈspaɪərɪŋ/; [adj]鼓舞人心的,激励人的;启发灵感的; [or]6j;
instability: [a]/ˌɪnstəˈbɪləti/; [n]不稳定(性); [or]6j;
install: [a]/ɪnˈstɔːl/; [v]安装,安置,使就职; [or]6j;
installment: [a]/ɪnˈstɔlmənt/; [n]分期付款;部分;安装,安置; [or]6j;
instantaneous: [a]/ˌɪnstənˈteɪniəs/; [adj]瞬间的;即刻的;猝发的; [or]6j;
instinct: [a]/ˈɪnstɪŋkt/; [n]天性;本能;直觉;  [adj]充满的; [or]6j;
institute: [a]/ˈɪnstɪtuːt/; [n]学会;学院,专科学院,研究院;  [vt]建立,设立,制定; [or]6j;
institution: [a]/ˌɪnstɪˈtuːʃn/; [n]机构;制度;惯例;习俗;建立,设立,制定; [or]6j;
instruct: [a]/ɪnˈstrʌkt/; [v]指导;教;指示;通知; [or]6j;
instructive: [a]/ɪnˈstrʌktɪv/; [adj]有教育意义的; [or]6j;
instrument: [a]/ˈɪnstrəmənt/; [n]仪器;工具;乐器;手段; [or]6j;
instrumental: [a]/ˌɪnstrəˈmentl/; [adj]乐器的;重要的;有帮助的;仪器的;  [n]工具词;器乐曲;工具格; [or]6j;
insulate: [a]/ˈɪnsəleɪt/; [v]隔离,使隔绝(以免受到影响);使隔热; [or]6j;
insulator: [a]/ˈɪnsəleɪtər/; [n]绝缘体,绝热器; [or]6j;
insurance: [a]/ɪnˈʃʊrəns/; [n]保险;保险费;保险业;安全保证; [or]6j;
intact: [a]/ɪnˈtækt/; [adj]原封未动的,未受损的,完整无缺的; [or]6j;
intake: [a]/ˈɪnteɪk/; [n]吸入,收纳;纳入(数量); [or]6j;
integral: [a]/ˈɪntɪɡrəl/; [adj](用于构成整体)必需的,不可缺少的,必不可少的;基本的,作为组成部分的,内置的;整体的,完整的; [or]6j;
integrity: [a]/ɪnˈteɡrəti/; [n]正直,真诚;完整; [or]6j;
intellect: [a]/ˈɪntəlekt/; [n]智力,理解力;非凡的才智;才华出众的人; [or]6j;
intellectual: [a]/ˌɪntəˈlektʃuəl/; [n]知识分子;  [adj]智力的;理智的;需用智力的;聪明的; [or]6j;
intelligent: [a]/ɪnˈtelɪdʒənt/; [adj]聪明的;智能的; [or]6j;
intelligible: [a]/ɪnˈtelɪdʒəbl/; [adj]可理解的,明白易懂的; [or]6j;
intense: [a]/ɪnˈtens/; [adj]强烈的,激烈的;紧张的;认真的;热情的; [or]6j;
intensify: [a]/ɪnˈtensɪfaɪ/; [v]增强;加剧; [or]6j;
intensive: [a]/ɪnˈtensɪv/; [adj]加强的,强调的;精耕细作的;密集的;  [n]加强器;<语>强义词,强调成份; [or]6j;
intent: [a]/ɪnˈtent/; [adj]全神贯注的;专心致志的;  [n]意图;意向;目的; [or]6j;
interact: [a]/ˌɪntərˈækt/; [v]交流,沟通,互动;互相作用,互相影响; [or]6j;
interaction: [a]/ˌɪntərˈækʃn/; [n]互动;相互作用,相互影响; [or]6j;
intercity: [a]/ˌɪntərˈsɪti/; [adj]城市间的,交际的,来往于城市间的; [or]6j;
interconnect: [a]/ˌɪntərkəˈnekt/; [v]互相连接; [or]6j;
intercourse: [a]/ˈɪntərkɔːrs/; [n]交流;性交; [or]6j;
interface: [a]/ˈɪntərfeɪs/; [n]界面;<地质>分界面,接触面;  [v]相互作用(或影响);交流,交谈; [or]6j;
interfere: [a]/ˌɪntərˈfɪr/; [v]干涉,妨碍;妨碍;干涉;  [vi]妨碍; [or]6j;
interpret: [a]/ɪnˈtɜːrprɪt/; [v]口译;解释;把..理解为; [or]6j;
interrupt: [a]/ˌɪntəˈrʌpt/; [v]打扰;打断,中断;插嘴;妨碍; [or]6j;
intersection: [a]/ˌɪntərˈsekʃn/; [n]交点,十字路口; [or]6j;
intervention: [a]/ˌɪntərˈvenʃn/; [n]介入;调停;干涉,干预; [or]6j;
intestine: [a]/ɪnˈtestɪn/; [n]肠; [or]6j;
intimate: [a]/ˈɪntɪmət/; [adj]亲密的,密切的;详细的;  [v]暗示;宣布,通知;  [n]密友,知己; [or]6j;
intimidate: [a]/ɪnˈtɪmɪdeɪt/; [v]恫吓,威胁; [or]6j;
intonation: [a]/ˌɪntəˈneɪʃn/; [n]声调;语调; [or]6j;
intricate: [a]/ˈɪntrɪkət/; [adj]错综复杂的; [or]6j;
intrigue: [a]/ɪnˈtriːɡ/; [n]阴谋;诡计;  [v]密谋;欺骗;引起极大兴趣; [or]6j;
intrinsic: [a]/ɪnˈtrɪnsɪk/; [adj]固有的; [or]6j;
intuition: [a]/ˌɪntuˈɪʃn/; [n]直觉;感觉; [or]6j;
invalid: [a]/ɪnˈvælɪd/; [adj]不能识别的;无效的;作废的,不能成立的;  [n]病人,残疾人; [or]6j;
invaluable: [a]/ɪnˈvæljuəbl/; [adj]非常宝贵的,极为贵重的,无价的; [or]6j;
invariably: [a]/ɪnˈveriəbli/; [adv]总是;不变地,永恒地; [or]6j;
inventory: [a]/ˈɪnvəntɔːri/; [n]详细目录;存货清单; [or]6j;
invert: [a]/ɪnˈvɜːrt/; [v]倒置;倒转;颠倒; [or]6j;
invest: [a]/ɪnˈvest/; [v]投资,投入;赋予,给予; [or]6j;
investigate: [a]/ɪnˈvestɪɡeɪt/; [v]调查,研究; [or]6j;
invisible: [a]/ɪnˈvɪzəbl/; [adj]看不见的,无形的; [or]6j;
invoice: [a]/ˈɪnvɔɪs/; [n]发票;  [v]开发票;记清单; [or]6j;
involve: [a]/ɪnˈvɑːlv/; [v]牵涉,涉及;卷入,使参与;吸引;包含,需要,影响; [or]6j;
ion: [a]/ˈaɪən/; [n]［物］离子; [or]6j;
ironically: [a]/aɪˈrɑːnɪkli/; [adv]讽刺地;出乎意料地; [or]6j;
irony: [a]/ˈaɪrəni/; [n]反语;冷嘲;具有讽刺意味的事; [or]6j;
irregularity: [a]/ɪˌreɡjəˈlærəti/; [n]不规律;无常;不良行为; [or]6j;
irrespective: [a]/ˌɪrɪˈspektɪv/; [adj]不考虑的,不顾的; [or]6j;
irreversible: [a]/ˌɪrɪˈvɜːrsəbl/; [adj]不能翻转的;不可撤销的;不可逆的; [or]6j;
irrigation: [a]/ˌɪrɪˈɡeɪʃn/; [n]灌溉; [or]6j;
irritate: [a]/ˈɪrɪteɪt/; [v]使烦躁;激怒;使难受; [or]6j;
isle: [a]/aɪl/; [n]岛,小岛; [or]6j;
isolate: [a]/ˈaɪsəleɪt/; [v]使隔离;使孤立;  [adj]孤立的;单独的; [or]6j;
issue: [a]/ˈɪʃuː/; [n]问题;议题;发行物;子女;  [v]发行;发布;分配,分发,给; [or]6j;
item: [a]/ˈaɪtəm/; [n]物品;条,条款,项目; [or]6j;
itinerary: [a]/aɪˈtɪnəreri/; [n]旅程,路线;旅行计划; [or]6j;
ivory: [a]/ˈaɪvəri/; [n]象牙,象牙制品;乳白色; [or]6j;
jack: [a]/dʒæk/; [n]千斤顶;<牌戏>J牌;插座,插口;  [adj]对..感到厌烦的;  [v]偷窃(特别是价值低的物品); [or]6j;
jail: [a]/dʒeɪl/; [n]监狱;看守所;  [v]监禁;拘留; [or]6j;
jealousy: [a]/ˈdʒeləsi/; [n]妒忌,猜忌; [or]6j;
jean: [a]/dʒɪn/; [n]牛仔裤; [or]6j;
jelly: [a]/ˈdʒeli/; [n]果冻,肉冻;胶状物;  [vi]成胶状;做胶冻;  [adj]有胶冻的;  [vt]使成胶冻; [or]6j;
jeopardize: [a]/ˈdʒepərdaɪz/; [v]危及,损害(也作jeopardise); [or]6j;
jerk: [a]/dʒɜːrk/; [v]猛拉;使猝然一动;  [n]急推;急拉;蠢货;古怪的人;腌制品;  [adj]颠簸不稳的; [or]6j;
jewelry: [a]/ˈdʒuːəlri/; [n]珠宝; [or]6j;
jingle: [a]/ˈdʒɪŋɡl/; [n](硬币,铃铛等发出的)叮当声;含有轻松而有节奏的韵律的诗篇;  [v]发出叮当声; [or]6j;
jog: [a]/dʒɑːɡ/; [v]慢跑;轻碰;  [n]轻推,慢跑,漫步; [or]6j;
journalist: [a]/ˈdʒɜːrnəlɪst/; [n]记者,新闻工作者; [or]6j;
judicial: [a]/dʒuˈdɪʃl/; [adj]司法的,法庭的,法律的,审判(上)的; [or]6j;
jug: [a]/dʒʌɡ/; [n](有把手,小口的)大壶;一壶,一罐(的量); [or]6j;
juggle: [a]/ˈdʒʌɡl/; [v]玩杂耍;同时做;对.巧妙应付; [or]6j;
junction: [a]/ˈdʒʌŋkʃn/; [n]连接,接合;接合处;路口; [or]6j;
junk: [a]/dʒʌŋk/; [n]废旧物品,垃圾,假货;  [v]把.(当废物)丢弃; [or]6j;
jury: [a]/ˈdʒʊri/; [n]陪审团;全体评审员,评判委员会; [or]6j;
juvenile: [a]/ˈdʒuːvənl/; [n]青少年;雏鸟;  [adj]青少年的;幼稚的; [or]6j;
keen: [a]/kiːn/; [adj]敏锐的;热衷的,热心的;强烈的,渴望的;  [v]恸哭;  [n]〈英〉号哭,恸哭;  [adv]如饥似渴地; [or]6j;
kernel: [a]/ˈkɜːrnl/; [n]子粒,谷粒;核心; [or]6j;
kerosene: [a]/ˈkerəsiːn/; [n]煤油; [or]6j;
kidnap: [a]/ˈkɪdnæp/; [v]诱拐;绑架; [or]6j;
kidney: [a]/ˈkɪdni/; [n]肾,腰子; [or]6j;
kilowatt: [a]/ˈkɪləwɑːt/; [n]<物>千瓦(功率单位); [or]6j;
kin: [a]/kɪn/; [n]亲属; [or]6j;
kindle: [a]/ˈkɪndl/; [v]点燃,激起;着火;照亮;煽动; [or]6j;
kinetic: [a]/kɪˈnetɪk/; [adj]运动的; [or]6j;
kit: [a]/kɪt/; [n]成套工具;工具箱;装备;  [vt]装备; [or]6j;
knight: [a]/naɪt/; [n]骑士;  [v]授以爵位; [or]6j;
knit: [a]/nɪt/; [v]编结,针织;  [n]编织的衣服;针织衫; [or]6j;
knob: [a]/nɑːb/; [n]圆形把手,旋钮,圆形突出物;  [v]突出;使有球形突出物;在.上生疖(长瘤);给(门等)装球形捏手; [or]6j;
label: [a]/ˈleɪbl/; [n]标签;称号;唱片公司;  [v]把..称为,贴标签于..; [or]6j;
lace: [a]/leɪs/; [n]鞋带;花边;  [v]加以修饰;结带子; [or]6j;
lame: [a]/leɪm/; [adj]跛的;瘸的;差劲的,乏味的;〔解释或借口〕无说服力的,站不住脚的,蹩脚的;  [v](使)变跛; [or]6j;
landscape: [a]/ˈlændskeɪp/; [n]风景;风景画;景观;横向打印格式;  [v]美化环境; [or]6j;
lane: [a]/leɪn/; [n]小径,巷,行车道; [or]6j;
lash: [a]/læʃ/; [v]鞭打;猛烈抨击;捆绑;摆动;猛击;  [n]鞭梢;鞭打; [or]6j;
latent: [a]/ˈleɪtnt/; [adj]潜在的,隐伏的,不易察觉的; [or]6j;
lathe: [a]/leɪð/; [n]车床; [or]6j;
latitude: [a]/ˈlætɪtuːd/; [n]纬度;地区;(言论,行动的)自由; [or]6j;
lattice: [a]/ˈlætɪs/; [n]格子架; [or]6j;
layer: [a]/ler/; [n]层;层次;阶层;  [v]把.分层堆放;借助压条法;将(头发)剪成不同层次; [or]6j;
layman: [a]/ˈleɪmən/; [n]门外汉;俗人;外行; [or]6j;
leakage: [a]/ˈliːkɪdʒ/; [n]泄漏; [or]6j;
lease: [a]/liːs/; [v]出租,租得;  [n]租约,租契; [or]6j;
leather: [a]/ˈleðər/; [n]皮革;皮制品;  [vt]用皮鞭抽打;用皮革覆盖; [or]6j;
legacy: [a]/ˈleɡəsi/; [n]遗赠(物);遗产; [or]6j;
legal: [a]/ˈliːɡl/; [adj]合法的,法定的;法律的; [or]6j;
legend: [a]/ˈledʒənd/; [n]传说,传奇人物;(奖章纪念牌等的)铭文;地图的图例,插图的说明; [or]6j;
legitimate: [a]/lɪˈdʒɪtɪmət/; [adj]合法的;合理的;  [vt]使合法;授权;宣布..为合法; [or]6j;
leisure: [a]/ˈliːʒər/; [n]闲暇,空暇,休闲时间;  [adj]空闲的; [or]6j;
lengthen: [a]/ˈleŋθən/; [v]变长;延长; [or]6j;
lens: [a]/lenz/; [n]镜头;透镜;镜片;晶状体; [or]6j;
leopard: [a]/ˈlepərd/; [n]豹;美洲豹;美洲虎; [or]6j;
lever: [a]/ˈlevər/; [n]杠杆;控制杆;施加影响的手段;  [v]用杠杆移动;撬开; [or]6j;
levy: [a]/ˈlevi/; [v]征收(税等);  [n]征税;税款; [or]6j;
liability: [a]/ˌlaɪəˈbɪləti/; [n]责任;债务;倾向;可能性;不利因素;惹麻烦的人(或事); [or]6j;
liable: [a]/ˈlaɪəbl/; [adj](for)有责任的;有义务的;(to)有.倾向的;易于.的,有可能.; [or]6j;
lick: [a]/lɪk/; [v]舔;卷烧;战胜;使无法理解;轻轻拍打;  [vi]舔;  [n]舔;舌头一次舔的量;狠揍; [or]6j;
lieutenant: [a]/luːˈtenənt/; [n]陆军中尉,海军上尉,空军中尉;副队长;助理官员;警督; [or]6j;
lighter: [a]/ˈlaɪtər/; [n]打火机; [or]6j;
likelihood: [a]/ˈlaɪklihʊd/; [n]可能;可能性; [or]6j;
likeness: [a]/ˈlaɪknəs/; [n]相像,相似;画像,写真; [or]6j;
lily: [a]/ˈlɪli/; [n]百合; [or]6j;
limb: [a]/lɪm/; [n]肢体;臂;枝干;树枝;  [v]肢解; [or]6j;
limestone: [a]/ˈlaɪmstoʊn/; [n]<地质学>石灰岩;石灰石; [or]6j;
limitation: [a]/ˌlɪmɪˈteɪʃn/; [n]限制,局限性; [or]6j;
limp: [a]/lɪmp/; [n]跛行;  [vi]一瘸一拐地走,跛行;慢腾腾地进行;  [adj]无力的,无生气的;柔软的,软弱的; [or]6j;
linear: [a]/ˈlɪniər/; [adj]线的,线性的;直线的;长度的; [or]6j;
linen: [a]/ˈlɪnɪn/; [n]亚麻桌布;亚麻布; [or]6j;
liner: [a]/ˈlaɪnər/; [n]眼线笔;班轮;班机;内衬; [or]6j;
linger: [a]/ˈlɪŋɡər/; [v]逗留,留恋; [or]6j;
linguist: [a]/ˈlɪŋɡwɪst/; [n]语言学家;会多国语言的人; [or]6j;
linguistic: [a]/lɪŋˈɡwɪstɪk/; [adj]语言的,语言上的; [or]6j;
lining: [a]/ˈlaɪnɪŋ/; [n](衣服等的)衬里;衬料;里子; [or]6j;
literacy: [a]/ˈlɪtərəsi/; [n]读写能力;识字;有文化;教养; [or]6j;
literal: [a]/ˈlɪtərəl/; [adj]字面上的;照字面的;缺乏想像力的; [or]6j;
literary: [a]/ˈlɪtəreri/; [adj]文学的,文学上的;精通文学的;以写作为职业的;书本上的;书面的;书面语的; [or]6j;
literate: [a]/ˈlɪtərət/; [adj]受过教育的;精通文学的;  [n]学者; [or]6j;
literature: [a]/ˈlɪtrətʃər/; [n]文学;宣传册;文献; [or]6j;
litter: [a]/ˈlɪtər/; [n]垃圾;杂乱;  [v]乱丢; [or]6j;
locality: [a]/loʊˈkæləti/; [n]地区;地点;位置;方位; [or]6j;
locomotive: [a]/ˌloʊkəˈmoʊtɪv/; [n]机车,火车头;  [adj]运动的; [or]6j;
locust: [a]/ˈloʊkəst/; [n]蝗虫; [or]6j;
lodging: [a]/ˈlɑːdʒɪŋ/; [n]住所;寄宿;(大学生的)校外宿舍; [or]6j;
lofty: [a]/ˈlɔːfti/; [adj]极高的,巍峨的;崇高的;高傲的; [or]6j;
logical: [a]/ˈlɑːdʒɪkl/; [adj]有逻辑的;合情合理的;推理正确的; [or]6j;
longevity: [a]/lɔːnˈdʒevəti/; [n]长寿,长命;寿命; [or]6j;
loom: [a]/luːm/; [n]织布机;  [v]阴森地逼近;隐现;即将来临; [or]6j;
loosely: [a]/ˈluːsli/; [adv]宽松地,松散地; [or]6j;
lounge: [a]/laʊndʒ/; [n]候机室,休息室,酒吧间;沙发,躺椅;懒散的步子;  [v](懒散地)倚,躺;闲逛; [or]6j;
loyal: [a]/ˈlɔɪəl/; [adj]忠心的;忠诚的;  [n]效忠(君主)的臣民; [or]6j;
loyalty: [a]/ˈlɔɪəlti/; [n]忠诚;忠心耿耿; [or]6j;
lubricate: [a]/ˈluːbrɪkeɪt/; [v]使.润滑;给.加润滑油; [or]6j;
luggage: [a]/ˈlʌɡɪdʒ/; [n]行李箱,行李;衣箱;皮箱; [or]6j;
luminous: [a]/ˈluːmɪnəs/; [adj]发光的;鲜艳的;明亮的;夜光的; [or]6j;
lunar: [a]/ˈluːnər/; [adj]月亮的; [or]6j;
luncheon: [a]/ˈlʌntʃən/; [n]午宴; [or]6j;
lure: [a]/lʊr/; [v]引诱;以诱饵吸引;  [n]诱惑力;诱惑物;鱼饵; [or]6j;
luxurious: [a]/lʌɡˈʒʊriəs/; [adj]奢侈的,豪华的; [or]6j;
luxury: [a]/ˈlʌkʃəri/; [adj]奢侈的,豪华的;  [n]奢侈,奢华; [or]6j;
machinery: [a]/məˈʃiːnəri/; [n]机器,机关;机构,机制; [or]6j;
magician: [a]/məˈdʒɪʃn/; [n]善于变戏法的人,魔术师,术士; [or]6j;
magistrate: [a]/ˈmædʒɪstreɪt/; [n]法官; [or]6j;
magnet: [a]/ˈmæɡnət/; [n]磁体,磁铁; [or]6j;
magnetic: [a]/mæɡˈnetɪk/; [adj]有磁性的;有吸引力的; [or]6j;
magnetism: [a]/ˈmæɡnətɪzəm/; [n]吸引力;磁性; [or]6j;
magnificent: [a]/mæɡˈnɪfɪsnt/; [adj]华丽的,宏伟的,壮丽的; [or]6j;
magnify: [a]/ˈmæɡnɪfaɪ/; [v]放大,扩大;夸大,夸张; [or]6j;
magnitude: [a]/ˈmæɡnɪtuːd/; [n]巨大;震级;重要性;<数>量值; [or]6j;
maiden: [a]/ˈmeɪdn/; [n](文学)少女,未嫁女子;  [adj]未婚的,处女的,初次的; [or]6j;
maintain: [a]/meɪnˈteɪn/; [v]维持,保持;断言,宣称;供养,赡养; [or]6j;
majesty: [a]/ˈmædʒəsti/; [n]最高权威;雄伟;壮丽;帝王; [or]6j;
majority: [a]/məˈdʒɔːrəti/; [n]多数,大多数,多数票;法定成年年龄; [or]6j;
makeup: [a]/'meɪkˌʌp/; [n]化妆品; [or]6j;
malice: [a]/ˈmælɪs/; [n]恶意,怨恨; [or]6j;
mall: [a]/mɔːl/; [n]购物商场; [or]6j;
malnutrition: [a]/ˌmælnuːˈtrɪʃn/; [n]营养不良; [or]6j;
mammal: [a]/ˈmæml/; [n]哺乳动物; [or]6j;
management: [a]/ˈmænɪdʒmənt/; [n]经营,管理,处理;管理者; [or]6j;
maneuver: [a]/məˈnʊvər/; [v]操纵;  [n]操纵;花招;调遣;策略; [or]6j;
manifest: [a]/ˈmænɪfest/; [adj]显然的,明白无误的,明了的;  [v]使显现,使显露,表明;  [n]货单,旅客名单; [or]6j;
manifestation: [a]/ˌmænɪfeˈsteɪʃn/; [n]表现,表示;显灵;示威运动; [or]6j;
manipulate: [a]/məˈnɪpjuleɪt/; [v]操纵,影响;正骨; [or]6j;
mansion: [a]/ˈmænʃn/; [n]官邸;巨宅;大厦; [or]6j;
manual: [a]/ˈmænjuəl/; [n]手册;指南;  [adj]手的;手制的;手工的;体力的; [or]6j;
manufacture: [a]/ˌmænjuˈfæktʃər/; [v]生产;制造;  [n]制造,生产;制造业;(复)产品; [or]6j;
manufacturer: [a]/ˌmænjuˈfæktʃərər/; [n]制造商;制造厂; [or]6j;
manure: [a]/məˈnʊr/; [n]肥料;  [v]施肥于;耕种; [or]6j;
manuscript: [a]/ˈmænjuskrɪpt/; [n]手稿;底稿;手抄本; [or]6j;
maple: [a]/ˈmeɪpl/; [n]枫树;枫木; [or]6j;
mar: [a]/mɑːr/; [v]毁坏,弄糟,玷污; [or]6j;
marble: [a]/ˈmɑːrbl/; [n]大理石;(游戏用的)玻璃弹子; [or]6j;
margin: [a]/ˈmɑːrdʒən/; [n]页边的空白,边缘;优势;利润; [or]6j;
marginal: [a]/ˈmɑːrdʒɪnl/; [adj]微小的,不重要的;仅以微弱多数票获胜的;  [n](议会或地方委员会的)边缘席位; [or]6j;
marsh: [a]/mɑːrʃ/; [n]湿地;沼泽; [or]6j;
marshal: [a]/ˈmɑːrʃl/; [v]整理,排列,集结;  [n]元帅;司仪,主持人; [or]6j;
martyr: [a]/ˈmɑːrtər/; [n]烈士;受难者;乞怜者;  [v]迫害,折磨; [or]6j;
marvel: [a]/ˈmɑːrvl/; [n]奇迹,奇景;奇才;  [v]惊叹,吃惊,诧异; [or]6j;
masculine: [a]/ˈmæskjəlɪn/; [adj]男性的;男子气概的; [or]6j;
mash: [a]/mæʃ/; [v]捣碎;  [n]糊状物; [or]6j;
mask: [a]/mæsk/; [n]面具;遮蔽物;伪装;  [v]隐藏(感情);掩盖,掩饰,掩护;伪装; [or]6j;
mason: [a]/ˈmeɪsn/; [n]泥瓦匠,共济会会员(等于freemason); [or]6j;
mass: [a]/mæs/; [n]众多;大多数;<物>质量;群众;  [adj]大量的,大规模的;  [v]聚集; [or]6j;
massacre: [a]/ˈmæsəkər/; [n]大屠杀,残杀;惨败;  [v]屠杀;彻底击败; [or]6j;
massive: [a]/ˈmæsɪv/; [adj]巨大的;大规模的;大量的; [or]6j;
mast: [a]/mæst/; [n]桅,桅杆,柱;旗杆;天线竿;  [v]装桅杆于; [or]6j;
masterpiece: [a]/ˈmæstərpiːs/; [n]杰作; [or]6j;
mature: [a]/məˈtʃʊr/; [adj]成熟的;到期的;  [vt]使成熟;  [vi]成熟; [or]6j;
maximum: [a]/ˈmæksɪməm/; [n]最大值;最大限度;  [adj]最大的; [or]6j;
meadow: [a]/ˈmedoʊ/; [n]草地; [or]6j;
mechanical: [a]/məˈkænɪkl/; [adj]机械的,机械学的,机械性的; [or]6j;
mechanism: [a]/ˈmekənɪzəm/; [n]机械装置;机制,机理,原理; [or]6j;
mechanize: [a]/ˈmekənaɪz/; [v]使机械化; [or]6j;
medal: [a]/ˈmedl/; [n]奖牌;勋章;  [v]授予奖章; [or]6j;
media: [a]/ˈmiːdiə/; [n]媒体;传播媒介; [or]6j;
mediate: [a]/ˈmiːdieɪt/; [v]调解,调停,斡旋; [or]6j;
medieval: [a]/ˌmediˈiːvl/; [adj]中世纪的,中古(时代)的; [or]6j;
meditate: [a]/ˈmedɪteɪt/; [v]考虑,沉思,冥想; [or]6j;
mediterranean: [a]/ˌmedɪtə'reɪniən/; [adj]地中海的;地中海地区的; [or]6j;
medium: [a]/ˈmiːdiəm/; [adj]中等的;适中的;  [n]手段;媒介;材料; [or]6j;
melancholy: [a]/ˈmelənkɑːli/; [n]忧郁,悲哀;  [adj]忧郁的,令人伤感的; [or]6j;
melody: [a]/ˈmelədi/; [n]旋律,曲调,悦耳的音乐; [or]6j;
melt: [a]/melt/; [v]融化;熔化;溶化; [or]6j;
membership: [a]/ˈmembərʃɪp/; [n]会员资格;成员资格; [or]6j;
memorize: [a]/ˈmeməraɪz/; [v]熟记; [or]6j;
menace: [a]/ˈmenəs/; [v]威胁,威吓;  [n]威胁;具有危险性的人(或物); [or]6j;
mental: [a]/ˈmentl/; [adj]精神的;心理的; [or]6j;
mentality: [a]/menˈtæləti/; [n]脑力;思想;心理; [or]6j;
merchandise: [a]/ˈmɜːrtʃəndaɪs/; [n]商品,货品;  [v]推销,经营; [or]6j;
merciful: [a]/ˈmɜːrsɪfl/; [adj]慈善的,仁慈的,宽大的; [or]6j;
mercury: [a]/ˈmɜːrkjəri/; [n]水银,汞;水星(Mercury); [or]6j;
mere: [a]/mɪr/; [adj]仅仅的;纯粹的;  [n]小湖,池塘;〈英〉边境(线); [or]6j;
merely: [a]/ˈmɪrli/; [adv]仅仅;仅仅,只不过; [or]6j;
merge: [a]/mɜːrdʒ/; [v]合并;融合; [or]6j;
merit: [a]/ˈmerɪt/; [n]优点;价值;功绩;  [v]值得;应得; [or]6j;
mesh: [a]/meʃ/; [n]网,筛孔;  [v]相啮合; [or]6j;
mess: [a]/mes/; [n]凌乱状态,混乱状态;肮脏,污秽;困境;食堂;大量某物;  [v]弄脏,弄乱;浪费时间,瞎闹; [or]6j;
messenger: [a]/ˈmesɪndʒər/; [n]送信者; [or]6j;
metallic: [a]/məˈtælɪk/; [adj]金属的;金属般的; [or]6j;
metallurgy: [a]/ˈmetlɜːrdʒi/; [n]冶金学,冶金术; [or]6j;
meteorite: [a]/ˈmiːtiəraɪt/; [n]流星;陨星; [or]6j;
methodology: [a]/ˌmeθəˈdɑːlədʒi/; [n]方法论,方法学;(某一学科的)一套方法; [or]6j;
metropolitan: [a]/ˌmetrəˈpɑːlɪtən/; [adj]大城市的,大都会的;大主教区的; [or]6j;
microprocessor: [a]/ˌmaɪkroʊˈproʊsesər/; [n]微处理器; [or]6j;
microscopic: [a]/ˌmaɪkrəˈskɑːpɪk/; [adj]极小的;用显微镜可见的; [or]6j;
microwave: [a]/ˈmaɪkrəweɪv/; [n]微波炉,微波;  [v]用微波炉加热; [or]6j;
midst: [a]/mɪdst/; [n]中部,中间; [or]6j;
mighty: [a]/ˈmaɪti/; [adj]强大的,强有力的,有势力的;  [adv]很,非常; [or]6j;
migrant: [a]/ˈmaɪɡrənt/; [n]候鸟;移民; [or]6j;
migrate: [a]/ˈmaɪɡreɪt/; [vi]迁徙;迁移,移往;迁移; [or]6j;
migration: [a]/maɪˈɡreɪʃn/; [n]迁移;移民;移动; [or]6j;
mild: [a]/maɪld/; [adj]味淡的;温暖的;轻微的;温和的;  [n]淡味啤酒; [or]6j;
militant: [a]/ˈmɪlɪtənt/; [adj]好战的,好暴力的;  [n]激进分子,斗士; [or]6j;
military: [a]/ˈmɪləteri/; [n]军队;  [adj]军事的; [or]6j;
millionaire: [a]/ˌmɪljəˈner/; [n]百万富翁,大富翁; [or]6j;
mingle: [a]/ˈmɪŋɡl/; [v]使混合,使相混;  [vi]相交往,相往来; [or]6j;
miniature: [a]/ˈmɪnətʃər/; [adj]小型的,微小的;  [n]微小的模型,缩影,微型人物像;  [vt]使成小型;把.画成纤细画;缩写; [or]6j;
minibus: [a]/ˈmɪnibʌs/; [n]小型公共汽车,小型巴士; [or]6j;
minimal: [a]/ˈmɪnɪməl/; [adj]最低限度的; [or]6j;
minimize: [a]/ˈmɪnɪmaɪz/; [v]使缩到最小;达到最低值; [or]6j;
minimum: [a]/ˈmɪnɪməm/; [adj]最少的,最低程度的;  [n]最低限度,最小量; [or]6j;
minority: [a]/maɪˈnɔːrəti/; [n]少数;少数民族;未成年;  [adj]构成少数的; [or]6j;
mint: [a]/mɪnt/; [n]薄荷,薄荷糖,造币厂;  [v]铸造(硬币); [or]6j;
miser: [a]/ˈmaɪzər/; [n]守财奴,吝啬鬼,(石油)凿井机; [or]6j;
misery: [a]/ˈmɪzəri/; [n]痛苦,悲惨,不幸; [or]6j;
misfortune: [a]/ˌmɪsˈfɔːrtʃuːn/; [n]不幸,灾祸; [or]6j;
mission: [a]/ˈmɪʃn/; [n]任务,使命;代表团,使团;  [vi]派遣..执行任务; [or]6j;
missionary: [a]/ˈmɪʃəneri/; [n]传教士; [or]6j;
mitten: [a]/ˈmɪtn/; [n]连指手套; [or]6j;
mixer: [a]/ˈmɪksər/; [n]搅拌机;调酒用的饮料;混频器; [or]6j;
moan: [a]/moʊn/; [n]呻吟声;呜咽声;怨声;牢骚;  [v]呻吟;呜咽;抱怨;发牢骚; [or]6j;
mob: [a]/mɑːb/; [n]乌合之众,(尤指)暴民;  [v](指民众)包围(为攻击或赞赏); [or]6j;
mobile: [a]/ˈmoʊbl/; [n]风铃,悬挂饰物;手机,移动电话;  [adj]可移动的;行动方便的; [or]6j;
mobilize: [a]/ˈmoʊbəlaɪz/; [v]动员起来;动员;鼓动起; [or]6j;
mock: [a]/mɑːk/; [v]嘲笑;轻蔑,蔑视;  [adj]不真诚的;伪造的;  [n]模拟考; [or]6j;
modernize: [a]/ˈmɑːdərnaɪz/; [v](使)现代化; [or]6j;
modest: [a]/ˈmɑːdɪst/; [adj]谦虚的,谦逊的;端庄的,羞怯的;不太大(或太贵,太重要)的,适度的; [or]6j;
modification: [a]/ˌmɑːdɪfɪˈkeɪʃn/; [n]修改,改进,改造; [or]6j;
modify: [a]/ˈmɑːdɪfaɪ/; [v]改装,修改,更改;修饰,限定; [or]6j;
modulate: [a]/ˈmɑːdʒəleɪt/; [v]调整(音调);变调;调节(使平衡); [or]6j;
module: [a]/ˈmɑːdʒuːl/; [n]组件,模件,(航天器的)舱;(组成一门课程的)独立单元; [or]6j;
molecular: [a]/məˈlekjələr/; [adj]分子的; [or]6j;
molecule: [a]/ˈmɑːlɪkjuːl/; [n]分子,微粒; [or]6j;
molten: [a]/ˈmoʊltən/; [adj]熔化的; [or]6j;
momentary: [a]/ˈmoʊmənteri/; [adj]短暂的,瞬间的; [or]6j;
momentum: [a]/moʊˈmentəm/; [n](物理)动量;势头;动力; [or]6j;
monarch: [a]/ˈmɑːnərk/; [n]君主;帝王;统治者; [or]6j;
monetary: [a]/ˈmɑːnɪteri/; [adj]货币的,金融的;金钱的; [or]6j;
monitor: [a]/ˈmɑːnɪtər/; [n]显示器;监视器;班长;  [v]监视;监督;监测; [or]6j;
monk: [a]/mʌŋk/; [n]和尚,修道士,僧侣; [or]6j;
monologue: [a]/ˈmɑːnəlɔːɡ/; [n]独白,个人长篇演说; [or]6j;
monopoly: [a]/məˈnɑːpəli/; [n]垄断;专卖;垄断商品;专卖商品; [or]6j;
monster: [a]/ˈmɑːnstər/; [n]怪物,怪兽,妖怪;巨兽,巨大的东西,庞然大物;极其残酷的人,恶人,恶魔;小恶棍,捣蛋鬼〔幽默用法〕;  [adj]巨大的;庞大的; [or]6j;
moor: [a]/mʊr/; [v]停泊;系住;  [n]旷野地;荒野; [or]6j;
mop: [a]/mɑːp/; [n]拖把(俗称地拖);多而蓬乱的头发;  [v]用拖把拖洗,擦,抹; [or]6j;
moral: [a]/ˈmɔːrəl/; [adj]道德(上)的,道义的;  [n]道德,品行;寓意; [or]6j;
morality: [a]/məˈræləti/; [n]道德,道德观;道德规范,伦理体系; [or]6j;
moreover: [a]/mɔːrˈoʊvər/; [adv]此外,而且; [or]6j;
mortal: [a]/ˈmɔːrtl/; [adj]必有一死的;致命的;极端的;  [n]人类; [or]6j;
mortgage: [a]/ˈmɔːrɡɪdʒ/; [n]按揭贷款,抵押贷款;  [v]抵押; [or]6j;
mosque: [a]/mɑːsk/; [n]伊斯兰教寺院;清真寺; [or]6j;
moss: [a]/mɔːs/; [n]苔,藓,地衣; [or]6j;
motivate: [a]/ˈmoʊtɪveɪt/; [vt]激励;使有动机;促进;促动;激发..的积极性; [or]6j;
motive: [a]/ˈmoʊtɪv/; [n]动机,目的;  [adj]发动的,运动的,动机的;  [v]引发,促进,激发; [or]6j;
motorway: [a]/ˈmoʊtərweɪ/; [n]高速公路; [or]6j;
motto: [a]/ˈmɑːtoʊ/; [n]座右铭;格言;箴言;口号; [or]6j;
mountainous: [a]/ˈmaʊntənəs/; [adj]多山的;巨大的; [or]6j;
mourn: [a]/mɔːrn/; [v]哀悼,哀伤; [or]6j;
muddy: [a]/ˈmʌdi/; [adj]泥泞的;暗淡的;浑浊的;  [v]使粘上烂泥;显得扑朔迷离; [or]6j;
multiple: [a]/ˈmʌltɪpl/; [adj]多重的,复合的,倍数的;  [n]倍数; [or]6j;
multiplication: [a]/ˌmʌltɪplɪˈkeɪʃn/; [n]乘法; [or]6j;
multiply: [a]/ˈmʌltɪplaɪ/; [v]乘;繁殖;增加; [or]6j;
multitude: [a]/ˈmʌltɪtuːd/; [n]大量;众多;大批;群众; [or]6j;
murmur: [a]/ˈmɜːrmər/; [v]低声说,低语;低声抱怨;  [n]低语;喃喃说话声; [or]6j;
muscular: [a]/ˈmʌskjələr/; [adj]肌肉的;肌肉发达的;强有力的; [or]6j;
muse: [a]/mjuːz/; [v]沉思;冥想;  [n]<希神>缪斯女神,灵感; [or]6j;
mustard: [a]/ˈmʌstərd/; [n]芥菜;芥末;芥末色;  [adj]芥末色的; [or]6j;
mute: [a]/mjuːt/; [n]弱音器;  [adj]缄默的;哑的;  [vt]减弱.的声音; [or]6j;
mutter: [a]/ˈmʌtər/; [n]低语;小声抱怨;  [v]低声说;小声抱怨;  [vt]低声说;抱怨地说; [or]6j;
mutual: [a]/ˈmjuːtʃuəl/; [adj]互相的;彼此的;共同的; [or]6j;
myth: [a]/mɪθ/; [n]神话;虚构的信念(或观念,理论);杜撰出来的人(或事物); [or]6j;
naive: [a]/naɪˈiːv/; [adj]天真的;  [n]天真的人; [or]6j;
napkin: [a]/ˈnæpkɪn/; [n]纸巾,餐巾,(小孩用的)尿布; [or]6j;
narration: [a]/nəˈreɪʃn/; [n]叙述;解说;配音; [or]6j;
narrative: [a]/ˈnærətɪv/; [n]叙述;  [adj]叙述的; [or]6j;
nasty: [a]/ˈnæsti/; [adj]令人讨厌的;严重的;恶劣的;下流的;  [n](复数形式)令人不愉快或对人有害的事物; [or]6j;
navigation: [a]/ˌnævɪˈɡeɪʃn/; [n]导航,航行,航海; [or]6j;
negative: [a]/ˈneɡətɪv/; [adj]消极的,负面的;否定的;  [n]否定,否定词;底片; [or]6j;
neglect: [a]/nɪˈɡlekt/; [v]忽视;忽略;疏忽;  [n]疏忽;忽视; [or]6j;
negligence: [a]/ˈneɡlɪdʒəns/; [n]疏忽; [or]6j;
negligible: [a]/ˈneɡlɪdʒəbl/; [adj]微不足道的,可忽略不计的; [or]6j;
negotiate: [a]/nɪˈɡoʊʃieɪt/; [v]谈判,交涉,商议;成功越过,渡过; [or]6j;
neighbouring: [a]/ˈneɪbərɪŋ/; [adj]附近的,毗邻的; [or]6j;
neutral: [a]/ˈnuːtrəl/; [adj]中立的;中性的;  [n]中立国;中性色; [or]6j;
neutron: [a]/ˈnuːtrɑːn/; [n]中子; [or]6j;
nickel: [a]/ˈnɪkl/; [n]镍;美国五分镍币;五分钱; [or]6j;
nickname: [a]/ˈnɪkneɪm/; [n]绰号;诨号;昵称;  [vt]起绰号;叫错.的名字; [or]6j;
nightmare: [a]/ˈnaɪtmer/; [n]噩梦;可怕的情景;  [adj]可怕的,噩梦似的; [or]6j;
nil: [a]/nɪl/; [n]零;无; [or]6j;
nominal: [a]/ˈnɑːmɪnl/; [adj]名义上的;象征性的,很少的;名词性的; [or]6j;
nominate: [a]/ˈnɑːmɪneɪt/; [v]提名;任命;  [adj]有特定名字的;被提名的;被指定的; [or]6j;
norm: [a]/nɔːrm/; [n]准则;模范;规范,标准; [or]6j;
normalization: [a]/ˌnɔːrmələˈzeɪʃn/; [n]正常化; [or]6j;
northward(s): [a]/ˈnɔːrθwərdz/; [adv]向北地; [or]6j;
notable: [a]/ˈnoʊtəbl/; [n]著名人士;  [adj]值得注意的,显著的,显要的; [or]6j;
notation: [a]/noʊˈteɪʃn/; [n]记号;标记法;记录; [or]6j;
noted: [a]/ˈnoʊtɪd/; [adj]著名的; [or]6j;
notify: [a]/ˈnoʊtɪfaɪ/; [v]通知,告知;报告; [or]6j;
notion: [a]/ˈnoʊʃn/; [n]概念,观念;观点,看法;突然的念头;意图; [or]6j;
notorious: [a]/noʊˈtɔːriəs/; [adj]臭名昭著的,声名狼藉的; [or]6j;
notwithstanding: [a]/ˌnɑːtwɪθˈstændɪŋ/; prep. 尽管,虽然;  [adv]尽管,虽然;  [conj]尽管,虽然; [or]6j;
nought: [a]/nɔːt/; [n]无;零; [or]6j;
nourish: [a]/ˈnɜːrɪʃ/; [v]养育;培育(希望);增强(希望); [or]6j;
nourishment: [a]/ˈnɜːrɪʃmənt/; [n]食物,营养品; [or]6j;
novelty: [a]/ˈnɑːvlti/; [n]新奇;新奇的事物;新颖小巧而廉价的小物品;  [adj]新奇的;风格独特的; [or]6j;
numerical: [a]/nuːˈmerɪkl/; [adj]数字的,用数字表示的; [or]6j;
numerous: [a]/ˈnuːmərəs/; [adj]为数众多的,许多的; [or]6j;
nun: [a]/nʌn/; [n]修女,尼姑; [or]6j;
nurture: [a]/ˈnɜːrtʃər/; [v]养育,培育;培植;  [n]养育,培养;教养;营养物; [or]6j;
nutrition: [a]/nuˈtrɪʃn/; [n]营养,营养学; [or]6j;
oar: [a]/ɔːr/; [n]桨,橹; [or]6j;
oath: [a]/oʊθ/; [n]誓言;誓约;咒骂;咒语; [or]6j;
obedient: [a]/oʊˈbiːdiənt/; [adj]服从的,顺从的;孝顺的; [or]6j;
object: [a]/ˈɑːbdʒekt/; [n]物体;宾语;目标;  [v]提出..作为反对的理由;反对; [or]6j;
objection: [a]/əbˈdʒekʃn/; [n]反对,异议; [or]6j;
objective: [a]/əbˈdʒektɪv/; [n]目标;目的;  [adj]客观的; [or]6j;
obligation: [a]/ˌɑːblɪˈɡeɪʃn/; [n]义务,责任; [or]6j;
obscene: [a]/əbˈsiːn/; [adj]下流的,淫秽的; [or]6j;
obscure: [a]/əbˈskjʊr/; [v]隐藏,使.模糊;使变暗;遮掩;  [adj]不清楚的;难以理解的;  [n]某种模糊的或不清楚的东西; [or]6j;
obsolete: [a]/ˌɑːbsəˈliːt/; [adj]已过时的;已废弃的;  [v]使过时;使作废;  [n]废词;被废弃的事物; [or]6j;
obstacle: [a]/ˈɑːbstəkl/; [n]障碍;障碍物;妨碍; [or]6j;
obstinate: [a]/ˈɑːbstɪnət/; [adj]顽固的;较难治愈的; [or]6j;
obtain: [a]/əbˈteɪn/; [v]获得,赢得,取得;存在,流行,适用; [or]6j;
occasional: [a]/əˈkeɪʒənl/; [adj]偶尔的;临时的;偶然的; [or]6j;
occupation: [a]/ˌɑːkjuˈpeɪʃn/; [n]占领,占据;占用,居住;职业,工作;消遣; [or]6j;
occupy: [a]/ˈɑːkjupaɪ/; [v]占领,占据,侵占;住在,居住,住进;担任(职务),任职;占用(时间,空间等),占有;使用(房屋,建筑); [or]6j;
occur: [a]/əˈkɜːr/; [vi]发生;出现,存在; [or]6j;
odor: [a]/ˈoʊdər/; [n]气味; [or]6j;
offense: [a]/əˈfens/; [n]犯罪,冒犯,过错,触怒,犯规,进攻; [or]6j;
offensive: [a]/əˈfensɪv/; [adj]冒犯的,进攻的,无礼的,令人不快的,得罪人的;  [n]进攻; [or]6j;
offset: [a]/ˈɔːfset/; [v]抵消;  [adj]胶印的,透印版印刷的;  [n]分支;抵销; [or]6j;
offspring: [a]/ˈɔːfsprɪŋ/; [n]后代; [or]6j;
ohm: [a]/oʊm/; [n]欧姆; [or]6j;
olive: [a]/ˈɑːlɪv/; [n]橄榄;橄榄树;橄榄色;  [adj]橄榄色的; [or]6j;
opaque: [a]/oʊˈpeɪk/; [adj]不透明的;难懂的; [or]6j;
opium: [a]/ˈoʊpiəm/; [n]鸦片; [or]6j;
opponent: [a]/əˈpoʊnənt/; [n]对手,敌手,对抗者;  [adj]对立的;敌对的; [or]6j;
oppose: [a]/əˈpoʊz/; [v]反对;反抗; [or]6j;
optimism: [a]/ˈɑːptɪmɪzəm/; [n]乐观,乐观主义; [or]6j;
optimist: [a]/ˈɑːptɪmɪst/; [n]乐天派,乐观者; [or]6j;
optimistic: [a]/ˌɑːptɪˈmɪstɪk/; [adj]乐观的,乐观主义的; [or]6j;
optimum: [a]/ˈɑːptɪməm/; [adj]最适宜的;最佳的;  [n]最适条件;最适宜; [or]6j;
option: [a]/ˈɑːpʃn/; [n]选择;选择权;选修课;  [v]得到或获准进行选择;调动球员; [or]6j;
orbit: [a]/ˈɔːrbɪt/; [v]环绕..的轨道运行;  [n]轨道;  [vi]环绕..的轨道运行; [or]6j;
orchestra: [a]/ˈɔːrkɪstrə/; [n]管弦乐队;  [adj]管弦乐队的; [or]6j;
ordinarily: [a]/ˌɔːrdnˈerəli/; [adv]普通;通常; [or]6j;
ore: [a]/ɔːr/; [n]矿石;矿砂;矿,矿石; [or]6j;
orient: [a]/ˈɔːrient/; [n][the Orient]东方;  [v]定..的方位;  [adj]东方的;(太阳等)上升的,新生的;闪闪发光的; [or]6j;
oriental: [a]/ˌɔːriˈentl/; [adj]东方的;  [n]东方人; [or]6j;
orientation: [a]/ˌɔːriənˈteɪʃn/; [n]信仰;倾向;<计>定向;(学生)迎新会;定向,方向;(任职,上学等之前的) 情况介绍;训练; [or]6j;
origin: [a]/ˈɔːrɪdʒɪn/; [n]起源;由来,来源;出身; [or]6j;
original: [a]/əˈrɪdʒənl/; [adj]有独创性的,原始的,最初的,新颖的;  [n]原件;怪人; [or]6j;
originality: [a]/əˌrɪdʒəˈnæləti/; [n]创造性;独创性; [or]6j;
originate: [a]/əˈrɪdʒɪneɪt/; [vi]起源;开始;  [vt]开创; [or]6j;
ornament: [a]/ˈɔːrnəmənt/; [n]装饰;  [v]装饰; [or]6j;
ornamental: [a]/ˌɔːrnəˈmentl/; [adj]装饰性的;  [n]观赏植物;装饰物; [or]6j;
orthodox: [a]/ˈɔːrθədɑːks/; [adj]正统的;传统的;(Orthodox)东正教的; [or]6j;
outbreak: [a]/ˈaʊtbreɪk/; [n](战争,叛乱,感情等的)爆发;突然发生;  [vi]爆发; [or]6j;
outermost: [a]/ˈaʊtərmoʊst/; [adj]最外面的;最远的; [or]6j;
outfit: [a]/ˈaʊtfɪt/; [n]装备,全部用品,(协同工作)的一组人;  [v]提供装备; [or]6j;
outlaw: [a]/ˈaʊtlɔː/; [n]歹徒,逃犯,丧失公权者;  [v]将..放逐,宣布..为不合法; [or]6j;
outline: [a]/ˈaʊtlaɪn/; [n]外形,轮廓;大纲,概要;  [v]描绘,画出..的轮廓; [or]6j;
output: [a]/ˈaʊtpʊt/; [n]产量,输出;  [vt]生产,出产,制造;输出;  [vi]生产,出产,制造;输出; [or]6j;
outrage: [a]/ˈaʊtreɪdʒ/; [n]残暴;暴行,愤怒;  [v]使震怒,使愤慨; [or]6j;
outset: [a]/ˈaʊtset/; [n]开始,开端; [or]6j;
outward: [a]/ˈaʊtwərd/; [adj]外面的;向外的;  [adv]外面地,向外地;  [n]外表;外在事务;周围世界;〈罕〉外部; [or]6j;
oval: [a]/ˈoʊvl/; [adj]椭圆形的;  [n]椭圆形; [or]6j;
overcome: [a]/ˌoʊvərˈkʌm/; [v]战胜;克服;压倒;得胜,征服; [or]6j;
overestimate: [a]/ˌoʊvərˈestɪmət/; [v]过高估计;过高评价;  [n]过高的估计;过高的评价; [or]6j;
overflow: [a]/ˌoʊvərˈfloʊ/; [v]满得外溢,外流,泛滥;充满,洋溢;  [n]溢流口,溢流管;容纳不下的物(或人);溢出,满出;超出额;  [adj]充满的; [or]6j;
overhang: [a]/ˌoʊvərˈhæŋ/; [n]突出;悬垂;伸出量;  [v]悬于..之上; [or]6j;
overhead: [a]/ˌoʊvərˈhed/; [adj]在头顶上的,上面的,架空的;  [adv]在上面;在头顶,在上面;  [n]吊顶,天花板,屋顶;企业运营的一般费用(如房租,电费等); [or]6j;
overhear: [a]/ˌoʊvərˈhɪr/; [v]无意中听到,偷听到; [or]6j;
overlap: [a]/ˌoʊvərˈlæp/; [n]重叠,重复;  [v](部分地)重叠; [or]6j;
overload: [a]/ˌoʊvərˈloʊd/; [n]过载;过重负担;过度刺激;  [v]使超载,使过载;使负担(或负荷)过重; [or]6j;
overlook: [a]/ˌoʊvərˈlʊk/; [v]忽视,未注意到;眺望,俯视;  [n]忽视,远眺; [or]6j;
overpass: [a]/ˈoʊvərpæs/; [n]天桥; [or]6j;
overt: [a]/oʊˈvɜːrt/; [adj]明显的;公开的;公然的; [or]6j;
overturn: [a]/ˌoʊvərˈtɜːrn/; [v]打翻;  [vt]推翻; [or]6j;
overwhelm: [a]/ˌoʊvərˈwelm/; [v]压垮;不知所措;淹没;打败,压倒; [or]6j;
overwhelming: [a]/ˌoʊvərˈwelmɪŋ/; [adj]巨大的,势不可挡的,压倒性的;制服的,无法抗拒的; [or]6j;
owe: [a]/oʊ/; [v]感谢;欠;把.归于;占有;欠钱; [or]6j;
owl: [a]/aʊl/; [n]猫头鹰; [or]6j;
oxidize: [a]/ˈɑːksɪdaɪz/; [v]生锈;氧化; [or]6j;
oxygen: [a]/ˈɑːksɪdʒən/; [n]氧气; [or]6j;
oyster: [a]/ˈɔɪstər/; [n]牡蛎;从中可得到好处的东西;<口语>沉默寡言;  [v]采牡蛎; [or]6j;
ozone: [a]/ˈoʊzoʊn/; [n]臭氧;(口语)新鲜空气;能使人兴奋的力量; [or]6j;
package: [a]/ˈpækɪdʒ/; [n]包裹;一揽子,一整套; [or]6j;
pact: [a]/pækt/; [n]合同;协约; [or]6j;
pajamas: [a]/pəˈdʒæməz/; [n](=pyjamas)睡衣,宽长裤; [or]6j;
pamphlet: [a]/ˈpæmflət/; [n]小册子; [or]6j;
panic: [a]/ˈpænɪk/; [n]恐慌;惊慌;慌乱;  [v](使)恐慌;使..惊慌失措;  [adj]恐慌的,惊慌的; [or]6j;
pant: [a]/pænt/; [v]喘息;气喘吁吁地说;喘气;  [n]喘气; [or]6j;
panther: [a]/ˈpænθər/; [n]豹;黑豹; [or]6j;
pantry: [a]/ˈpæntri/; [n]食品室;餐具室; [or]6j;
paperback: [a]/ˈpeɪpərbæk/; [n]平装书,平装本,简装本;  [adj]纸面装订的,平装本的;  [v]以平装本(或纸面本)出版; [or]6j;
parachute: [a]/ˈpærəʃuːt/; [n]降落伞;  [v]跳伞; [or]6j;
paradise: [a]/ˈpærədaɪs/; [n]天国;天堂;极乐世界; [or]6j;
paradox: [a]/ˈpærədɑːks/; [n]矛盾;似矛盾而正确的说法; [or]6j;
paragraph: [a]/ˈpærəɡræf/; [n](文章的)段,节; [or]6j;
parallel: [a]/ˈpærəlel/; [adj]平行的;相似的;  [n]相似物;平行线;  [v]与..相似;与..匹配;  [adv]并行地,平行地; [or]6j;
paralysis: [a]/pəˈræləsɪs/; [n]瘫痪(症),麻痹(症); [or]6j;
paralyze: [a]/ˈperəˌlaɪz/; [vt]使瘫痪;使麻痹;使不能活动; [or]6j;
parasite: [a]/ˈpærəsaɪt/; [n]寄生虫;靠他人为生的人; [or]6j;
partial: [a]/ˈpɑːrʃl/; [adj]偏爱的,特别喜欢的;偏袒的,不公平的,有偏见的;部分的;不完全的;  [n]<数学>偏微商; [or]6j;
participant: [a]/pɑːrˈtɪsɪpənt/; [n]参加者,参与者;  [adj]参加的;有关系的; [or]6j;
participation: [a]/pɑːrˌtɪsɪˈpeɪʃn/; [n]参与;参加; [or]6j;
partition: [a]/pɑːrˈtɪʃn/; [n]划分;隔开物,隔墙,隔板;  [v]隔开;  [vt]瓜分;分割; [or]6j;
passion: [a]/ˈpæʃn/; [n]激情; [or]6j;
passive: [a]/ˈpæsɪv/; [adj]被动的;消极的;  [n]被动语态; [or]6j;
pastime: [a]/ˈpæstaɪm/; [n]消遣,娱乐; [or]6j;
pastry: [a]/ˈpeɪstri/; [n]糕点,点心; [or]6j;
pasture: [a]/ˈpæstʃər/; [n]牧场,草地;生活状况;  [v]放牧; [or]6j;
patent: [a]/ˈpætnt/; [n]专利;  [adj]显然的,明显的;专利的;独创的;  [v]取得.的专利权; [or]6j;
pathetic: [a]/pəˈθetɪk/; [adj]可怜的;不足的; [or]6j;
patriot: [a]/ˈpeɪtriət/; [n]爱国者; [or]6j;
patriotic: [a]/ˌpeɪtriˈɑːtɪk/; [adj]爱国的,有爱国心的,显示爱国精神的; [or]6j;
patrol: [a]/pəˈtroʊl/; [n]巡逻兵;巡逻;  [v]巡逻;巡查,巡游; [or]6j;
patron: [a]/ˈpeɪtrən/; [n]老主顾;赞助人;支持者; [or]6j;
pattern: [a]/ˈpætərn/; [n]模型,模式;典型;图案;版式;样品;  [vi]形成图案;  [vt]用图案装饰; [or]6j;
pave: [a]/peɪv/; [v]铺(路),铺筑; [or]6j;
peak: [a]/piːk/; [n]顶峰;山顶;尖端;  [v]达到最高点;  [adj]最高度的;高峰时期的;巅峰状态的; [or]6j;
pearl: [a]/pɜːrl/; [n]珍珠;珠状物; [or]6j;
peculiar: [a]/pɪˈkjuːliər/; [adj]奇怪的,古怪的;特有的,特别的; [or]6j;
peculiarity: [a]/pɪˌkjuːliˈærəti/; [n]怪癖;独特性; [or]6j;
pedal: [a]/ˈpedl/; [n]踏脚板;  [v]踏踩板;  [adj]脚踏的;  [vt]踏.的踏板; [or]6j;
pedestrian: [a]/pəˈdestriən/; [n]步行者,行人;  [adj]步行的;平庸无奇的,无聊的; [or]6j;
pedlar: [a]/ˈpedlər/; [n]小贩;传播者; [or]6j;
peel: [a]/piːl/; [v]剥皮,削皮,去壳;  [n]果皮,外皮; [or]6j;
peer: [a]/pɪr/; [n]同龄人,同等地位的人;贵族;  [v]仔细看,费力地看; [or]6j;
peg: [a]/peɡ/; [n]小钉,栓,挂物钉;晾衣夹;  [v]用钉子钉,用钉(或桩等)固定;限定(价格,工资等);将.看成,将.归入; [or]6j;
penalty: [a]/ˈpenəlti/; [n]惩罚,处罚,不利,罚球;  [adj]处罚的; [or]6j;
pendulum: [a]/ˈpendʒələm/; [n]摆,钟摆;摇摆不定的事态(或局面); [or]6j;
penguin: [a]/ˈpeŋɡwɪn/; [n]企鹅; [or]6j;
peninsula: [a]/pəˈnɪnsələ/; [n]半岛; [or]6j;
pension: [a]/ˈpenʃn/; [n]养老金,抚恤金;廉租屋;  [v]发给..养老金; [or]6j;
perception: [a]/pərˈsepʃn/; [n]洞察力,理解力;洞察力,理解力,认识,观念,看法; [or]6j;
perch: [a]/pɜːrtʃ/; [v](使)栖息,就位;  [n]栖木,有利的地位,杆,河鲈; [or]6j;
perfection: [a]/pərˈfekʃn/; [n]完美,完满;完善; [or]6j;
performance: [a]/pərˈfɔːrməns/; [n]表演,演出;表现;执行;性能; [or]6j;
perfume: [a]/pərˈfjuːm/; [n]香水;香气;  [v]使充满芳香;洒香水于; [or]6j;
peril: [a]/ˈperəl/; [n]危险;  [vt]置.于危险中;危及; [or]6j;
perimeter: [a]/pəˈrɪmɪtər/; [n]周长;周界; [or]6j;
periodical: [a]/ˌpɪriˈɑːdɪkl/; [n]期刊;杂志; [or]6j;
peripheral: [a]/pəˈrɪfərəl/; [adj]外围的;  [n]外围设备; [or]6j;
perish: [a]/ˈperɪʃ/; [vi]死去;毁灭,灭亡;  [v]脆裂,老化,腐烂; [or]6j;
permanence: [a]/ˈpɜːrmənəns/; [n]持久;永久; [or]6j;
permanent: [a]/ˈpɜːrmənənt/; [adj]永久的,持久的;  [n]电烫发; [or]6j;
permeate: [a]/ˈpɜːrmieɪt/; [v]弥漫;普及;渗透; [or]6j;
permissible: [a]/pərˈmɪsəbl/; [adj]容许的;许可的; [or]6j;
perpendicular: [a]/ˌpɜːrpənˈdɪkjələr/; [adj]成直角的,垂直的;直立的;  [n]垂直线; [or]6j;
perpetual: [a]/pərˈpetʃuəl/; [adj]永远的,永恒的;不断的; [or]6j;
perplex: [a]/pərˈpleks/; [v]使困惑; [or]6j;
persecute: [a]/ˈpɜːrsɪkjuːt/; [v](尤指因宗教或政治信仰不同)迫害;烦扰,纠缠; [or]6j;
persevere: [a]/ˌpɜːrsəˈvɪr/; [v]坚持,不屈不挠; [or]6j;
persist: [a]/pərˈsɪst/; [v]坚持,固执;继续存留; [or]6j;
persistence: [a]/pərˈsɪstəns/; [n]坚持不懈,持续; [or]6j;
persistent: [a]/pərˈsɪstənt/; [adj]坚持的;持续的; [or]6j;
perspective: [a]/pərˈspektɪv/; [n]角度,视角,观点,想法;(对事物的)合理判断,正确认识;远景;透视图,透视法,透视效果;  [adj]透视的; [or]6j;
perspiration: [a]/ˌpɜːrspəˈreɪʃn/; [n]汗水;出汗; [or]6j;
persuasion: [a]/pərˈsweɪʒn/; [n]说服;说服力; [or]6j;
pertinent: [a]/ˈpɜːrtnənt/; [adj]有关的;适当的;中肯的;  [n]附属物;参考; [or]6j;
pessimistic: [a]/ˌpesɪˈmɪstɪk/; [adj]悲观(主义)的; [or]6j;
pest: [a]/pest/; [n]讨厌的人(或东西);害虫; [or]6j;
pesticide: [a]/ˈpestɪsaɪd/; [n]杀虫剂;农药; [or]6j;
petition: [a]/pəˈtɪʃn/; [n]请愿;请愿书;祈求;  [v]请愿; [or]6j;
petty: [a]/ˈpeti/; [adj]价值不大的;小的;器量小的;琐碎的; [or]6j;
pharmacy: [a]/ˈfɑːrməsi/; [n]药房,药剂学,配药业,制药业,一批备用药品; [or]6j;
phase: [a]/feɪz/; [n](月等的)变相;盈亏;方面;阶段; [or]6j;
phenomenon: [a]/fəˈnɑːmɪnən/; [n]现象;奇迹,奇事,奇才; [or]6j;
photoelectric: [a]/ˌfoʊtoʊɪˈlektrɪk/; [adj]光电的; [or]6j;
photography: [a]/fəˈtɑːɡrəfi/; [n]摄影;摄影术; [or]6j;
physiological: [a]/ˌfɪziəˈlɑːdʒɪkl/; [adj]生理的,生理学的; [or]6j;
pickle: [a]/ˈpɪkl/; [n]盐汁;泡菜;  [v]腌; [or]6j;
pier: [a]/pɪr/; [n]码头;桥墩; [or]6j;
pilgrim: [a]/ˈpɪlɡrɪm/; [n]朝圣客;香客; [or]6j;
pineapple: [a]/ˈpaɪnæpl/; [n]凤梨,菠萝; [or]6j;
pinpoint: [a]/ˈpɪnpɔɪnt/; [v]准确地解释或说明;  [adj]精确的;  [n]针尖,极小之物,极不重要的事物; [or]6j;
pious: [a]/ˈpaɪəs/; [adj]虔诚的;难以实现的;尽责的; [or]6j;
pirate: [a]/ˈpaɪrət/; [n]海盗;剽窃者;  [v]剽窃; [or]6j;
pistol: [a]/ˈpɪstl/; [n]手枪,信号,发令枪;  [v]用手枪杀死,用手枪伤害; [or]6j;
piston: [a]/ˈpɪstən/; [n]活塞,瓣; [or]6j;
pitch: [a]/pɪtʃ/; [v]投掷;用沥青覆盖;<音>为...定音高;扎营;搭帐篷;  [n]投掷;球场;沥青;音高; [or]6j;
plague: [a]/pleɪɡ/; [n]瘟疫;灾难;麻烦;  [v]折磨;烦扰;造成麻烦; [or]6j;
planet: [a]/ˈplænɪt/; [n]行星; [or]6j;
plaster: [a]/ˈplæstər/; [n]灰泥,石膏;  [v]抹泥; [or]6j;
plateau: [a]/plæˈtoʊ/; [n]高原;  [vi]到达平稳阶段; [or]6j;
plausible: [a]/ˈplɔːzəbl/; [adj]似乎有理的;巧嘴的; [or]6j;
plea: [a]/pliː/; [n](法律)抗辩;恳求;请求,托词,口实; [or]6j;
plead: [a]/pliːd/; [v]恳求,辩护,(不)认罪;提出.为理由; [or]6j;
pledge: [a]/pledʒ/; [v]发誓,保证,以.抵押,向.祝酒;  [n]保证,誓言; [or]6j;
plight: [a]/plaɪt/; [n]困境;  [v]宣誓,保证; [or]6j;
pluck: [a]/plʌk/; [v]拔去(毛发等);拽开;选;  [n]勇气; [or]6j;
plump: [a]/plʌmp/; [adj]颇胖的,丰满的;  [v]拍打使鼓起,突然坐下,倒下,; [or]6j;
plunder: [a]/ˈplʌndər/; [v]抢劫,掠夺;  [n]抢劫,战利品; [or]6j;
plunge: [a]/plʌndʒ/; [v]跳进,(使)投入;使陷入;暴跌;  [n]卷入,参与;暴跌,骤减; [or]6j;
pneumatic: [a]/nuːˈmætɪk/; [adj]装满空气的;风力的; [or]6j;
poetry: [a]/ˈpoʊətri/; [n]诗,诗歌,诗作;诗意; [or]6j;
poisonous: [a]/ˈpɔɪzənəs/; [adj]有毒的; [or]6j;
poke: [a]/poʊk/; [v]刺,戳;拨开,拨(弄);探(出),露出;  [n]戳,捅; [or]6j;
polar: [a]/ˈpoʊlər/; [adj]极地的;南北两极的;截然对立的,正好相反的; [or]6j;
polarity: [a]/pəˈlærəti/; [n](分)极性;相对的观点; [or]6j;
pole: [a]/poʊl/; [n]杆,竿极(点);磁极;电极; [or]6j;
polish: [a]/ˈpɑːlɪʃ/; [v]磨光,擦亮;润饰,使优美;  [n]擦光剂;优美,完善;  [adj]波兰的;波兰人的;波兰语的; [or]6j;
poll: [a]/poʊl/; [n]投票,投票数;投票站;民意测验;  [v]获得(票数);  [adj]<法>当事人一方作成的; [or]6j;
polymer: [a]/ˈpɑːlɪmər/; [n]聚合体; [or]6j;
ponder: [a]/ˈpɑːndər/; [v]仔细考虑,沉思; [or]6j;
popularity: [a]/ˌpɑːpjuˈlærəti/; [n]受大众欢迎; [or]6j;
porch: [a]/pɔːrtʃ/; [n]门廊;走廊; [or]6j;
pore: [a]/pɔːr/; [n]毛孔,细孔;  [v]深思熟虑,仔细阅读,审视; [or]6j;
portray: [a]/pɔːrˈtreɪ/; [v]描绘;描述; [or]6j;
pose: [a]/poʊz/; [n]姿势;装腔作势,伪装;  [vi]摆造型;  [vt]主张,提出;引起,导致; [or]6j;
positive: [a]/ˈpɑːzətɪv/; [adj]积极的;肯定的,明确的;正面的;阳性的;  [n]正面;肯定;优点;正数; [or]6j;
possess: [a]/pəˈzes/; [v]拥有,占有;缠住,迷住;支配; [or]6j;
postal: [a]/ˈpoʊstl/; [adj]邮政的,邮局的;邮件的; [or]6j;
poster: [a]/ˈpoʊstər/; [n]海报,张贴的大幅广告;贴标语的人; [or]6j;
postulate: [a]/ˈpɑːstʃəleɪt/; [v]假定.是真的;  [n]假定; [or]6j;
posture: [a]/ˈpɑːstʃər/; [n]姿势;看法;态度;  [v]装模作样; [or]6j;
potential: [a]/pəˈtenʃl/; [n]潜力,潜能;  [adj]潜在的,可能的; [or]6j;
poultry: [a]/ˈpoʊltri/; [n]家禽(肉); [or]6j;
poverty: [a]/ˈpɑːvərti/; [n]贫困;贫穷; [or]6j;
practicable: [a]/ˈpræktɪkəbl/; [adj]能实行的,行得通的;适用的,能用的;可通行的; [or]6j;
prayer: [a]/prer/; [n]祈祷,祷告;祷文; [or]6j;
preach: [a]/priːtʃ/; [v]传教,布道;说教;宣扬; [or]6j;
precedent: [a]/ˈpresɪdənt/; [n]先例,范例;惯例;  [adj]在前的,前面的; [or]6j;
precious: [a]/ˈpreʃəs/; [n]<口>宝贝,心爱的人;  [adv]强调极少或太少;  [adj]珍贵的,宝贵的; [or]6j;
precipitate: [a]/prɪˈsɪpɪteɪt/; [v]促成,使..沉淀,猛摔;<气象>凝结;  [n]沉淀物,冷凝物;  [adj]突如其来的,仓促的,迅猛的;感情用事的; [or]6j;
precise: [a]/prɪˈsaɪs/; [adj]精确的;恰好的; [or]6j;
preclude: [a]/prɪˈkluːd/; [v]阻止;排除; [or]6j;
predecessor: [a]/ˈpredəsesər/; [n]前辈;(被取代的)原有事物; [or]6j;
predict: [a]/prɪˈdɪkt/; [v]预言,预告,预测; [or]6j;
prediction: [a]/prɪˈdɪkʃn/; [n]预言,预测; [or]6j;
predominant: [a]/prɪˈdɑːmɪnənt/; [adj]占主导地位的;显著的; [or]6j;
preferable: [a]/ˈprefrəbl/; [adj]更可取的,更好的,更合适的(to); [or]6j;
preference: [a]/ˈprefrəns/; [n]偏爱;喜爱物; [or]6j;
pregnant: [a]/ˈpreɡnənt/; [adj]怀孕的;充满的,意味深长的; [or]6j;
prejudice: [a]/ˈpredʒudɪs/; [n]偏见;成见;损害;侵害;  [vt]使抱偏见; [or]6j;
preliminary: [a]/prɪˈlɪmɪneri/; [adj]初步的,预备的;  [n]预赛;预考,初试;初步措施; [or]6j;
premature: [a]/ˌpriːməˈtʃʊr/; [adj]早产的,过早的,早熟的;  [n]早产儿; [or]6j;
premier: [a]/prɪˈmɪr/; [n]总理,首相;  [adj]第一的,首位的; [or]6j;
premise: [a]/ˈpremɪs/; [n]前提;房屋地基;  [v]假定; [or]6j;
premium: [a]/ˈpriːmiəm/; [adj]高级的;高价的;(汽油)辛烷值高的;  [n]额外费用,溢价;保险金; [or]6j;
prescription: [a]/prɪˈskrɪpʃn/; [n]处方,药方;(医生开)的药;开处方,开药方; [or]6j;
presentation: [a]/ˌpriːzenˈteɪʃn/; [n]演讲;报告;介绍;颁奖仪式; [or]6j;
preservation: [a]/ˌprezərˈveɪʃn/; [n]保存,保护; [or]6j;
preserve: [a]/prɪˈzɜːrv/; [v]贮鲜,保鲜;保存;保护;  [n]独揽之事,独占的活动; [or]6j;
preside: [a]/prɪˈzaɪd/; [v]主持; [or]6j;
pressure: [a]/ˈpreʃər/; [n]压力;压迫,<物> 压强;迫使;  [v]对..施加压力;密封; [or]6j;
prestige: [a]/preˈstiːʒ/; [n]威望,声望; [or]6j;
pretext: [a]/ˈpriːtekst/; [n]借口,托词; [or]6j;
prevail: [a]/prɪˈveɪl/; [v]流行,盛行;战胜,压倒; [or]6j;
prevailing: [a]/prɪˈveɪlɪŋ/; [adj]流行的;盛行的;普遍的; [or]6j;
prevalent: [a]/ˈprevələnt/; [adj]普遍的,流行的; [or]6j;
prevention: [a]/prɪˈvenʃn/; [n]预防,防止; [or]6j;
preview: [a]/ˈpriːvjuː/; [n](电影,戏剧等的)预映;(电影等的)预告(片);  [v]预观;预习; [or]6j;
previous: [a]/ˈpriːviəs/; [adj]以前的;早先的;过早的; [or]6j;
prick: [a]/prɪk/; [n]扎,一刺,刺痛,锥,阴茎;  [v]刺,戳,刺痛,竖起; [or]6j;
priest: [a]/priːst/; [n]教士,神父; [or]6j;
primarily: [a]/praɪˈmerəli/; [adv]首先;主要地; [or]6j;
primary: [a]/ˈpraɪmeri/; [adj]初等教育的;初级的;基本的;首要的;主要的;  [n]首选;(美)初选; [or]6j;
prime: [a]/praɪm/; [adj]首要的,主要的;最好的,第一流的;  [n]青春,全盛期,青壮年时期;  [v]使准备好; [or]6j;
primitive: [a]/ˈprɪmətɪv/; [adj]原始的;简陋的;  [n]原始人; [or]6j;
principal: [a]/ˈprɪnsəpl/; [n]校长,负责人;本金,资本;  [adj]主要的,首要的; [or]6j;
principally: [a]/ˈprɪnsəpli/; [adv]主要地; [or]6j;
principle: [a]/ˈprɪnsəpl/; [n]原则,原理;理由,信条; [or]6j;
printer: [a]/ˈprɪntər/; [n]印刷机,印刷工;打印机; [or]6j;
priority: [a]/praɪˈɔːrəti/; [n]优先;优先权;优先考虑的事;重要事项; [or]6j;
prism: [a]/ˈprɪzəm/; [n]棱镜;棱柱; [or]6j;
pristine: [a]/ˈprɪstiːn/; [adj]原始的;古时的;纯朴的;崭新的; [or]6j;
privacy: [a]/ˈpraɪvəsi/; [n]隐私;秘密;私生活; [or]6j;
privilege: [a]/ˈprɪvəlɪdʒ/; [n]特权,优待;荣幸;  [v]给..特权; [or]6j;
probability: [a]/ˌprɑːbəˈbɪləti/; [n]可能性;几率,概率; [or]6j;
probation: [a]/proʊˈbeɪʃn/; [n]试用;缓刑;察看; [or]6j;
probe: [a]/proʊb/; [v]探测,探索;  [n]探索,调查;探针,探测器; [or]6j;
procedure: [a]/prəˈsiːdʒər/; [n]步骤,过程;程序;手续; [or]6j;
proceeding: [a]/prəˈsiːdɪŋ/; [n]诉讼;(会议等的)项目;行动;会议记录,会刊;  [v]继续进行; [or]6j;
process: [a]/ˈprɑːses/; [v]加工;处理;  [n]过程,进程;工序,程序;传票; [or]6j;
proclaim: [a]/prəˈkleɪm/; [v]声明,声称;宣告;表明; [or]6j;
producer: [a]/prəˈduːsər/; [n]电影制片人;电视制作人,制作公司;出产地; [or]6j;
productive: [a]/prəˈdʌktɪv/; [adj]多产的;产生..的;富有成效的; [or]6j;
productivity: [a]/ˌprɑːdʌkˈtɪvəti/; [n]生产力;生产率;多产; [or]6j;
profess: [a]/prəˈfes/; [v]表示,承认;宣称; [or]6j;
profession: [a]/prəˈfeʃn/; [n]职业;行业;声明;立誓信教; [or]6j;
professional: [a]/prəˈfeʃənl/; [adj]职业的;专业的;  [n]专业人员; [or]6j;
proficiency: [a]/prəˈfɪʃnsi/; [n]熟练;精通; [or]6j;
proficient: [a]/prəˈfɪʃnt/; [adj]精通的,熟练的; [or]6j;
profile: [a]/ˈproʊfaɪl/; [n]侧面像;外形,轮廓;  [v]描绘..的轮廓,扼要描述; [or]6j;
progressive: [a]/prəˈɡresɪv/; [adj]进步的;逐步的,渐进的;  [n]进步人士; [or]6j;
prohibit: [a]/prəˈhɪbɪt/; [v]禁止; [or]6j;
project: [a]/ˈprɑːdʒekt/; [n]项目,工程;专题研究;课题方案;  [v]映射,放映;计划,设计,打算,拟订方案;投掷,发射,喷射;表明..的特性,使呈现特性;阐述;突出,伸出;估计,预估; [or]6j;
projector: [a]/prəˈdʒektər/; [n]放映机;投影仪; [or]6j;
prominent: [a]/ˈprɑːmɪnənt/; [adj]突起的,显眼的;突出的,杰出的; [or]6j;
promising: [a]/ˈprɑːmɪsɪŋ/; [adj]有前途的,有希望的;(前景)光明的; [or]6j;
promote: [a]/prəˈmoʊt/; [v]提升;促进;发扬;促销; [or]6j;
promotion: [a]/prəˈmoʊʃn/; [n]晋升;提升;促销;促进; [or]6j;
prone: [a]/proʊn/; [adj]易于.的;有.倾向的;俯卧的; [or]6j;
proof: [a]/pruːf/; [n]证据,证明,校样;  [v]校对;试验;  [adj]防.的;能抵御;能防范; [or]6j;
propaganda: [a]/ˌprɑːpəˈɡændə/; [n]宣传;宣传方法; [or]6j;
propagate: [a]/ˈprɑːpəɡeɪt/; [v]繁殖,增殖;  [vt]传播,宣传; [or]6j;
propagation: [a]/ˌprɑːpəˈɡeɪʃn/; [n]繁殖;传播; [or]6j;
propel: [a]/prəˈpel/; [v]推进,推动,激励; [or]6j;
propeller: [a]/prəˈpelər/; [n]螺旋桨;推进器; [or]6j;
property: [a]/ˈprɑːpərti/; [n]房产;财产;特性;性能; [or]6j;
prophecy: [a]/ˈprɑːfəsi/; [n]预言书;预言,预言能力; [or]6j;
prophet: [a]/ˈprɑːfɪt/; [n]先知,预言者; [or]6j;
proposition: [a]/ˌprɑːpəˈzɪʃn/; [n]提议,计划,命题;  [v]向.求欢; [or]6j;
propulsion: [a]/prəˈpʌlʃn/; [n]推进力; [or]6j;
prose: [a]/proʊz/; [n]散文;  [vt]用散文写,把.改写成散文;平淡无趣地写;啰啰唆唆地讲; [or]6j;
prosecute: [a]/ˈprɑːsɪkjuːt/; [v]起诉;做检察官;从事; [or]6j;
prospect: [a]/ˈprɑːspekt/; [n]前景,展望;视野;景象;  [v]勘察;有前途;勘探;对..进行仔细调查; [or]6j;
prospective: [a]/prəˈspektɪv/; [adj]未来的;预期的;  [n]预期; [or]6j;
prosper: [a]/ˈprɑːspər/; [v](生意等)成功;(城市,文化,植物生长等)繁荣; [or]6j;
prosperous: [a]/ˈprɑːspərəs/; [adj]富裕的;繁荣的;茂盛的;茁壮生长的; [or]6j;
protein: [a]/ˈproʊtiːn/; [n]蛋白质;  [adj]蛋白质的; [or]6j;
protest: [a]/ˈproʊtest/; [v]抗议;反对;  [n]声明,反对; [or]6j;
proton: [a]/ˈproʊtɑːn/; [n]质子; [or]6j;
prototype: [a]/ˈproʊtətaɪp/; [n]原型,典型,样本; [or]6j;
proverb: [a]/ˈprɑːvɜːrb/; [n]谚语; [or]6j;
provided: [a]/prəˈvaɪdɪd/; [conj]假如,如果,以..为条件;  [adj]预备好的,提供的; [or]6j;
provision: [a]/prəˈvɪʒn/; [n](法律等)条款;供应;预备,存粮;必需品;  [v]为..提供必需品; [or]6j;
provocative: [a]/prəˈvɑːkətɪv/; [adj]挑衅的,煽动的,刺激的;挑逗的; [or]6j;
provoke: [a]/prəˈvoʊk/; [v]激怒;对.挑衅;引起; [or]6j;
proximity: [a]/prɑːkˈsɪməti/; [n]接近;邻近; [or]6j;
prudent: [a]/ˈpruːdnt/; [adj]谨慎的,精明的; [or]6j;
prune: [a]/pruːn/; [n]梅干;  [v]修剪;削减; [or]6j;
psychiatrist: [a]/saɪˈkaɪətrɪst/; [n]精神病医生;精神病学家; [or]6j;
psychological: [a]/ˌsaɪkəˈlɑːdʒɪkl/; [adj]心理的,心理学的; [or]6j;
psychology: [a]/saɪˈkɑːlədʒi/; [n]心理学;心理状态;心理; [or]6j;
publicity: [a]/pʌbˈlɪsəti/; [n]公开(性),公众的关注;宣传;名声; [or]6j;
pudding: [a]/ˈpʊdɪŋ/; [n]布丁,一种甜点心; [or]6j;
puff: [a]/pʌf/; [v]喷出;膨胀,肿胀;吹捧;一口口抽烟;  [n]一口(气味,烟雾);一阵,一股;喷出;粉扑;呼吸;  [adj]吹嘘的; [or]6j;
pulley: [a]/ˈpʊli/; [n]滑轮; [or]6j;
pumpkin: [a]/ˈpʌmpkɪn/; [n]南瓜,倭瓜; [or]6j;
puppy: [a]/ˈpʌpi/; [n]小狗,幼犬; [or]6j;
purchase: [a]/ˈpɜːrtʃəs/; [v]购买;  [n]购买;所购之物; [or]6j;
purify: [a]/ˈpjʊrɪfaɪ/; [v]净化;提纯; [or]6j;
purity: [a]/ˈpjʊrəti/; [n]纯洁;纯净;纯正;纯粹; [or]6j;
pursue: [a]/pərˈsuː/; [v]进行,从事;追求,追赶; [or]6j;
pursuit: [a]/pərˈsuːt/; [n]追求,寻找;追赶,跟踪;事业,消遣;  [v]追踪,追击; [or]6j;
quaint: [a]/kweɪnt/; [adj]精巧的;古雅的; [or]6j;
qualification: [a]/ˌkwɑːlɪfɪˈkeɪʃn/; [n]资格证明;条件;合格证书;资格;限制性条件; [or]6j;
qualitative: [a]/ˈkwɑːləteɪtɪv/; [adj](性)质的,定性的; [or]6j;
quantify: [a]/ˈkwɑːntɪfaɪ/; [v]确定数量; [or]6j;
quantitative: [a]/ˈkwɑːntəteɪtɪv/; [adj]定量的; [or]6j;
quart: [a]/kwɔːrt/; [n]夸脱; [or]6j;
quartz: [a]/kwɔːrts/; [n]石英; [or]6j;
queer: [a]/kwɪr/; [adj]怪异的;〈贬〉同性恋的;  [n]〈贬〉同性恋者;  [v]破坏.的计划; [or]6j;
quench: [a]/kwentʃ/; [v]扑灭(火);止渴; [or]6j;
quest: [a]/kwest/; [n]探索,寻求;  [v]寻找,搜索; [or]6j;
questionable: [a]/ˈkwestʃənəbl/; [adj]可疑的,不可靠的; [or]6j;
questionnaire: [a]/ˌkwestʃəˈner/; [n]调查表,问卷; [or]6j;
quiver: [a]/ˈkwɪvər/; [n]颤抖;箭袋;  [vi]颤抖; [or]6j;
quota: [a]/ˈkwoʊtə/; [n]配额;限额;定额; [or]6j;
racial: [a]/ˈreɪʃl/; [adj]种族的;人种的; [or]6j;
racket: [a]/ˈrækɪt/; [n]吵闹声;球拍;  [v]嚷闹,吵闹,纵情欢闹;用球拍打; [or]6j;
radiant: [a]/ˈreɪdiənt/; [adj]光芒四射的,绚丽的;喜悦的; [or]6j;
radiate: [a]/ˈreɪdieɪt/; [v]辐射,发出(光或热);流露,显示;(使)从中心发散; [or]6j;
radiator: [a]/ˈreɪdieɪtər/; [n]散热器;暖气片; [or]6j;
radical: [a]/ˈrædɪkl/; [n]激进分子;基础;原子团;根数,根式;  [adj]重大的,彻底的;激进的; [or]6j;
radioactive: [a]/ˌreɪdioʊˈæktɪv/; [adj]放射性的; [or]6j;
radius: [a]/ˈreɪdiəs/; [n]半径;范围; [or]6j;
rage: [a]/reɪdʒ/; [n]极怒;盛怒;  [v]迅速蔓延,快速扩散;(战争等)激烈地进行; [or]6j;
raid: [a]/reɪd/; [n]突袭;袭击;  [v]袭击;劫掠;攫取;突然搜捕; [or]6j;
raisin: [a]/ˈreɪzn/; [n]葡萄干; [or]6j;
rally: [a]/ˈræli/; [n]集会;公路汽车赛;  [v]集合;恢复(健康等),重新振作; [or]6j;
ramble: [a]/ˈræmbl/; [vi]瞎扯;溜达;漫步于;  [n]漫步; [or]6j;
ramp: [a]/ræmp/; [n]斜坡,坡道;倾斜装置;  [v]蔓延; [or]6j;
ranch: [a]/ræntʃ/; [n]大农场; [or]6j;
random: [a]/ˈrændəm/; [adj]随机的;任意的;胡乱的; [or]6j;
rank: [a]/ræŋk/; [v]排名;把.分等级;列队;  [n]等级;军队中的官阶;  [adj]繁茂的,讨厌的,难闻的; [or]6j;
rap: [a]/ræp/; [n]饶舌歌;  [v]轻敲;表演说唱;严厉批评; [or]6j;
rape: [a]/reɪp/; [v]强奸;  [n]强奸;掠夺,强夺;油菜; [or]6j;
rapidity: [a]/rəˈpɪdəti/; [n]速度;陡峭; [or]6j;
rapture: [a]/ˈræptʃər/; [n]狂喜; [or]6j;
rarely: [a]/ˈrerli/; [adv]很少,难得; [or]6j;
rascal: [a]/ˈræskl/; [n]不诚实的人;坏蛋,淘气鬼; [or]6j;
rash: [a]/ræʃ/; [adj]轻率的,鲁莽的;  [n]疹,皮疹;(短时期内)爆发的一连串; [or]6j;
rating: [a]/ˈreɪtɪŋ/; [n]评价;等级;等级评定;额定功率;评分,收视率; [or]6j;
rational: [a]/ˈræʃnəl/; [adj]理性的;理智的;合理的; [or]6j;
rattle: [a]/ˈrætl/; [n]格格声,发出嘎嘎声的儿童玩具,(响尾蛇)音响器官;  [v](使)发出格格声,(人或车)疾驰,使烦扰; [or]6j;
reaction: [a]/riˈækʃn/; [n]反应能力;反应;生理反应; [or]6j;
reactor: [a]/riˈæktər/; [n]［原］反应堆; [or]6j;
readily: [a]/ˈredɪli/; [adv]容易地;乐意地;欣然地; [or]6j;
realistic: [a]/ˌriːəˈlɪstɪk/; [adj]现实(主义)的;现实可行的;逼真的,栩栩如生的; [or]6j;
realization: [a]/ˌriːələˈzeɪʃn/; [n]认识,领会,领悟,实现; [or]6j;
reap: [a]/riːp/; [v]收割;获得;收获; [or]6j;
reassure: [a]/ˌriːəˈʃʊr/; [v]使放心,使消除疑虑; [or]6j;
rebel: [a]/ˈrebl/; [v]造反,反抗,反叛;  [n]造反者;反叛者;叛逆者;  [adj]反抗的;造反的; [or]6j;
rebellion: [a]/rɪˈbeljən/; [n]反叛,叛乱;反抗; [or]6j;
rebuke: [a]/rɪˈbjuːk/; [v]指责;  [n]谴责; [or]6j;
recall: [a]/rɪˈkɔːl/; [v]回想起,记起,回忆;召回;  [n]召回(有问题的产品); [or]6j;
recede: [a]/rɪˈsiːd/; [vi]退去;渐渐远去;(尤指问题,感情或品质)逐渐减弱;(头发)从前向后减少;向后倾斜; [or]6j;
receipt: [a]/rɪˈsiːt/; [n]收据,收条;收入;收到; [or]6j;
reception: [a]/rɪˈsepʃn/; [n]前台,接待处,接收,欢迎,招待会; [or]6j;
recession: [a]/rɪˈseʃn/; [n](经济)衰退,不景气;后退,撤回;凹处; [or]6j;
recipe: [a]/ˈresəpi/; [n]方法;食谱; [or]6j;
recipient: [a]/rɪˈsɪpiənt/; [n]接受者;容器;间接宾语;  [adj]接受的;善于接受的;接受能力强的; [or]6j;
reciprocal: [a]/rɪˈsɪprəkl/; [adj]相互的,互惠的;  [n]倒数;互相关联的事物; [or]6j;
recite: [a]/rɪˈsaɪt/; [vi]背诵;朗诵;  [vt]背诵;朗诵;叙述;列举; [or]6j;
reckless: [a]/ˈrekləs/; [adj]不顾虑的;鲁莽的,不顾后果的; [or]6j;
reckon: [a]/ˈrekən/; [vt]计算;想,指望;把.看做;  [v]认为;  [vi]计算;估计; [or]6j;
reclaim: [a]/rɪˈkleɪm/; [v]开拓,开垦;感化;取回;改造;废物回收利用; [or]6j;
recognition: [a]/ˌrekəɡˈnɪʃn/; [n]承认,认可;认出;认识; [or]6j;
recognize: [a]/ˈrekəɡnaɪz/; [v]辨别,认出;赏识,表彰;承认;赞成; [or]6j;
reconcile: [a]/ˈrekənsaɪl/; [v]和解;调解;调和; [or]6j;
reconciliation: [a]/ˌrekənsɪliˈeɪʃn/; [n]和解,修好,和好,调停,调解; [or]6j;
recover: [a]/rɪˈkʌvər/; [v]恢复;痊愈,恢复健康;收回;换回;重新获得;重新找到; [or]6j;
recovery: [a]/rɪˈkʌvəri/; [n]痊愈;恢复,复苏;重获; [or]6j;
recreation: [a]/ˌrekriˈeɪʃn/; [n]娱乐活动,消遣; [or]6j;
recruit: [a]/rɪˈkruːt/; [v]招募(新兵),招收(新成员);  [n]新兵,新成员; [or]6j;
rectangle: [a]/ˈrektæŋɡl/; [n]长方形,矩形; [or]6j;
rectangular: [a]/rekˈtæŋɡjələr/; [adj]长方形的; [or]6j;
rectify: [a]/ˈrektɪfaɪ/; [v]纠正;修复; [or]6j;
recur: [a]/rɪˈkɜːr/; [v]重新出现;再次发生;重新提起;诉诸;反复; [or]6j;
recycle: [a]/ˌriːˈsaɪkl/; [v]回收利用;改建;  [n]再循环; [or]6j;
redundant: [a]/rɪˈdʌndənt/; [adj]多余的,过剩的;被下岗的; [or]6j;
reed: [a]/riːd/; [n]芦苇;苇丛;芦笛;牧笛; [or]6j;
reef: [a]/riːf/; [n]礁;  [v]收帆,缩帆; [or]6j;
reel: [a]/riːl/; [n]卷盘;  [v]旋转;感到震惊;眩晕; [or]6j;
referee: [a]/ˌrefəˈriː/; [n]裁判员,仲裁者;  [v]裁判,仲裁; [or]6j;
reference: [a]/ˈrefrəns/; [n]参考书;提及;推荐人;参考;证明;推荐信;  [v]附.以供参考;引用; [or]6j;
refinery: [a]/rɪˈfaɪnəri/; [n]精炼厂; [or]6j;
reflect: [a]/rɪˈflekt/; [v]倒映;反映,反射;仔细思考;反省; [or]6j;
refrain: [a]/rɪˈfreɪn/; [v]抑制,避免;  [n]歌曲的反复句,叠句; [or]6j;
refresh: [a]/rɪˈfreʃ/; [v](使)恢复精神,提神;刷新; [or]6j;
refreshment: [a]/rɪˈfreʃmənt/; [n]茶点;食物,饮料;(会议或旅行期间提供的)饮料,点心,茶点; [or]6j;
refuge: [a]/ˈrefjuːdʒ/; [n]避难,庇护;避难所,收容所;隐蔽处;保护区;  [vi]避难,寻求庇护;  [vt]给以庇护,提供庇护; [or]6j;
refugee: [a]/ˌrefjuˈdʒiː/; [n]避难者,难民;  [v]避难;  [adj]避难的; [or]6j;
refusal: [a]/rɪˈfjuːzl/; [n]拒绝,回绝; [or]6j;
regenerative: [a]/rɪˈdʒenərətɪv/; [adj]再生的;更新的; [or]6j;
regime: [a]/reɪˈʒiːm/; [n]政权;政治制度;养生法,生活规则; [or]6j;
regiment: [a]/ˈredʒɪmənt/; [n](军队)团;  [v]组编成团;严格控制; [or]6j;
region: [a]/ˈriːdʒən/; [n]地区,区域;范围;行政区;身体部位; [or]6j;
register: [a]/ˈredʒɪstər/; [v]登记,注册;(仪表等)显示;留意;  [n]登记,注册;现金收纳机; [or]6j;
regulation: [a]/ˌreɡjuˈleɪʃn/; [n]法规,条例,规章;管理; [or]6j;
rehearsal: [a]/rɪˈhɜːrsl/; [n]排演;叙述;详述;排练; [or]6j;
reign: [a]/reɪn/; [v]占主导地位,统治,当政;  [n](君主)统治时期; [or]6j;
rein: [a]/reɪn/; [n]缰绳;  [v]控制; [or]6j;
reinforce: [a]/ˌriːɪnˈfɔːrs/; [v]加固;加强;增援;支持; [or]6j;
reject: [a]/rɪˈdʒekt/; [v]拒绝;抵制;  [n]废品;次品;不合格者;被剔除者; [or]6j;
rejoice: [a]/rɪˈdʒɔɪs/; [v]欣喜,高兴; [or]6j;
relative: [a]/ˈrelətɪv/; [n]亲戚,家人,亲属;相关物,关系词,同类事物;  [adj]相对的;有关系的,(语)关系的; [or]6j;
relay: [a]/ˈriːleɪ/; [n]替班;转播;接力赛跑;  [v]转播;传递; [or]6j;
release: [a]/rɪˈliːs/; [v]释放;解放;发行;  [n]解除;免除;发表; [or]6j;
relevant: [a]/ˈreləvənt/; [adj]有关的;恰当的;贴切的; [or]6j;
reliable: [a]/rɪˈlaɪəbl/; [adj]可靠的;可信赖的;确实的; [or]6j;
reliance: [a]/rɪˈlaɪəns/; [n]信任,信心;信赖,依靠;信赖的人,(或物); [or]6j;
relief: [a]/rɪˈliːf/; [n]安慰;解脱;减轻;浮雕;凸显,起伏;救济金;救济物资;换班人;接替人; [or]6j;
relieve: [a]/rɪˈliːv/; [v]消除,减轻;换班; [or]6j;
religion: [a]/rɪˈlɪdʒən/; [n]宗教;宗教信仰;宗教生活;虔诚的追求; [or]6j;
religious: [a]/rɪˈlɪdʒəs/; [adj]宗教的;虔诚的; [or]6j;
relish: [a]/ˈrelɪʃ/; [v]享受;享受.的味道;品味;  [n]乐趣;调味品; [or]6j;
reluctant: [a]/rɪˈlʌktənt/; [adj]不情愿的;勉强的; [or]6j;
rely: [a]/rɪˈlaɪ/; [v]依赖,依靠;信赖; [or]6j;
remain: [a]/rɪˈmeɪn/; [v]剩余;逗留;保持不变;依然,继续;  [n]剩余物;遗迹;残骸; [or]6j;
remainder: [a]/rɪˈmeɪndər/; [n]剩下的人;剩余物,残留部分;  [v]减价出售,削价处理;  [adj]剩余的;留存下的; [or]6j;
remedy: [a]/ˈremədi/; [v]治疗;恢复;补救;  [n]治疗;补救;矫正; [or]6j;
remnant: [a]/ˈremnənt/; [n]遗迹;边角剩料; [or]6j;
remote: [a]/rɪˈmoʊt/; [n]遥控器;  [adj]遥远的;偏僻的;关系远的; [or]6j;
renaissance: [a]/ˈrenəsɑːns/; [n]新生,复兴;文艺复兴; [or]6j;
render: [a]/ˈrendər/; [v]使成为,致使,使处于(某种状态);提供,给予,以.回报;(以某种方式)表达,表现;翻译;粉刷,往(墙上)抹灰;将(脂肪)熬成油,使熔化;  [n]粉刷,打底,交纳; [or]6j;
repay: [a]/rɪˈpeɪ/; [v]偿还(钱款或债务);报答;回报; [or]6j;
repeal: [a]/rɪˈpiːl/; [n]撤销;  [v]废除;废止; [or]6j;
repel: [a]/rɪˈpel/; [v]击退,驱逐;排斥,抵制;使厌恶,使反感;使恐惧; [or]6j;
replacement: [a]/rɪˈpleɪsmənt/; [n]代替物;接替者;更换; [or]6j;
represent: [a]/ˌreprɪˈzent/; [v]代表;象征;表示;描述;阐明;说明;演绎; [or]6j;
repression: [a]/rɪˈpreʃn/; [n]压抑,压制,镇压; [or]6j;
reproach: [a]/rɪˈproʊtʃ/; [v]责备,指责;  [n]指责; [or]6j;
reproduction: [a]/ˌriːprəˈdʌkʃn/; [n]复制;繁殖;复制品;再现; [or]6j;
reptile: [a]/ˈreptaɪl/; [n]爬行动物,爬虫;  [adj]爬行的,爬虫类的; [or]6j;
republican: [a]/rɪˈpʌblɪkən/; [n]共和主义者;共和党员;  [adj]共和国的,共和政体的;共和党的; [or]6j;
reputation: [a]/ˌrepjuˈteɪʃn/; [n]名声;声誉; [or]6j;
requisite: [a]/ˈrekwɪzɪt/; [n]必需品;  [adj]需要的,必不可少的,必备的; [or]6j;
resemblance: [a]/rɪˈzembləns/; [n]相似,形似; [or]6j;
resent: [a]/rɪˈzent/; [v]愤恨; [or]6j;
reservation: [a]/ˌrezərˈveɪʃn/; [n](住处,席位的)预订;保留态度,保留意见;(美国印第安部落的)居留地; [or]6j;
reserve: [a]/rɪˈzɜːrv/; [n]储备;保留;保护区;  [v]保留;预定;储备; [or]6j;
reside: [a]/rɪˈzaɪd/; [v]居住; [or]6j;
resident: [a]/ˈrezɪdənt/; [n]居民;住客;住院实习医师;  [adj]居住的;住校的;固有的; [or]6j;
residential: [a]/ˌrezɪˈdenʃl/; [adj]居住的,住宅的;寄宿的; [or]6j;
residual: [a]/rɪˈzɪdʒuəl/; [adj]残余的,剩余的; [or]6j;
resign: [a]/rɪˈzaɪn/; [v]辞职; [or]6j;
resignation: [a]/ˌrezɪɡˈneɪʃn/; [n]辞职;辞职书;无奈;顺从; [or]6j;
resistant: [a]/rɪˈzɪstənt/; [adj]有抵抗力的,抗..的;反抗的; [or]6j;
resolute: [a]/ˈrezəluːt/; [adj]坚决的;果断的; [or]6j;
resolve: [a]/rɪˈzɑːlv/; [n]决心;  [v]解决,决定,表决; [or]6j;
resonance: [a]/ˈrezənəns/; [n]共振;回声;(情感等的)共鸣; [or]6j;
resort: [a]/rɪˈzɔːrt/; [vi]采取;求助;  [n]求助;凭借;诉诸,采取;度假胜地; [or]6j;
respectful: [a]/rɪˈspektfl/; [adj]有礼貌的;恭敬的; [or]6j;
respective: [a]/rɪˈspektɪv/; [adj]各自的; [or]6j;
respond: [a]/rɪˈspɑːnd/; [vi]作答;对..有效果;做出反应;  [v]回应; [or]6j;
response: [a]/rɪˈspɑːns/; [n]回应;作答;响应,回答; [or]6j;
responsible: [a]/rɪˈspɑːnsəbl/; [adj]有责任,负责的; [or]6j;
restore: [a]/rɪˈstɔːr/; [v]恢复;修补;归还; [or]6j;
restrain: [a]/rɪˈstreɪn/; [v]制止(做);抑制(愤怒等),控制;监禁; [or]6j;
restrict: [a]/rɪˈstrɪkt/; [v]限制;约束; [or]6j;
resultant: [a]/rɪˈzʌltənt/; [adj]作为结果的; [or]6j;
resume: [a]/ˈrezəmeɪ/; [n]简历;  [v]重新开始;继续;  [vt]回到;恢复;重新开始; [or]6j;
retail: [a]/ˈriːteɪl/; [adj]零售的;  [n]零售;  [v]零售,零售价是;  [adv]以零售方式,以零售形式; [or]6j;
retain: [a]/rɪˈteɪn/; [v]保持,保留,保存;聘请; [or]6j;
retard: [a]/rɪˈtɑːrd/; [v]延迟,使减速;  [n]妨碍,阻碍; [or]6j;
retention: [a]/rɪˈtenʃn/; [n]保留,保持; [or]6j;
retirement: [a]/rɪˈtaɪərmənt/; [n]退休,退休生活;退役; [or]6j;
retort: [a]/rɪˈtɔːrt/; [v]反驳;  [n]反驳,反击,回嘴; [or]6j;
retrieve: [a]/rɪˈtriːv/; [v]取回,重新得到,挽回,检索; [or]6j;
reunion: [a]/ˌriːˈjuːniən/; [n]团聚;再联合;再结合;(亲友等的)重聚; [or]6j;
reveal: [a]/rɪˈviːl/; [v]揭示;透露;显示; [or]6j;
revel: [a]/ˈrevl/; [n]狂欢;  [v]狂欢; [or]6j;
revelation: [a]/ˌrevəˈleɪʃn/; [n]揭露;揭示;(出乎意料的)被揭示的真相; [or]6j;
revenge: [a]/rɪˈvendʒ/; [n]报仇;报复;  [v]为.报仇,报.之仇; [or]6j;
revenue: [a]/ˈrevənuː/; [n]收入;财政收入;国家的税收; [or]6j;
reverse: [a]/rɪˈvɜːrs/; [n]失败,挫折,倒退;相反,背面;  [v]颠倒,翻转;  [adj]相反的,反面的,颠倒的; [or]6j;
revision: [a]/rɪˈvɪʒn/; [n]修订;修改;修订本;复习; [or]6j;
revive: [a]/rɪˈvaɪv/; [v](使)苏醒;(使)复苏;再兴起;重做; [or]6j;
revolutionary: [a]/ˌrevəˈluːʃəneri/; [n]革命者;  [adj]革命的;革命性的; [or]6j;
revolve: [a]/rɪˈvɑːlv/; [v](使)旋转;(使)绕转; [or]6j;
reward: [a]/rɪˈwɔːrd/; [n]奖品,报酬,回报;悬赏;  [v]报答,酬谢; [or]6j;
rhythm: [a]/ˈrɪðəm/; [n]节奏;韵律;格律; [or]6j;
ridicule: [a]/ˈrɪdɪkjuːl/; [v]嘲笑,愚弄;  [n]嘲笑,愚弄; [or]6j;
ridiculous: [a]/rɪˈdɪkjələs/; [adj]可笑的,荒谬的; [or]6j;
rig: [a]/rɪɡ/; [n]钻井架;装备;帆具;成套器械;  [v]操纵;装配;欺骗; [or]6j;
rigorous: [a]/ˈrɪɡərəs/; [adj]严厉的,严格的; [or]6j;
rinse: [a]/rɪns/; [v](用清水)刷,冲洗掉,漂净,漱口;  [n]嗽洗,漂洗,漂清,冲洗; [or]6j;
riot: [a]/ˈraɪət/; [v]闹事;  [n]骚乱;暴乱;骚动;放纵; [or]6j;
rip: [a]/rɪp/; [n]裂缝,裂口;  [v]撕开,扯破,裂开,敲诈; [or]6j;
ripple: [a]/ˈrɪpl/; [n]涟漪,波纹;  [v](使)泛起层层细浪; [or]6j;
ritual: [a]/ˈrɪtʃuəl/; [n](宗教等的)仪式,例行公事,老规矩;  [adj]作为仪式一部分的,例行的; [or]6j;
rival: [a]/ˈraɪvl/; [n]竞争者,对手;  [v]与.竞争,与.匹敌;  [adj]竞争的,敌对的; [or]6j;
rivalry: [a]/ˈraɪvlri/; [n]竞争,敌对; [or]6j;
roam: [a]/roʊm/; [v]闲逛,漫步,徘徊;眼睛或手(缓慢地)扫遍;  [n]漫步,漫游; [or]6j;
robust: [a]/roʊˈbʌst/; [adj]健壮的,强壮的;精力充沛的;坚固的;粗鲁的; [or]6j;
romance: [a]/ˈroʊmæns/; [n]浪漫;  [v]向..求爱; [or]6j;
rot: [a]/rɑːt/; [v](使)腐烂;  [n]胡话;腐烂;腐朽,腐败; [or]6j;
rotary: [a]/ˈroʊtəri/; [adj]旋转的;  [n]旋转运行的机器; [or]6j;
roundabout: [a]/ˈraʊndəbaʊt/; [n]环形路;旋转木马;  [adj]绕远道的;迂回的;转弯抹角的; [or]6j;
routine: [a]/ruːˈtiːn/; [n]常规,例行公事,一套固定舞步(或动作);  [adj]例行的,普通的,惯例的; [or]6j;
royalty: [a]/ˈrɔɪəlti/; [n]皇家,王族,皇族;版税;专利费; [or]6j;
ruin: [a]/ˈruːɪn/; [v]毁灭,毁坏;(使)破产;(使)堕落;  [n]毁灭;废墟; [or]6j;
rupture: [a]/ˈrʌptʃər/; [n]破裂;割裂;  [v]使破裂;断绝(关系); [or]6j;
ruthless: [a]/ˈruːθləs/; [adj]无情的;残忍的; [or]6j;
sacred: [a]/ˈseɪkrɪd/; [adj]神圣的,宗教(性)的;神圣不可侵犯的; [or]6j;
sacrifice: [a]/ˈsækrɪfaɪs/; [vt]牺牲;祭献;  [vi]奉献;做出牺牲;  [n]祭品;牺牲; [or]6j;
safeguard: [a]/ˈseɪfɡɑːrd/; [v]保护,维护;  [n]防卫措施,防范措施; [or]6j;
saint: [a]/seɪnt/; [n]圣人; [or]6j;
salmon: [a]/ˈsæmən/; [n]鲑鱼; [or]6j;
salute: [a]/səˈluːt/; [n]致意;致敬,欢迎;  [v]向..行举手礼;敬礼; [or]6j;
salvation: [a]/sælˈveɪʃn/; [n]拯救,救赎;救助;救世; [or]6j;
sample: [a]/ˈsæmpl/; [n]样品,样本;(用于检验,分析的) 试样;  [adj]样品的,作为例子的;  [vi]抽样检查;  [vt]抽取.的试样;  [v]品尝;体验,尝试; [or]6j;
sanction: [a]/ˈsæŋkʃn/; [n]批准;制裁,处罚;  [v]批准,支持,对..实施制裁; [or]6j;
sardine: [a]/ˌsɑːrˈdiːn/; [n]<鱼>沙丁鱼; [or]6j;
satisfactorily: [a]/ˌsætɪsˈfæktərəli/; [adv]满意地; [or]6j;
saturate: [a]/ˈsætʃəreɪt/; [v]使充满,使饱和,使湿透; [or]6j;
saturation: [a]/ˌsætʃəˈreɪʃn/; [n]饱和(状态),浸润,浸透; [or]6j;
sauce: [a]/sɔːs/; [n]酱,调味汁;莽撞,冒失; [or]6j;
savage: [a]/ˈsævɪdʒ/; [n]野蛮人,粗鲁的人;  [adj]凶猛的,猛烈的;野蛮的;未驯化的;  [v](狗等)乱咬;激烈抨击; [or]6j;
scale: [a]/skeɪl/; [n]天平,磅秤;刻度,尺度,标度;等级,级别, 等级体系;鳞片,鳞状物;规模;水垢,牙垢;  [v]攀登;按比例决定;称重;刮鳞,剥落; [or]6j;
scan: [a]/skæn/; [v]细看;浏览;扫描;  [n]扫描;浏览; [or]6j;
scandal: [a]/ˈskændl/; [n]丑闻;丢脸;流言蜚语;反感;愤慨;  [v]诋毁; [or]6j;
scar: [a]/skɑːr/; [n]伤疤,伤痕;内心创伤;  [v](给.)留下伤痕; [or]6j;
scarcity: [a]/ˈskersəti/; [n]缺乏,不足; [or]6j;
scared: [a]/skerd/; [adj]害怕的,恐惧的; [or]6j;
scarlet: [a]/ˈskɑːrlət/; [n]鲜红色;鲜红色布匹;  [adj]鲜红色的;罪不可赦的; [or]6j;
scatter: [a]/ˈskætər/; [v](使)分散,撒开,散播; [or]6j;
scent: [a]/sent/; [n]气味;香味;迹象;  [v]嗅到;察觉; [or]6j;
schedule: [a]/ˈskedʒuːl/; [n]时间表,日程,计划表;清单,节目表;  [v]预定,安排; [or]6j;
scheme: [a]/skiːm/; [n]方案,计划;阴谋,诡计;  [v]图谋,密谋;  [adj]计划的; [or]6j;
scoff: [a]/skɔːf/; [vi]讥笑;  [v]嘲笑;  [n]愚弄; [or]6j;
scope: [a]/skoʊp/; [n]瞄准镜;范围;余地; [or]6j;
scorch: [a]/skɔːrtʃ/; [v]烧焦;枯萎;  [vi]高速行驶,疾驰,飞驰; [or]6j;
score: [a]/skɔːr/; [n]得分;刻痕;二十;配乐;  [vi]刻痕;  [v]得分;  [vt]在.上刻痕; [or]6j;
scorn: [a]/skɔːrn/; [n]鄙视;  [v]轻蔑;对.不屑一顾; [or]6j;
scramble: [a]/ˈskræmbl/; [v]争夺,攀登; [or]6j;
scrap: [a]/skræp/; [n]碎片;口角,吵架;小块,小片;废金属;残羹冷炙;  [v]报废;舍弃;打架; [or]6j;
scrape: [a]/skreɪp/; [n]擦伤;刮,擦;  [v]刮,擦; [or]6j;
scratch: [a]/skrætʃ/; [n]抓痕,擦伤;  [v]划破,擦伤,挠; [or]6j;
screw: [a]/skruː/; [n]螺旋;螺丝;  [v]拧紧;  [vi]敲诈勒索;  [vt]用螺钉固定;把.拧紧; [or]6j;
script: [a]/skrɪpt/; [n]剧本,脚本,手稿;文字系统;  [v]为电影(或戏剧等)写剧本; [or]6j;
scripture: [a]/ˈskrɪptʃər/; [n]经文;圣经; [or]6j;
scrub: [a]/skrʌb/; [v]用力擦洗;宣布中止;  [n]灌木丛;擦洗; [or]6j;
scrutinize: [a]/ˈskruːtənaɪz/; [v]仔细检查,细看; [or]6j;
scrutiny: [a]/ˈskruːtəni/; [n]监视,细看,详细检查,仔细观察; [or]6j;
sculpture: [a]/ˈskʌlptʃər/; [n]雕刻艺术;雕刻,雕塑; [or]6j;
seam: [a]/siːm/; [n]缝;接缝;地层; [or]6j;
seaport: [a]/ˈsiːpɔːrt/; [n]海港; [or]6j;
seaside: [a]/ˈsiːsaɪd/; [n]海滨,海边;  [adj]海边的,海滨的; [or]6j;
sector: [a]/ˈsektər/; [n](经济等)部门,部分;战区,防区;扇形,扇区; [or]6j;
security: [a]/sɪˈkjʊrəti/; [n]安全;防护措施;债券;抵押物; [or]6j;
sediment: [a]/ˈsedɪmənt/; [n]沉渣,沉淀物,沉淀; [or]6j;
seemingly: [a]/ˈsiːmɪŋli/; [adv]表面上;看上去;似乎; [or]6j;
segment: [a]/ˈseɡmənt/; [n]部分;片段;(橘子等的)瓣;  [v]分割; [or]6j;
segregate: [a]/ˈseɡrɪɡeɪt/; [v]分开,隔离,进行种族隔离; [or]6j;
semester: [a]/sɪˈmestər/; [n]一学期;半年; [or]6j;
seminar: [a]/ˈsemɪnɑːr/; [n]研究班;研讨会; [or]6j;
senator: [a]/ˈsenətər/; [n]参议员; [or]6j;
sensation: [a]/senˈseɪʃn/; [n]感觉;知觉;轰动; [or]6j;
senseless: [a]/ˈsensləs/; [adj]不省人事的;无知的;愚蠢的;无意义的;不理解的; [or]6j;
sensible: [a]/ˈsensəbl/; [adj]明智的,理智的;可觉察的;实用耐穿的; [or]6j;
sensitive: [a]/ˈsensətɪv/; [adj]敏感的,过敏的;灵敏的;善解人意的,体恤的; [or]6j;
sensitivity: [a]/ˌsensəˈtɪvəti/; [n]灵敏性;敏感; [or]6j;
sensor: [a]/ˈsensər/; [n]传感器,灵敏元件; [or]6j;
sentiment: [a]/ˈsentɪmənt/; [n]感情;情绪; [or]6j;
sequence: [a]/ˈsiːkwəns/; [n]顺序,次序;连续,继续; [or]6j;
sergeant: [a]/ˈsɑːrdʒənt/; [n]士官,中士,警官; [or]6j;
series: [a]/ˈsɪriːz/; [n]系列,系列节目;连续比赛;连续,接连; [or]6j;
sermon: [a]/ˈsɜːrmən/; [n]布道;训诫; [or]6j;
serpent: [a]/ˈsɜːrpənt/; [n]大毒蛇,阴险的人; [or]6j;
setback: [a]/ˈsetbæk/; [n]挫折;失败; [or]6j;
settle: [a]/ˈsetl/; [v]安顿;定居;解决;调停;(目光)停留;结算,算清;  [n]背长椅,座位;定居,安顿; [or]6j;
settlement: [a]/ˈsetlmənt/; [n]解决;结算;协议;定居; [or]6j;
severe: [a]/sɪˈvɪr/; [adj]严重的;严厉的;严酷的;剧烈的; [or]6j;
sexual: [a]/ˈsekʃuəl/; [adj]性别的;性的;性感的; [or]6j;
shabby: [a]/ˈʃæbi/; [adj]破烂的,卑鄙的,衣衫褴褛的; [or]6j;
shadowy: [a]/ˈʃædoʊi/; [adj]朦胧的;模糊的;多荫的,阴凉的; [or]6j;
shady: [a]/ˈʃeɪdi/; [adj]成荫的,多荫的;可疑的,靠不住的; [or]6j;
shaft: [a]/ʃæft/; [n]柄;轴;杆状物;  [v]苛刻地对待;  [vt]给.装杆; [or]6j;
sham: [a]/ʃæm/; [n]假货;虚假;欺诈;  [v]假装;  [adj]虚假的,假装的; [or]6j;
shark: [a]/ʃɑːrk/; [n]鲨鱼;骗子; [or]6j;
sharply: [a]/ˈʃɑːrpli/; [adv]锐利地,敏锐地,急剧地,剧烈地; [or]6j;
shatter: [a]/ˈʃætər/; [v]使粉碎;砸碎;打碎;粉碎; [or]6j;
shear: [a]/ʃɪr/; [vt]剪羊毛;剪头发;  [n](复数)大剪刀; [or]6j;
shed: [a]/ʃed/; [v]流出(眼泪);蜕皮;脱落;使清晰;流下;去除,摆脱;  [n]棚屋; [or]6j;
sheer: [a]/ʃɪr/; [adj]陡峭的;纯粹的;  [v](off)急转向,偏离;  [n]透明薄纱,透明布料的衣服;  [adv]完全地,全然;垂直地,陡峭地; [or]6j;
shepherd: [a]/ˈʃepərd/; [n]牧羊人;  [v]带领; [or]6j;
sheriff: [a]/ˈʃerɪf/; [n]警长,郡治安官,州长; [or]6j;
shield: [a]/ʃiːld/; [n]盾牌;防护物;  [v]保护; [or]6j;
shipment: [a]/ˈʃɪpmənt/; [n]装载的货物;装船;装运;装货量; [or]6j;
shipwreck: [a]/ˈʃɪprek/; [n]遇难船;船只失事;  [v]使遭遇海难; [or]6j;
shortcut: [a]/ˈʃɔːrtkʌt/; [n]捷径;快捷之法;  [adj]提供捷径的;有简便方法的;  [v]抄近路,走捷径; [or]6j;
shorten: [a]/ˈʃɔːrtn/; [v]缩短,(使)变短; [or]6j;
shorthand: [a]/ˈʃɔːrthænd/; [n]速记;缩写; [or]6j;
shove: [a]/ʃʌv/; [v]推;猛推;  [n]推搡; [or]6j;
shovel: [a]/ˈʃʌvl/; [n]铁锨,铲;  [v]铲起; [or]6j;
shrewd: [a]/ʃruːd/; [adj]精明的;机灵的;  [n]精明;精明者; [or]6j;
shrill: [a]/ʃrɪl/; [adj]尖声的,刺耳的;  [vi]尖叫;  [vt]尖叫着说;  [n]尖叫声;  [adv]尖声地,无节制地; [or]6j;
shrimp: [a]/ʃrɪmp/; [n](小)虾; [or]6j;
shrine: [a]/ʃraɪn/; [n]神殿,神祠,圣地; [or]6j;
shrink: [a]/ʃrɪŋk/; [v]收缩;缩小;退缩;  [n](非正式用法)心理医生,精神病医生; [or]6j;
shrub: [a]/ʃrʌb/; [n]灌木; [or]6j;
shrug: [a]/ʃrʌɡ/; [n]耸肩;  [v](为表示厌恶,轻漠,冷淡,怀疑等)耸肩;以耸肩表示(厌恶,轻蔑,冷淡,怀疑等); [or]6j;
shutter: [a]/ˈʃʌtər/; [n]百叶窗;照相机快门; [or]6j;
shuttle: [a]/ˈʃʌtl/; [n]短程穿梭运行的车辆,接驳车;梭子;穿梭;航天飞机;  [v]穿梭移动;穿梭往返;往返于两地之间; [or]6j;
siege: [a]/siːdʒ/; [n]围困;包围; [or]6j;
sieve: [a]/sɪv/; [n]筛子,粗篮;  [v]筛,滤; [or]6j;
sift: [a]/sɪft/; [vt]筛;  [v]筛分;精选;细查; [or]6j;
signal: [a]/ˈsɪɡnəl/; [n]信号;预兆;  [v]发信号;标志;  [adj]显著的,优越的;暗号的,作信号用的; [or]6j;
significant: [a]/sɪɡˈnɪfɪkənt/; [adj]重大的,有意义的;意味深长的;数量相当大的;  [n]象征,标志; [or]6j;
signify: [a]/ˈsɪɡnɪfaɪ/; [vi]具有重要性;  [vt]表示; [or]6j;
silicon: [a]/ˈsɪlɪkən/; [n]硅; [or]6j;
similar: [a]/ˈsɪmələr/; [adj]相似的;类似的;  [n]类似物;相像的人;相似物; [or]6j;
similarity: [a]/ˌsɪməˈlærəti/; [n]相似,类似; [or]6j;
simulate: [a]/ˈsɪmjuleɪt/; [v]假装;模仿;模拟; [or]6j;
simultaneous: [a]/ˌsaɪmlˈteɪniəs/; [adj]同时发生的; [or]6j;
simultaneously: [a]/ˌsaɪmlˈteɪniəsli/; [adv]同时地; [or]6j;
sin: [a]/sɪn/; [n]罪;罪孽;错误;  [v]违犯戒律;犯过失; [or]6j;
sincerity: [a]/sɪnˈserəti/; [n]诚挚; [or]6j;
sip: [a]/sɪp/; [v]啜饮;  [n]一小口; [or]6j;
situated: [a]/ˈsɪtʃueɪtɪd/; [adj]坐落在.的;处于某种境地的; [or]6j;
skeleton: [a]/ˈskelɪtn/; [n]骨骼,梗概;骨瘦如柴的人或动物; [or]6j;
skeptical: [a]/ˈskeptɪkl/; [adj]表示怀疑的; [or]6j;
skip: [a]/skɪp/; [v]跳过;略过;遗漏;  [n]跳跃;跳读;省略; [or]6j;
skull: [a]/skʌl/; [n]颅骨;脑壳; [or]6j;
skyscraper: [a]/ˈskaɪskreɪpər/; [n]摩天大楼; [or]6j;
slack: [a]/slæk/; [adj]松弛的;懈怠的;萧条的;  [n]松弛的部分,松散;  [v]变松弛,逃避工作; [or]6j;
slander: [a]/ˈslændər/; [n]诽谤,诋毁;  [v]讲坏话,污蔑,诽谤; [or]6j;
slang: [a]/slæŋ/; [n]俚语,行话; [or]6j;
slap: [a]/slæp/; [v]掌掴,拍打,侮辱;  [n]侮辱,掴,拍击声;  [adv]猛然;径直;恰好;正好; [or]6j;
slash: [a]/slæʃ/; [n]砍痕;砍;  [v]砍,大幅度削减; [or]6j;
slate: [a]/sleɪt/; [n]黑板,石板,候选人名单;  [v]提名; [or]6j;
slaughter: [a]/ˈslɔːtər/; [v]屠杀,屠宰;  [n]屠宰,屠杀; [or]6j;
slice: [a]/slaɪs/; [v]把..切成片;大幅度削减;切开;  [n]薄片;份额,部分; [or]6j;
slick: [a]/slɪk/; [adj]光滑的;圆滑的;顺利的;不费力的;  [n]海面浮油;小块湿润的区域;  [v]使平滑; [or]6j;
slide: [a]/slaɪd/; [n]滑行;下落;滑面;幻灯片;  [v]使滑动;使滑入;滑动;滑倒;滑落;下跌; [or]6j;
slim: [a]/slɪm/; [adj]细长的;苗条的;  [v](用运动,节食等)减轻体重,变苗条; [or]6j;
slip: [a]/slɪp/; [v]滑倒,跌落,溜走,疏忽;偷偷地给;被遗忘;  [n]溜走;疏忽,错误;纸条;  [adj]打有活结的;可拆卸的;滑动的; [or]6j;
slippery: [a]/ˈslɪpəri/; [adj]滑的;易滑脱的;不老实的;不稳定的; [or]6j;
slogan: [a]/ˈsloʊɡən/; [n]标语;口号;广告语; [or]6j;
slope: [a]/sloʊp/; [n]山坡,斜坡,倾斜;  [v]倾斜; [or]6j;
slot: [a]/slɑːt/; [n]狭缝,狭槽,(机构的)职位;  [v]把.放入狭长开口中,把.纳入; [or]6j;
slum: [a]/slʌm/; [n]贫民窟,贫民区,陋巷;  [v]去贫民窟,到贫民区去(参观,游玩等); [or]6j;
slumber: [a]/ˈslʌmbər/; [n]睡眠;睡觉;  [v]浅睡;打盹儿; [or]6j;
smash: [a]/smæʃ/; [v]粉碎,猛冲,击溃;  [n]破碎(声),猛撞,巨大的成功;  [adj]极为成功的; [or]6j;
smog: [a]/smɑːɡ/; [n]烟雾; [or]6j;
smoothly: [a]/ˈsmuːðli/; [adv]流畅地;顺畅地,流利地;平滑地;平稳地; [or]6j;
smuggle: [a]/ˈsmʌɡl/; [v]非法偷运;走私; [or]6j;
snack: [a]/snæk/; [n]零食,小吃,快餐; [or]6j;
snail: [a]/sneɪl/; [n]蜗牛;迟钝的人;  [v]捉蜗牛;缓慢移动; [or]6j;
snap: [a]/snæp/; [v]使喀嚓一声折断,使发出吧嗒一声(关上或打开);  [n]吧嗒声;快照;  [adj]仓促的,突然的; [or]6j;
snatch: [a]/snætʃ/; [v]强夺;攫取;  [n]片断; [or]6j;
sneak: [a]/sniːk/; [vi]鬼鬼祟祟地走;打小报告;  [vt]潜行;偷窃;  [adj]偷偷的;  [n]行为鬼祟的人; [or]6j;
sneer: [a]/snɪr/; [v]冷笑;嘲笑;  [n]嘲笑; [or]6j;
sneeze: [a]/sniːz/; [n]喷嚏;  [v]打喷嚏; [or]6j;
sniff: [a]/snɪf/; [n]嗅,吸气(声);  [v]嗅,吸气; [or]6j;
snob: [a]/snɑːb/; [n]势利小人;假行家; [or]6j;
snobbish: [a]/ˈsnɑːbɪʃ/; [adj]自命不凡的,势利的; [or]6j;
snore: [a]/snɔːr/; [vi]打鼾;  [n]鼾声; [or]6j;
soar: [a]/sɔːr/; [v]高飞,翱翔;飞腾;猛增;高飞越过;  [n]高飞;高涨; [or]6j;
sober: [a]/ˈsoʊbər/; [vi]变得冷静;  [adj]未饮醉的,清醒的;有节制的;严肃的;  [v]使清醒;使冷静; [or]6j;
sociable: [a]/ˈsoʊʃəbl/; [adj]好交际的; [or]6j;
sociology: [a]/ˌsoʊsiˈɑːlədʒi/; [n]社会学; [or]6j;
soften: [a]/ˈsɔːfn/; [v](使)变柔软,(使)变柔和;使(态度)温和,变温和;使 (光,颜色或声音) 变柔和; [or]6j;
softness: [a]/ˈsɔːftnəs/; [n]柔和,温柔; [or]6j;
software: [a]/ˈsɔːftwer/; [n]软件; [or]6j;
solemn: [a]/ˈsɑːləm/; [adj]严肃的;庄严的,隆重的;神圣的; [or]6j;
solicit: [a]/səˈlɪsɪt/; [v]乞求,恳求给予(帮助,金钱); [or]6j;
solicitor: [a]/səˈlɪsɪtər/; [n](英)初级律师; [or]6j;
solidarity: [a]/ˌsɑːlɪˈdærəti/; [n]团结一致; [or]6j;
solidify: [a]/səˈlɪdɪfaɪ/; [v](使)凝固,(使)团结,巩固; [or]6j;
solitary: [a]/ˈsɑːləteri/; [adj]孤独的,单独的,隐居的;  [n]独居者,隐士;单独禁闭; [or]6j;
solitude: [a]/ˈsɑːlətuːd/; [n]孤独; [or]6j;
solo: [a]/ˈsoʊloʊ/; [n]独唱;  [adj]独奏的;单独的;  [adv]独奏地;单独地;  [v]放单飞; [or]6j;
soluble: [a]/ˈsɑːljəbl/; [adj]可溶解的;可解决的; [or]6j;
solution: [a]/səˈluːʃn/; [n]解决办法;解答;溶液;溶解; [or]6j;
sophisticated: [a]/səˈfɪstɪkeɪtɪd/; [adj](仪器)精密的,复杂的;老于世故的,老练的,富有经验的;高雅的,精致的; [or]6j;
sorrowful: [a]/ˈsɑːroʊfl/; [adj]充满悲伤的,悲哀的,伤心的; [or]6j;
sour: [a]/ˈsaʊər/; [adj]酸的;(人)尖酸刻薄的,不友好的;  [v](友谊,局势,态度等)变坏;使恶化; [or]6j;
souvenir: [a]/ˈsuːvənɪr/; [n]纪念物,纪念品;  [vt]把.留作纪念; [or]6j;
sovereign: [a]/ˈsɑːvrən/; [adj]至高无上的,具有独立主权的,有最高统治权的;  [n]最高统治者,君主,元首; [or]6j;
soy: [a]/sɔɪ/; [n]大豆;酱油; [or]6j;
spacious: [a]/ˈspeɪʃəs/; [adj]宽敞的,广阔的; [or]6j;
span: [a]/spæn/; [n]跨度;时间段;范围;持续时间;  [v]持续;横跨;包括; [or]6j;
sparkle: [a]/ˈspɑːrkl/; [vi]闪耀;焕发,活跃,才华横溢;  [n]光亮;活力; [or]6j;
spatial: [a]/ˈspeɪʃl/; [adj]空间的,关于空间的; [or]6j;
spear: [a]/spɪr/; [n]矛;标枪;嫩叶;  [v]刺戳; [or]6j;
specialist: [a]/ˈspeʃəlɪst/; [n]专家;专科医生;  [adj]专家的;专业的; [or]6j;
specialty: [a]/ˈspeʃəlti/; [n]特色菜;专业,专长,特点; [or]6j;
species: [a]/ˈspiːʃiːz/; [n](单复同)物种;种类;人类;  [adj]物种上的; [or]6j;
specific: [a]/spəˈsɪfɪk/; [adj]具体的,明确的;特定的;特殊的;针对..的;  [n]详情;特性; [or]6j;
specification: [a]/ˌspesɪfɪˈkeɪʃn/; [n]规格,载明,详述; [or]6j;
spectacle: [a]/ˈspektəkl/; [n]场面;景象,奇观;眼镜; [or]6j;
spectacular: [a]/spekˈtækjələr/; [adj]壮观的,引人入胜的;  [n]壮观的场面,精彩的表演; [or]6j;
spectator: [a]/ˈspekteɪtər/; [n]旁观者;观众;目击者; [or]6j;
spectrum: [a]/ˈspektrəm/; [n]光谱,范围,系列; [or]6j;
speculate: [a]/ˈspekjuleɪt/; [vi]推测,猜测;投机,做投机买卖;  [vt]推测; [or]6j;
spherical: [a]/ˈsferɪkl/; [adj]球形的; [or]6j;
spice: [a]/spaɪs/; [n]香料,调味品;额外的趣味;  [v]使增添趣味;加香料于; [or]6j;
spine: [a]/spaɪn/; [n]脊椎; [or]6j;
spiral: [a]/ˈspaɪrəl/; [n]螺旋,螺线;  [v]不断急剧地上升(或下降),螺旋形行进;  [adj]螺旋的; [or]6j;
spite: [a]/spaɪt/; [n]恶意,怨恨;  [v]刁难,欺侮; [or]6j;
splash: [a]/splæʃ/; [v]泼洒,溅,使成斑驳状;将.置于显眼位置;  [n]污点;飞溅的水;卖弄;拍打水的声音; 落入水的声音; [or]6j;
spoil: [a]/spɔɪl/; [v]溺爱;娇惯;(食物)变质;毁坏;  [n]溺爱;战利品;犒劳;成功所带来的好处; [or]6j;
spokesman: [a]/ˈspoʊksmən/; [n]发言人; [or]6j;
sponge: [a]/spʌndʒ/; [n]海绵,多孔布丁,松蛋糕;  [v]用湿海绵(或布)擦,揩; [or]6j;
spontaneous: [a]/spɑːnˈteɪniəs/; [adj]自发的,无意识的;自然的,天真率直的; [or]6j;
spotlight: [a]/ˈspɑːtlaɪt/; [n]聚光灯;  [v]聚光照明,使显著; [or]6j;
spouse: [a]/spaʊs/; [n]配偶,夫妇;夫,妻;  [v]和.结婚; [or]6j;
sprinkle: [a]/ˈsprɪŋkl/; [v]撒,洒;下稀疏的雨;  [n]小雨;少量; [or]6j;
spy: [a]/spaɪ/; [n]间谍,密探;  [v]当间谍,暗中监视(或侦察); [or]6j;
squad: [a]/skwɑːd/; [n](军队的)班,小队,小组;  [v]编成班; [or]6j;
squash: [a]/skwɑːʃ/; [v]压扁,压制;  [n]南瓜,易压烂的物品,拥挤的人群,壁球; [or]6j;
squat: [a]/skwɑːt/; [adj]蹲着的;  [v]蹲坐,蹲伏;  [n]蹲坐; [or]6j;
stab: [a]/stæb/; [v]刺伤;戳;  [n]刺痛;尝试,努力;一种突然强烈的感觉; [or]6j;
stability: [a]/stəˈbɪləti/; [n]稳定,稳定性; [or]6j;
stabilize: [a]/ˈsteɪbəlaɪz/; [v]使稳定; [or]6j;
stable: [a]/ˈsteɪbl/; [n]马厩;  [adj]稳定的;安定的;  [v]使(马)入厩; [or]6j;
stack: [a]/stæk/; [n]堆,一大堆;烟囱;  [v]堆积,堆放; [or]6j;
stagger: [a]/ˈstæɡər/; [v]蹒跚;(使)错开(时间),交错安排;使吃惊;  [n]蹒跚; [or]6j;
stainless: [a]/ˌsteɪnləs/; [adj]不生锈的,不锈钢的; [or]6j;
staircase: [a]/ˈsterkeɪs/; [n]楼梯; [or]6j;
stairway: [a]/ˈsterweɪ/; [n]楼梯; [or]6j;
stalk: [a]/stɔːk/; [n]茎,梗;  [v]隐伏跟踪,(为搜索而)走遍;高视阔步,蔓延; [or]6j;
stall: [a]/stɔːl/; [n]分隔栏;售货摊;厩;  [v]停止(因故障); [or]6j;
standardize: [a]/ˈstændərdaɪz/; [v]立下标准;制定标准;使合乎标准;使标准化; [or]6j;
standpoint: [a]/ˈstændpɔɪnt/; [n]立场,观点; [or]6j;
staple: [a]/ˈsteɪpl/; [v]用订书钉订;  [n]订书钉;主食;主要产品;  [adj]主要的;基本的;标准的; [or]6j;
stark: [a]/stɑːrk/; [adj]完全的,明显的,荒凉的;  [adv]完全,明显地; [or]6j;
startle: [a]/ˈstɑːrtl/; [v]吃惊;惊吓; [or]6j;
statement: [a]/ˈsteɪtmənt/; [n]声明;结算单,报表;陈述; [or]6j;
statesman: [a]/ˈsteɪtsmən/; [n]政治家; [or]6j;
stationary: [a]/ˈsteɪʃəneri/; [adj]静止的;固定的;  [n]定居者,驻军; [or]6j;
stationery: [a]/ˈsteɪʃəneri/; [n]文具;(有配套信封的)信纸; [or]6j;
statistics: [a]/stəˈtɪstɪks/; [n]统计;统计数字,数据;统计学; [or]6j;
status: [a]/ˈsteɪtəs/; [n]地位;状态;身份; [or]6j;
stereo: [a]/ˈsterioʊ/; [n]立体声(装置);  [adj]立体声的; [or]6j;
stereotype: [a]/ˈsteriətaɪp/; [n]老套的模式,陈规,成见;  [v]对..产生成见; [or]6j;
stern: [a]/stɜːrn/; [adj]严厉的;严峻的;苛刻的;坚决的;  [n]船尾; [or]6j;
stew: [a]/stuː/; [v]炖,焖,受闷热;使焦虑不安;  [n]炖肉(或菜);鱼塘; [or]6j;
sticky: [a]/ˈstɪki/; [adj]粘的,黏糊糊的;闷热的;困难的;令人不满意的;  [n]便利贴; [or]6j;
stiffness: [a]/ˈstɪfnəs/; [n]僵硬;不友好,死板;硬度; [or]6j;
stillness: [a]/ˈstɪlnəs/; [n]沉静;宁静,静止; [or]6j;
stimulus: [a]/ˈstɪmjələs/; [n]刺激物;鼓励;促进因素; [or]6j;
stitch: [a]/stɪtʃ/; [v]缝,绣;  [n]一针,线迹;缝法,编结法;(肋部的)突然剧痛;缝合(伤口); [or]6j;
stock: [a]/stɑːk/; [n]股票;股份;存货;储备;家畜;  [v]给..装满;储存;  [adj]储备的; [or]6j;
stout: [a]/staʊt/; [adj]矮胖的,结实的;勇敢的;激烈的;  [n]矮胖子;烈性啤酒; [or]6j;
straighten: [a]/ˈstreɪtn/; [v](使)弄直,伸直; [or]6j;
straightforward: [a]/ˌstreɪtˈfɔːrwərd/; [adj]坦率的,笔直的,正直的,直接的; [or]6j;
strain: [a]/streɪn/; [n]负担;紧张;拉力;(生物体)品种,种类;  [v]拉紧;劳累;过分使用; [or]6j;
strait: [a]/streɪt/; [n]海峡;窘迫; [or]6j;
strand: [a]/strænd/; [n](线等的)股,缕;一个组成部分;海滨,河岸,海滩,湖滨;  [v]使陷入困境;使滞留,使搁浅; [or]6j;
strategic: [a]/strəˈtiːdʒɪk/; [adj]战略(上)的,对全局有重要意义的,关键的; [or]6j;
strategy: [a]/ˈstrætədʒi/; [n]谋略,策略,计谋; [or]6j;
stray: [a]/streɪ/; [adj]走失的,迷路的;离了群的;  [v]走失;分心,走神;有外遇,在别处拈花惹草;  [n]流浪者;走失,迷路; [or]6j;
streak: [a]/striːk/; [n]条纹,条痕,色线;  [v]裸奔;成条纹; [or]6j;
stream: [a]/striːm/; [n]小河,溪流;流,一股,一串;  [v]流(出),涌(出);按能力分班(或分组); [or]6j;
streamline: [a]/ˈstriːmlaɪn/; [n]流线型;  [adj]流线型的;  [vt]使成流线型;使.简化; [or]6j;
stride: [a]/straɪd/; [v]大步走;越过;跨越;  [vt]大步走过;跨骑在.上;  [n]大步;阔步行走的姿势;一大步;跨越;正常的进展; [or]6j;
strife: [a]/straɪf/; [n]纷争,倾轧; [or]6j;
striking: [a]/ˈstraɪkɪŋ/; [adj]容貌出众的,吸引人的;显著的,突出的;  [n]罢工; [or]6j;
string: [a]/strɪŋ/; [n]弦,线,细绳,一系列;一行;  [v]串起;悬挂;使紧张;  [adj]线的,线织的;由弦乐器组成的; [or]6j;
strive: [a]/straɪv/; [v]斗争;努力,奋斗; [or]6j;
stroke: [a]/stroʊk/; [n]击打;一击,一次,一举;中风;抚摸;笔画;  [v]拭去;轻抚; [or]6j;
stroll: [a]/stroʊl/; [n]漫步;散步;闲荡;溜达;  [vi]散步;  [vt]溜达;游荡;在.散步;在.漫步; [or]6j;
stubborn: [a]/ˈstʌbərn/; [adj]顽固的;倔强的;难对付的; [or]6j;
studio: [a]/ˈstuːdioʊ/; [n]摄影棚;工作室;录音室;单间公寓(studio flat);制片公司; [or]6j;
stuffy: [a]/ˈstʌfi/; [adj]闷热的;古板的;鼻子不通气的; [or]6j;
stumble: [a]/ˈstʌmbl/; [v]绊跌,绊倒;结结巴巴说话;  [n]绊倒;失足;失误;失败; [or]6j;
stump: [a]/stʌmp/; [n]树桩,残肢,残余的部分;  [v]把..难住,到处做演讲,沉重或笨重地移动; [or]6j;
stun: [a]/stʌn/; [v]使昏迷,使发愣; [or]6j;
sturdy: [a]/ˈstɜːrdi/; [adj]结实的;坚固的;强壮的;健壮的;  [n](羊的)晕倒病; [or]6j;
stylish: [a]/ˈstaɪlɪʃ/; [adj]时髦的,漂亮的,流行的; [or]6j;
subdivide: [a]/ˈsʌbdɪvaɪd/; [v]再分; [or]6j;
subdue: [a]/səbˈduː/; [v]征服,压制,减轻; [or]6j;
subjective: [a]/səbˈdʒektɪv/; [adj]主观(上)的,个人的; [or]6j;
submarine: [a]/ˈsʌbməriːn/; [n]潜水艇;  [adj]水底的,海底的; [or]6j;
submit: [a]/səbˈmɪt/; [v]提交;屈服,使...服从;建议,主张; [or]6j;
subordinate: [a]/səˈbɔːrdɪnət/; [n]部下;下属;  [adj]次要的;从属的;下级的;  [v]使从属于;使处于次要地位; [or]6j;
subscribe: [a]/səbˈskraɪb/; [vi]捐款;订阅;认购(股份);  [vt]申请; [or]6j;
subscription: [a]/səbˈskrɪpʃn/; [n]订阅;捐款;签署;同意;会费;  [adj]收费的; [or]6j;
subsequent: [a]/ˈsʌbsɪkwənt/; [adj]随后的; [or]6j;
subsidy: [a]/ˈsʌbsədi/; [n]补助金,津贴; [or]6j;
substance: [a]/ˈsʌbstəns/; [n]物质;实质,本质;药物; [or]6j;
substitute: [a]/ˈsʌbstɪtuːt/; [v]代替;  [n]代替者,代用品,替补队员; [or]6j;
subtle: [a]/ˈsʌtl/; [adj]微妙的;敏锐的;不明显的;精细的;狡猾的; [or]6j;
subtract: [a]/səbˈtrækt/; [v]减少;减去;扣除;  [vt]减去; [or]6j;
suburb: [a]/ˈsʌbɜːrb/; [n]郊区; [or]6j;
successive: [a]/səkˈsesɪv/; [adj]连续的;接连的; [or]6j;
successor: [a]/səkˈsesər/; [n]继承者;继任者; [or]6j;
sue: [a]/suː/; [v]控告,提起诉讼;控告;起诉;  [n]女子名(Sue); [or]6j;
suffice: [a]/səˈfaɪs/; [v]足够; [or]6j;
sufficient: [a]/səˈfɪʃnt/; [adj]足够的;充分的; [or]6j;
suicide: [a]/ˈsuːɪsaɪd/; [n]自杀;自毁; [or]6j;
suitcase: [a]/ˈsuːtkeɪs/; [n]小提箱,手提箱; [or]6j;
suite: [a]/swiːt/; [n](旅馆的)套间;一套家具;一组程序;组曲; [or]6j;
sulfur: [a]/ˈsʌlfər/; [n]硫磺; [or]6j;
sullen: [a]/ˈsʌlən/; [adj]沮丧的,闷闷不乐的;阴沉的; [or]6j;
summit: [a]/ˈsʌmɪt/; [n]山顶,顶点;(政府间的)峰会; [or]6j;
summon: [a]/ˈsʌmən/; [v]召唤;召集;聚集; [or]6j;
superb: [a]/suːˈpɜːrb/; [adj]极好的;壮丽的; [or]6j;
superficial: [a]/ˌsuːpərˈfɪʃl/; [adj]肤浅的;表面的;微不足道的;  [n]表面文章; [or]6j;
superintendent: [a]/ˌsuːpərɪnˈtendənt/; [n]主管人,负责人;警长;监督人; [or]6j;
superior: [a]/suːˈpɪriər/; [n]上级,高手;  [adj]较高级的,上层的,出众的; [or]6j;
superiority: [a]/suːˌpɪriˈɔːrəti/; [n]优越(性),优等; [or]6j;
supersonic: [a]/ˌsuːpərˈsɑːnɪk/; [adj]超音速的; [or]6j;
superstition: [a]/ˌsuːpərˈstɪʃn/; [n]迷信,盲目恐惧; [or]6j;
supervise: [a]/ˈsuːpərvaɪz/; [v]监督;指导;管理; [or]6j;
supple: [a]/ˈsʌpl/; [adj]柔软的;柔顺的; [or]6j;
supplement: [a]/ˈsʌplɪmənt/; [n]增补,补充物,保健品;附录;  [v]补充; [or]6j;
supplementary: [a]/ˌsʌplɪˈmentri/; [adj]补充的;附加的;  [n]补充者; [or]6j;
suppress: [a]/səˈpres/; [v]镇压;禁止发表;抑制(感情等);阻止.的生长; [or]6j;
supreme: [a]/suːˈpriːm/; [adj]至高的;最重要的;极度的; [or]6j;
surge: [a]/sɜːrdʒ/; [n]波涛汹涌;波动;激增;  [v]波浪般汹涌奔腾;激增; [or]6j;
surgeon: [a]/ˈsɜːrdʒən/; [n]外科医生; [or]6j;
surgery: [a]/ˈsɜːrdʒəri/; [n]外科手术;外科; [or]6j;
surpass: [a]/sərˈpæs/; [v]胜过;超出; [or]6j;
surplus: [a]/ˈsɜːrplʌs/; [adj]过剩的,多余的;  [n]过剩,盈余;顺差; [or]6j;
survival: [a]/sərˈvaɪvl/; [n]存活;生存; [or]6j;
survive: [a]/sərˈvaɪv/; [vi]活下来,幸存;  [vt]比..活得长;幸存,存活;幸免于难; [or]6j;
susceptible: [a]/səˈseptəbl/; [adj]易受感染的;易受影响的;多情的; [or]6j;
suspension: [a]/səˈspenʃn/; [n]悬浮;暂停;停职; [or]6j;
suspicion: [a]/səˈspɪʃn/; [n]怀疑,猜疑,疑心;少许; [or]6j;
suspicious: [a]/səˈspɪʃəs/; [adj]可疑的,引起怀疑的;怀疑的,猜疑的; [or]6j;
sustain: [a]/səˈsteɪn/; [v]维持;支撑,承受;供养;忍受;遭受,蒙受; [or]6j;
swamp: [a]/swɑːmp/; [n]沼泽;  [v]淹没,浸没;使困惑,压倒; [or]6j;
swap: [a]/swɑːp/; [v]交换;替换;对调;  [n]交换;交换物; [or]6j;
sweetness: [a]/ˈswiːtnəs/; [n]甜蜜,可爱;甜味; [or]6j;
symbol: [a]/ˈsɪmbl/; [n]象征;符号,图标;记号;标志; [or]6j;
symmetrical: [a]/sɪˈmetrɪkl/; [adj]对称的; [or]6j;
symmetry: [a]/ˈsɪmətri/; [n]对称;均衡; [or]6j;
sympathetic: [a]/ˌsɪmpəˈθetɪk/; [adj]有同情心的,同情的;支持的;称心的; [or]6j;
sympathy: [a]/ˈsɪmpəθi/; [n]同情;同感; [or]6j;
symphony: [a]/ˈsɪmfəni/; [n]交响乐; [or]6j;
symposium: [a]/sɪmˈpoʊziəm/; [n]专题报告会; [or]6j;
symptom: [a]/ˈsɪmptəm/; [n]症状;征兆; [or]6j;
syndrome: [a]/ˈsɪndroʊm/; [n]［医］综合征;一系列表现; [or]6j;
synthesis: [a]/ˈsɪnθəsɪs/; [n]合成; [or]6j;
systematically: [a]/ˌsɪstəˈmætɪkli/; [adv]有系统地; [or]6j;
tablet: [a]/ˈtæblət/; [n]药片;便笺簿;碑,匾; [or]6j;
tabulate: [a]/ˈtæbjuleɪt/; [v]将.制成表;制成表格;  [vt]把.列表显示;  [adj]平面的;板状的; [or]6j;
tack: [a]/tæk/; [n]平头钉;行动步骤;  [v]钉住;使(船)抢风转变航向; [or]6j;
tackle: [a]/ˈtækl/; [v]对付,处理;(足球等比赛中)阻截;  [n]阻截;钓具;滑轮(组); [or]6j;
tact: [a]/tækt/; [n]机智,得体,老练,圆滑; [or]6j;
tactics: [a]/'tæktɪks/; [n]战术,策略; [or]6j;
tame: [a]/teɪm/; [adj]驯服的,温顺的;顺从的;枯燥的;  [v]驯服; [or]6j;
tan: [a]/tæn/; [n]棕褐色,棕黄色;晒成棕褐色,晒黑;  [v]使晒成棕褐色;硝制(皮革); [or]6j;
tangle: [a]/ˈtæŋɡl/; [v](使)缠结;(使)乱作一团;  [n]纠缠;纠结;复杂的问题;困惑; [or]6j;
tanker: [a]/ˈtæŋkər/; [n]油轮;运油飞机;油槽车;坦克手; [or]6j;
taper: [a]/ˈteɪpər/; [v]逐渐变细;  [n]锥形;渐弱;蜡芯,小蜡烛;  [vi]变尖;逐渐减弱;  [vt]变尖;逐渐减弱;  [adj]渐细的;斜的;依次递减的; [or]6j;
tar: [a]/tɑːr/; [n]柏油;焦油;  [v]涂柏油; [or]6j;
target: [a]/ˈtɑːrɡɪt/; [n]目标;靶子;  [v]瞄准; [or]6j;
tease: [a]/tiːz/; [v]取笑;挑逗;逗弄;使..渴望;逆梳;  [n]爱戏弄别人者; [or]6j;
tedious: [a]/ˈtiːdiəs/; [adj]沉闷的,冗长乏味的; [or]6j;
telecommunication: [a]/ˌtelikəˌmjuːnɪˈkeɪʃn/; [n]远程通讯;  [adj]与电信有关的; [or]6j;
telecommunications: [a]/ˌtelikəˌmjuːnɪˈkeɪʃnz/; [n]无线电通讯;电信学; [or]6j;
temper: [a]/ˈtempər/; [n]脾气,性情;调和剂;  [v]锻炼,缓和; [or]6j;
temperament: [a]/ˈtemprəmənt/; [n]气质,性格,喜怒无常; [or]6j;
tempt: [a]/tempt/; [v]诱惑;吸引;冒..的风险,不顾; [or]6j;
tenant: [a]/ˈtenənt/; [n]承租人,租客,佃户; [or]6j;
tendency: [a]/ˈtendənsi/; [n]趋向,趋势,倾向;癖好,意向;派别; [or]6j;
tensile: [a]/ˈtensl/; [adj]可拉长的,可伸长的,<物>张力的,拉力的; [or]6j;
tentative: [a]/ˈtentətɪv/; [adj]试探性的;不确定的;暂时的;犹豫不决的; [or]6j;
tenure: [a]/ˈtenjər/; [n]任期;终身职位; [or]6j;
terminate: [a]/ˈtɜːrmɪneɪt/; [adj]终止的;可结尾的;  [vi]结束;结尾;  [v]使结束,终止; [or]6j;
terminology: [a]/ˌtɜːrməˈnɑːlədʒi/; [n]术语,术语学; [or]6j;
terrace: [a]/ˈterəs/; [n]阳台;梯田;走廊;  [vi]成阶地;  [adj]梯形的;  [vt]使成梯田; [or]6j;
terrain: [a]/təˈreɪn/; [n]地面,地形; [or]6j;
terrific: [a]/təˈrɪfɪk/; [adj]极好的;可怕的;(尺寸或程度)极其巨大的,大的惊人的; [or]6j;
terrify: [a]/ˈterɪfaɪ/; [v]使害怕;使惊恐; [or]6j;
territory: [a]/ˈterətɔːri/; [n]地区,领土;版图;领域;范围;属地; [or]6j;
terrorist: [a]/ˈterərɪst/; [n]恐怖主义者; [or]6j;
testify: [a]/ˈtestɪfaɪ/; [vt]作证;  [vi]证明;  [v]声明;见证(上帝的存在);证实; [or]6j;
testimony: [a]/ˈtestɪmoʊni/; [n]证据,证词;表明,说明;见证,证明; [or]6j;
theft: [a]/θeft/; [n]偷盗,失窃; [or]6j;
theme: [a]/θiːm/; [n]主题;主旨;主旋律;  [adj]主题的;  [v]赋予.某种主题; [or]6j;
theorem: [a]/ˈθiːərəm/; [n]<数>定理,法则; [or]6j;
therapy: [a]/ˈθerəpi/; [n]治疗,理疗;疗法; [or]6j;
therefore: [a]/ˈðerfɔːr/; [adv]因此,所以; [or]6j;
thermal: [a]/ˈθɜːrml/; [adj]保暖的;温泉的;热的;  [n]保暖内衣裤; [or]6j;
thesis: [a]/ˈθiːsɪs/; [n](学位)论文,论题,论点; [or]6j;
thicken: [a]/ˈθɪkən/; [v](使)变厚,(使)变粗,使)变浓;变复杂,变密集; [or]6j;
thigh: [a]/θaɪ/; [n]大腿; [or]6j;
thirst: [a]/θɜːrst/; [n]渴;干渴,缺水;渴求,渴望;  [v]渴求; [or]6j;
thorn: [a]/θɔːrn/; [n]刺;荆棘;带刺小灌木; [or]6j;
thoughtless: [a]/ˈθɔːtləs/; [adj]欠考虑的,轻率的;不体贴人的; [or]6j;
thrash: [a]/θræʃ/; [v]打(谷),(用棍,鞭等)痛打,打败,使逆行,胜过;  [n]敲击摇滚乐; [or]6j;
threaten: [a]/ˈθretn/; [vt]威胁;危及;恐吓;预示..的恶兆;  [v]恐吓; [or]6j;
threshold: [a]/ˈθreʃhoʊld/; [n]门槛;开端; [or]6j;
thrifty: [a]/ˈθrɪfti/; [adj]节省的,节俭的; [or]6j;
thrill: [a]/θrɪl/; [n]兴奋,激动,引起激动的事物;  [v](使)非常兴奋,(使)非常激动; [or]6j;
thrive: [a]/θraɪv/; [v]茁壮成长;繁荣,兴旺; [or]6j;
throne: [a]/θroʊn/; [n]王座;君主; [or]6j;
tick: [a]/tɪk/; [n]勾号,(钟表)滴答声,一刹那;  [v]用勾作为记号,发出滴答声; [or]6j;
tickle: [a]/ˈtɪkl/; [v]呵.痒,使发痒;使高兴;  [n]痒; [or]6j;
tighten: [a]/ˈtaɪtn/; [v]拉紧;使..更严格; [or]6j;
tightly: [a]/ˈtaɪtli/; [adv]紧紧地; [or]6j;
tile: [a]/taɪl/; [n]瓦;瓷砖;  [v]贴砖于;用瓦盖; [or]6j;
tilt: [a]/tɪlt/; [v](使)倾斜;  [n]倾斜,斜坡; [or]6j;
timber: [a]/ˈtɪmbər/; [n]木料;树木;性格,素质;  [int]树要倒啦!;  [adj]木材的,木制的;  [v]用木材作骨架;以林木覆盖; [or]6j;
timely: [a]/ˈtaɪmli/; [adj]适时的,及时的;  [adv]及时地; [or]6j;
timid: [a]/ˈtɪmɪd/; [adj]胆怯的;腼腆的; [or]6j;
tiresome: [a]/ˈtaɪərsəm/; [adj]使人疲倦的;烦人的,讨厌的;无聊的; [or]6j;
tissue: [a]/ˈtɪʃuː/; [n]面巾纸,(动植物的)组织,纱布; [or]6j;
toad: [a]/toʊd/; [n]<动>蟾蜍,癞蛤蟆,讨厌的家伙; [or]6j;
token: [a]/ˈtoʊkən/; [n]象征;礼券,代金券;筹码,代币;  [adj]象征性的; [or]6j;
tolerant: [a]/ˈtɑːlərənt/; [adj]容忍的,宽容的; [or]6j;
toll: [a]/toʊl/; [n]伤亡人数;(道路等的)通行费;钟声;  [v]敲钟; [or]6j;
torpedo: [a]/tɔːrˈpiːdoʊ/; [n]鱼雷;油井爆破筒;  [v]用鱼雷进攻,破坏; [or]6j;
torque: [a]/tɔːrk/; [n]转矩; [or]6j;
toss: [a]/tɔːs/; [v]扔,抛,掷;  [n]掷,掷钱币来决定,猛抬头; [or]6j;
touched: [a]/tʌtʃt/; [adj]受感动的;精神轻微失常的; [or]6j;
tow: [a]/toʊ/; [v]拖,牵引;拉; [or]6j;
toward: [a]/tɔːrd/; prep. 向;朝;对于; [or]6j;
toxic: [a]/ˈtɑːksɪk/; [n]毒物;  [adj]有毒的;中毒的; [or]6j;
tract: [a]/trækt/; [n]器官系统;一大片地;短文,小册子; [or]6j;
trader: [a]/ˈtreɪdər/; [n]商人; [or]6j;
tradesman: [a]/ˈtreɪdzmən/; [n]零售商;工匠; [or]6j;
trait: [a]/treɪt/; [n]特征; [or]6j;
tramp: [a]/træmp/; [n]流浪汉;无业游民;沉重的脚步声;长途跋涉;  [v]重步行走;踏;践踏; [or]6j;
tranquil: [a]/ˈtræŋkwɪl/; [adj]宁静的,安静的; [or]6j;
transaction: [a]/trænˈzækʃn/; [n]交易;办理;事务;学报; [or]6j;
transcend: [a]/trænˈsend/; [v]超越(经验,理性,信念等)的范围,超过; [or]6j;
transfer: [a]/trænsˈfɜːr/; [v]转移;调任;换乘;转变;改编;  [n]转让;转移;调任;汇兑; [or]6j;
transform: [a]/trænsˈfɔːrm/; [v]将..变形,改变,转换; [or]6j;
transformation: [a]/ˌtrænsfərˈmeɪʃn/; [n]变化,改造,转变; [or]6j;
transient: [a]/ˈtrænʃnt/; [adj]短暂的,路过的;转瞬即逝的;  [n]过客; [or]6j;
transistor: [a]/trænˈzɪstər/; [n]晶体管;半导体收音机; [or]6j;
transit: [a]/ˈtrænzɪt/; [n]运输;运送;  [v]运送;通过; [or]6j;
transition: [a]/trænˈzɪʃn/; [n]转变,过渡时期;  [v](从某一状态或活动)转变,过渡(到另一状态或活动); [or]6j;
transmission: [a]/trænsˈmɪʃn/; [n]发射,转播,传播,变速器; [or]6j;
transmit: [a]/trænsˈmɪt/; [v]传送;传播,传导;发射; [or]6j;
transplant: [a]/trænsˈplænt/; [n]移种;移植;  [v]移植(器官),使移居,移种(植物等); [or]6j;
transport: [a]/ˈtrænspɔːrt/; [v]运输;使狂喜;流放;  [n]运输;运输工具;流放犯; [or]6j;
transverse: [a]/ˈtrænzvɜːrs/; [adj]横向的;横断的; [or]6j;
traverse: [a]/trəˈvɜːrs/; [v]横越;穿过;  [n]横越; [or]6j;
treasurer: [a]/ˈtreʒərər/; [n]财务主管; [or]6j;
treaty: [a]/ˈtriːti/; [n]条约;协议;协定; [or]6j;
tremendous: [a]/trəˈmendəs/; [adj]巨大的;极大的;惊人的; [or]6j;
trench: [a]/trentʃ/; [n]沟;壕沟,战壕;海沟; [or]6j;
trend: [a]/trend/; [n]趋势;倾向;时尚;  [v]倾向;走向;转向;使趋向; [or]6j;
trial: [a]/ˈtraɪəl/; [n]审判,审理;试验;试用;磨炼,苦难;  [adj]试验的,试验性的;考验的;审判的;  [v]测试; [or]6j;
triangular: [a]/traɪˈæŋɡjələr/; [adj]三角形的;三人间的; [or]6j;
tribe: [a]/traɪb/; [n]部落; [or]6j;
tribute: [a]/ˈtrɪbjuːt/; [n]致敬;悼念;贡品;称赞; [or]6j;
trifle: [a]/ˈtraɪfl/; [n]蛋糕;琐事,小事,无价值的东西;  [v]嘲笑,轻视; [or]6j;
trigger: [a]/ˈtrɪɡər/; [n](枪等的)扳机,诱因;  [v]触发,引起,激发,扣扳机; [or]6j;
triple: [a]/ˈtrɪpl/; [v]使成三倍,三倍于;  [adj]三倍的; [or]6j;
triumph: [a]/ˈtraɪʌmf/; [n]喜悦,狂喜;凯旋,胜利;  [v]成功,获胜; [or]6j;
triumphant: [a]/traɪˈʌmfənt/; [adj]得胜的,得意洋洋的; [or]6j;
trolley: [a]/ˈtrɑːli/; [n]电车;有轨电车;无轨电车;触轮;手推车;  [vt]搭乘;  [vi]搭乘; [or]6j;
tropic: [a]/ˈtrɑːpɪk/; [n]热带,回归线;  [adj]热带的; [or]6j;
trot: [a]/trɑːt/; [v](使)小跑,(使)快步走,骑马小跑,疾走;  [n]小跑,骑马,疾走;忙碌; [or]6j;
tub: [a]/tʌb/; [n]洗澡盆,浴缸,桶,盆,杯,一桶的(分量); [or]6j;
tuberculosis: [a]/tuːˌbɜːrkjəˈloʊsɪs/; [n]肺结核; [or]6j;
tuck: [a]/tʌk/; [v]把(衬衫,餐巾等的)边塞到里面;把.夹入,把.藏入;  [n](衣服等的)褶,裥; [or]6j;
tug: [a]/tʌɡ/; [v]用力拖(或拉);  [n]猛拉;牵引; [or]6j;
tuition: [a]/tuˈɪʃn/; [n]学费,教学,讲授; [or]6j;
tulip: [a]/ˈtuːlɪp/; [n]<植>郁金香; [or]6j;
tumble: [a]/ˈtʌmbl/; [v]翻滚;不由自主地卷入;(价格等)暴跌;跌倒,摔下,滚下;  [n]跌倒,摔倒; [or]6j;
tuna: [a]/ˈtuːnə/; [n]金枪鱼; [or]6j;
tunnel: [a]/ˈtʌnl/; [n]隧道;  [v]挖地道; [or]6j;
turbulent: [a]/ˈtɜːrbjələnt/; [adj]湍急的;混乱的,动荡的;骚动的; [or]6j;
turnover: [a]/ˈtɜːrnoʊvər/; [n]成交量;营业收入;人员更替率;半圆卷饼; [or]6j;
turtle: [a]/ˈtɜːrtl/; [n]海龟; [or]6j;
tutor: [a]/ˈtuːtər/; [n]家庭教师,指导教师;  [v]个别指导;当.家庭教师; [or]6j;
twilight: [a]/ˈtwaɪlaɪt/; [n]黄昏,薄暮,黎明;晚期,没落时期;  [adj]微明的;界限不清的; [or]6j;
twinkle: [a]/ˈtwɪŋkl/; [vi]闪烁;闪闪发光; [or]6j;
twist: [a]/twɪst/; [v]捻,搓;扭;歪曲;  [n]搓,扭拧;意外进展;弯曲处; [or]6j;
tyrant: [a]/ˈtaɪrənt/; [n]暴君; [or]6j;
ultimate: [a]/ˈʌltɪmət/; [adj]根本的;最后的,最终的; [or]6j;
ultrasonic: [a]/ˌʌltrəˈsɑːnɪk/; [adj]超声的; [or]6j;
ultraviolet: [a]/ˌʌltrəˈvaɪələt/; [adj]紫外线;紫外线的; [or]6j;
unanimous: [a]/juˈnænɪməs/; [adj]全体一致的;一致同意的; [or]6j;
uncertain: [a]/ʌnˈsɜːrtn/; [adj]不确定的;不确知的;不可靠的;易变的; [or]6j;
underestimate: [a]/ˌʌndərˈestɪmeɪt/; [v]低估;对.估计不足; [or]6j;
undergo: [a]/ˌʌndərˈɡoʊ/; [v]经历;遭受; [or]6j;
underlying: [a]/ˌʌndərˈlaɪɪŋ/; [adj]基本的;潜在的;在下面的; [or]6j;
undermine: [a]/ˌʌndərˈmaɪn/; [v]暗中破坏;逐渐削弱;侵蚀.的基础;在...下挖坑道,从根基处损害; [or]6j;
underprivileged: [a]/ˌʌndərˈprɪvəlɪdʒd/; [adj]贫困的;被剥夺基本权力的;社会地位低下的;  [n]弱势群体;贫困阶层; [or]6j;
undertaking: [a]/ˌʌndərˈteɪkɪŋ/; [n]事业,企业;承诺,保证;殡仪业;工程; [or]6j;
underwear: [a]/ˈʌndərwer/; [n]内衣裤; [or]6j;
undesirable: [a]/ˌʌndɪˈzaɪərəbl/; [adj]令人不悦的;讨厌的;  [n]不受欢迎的人;不良分子; [or]6j;
undue: [a]/ˌʌnˈduː/; [adj]过分的,不适当的;过度的;尚未到期的; [or]6j;
unemployment: [a]/ˌʌnɪmˈplɔɪmənt/; [n]失业;失业人数; [or]6j;
unfit: [a]/ʌnˈfɪt/; [adj]不适宜的,不合适的;不适当的;不健康的;  [v]不适合; [or]6j;
unfold: [a]/ʌnˈfoʊld/; [v]展开,伸展;表露,显露; [or]6j;
uniformly: [a]/ˈjuːnɪfɔːrmli/; [adv]一致地; [or]6j;
unify: [a]/ˈjuːnɪfaɪ/; [v]使联合,统一;使相同,使一致; [or]6j;
unique: [a]/juˈniːk/; [adj]独特的,独一无二的;(唯一的)特有的;不同寻常的; [or]6j;
unity: [a]/ˈjuːnəti/; [n]联合,统一;统一体;团结,一致; [or]6j;
universally: [a]/ˌjuːnɪˈvɜːrsəli/; [adv]普遍地;到处; [or]6j;
universe: [a]/ˈjuːnɪvɜːrs/; [n]宇宙,万物,世界,领域,范围; [or]6j;
unlock: [a]/ˌʌnˈlɑːk/; [v]开启;解开; [or]6j;
unpaid: [a]/ˌʌnˈpeɪd/; [adj]未付款的;不受报酬的; [or]6j;
unreasonable: [a]/ʌnˈriːznəbl/; [adj]不合理的;过度的; [or]6j;
untie: [a]/ʌnˈtaɪ/; [v]解开,解放; [or]6j;
update: [a]/ˌʌpˈdeɪt/; [v]更新;为..提供最新信息;  [n]更新;最新的情况; [or]6j;
upgrade: [a]/ˈʌpɡreɪd/; [v]升级;提高;  [n]改善,提高;升级;升舱; [or]6j;
upright: [a]/ˈʌpraɪt/; [adj]垂直的;正直的;  [adv]直立地;  [n]立柱; [or]6j;
uproar: [a]/ˈʌprɔːr/; [n]骚动;喧嚣; [or]6j;
urban: [a]/ˈɜːrbən/; [adj]城市的,城镇的,都市的; [or]6j;
urge: [a]/ɜːrdʒ/; [v]力劝,敦促;驱策;力荐;  [vi]驱策;  [n]冲动,欲望; [or]6j;
urine: [a]/ˈjʊrən/; [n]尿; [or]6j;
utensil: [a]/juːˈtensl/; [n]工具,(厨房)用具; [or]6j;
utilization: [a]/ˌjuːtələˈzeɪʃn/; [n]利用; [or]6j;
utilize: [a]/ˈjuːtəlaɪz/; [v]利用;使用; [or]6j;
utmost: [a]/ˈʌtmoʊst/; [adj]最大的;极度的;最远的;  [n]极限; [or]6j;
vacancy: [a]/ˈveɪkənsi/; [n]空,空白,空房;(职位)空缺;空虚; [or]6j;
vacant: [a]/ˈveɪkənt/; [adj]空的,未被占用的;闲置的;空缺的;茫然的; [or]6j;
vaccinate: [a]/ˈvæksɪneɪt/; [v]进行预防接种;  [n]被接种牛痘者; [or]6j;
vain: [a]/veɪn/; [adj]爱虚荣的;徒劳的;没有真正意义的,没有真正价值的,无关紧要的;自负的,自高自大的;无益的; [or]6j;
valid: [a]/ˈvælɪd/; [adj]有效的,正式认可的;合理的,有根据的; [or]6j;
validity: [a]/vəˈlɪdəti/; [n]正确(性);有效(性),效力; [or]6j;
valve: [a]/vælv/; [n]阀门,活门; [or]6j;
van: [a]/væn/; [n]厢式货车;面包车;(火车的)货车车厢;先锋; [or]6j;
variation: [a]/ˌveriˈeɪʃn/; [n]变异,变化,变奏曲;<生物> 变异,变种;差异; [or]6j;
various: [a]/ˈveriəs/; [adj]各种各样的;不同的; [or]6j;
vary: [a]/ˈveri/; [v]相异;改变,变化;使多样化; [or]6j;
vast: [a]/væst/; [adj]辽阔的;巨大的; [or]6j;
vault: [a]/vɔːlt/; [n]保险库,金库,拱顶,墓室;  [v]越过,跳过; [or]6j;
vector: [a]/ˈvektər/; [n]<数>向量;矢量;带菌者; [or]6j;
vegetation: [a]/ˌvedʒəˈteɪʃn/; [n]植被; [or]6j;
vehicle: [a]/ˈviːəkl/; [n]交通工具,机动车;传播媒介;工具,手段; [or]6j;
veil: [a]/veɪl/; [v]用面纱掩盖,掩饰;  [n]面纱,遮蔽物; [or]6j;
vein: [a]/veɪn/; [n]静脉;血管;叶脉;纹理;迹象;风格,性情; [or]6j;
velocity: [a]/vəˈlɑːsəti/; [n]速度;迅速,快速; [or]6j;
velvet: [a]/ˈvelvɪt/; [n]天鹅绒;鹿茸的嫩皮;  [adj]天鹅绒的; [or]6j;
vent: [a]/vent/; [n]发泄;通风口,排气口;(上衣背部或两侧的)开衩;(小型动物的)排泄口;  [v]发泄(情绪),开孔,泄露; [or]6j;
ventilate: [a]/ˈventɪleɪt/; [v]使.通风,透风;公开讨论; [or]6j;
venture: [a]/ˈventʃər/; [n]企业;(商业)冒险;投机,风险投资;  [vi]冒险前进;  [vt]冒.的危险;以.做赌注; [or]6j;
verbal: [a]/ˈvɜːrbl/; [adj]言语的,口头的,动词的; [or]6j;
verdict: [a]/ˈvɜːrdɪkt/; [n](陪审团)裁决;定论;意见; [or]6j;
verge: [a]/vɜːrdʒ/; [n]边缘;边界;  [v]接近;濒临; [or]6j;
verify: [a]/ˈverɪfaɪ/; [v]查证,证明,证实; [or]6j;
versatile: [a]/ˈvɜːrsətl/; [adj]万能的,综合的,多才多艺的; [or]6j;
verse: [a]/vɜːrs/; [n]诗句,诗节,诗; [or]6j;
version: [a]/ˈvɜːrʒn/; [n]版本;译文;(某人对于某件事不同于其他人的)描述,说法; [or]6j;
versus: [a]/ˈvɜːrsəs/; prep. 以..为对手;与..相对,与..相比; [or]6j;
vertical: [a]/ˈvɜːrtɪkl/; [adj]垂直的;顶点的;  [n]垂直线,垂直面; [or]6j;
veto: [a]/ˈviːtoʊ/; [v]否决;投反对票;  [n]否决;否决权;禁止; [or]6j;
vice: [a]/vaɪs/; [n]缺点;恶习;邪恶;罪行;生理缺陷;  [adj]副的;代理的;  pref. 代理的;  [vt]用老虎钳夹紧;钳制; [or]6j;
vicinity: [a]/vəˈsɪnəti/; [n]附近地区;近邻;附近; [or]6j;
vicious: [a]/ˈvɪʃəs/; [adj]罪恶的;恶意的;凶猛的,残忍的; [or]6j;
victim: [a]/ˈvɪktɪm/; [n]牺牲品,受害者,替罪羊; [or]6j;
vigorous: [a]/ˈvɪɡərəs/; [adj]精力充沛的;强有力的,有活力的;强健的; [or]6j;
vigour: [a]/ˈvɪɡər/; [n]活力; [or]6j;
vine: [a]/vaɪn/; [n]藤,蔓; [or]6j;
violate: [a]/ˈvaɪəleɪt/; [v]违反,违背;侵犯,妨碍;亵渎; [or]6j;
violation: [a]/ˌvaɪəˈleɪʃn/; [n]违反,违背,妨碍;侵害;<体>违例,强奸; [or]6j;
violent: [a]/ˈvaɪələnt/; [adj]强烈的,猛烈的;暴力的,粗暴的; [or]6j;
virgin: [a]/ˈvɜːrdʒɪn/; [n]处女;处男;贞女;  [adj]处女的; [or]6j;
virtual: [a]/ˈvɜːrtʃuəl/; [adj](计算机)虚拟的;十分接近的;实质上的; [or]6j;
virtue: [a]/ˈvɜːrtʃuː/; [n]正直,善良;美德,德行;好处,优点; [or]6j;
virus: [a]/ˈvaɪrəs/; [n]病毒;(计算机) 病毒;病毒性疾病; [or]6j;
visa: [a]/ˈviːzə/; [n]签证; [or]6j;
viscous: [a]/ˈvɪskəs/; [adj]黏的;黏稠的;黏滞的;有黏性的; [or]6j;
vision: [a]/ˈvɪʒn/; [n]视力;视野;视觉;景象;想象;洞察;  [v]幻想,设想; [or]6j;
visualize: [a]/ˈvɪʒuəlaɪz/; [v]使形象化;想象; [or]6j;
vital: [a]/ˈvaɪtl/; [adj]生命所必需的;必不可少的;至关重要的;有活力的;生命攸关的;  [n]要害;重要部分; [or]6j;
vivid: [a]/ˈvɪvɪd/; [adj](颜色)鲜艳的,强烈的(颜色,光);生动的,清晰的(记忆,描述); [or]6j;
vocal: [a]/ˈvoʊkl/; [n]声乐作品;  [adj]畅言无忌的;声音的; [or]6j;
vocation: [a]/voʊˈkeɪʃn/; [n]职业;行业;天职;使命; [or]6j;
vocational: [a]/voʊˈkeɪʃənl/; [adj]职业的;业务的; [or]6j;
volume: [a]/ˈvɑːljuːm/; [n]音量;数量;容量;册,卷; [or]6j;
voluntary: [a]/ˈvɑːlənteri/; [adj]自愿的;无偿的;志愿的;  [n]即兴曲; [or]6j;
volunteer: [a]/ˌvɑːlənˈtɪr/; [n]志愿者;志愿兵;志愿者,义务工作者;  [v]自愿做;自愿加入;主动要求;主动提供 (信息); [or]6j;
vow: [a]/vaʊ/; [n]誓约;  [v]宣誓;立誓;发誓; [or]6j;
vowel: [a]/ˈvaʊəl/; [n]元音;元音字母; [or]6j;
vulgar: [a]/ˈvʌlɡər/; [adj]粗俗的;下流的;平民的;通俗的;  [n]平民;方言; [or]6j;
vulnerable: [a]/ˈvʌlnərəbl/; [adj]易受伤的;脆弱的;易受攻击的; [or]6j;
wade: [a]/weɪd/; [v]涉水而行,淌水;跋涉; [or]6j;
wag: [a]/wæɡ/; [n]摇摆;爱说笑的人;  [v]摇动; [or]6j;
waitress: [a]/ˈweɪtrəs/; [n]女侍者;女服务员; [or]6j;
wallet: [a]/ˈwɑːlɪt/; [n]皮夹,钱包; [or]6j;
walnut: [a]/ˈwɔːlnʌt/; [n]核桃,胡桃;核桃树;胡桃木; [or]6j;
ward: [a]/wɔːrd/; [n]病房;行政区;受监护人;  [v]守护,躲开; [or]6j;
wardrobe: [a]/ˈwɔːrdroʊb/; [n]衣橱;全部服装;剧服; [or]6j;
ware: [a]/wer/; [n]货物;制品;陶器; [or]6j;
warehouse: [a]/ˈwerhaʊs/; [n]仓库; [or]6j;
warfare: [a]/ˈwɔːrfer/; [n]战争;斗争,冲突; [or]6j;
warning: [a]/ˈwɔːrnɪŋ/; [n]警告;预告;通知;预兆;  [adj]警告的;告诫的;引以为戒的;  [v]warn的现在进行时; [or]6j;
warrant: [a]/ˈwɔːrənt/; [n]逮捕证;正当理由;凭证;  [v]使正当; [or]6j;
wasp: [a]/wɑːsp/; [n]黄蜂; [or]6j;
watchful: [a]/ˈwɑːtʃfl/; [adj]注意的,警惕的; [or]6j;
watertight: [a]/ˈwɔːtərtaɪt/; [adj]不透水的;无懈可击的; [or]6j;
watery: [a]/ˈwɔːtəri/; [adj]水的;水分多的;水淋淋的,平淡的,稀薄的,松软的,有雨意的;微弱的,淡薄的; [or]6j;
watt: [a]/wɑːt/; [n]瓦,瓦特; [or]6j;
waver: [a]/ˈweɪvər/; [vi]犹豫;摇摆;颤抖; [or]6j;
wax: [a]/wæks/; [n]蜡;蜡状物;  [v]给.上蜡;给.打蜡,给.上蜡;渐渐变大;变为;(月亮)渐圆,渐盈;  [adj]蜡制的; [or]6j;
waxy: [a]/ˈwæksi/; [adj]蜡制的;蜡质的;似蜡的; [or]6j;
wealth: [a]/welθ/; [n]财富;财产;大量; [or]6j;
wealthy: [a]/ˈwelθi/; [n]富人;  [adj]富有的;充分的; [or]6j;
weapon: [a]/ˈwepən/; [n]武器;手段;  [v]武装,提供武器; [or]6j;
weary: [a]/ˈwɪri/; [adj]疲倦的,困乏的,令人厌倦的;  [v]使疲倦;使厌倦; [or]6j;
weaver: [a]/ˈwiːvər/; [n]织布者,织工; [or]6j;
web: [a]/web/; [n]网;蜘蛛网; [or]6j;
wedge: [a]/wedʒ/; [v]楔入;  [n]楔子; [or]6j;
weird: [a]/wɪrd/; [adj]古怪的;荒唐的; [or]6j;
wharf: [a]/wɔːrf/; [n]码头; [or]6j;
whirl: [a]/wɜːrl/; [v]回旋;使旋转;  [n]回旋;一个接一个的活动; [or]6j;
whisker: [a]/ˈwɪskər/; [n]胡须;腮须; [or]6j;
whitewash: [a]/ˈwaɪtwɑːʃ/; [v]用石灰水把..刷白;  [n]石灰水,白色涂料,白粉胶泥水,涂脂抹粉; [or]6j;
wholesaler: [a]/ˈhoʊlseɪlər/; [n]批发商; [or]6j;
wholesome: [a]/ˈhoʊlsəm/; [adj]有益于健康的;有益的; [or]6j;
wield: [a]/wiːld/; [v]运用,行使;挥;  [vt]使用; [or]6j;
willingness: [a]/ˈwɪlɪŋnəs/; [n]自愿; [or]6j;
willow: [a]/ˈwɪloʊ/; [n]柳树;  [v]用打棉机打开和清理;  [adj]柳木制的; [or]6j;
winding: [a]/ˈwaɪndɪŋ/; [adj]蜿蜒的,弯曲的; [or]6j;
windmill: [a]/ˈwɪndmɪl/; [n]风车;风车房; [or]6j;
wink: [a]/wɪŋk/; [vi]闪烁;眨眼示意;  [n]眨眼; [or]6j;
withdraw: [a]/wɪðˈdrɔː/; [v]取款;撤退,收回,撤离; [or]6j;
wither: [a]/ˈwɪðər/; [v]枯萎;凋谢;  [vt]使枯萎,使凋谢,萎缩;使人感觉羞惭或迷惑; [or]6j;
withhold: [a]/wɪðˈhoʊld/; [v]抑制,拒绝给某事物; [or]6j;
witness: [a]/ˈwɪtnəs/; [n]目击者,证人;  [v]目击,亲眼看见;为..作证; [or]6j;
woe: [a]/woʊ/; [n]悲哀;痛苦;  [int]唉(表示痛苦,悲伤或悔恨);咳; [or]6j;
woodpecker: [a]/ˈwʊdpekər/; [n]啄木鸟; [or]6j;
worthwhile: [a]/ˌwɜːrθˈwaɪl/; [adj]值得(花时间,精力)的,有意义的; [or]6j;
worthy: [a]/ˈwɜːrði/; [adj](of)值得..的,配得上..的,可尊敬的,有价值的;  [n]知名人士;杰出人物; [or]6j;
wrath: [a]/ræθ/; [n]愤怒; [or]6j;
wreck: [a]/rek/; [n]沉船,失事船;失事;(事故中)遭严重损坏的汽车(飞机等);  [v]破坏,使毁灭; [or]6j;
wrench: [a]/rentʃ/; [n]扳手;痛苦,难受;猛扭,猛拉;  [v]猛拧;挣脱;使扭伤; [or]6j;
wrestle: [a]/ˈresl/; [v]摔跤,角斗;斗争,努力;  [n]摔跤,角力,扭斗; [or]6j;
wretched: [a]/ˈretʃɪd/; [adj]可怜的;恶劣的;身心疲惫的; [or]6j;
wring: [a]/rɪŋ/; [v]扭,榨取,强求;绞,拧,扭(尤指脖子);  [n]扭,榨取,强求;折磨; [or]6j;
wrinkle: [a]/ˈrɪŋkl/; [n]皱纹,褶皱;窍门;转折,改变;  [v](使)起褶皱; [or]6j;
xerox: [a]/ˈzɪrɑːks/; [v]复印; [or]6j;
yacht: [a]/jɑːt/; [n]游艇;帆船; [or]6j;
yearn: [a]/jɜːrn/; [v]渴望,向往; [or]6j;
yell: [a]/jel/; [v]叫喊;  [n]叫喊;呐喊,欢呼; [or]6j;
yield: [a]/jiːld/; [v]出产;屈服;弯曲;让行;  [n]收益; [or]6j;
yoke: [a]/joʊk/; [n]牛轭;枷锁;纽带;  [v]结合;连结; [or]6j;
yolk: [a]/joʊk/; [n]蛋黄; [or]6j;
youngster: [a]/ˈjʌŋstər/; [n]年轻人,少年; [or]6j;
