Armada: [-]/ɑːrˈmɑːdə/; [n](西班牙的)无敌舰队; [^]z8;
August: [-]/ˈɔːɡəst/; [n]八月; [^]z8;
Baroque: [-]/bəˈroʊk/; [a]巴洛克式的,结构复杂的,形式怪样的; [n]巴洛克风格,巴洛克艺术; [^]z8;
Canon: [-]/ˈkænən/; [n]标准,教规,正典圣经,教士; [^]z8;
Halloween: [-]/ˌhæloʊˈiːn/; [n]万圣节前夕(指十月三十一日夜晚); [^]z8;
Hispanic: [-]/hɪˈspænɪk/; [a]拉丁美洲的;西班牙人的;西班牙的; [n]讲西班牙语的人;拉美裔美国人; [^]z8;
Quaker: [-]/ˈkweɪkər/; [n]夸克党,教友派信徒; [^]z8;
RAM: [-]/ræm/; [n]公羊,撞锤,<计>随机存取内存; [v]猛击,撞; [^]z8;
Sabbath: [-]/ˈsæbəθ/; [n]安息日; [^]z8;
Satanic: [-]/səˈtænɪk/; [a]邪恶的,魔鬼的; [^]z8;
Titanic: [-]/taɪˈtænɪk/; [a]巨人的,力大无比的; [n]泰坦尼克号; [^]z8;
Utopia: [-]/juːˈtoʊpiə/; [n]乌托邦(理想中最美好的社会),理想国; [^]z8;
Yank: [-]/jæŋk/; [n]美国人(等于Yankee); [^]z8;
abacus: [-]/ˈæbəkəs/; [n]算盘; [^]z8;
abase: [-]/əˈbeɪs/; [v]贬抑;使卑下;降低.的地位; [n]贬低;屈辱;贬低别人的人; [^]z8;
abbreviate: [-]/əˈbriːvieɪt/; [v]缩写,使省略,使用缩写词; [n]使用缩写词的人;缩短,缩写(词,短语,名字,名称); [^]z8;
abbreviation: [-]/əˌbriːviˈeɪʃn/; [n]缩短;缩写词;省略号; [^]z8;
abdicate: [-]/ˈæbdɪkeɪt/; [a]放弃权力的;退位的; [n]放弃权力者;退位者; [vi]退位,辞职; [vt]辞;放弃; [^]z8;
abdominal: [-]/æbˈdɑːmɪnl/; [a]腹部的,有腹鳍的; [^]z8;
abduct: [-]/æbˈdʌkt/; [v]绑架,拐走; [^]z8;
aberrant: [-]/æˈberənt/; [n]离开正路的人,反常的人; [a]偏离正轨的;异常的,畸变的; [^]z8;
abhor: [-]/əbˈhɔːr/; [v]痛恨;憎恶; [^]z8;
abide: [-]/əˈbaɪd/; [v]遵守;忍受;居住; [^]z8;
abiding: [-]/əˈbaɪdɪŋ/; [a]持久的;永久的,不变的; [^]z8;
abject: [-]/ˈæbdʒekt/; [a]糟糕透顶的;可怜的,不幸的; [^]z8;
ablaze: [-]/əˈbleɪz/; [a]着火的,燃烧的;激昂的;光彩夺目的; [^]z8;
abode: [-]/əˈboʊd/; [n]住处,住所; [vt]<古>预兆,预示; [^]z8;
abominable: [-]/əˈbɑːmɪnəbl/; [a]讨厌的,令人憎恶的,糟透的; [n]讨厌,可恶; [ad]恶劣地,令人厌恶地; [^]z8;
abort: [-]/əˈbɔːrt/; [v]异常中断,中途失败,流产,发育不全; [^]z8;
abrasive: [-]/əˈbreɪsɪv/; [a]粗糙的;有研磨作用的;伤人感情的; [n]研磨料; [^]z8;
abreast: [-]/əˈbrest/; [ad]并肩地,并列; [a]并排的;并肩的; [^]z8;
absentee: [-]/ˌæbsənˈtiː/; [n]缺席者; [a]缺席者的;在外地主的,在外业主的; [^]z8;
abstain: [-]/əbˈsteɪn/; [v]戒掉(烟\酒等);避开;弃权; [^]z8;
abstention: [-]/əbˈstenʃn/; [n]戒除,回避;弃权;弃权者; [^]z8;
abstinence: [-]/ˈæbstɪnəns/; [n]节制,禁欲; [^]z8;
abusive: [-]/əˈbjuːsɪv/; [a]辱骂的;滥用的;虐待的; [^]z8;
abyss: [-]/əˈbɪs/; [n]深渊;深不可测的事物,绝境;深海;深邃;炼狱; [^]z8;
academician: [-]/ˌækədəˈmɪʃn/; [n]院士;大学生;学会会员; [^]z8;
accede: [-]/əkˈsiːd/; [v]同意,就任,加入; [^]z8;
accentuate: [-]/əkˈsentʃueɪt/; [v]强调;重读; [^]z8;
accessible: [-]/əkˈsesəbl/; [a]可使用的;可到达的;可进入的;易懂的; [^]z8;
accession: [-]/ækˈseʃn/; [n]加入(国际组织);登基,即位;增加物;增加;接近,到达;同意; [vt]登录,登入新增目录;获得; [^]z8;
acclaim: [-]/əˈkleɪm/; [n]欢呼,赞扬,称赞; [v]欢呼,喝彩,鼓掌欢迎; [vt]鼓掌欢迎,向.欢呼,为.喝彩;推选; [^]z8;
accompanist: [-]/əˈkʌmpənɪst/; [n]伴奏者,伴随者; [^]z8;
accomplice: [-]/əˈkɑːmplɪs/; [n]同谋者,帮凶; [^]z8;
accountable: [-]/əˈkaʊntəbl/; [a]应负责的,应作解释的;可解释的; [^]z8;
accountancy: [-]/əˈkaʊntənsi/; [n]会计工作,会计学,会计职业; [^]z8;
accredit: [-]/əˈkredɪt/; [v]授权;信任;委派;归因于; [^]z8;
accrue: [-]/əˈkruː/; [v](利息等)增大,增多; [^]z8;
acoustics: [-]/əˈkuːstɪks/; [n]声学; [^]z8;
acquiesce: [-]/ˌækwiˈes/; [v]默许;勉强同意; [a]默认的; [^]z8;
acquittal: [-]/əˈkwɪtl/; [n]宣告无罪,开释; [^]z8;
acrimony: [-]/ˈækrɪmoʊni/; [n]尖刻,刻薄; [^]z8;
actuality: [-]/ˌæktʃuˈæləti/; [n]现状,现实,事实; [^]z8;
acumen: [-]/ˈækjəmən/; [n]聪明,敏锐; [^]z8;
adamant: [-]/ˈædəmənt/; [a]强硬的,固执的; [n]坚硬的东西;坚石; [^]z8;
addictive: [-]/əˈdɪktɪv/; [a]使人上瘾的; [^]z8;
additive: [-]/ˈædətɪv/; [n]添加剂,添加物; [a]附加的;<数>加法的; [^]z8;
adept: [-]/əˈdept/; [n]专家,能手; [a]熟练的;巧妙的; [^]z8;
adhesive: [-]/ədˈhiːsɪv/; [n]粘合剂,胶水; [a]带粘性的;粘着的;难忘的; [^]z8;
adjoin: [-]/əˈdʒɔɪn/; [v]与.毗连;贴近; [^]z8;
adjourn: [-]/əˈdʒɜːrn/; [v]延期,休会,推迟对.采取行动; [vi]休会; [^]z8;
adjudicate: [-]/əˈdʒuːdɪkeɪt/; [v]充当裁判,判决; [n]判决,宣判;裁判员; [^]z8;
adjunct: [-]/ˈædʒʌŋkt/; [n]附属物,配件,添加剂;助手,部下; [a]附加的,辅助的,下级的; [^]z8;
admonish: [-]/ədˈmɑːnɪʃ/; [v]训诫,警告; [^]z8;
adorn: [-]/əˈdɔːrn/; [v]装饰; [^]z8;
adrift: [-]/əˈdrɪft/; [a]漂泊的,漂浮着的; [ad]随波逐流地;漂流无定;<比喻>无定职;<口>孤陋寡闻; [^]z8;
adroit: [-]/əˈdrɔɪt/; [a]熟练的,灵巧的; [^]z8;
adulterate: [-]/əˈdʌltəreɪt/; [v]掺假; [a]通奸的;搀杂的; [n]掺假; [^]z8;
advent: [-]/ˈædvent/; [n]来临;到来;出现; [^]z8;
adversary: [-]/ˈædvərseri/; [n]对手,敌手; [^]z8;
adverse: [-]/ˈædvɜːrs/; [a]不利的;(方向上)逆的;在相反的方向上移动(或运转);相反的; [^]z8;
adversity: [-]/ədˈvɜːrsəti/; [n]逆境,不幸,灾难; [^]z8;
advocacy: [-]/ˈædvəkəsi/; [n]主张;拥护;辩护; [^]z8;
aerodynamics: [-]/ˌeroʊdaɪˈnæmɪks/; [n]<流>气体力学;空气动力学; [a]空气动力(学)的; [^]z8;
aerosol: [-]/ˈerəsɔːl/; [n]烟雾,［化］气溶,烟雾剂; [a]喷雾的,喷雾器的; [^]z8;
affable: [-]/ˈæfəbl/; [a]易于交谈的,和蔼的; [^]z8;
affinity: [-]/əˈfɪnəti/; [n]姻亲关系;密切关系;近似,类似关系;亲近; [^]z8;
afflict: [-]/əˈflɪkt/; [v]使痛苦;使苦恼; [^]z8;
affront: [-]/əˈfrʌnt/; [v]冒犯,有意冒犯,公开侮辱;面对; [n]轻蔑;公开侮辱; [^]z8;
afield: [-]/əˈfiːld/; [ad]在战场上,去野外,在远处,远离着; [^]z8;
afloat: [-]/əˈfloʊt/; [a]在海上的;飘浮的;浸满水的;在传播的; [ad]在海上;飘浮著;浸满水; [^]z8;
aggravate: [-]/ˈæɡrəveɪt/; [v]使恶化,加重;使气恼,激怒; [^]z8;
aggregate: [-]/ˈæɡrɪɡət/; [n]合计;总数;混凝料;总计; [v]集合;聚集;合计; [a]总的,总数的;集合的; [^]z8;
aggrieved: [-]/əˈɡriːvd/; [a]忿忿不平的,痛心的;权利受到不法侵害的; [^]z8;
agile: [-]/ˈædʒl/; [a]灵活的,敏捷的; [^]z8;
agitate: [-]/ˈædʒɪteɪt/; [v](尤指为法律,社会状况的改变而)激烈争论,鼓动,煽动;搅动(液体);激怒; [^]z8;
agitation: [-]/ˌædʒɪˈteɪʃn/; [n]摇动;焦虑,忧虑;煽动; [^]z8;
agnostic: [-]/æɡˈnɑːstɪk/; [a]不可知论的; [n]不可知论者; [^]z8;
ailing: [-]/ˈeɪlɪŋ/; [a]生病的,身体不舒服的;体衰的; [^]z8;
ailment: [-]/ˈeɪlmənt/; [n]疾病(尤指微恙),不宁,不安; [^]z8;
airborne: [-]/ˈerbɔːrn/; [a]空运的;在空中的; [^]z8;
airy: [-]/ˈeri/; [a]空气的;通风的;幻想的;轻快的;空中的; [^]z8;
ajar: [-]/əˈdʒɑːr/; [a]半开的;微开的; [^]z8;
alchemy: [-]/ˈælkəmi/; [n]炼金术;魔力; [^]z8;
alcoholism: [-]/ˈælkəhɔːlɪzəm/; [n]酒精中毒; [^]z8;
alias: [-]/ˈeɪliəs/; [n]别名,化名; [ad]别名为,化名为; [^]z8;
alight: [-]/əˈlaɪt/; [vi]下来;飞落; [a]烧着的;点亮着的; [^]z8;
align: [-]/əˈlaɪn/; [vi]排队,排成一行; [vt]使成一直线; [^]z8;
alimony: [-]/ˈælɪmoʊni/; [n](法)赡养费,生活费; [^]z8;
allay: [-]/əˈleɪ/; [v]减轻;使缓和;使平静; [^]z8;
allegiance: [-]/əˈliːdʒəns/; [n]忠诚,拥护; [^]z8;
allegory: [-]/ˈæləɡɔːri/; [n]讽喻;寓意;寓言; [^]z8;
allergic: [-]/əˈlɜːrdʒɪk/; [a]过敏的,对.讨厌的; [^]z8;
allergy: [-]/ˈælərdʒi/; [n]过敏症,厌恶; [^]z8;
alleviate: [-]/əˈliːvieɪt/; [v]减轻;缓解;缓和; [^]z8;
allude: [-]/əˈluːd/; [v]间接提到,暗指,暗示; [^]z8;
allure: [-]/əˈlʊr/; [v]吸引;诱使; [n]诱惑力; [^]z8;
allusion: [-]/əˈluːʒn/; [n]暗示;提及; [^]z8;
amalgamate: [-]/əˈmælɡəmeɪt/; [v]合并,混合; [^]z8;
amass: [-]/əˈmæs/; [vi]聚集; [vt]收集;积累,积聚; [^]z8;
ambivalent: [-]/æmˈbɪvələnt/; [a]矛盾的;摇摆不定的;好恶相克的; [n]两性人; [^]z8;
ambush: [-]/ˈæmbʊʃ/; [n]埋伏,伏击;伏兵; [v]埋伏,伏击; [^]z8;
amenity: [-]/əˈmenəti/; [n]适意;舒适;便利设施;舒适,愉快;礼仪; [^]z8;
amiable: [-]/ˈeɪmiəbl/; [a]和蔼的,亲切的;温和的; [^]z8;
amicable: [-]/ˈæmɪkəbl/; [a]友善的,温和的,平心静气的; [^]z8;
amnesia: [-]/æmˈniːʒə/; [n]<医学>遗忘症; [^]z8;
amnesty: [-]/ˈæmnəsti/; [n]赦免; [v]对.实行大赦; [^]z8;
amoral: [-]/ˌeɪˈmɔːrəl/; [a]不知是非的; [^]z8;
amphibian: [-]/æmˈfɪbiən/; [n]两栖动物;水陆两用飞机和车辆; [a]两栖类的;<车辆>水陆两用的;具有双重性格的; [^]z8;
amphibious: [-]/æmˈfɪbiəs/; [a]两栖的; [^]z8;
anarchist: [-]/ˈænərkɪst/; [n]无政府主义者; [^]z8;
anarchy: [-]/ˈænərki/; [n]无政府状态,政治混乱; [^]z8;
anemia: [-]/ə'niːmiːə/; [n]贫血,贫血症; [^]z8;
anesthesia: [-]/ˌænəsˈθiʒə/; [n]麻醉;麻木(等于anaesthesia); [^]z8;
anesthetic: [-]/ˌænəs'θetɪk/; [n]麻醉剂,麻药; [a]麻醉的,感觉缺失的; [^]z8;
anew: [-]/əˈnuː/; [ad]重新,再; [^]z8;
anguish: [-]/ˈæŋɡwɪʃ/; [n]痛苦;苦恼; [v]感到极度痛苦; [^]z8;
animate: [-]/ˈænɪmeɪt/; [v]使有生气,使活泼;鼓舞,推动; [a]有生命的; [^]z8;
animation: [-]/ˌænɪˈmeɪʃn/; [n]活泼,有生气,动画片,动画片制作; [^]z8;
animosity: [-]/ˌænɪˈmɑːsəti/; [n]憎恶,仇恨; [^]z8;
annihilate: [-]/əˈnaɪəleɪt/; [v]消灭; [^]z8;
annuity: [-]/əˈnuːəti/; [n]年金,养老金;年金保险;年金享受权; [^]z8;
anomaly: [-]/əˈnɑːməli/; [n]异常,不规则,反常事物; [^]z8;
anonymity: [-]/ˌænəˈnɪməti/; [n]匿名,作者不明(或不详),无名之辈; [^]z8;
antagonize: [-]/ænˈtæɡənaɪz/; [v]使.敌对,使.对抗,引起反抗; [^]z8;
anthology: [-]/ænˈθɑːlədʒi/; [n](诗,文,曲,画等的)选集; [^]z8;
anthropology: [-]/ˌænθrəˈpɑːlədʒi/; [n]人类学; [^]z8;
antibody: [-]/ˈæntibɑːdi/; [n]<免疫>抗体; [^]z8;
antidote: [-]/ˈæntidoʊt/; [n]<药>解毒剂,解药;矫正方法; [^]z8;
antipathy: [-]/ænˈtɪpəθi/; [n]反感,厌恶,憎恶; [^]z8;
antiseptic: [-]/ˌæntiˈseptɪk/; [n]杀菌剂; [a]防腐的,抗菌的; [^]z8;
antler: [-]/ˈæntlər/; [n]鹿角,茸角; [^]z8;
apathy: [-]/ˈæpəθi/; [n]冷漠,无兴趣;漠不关心,无感情; [^]z8;
apex: [-]/ˈeɪpeks/; [n]顶点;尖端; [^]z8;
apiece: [-]/əˈpiːs/; [ad]每人;每个;各自地; [^]z8;
apparel: [-]/əˈpærəl/; [n]服装,衣服; [vt]给.穿衣服(尤指华丽或特殊的服装); [^]z8;
appease: [-]/əˈpiːz/; [v]抚慰;平息; [^]z8;
appendix: [-]/əˈpendɪks/; [n]附录;阑尾;附属物; [^]z8;
appraise: [-]/əˈpreɪz/; [v]评价,鉴定;估价; [^]z8;
apprehend: [-]/ˌæprɪˈhend/; [vt]理解,领会;逮捕;对.忧虑;把.视作; [vi]忧虑; [^]z8;
apprehension: [-]/ˌæprɪˈhenʃn/; [n]忧虑,担心,疑惧;逮捕;理解; [^]z8;
aquarium: [-]/əˈkweriəm/; [n]水族馆,水族箱,鱼缸; [^]z8;
arbitrate: [-]/ˈɑːrbɪtreɪt/; [v]仲裁,公断; [^]z8;
arcade: [-]/ɑːrˈkeɪd/; [n]拱廊;有拱廊的街道;游乐场所,游戏厅; [^]z8;
archaic: [-]/ɑːrˈkeɪɪk/; [a]古代的;陈旧的,过时的,老式的;已不通用的; [^]z8;
archer: [-]/ˈɑːrtʃər/; [n]弓箭手; [^]z8;
archetype: [-]/ˈɑːrkitaɪp/; [n]原型,典型; [^]z8;
archipelago: [-]/ˌɑːrkɪˈpeləɡoʊ/; [n]群岛; [^]z8;
archive: [-]/ˈɑːrkaɪv/; [n]档案室,档案; [vt]把.收集归档; [^]z8;
ardent: [-]/ˈɑːrdnt/; [a]热心的,热烈的; [^]z8;
ardor: [-]/'ɑːdə/; [n]热情,狂热; [^]z8;
arduous: [-]/ˈɑːrdʒuəs/; [a]艰巨的;努力的;陡峭的; [^]z8;
aroma: [-]/əˈroʊmə/; [n]芳香,香气; [^]z8;
aromatic: [-]/ˌærəˈmætɪk/; [a]芳香的; [n]芳香植物;芳香族化合物; [^]z8;
arrears: [-]/əˈrɪrz/; [n]债,欠债; [^]z8;
arsenal: [-]/ˈɑːrsənl/; [n]兵工厂,军械库;储藏; [^]z8;
arson: [-]/ˈɑːrsn/; [n]<法律>纵火,纵火罪; [^]z8;
artful: [-]/ˈɑːrtfl/; [a]巧妙的,有技巧的,狡猾的,欺诈的; [^]z8;
arthritis: [-]/ɑːrˈθraɪtɪs/; [n]<外科>关节炎; [^]z8;
articulate: [-]/ɑːrˈtɪkjuleɪt/; [a]善于表达的;发音清晰的; [v]清晰地发音;清楚地讲话;连接,接合;与.合成整体 ,使相互连贯; [^]z8;
artifact: [-]/ˈɑːrtɪfækt/; [n]人工制品;手工艺品; [^]z8;
artifice: [-]/ˈɑːrtɪfɪs/; [n]诡计;欺骗;巧妙的办法; [^]z8;
artisan: [-]/ˈɑːrtəzn/; [n]工匠,手艺人; [^]z8;
ascendant: [-]/əˈsendənt/; [n]优势,支配地位; [a]上升的,优越的; [^]z8;
ascertain: [-]/ˌæsərˈteɪn/; [v]探知,弄清,查明(真相等); [^]z8;
ascetic: [-]/əˈsetɪk/; [a]禁欲的;苦行的; [n]禁欲者;苦行者; [^]z8;
ascribe: [-]/əˈskraɪb/; [v]把.归因于;把.归属于; [^]z8;
aspiration: [-]/ˌæspəˈreɪʃn/; [n]抱负,志向;发 h 音; [^]z8;
aspire: [-]/əˈspaɪər/; [vi]渴望,有志于(与to,for,after连用或后接不定式); [^]z8;
assail: [-]/əˈseɪl/; [v]攻击;质问;着手解决; [^]z8;
assent: [-]/əˈsent/; [v]同意,赞成; [n]同意;赞成; [^]z8;
assertive: [-]/əˈsɜːrtɪv/; [a]肯定的;决断的;坚定而自信的;独断的; [^]z8;
assiduous: [-]/əˈsɪdʒuəs/; [a]勤勉的,刻苦的; [^]z8;
assimilate: [-]/əˈsɪməleɪt/; [v]使同化;吸收;消化; [^]z8;
assorted: [-]/əˈsɔːrtəd/; [a]各式各样的; [^]z8;
assortment: [-]/əˈsɔːrtmənt/; [n]分类;混合物; [^]z8;
asthma: [-]/ˈæzmə/; [n]哮喘症; [^]z8;
astrology: [-]/əˈstrɑːlədʒi/; [n]占星学,占星术,星座; [^]z8;
asylum: [-]/əˈsaɪləm/; [n]精神病院,疯人院;避难所; [^]z8;
asymmetric: [-]/ˌeɪsɪˈmetrɪk/; [a]不对称的,不匀称的; [^]z8;
atrocious: [-]/əˈtroʊʃəs/; [a]糟透的,残暴的,骇人听闻的; [^]z8;
atrocity: [-]/əˈtrɑːsəti/; [n]残暴,暴行; [^]z8;
attest: [-]/əˈtest/; [vt]证明;证实;为.作证; [vi]证明;作证; [^]z8;
audacious: [-]/ɔːˈdeɪʃəs/; [a]大胆的,鲁莽的,大胆创新的; [^]z8;
audible: [-]/ˈɔːdəbl/; [a]听得见的; [^]z8;
audition: [-]/ɔːˈdɪʃn/; [n]听力,听觉;试听;试镜; [vi]试唱; [vt]对.进行面试;让.试唱; [^]z8;
augment: [-]/ɔːɡˈment/; [v]增加;助长; [^]z8;
aura: [-]/ˈɔːrə/; [n](人或物发出的)气味,气氛,先兆; [^]z8;
auspicious: [-]/ɔːˈspɪʃəs/; [a]吉兆的,幸运的; [^]z8;
austere: [-]/ɔːˈstɪr/; [a]严峻的;简朴的;苦行的;无装饰的; [^]z8;
authoritarian: [-]/əˌθɔːrəˈteriən/; [a]独裁主义的,权力主义的; [n]权力主义者,独裁主义者; [^]z8;
autocrat: [-]/ˈɔːtəkræt/; [n]独裁者; [^]z8;
autocratic: [-]/ˌɔːtəˈkrætɪk/; [a]独裁的,专断的; [^]z8;
autograph: [-]/ˈɔːtəɡræf/; [n]亲笔签名; [v]署名; [a]亲笔的; [^]z8;
automate: [-]/ˈɔːtəmeɪt/; [v]使自动化,自动操作; [^]z8;
autopsy: [-]/ˈɔːtɑːpsi/; [n]验尸;<病理><特医>剖检; [^]z8;
avalanche: [-]/ˈævəlæntʃ/; [n]雪崩;大量拥至; [vi]崩塌; [^]z8;
aversion: [-]/əˈvɜːrʒn/; [n]厌恶;讨厌的人,(或东西); [^]z8;
avid: [-]/ˈævɪd/; [a]渴望的,贪婪的;热心的; [^]z8;
awesome: [-]/ˈɔːsəm/; [a]〔俚语〕极好的,棒极了的;引起敬畏的,可怕的; [^]z8;
babble: [-]/ˈbæbl/; [v]呀呀学语,喋喋不休,作潺潺声;泄露(秘密); [n]儿语,胡言乱语,潺潺声; [^]z8;
backbreaking: [-]/'bækˌbreɪkɪŋ/; [a]非常辛劳的,费力的; [^]z8;
backdrop: [-]/ˈbækdrɑːp/; [n]背景幕;(事件的)背景; [^]z8;
backfire: [-]/ˌbækˈfaɪər/; [v]放出逆火,产生出乎意料及事与愿违的结果; [n]逆火;后爆的巨大响声; [^]z8;
badger: [-]/ˈbædʒər/; [n]獾;獾皮毛; [v]纠缠;烦扰(反复提提出问题或要求); [^]z8;
baffle: [-]/ˈbæfl/; [v]使困惑;难住;阻碍; [n]挡板; [^]z8;
baleful: [-]/ˈbeɪlfl/; [a]邪恶的,恶意的; [ad]凶恶地,有害地; [^]z8;
balk: [-]/bɔːk/; [v]畏缩;阻止;停止; [n]障碍;错误; [^]z8;
ballad: [-]/ˈbæləd/; [n]歌谣;小曲; [^]z8;
ballast: [-]/ˈbæləst/; [n](船等)压舱物;稳定因素;<比喻>沉着; [vt]给某物装上压舱物;给.铺道渣;使稳定;使沉着; [^]z8;
balm: [-]/bɑːm/; [n]香油,止痛膏,安慰物,香气; [^]z8;
balmy: [-]/ˈbɑːmi/; [a](气候)温和的; [^]z8;
banal: [-]/bəˈnɑːl/; [a]陈腐的;平庸的;老一套的; [^]z8;
bane: [-]/beɪn/; [n]祸根; [^]z8;
banish: [-]/ˈbænɪʃ/; [v]放逐;摒弃; [^]z8;
banister: [-]/ˈbænɪstər/; [n]栏杆的支柱,楼梯的扶栏; [^]z8;
banjo: [-]/ˈbændʒoʊ/; [n]班卓琴;五弦琴; [^]z8;
banter: [-]/ˈbæntər/; [n]善意地取笑,逗弄; [v]善意的与人开玩笑; [^]z8;
barrage: [-]/bəˈrɑːʒ/; [n]大量;阻塞;齐射式攻击;<水利>拦河坝; [v]以密集火力阻击; [^]z8;
barricade: [-]/ˌbærɪˈkeɪd/; [n]路障;障碍物;栅栏; [v]设路障;挡住; [^]z8;
barrister: [-]/ˈbærɪstər/; [n]辩护律师,出庭律师; [^]z8;
barrow: [-]/ˈbæroʊ/; [n]搬运架,手推车,弃矿,古坟; [^]z8;
barter: [-]/ˈbɑːrtər/; [v]物物交换;以货易货; [n]物物交换;实物交易; [^]z8;
bash: [-]/bæʃ/; [v]猛击,痛击;怒殴; [n]猛烈的一击,痛击; [^]z8;
bashful: [-]/ˈbæʃfl/; [a]害羞的;羞怯的; [^]z8;
bask: [-]/bæsk/; [vi]晒太阳(享受温暖),感到温暖,愉快或舒适; [n]晒太阳,取暖;沉浸于; [^]z8;
bastion: [-]/ˈbæstiən/; [n]堡垒;棱堡; [^]z8;
baton: [-]/bəˈtɑːn/; [n]警棍,指挥棒,接力棒; [v]用短棒打; [^]z8;
battalion: [-]/bəˈtæliən/; [n]营,军营;军队,部队; [^]z8;
bawl: [-]/bɔːl/; [v]大叫,大喊,放声痛哭; [n]叫喊声,叫骂声,号哭; [^]z8;
bay: [-]/beɪ/; [n]海湾,港湾;困境; [vi](尤指猎犬等)吠,叫,咆哮;筑堤遏(水); [v]穷追,使陷入绝境;阻止(敌人)不使前进;向.吠叫; [a]赤褐色的,栗色的; [^]z8;
bazaar: [-]/bəˈzɑːr/; [n]集市,商店集中区; [^]z8;
bearing: [-]/ˈberɪŋ/; [n]方向;举止;轴承; [^]z8;
beastly: [-]/ˈbiːstli/; [a]兽性的,恶毒的,刻薄的;令人厌恶的,令人极其不快的; [^]z8;
bedding: [-]/ˈbedɪŋ/; [n]寝具,基床,草垫; [a]适于花坛种植的; [^]z8;
begrudge: [-]/bɪˈɡrʌdʒ/; [v]嫉妒,吝惜,舍不得给; [^]z8;
beguile: [-]/bɪˈɡaɪl/; [v]欺骗,迷住,吸引; [^]z8;
beige: [-]/beɪʒ/; [n]米黄色; [a]浅褐色的,米黄色的; [^]z8;
belie: [-]/bɪˈlaɪ/; [vt]与.不符;矛盾,误解; [^]z8;
bemoan: [-]/bɪˈmoʊn/; [v]哀悼;为..恸哭;哀叹,对..表示惋惜; [^]z8;
bemused: [-]/bɪˈmjuːzd/; [a]困惑的,发呆的; [^]z8;
benchmark: [-]/ˈbentʃmɑːrk/; [n]基准;标准检查程序; [v]用基准问题测试(计算机系统等); [^]z8;
benediction: [-]/ˌbenɪˈdɪkʃn/; [n]祝福,祈祷; [^]z8;
beneficiary: [-]/ˌbenɪˈfɪʃieri/; [n]<金融>受益人,受惠者;封臣; [a]拥有封地的;受圣俸的; [^]z8;
benevolent: [-]/bəˈnevələnt/; [a]慈爱的,仁慈的;乐善好施的;慈善的; [^]z8;
benign: [-]/bɪˈnaɪn/; [a]仁慈的;慈祥的;(病)良性的; [^]z8;
bequeath: [-]/bɪˈkwiːð/; [v]遗赠(留); [^]z8;
bequest: [-]/bɪˈkwest/; [n]遗产;遗赠物; [^]z8;
bereaved: [-]/bɪˈriːvd/; [a]丧失的;死了.的; [n]丧失亲人的人; [^]z8;
beset: [-]/bɪˈset/; [v]困扰;镶嵌;围绕; [^]z8;
bewitch: [-]/bɪˈwɪtʃ/; [v]施魔法于,蛊惑,使着迷; [^]z8;
bicker: [-]/ˈbɪkər/; [v]斗嘴,流动,闪动; [n]口角,流水声; [^]z8;
bigot: [-]/ˈbɪɡət/; [n](宗教,种族,政治等的)偏执者,盲信者; [^]z8;
bile: [-]/baɪl/; [n]胆汁;愤怒; [^]z8;
billiards: [-]/ˈbɪljərdz/; [n]台球;英式台球;弹子戏; [^]z8;
billow: [-]/ˈbɪloʊ/; [n]巨浪,波浪般滚滚向前的东西;滚滚烟尘; [v]翻腾; [^]z8;
binge: [-]/bɪndʒ/; [n]狂饮,无节制的行为; [v]狂饮作乐;大吃大喝; [^]z8;
bingo: [-]/ˈbɪŋɡoʊ/; [n]宾戈游戏; [^]z8;
bipartisan: [-]/ˌbaɪˈpɑːrtɪzn/; [a]由两党成员组成的;被两党支持的; [^]z8;
bisect: [-]/baɪˈsekt/; [n]对剖邮票; [vi]分开; [vt]把.分切为二,把.二等分;二等分; [^]z8;
bitch: [-]/bɪtʃ/; [n]母狗;泼妇; [vi]发牢骚; [a]不合标准的; [vt]轻率拙劣地把.弄糟; [^]z8;
bizarre: [-]/bɪˈzɑːr/; [a]稀奇古怪的; [^]z8;
blackmail: [-]/ˈblækmeɪl/; [n]敲诈,勒索;保护费; [vt]向.敲诈; [^]z8;
blackout: [-]/ˈblækaʊt/; [n]断电; [a]防空袭的; [^]z8;
blanch: [-]/blæntʃ/; [v]变白;漂白; [n]铅矿石; [a]漂白的;银白色的; [^]z8;
blare: [-]/bler/; [v]高声鸣叫,发嘟嘟声; [n]嘟嘟声,号声,巨响; [^]z8;
blatant: [-]/ˈbleɪtnt/; [a]喧哗的;露骨的;公然的;明目张胆的; [^]z8;
blemish: [-]/ˈblemɪʃ/; [v]损害,玷污; [n]瑕疵,缺点; [^]z8;
bliss: [-]/blɪs/; [n]福佑,天赐的福; [vt]使欣喜若狂,使狂喜; [vi]欣喜若狂,狂喜; [^]z8;
blizzard: [-]/ˈblɪzərd/; [n]暴风雪; [^]z8;
blob: [-]/blɑːb/; [n]一滴,一抹,难以名状的一团; [v]弄脏,把.做错,得零分; [^]z8;
blues: [-]/bluːz/; [n]忧郁布鲁斯歌曲;蓝色物;忧郁,悲伤; [^]z8;
blunder: [-]/ˈblʌndər/; [n]愚蠢之举;大错; [vi]犯大错; [v]失策;绊倒; [^]z8;
blur: [-]/blɜːr/; [n]污点,模糊; [v]使.模糊;弄脏;变模糊; [^]z8;
blurt: [-]/blɜːrt/; [v]突然说出,冲动地说; [^]z8;
bog: [-]/bɑːɡ/; [n]沼泽;泥塘; [v]陷于泥沼;动弹不得; [^]z8;
boggle: [-]/ˈbɑːɡl/; [v]畏缩不前;惊恐;使..困惑; [^]z8;
bogus: [-]/ˈboʊɡəs/; [a]假的,假装的; [n]伪币;冒牌货; [^]z8;
boisterous: [-]/ˈbɔɪstərəs/; [a]喧闹的,欢闹的; [^]z8;
bombard: [-]/bɑːmˈbɑːrd/; [v]不断攻击,炮击; [^]z8;
bonfire: [-]/ˈbɑːnfaɪər/; [n]篝火;营火; [^]z8;
bonnet: [-]/ˈbɑːnət/; [n]圆帽,扁平软帽; [vt]给.戴上; [^]z8;
boo: [-]/buː/; [n]嘘声; [v]嘘(以表示不满或嘲笑); [^]z8;
boon: [-]/buːn/; [n]恩惠,福利,利益; [a]愉快的; [^]z8;
boost: [-]/buːst/; [v]增加;偷盗; [n]提高;激励;后推;助推发动机; [^]z8;
booze: [-]/buːz/; [n]酒宴,酒; [v]暴饮; [^]z8;
bountiful: [-]/ˈbaʊntɪfl/; [a]充足的,慷慨的,丰裕的; [^]z8;
bounty: [-]/ˈbaʊnti/; [n]慷慨;赠物;奖金; [vt]发给.奖金; [^]z8;
bout: [-]/baʊt/; [n]一回合,较量,一阵; [^]z8;
boutique: [-]/buːˈtiːk/; [n]专卖流行衣服的小商店; [a](商店)精品的; [^]z8;
brace: [-]/breɪs/; [n]<医学>牙齿定位器; [v]支柱;支撑;加固;使绷紧; [^]z8;
braid: [-]/breɪd/; [n]辫子;编带; [vi]交叉往来,迂回前进; [vt]编织;把头发编成辫子; [^]z8;
brash: [-]/bræʃ/; [a]无礼的,傲慢的;仓促的,性急的; [n]骤雨;碎片;<医>胃灼热; [^]z8;
bravado: [-]/brəˈvɑːdoʊ/; [n]故作勇敢,逞能; [^]z8;
brevity: [-]/ˈbrevəti/; [n]简短,短小,精炼; [^]z8;
bridal: [-]/ˈbraɪdl/; [a]新娘的;婚礼的; [n]婚礼; [^]z8;
bridle: [-]/ˈbraɪdl/; [n]马笼头,缰绳; [v]上笼头;昂首(表傲慢,愤怒等);抑制,控制; [^]z8;
brittle: [-]/ˈbrɪtl/; [a]易碎的;脆弱的;靠不住的; [n]薄片脆糖; [^]z8;
broccoli: [-]/ˈbrɑːkəli/; [n]硬花球花椰菜;花茎甘蓝; [^]z8;
broke: [-]/broʊk/; [a]一文不名的,破产的; [vt]打破,弄破;(使)破,裂,碎;中断;违犯;背弃;把...换成零钱;找开; [vi]破晓;(风暴)开始; [^]z8;
broker: [-]/ˈbroʊkər/; [n]经纪人,掮客; [v]作为经纪人进行谈判,以中间人等身份安排; [^]z8;
brokerage: [-]/ˈbroʊkərɪdʒ/; [n]中间人业务,经济业;付给经纪人的经手费,佣金,回扣; [^]z8;
bronchitis: [-]/brɑːŋˈkaɪtɪs/; [n]<内科>支气管炎; [^]z8;
brunt: [-]/brʌnt/; [n]冲击,主要冲力; [^]z8;
brusque: [-]/brʌsk/; [a]唐突的,直率的,无礼的; [^]z8;
buddy: [-]/ˈbʌdi/; [n]密友,好朋友,伙伴;小男孩; [vi]交朋友,做好朋友; [^]z8;
budge: [-]/bʌdʒ/; [v]移动一点;妥协; [^]z8;
buff: [-]/bʌf/; [vt]擦亮,擦净; [n]浅黄,浅黄色,爱好者; [a]浅黄牛皮革制的,浅黄色的; [^]z8;
buffer: [-]/ˈbʌfər/; [n]缓冲,缓冲区; [v]缓冲; [^]z8;
buggy: [-]/ˈbʌɡi/; [n]轻型马车,婴儿车; [^]z8;
bulge: [-]/bʌldʒ/; [n]凸出部分; [v]凸出,膨胀; [^]z8;
bulk: [-]/bʌlk/; [n]大批;容量;体积;大块; [a]大量的;散装的; [v]膨胀;显得重要; [^]z8;
bulky: [-]/ˈbʌlki/; [a]体积大的,庞大的;笨重的; [^]z8;
bum: [-]/bʌm/; [n]流浪汉,乞讨者,游手好闲的人; [v]流浪,乞讨,过游民生活; [a]差劲的; [^]z8;
bumper: [-]/ˈbʌmpər/; [n]汽车前后的保险杆; [a]特大的;丰盛的; [vt]装满;为.祝酒; [vi]干杯; [^]z8;
bunk: [-]/bʌŋk/; [n](火车等)床铺,铺位,卧铺;骗人的话,废话; [v]睡(在床铺上),去睡; [^]z8;
buoyancy: [-]/ˈbɔɪənsi/; [n]浮力,浮性,浮动性; [^]z8;
burrow: [-]/ˈbɜːroʊ/; [n]洞穴,地道;藏身处,住处; [v]挖;钻进;搜寻; [vt]掩蔽; [^]z8;
bustle: [-]/ˈbʌsl/; [n]喧闹,熙攘;腰垫;奔走,奔忙; [v]喧闹;忙乱,奔忙; [^]z8;
buttock: [-]/ˈbʌtək/; [n]屁股的一半,屁股,船尾; [v]<跤>背摔; [^]z8;
bypass: [-]/ˈbaɪpæs/; [v]绕过;回避; [n]旁路;心脏分流手术; [^]z8;
cache: [-]/kæʃ/; [n]隐藏处所,隐藏的粮食或物资,贮藏物; [vt]贮藏; [vi]躲藏; [^]z8;
cajole: [-]/kəˈdʒoʊl/; [v]以甜言蜜语哄骗,勾引; [^]z8;
calamity: [-]/kəˈlæməti/; [n]大灾祸,不幸之事; [^]z8;
callous: [-]/ˈkæləs/; [a]无情的,铁石心肠的,硬结的; [vt](使)变硬,(使)起茧;(使)冷酷无情; [^]z8;
callow: [-]/ˈkæloʊ/; [a](鸟)未生羽毛的;年轻而无经验的; [^]z8;
cameo: [-]/ˈkæmioʊ/; [n]石雕,贝雕;浮雕玉石;文学小品; [^]z8;
camouflage: [-]/ˈkæməflɑːʒ/; [n]伪装;掩饰; [v]使改头换面,伪装,掩饰;欺瞒; [^]z8;
candid: [-]/ˈkændɪd/; [a]坦白的;无偏见的;公正的;率直的; [^]z8;
cannibal: [-]/ˈkænɪbl/; [n]食人者,食同类的动物; [a]食人者的;同类相食的;凶残的; [^]z8;
canny: [-]/ˈkæni/; [a]精明的,谨慎的,节约的; [ad]<苏格兰>仔细地; [^]z8;
canoe: [-]/kəˈnuː/; [n]独木舟,轻舟; [v]乘独木舟; [^]z8;
canopy: [-]/ˈkænəpi/; [n]华盖;天篷;顶篷;苍穹; [vt]用天篷遮盖;遮蔽; [^]z8;
canter: [-]/ˈkæntər/; [n]慢跑(多用于马); [^]z8;
canvass: [-]/ˈkænvəs/; [v]仔细检查或详尽地讨论;审查,游说; [n]讨论;细查;劝诱; [^]z8;
cape: [-]/keɪp/; [n]斗篷;披肩;岬,海岬,海角; [^]z8;
capillary: [-]/ˈkæpəleri/; [n]毛细血管; [a]毛细血管的;毛状的; [^]z8;
capitulate: [-]/kəˈpɪtʃuleɪt/; [vi]有条件投降,认输,屈服,让步,停止抵抗; [^]z8;
caprice: [-]/kəˈpriːs/; [n]任性,反复无常,随想曲; [^]z8;
capricious: [-]/kəˈprɪʃəs/; [a]变化无常的,任性的; [^]z8;
captivate: [-]/ˈkæptɪveɪt/; [v]吸引,迷惑; [^]z8;
captivity: [-]/kæpˈtɪvəti/; [n]囚禁;被关; [^]z8;
carat: [-]/ˈkærət/; [n]公制克拉;(金子)开; [^]z8;
carbohydrate: [-]/ˌkɑːrboʊˈhaɪdreɪt/; [n]<化>碳水化合物;淀粉质食物; [^]z8;
cardiac: [-]/ˈkɑːrdiæk/; [a]心脏的,心脏病的; [n]心脏病患者;强心剂;健胃剂; [^]z8;
caress: [-]/kəˈres/; [v]抚摸; [vt]拥抱; [n]爱抚;拥抱;亲吻; [^]z8;
caricature: [-]/ˈkærɪkətʃər/; [n]讽刺画,滑稽模仿;扭曲,夸张的描述; [^]z8;
carnage: [-]/ˈkɑːrnɪdʒ/; [n]大屠杀,残杀,大量绝灭; [^]z8;
carnal: [-]/ˈkɑːrnl/; [a]肉体的,肉欲的,性欲的,色欲的,淫荡的; [^]z8;
carnation: [-]/kɑːrˈneɪʃn/; [n]康乃馨,粉红色; [a]淡红色的;肉色的; [^]z8;
carnivore: [-]/ˈkɑːrnɪvɔːr/; [n]食肉动物,食虫植物; [^]z8;
carp: [-]/kɑːrp/; [n]鲤鱼; [v]吹毛求疵; [^]z8;
cartridge: [-]/ˈkɑːrtrɪdʒ/; [n]墨盒;弹药筒,弹药;墨水,笔芯; [^]z8;
cascade: [-]/kæˈskeɪd/; [n]层叠;小瀑布;喷流; [v]像瀑布般冲下或倾泻; [^]z8;
caste: [-]/kæst/; [n](印度社会中的)种姓;(具有严格等级差别的)社会地位;(排他的)社会团体; [^]z8;
catalyst: [-]/ˈkætəlɪst/; [n]催化剂;造成变化的人或事; [^]z8;
categorical: [-]/ˌkætəˈɡɔːrɪkl/; [a]绝对的;直接了当的;无条件的;属于某一范畴的; [^]z8;
cathode: [-]/ˈkæθoʊd/; [n](电)阴极,正极; [^]z8;
causal: [-]/ˈkɔːzl/; [a]因果关系的,有原因的; [n]表示原因的连词; [^]z8;
cavern: [-]/ˈkævərn/; [n]洞穴;凹处; [v]挖空;置.于洞穴中; [^]z8;
caviar: [-]/ˈkæviɑːr/; [n]鱼子酱; [^]z8;
cavity: [-]/ˈkævəti/; [n]洞;龋洞; [^]z8;
cedar: [-]/ˈsiːdər/; [n]雪松,香柏,西洋杉木; [^]z8;
cede: [-]/siːd/; [v]放弃;割让(领土); [^]z8;
celestial: [-]/səˈlestʃl/; [a]天体的,天上的; [n]天人,神仙;(指封建时代的)中国人,天朝之人; [^]z8;
censor: [-]/ˈsensər/; [n]检查员; [vt]审查,检查;修改; [^]z8;
censorious: [-]/senˈsɔːriəs/; [a]爱挑剔的,吹毛求疵的,严厉批评的; [^]z8;
censorship: [-]/ˈsensərʃɪp/; [n]审查制度;审查机构; [^]z8;
censure: [-]/ˈsenʃər/; [v]责难,责备; [n]责难,责备; [^]z8;
centenary: [-]/senˈtenəri/; [n]一百年; [a]一百年的; [^]z8;
centralize: [-]/ˈsentrəlaɪz/; [v]使集中;使成为.的中心;使集权; [^]z8;
cerebral: [-]/səˈriːbrəl/; [a]大脑的,深思的; [^]z8;
ceremonious: [-]/ˌserəˈmoʊniəs/; [a]隆重的;讲究仪式的;正式的; [^]z8;
certify: [-]/ˈsɜːrtɪfaɪ/; [v](发给证书)证明;证实; [^]z8;
certitude: [-]/ˈsɜːrtɪtuːd/; [n]确实;确信;必然性; [^]z8;
chant: [-]/tʃænt/; [v]吟唱;诵扬; [n]圣歌;赞美诗;旋律; [^]z8;
chaplain: [-]/ˈtʃæplɪn/; [n]牧师,专职教士; [^]z8;
charisma: [-]/kəˈrɪzmə/; [n]魅力; [^]z8;
charismatic: [-]/ˌkærɪzˈmætɪk/; [a]超凡魅力的;神赐能力的;有魅力的; [n]有特恩的基督徒; [^]z8;
chaste: [-]/tʃeɪst/; [a]贞洁的;纯洁的;朴素的; [^]z8;
chauvinism: [-]/ˈʃoʊvɪnɪzəm/; [n]沙文主义者,盲目爱国主义; [^]z8;
checkmate: [-]/ˌtʃekˈmeɪt/; [n](国际象棋)将死,输棋,败局,败北; [^]z8;
chic: [-]/ʃiːk/; [n]时髦,款式别致; [a]别致的;时髦的; [^]z8;
chime: [-]/tʃaɪm/; [n]一套钟,合奏钟声; [v]鸣响,敲出和谐的声音; [^]z8;
chimpanzee: [-]/ˌtʃɪmpænˈziː/; [n]<动物>黑猩猩; [^]z8;
chirp: [-]/tʃɜːrp/; [n]唧唧声;喳喳声; [v](鸟或虫)唧唧叫; [^]z8;
chisel: [-]/ˈtʃɪzl/; [v]刻,凿; [n]凿子; [^]z8;
chivalry: [-]/ˈʃɪvəlri/; [n]骑士精神,骑士气概;骑士制度; [^]z8;
cholesterol: [-]/kəˈlestərɔːl/; [n]胆固醇; [^]z8;
choppy: [-]/ˈtʃɑːpi/; [a]波涛汹涌的;不断改变方向的; [^]z8;
choreography: [-]/ˌkɔːriˈɑːɡrəfi/; [n]编舞艺术;舞蹈编排;舞蹈编排; [^]z8;
christen: [-]/ˈkrɪsn/; [v]为.命名,为.施洗礼; [n]<女名>女子名; [^]z8;
chromosome: [-]/ˈkroʊməsoʊm/; [n]染色体; [^]z8;
chronology: [-]/krəˈnɑːlədʒi/; [n]年代学;(事件等)按年月次序的排列;年表; [^]z8;
chubby: [-]/ˈtʃʌbi/; [a]圆脸的,胖乎乎的; [^]z8;
chuck: [-]/tʃʌk/; [v]轻轻地扔;抛;丢弃; [^]z8;
chum: [-]/tʃʌm/; [n]密友,鱼饵; [v]结为密友,用鱼饵引诱; [^]z8;
churlish: [-]/ˈtʃɜːrlɪʃ/; [a]脾气暴躁的;没有礼貌的; [^]z8;
churn: [-]/tʃɜːrn/; [n](炼制黄油用的)搅乳器; [v]用搅乳器搅拌; [^]z8;
cinder: [-]/ˈsɪndər/; [n]余烬,矿渣; [^]z8;
circumvent: [-]/ˌsɜːrkəmˈvent/; [v]用计避免,规避; [^]z8;
claimant: [-]/ˈkleɪmənt/; [n]原告,<贸易>索赔人,提出要求者; [^]z8;
clamber: [-]/ˈklæmbər/; [v]攀登,爬上; [n]攀登,攀爬; [^]z8;
clandestine: [-]/klænˈdestɪn/; [a]秘密的,私下的,暗中的; [^]z8;
clatter: [-]/ˈklætər/; [n]咔嗒;哗啦声;嘈杂的谈笑声; [v]发出哗啦声;喧闹的谈笑; [^]z8;
claustrophobia: [-]/ˌklɔːstrəˈfoʊbiə/; [n]幽闭恐怖症; [^]z8;
cleanse: [-]/klenz/; [v]净化; [^]z8;
cleavage: [-]/ˈkliːvɪdʒ/; [n]分裂;乳沟;裂缝; [^]z8;
cleave: [-]/kliːv/; [v]劈开,分裂; [^]z8;
cliche: [-]/klɪˈʃeɪ/; [n]陈腐思想,陈词滥调; [a]陈腐的; [^]z8;
clinch: [-]/klɪntʃ/; [n]扭抱;紧紧相拥; [v]达成,取得;解决; [^]z8;
clog: [-]/klɑːɡ/; [v]阻塞,阻碍; [n]障碍;木底鞋; [^]z8;
closure: [-]/ˈkloʊʒər/; [n]关闭,终止,结束; [^]z8;
clot: [-]/klɑːt/; [v]使凝成块; [n]凝块; [^]z8;
clump: [-]/klʌmp/; [n]土块; [v]丛生; [^]z8;
clutter: [-]/ˈklʌtər/; [n]混乱,凌乱; [v]弄乱,搅乱; [^]z8;
coax: [-]/koʊks/; [v]哄,哄诱; [^]z8;
cobble: [-]/ˈkɑːbl/; [v]修,拙劣地修补;铺鹅卵石,用圆石铺面; [n]鹅卵石,圆石; [^]z8;
cocaine: [-]/koʊˈkeɪn/; [n]可卡因,古柯碱; [^]z8;
coddle: [-]/ˈkɑːdl/; [v]溺爱;用文火煮; [n]〈口〉娇生惯养的人; [^]z8;
coed: [-]/ˌkoʊˈed/; [n]男女同校的女生; [a]男女同校的; [^]z8;
coefficient: [-]/ˌkoʊɪˈfɪʃnt/; [n]<数>系数; [a]共同作用的; [^]z8;
coerce: [-]/koʊˈɜːrs/; [v]强迫,压制; [^]z8;
coercion: [-]/koʊˈɜːrʒn/; [n]胁迫,威压; [^]z8;
coexist: [-]/ˌkoʊɪɡˈzɪst/; [v]共存;和平共处; [^]z8;
cognitive: [-]/ˈkɑːɡnətɪv/; [a]认识能力的;认知的; [^]z8;
coherent: [-]/koʊˈhɪrənt/; [a]协调一致的;条理清楚的,有条理的;连贯的;有黏性的,黏合在一起的,粘着的; [^]z8;
cohesive: [-]/koʊˈhiːsɪv/; [a]团结的;紧密结合的;有黏着力的; [^]z8;
collate: [-]/kəˈleɪt/; [v]核对,校对;校勘; [^]z8;
collude: [-]/kəˈluːd/; [v]串通,共谋; [^]z8;
collusion: [-]/kəˈluːʒn/; [n]勾结;共谋; [^]z8;
colonize: [-]/ˈkɑːlənaɪz/; [v]在(某处)开拓殖民地;占据;(为政治目的)打入,混入(某部门等); [^]z8;
colossal: [-]/kəˈlɑːsl/; [a]巨像(似)的;巨大的,庞大的; [^]z8;
colossus: [-]/kəˈlɑːsəs/; [n]巨像,巨人,巨大的东西; [^]z8;
colt: [-]/koʊlt/; [n]小马,生手; [v]以笞绳鞭打; [^]z8;
combustible: [-]/kəmˈbʌstəbl/; [a]易燃的;易激动的; [n]可燃物;易燃物; [^]z8;
commensurate: [-]/kəˈmenʃərət/; [a]相称的,相应的;同量的;同样大小的; [^]z8;
communicable: [-]/kəˈmjuːnɪkəbl/; [a]可传达的,会传染的,爱说话的; [^]z8;
communion: [-]/kəˈmjuːniən/; [n]共享,恳谈,宗教团体,圣餐仪式; [^]z8;
compatible: [-]/kəmˈpætəbl/; [a]可和谐共存的;兼容的; [^]z8;
compatriot: [-]/kəmˈpeɪtriət/; [n]同胞; [a]同胞的; [^]z8;
complementary: [-]/ˌkɑːmplɪˈmentri/; [a]补足的,补充的,互补的; [^]z8;
complexion: [-]/kəmˈplekʃn/; [n]肤色;特性; [^]z8;
composite: [-]/kəmˈpɑːzət/; [a]合成的,复合的; [n]合成物,复合材料; [v]使合成,使混合; [^]z8;
composure: [-]/kəmˈpoʊʒər/; [n]镇静,沉着; [^]z8;
compulsion: [-]/kəmˈpʌlʃn/; [n]强制,强迫,强制力; [^]z8;
compunction: [-]/kəmˈpʌŋkʃn/; [n]懊悔,良心不安; [^]z8;
con: [-]/kɑːn/; [v]熟读,精读;哄骗; [ad]反对;从反面; prep. 反对;<意大利语><音乐>以; [n]指挥操舵;指挥操舵者的位置;反对(论点); [a]骗取信任的; [^]z8;
concede: [-]/kənˈsiːd/; [v]承认;承认失败;让给,让与;让步; [^]z8;
concentric: [-]/kənˈsentrɪk/; [a]同中心的; [ad]同一中心地;同轴地; [^]z8;
concerto: [-]/kənˈtʃɜːrtoʊ/; [n]<音乐>协奏曲; [^]z8;
conciliate: [-]/kənˈsɪlieɪt/; [v]调和,安抚; [^]z8;
concord: [-]/ˈkɑːŋkɔːrd/; [n]和睦,公约; [^]z8;
concur: [-]/kənˈkɜːr/; [v]同意;一致; [^]z8;
condom: [-]/ˈkɑːndəm/; [n]安全套,避孕套; [^]z8;
confection: [-]/kənˈfekʃn/; [n]糖果,蜜饯,调制,糖膏(剂),精制工艺品; [v]〈古〉调制; [^]z8;
confederacy: [-]/kənˈfedərəsi/; [n]联盟;同谋; [^]z8;
confederate: [-]/kənˈfedərət/; [n]同盟国,同盟者; [a]同盟的,联合的; [v]结盟,联合; [^]z8;
confer: [-]/kənˈfɜːr/; [v]授予(奖项,学位,荣誉或权利);商讨,协商; [^]z8;
confetti: [-]/kənˈfeti/; [n](婚礼,狂欢节中抛撒的)五彩纸屑; [^]z8;
confidant: [-]/ˈkɑːnfɪdænt/; [n]密友; [^]z8;
confide: [-]/kənˈfaɪd/; [v]倾诉;委托;信赖; [^]z8;
configuration: [-]/kənˌfɪɡjəˈreɪʃn/; [n]配置,布局,构造; [^]z8;
confinement: [-]/kənˈfaɪnmənt/; [n]限制;监禁;分娩; [^]z8;
conflate: [-]/kənˈfleɪt/; [v]合并; [^]z8;
congenial: [-]/kənˈdʒiːniəl/; [a]意气相投的,令人愉快的,意气相投的,协调的; [^]z8;
congenital: [-]/kənˈdʒenɪtl/; [a]天生的,固有的; [^]z8;
congested: [-]/kənˈdʒestɪd/; [a]拥挤的,密集的; [^]z8;
conjecture: [-]/kənˈdʒektʃər/; [n]推测;猜想; [v]推测;揣摩; [^]z8;
conjure: [-]/ˈkʌndʒər/; [v]变魔术;使...变戏法般地出现(或消失);使想起;使...呈现于脑际;(a name to conjure with)大名鼎鼎的人;影响巨大的事物;恳求; [^]z8;
connoisseur: [-]/ˌkɑːnəˈsɜːr/; [n](艺术品等的)鉴赏家,鉴定家,行家; [^]z8;
consecrate: [-]/ˈkɑːnsɪkreɪt/; [v]使神圣,(用宗教仪式)授予..以某种职位; [a]神圣的;被献给神的; [^]z8;
consensus: [-]/kənˈsensəs/; [n]一致同意,合意; [^]z8;
consign: [-]/kənˈsaɪn/; [v]托运,托卖,寄存; [^]z8;
consignment: [-]/kənˈsaɪnmənt/; [n]委托;运送;托付物; [^]z8;
console: [-]/kənˈsoʊl/; [v]安慰,慰问; [n]控制台,仪表板;落地柜; [^]z8;
conspiracy: [-]/kənˈspɪrəsi/; [n]密谋,阴谋; [^]z8;
conspire: [-]/kənˈspaɪər/; [v]密谋策划;共谋,串通一气; [^]z8;
constancy: [-]/ˈkɑːnstənsi/; [n]坚贞,忠诚,专一;稳定性,恒定性; [^]z8;
constituent: [-]/kənˈstɪtʃuənt/; [a]组成的;有选举权的; [n]选民;成分; [^]z8;
constrain: [-]/kənˈstreɪn/; [v]约束;限制;强迫; [^]z8;
constraint: [-]/kənˈstreɪnt/; [n]限制;强迫,拘束;强制; [^]z8;
consummate: [-]/ˈkɑːnsəmət/; [a]至上的,完美的; [v]完成,使达到极点; [^]z8;
contemplate: [-]/ˈkɑːntəmpleɪt/; [v]沉思;对..周密考虑;注视; [^]z8;
contend: [-]/kənˈtend/; [v]争辩;坚决主张;搏斗; [^]z8;
contingency: [-]/kənˈtɪndʒənsi/; [n]偶然性;<安全>意外事故;可能性;<审计>意外开支; [^]z8;
contingent: [-]/kənˈtɪndʒənt/; [n]分遣队; [a]意外的,视情况条件而定的; [^]z8;
continuum: [-]/kənˈtɪnjuəm/; [n]连续,连续统,闭连集; [^]z8;
contort: [-]/kənˈtɔːrt/; [v]扭曲,歪曲; [^]z8;
contour: [-]/ˈkɑːntʊr/; [n]轮廓,等高线,概要; [vt]画轮廓,画等高线; [a](表示<循着>)等高线的;与轮廓相合的; [^]z8;
contraception: [-]/ˌkɑːntrəˈsepʃn/; [n]避孕,避孕法; [^]z8;
contraceptive: [-]/ˌkɑːntrəˈseptɪv/; [a]避孕的; [n]避孕品,避孕用具; [^]z8;
contrive: [-]/kənˈtraɪv/; [v]发明;设计出;设法做到;谋划;策划; [^]z8;
convene: [-]/kənˈviːn/; [v]集合,召集,召唤; [^]z8;
converge: [-]/kənˈvɜːrdʒ/; [v](向某一点)相交,会合;汇集,聚集,集中; [^]z8;
conversant: [-]/kənˈvɜːrsnt/; [a]熟悉的;精通的;亲近的; [^]z8;
convoy: [-]/ˈkɑːnvɔɪ/; [n]护送,护卫,护航队; [v]护航,护送; [^]z8;
convulse: [-]/kənˈvʌls/; [v]使抽搐,使震动,震惊; [^]z8;
coop: [-]/kuːp/; [v]把.关进笼子里;限制;拘禁; [n]鸡笼;小屋;捕鱼篓; [^]z8;
cornet: [-]/ˈkɔːrnɪt/; [n]短号;圆锥形蛋卷; [^]z8;
corollary: [-]/ˈkɔːrəleri/; [n]推论;必然的结果; [^]z8;
coronation: [-]/ˌkɔːrəˈneɪʃn/; [n]加冕,加冕礼; [^]z8;
coroner: [-]/ˈkɔːrənər/; [n]验尸官; [^]z8;
corps: [-]/kɔːr/; [n](由两个或以上师组成的)军,兵团;一群人;特别小组; [^]z8;
corpulent: [-]/ˈkɔːrpjələnt/; [a]肥胖的; [^]z8;
correlate: [-]/ˈkɔːrələt/; [v](使)相关联; [n]相关物; [^]z8;
corroborate: [-]/kəˈrɑːbəreɪt/; [v]支持或证实,强化; [n]确证者,证物; [^]z8;
corrode: [-]/kəˈroʊd/; [v]受腐蚀;腐蚀,侵蚀; [^]z8;
corrosion: [-]/kəˈroʊʒn/; [n]侵蚀,腐蚀状态; [^]z8;
corrugated: [-]/ˈkɔːrəɡeɪtɪd/; [a]褶皱的; [^]z8;
countenance: [-]/ˈkaʊntənəns/; [n]面容,表情,气色; [v]支持,赞成; [^]z8;
counteract: [-]/ˌkaʊntərˈækt/; [v]抵消;中和;阻碍; [^]z8;
counterbalance: [-]/ˌkaʊntərˈbæləns/; [n]平衡力;抵销; [v]使平衡;抵消; [^]z8;
counterfeit: [-]/ˈkaʊntərfɪt/; [n]仿制品,伪造物; [a]仿造的.假冒的; [v]伪造,仿造; [^]z8;
coup: [-]/kuː/; [n]政变;出乎意料的行动或胜利; [^]z8;
courier: [-]/ˈkʊriər/; [n]快递员,通讯员,导游; [^]z8;
courtship: [-]/ˈkɔːrtʃɪp/; [n]求爱,求爱时期,交往期间; [^]z8;
covenant: [-]/ˈkʌvənənt/; [n]契约; [v]立书保证; [^]z8;
coverage: [-]/ˈkʌvərɪdʒ/; [n]新闻报道;可达范围;覆盖范围; [^]z8;
covet: [-]/ˈkʌvət/; [v]垂涎;觊觎; [^]z8;
cowardice: [-]/ˈkaʊərdɪs/; [n]胆小,懦弱; [^]z8;
coy: [-]/kɔɪ/; [a]腼腆的,怕羞的;卖弄风情的; [^]z8;
cram: [-]/kræm/; [v]塞满;猛吃;仓促备考; [^]z8;
cramp: [-]/kræmp/; [n]痉挛,绞痛;<五金>铁夹钳; [v]束缚,限制;使.抽筋;以铁箍扣紧; [^]z8;
cranky: [-]/ˈkræŋki/; [a]暴躁的;古怪的;动摇的; [^]z8;
crap: [-]/kræp/; [n]废话,废物,屎; [v]掷骰子,拉屎; [a]坏的;糟糕的;劣质的; [^]z8;
crater: [-]/ˈkreɪtər/; [n]火山口;弹坑; [v]在.上形成坑;毁坏; [^]z8;
crave: [-]/kreɪv/; [v]渴望;恳求; [^]z8;
craven: [-]/ˈkreɪvn/; [a]懦弱的,畏缩的; [^]z8;
crease: [-]/kriːs/; [n]折缝,皱痕; [v]起折痕; [^]z8;
credibility: [-]/ˌkredəˈbɪləti/; [n]可靠性,可信性,确实有效性; [^]z8;
crescent: [-]/ˈkresnt/; [n]新月,新月状物,伊斯兰教的标记,土耳其的新月形国徽; [a]新月形的,逐渐增加的; [v]以新月形物装饰,使成新月形; [^]z8;
cringe: [-]/krɪndʒ/; [vi]畏缩;觉得尴尬不安或难为情; [v]奉承,阿谀; [n]畏缩;奉承; [^]z8;
crinkle: [-]/ˈkrɪŋkl/; [n]皱纹,波纹,沙沙声; [v]起皱,使沙沙作响; [^]z8;
critique: [-]/krɪˈtiːk/; [n]批评;评论文章; [v]批判,评论;评论; [^]z8;
croak: [-]/kroʊk/; [n]蛙鸣声; [^]z8;
crook: [-]/krʊk/; [n]骗子;弯曲处;钩;河弯;诡计; [v]使弯曲; [a]不正当的;骗人的; [^]z8;
crooked: [-]/ˈkrʊkɪd/; [a]弯曲的;歪的;不正当的;不正直的; [^]z8;
crossword: [-]/ˈkrɔːswɜːrd/; [n]纵横字谜,纵横填字谜; [^]z8;
crucify: [-]/ˈkruːsɪfaɪ/; [v]折磨,迫害;十字架上钉死;克制; [^]z8;
crunch: [-]/krʌntʃ/; [n]嘎吱嘎吱的声音; [vt]嘎吱嘎吱地咀嚼; [vi]嘎吱嘎吱地咀嚼;嘎吱嘎吱地动;发嘎吱嘎吱声; [^]z8;
crux: [-]/krʌks/; [n]关键,难题,十字架形,坩埚; [^]z8;
crypt: [-]/krɪpt/; [n]地窟,［解］腺窝,小囊; pref. 隐藏的;秘密的(=crypto); [^]z8;
cryptic: [-]/ˈkrɪptɪk/; [a]秘密的,含义模糊的,神秘的,隐藏的; [^]z8;
cub: [-]/kʌb/; [n]幼兽,年轻无经验的人; [v](野兽)生仔; [a]没经验的; [^]z8;
cuckoo: [-]/ˈkʊkuː/; [n]杜鹃鸟;布谷鸟; [a]疯狂的; [^]z8;
cuddle: [-]/ˈkʌdl/; [n]拥抱; [v]拥抱,搂抱;紧贴着身子睡; [^]z8;
culminate: [-]/ˈkʌlmɪneɪt/; [v]使达高潮,使结束; [^]z8;
culprit: [-]/ˈkʌlprɪt/; [n]罪犯,犯人,犯错者; [^]z8;
cult: [-]/kʌlt/; [n]异教;风尚,热潮;信徒; [a]流行的;风靡一时的; [^]z8;
cumbersome: [-]/ˈkʌmbərsəm/; [a]笨重的;麻烦的; [^]z8;
cumulative: [-]/ˈkjuːmjəleɪtɪv/; [a]渐增的;累积的; [^]z8;
curfew: [-]/ˈkɜːrfjuː/; [n]宵禁,宵禁令,晚钟声,熄灯就寝时刻; [^]z8;
cursive: [-]/ˈkɜːrsɪv/; [n]草书;草书原稿; [a]草书的;草书体的; [^]z8;
cursory: [-]/ˈkɜːrsəri/; [a]匆忙的,不注意细节的;草率地;粗略地; [^]z8;
curt: [-]/kɜːrt/; [a]简略的; [^]z8;
curtail: [-]/kɜːrˈteɪl/; [vt]截短;削减;剥夺.特权; [^]z8;
custard: [-]/ˈkʌstərd/; [n]奶油冻,奶油蛋羹; [^]z8;
dab: [-]/dæb/; [n]轻拍,少量,熟手,比目鱼; [v]轻拍,涂,轻擦,轻敷; [^]z8;
daffodil: [-]/ˈdæfədɪl/; [n]水仙花; [a]水仙花色的; [^]z8;
daft: [-]/dæft/; [a]愚蠢的; [^]z8;
dais: [-]/ˈdeɪɪs/; [n]主席台,嘉宾席; [^]z8;
daisy: [-]/ˈdeɪzi/; [n]雏菊;菊科植物;极好的东西; [a]极好的;上等的; [^]z8;
dampen: [-]/ˈdæmpən/; [v]变潮湿; [vi]沮丧; [vt]使潮湿;抑制,使扫兴; [^]z8;
damsel: [-]/ˈdæmzl/; [n]少女,年轻女子; [^]z8;
dandelion: [-]/ˈdændɪlaɪən/; [n]蒲公英; [^]z8;
dandy: [-]/ˈdændi/; [n]花花公子; [a]服装华丽的,极好的,上等的; [^]z8;
dank: [-]/dæŋk/; [a]潮湿的,阴湿的;透水的; [^]z8;
dapper: [-]/ˈdæpər/; [a]干净利落的,衣冠楚楚的; [^]z8;
dappled: [-]/ˈdæpld/; [a]有斑点的,斑驳的; [^]z8;
daredevil: [-]/ˈderdevl/; [n]铤而走险的人,蛮勇的人; [a]蛮勇的,不怕死的; [^]z8;
darn: [-]/dɑːrn/; [v]缝补; [a]可恶的;完全的; [ad]极其; [int]可恶; [n]补丁;织补之处; [^]z8;
dated: [-]/ˈdeɪtɪd/; [a]注有(或注明)日期的;过时的,旧式的; [^]z8;
daunt: [-]/dɔːnt/; [v]使气馁,使畏缩,威吓; [^]z8;
dauntless: [-]/ˈdɔːntləs/; [a]勇敢的,无畏的;不屈不挠的; [^]z8;
dawdle: [-]/ˈdɔːdl/; [v]闲荡,浪费时间; [^]z8;
deadlock: [-]/ˈdedlɑːk/; [vt](使)相持不下; [vi]僵持; [n]僵局;不分胜负; [^]z8;
debacle: [-]/dɪˈbɑːkl/; [n]解冻,崩溃;灾害; [^]z8;
debase: [-]/dɪˈbeɪs/; [v]贬值,降低; [^]z8;
debilitate: [-]/dɪˈbɪlɪteɪt/; [v]使衰弱; [^]z8;
debit: [-]/ˈdebɪt/; [vt]记入借方,登入借方; [n]借方; [^]z8;
debris: [-]/dəˈbriː/; [n]废墟,残骸; [^]z8;
decadent: [-]/ˈdekədənt/; [a]颓废的;衰退的; [^]z8;
decease: [-]/dɪˈsiːs/; [n]死亡; [v]死; [^]z8;
decelerate: [-]/ˌdiːˈseləreɪt/; [v](使)减速; [^]z8;
decency: [-]/ˈdiːsnsi/; [n]正派,体面,庄重,合乎礼仪,礼貌; [^]z8;
decipher: [-]/dɪˈsaɪfər/; [n]密电译文; [vt]解释;破译; [^]z8;
declaim: [-]/dɪˈkleɪm/; [v]高谈阔论,雄辩,大声说; [^]z8;
decompose: [-]/ˌdiːkəmˈpoʊz/; [v](使)腐烂;分解; [^]z8;
decor: [-]/deɪˈkɔːr/; [n]装饰,布置; [^]z8;
decorous: [-]/ˈdekərəs/; [a]端庄稳重的,正派得体的,有礼貌的,高雅的; [^]z8;
decorum: [-]/dɪˈkɔːrəm/; [n]礼节,礼貌,端庄,正派; [^]z8;
decoy: [-]/dɪˈkɔɪ/; [n]诱饵;诱骗; [v]诱骗; [^]z8;
decry: [-]/dɪˈkraɪ/; [v]谴责,责难,诽谤; [^]z8;
deem: [-]/diːm/; [v]认为,视为;知道,相信; [^]z8;
deface: [-]/dɪˈfeɪs/; [v]损伤外观,丑化; [^]z8;
defame: [-]/dɪˈfeɪm/; [v]诽谤,中伤; [^]z8;
defer: [-]/dɪˈfɜːr/; [v]使推迟,使延期;听从,顺从; [vi]延期; [^]z8;
defile: [-]/dɪˈfaɪl/; [v]污损,弄脏;以纵队前进; [n]狭谷;隘路; [^]z8;
definitive: [-]/dɪˈfɪnətɪv/; [a]可靠的,明确的,权威的;决定性的; [^]z8;
deflate: [-]/dɪˈfleɪt/; [v]放气;使缩小;紧缩通货;打击;使泄气;物价下降; [^]z8;
defoliate: [-]/ˌdiːˈfoʊlieɪt/; [v]落叶; [a]〈罕〉落了叶的; [^]z8;
deform: [-]/dɪˈfɔːrm/; [v](使)变形; [a]畸形的;丑陋的; [^]z8;
defraud: [-]/dɪˈfrɔːd/; [v]欺诈,诈取,骗取; [^]z8;
defrost: [-]/ˌdiːˈfrɔːst/; [v]除霜,解冻; [^]z8;
deft: [-]/deft/; [a]灵巧的,敏捷的,熟练的; [^]z8;
defunct: [-]/dɪˈfʌŋkt/; [a]已故的,不复存在的;不再使用的; [^]z8;
defuse: [-]/ˌdiːˈfjuːz/; [vi]平息,变弱; [vt]拆除;使消除危险性,平息; [^]z8;
degenerate: [-]/dɪˈdʒenəreɪt/; [v]堕落,衰减; [a]腐化的,颓废的,退化的;变质的; [n]堕落者; [^]z8;
degrade: [-]/dɪˈɡreɪd/; [v]贬低;降低品格(身价,价值等);分解;降低; [^]z8;
dehydrate: [-]/diːˈhaɪdreɪt/; [v]除去水份,脱水; [^]z8;
deify: [-]/ˈdeɪɪfaɪ/; [v]奉为神;崇拜; [^]z8;
deity: [-]/ˈdiːəti/; [n]上帝,神性; [^]z8;
deliberate: [-]/dɪˈlɪbərət/; [a]故意的;深思熟虑的;从容不迫的; [v]仔细考虑;研讨; [^]z8;
delimit: [-]/diˈlɪmɪt/; [v]定界,划界; [^]z8;
delineate: [-]/dɪˈlɪnieɪt/; [v]描画;画出..轮廓; [^]z8;
delirious: [-]/dɪˈlɪriəs/; [a]精神错乱的,发狂的; [^]z8;
delude: [-]/dɪˈluːd/; [v]欺骗,哄骗; [^]z8;
deluge: [-]/ˈdeljuːdʒ/; [n]洪水;暴雨;泛滥; [v]使泛滥;压倒; [^]z8;
deluxe: [-]/dɪˈlʌks/; [a]豪华的,华丽的; [^]z8;
delve: [-]/delv/; [v]钻研;探究;挖; [n]穴;洞; [^]z8;
demean: [-]/dɪˈmiːn/; [v]贬抑,降低; [^]z8;
demeanor: [-]/dɪ'miːnə/; [n]举止,行为,风度; [^]z8;
demented: [-]/dɪˈmentɪd/; [a]发狂的,精神错乱的; [v]精神错乱;变得痴呆; [^]z8;
demobilize: [-]/diːˈmoʊbəlaɪz/; [v]遣散,使退伍; [^]z8;
demography: [-]/dɪˈmɑːɡrəfi/; [n]人口统计,人口统计学; [^]z8;
demon: [-]/ˈdiːmən/; [n]魔鬼,极残忍的人; [^]z8;
demoralize: [-]/dɪˈmɔːrəlaɪz/; [v]使低落,使沮丧;使道德败坏;使士气低落; [^]z8;
demote: [-]/ˌdiːˈmoʊt/; [v]降级,降职; [^]z8;
denizen: [-]/ˈdenɪzn/; [n]居民,外籍居民; [^]z8;
denominate: [-]/dɪˈnɑːmɪneɪt/; [v]命名,取名; [a]有说明性名称的; [^]z8;
dent: [-]/dent/; [n]缺口,凹痕; [v]使凹下,凹进,削弱; [^]z8;
dentistry: [-]/ˈdentɪstri/; [n]牙科学;牙医职业; [^]z8;
deodorant: [-]/diˈoʊdərənt/; [a]除臭的;防臭的; [n]除臭剂; [^]z8;
deplete: [-]/dɪˈpliːt/; [v]使大大减少;耗尽,用尽; [^]z8;
deplore: [-]/dɪˈplɔːr/; [v]谴责;对...深感遗憾;悲悼;痛惜; [^]z8;
depose: [-]/dɪˈpoʊz/; [v]免职,废黜,作证; [^]z8;
depository: [-]/dɪˈpɑːzətɔːri/; [n]贮藏所,受托者; [a]保管的,存储的; [^]z8;
deprecate: [-]/ˈdeprəkeɪt/; [v]反对;轻视; [^]z8;
depreciate: [-]/dɪˈpriːʃieɪt/; [v]贬低,轻视;贬值;折旧; [^]z8;
deride: [-]/dɪˈraɪd/; [v]嘲弄,愚弄; [^]z8;
derision: [-]/dɪˈrɪʒn/; [n]嘲笑,嘲笑的目标,笑柄; [^]z8;
derogatory: [-]/dɪˈrɑːɡətɔːri/; [a]不敬的,诽谤的; [^]z8;
derrick: [-]/ˈderɪk/; [n]起重机,转臂起重机,油井的铁架塔; [^]z8;
desiccate: [-]/'desɪˌkeɪt/; [v](使)完全干涸,脱水; [^]z8;
despicable: [-]/dɪˈspɪkəbl/; [a]可鄙的,卑劣的; [^]z8;
despoil: [-]/dɪˈspɔɪl/; [v]掠夺,剥夺;夺取; [^]z8;
destitute: [-]/ˈdestɪtuːt/; [a]贫穷的,缺乏的; [^]z8;
deterrent: [-]/dɪˈtɜːrənt/; [n]威慑物; [v]威慑的; [^]z8;
detest: [-]/dɪˈtest/; [vt]厌恶,憎恨,痛恨; [^]z8;
detonate: [-]/ˈdetəneɪt/; [v](使)爆炸,引爆; [^]z8;
detour: [-]/ˈdiːtʊr/; [n]弯路,绕行之路; [v]绕道,迂回; [^]z8;
devastate: [-]/ˈdevəsteɪt/; [v]摧毁;使垮掉,使不知所措,使陷于混乱; [^]z8;
deviant: [-]/ˈdiːviənt/; [a]变态的,反常的(多指性行为);越出常规的; [n]异常的人;性变态者; [^]z8;
deviate: [-]/ˈdiːvieɪt/; [v]偏离;背离; [a]脱离常轨的; [n]脱离常轨的人; [^]z8;
deviation: [-]/ˌdiːviˈeɪʃn/; [n]偏离,背离; [^]z8;
devious: [-]/ˈdiːviəs/; [a]迂回弯曲的,狡猾的; [^]z8;
devoid: [-]/dɪˈvɔɪd/; [a]全无的,缺乏的; [^]z8;
devolve: [-]/dɪˈvɑːlv/; [v]被移交;转让;移交;使滚下;衰落; [^]z8;
devout: [-]/dɪˈvaʊt/; [a]虔诚的,真挚的,诚恳的; [n]虔诚;真挚,诚恳; [^]z8;
dexterity: [-]/dekˈsterəti/; [n]纯熟;灵巧; [^]z8;
diabetes: [-]/ˌdaɪəˈbiːtiːz/; [n]糖尿病,多尿症; [^]z8;
diagonal: [-]/daɪˈæɡənl/; [n]对角线; [a]对角线的;斜的;斜纹的; [^]z8;
diarrhea: [-]/ˌdaɪə'riːə/; [n]腹泻,拉肚子; [^]z8;
diarrhoea: [-]/ˌdaɪəˈriːə/; [n]腹泻; [^]z8;
dice: [-]/daɪs/; [n]骰子,小方块; [v]掷骰子;切成方块; [^]z8;
dichotomy: [-]/daɪˈkɑːtəmi/; [n]二分,本质对立; [^]z8;
dictum: [-]/ˈdɪktəm/; [n]名言,格言;法官的附带意见; [^]z8;
didactic: [-]/daɪˈdæktɪk/; [a]说教的;教诲的; [^]z8;
diehard: [-]/ˈdaɪhɑːrd/; [n]顽固分子,保守分子; [a]顽固的,执拗的; [^]z8;
differentiate: [-]/ˌdɪfəˈrenʃieɪt/; [v]使有差异;区别; [^]z8;
diffident: [-]/ˈdɪfɪdənt/; [a]羞怯的,缺乏自信的,谦虚谨慎的; [^]z8;
digress: [-]/daɪˈɡres/; [v]离题;走向岔道; [^]z8;
dilapidated: [-]/dɪˈlæpɪdeɪtɪd/; [a]破旧的,破烂的;倾坍的; [^]z8;
dilate: [-]/daɪˈleɪt/; [v]使膨胀,扩张,膨胀;详述; [^]z8;
dilettante: [-]/ˌdɪləˈtænti/; [n]半吊子; [^]z8;
dimple: [-]/ˈdɪmpl/; [n]酒窝,涟漪,浅凹;酒窝;浅凹;酒涡,涟漪,浅凹; [v]做出凹痕;(使)起波纹;(使)起涟漪; [^]z8;
din: [-]/dɪn/; [n]喧闹声,嘈杂声; [v]喧闹,喋喋不休地说; [^]z8;
dinghy: [-]/ˈdɪŋi/; [n]无篷小船,小艇; [^]z8;
dingy: [-]/ˈdɪndʒi/; [a]昏暗的,肮脏的;褴褛的; [n]同"dingey"; [^]z8;
diphthong: [-]/ˈdɪfθɑːŋ/; [n]双元音,元音连字; [^]z8;
dire: [-]/ˈdaɪər/; [a]可怕的;悲惨的;极端的; [^]z8;
directive: [-]/dəˈrektɪv/; [n]指示,指令; [a]指导的,管理的;方向的; [^]z8;
disarray: [-]/ˌdɪsəˈreɪ/; [n]混乱,漫无秩序; [^]z8;
disavow: [-]/ˌdɪsəˈvaʊ/; [v]不承认,抵赖,拒绝对..承担责任; [^]z8;
discernible: [-]/dɪˈsɜːrnəbl/; [a]可辨别的;可识别的; [^]z8;
discerning: [-]/dɪˈsɜːrnɪŋ/; [a]有辨别力的,敏锐的; [^]z8;
disclaim: [-]/dɪsˈkleɪm/; [v]放弃权利,拒绝承认,拒绝; [^]z8;
disconcert: [-]/ˌdɪskənˈsɜːrt/; [v]使仓皇失措;使困惑;破坏; [^]z8;
discredit: [-]/dɪsˈkredɪt/; [v]使不相信,使怀疑;败坏.的名声; [n]丧失信誉,丧失名誉;败坏名声的人或事,耻辱; [^]z8;
discreet: [-]/dɪˈskriːt/; [a]谨慎的;思虑周全的,小心的; [^]z8;
discrete: [-]/dɪˈskriːt/; [a]分开的;不连续的; [^]z8;
disenchant: [-]/ˌdɪsɪn'tʃænt/; [v]使觉悟,使摆脱幻想; [^]z8;
dishonor: [-]/dɪs'ɒnə/; [n]不光彩,不名誉; [v]使丢脸,凌辱; [^]z8;
dishonour: [-]/dɪsˈɑːnər/; [n]失去名誉;不光彩,耻辱;丢脸的人;无礼; [v]使受耻辱;不遵守;奸污; [^]z8;
disinterested: [-]/dɪsˈɪntrəstɪd/; [a]公正的;不感兴趣的;无私的;廉洁的; [^]z8;
disjointed: [-]/dɪsˈdʒɔɪntɪd/; [a]杂乱的,无逻辑的,脱节的; [^]z8;
dislocate: [-]/ˈdɪsloʊkeɪt/; [v]使脱臼;把.弄乱; [^]z8;
dislodge: [-]/dɪsˈlɑːdʒ/; [v]驱逐;移去;取出; [^]z8;
disparate: [-]/ˈdɪspərət/; [a]迥然不同的; [^]z8;
disparity: [-]/dɪˈspærəti/; [n]不同,不一致,不等; [^]z8;
dispensable: [-]/dɪˈspensəbl/; [a]不必要的,可有可无的; [^]z8;
dispirited: [-]/dɪˈspɪrɪtɪd/; [a]沮丧的;消沉的;情绪低落的;灰心的; [^]z8;
disprove: [-]/ˌdɪsˈpruːv/; [v]反驳,证明.是虚假的; [^]z8;
disrepute: [-]/ˌdɪsrɪˈpjuːt/; [n]不光彩,坏名声; [^]z8;
disrespect: [-]/ˌdɪsrɪˈspekt/; [n]不礼貌,无礼,失礼; [vt]不尊重,藐视,轻视; [^]z8;
disseminate: [-]/dɪˈsemɪneɪt/; [v]宣传,传播;散布; [^]z8;
dissension: [-]/dɪˈsenʃn/; [n]意见分歧;纷争;倾轧; [^]z8;
dissipated: [-]/ˈdɪsɪpeɪtɪd/; [a]消散的;沉迷于酒色的;闲游浪荡的;放荡的; [^]z8;
dissolute: [-]/ˈdɪsəluːt/; [a]无节制的;放荡的; [^]z8;
dissonance: [-]/ˈdɪsənəns/; [n]不一致;不调和;不和谐音; [^]z8;
dissuade: [-]/dɪˈsweɪd/; [v]劝阻,阻止; [^]z8;
distaste: [-]/dɪsˈteɪst/; [n]厌恶,讨厌; [v]厌恶,不喜欢; [^]z8;
distraught: [-]/dɪˈstrɔːt/; [a]发狂的;心烦意乱的; [^]z8;
dither: [-]/ˈdɪðər/; [n]慌乱,犹豫,颤抖; [v]慌乱,踌躇犹豫,颤抖; [^]z8;
diverge: [-]/daɪˈvɜːrdʒ/; [v]分歧,分开; [^]z8;
divergent: [-]/daɪˈvɜːrdʒənt/; [a]叉开的;分歧的; [^]z8;
dividend: [-]/ˈdɪvɪdend/; [n](股份的)红利,回报,效益,被除数; [^]z8;
divine: [-]/dɪˈvaɪn/; [a]神的,神圣的;极好的; [v](凭直觉)发现,猜到; [n]神学家;圣职人员;教士;上帝; [^]z8;
divinity: [-]/dɪˈvɪnəti/; [n]神,神性,神学; [^]z8;
divisive: [-]/dɪˈvaɪsɪv/; [a]分裂的;区分的;造成不和的; [^]z8;
divulge: [-]/daɪˈvʌldʒ/; [v]泄露,透露; [^]z8;
docile: [-]/ˈdɑːsl/; [a]驯服的,温顺的; [^]z8;
doctorate: [-]/ˈdɑːktərət/; [n]博士头衔; [^]z8;
dogma: [-]/ˈdɔːɡmə/; [n]教条;武断的意见; [a]教义的,教条的,信条的; [^]z8;
dogmatic: [-]/dɔːɡˈmætɪk/; [a]教条的,武断的; [^]z8;
doldrums: [-]/ˈdoʊldrəmz/; [n](海洋上的)无风带,情绪低沉; [^]z8;
dole: [-]/doʊl/; [n]救济,(失业)救济金; [v]发放,发给; [^]z8;
doleful: [-]/ˈdoʊlfl/; [a]寂寞的;悲哀的;阴沉的; [^]z8;
domain: [-]/doʊˈmeɪn/; [n]域名;领土;管区,势力圈; [^]z8;
domesticate: [-]/dəˈmestɪkeɪt/; [vt]使习惯于家庭生活;驯养;引进; [^]z8;
domesticity: [-]/ˌdoʊmeˈstɪsəti/; [n]家庭生活,专心于家务,对家庭的挚爱; [^]z8;
domicile: [-]/ˈdɑːmɪsaɪl/; [n]住宅;永久居住地;期票支付场所; [v]居住;使在指定的场所支付(期票等; [a]定居;在固定住所生活; [^]z8;
doodle: [-]/ˈduːdl/; [v](无目的地)乱画,漫无目的地打发时光; [n]涂鸦; [^]z8;
dope: [-]/doʊp/; [n]毒品;粘稠物,胶状物,添加剂;傻瓜,蠢货;内幕消息; [v]给.服用麻醉剂; [a]<俚>极好的; [^]z8;
dormant: [-]/ˈdɔːrmənt/; [a]睡眠的,休眠的;静止的,隐伏的; [^]z8;
dosage: [-]/ˈdoʊsɪdʒ/; [n]剂量; [^]z8;
dossier: [-]/ˈdɔːsieɪ/; [n]档案,卷宗;病历表册; [^]z8;
dote: [-]/doʊt/; [v]溺爱;昏愦; [^]z8;
downhill: [-]/ˈdaʊnhɪl/; [ad]下坡,向下,每况愈下; [a]下坡的,容易的; [n]下坡,滑降; [^]z8;
downright: [-]/ˈdaʊnraɪt/; [a]明白的,直率的,显明的; [ad]完全,彻底,全然; [^]z8;
downstream: [-]/ˌdaʊnˈstriːm/; [ad]下游地; [a]下游的; [n]下行;顺流;〔体〕顺水;下游侧; [^]z8;
dowry: [-]/ˈdaʊri/; [n]嫁妆,天资,亡夫遗产; [^]z8;
drab: [-]/dræb/; [a]枯黄色的,无聊的,单调的; [n]单调;淡褐色;[印,纺]淡褐色厚呢;邋遢女人; [^]z8;
drape: [-]/dreɪp/; [v]用布帘覆盖,使呈褶裥状; [n]窗帘,褶裥; [^]z8;
draught: [-]/dræft/; [n]气流,通风,穿堂风;药水; [v]起草;选派; [a]桶装的;驮物的; [^]z8;
dregs: [-]/dreɡz/; [n]渣滓;少量;沉淀物; [^]z8;
drench: [-]/drentʃ/; [v]使淋透;使湿透; [n]淋透;雨淋;浸渍液;(制革时浸泡熟皮的)脱灰水; [^]z8;
dribble: [-]/ˈdrɪbl/; [v](液体)往下滴,淌,流口水,运球; [n]口水,运球; [^]z8;
drone: [-]/droʊn/; [n]无人机,无人驾驶飞机;雄蜂;单调的低音; [v]嗡嗡地响; [vi]混日子; [^]z8;
drool: [-]/druːl/; [v]流口水,胡说; [n]口水,梦话,胡说; [^]z8;
drowse: [-]/draʊz/; [v]打瞌睡;发呆;昏昏沉沉地消磨(时光); [n]瞌睡; [^]z8;
dub: [-]/dʌb/; [v]授予(称号);为(电影)配音;混录录制(音乐); [n](西印度群岛的)强节奏音乐; [^]z8;
duchy: [-]/ˈdʌtʃi/; [n]公国,公爵领地,直辖领地; [^]z8;
duet: [-]/duˈet/; [n]二重唱; [vi]演奏二重奏或二重唱; [^]z8;
dune: [-]/duːn/; [n](由风吹积而成的)沙丘; [^]z8;
duo: [-]/ˈduːoʊ/; [n]一对,二重唱; pref. 表示"二";"一对"; [^]z8;
dupe: [-]/duːp/; [n]受骗的人,上当者; [v]欺骗,愚弄; [^]z8;
duplicity: [-]/duːˈplɪsəti/; [n]口是心非;表里不一;不诚实; [^]z8;
dusky: [-]/ˈdʌski/; [a]暗淡的,微暗的,忧郁的,朦胧的; [ad]昏暗地,黑暗地; [n]昏暗,黑暗; [^]z8;
dynamics: [-]/daɪ'næmɪks/; [n]动力学;力学; [^]z8;
earthenware: [-]/ˈɜːrθnwer/; [n]<总称>陶器; [a]陶制的; [^]z8;
eaves: [-]/iːvz/; [n]屋檐,凸出的边缘; pl. 屋檐; [^]z8;
eavesdrop: [-]/ˈiːvzdrɑːp/; [v]偷听,窃听; [n]屋檐水; [^]z8;
eccentricity: [-]/ˌeksenˈtrɪsəti/; [n]古怪;怪癖;<数>离心率; [^]z8;
eclectic: [-]/ɪˈklektɪk/; [a]折衷主义的;选择的; [n]折衷主义者,折衷派的人; [^]z8;
ecstasy: [-]/ˈekstəsi/; [n]狂喜,心醉神怡; [^]z8;
eddy: [-]/ˈedi/; [n]漩涡; [v]旋转;起漩涡; [^]z8;
edict: [-]/ˈiːdɪkt/; [n]法令,布告; [^]z8;
edifice: [-]/ˈedɪfɪs/; [n]宏伟的建筑物;大厦;(知识的)体系,结构; [^]z8;
eerie: [-]/ˈɪri/; [a]胆怯的,引起恐惧的; [^]z8;
efface: [-]/ɪˈfeɪs/; [v]擦掉,抹去;消去; [^]z8;
effeminate: [-]/ɪˈfemɪnət/; [a]柔弱的,女人气的,娇气的; [v](使)带女人气; [^]z8;
efficacy: [-]/ˈefɪkəsi/; [n]功效,效力; [^]z8;
effluent: [-]/ˈefluənt/; [n]污水; [a]流出的; [^]z8;
egocentric: [-]/ˌiːɡoʊˈsentrɪk/; [a]自我中心的,利己的; [n]自我主义者; [^]z8;
egoist: [-]/ˈiːɡoʊɪst/; [n]自我主义者,利己主义者; [^]z8;
ejaculate: [-]/iˈdʒækjuleɪt/; [v]突然叫出,射出; [n]射出;射出者;一次射出的精液;突然的喊出; [^]z8;
eject: [-]/iˈdʒekt/; [v](使)弹出;喷射;放逐; [^]z8;
elated: [-]/iˈleɪtɪd/; [a]得意洋洋的;振奋的; [^]z8;
electorate: [-]/ɪˈlektərət/; [n]选民;选区; [^]z8;
electrify: [-]/ɪˈlektrɪfaɪ/; [v]通电;使触电;使激动;使震惊; [^]z8;
electrocute: [-]/ɪˈlektrəkjuːt/; [v](美)以电椅处死,使触电致死; [^]z8;
electrode: [-]/ɪˈlektroʊd/; [n]电极; [^]z8;
elemental: [-]/ˌelɪˈmentl/; [a]基本的;自然力的; [^]z8;
elicit: [-]/iˈlɪsɪt/; [v]引出;诱出;探出; [^]z8;
eligible: [-]/ˈelɪdʒəbl/; [a]适合被选的,符合条件的;(尤指婚姻等)合适的,合意的; [^]z8;
elite: [-]/ɪˈliːt/; [n]精英; [a]高级的; [^]z8;
elope: [-]/ɪˈloʊp/; [v]私奔;潜逃;出走; [^]z8;
elucidate: [-]/iˈluːsɪdeɪt/; [v]阐明,说明; [^]z8;
elude: [-]/iˈluːd/; [v]逃避,躲避;使.错过,使.找不到;使.不记得;把.难住; [^]z8;
elusive: [-]/iˈluːsɪv/; [a]难懂的;难捉摸的;难找的;难懂的;易忘的;逃避的;难捉摸的; [^]z8;
emaciated: [-]/ɪˈmeɪʃieɪtɪd/; [a]瘦弱的;憔悴的; [^]z8;
emanate: [-]/ˈeməneɪt/; [v]发出;放射; [^]z8;
embed: [-]/ɪmˈbed/; [v]把.嵌入;使嵌入; [^]z8;
embellish: [-]/ɪmˈbelɪʃ/; [vt]装饰; [v]吹嘘;润色(文章); [vi]装饰起来;加以润色;添加细节,对...添枝加叶; [^]z8;
embezzle: [-]/ɪmˈbezl/; [v]盗用,挪用,贪污; [^]z8;
emblem: [-]/ˈembləm/; [n]象征;徽章;符号; [^]z8;
embody: [-]/ɪmˈbɑːdi/; [v]包含;体现,象征; [^]z8;
emboss: [-]/ɪmˈbɔːs/; [v]加浮雕花纹于;使凸出;装饰; [^]z8;
embroil: [-]/ɪmˈbrɔɪl/; [v]使卷入;使混乱; [^]z8;
emissary: [-]/ˈemɪseri/; [n]代理,信使,使者; [^]z8;
empathy: [-]/ˈempəθi/; [n]共鸣,同感;移情作用; [^]z8;
empiricism: [-]/ɪmˈpɪrɪsɪzəm/; [n]经验主义,经验论; [^]z8;
emulate: [-]/ˈemjuleɪt/; [v]努力赶上(超过),仿效; [n]仿真; [^]z8;
encampment: [-]/ɪnˈkæmpmənt/; [n]营地,露营; [^]z8;
encase: [-]/ɪnˈkeɪs/; [v]装入,包住,围; [^]z8;
enclave: [-]/ˈenkleɪv/; [n]飞地(指在本国境内的隶属另一国的一块领土),被包围的领土,被包围物; [^]z8;
encompass: [-]/ɪnˈkʌmpəs/; [vt]环绕,包围;包含;完成; [^]z8;
encore: [-]/ˈɑːŋkɔːr/; [n]再演唱的要求,经要求而再唱; [v]要求再演或唱; [int]再来一个; [^]z8;
encroach: [-]/ɪnˈkroʊtʃ/; [v]侵犯,侵占;蚕食(on); [^]z8;
encumber: [-]/ɪnˈkʌmbər/; [v]阻塞,妨害,拖累; [^]z8;
endanger: [-]/ɪnˈdeɪndʒər/; [v]危及,危害; [^]z8;
endemic: [-]/enˈdemɪk/; [a]地方性的; [n]地方病; [^]z8;
endorse: [-]/ɪnˈdɔːrs/; [v]赞同,认可;签注(文件); [^]z8;
energize: [-]/ˈenərdʒaɪz/; [v]使活跃;给予精力;使兴奋; [^]z8;
enfold: [-]/ɪnˈfoʊld/; [v]拥抱,包裹,折叠; [^]z8;
engender: [-]/ɪnˈdʒendər/; [v]产生; [^]z8;
engross: [-]/ɪnˈɡroʊs/; [v]独占;正式誊写;使全神贯注于;用大字体书写; [^]z8;
enhance: [-]/ɪnˈhæns/; [v]提高(强度,力量,数量等);增加,加强; [^]z8;
enigma: [-]/ɪˈnɪɡmə/; [n]谜,哑谜;闷葫芦; [^]z8;
enigmatic: [-]/ˌenɪɡˈmætɪk/; [a]神秘的,高深莫测的,谜一般的; [^]z8;
enmity: [-]/ˈenməti/; [n]敌意,憎恨; [^]z8;
enormity: [-]/ɪˈnɔːrməti/; [n]巨大;暴行;极恶; [^]z8;
enrage: [-]/ɪnˈreɪdʒ/; [v]使狂怒,激怒; [^]z8;
ensconce: [-]/ɪnˈskɑːns/; [v]安置;安顿下来;使.隐藏; [^]z8;
ensemble: [-]/ɑːnˈsɑːmbl/; [n]合唱团,表演团体;总效果;全套服装;全套家具; [^]z8;
enshrine: [-]/ɪnˈʃraɪn/; [v]把.置于神龛内;铭记,珍藏;把.奉为神圣; [^]z8;
ensign: [-]/ˈensən/; [n]旗,海军少尉,徽章; [^]z8;
ensue: [-]/ɪnˈsuː/; [v]跟着发生,接踵而来;因而产生; [^]z8;
entangle: [-]/ɪnˈtæŋɡl/; [v]使纠缠,卷入; [^]z8;
entice: [-]/ɪnˈtaɪs/; [v]怂恿,引诱; [^]z8;
entourage: [-]/ˈɑːnturɑːʒ/; [n]随从,周围,环境; [^]z8;
entreat: [-]/ɪnˈtriːt/; [v]恳求,请求; [^]z8;
entree: [-]/ˈɑːntreɪ/; [n]进入,入场权,［美］主菜,(歌剧等)开始的乐章; [^]z8;
entrust: [-]/ɪnˈtrʌst/; [v]委托,托管; [^]z8;
entwine: [-]/ɪnˈtwaɪn/; [v]使缠绕,交织; [^]z8;
enumerate: [-]/ɪˈnuːməreɪt/; [v]列举; [^]z8;
ephemeral: [-]/ɪˈfemərəl/; [a]短暂的,短命的; [n]生存极短时间的事物; [^]z8;
epigram: [-]/ˈepɪɡræm/; [n]机智的言语; [^]z8;
epilogue: [-]/ˈepɪlɔːɡ/; [n]收场白;尾声; [^]z8;
epitaph: [-]/ˈepɪtæf/; [n]碑文,墓志铭; [^]z8;
epitome: [-]/ɪˈpɪtəmi/; [n]摘要,缩影; [^]z8;
epitomize: [-]/ɪˈpɪtəmaɪz/; [v]摘要;化身;成为.的缩影; [^]z8;
equable: [-]/ˈekwəbl/; [a]温和,平均,稳定的,不变的,(脾气)温和的; [^]z8;
equilibrium: [-]/ˌiːkwɪˈlɪbriəm/; [n](心态情感等)平静;平衡; [^]z8;
equinox: [-]/ˈiːkwɪnɑːks/; [n]春分;秋分;昼夜平分点; [^]z8;
equitable: [-]/ˈekwɪtəbl/; [a]公正的,公平的; [^]z8;
equivocal: [-]/ɪˈkwɪvəkl/; [a]模棱两可的,不明确的,可疑的; [^]z8;
erasure: [-]/ɪˈreɪʒər/; [n]消除,涂擦的痕迹,消磁; [^]z8;
erotic: [-]/ɪˈrɑːtɪk/; [a]性爱的,性欲的,色情的; [n]好色之徒; [ad]引起性欲地; [^]z8;
errant: [-]/ˈerənt/; [a]错误的,脱离正途的,迷路的;周游的,漂泊的;无定的; [n]游侠; [^]z8;
erratic: [-]/ɪˈrætɪk/; [a]古怪的;反复无常的,不稳定的; [^]z8;
erudite: [-]/ˈerudaɪt/; [a]博学的,有学问的; [n]饱学之士,有学问的人; [^]z8;
escalate: [-]/ˈeskəleɪt/; [v]逐步升高,逐步增强,加剧恶化; [^]z8;
eschew: [-]/ɪsˈtʃuː/; [v]避开;戒绝; [^]z8;
esoteric: [-]/ˌesəˈterɪk/; [a]秘传的,神秘的,限于少数人的; [n]受秘传的人; [^]z8;
espionage: [-]/ˈespiənɑːʒ/; [n]间谍活动,侦查,监视; [^]z8;
espouse: [-]/ɪˈspaʊz/; [v]支持,拥护; [^]z8;
estimable: [-]/ˈestɪməbl/; [a]可估计的;可尊敬的;有价值的; [^]z8;
estrange: [-]/ɪ'streɪndʒ/; [v]使疏远,离间; [^]z8;
etch: [-]/etʃ/; [n]蚀刻; [vi]蚀刻; [vt]蚀镂,蚀刻,描述,铭记; [^]z8;
ethereal: [-]/iˈθɪriəl/; [a]太空的,轻巧的,像空气的; [^]z8;
ethical: [-]/ˈeθɪkl/; [a]伦理的;道德的;凭处方出售的; [n]处方药; [^]z8;
ethics: [-]/'eθɪks/; [n]行为准则;道德规范; [^]z8;
ethos: [-]/ˈiːθɑːs/; [n]民族精神,气质,社会思潮; [^]z8;
etiquette: [-]/ˈetɪket/; [n]礼仪; [^]z8;
eulogy: [-]/ˈjuːlədʒi/; [n]颂词,赞美词; [^]z8;
euphemism: [-]/ˈjuːfəmɪzəm/; [n]婉言,委婉的说法; [^]z8;
euphoria: [-]/juːˈfɔːriə/; [n]幸福愉快感; [^]z8;
euthanasia: [-]/ˌjuːθəˈneɪʒə/; [n]安乐死,安乐死术; [^]z8;
evacuate: [-]/ɪˈvækjueɪt/; [v]撤离,疏散,排清; [^]z8;
evade: [-]/ɪˈveɪd/; [v]躲避,回避; [^]z8;
evanescent: [-]/ˌevəˈnesnt/; [a]短暂的,容易消散的,(印象等)逐渐消失的,会凋零的; [^]z8;
evangelical: [-]/ˌiːvænˈdʒelɪkl/; [a]福音的,热切的; [n]福音派信徒; [^]z8;
evasive: [-]/ɪˈveɪsɪv/; [a]逃避的;托辞的,推托的; [^]z8;
evict: [-]/ɪˈvɪkt/; [v]驱逐,逐出; [^]z8;
evince: [-]/ɪˈvɪns/; [v]表明,表示,引起; [^]z8;
evocative: [-]/ɪˈvɑːkətɪv/; [a]唤起的;唤出的; [^]z8;
evoke: [-]/ɪˈvoʊk/; [v]唤起;引起;使人想起; [^]z8;
evolutionary: [-]/ˌevəˈluːʃəneri/; [a]进化的,演进的; [^]z8;
ewe: [-]/juː/; [n]<畜牧>母羊; [^]z8;
exacerbate: [-]/ɪɡˈzæsərbeɪt/; [v]加重;恶化;激怒; [^]z8;
exalt: [-]/ɪɡˈzɔːlt/; [v]提升,提拔,赞扬,使得意; [^]z8;
exaltation: [-]/ˌeɡzɔːlˈteɪʃn/; [n]提升,提高,兴奋,得意洋洋; [^]z8;
exalted: [-]/ɪɡˈzɔːltɪd/; [a]尊贵的,高位的;兴奋的;高尚的; [^]z8;
exasperate: [-]/ɪɡˈzæspəreɪt/; [vt]激怒;加剧; [^]z8;
excavate: [-]/ˈekskəveɪt/; [v]挖掘,挖出;挖(空),挖(洞); [^]z8;
excerpt: [-]/ˈeksɜːrpt/; [n]摘录,节选; [v]摘,选;引用; [^]z8;
excise: [-]/ˈeksaɪz/; [v]切除,删去; [n]消费税,货物税,国产税; [^]z8;
execrable: [-]/ˈeksɪkrəbl/; [a]极坏的; [^]z8;
exemplary: [-]/ɪɡˈzempləri/; [a]模范的,可仿效的; [^]z8;
exemplify: [-]/ɪɡˈzemplɪfaɪ/; [v]举例说明;例示,是..的典范; [^]z8;
exhilarate: [-]/ɪɡˈzɪləreɪt/; [v]使高兴;使兴奋; [a]使人高兴的,令人兴奋的; [^]z8;
exhilarating: [-]/ɪɡˈzɪləreɪtɪŋ/; [a]令人高兴的; [v]使高兴;使兴奋; [^]z8;
exhort: [-]/ɪɡˈzɔːrt/; [vt]敦促,劝告; [vi]规劝,劝告; [^]z8;
existential: [-]/ˌeɡzɪˈstenʃəl/; [a]存在主义的,有关存在的,存在判断的; [^]z8;
exodus: [-]/ˈeksədəs/; [n]大批离去,成群外出; [^]z8;
exonerate: [-]/ɪɡˈzɑːnəreɪt/; [v]使免罪; [^]z8;
exotic: [-]/ɪɡˈzɑːtɪk/; [a]奇异的,珍奇的,来自异国的; [^]z8;
expansive: [-]/ɪkˈspænsɪv/; [a]广阔的,扩张的,豪爽的; [^]z8;
expectancy: [-]/ɪkˈspektənsi/; [n]期待;预期;期望的东西; [^]z8;
expectant: [-]/ɪkˈspektənt/; [a]期待的;怀孕的;预期中的; [n]期待者;候选; [^]z8;
expedient: [-]/ɪkˈspiːdiənt/; [n]权宜之计,手段; [a]有利的,方便的;权宜之计的; [^]z8;
expedite: [-]/ˈekspədaɪt/; [v]加快;促进;发出; [a]畅通的;迅速的;方便的; [^]z8;
expiry: [-]/ɪkˈspaɪəri/; [n]满期,逾期,呼气,终结; [^]z8;
exploit: [-]/ɪkˈsplɔɪt/; [v]剥削,利用;开发,开拓; [n]辉煌功绩; [^]z8;
exponent: [-]/ɪkˈspoʊnənt/; [n]<数>指数;典型;说明者,说明物; [a]说明的; [^]z8;
expound: [-]/ɪkˈspaʊnd/; [v]详细说明,解释,阐述; [^]z8;
expulsion: [-]/ɪkˈspʌlʃn/; [n]驱逐;开除; [^]z8;
expunge: [-]/ɪkˈspʌndʒ/; [v]删除; [^]z8;
expurgate: [-]/ˈekspərɡeɪt/; [v]净化,删去; [^]z8;
extant: [-]/ekˈstænt/; [a]现存的;显著的; [^]z8;
exterminate: [-]/ɪkˈstɜːrmɪneɪt/; [v]消灭,灭绝;根除; [^]z8;
extol: [-]/ɪkˈstoʊl/; [v]赞美,称赞,颂扬; [^]z8;
extort: [-]/ɪkˈstɔːrt/; [vt]敲诈,勒索; [^]z8;
extract: [-]/ɪkˈstrækt/; [v]取出;提取;摘录;设法得到;索取; [n]摘录;提出物; [^]z8;
extraction: [-]/ɪkˈstrækʃn/; [n]抽出,取出;家世,出身;抽出物; [^]z8;
extradite: [-]/ˈekstrədaɪt/; [v]引渡,获取.的引渡; [^]z8;
extrapolate: [-]/ɪkˈstræpəleɪt/; [v]进行推断; [^]z8;
extraterrestrial: [-]/ˌekstrətəˈrestriəl/; [a]地球外的,地球大气圈外的; [n]外星人,外星生物,宇航员; [^]z8;
extremity: [-]/ɪkˈstreməti/; [n]尽头,末端,极端;绝境;身体末端 (尤指手和脚);脚趾; [^]z8;
extricate: [-]/ˈekstrɪkeɪt/; [v]拯救,救出; [n]解脱;解脱者; [^]z8;
extrovert: [-]/ˈekstrəvɜːrt/; [v]变成外向性格;使成外向性格; [n]性格外向者; [a]性格外向的; [^]z8;
exuberant: [-]/ɪɡˈzuːbərənt/; [a](植物)茂盛的,(人)充满活力的; [^]z8;
exude: [-]/ɪɡˈzuːd/; [v]慢慢流出,四溢,渗出,散发; [^]z8;
exult: [-]/ɪɡˈzʌlt/; [v]狂喜,欢欣鼓舞; [^]z8;
eye-catching: [-]/ˈaɪ kætʃɪŋ/; [a]引人注目的;耀眼的; [^]z8;
fabricate: [-]/ˈfæbrɪkeɪt/; [v]建造,制造,伪造(文件等),捏造,编造(谎言,借口等); [^]z8;
facade: [-]/fəˈsɑːd/; [n]建筑物的正面,外表; [^]z8;
facet: [-]/ˈfæsɪt/; [n](多面体的)面,小平面;琢面,侧面; [vt]在.上琢面; [^]z8;
facing: [-]/ˈfeɪsɪŋ/; [n]饰面,衣服等的贴边; [^]z8;
faction: [-]/ˈfækʃn/; [n]派别,小集团,小派系;派系斗争,内讧; [^]z8;
fad: [-]/fæd/; [n]风尚,风行一时的东西; [a]极好的; [^]z8;
fairground: [-]/ˈferɡraʊnd/; [n]露天市场,举行赛会的场所; [^]z8;
falcon: [-]/ˈfælkən/; [n]猎鹰; [^]z8;
fallacious: [-]/fəˈleɪʃəs/; [a]谬误的,易误解的,虚妄的; [^]z8;
fallacy: [-]/ˈfæləsi/; [n]谬论,谬见;错误,谬误; [^]z8;
fallible: [-]/ˈfæləbl/; [a]会犯错的,易犯错的; [^]z8;
fallow: [-]/ˈfæloʊ/; [a]休耕的;不活跃的;休闲地,休闲的; [n]休耕地;休耕; [v]使(翻耕后的土地)休闲; [^]z8;
falsehood: [-]/ˈfɔːlshʊd/; [n]谬误,不真实,谎言,虚假; [^]z8;
falsify: [-]/ˈfɔːlsɪfaɪ/; [v]篡改,说谎; [^]z8;
falsity: [-]/ˈfɔːlsəti/; [n]谎言,不真实; [^]z8;
fanciful: [-]/ˈfænsɪfl/; [a]异想天开的;别出心裁的; [^]z8;
faraway: [-]/ˈfɑːrəweɪ/; [a]遥远的,久远的,恍惚的,朦胧的; [n]遥远的事物; [^]z8;
farce: [-]/fɑːrs/; [n]闹剧;胡闹;笑剧; [^]z8;
fastidious: [-]/fæˈstɪdiəs/; [a]难讨好的,爱挑剔的; [^]z8;
fatality: [-]/fəˈtæləti/; [n]死亡;宿命;致命性;不幸,灾祸; [^]z8;
fateful: [-]/ˈfeɪtfl/; [a]重大的;决定性的;宿命的; [^]z8;
fatuous: [-]/ˈfætʃuəs/; [a]愚昧而不自知的; [^]z8;
faucet: [-]/ˈfɔːsɪt/; [n]龙头,旋塞,(连接管子的)插口; [^]z8;
fauna: [-]/ˈfɔːnə/; [n]动物区系,动物群; [^]z8;
favoritism: [-]/'feɪvərɪtˌɪzəm/; [n]偏爱,偏袒; [^]z8;
fawn: [-]/fɔːn/; [v]奉承;生(小鹿或小动物); [n]小鹿;浅黄褐色; [^]z8;
faze: [-]/feɪz/; [v]打扰,折磨,使狼狈,使担忧; [^]z8;
feckless: [-]/ˈfekləs/; [a]不负责任的,无目标无计划的,无效的; [ad]没有价值地;没有长远目标地;不负责任地; [n]没有价值,没有长远目标,不负责任; [^]z8;
fecund: [-]/ˈfiːkənd/; [a]肥沃的;多产的;丰饶的;生殖力旺盛的; [^]z8;
feign: [-]/feɪn/; [v]假装,装作; [^]z8;
feint: [-]/feɪnt/; [v]佯攻,虚击; [n]佯攻; [a]虚假的; [^]z8;
felicity: [-]/fəˈlɪsəti/; [n]幸福,快乐,幸运; [^]z8;
felony: [-]/ˈfeləni/; [n]重罪; [^]z8;
fence: [-]/fens/; [n]篱笆,围栏,栅栏; [v]击剑;用篱笆围住;束缚; [^]z8;
fend: [-]/fend/; [v](靠自己)照顾,照料;保护;力争; [^]z8;
fender: [-]/ˈfendər/; [n]火炉围栏;挡泥板,防护板;(汽车的)保险杠; [^]z8;
ferocity: [-]/fəˈrɑːsəti/; [n]凶猛,残暴; [^]z8;
ferret: [-]/ˈferɪt/; [n]雪貂;白鼬;侦探; [v]搜寻;查获;驱出;用雪貂猎取; [a]雪貂似的;搜索者般的;爱窥探的; [^]z8;
fervent: [-]/ˈfɜːrvənt/; [a]热烈的,满怀热情的;狂热的; [^]z8;
fervor: [-]/ˈfɜrvər/; [n]强烈感情,激情,热情; [^]z8;
fester: [-]/ˈfestər/; [v]溃烂;化脓;使..痛苦;使..恶化; [n]溃烂;脓疮,脓疱; [^]z8;
festive: [-]/ˈfestɪv/; [a]庆祝的,喜庆的,欢乐的,节日似的; [^]z8;
festivity: [-]/feˈstɪvəti/; [n]欢庆,欢宴,庆典,欢乐; [^]z8;
fetid: [-]/ˈfetɪd/; [a]有恶臭的; [^]z8;
fetter: [-]/ˈfetər/; [n]脚镣;束缚; [vt]给.上脚镣;束缚; [^]z8;
fetus: [-]/ˈfiːtəs/; [n]胎儿; [^]z8;
feud: [-]/fjuːd/; [n]不和;争执;封地; [v]长期不和,长期争斗; [^]z8;
feverish: [-]/ˈfiːvərɪʃ/; [a]发烧的;狂热的,极其兴奋的;不稳定的; [^]z8;
fiasco: [-]/fiˈæskoʊ/; [n]大失败,惨败; [^]z8;
fickle: [-]/ˈfɪkl/; [a](在感情等方面)反复无常的,轻浮的,善变的; [^]z8;
fictitious: [-]/fɪkˈtɪʃəs/; [a]虚构的; [^]z8;
fidget: [-]/ˈfɪdʒɪt/; [v]坐立不安; [n]烦躁之人,烦躁; [a]坐立不安的,不安定的,为琐事操心的; [^]z8;
fieldwork: [-]/ˈfiːldwɜːrk/; [n]现场工作,野外工作; [^]z8;
fiend: [-]/fiːnd/; [n]恶魔;能手;..迷; [^]z8;
fig: [-]/fɪɡ/; [n]无花果;无花果树;少许,一些;无价值的东西;服装; [vt]打扮;使马跑快; [^]z8;
figment: [-]/ˈfɪɡmənt/; [n]空想;虚构的理论,故事等; [^]z8;
figurative: [-]/ˈfɪɡərətɪv/; [a]比喻的,修饰丰富的,形容多的; [^]z8;
figurehead: [-]/ˈfɪɡjərhed/; [n]名义领袖; [^]z8;
filial: [-]/ˈfɪliəl/; [a]子女的,孝顺的;<生物>子代的,后代的; [ad]子女地; [^]z8;
fillet: [-]/fɪˈleɪ/; [n]肉片;头带;平边;饰线; [v]用带缚;把.切成片; [^]z8;
finalist: [-]/ˈfaɪnəlɪst/; [n]参加决赛的选手; [^]z8;
finely: [-]/ˈfaɪnli/; [ad]细小地;美好地; [^]z8;
finery: [-]/ˈfaɪnəri/; [n]服饰,华丽的服饰,鲜艳服装,装饰; [^]z8;
finesse: [-]/fɪˈnes/; [n]技巧,计谋,策略; [v]以技巧取胜; [^]z8;
fingertip: [-]/ˈfɪŋɡərtɪp/; [n]指尖;指套; [^]z8;
finicky: [-]/ˈfɪnɪki/; [a]苛求的,过份讲究的; [^]z8;
fiscal: [-]/ˈfɪskl/; [a]会计的;财政的;国库的; [^]z8;
fishery: [-]/ˈfɪʃəri/; [n]渔场;养鱼场所; [^]z8;
fissure: [-]/ˈfɪʃər/; [v]裂开,龟裂; [n]裂缝,裂隙; [^]z8;
fitful: [-]/ˈfɪtfl/; [a]发作的,间歇的,不定的; [^]z8;
fixture: [-]/ˈfɪkstʃər/; [n]固定装置;体育项目; [^]z8;
flabby: [-]/ˈflæbi/; [a](肌肉)松软的,意志薄弱的; [ad]肌肉松垂地,肥胖地; [n](肌肉等)不结实,松弛; [^]z8;
flaccid: [-]/ˈflæsɪd/; [a]软弱的,无活力的,没气力的,松弛的; [^]z8;
flag: [-]/flæɡ/; [v](以旗子)标出,标记;疲乏,热情衰减; [n]国旗,旗帜; [^]z8;
flagrant: [-]/ˈfleɪɡrənt/; [a]罪恶昭彰的,残暴的,丑恶可耻的,明目张胆的; [^]z8;
flair: [-]/fler/; [n]天资,特别的本领;敏锐的洞察力;嗜好;格调; [^]z8;
flak: [-]/flæk/; [n]高射炮,抨击,谴责; [^]z8;
flamboyant: [-]/flæmˈbɔɪənt/; [a]辉耀的;华丽的,艳丽的;火焰似的; [^]z8;
flank: [-]/flæŋk/; [v]位于.的侧面; [n]肋,肋腹,侧翼; [^]z8;
flare: [-]/fler/; [v]燃烧(摇曳着);突然发怒; [n]照明弹;摇曳的火焰;闪光信号; [^]z8;
flaunt: [-]/flɔːnt/; [n]招摇;飘扬;藐视; [vi]炫耀;飘扬; [vt]炫耀; [^]z8;
flavoring: [-]/ˈfleɪvərɪŋ/; [n]调味品; [^]z8;
flawless: [-]/ˈflɔːləs/; [a]完美的,无瑕疵的; [^]z8;
flax: [-]/flæks/; [n]亚麻,亚麻纤维; [a]亚麻科; [^]z8;
fleck: [-]/flek/; [n]斑点,斑纹;雀斑;微粒,小片; [v]使起斑点;使有斑纹; [^]z8;
fleeting: [-]/ˈfliːtɪŋ/; [a]短暂的,飞逝的; [^]z8;
flex: [-]/fleks/; [v]弯曲;伸缩;屈曲;(使)收缩; [n]花线;弯曲;弹性;电线;松紧带; [a]弹性工作制的; [^]z8;
flicker: [-]/ˈflɪkər/; [v]闪烁,摇曳;颤动;扑动翅膀;假装昏倒; [n]闪烁,闪光; [^]z8;
flighty: [-]/ˈflaɪti/; [a]轻浮的;轻狂的;心情浮动的,容易激动的;(马等)易惊的; [^]z8;
flimsy: [-]/ˈflɪmzi/; [a]轻而薄的,脆弱的,没有价值的,不足信的; [^]z8;
flinch: [-]/flɪntʃ/; [v]畏缩,退缩; [n]退缩,畏惧; [^]z8;
flip: [-]/flɪp/; [v]把.往上抛;掷;抽打;用指轻弹;空翻; [a]轻率的,无礼的; [^]z8;
flippant: [-]/ˈflɪpənt/; [a]无礼的,轻率的,随意的; [^]z8;
flirt: [-]/flɜːrt/; [n]急扔;调情者; [vi]卖弄风情,调情;戏弄,不认真地对待;摆动; [vt]急速摆动,挥动; [^]z8;
flit: [-]/flɪt/; [n]轻快的飞行;迁移; [vi]掠过;轻快地飞过;偷偷溜走;去世; [^]z8;
flop: [-]/flɑːp/; [vt]重重地摔落; [vi]惨败;扑通落下; [n]失败; [ad]扑通一声; [^]z8;
floral: [-]/ˈflɔːrəl/; [a]花的,像花的;植物区系的; [n]以花占主要的图片或设计; [^]z8;
florid: [-]/ˈflɔːrɪd/; [a]涨红的,华丽的,红润的; [^]z8;
florist: [-]/ˈflɔːrɪst/; [n]花商,种花者,花卉研究者; [^]z8;
flounder: [-]/ˈflaʊndər/; [n]比目鱼;踉跄前进; [v]踉跄前行;(在水或泥浆中)挣扎,陷入困境; [^]z8;
flout: [-]/flaʊt/; [n]表示轻蔑的言行;嘲弄;嘲笑; [vi]藐视;嘲弄;嘲笑; [vt]嘲弄;嘲笑;藐视; [^]z8;
fluke: [-]/fluːk/; [n]侥幸成功;意外的挫折; [v]侥幸做成;意外受挫; [^]z8;
flunk: [-]/flʌŋk/; [v]考试不及格; [n]失败,不及格; [^]z8;
flurry: [-]/ˈflɜːri/; [n]阵雪,慌张; [v]慌张,激动; [^]z8;
flux: [-]/flʌks/; [n]流动,不断的变动; [^]z8;
foible: [-]/ˈfɔɪbl/; [n]弱点,小缺点,癖好; [^]z8;
foil: [-]/fɔɪl/; [n]箔;锡箔纸;衬托; [v]挫败;使受挫折; [^]z8;
fold: [-]/foʊld/; [v]折叠;彻底失败;合拢; [n]折叠;褶; [^]z8;
folklore: [-]/ˈfoʊklɔːr/; [n]民俗学,民间传说;民间看法;民俗; [^]z8;
fondle: [-]/ˈfɑːndl/; [v]抚弄,抚摸; [^]z8;
foolproof: [-]/ˈfuːlpruːf/; [a]万无一失的,简单的,肯定成功的; [^]z8;
foothold: [-]/ˈfʊthoʊld/; [n]立足点,根据地; [^]z8;
footloose: [-]/ˈfʊtluːs/; [a]自由自在的,无拘束的,到处走动的; [^]z8;
forage: [-]/ˈfɔːrɪdʒ/; [v]搜寻,翻寻,觅食; [n](牛马的)饲料,粮草; [^]z8;
foray: [-]/ˈfɔːreɪ/; [n]突袭;首次尝试;短途旅行; [v]袭击; [^]z8;
forbidding: [-]/fərˈbɪdɪŋ/; [a]可怕的,令人生畏的;(表情)冷峻的;形势险恶的; [^]z8;
forceps: [-]/ˈfɔːrseps/; [n]钳子,镊子,手术钳; [^]z8;
forebode: [-]/foʊr'boʊd/; [v]预示,预兆,预言; [^]z8;
foreboding: [-]/fɔːrˈboʊdɪŋ/; [n]预感,预兆; [a]预感的,不祥之兆的; [^]z8;
foreground: [-]/ˈfɔːrɡraʊnd/; [n]前景,最显著的位置; [v]强调; [^]z8;
forensic: [-]/fəˈrensɪk/; [a]科学手段的,法庭的,辩论的; [n]辩论练习;辩论学,辩论术; [^]z8;
forerunner: [-]/ˈfɔːrʌnər/; [n]先驱;祖先;前兆;预兆; [^]z8;
foreshadow: [-]/fɔːrˈʃædoʊ/; [v]预示; [n]预兆; [^]z8;
forestall: [-]/fɔːrˈstɔːl/; [v]领先;占先一步;先发制人,阻止,妨碍;垄断;占先一步; [^]z8;
forge: [-]/fɔːrdʒ/; [n]熔炉;锻工车间;铁匠店; [v]锻造;经锻炼而形成;伪造;推进,加强; [^]z8;
forgo: [-]/fɔːrˈɡoʊ/; [v]放弃;停止;对.断念; [^]z8;
forlorn: [-]/fərˈlɔːrn/; [a]被遗弃的; [^]z8;
formative: [-]/ˈfɔːrmətɪv/; [a]形成的;造形的;影响发展的;造型的;格式化的; [n]构词要素; [^]z8;
formulate: [-]/ˈfɔːrmjuleɪt/; [v]构想出(计划,方法等);系统地阐述; [^]z8;
formulation: [-]/ˌfɔːrmjuˈleɪʃn/; [n]表述方式;构想,规划;公式化; [^]z8;
fornicate: [-]/ˈfɔːrnɪkeɪt/; [v]与..通奸,私通; [^]z8;
forsake: [-]/fərˈseɪk/; [v]放弃;抛弃,离开; [^]z8;
forte: [-]/fɔːrt/; [n]长处,特长; [a]强音的;响的; [ad]响亮地; [^]z8;
forthright: [-]/ˈfɔːrθraɪt/; [a]直接的,直率的,坦白的,豪爽的; [ad]马上,立即; [n]直路; [^]z8;
fortify: [-]/ˈfɔːrtɪfaɪ/; [v]设防于;增强; [^]z8;
fortuitous: [-]/fɔːrˈtuːɪtəs/; [a]偶然的;幸运的; [^]z8;
forum: [-]/ˈfɔːrəm/; [n]论坛;讨论会; [^]z8;
foul: [-]/faʊl/; [a]难闻的,发臭的;糟透了的;污秽的;犯规的; [n]犯规; [vi]犯规; [vt]弄脏,使污秽;使纠缠; [^]z8;
fractious: [-]/ˈfrækʃəs/; [a]易怒的;难以对待的;倔强的;好争吵的; [^]z8;
fracture: [-]/ˈfræktʃər/; [n]骨折;折断;裂口; [v]使折断;使骨折; [^]z8;
franchise: [-]/ˈfræntʃaɪz/; [n]特许(经营权),公民权,选举权; [v]赋予特权,赋予公民权; [^]z8;
frantic: [-]/ˈfræntɪk/; [a]疯狂的;狂乱的;慌乱的; [^]z8;
fraternal: [-]/frəˈtɜːrnl/; [a]兄弟的,兄弟般的,友爱的; [^]z8;
fraudulent: [-]/ˈfrɔːdʒələnt/; [a]欺诈的,欺骗性的,骗得的; [^]z8;
fraught: [-]/frɔːt/; [a]担心的,忧虑的;充满.的; [n]货物,装载物; [vt]装货于; [^]z8;
fray: [-]/freɪ/; [n]吵架,打斗,磨损处; [v]磨损,摩擦,使关系紧张; [^]z8;
freak: [-]/friːk/; [n]怪人,怪物,奇事; [a]反常的,怪诞的; [vt]使强烈反应(震惊;畏惧); [vi]在药物影响下变得异乎寻常; [^]z8;
freckle: [-]/ˈfrekl/; [n]雀斑;斑点; [^]z8;
freelance: [-]/ˈfriːlæns/; [ad]作为自由职业者地; [a]自由投稿的; [vi]当自由职业者; [^]z8;
freighter: [-]/ˈfreɪtər/; [n]<水运><船>货船;承运人; [^]z8;
frenetic: [-]/frəˈnetɪk/; [a]狂乱的;非常激动的; [n]疯子;狂人; [^]z8;
frenzy: [-]/ˈfrenzi/; [n]狂暴;狂怒,暴怒;疯狂,迷乱; [v]使发狂,使狂怒; [^]z8;
fresco: [-]/ˈfreskoʊ/; [n]壁画;壁画法; [v]在..上做壁画;用壁画法画出; [^]z8;
fret: [-]/fret/; [v]使烦恼,使焦急;使腐蚀;使磨损; [n](斑卓琴,吉他,曼陀林琴等弦乐器指板上定音的)档;侵蚀; [^]z8;
frigid: [-]/ˈfrɪdʒɪd/; [a]寒冷的,冷淡的,死板的,呆板的,性冷淡的; [^]z8;
frisk: [-]/frɪsk/; [v]搜身;蹦跳,欢跃; [n]欢跃,蹦跳,快活的时刻; [^]z8;
frivolity: [-]/frɪˈvɑːləti/; [n]轻浮;轻佻;轻薄的话(或举动); [^]z8;
frivolous: [-]/ˈfrɪvələs/; [a]轻佻的,不重要的,缺乏基础的; [^]z8;
frock: [-]/frɑːk/; [n]僧袍;(妇女,小儿的连衣裙式)长衣; [^]z8;
frolic: [-]/ˈfrɑːlɪk/; [n]嬉闹; [v]嬉戏,雀跃; [a]嬉戏的,欢乐的; [^]z8;
frontal: [-]/ˈfrʌntl/; [a]额的,正面的,前面的; [n]额骨,额部,房屋的正面; [^]z8;
froth: [-]/frɔːθ/; [n]泡沫,泡;口沫; [v]吐白沫;起泡沫; [^]z8;
fruition: [-]/fruˈɪʃn/; [n]享有;最后完成,实现,取得成果; [^]z8;
fry: [-]/fraɪ/; [v]油煎;油炸; [n]鱼苗,鱼秧;弗赖伊(姓氏);油炸食物;(口语)烦恼,愤激; [a]油炸的,油煎的(fried); [^]z8;
fugitive: [-]/ˈfjuːdʒətɪv/; [a]逃亡的,易逝的; [n]逃犯,逃亡者; [^]z8;
fumble: [-]/ˈfʌmbl/; [v]摸索,笨拙地做,漏球; [n]摸索,笨拙的处理,漏球; [a]笨拙的;迟疑的; [^]z8;
funk: [-]/fʌŋk/; [n]恐慌,怯懦,早期爵士乐; [vt](因恐惧)避开(某事物);害怕;使闻到刺鼻的味道; [vi]畏缩;发出刺鼻臭味; [^]z8;
furrow: [-]/ˈfɜːroʊ/; [n]犁沟,皱纹; [v]犁田,开沟,犁出浪迹; [^]z8;
furtive: [-]/ˈfɜːrtɪv/; [a]偷偷的,秘密的,鬼鬼祟祟的,; [^]z8;
fuse: [-]/fjuːz/; [n]导火线,引信,保险丝; [v](使)因保险丝熔断而中断工作,熔合,合并; [^]z8;
fuzz: [-]/fʌz/; [n]绒毛,模糊,细毛,警员; [vi]作绒毛状飞散,变成绒毛状,变得模糊; [vt]使模糊,起毛; [^]z8;
gabble: [-]/ˈɡæbl/; [n]急促不清的话,胡言乱语; [vi]急促而不清楚地说,闲聊,啰嗦,喋喋不休地说; [vt]急促而不清楚地说,胡说八道; [^]z8;
gag: [-]/ɡæɡ/; [n]塞口物,随口科白,打诨,箝口物,言论,讨论终结; [v]塞物于..的口中,禁止,使窒息,使呕吐,欺骗,作呕; [^]z8;
gaiety: [-]/ˈɡeɪəti/; [n]欢乐,快活,庆祝活动,(服饰)华丽,艳丽; [^]z8;
gallant: [-]/ˈɡælənt/; [a]勇敢的;(男子对女子)殷勤的; [v]向(女子)献殷勤;护卫;求爱; [n](尤指对女子殷勤的)时髦男子; [^]z8;
galvanize: [-]/ˈɡælvənaɪz/; [v]镀锌,通电,刺激; [^]z8;
gambit: [-]/ˈɡæmbɪt/; [n](常指带风险的)策略,弃兵局(指国际象棋开局弃一卒以取得优势),话题,开始,开场白; [^]z8;
gape: [-]/ɡeɪp/; [n]裂口,张嘴,打哈欠; [v]目瞪口呆地凝视,打哈欠,张开,裂开; [^]z8;
garland: [-]/ˈɡɑːrlənd/; [n]花环; [vt]戴花环; [^]z8;
gastric: [-]/ˈɡæstrɪk/; [a]胃的,胃部的; [^]z8;
gastritis: [-]/ɡæˈstraɪtɪs/; [n]<医>胃炎; [^]z8;
gauge: [-]/ɡeɪdʒ/; [n]测量仪;尺度,标准; [v]估计,判断;计量; [^]z8;
gaunt: [-]/ɡɔːnt/; [a]憔悴的,瘦削的; [n]憔悴,荒凉; [^]z8;
gazette: [-]/ɡəˈzet/; [n]报纸; [v]在报上刊载; [^]z8;
generate: [-]/ˈdʒenəreɪt/; [v]产生(热,电等能量),创造; [^]z8;
generic: [-]/dʒəˈnerɪk/; [n]无注册商标产品;通名; [a]一般的;非商标的;属的,类的; [^]z8;
genesis: [-]/ˈdʒenəsɪs/; [n](事物的)起源,发生; [^]z8;
genial: [-]/ˈdʒiːniəl/; [a]愉快的,脾气好的,友好的; [^]z8;
genteel: [-]/dʒenˈtiːl/; [a]有教养的,文雅的;高雅的;假斯文的,装作体面的; [^]z8;
gentility: [-]/dʒenˈtɪləti/; [n]上流阶层;文雅;有教养; [^]z8;
germinate: [-]/ˈdʒɜːrmɪneɪt/; [v]发芽,发展,生长; [^]z8;
gesticulate: [-]/dʒeˈstɪkjuleɪt/; [vt]用手势表达,用姿势,表示; [vi](讲话时)做手势; [n]做手势,做示意动作,手势; [^]z8;
ghastly: [-]/ˈɡæstli/; [a]苍白的,可怕的,令人不快的; [ad]恐怖地,惨白地; [^]z8;
gibberish: [-]/ˈdʒɪbərɪʃ/; [n]乱语;快速而不清楚的言语; [^]z8;
gibbon: [-]/ˈɡɪbən/; [n]长臂猿; [^]z8;
giddy: [-]/ˈɡɪdi/; [a]眼花缭乱的,头晕的,轻率的; [v](使)眼花,(使)眩晕; [^]z8;
gill: [-]/ɡɪl/; [n]鳃,菌褶; [vi]被刺网缠住; [vt]用刺网捕,取出(鱼的)鳃和内脏; [^]z8;
gimmick: [-]/ˈɡɪmɪk/; [n]吸引人的花招,噱头; [vt]用暗机关改变或影响; [^]z8;
girder: [-]/ˈɡɜːrdər/; [n]<建>大梁;纵梁;撑住; [^]z8;
girdle: [-]/ˈɡɜːrdl/; [n]腰带;妇女紧身褡; [v]围,包围,环绕; [^]z8;
glacial: [-]/ˈɡleɪʃl/; [a]冰的;冰冷的;冰河时代的; [^]z8;
gladiator: [-]/ˈɡlædieɪtər/; [n]职业格斗者;角斗士,斗剑者; [^]z8;
glaze: [-]/ɡleɪz/; [n](浇在糕点上的)糖浆,蛋浆,釉;<气>雨淞; [v](眼睛)变呆滞;浇浆汁于 (食物) 表面;给.安装玻璃; [^]z8;
glean: [-]/ɡliːn/; [v]收集(资料); [^]z8;
glee: [-]/ɡliː/; [n]欢喜,高兴; [^]z8;
gloat: [-]/ɡloʊt/; [v]幸灾乐祸地看,窃喜; [^]z8;
gloss: [-]/ɡlɑːs/; [n]光泽;假象;唇膏; [vt]使有光彩;掩盖; [^]z8;
glossary: [-]/ˈɡlɑːsəri/; [n]词汇表,术语汇编; [^]z8;
glum: [-]/ɡlʌm/; [a]闷闷不乐的,阴郁的; [n]闷闷不乐;忧郁; [^]z8;
glutton: [-]/ˈɡlʌtn/; [n]贪吃者,对..贪婪的人; [^]z8;
gnarled: [-]/nɑːrld/; [a]多节的,粗糙的;多瘤的;弯曲的; [^]z8;
gobble: [-]/ˈɡɑːbl/; [v]狼吞虎咽;急急抓住,任意花完;如饥似渴地阅读;发出雄火鸡般的咯咯叫声; [n](火鸡的)咯咯声; [^]z8;
goggle: [-]/ˈɡɑːɡl/; [n]眼睛睁视,风镜,护目镜; [a]睁眼的,瞪眼的; [v]眼珠转动,瞪眼看,使瞪眼; [^]z8;
goody: [-]/ˈɡʊdi/; [n]好吃的东西;吸引人的东西,好东西; [int]太好啦; [^]z8;
gorge: [-]/ɡɔːrdʒ/; [n]峡谷;胃;暴食;咽喉;障碍物; [v]拼命吃;吞下,狼吞虎咽;塞满,填满; [^]z8;
gospel: [-]/ˈɡɑːspl/; [n]教义,信条;福音书; [a]传播福音的;福音赞美诗的; [^]z8;
graffiti: [-]/ɡrəˈfiːti/; [n]乱涂乱写; [v]在.上涂鸦; [^]z8;
graft: [-]/ɡræft/; [n]嫁接;嫁接株;移植; [vi]接枝; [vt]将.嫁接;移植(器官); [^]z8;
grandeur: [-]/ˈɡrændʒər/; [n]壮观,宏伟,庄严; [^]z8;
grandiose: [-]/ˈɡrændioʊs/; [a]浮夸的,夸大的,宏伟的; [^]z8;
granular: [-]/ˈɡrænjələr/; [a]粒状的,含颗粒的; [^]z8;
granule: [-]/ˈɡrænjuːl/; [n]颗粒,微粒,粒状斑点; [^]z8;
grapple: [-]/ˈɡræpl/; [v]抓住;格斗; [n]抓住;格斗; [^]z8;
grate: [-]/ɡreɪt/; [n]壁炉;格栅; [v]磨碎,使人烦燥; [^]z8;
gratify: [-]/ˈɡrætɪfaɪ/; [v]使高兴,使满足; [^]z8;
gratuitous: [-]/ɡrəˈtuːɪtəs/; [a]无根据的,无理由的,无报酬的,免费的,多余的; [^]z8;
gravel: [-]/ˈɡrævl/; [n]沙砾,小石,砾石; [a]粗重而沙哑的,刺耳的; [vt]用砾石铺;使困惑; [^]z8;
gravitate: [-]/ˈɡrævɪteɪt/; [v]受引力作用;被吸引; [^]z8;
gregarious: [-]/ɡrɪˈɡeriəs/; [a]群居的,爱社交的; [^]z8;
grid: [-]/ɡrɪd/; [n]格子,地图坐标; [^]z8;
grievance: [-]/ˈɡriːvəns/; [n]牢骚,委屈,抱怨; [^]z8;
grievous: [-]/ˈɡriːvəs/; [a]悲痛的,痛苦的,可叹的,痛心的,剧烈的,严重的,难忍的; [^]z8;
gripe: [-]/ɡraɪp/; [n]控制,发牢骚,肠绞痛; [v]抱怨,发牢骚; [^]z8;
grisly: [-]/ˈɡrɪzli/; [a]恐怖的;令人震惊的;厉害的; [^]z8;
grotesque: [-]/ɡroʊˈtesk/; [a]奇形怪状的,奇异的; [n]奇形怪状的人(或物,图案等);奇异风格; [^]z8;
grove: [-]/ɡroʊv/; [n]小树林;果园; [^]z8;
grovel: [-]/ˈɡrɑːvl/; [v]摇尾乞怜;奴颜婢膝;匍匐; [^]z8;
gruesome: [-]/ˈɡruːsəm/; [a]阴森的;可怕的; [^]z8;
gruff: [-]/ɡrʌf/; [a]粗暴的,粗哑的,脾气坏的; [vt]粗鲁地说,生硬地说; [vi]粗鲁地说,生硬地说话; [^]z8;
grumpy: [-]/ˈɡrʌmpi/; [a]脾气暴躁的,性情乖戾的; [n]脾气坏的人,爱抱怨的人; [^]z8;
guise: [-]/ɡaɪz/; [n]外观,姿态,装束,伪装; [v]伪装; [^]z8;
gush: [-]/ɡʌʃ/; [v]涌出;滔滔不绝地说,洋洋洒洒地写; [n]迸发; [^]z8;
gusto: [-]/ˈɡʌstoʊ/; [n]由衷的高兴;爱好,嗜好; [^]z8;
hack: [-]/hæk/; [n]砍,劈;出租马车;出租车; [vt]砍,乱劈;胡乱删改;<计算机>(熟练地编辑或修改)程序;非法侵入(他人计算机系统); [a]出租的;用旧了的;(文人等)被雇佣的;雇佣文人做的; [^]z8;
hackneyed: [-]/ˈhæknid/; [a]陈腐的,平常的; [^]z8;
haggard: [-]/ˈhæɡərd/; [a]憔悴的,消瘦的; [n]哈格德;未驯服的鹰;悍鹰; [^]z8;
haggle: [-]/ˈhæɡl/; [n]讨价还价; [v]争论,讨价还价; [^]z8;
hairdo: [-]/ˈherduː/; [n]发型; [^]z8;
hale: [-]/heɪl/; [a]矍铄的(尤指老人);强壮的; [ad]完全地; [v]迫使;猛拉;不断流出; [^]z8;
hallmark: [-]/ˈhɔːlmɑːrk/; [n]特点;品质证明; [v]给.盖上品质证明印记;使具有.标志; [^]z8;
hallowed: [-]/ˈhæloʊd/; [a]神圣的; [^]z8;
hallucination: [-]/həˌluːsɪˈneɪʃn/; [n]幻觉,幻想; [^]z8;
halo: [-]/ˈheɪloʊ/; [n](日月等)晕;神像之光环; [vt]使有晕轮;围以光环; [vi]成晕轮; [^]z8;
hamlet: [-]/ˈhæmlət/; [n]小村庄;哈姆雷特; [^]z8;
hamper: [-]/ˈhæmpər/; [v]阻碍,妨碍,牵制; [n](有盖的)大篮子; [^]z8;
hamstring: [-]/ˈhæmstrɪŋ/; [n]腿筋; [v]切断腿筋使成跛腿;使无效; [^]z8;
handicraft: [-]/ˈhændikræft/; [n]手工艺;手工制品; [^]z8;
handily: [-]/ˈhændɪli/; [ad]方便地,敏捷地,灵巧地; [^]z8;
handiwork: [-]/ˈhændiwɜːrk/; [n]手工艺,手工制品,行为后果; [^]z8;
handsomely: [-]/ˈhænsəmli/; [ad]漂亮地,慷慨地,相当大地; [^]z8;
handstand: [-]/ˈhændstænd/; [n]手倒立; [^]z8;
hangar: [-]/ˈhæŋər/; [n]飞机库; [^]z8;
hanger: [-]/ˈhæŋər/; [n]衣架,挂衣钩; [^]z8;
hangnail: [-]/ˈhæŋneɪl/; [n]手指头的倒拉刺(指甲旁的逆刺皮); [^]z8;
hangover: [-]/ˈhæŋoʊvər/; [n]宿醉; [^]z8;
hanker: [-]/ˈhæŋkər/; [vi]渴望,追求; [^]z8;
haphazard: [-]/hæpˈhæzərd/; [a]偶然的;随意的;凑合的;胡乱的; [^]z8;
harangue: [-]/həˈræŋ/; [n]长篇大论; [v]高谈阔论;大声训斥; [^]z8;
harass: [-]/həˈræs/; [v]使困扰,使烦恼,反复袭击; [^]z8;
harbinger: [-]/ˈhɑːrbɪndʒər/; [n]先驱,先兆; [vt]预告;充做.的前驱; [^]z8;
hardheaded: [-]/'hɑːd'hedɪd/; [a]现实的,精明的,顽固的; [^]z8;
harmonica: [-]/hɑːrˈmɑːnɪkə/; [n]口琴; [^]z8;
harmonize: [-]/ˈhɑːrmənaɪz/; [v]使调和,使一致; [^]z8;
harness: [-]/ˈhɑːrnɪs/; [n]挽具,马具,降落伞背带; [v]上挽具;治理(河流等);利用; [^]z8;
harp: [-]/hɑːrp/; [n]竖琴; [v]不停地说,喋喋不休; [^]z8;
harpoon: [-]/hɑːrˈpuːn/; [n](捕鲸的)鱼叉; [vt]用鱼叉叉;用鱼叉捕获; [^]z8;
harrow: [-]/ˈhæroʊ/; [n]耙; [v]耙地,使苦恼,被耙松; [^]z8;
harrowing: [-]/ˈhæroʊɪŋ/; [a]悲痛的,难受的; [^]z8;
hassle: [-]/ˈhæsl/; [vt]找麻烦,搅扰;与.争辩;使.烦恼; [n]困难,麻烦;激战; [vi]争论,争辩; [^]z8;
hatchback: [-]/ˈhætʃbæk/; [n]［美］有可向上开启天窗的汽车背部; [^]z8;
hatchery: [-]/ˈhætʃəri/; [n]孵卵处,孵化场; [^]z8;
hatchet: [-]/ˈhætʃɪt/; [n]短柄小斧; [vt]扼杀; [a]瘦削而棱角分明的; [^]z8;
haven: [-]/ˈheɪvn/; [n]港湾;避难所; [vt]为.提供庇护所; [^]z8;
haversack: [-]/ˈhævərsæk/; [n]干粮袋,背袋; [^]z8;
havoc: [-]/ˈhævək/; [n](天灾,战争等造成的)大破坏,大毁灭; [vi]损毁; [vt]严重破坏; [^]z8;
haze: [-]/heɪz/; [n]阴霾;薄雾;疑惑,迷糊; [v](使)变朦胧;(使)变糊涂; [^]z8;
hazel: [-]/ˈheɪzl/; [n]淡褐色;榛子; [a]淡褐色的;榛树的; [^]z8;
headdress: [-]/ˈheddres/; [n]头巾,头饰; [^]z8;
headstrong: [-]/ˈhedstrɔːŋ/; [a]任性的;顽固的; [^]z8;
heady: [-]/ˈhedi/; [a]兴奋的,任性的,性急的,顽固的,使人头晕的; [^]z8;
hearsay: [-]/ˈhɪrseɪ/; [n]传闻,谣言; [a]传闻的,风闻的; [^]z8;
hearten: [-]/ˈhɑːrtn/; [v]激励,鼓励,(使)振作; [^]z8;
heathen: [-]/ˈhiːðn/; [n]无宗教信仰者,异教徒; [a]不信神的,未开化的,异教徒的,异国的; [^]z8;
heckle: [-]/ˈhekl/; [v]诘问,困扰; [n]麻梳;梳理;<印>针排; [^]z8;
hectic: [-]/ˈhektɪk/; [a]紧张的,忙碌的;患肺病的;(因患肺病等)发烧的,有病态潮红的;脸上发红,发热的,兴奋的,狂热的,肺病的; [^]z8;
hector: [-]/ˈhektər/; [v]凌辱,威吓; [n]暴徒,威吓者,作威作福的人; [^]z8;
hedonism: [-]/ˈhiːdənɪzəm/; [n]享乐主义; [^]z8;
hedonist: [-]/ˈhiːdənɪst/; [n]享乐主义者,［心］欢乐主义者; [a]享乐主义者的; [^]z8;
heed: [-]/hiːd/; [vt]注意;留心; [v]注意; [vi]留心; [n]注意;留心; [^]z8;
hefty: [-]/ˈhefti/; [a]重的,肌肉发达的,异常大的; [ad]强有力地,非常; [n]体格健壮的人; [^]z8;
hegemony: [-]/hɪˈdʒemoʊni/; [n]霸权,领导权; [^]z8;
heinous: [-]/ˈheɪnəs/; [a]可憎的;极凶恶的; [^]z8;
heirloom: [-]/ˈerluːm/; [n]传家宝,祖传遗物; [a](植物)原种的(通常指过去大量种植,但已不再作为经济作物而种植的植物); [^]z8;
helium: [-]/ˈhiːliəm/; [n]<化学>氦(元素符号He); [^]z8;
helm: [-]/helm/; [n]舵;驾驶盘;领导地位; [v]指挥;给..掌舵; [^]z8;
hemlock: [-]/ˈhemlɑːk/; [n]铁杉,常青树; [^]z8;
henpecked: [-]/ˈhenpekt/; [a]妻管严,怕老婆的; [^]z8;
hepatitis: [-]/ˌhepəˈtaɪtɪs/; [n]肝炎; [^]z8;
herbivorous: [-]/ɜːrˈbɪvərəs/; [a]食草的; [^]z8;
hereafter: [-]/ˌhɪrˈæftər/; [ad]今后,从此以后; [n]将来,来世; [^]z8;
hereditary: [-]/həˈredɪteri/; [a]世袭的,遗传的; [^]z8;
heredity: [-]/həˈredəti/; [n]遗传;遗传特征; [^]z8;
heresy: [-]/ˈherəsi/; [n]异端邪说;异教; [^]z8;
heretic: [-]/ˈherətɪk/; [n]异教徒,持异端者; [a]异端的,异教的; [^]z8;
heretical: [-]/həˈretɪkl/; [a]异端的,异教的; [^]z8;
hermetic: [-]/hɜːrˈmetɪk/; [a]密封的;与外界隔绝的;不透气的;炼金术的; [^]z8;
hermitage: [-]/ˈhɜːrmɪtɪdʒ/; [n]隐士生活;隐士住处; [^]z8;
heterogeneous: [-]/ˌhetərəˈdʒiːniəs/; [a]多相的,异种的,不均匀的,由不同成分形成的; [^]z8;
hew: [-]/hjuː/; [v]砍伐;劈;遵守,坚持; [^]z8;
heyday: [-]/ˈheɪdeɪ/; [n]全盛期; [int]嘿(表喜悦或惊奇等); [^]z8;
hiatus: [-]/haɪˈeɪtəs/; [n]空隙,裂缝,中断; [^]z8;
hibernate: [-]/ˈhaɪbərneɪt/; [vi]冬眠,蛰居; [^]z8;
hiccup: [-]/ˈhɪkʌp/; [n]打嗝,小问题; [v]打嗝; [^]z8;
hidebound: [-]/ˈhaɪdbaʊnd/; [a]死板的,顽固的,墨守成规的; [^]z8;
hierarchical: [-]/ˌhaɪəˈrɑːrkɪkl/; [a]分等级的; [^]z8;
hierarchy: [-]/ˈhaɪərɑːrki/; [n]阶层,等级制度; [^]z8;
highness: [-]/ˈhaɪnəs/; [n]殿下,阁下,高度,高位,高尚,高贵; [^]z8;
hike: [-]/haɪk/; [n]远足,徒步旅行;(数量,价格等)增加,上升; [v]作长途徒步旅行;使高涨,提高(价格); [^]z8;
hilarious: [-]/hɪˈleriəs/; [a]有趣的;令人捧腹的;滑稽的;欢闹的; [^]z8;
hillock: [-]/ˈhɪlək/; [n]小丘,小山似的一堆; [^]z8;
hilt: [-]/hɪlt/; [n]刀把,柄; [vt]给.装柄; [^]z8;
hiss: [-]/hɪs/; [n]嘶嘶声;发嘘声; [vi]发出嘶嘶声; [vt]嘶嘶地发出;发嘘声让(某人)别做声; [^]z8;
histrionic: [-]/ˌhɪstriˈɑːnɪk/; [a]戏剧的,装腔作势的,作戏的; [n]演员;戏剧表演;舞台艺术;戏剧似的言行; [^]z8;
hive: [-]/haɪv/; [n]蜂房,忙碌之地; [v]分开,隔开; [^]z8;
hoard: [-]/hɔːrd/; [v]贮藏,秘藏; [n]贮藏物; [^]z8;
hoary: [-]/ˈhɔːri/; [a]年纪高迈的;(头发等)灰白的;古老的; [^]z8;
hoax: [-]/hoʊks/; [n]骗局;恶作剧; [vt]愚弄;欺骗; [^]z8;
hobble: [-]/ˈhɑːbl/; [v]蹒跚,跛行; [n]跛行;韵律不全的诗;马的脚绊;〈口,方〉困境; [^]z8;
hobgoblin: [-]/ˈhɑːbɡɑːblɪn/; [n]妖怪; [^]z8;
holiness: [-]/ˈhoʊlinəs/; [n]神圣,圣座(大写,对教宗等的尊称); [^]z8;
holly: [-]/ˈhɑːli/; [n]冬青树(等于holm oak); [a]冬青属植物的; [^]z8;
holocaust: [-]/ˈhɑːləkɔːst/; [n]大屠杀,浩劫; [^]z8;
holster: [-]/ˈhoʊlstər/; [n]手枪皮套; [^]z8;
homage: [-]/ˈhɑːmɪdʒ/; [n]敬意;尊敬;效忠; [^]z8;
homestead: [-]/ˈhoʊmsted/; [n]家园; [^]z8;
homicide: [-]/ˈhɑːmɪsaɪd/; [n]杀人,杀人者; [^]z8;
homogeneous: [-]/ˌhoʊməˈdʒiːniəs/; [a]同类的,同质的,有相同特征的; [^]z8;
homogenize: [-]/həˈmɑdʒəˌnaɪz/; [vi]变均匀; [vt]使均匀,使类同; [^]z8;
homosexual: [-]/ˌhoʊməˈsekʃuəl/; [a]同性恋的; [n]同性恋; [^]z8;
honeycomb: [-]/ˈhʌnikoʊm/; [n]蜜蜂巢; [vt]使成蜂巢状;把.弄得千疮百孔; [a]似蜂巢的; [vi]变成蜂巢状; [^]z8;
honk: [-]/hɑːŋk/; [n]雁叫声,汽车喇叭声; [vi]发雁鸣或汽车喇叭声; [vt]按汽车喇叭; [^]z8;
hoodwink: [-]/ˈhʊdwɪŋk/; [v]欺骗,遮眼,蒙蔽; [^]z8;
hooligan: [-]/ˈhuːlɪɡən/; [n]流氓,歹徒; [^]z8;
hooray: [-]/huˈreɪ/; [int]万岁; [^]z8;
horde: [-]/hɔːrd/; [n]一大群,群,游牧部落; [v]成群;结成部落而居; [^]z8;
hormone: [-]/ˈhɔːrmoʊn/; [n]荷尔蒙,激素; [^]z8;
hornet: [-]/ˈhɔːrnɪt/; [n]大黄蜂; [^]z8;
horoscope: [-]/ˈhɔːrəskoʊp/; [n]占星术,星象,十二宫图; [^]z8;
horrendous: [-]/həˈrendəs/; [a]可怕的,令人惊惧的; [^]z8;
horrid: [-]/ˈhɔːrɪd/; [a]可怕的,恐怖的,极讨厌的; [^]z8;
horrific: [-]/həˈrɪfɪk/; [a]可怖的,令人恐惧的,极其可怕的; [^]z8;
horseshoe: [-]/ˈhɔːrʃʃuː/; [n]马蹄铁,U形物; [vt]装蹄铁于; [^]z8;
horsewhip: [-]/ˈhɔːrswɪp/; [n]马鞭; [vt]用马鞭鞭打,惩罚; [^]z8;
horticulture: [-]/ˈhɔːrtɪkʌltʃər/; [n]园艺;园艺学; [^]z8;
hospice: [-]/ˈhɑːspɪs/; [n]收容所,旅客招待所,救济院; [^]z8;
hotbed: [-]/ˈhɑːtbed/; [n]温床,滋长地; [^]z8;
hovel: [-]/ˈhʌvl/; [n]茅舍,肮脏的小屋; [^]z8;
howler: [-]/ˈhaʊlər/; [n]嚎叫的人或动物,滑稽可笑的错误; [^]z8;
hub: [-]/hʌb/; [n]轴心,中心;木片; [^]z8;
hubbub: [-]/ˈhʌbʌb/; [n]嘈杂,喧哗; [^]z8;
huckster: [-]/ˈhʌkstər/; [v]叫卖,讨价还价; [n]叫卖的小贩,小商人,零售商; [^]z8;
hue: [-]/hjuː/; [n]色彩;色度,颜色;叫声; [^]z8;
hulk: [-]/hʌlk/; [n]废船;笨重的人或物; [vi]赫然显现;<英口>笨拙地挪动; [^]z8;
hulking: [-]/ˈhʌlkɪŋ/; [a]笨重的; [^]z8;
hull: [-]/hʌl/; [n](果实等的)外壳,船体; [v]剥壳; [^]z8;
humdrum: [-]/ˈhʌmdrʌm/; [a]单调的;乏味的; [n]平凡;单调; [vi]单调乏味地进行; [^]z8;
humility: [-]/hjuːˈmɪləti/; [n]谦逊,谦恭; [^]z8;
hump: [-]/hʌmp/; [n]驼峰;小园丘,峰丘; [v](使)隆起,弓起; [^]z8;
humus: [-]/ˈhjuːməs/; [n]腐殖质,腐植土; [^]z8;
hunch: [-]/hʌntʃ/; [n]预感,大块,肉峰; [vt]耸肩,预感到,弯腰驼背; [vi]隆起,向前移动; [^]z8;
hunk: [-]/hʌŋk/; [n]大块,有魅力的健壮男子; [^]z8;
hurdle: [-]/ˈhɜːrdl/; [n]跳栏,障碍; [v]用篱笆围; [^]z8;
hurtle: [-]/ˈhɜːrtl/; [v]猛冲,猛烈碰撞,使冲向; [n]碰撞;碰撞声;猛冲; [^]z8;
husbandry: [-]/ˈhʌzbəndri/; [n]饲养;务农,耕种;家政; [^]z8;
husk: [-]/hʌsk/; [n]外壳,皮;无价值之物; [v]削皮;以粗哑的嗓音说; [^]z8;
hutch: [-]/hʌtʃ/; [n]笼,小屋,贮藏箱,矿车; [vt]把.装箱; [^]z8;
hybrid: [-]/ˈhaɪbrɪd/; [n]杂种,混血儿,混合物; [a]混合的;杂种的; [^]z8;
hydrant: [-]/ˈhaɪdrənt/; [n]消防栓,消防龙头; [^]z8;
hydraulic: [-]/haɪˈdrɔːlɪk/; [a]水力的,水压的; [^]z8;
hydrocarbon: [-]/ˌhaɪdrəˈkɑːrbən/; [n]碳氢化合物,烃; [^]z8;
hype: [-]/haɪp/; [n]大肆宣传; [v]大肆宣传;使.兴奋; [^]z8;
hypertension: [-]/ˌhaɪpərˈtenʃn/; [n]［医］高血压,过度紧张; [^]z8;
hyphen: [-]/ˈhaɪfn/; [n]连词号,连字符; [vt]以连字号连接; [^]z8;
hypnosis: [-]/hɪpˈnoʊsɪs/; [n]催眠,催眠状态; [^]z8;
hypnotic: [-]/hɪpˈnɑːtɪk/; [n]安眠药; [a]催眠的,令人着迷的; [^]z8;
hypocrisy: [-]/hɪˈpɑːkrəsi/; [n]虚伪;伪善; [^]z8;
hypodermic: [-]/ˌhaɪpəˈdɜːrmɪk/; [a]皮下注射的; [n]皮下注射器; [^]z8;
hypotenuse: [-]/haɪˈpɑːtənuːs/; [n](直角三角形的)斜边; [^]z8;
hypothesis: [-]/haɪˈpɑːθəsɪs/; [n]假说;假设; [^]z8;
icicle: [-]/ˈaɪsɪkl/; [n]冰柱,冰垂; [^]z8;
icing: [-]/ˈaɪsɪŋ/; [n]结冰,糖衣,酥皮; [v]冰冻; [^]z8;
icon: [-]/ˈaɪkɑːn/; [n]图标,肖像,偶像; [^]z8;
idiosyncrasy: [-]/ˌɪdiəˈsɪŋkrəsi/; [n]特殊癖性或行为; [^]z8;
idyllic: [-]/aɪˈdɪlɪk/; [a]田园短诗的,牧歌的,生动逼真的; [^]z8;
ignite: [-]/ɪɡˈnaɪt/; [v]点燃,发光,燃烧; [^]z8;
ignition: [-]/ɪɡˈnɪʃn/; [n]点火,着火;点火开关; [^]z8;
ignominy: [-]/ˈɪɡnəmɪni/; [n]耻辱,不体面,丑行; [^]z8;
illicit: [-]/ɪˈlɪsɪt/; [a]违法的,违禁的; [^]z8;
illustrious: [-]/ɪˈlʌstriəs/; [a]著名的,杰出的;辉煌的; [^]z8;
imagery: [-]/ˈɪmɪdʒəri/; [n]像,肖像,画像,雕像;意象;比喻;形象化的描述; [^]z8;
imbecile: [-]/ˈɪmbəsl/; [n]低能者,愚蠢的人; [a]低能的,愚笨的,虚弱的; [^]z8;
imbecility: [-]/ˌɪmbəˈsɪləti/; [n]愚钝,低能,愚蠢的行为或言语; [^]z8;
imbibe: [-]/ɪmˈbaɪb/; [v]喝,饮;吸收,接受; [^]z8;
immaculate: [-]/ɪˈmækjələt/; [a]完美的,无瑕疵的;洁净的; [^]z8;
immaterial: [-]/ˌɪməˈtɪriəl/; [a]非实体的,无关紧要的; [^]z8;
immerse: [-]/ɪˈmɜːrs/; [v]沉浸,沉浸于;使陷入; [^]z8;
immobile: [-]/ɪˈmoʊbl/; [a]不动的;不能活动的;不变的;静止的; [^]z8;
immune: [-]/ɪˈmjuːn/; [a]免疫的,有免疫力的;不受影响的;免除的; [^]z8;
impair: [-]/ɪmˈper/; [v]损害;削弱; [^]z8;
impale: [-]/ɪmˈpeɪl/; [v]刺穿,刺住; [^]z8;
impart: [-]/ɪmˈpɑːrt/; [v]传授,给予,将(某性质)给予或赋予某事物; [^]z8;
impartial: [-]/ɪmˈpɑːrʃl/; [a]公平的,不偏不倚的; [^]z8;
impasse: [-]/ˈɪmpæs/; [n]僵局;死路; [^]z8;
impassioned: [-]/ɪmˈpæʃnd/; [a]慷慨激昂的,充满激情的; [^]z8;
impassive: [-]/ɪmˈpæsɪv/; [a]无动于衷的,冷漠的; [^]z8;
impeccable: [-]/ɪmˈpekəbl/; [a]无瑕疵的,没有缺点的; [^]z8;
impede: [-]/ɪmˈpiːd/; [v]妨碍,阻碍; [^]z8;
impediment: [-]/ɪmˈpedɪmənt/; [n]妨碍,阻碍;障碍物;(言语)障碍;口吃; [^]z8;
impel: [-]/ɪmˈpel/; [v]推进,驱使; [^]z8;
impending: [-]/ɪmˈpendɪŋ/; [a]即将到来的;迫在眉睫的,紧急的; [^]z8;
impenetrable: [-]/ɪmˈpenɪtrəbl/; [a]难以渗透的,坚不可摧的; [^]z8;
imperceptible: [-]/ˌɪmpərˈseptəbl/; [a]极细微的,觉察不到的,感觉不到的,; [^]z8;
imperious: [-]/ɪmˈpɪriəs/; [a]傲慢的,专横的; [^]z8;
impersonate: [-]/ɪmˈpɜːrsəneɪt/; [v]模仿,扮演,人格化,拟人; [^]z8;
impertinent: [-]/ɪmˈpɜːrtnənt/; [a]不恰当的,粗鲁的; [^]z8;
impetuous: [-]/ɪmˈpetʃuəs/; [a]冲动的,鲁莽的; [^]z8;
impetus: [-]/ˈɪmpɪtəs/; [n]推动力;促进; [^]z8;
impinge: [-]/ɪmˈpɪndʒ/; [v]侵犯,撞击,碰撞; [^]z8;
impious: [-]/ɪmˈpaɪəs/; [a]不敬神的,不虔诚的,不孝的; [^]z8;
implacable: [-]/ɪmˈplækəbl/; [a]难以满足的,难平息的; [^]z8;
implant: [-]/ɪmˈplænt/; [v]嵌入,注入,灌输; [n]<医>植入物,植入管; [^]z8;
implicit: [-]/ɪmˈplɪsɪt/; [a]隐含的;盲目的;完全的,绝对的;成为一部分的; [^]z8;
implore: [-]/ɪmˈplɔːr/; [v]恳求; [^]z8;
impostor: [-]/ɪmˈpɑːstər/; [n]骗子;冒充者; [^]z8;
impotent: [-]/ˈɪmpətənt/; [a]无力的,无能的,阳痿的; [n]虚弱者;阳痿者; [^]z8;
impound: [-]/ɪmˈpaʊnd/; [v]没收,拘留; [^]z8;
impoverish: [-]/ɪmˈpɑːvərɪʃ/; [v]使成赤贫,使枯竭; [^]z8;
impregnable: [-]/ɪmˈpreɡnəbl/; [a]攻不破的,征服不了的; [^]z8;
impregnate: [-]/ɪmˈpreɡneɪt/; [v]使怀孕,使充满; [^]z8;
impressionable: [-]/ɪmˈpreʃənəbl/; [a]敏感的;易受影响的; [^]z8;
imprint: [-]/ɪmˈprɪnt/; [n]印痕;特征;版本说明; [vt]盖;铭刻; [^]z8;
impromptu: [-]/ɪmˈprɑːmptuː/; [a]一触即发的;即席的,即兴的; [ad]即席地,即兴地; [n]即兴之作; [^]z8;
improvise: [-]/ˈɪmprəvaɪz/; [v]即席创作,临时凑成; 随机应变; [^]z8;
imprudent: [-]/ɪmˈpruːdnt/; [a]轻率的,鲁莽的; [^]z8;
inadvertent: [-]/ˌɪnədˈvɜːrtənt/; [a]疏忽的,漫不经心的,无意中的; [^]z8;
inanimate: [-]/ɪnˈænɪmət/; [a]无生命的;无生气的; [^]z8;
inborn: [-]/ˌɪnˈbɔːrn/; [a]天生的;先天的; [^]z8;
incantation: [-]/ˌɪnkænˈteɪʃn/; [n]咒语; [^]z8;
incapacitate: [-]/ˌɪnkəˈpæsɪteɪt/; [v]使不能;使瘫痪;使无能力;使不适合; [^]z8;
incarnate: [-]/ɪnˈkɑːrnət/; [a]化身的,人体化的,肉色的; [v]体现,使.具体化,使实体化; [^]z8;
incarnation: [-]/ˌɪnkɑːrˈneɪʃn/; [n]赋与肉体,具人形,化身; [^]z8;
incendiary: [-]/ɪnˈsendieri/; [n]放火者,纵火者,燃烧弹,煽动者; [a]放火的,纵火的,能燃烧的,煽动性的; [^]z8;
incense: [-]/ˈɪnsens/; [n]焚香时的烟,香味; [v]激怒; [^]z8;
inception: [-]/ɪnˈsepʃn/; [n]起初;获得学位; [^]z8;
incessant: [-]/ɪnˈsesnt/; [a]无间断的,连续的; [^]z8;
incest: [-]/ˈɪnsest/; [n]乱伦,近亲通婚; [^]z8;
incinerate: [-]/ɪnˈsɪnəreɪt/; [v]焚化,毁弃; [^]z8;
incipient: [-]/ɪnˈsɪpiənt/; [a]初期的;刚出现的; [^]z8;
incise: [-]/ɪnˈsaɪz/; [v]切,切割;雕刻; [^]z8;
incisive: [-]/ɪnˈsaɪsɪv/; [a]一针见血的,敏锐的; [^]z8;
incite: [-]/ɪnˈsaɪt/; [v]刺激;煽动; [^]z8;
incoherent: [-]/ˌɪnkoʊˈhɪrənt/; [a]语无伦次的;不合逻辑的;不连贯的; [^]z8;
incoming: [-]/ˈɪnkʌmɪŋ/; [a]引入的,到来的,打入的; [n]进来,到来,收入; [^]z8;
incompatible: [-]/ˌɪnkəmˈpætəbl/; [a]不兼容的,矛盾的,不调和的; [^]z8;
incontrovertible: [-]/ˌɪnkɑːntrəˈvɜːrtəbl/; [a]无可争议的; [^]z8;
incredulous: [-]/ɪnˈkredʒələs/; [a]怀疑的,不轻信的; [^]z8;
incriminate: [-]/ɪnˈkrɪmɪneɪt/; [v]控告,暗示..有罪; [^]z8;
incubate: [-]/ˈɪŋkjubeɪt/; [v]孵卵; [^]z8;
incubation: [-]/ˌɪŋkjuˈbeɪʃn/; [n]孵化,孵卵,酝酿,培育,(传染病的)潜伏期; [^]z8;
incubator: [-]/ˈɪŋkjubeɪtər/; [n]孵卵器,保温箱,早产儿保育器,细菌培养器; [^]z8;
inculcate: [-]/ɪnˈkʌlkeɪt/; [v]灌输,谆谆教诲; [^]z8;
incumbent: [-]/ɪnˈkʌmbənt/; [n]在职者,现任者; [a]现任的;依靠的;负有职责的; [^]z8;
incur: [-]/ɪnˈkɜːr/; [v]遭受;招致;引起; [^]z8;
incursion: [-]/ɪnˈkɜːrʒn/; [n]入侵,侵犯; [^]z8;
indelible: [-]/ɪnˈdeləbl/; [a](印记等)无法擦除的,无法忘怀的; [^]z8;
indemnity: [-]/ɪnˈdemnəti/; [n]赔偿物;补偿,赔偿;保障; [^]z8;
indent: [-]/ɪnˈdent/; [v]切割成锯齿状;(书写)缩排,印刷;定货;印凹痕; [n]缩进;契约;订货单;凹痕; [^]z8;
indict: [-]/ɪnˈdaɪt/; [v]控诉,起诉; [^]z8;
indigenous: [-]/ɪnˈdɪdʒənəs/; [a]土生土长的,本土的; [^]z8;
indigestion: [-]/ˌɪndɪˈdʒestʃən/; [n]消化不良;不消化; [^]z8;
indiscriminate: [-]/ˌɪndɪˈskrɪmɪnət/; [a]任意的;不加区别的,不加选择的; [^]z8;
indisposed: [-]/ˌɪndɪˈspoʊzd/; [a]不舒服的,不愿意的,不合适的; [^]z8;
indisputable: [-]/ˌɪndɪˈspjuːtəbl/; [a]没有争论余地,非常清楚的; [^]z8;
indoctrinate: [-]/ɪnˈdɑːktrɪneɪt/; [v]灌输思想; [^]z8;
indolent: [-]/ˈɪndələnt/; [a]懒惰的,懒洋洋的; [^]z8;
ineluctable: [-]/ˌɪnɪˈlʌktəbl/; [a]不可改变的,无法逃避的; [^]z8;
inept: [-]/ɪˈnept/; [a]无能的;不称职的;笨拙的; [^]z8;
inexhaustible: [-]/ˌɪnɪɡˈzɔːstəbl/; [a]无穷无尽的,取之不竭的; [^]z8;
inexorable: [-]/ɪnˈeksərəbl/; [a]不为所动的,坚决不变的; [n]坚定不移的人; [^]z8;
inexplicable: [-]/ˌɪnɪkˈsplɪkəbl/; [a]无法解释的,难理解的,莫名其妙的; [^]z8;
infamous: [-]/ˈɪnfəməs/; [a]声名狼藉的,无耻的; [^]z8;
infantile: [-]/ˈɪnfəntaɪl/; [a]婴儿的,幼稚的,初期的; [^]z8;
infantry: [-]/ˈɪnfəntri/; [n]步兵,步兵团; [^]z8;
infatuated: [-]/ɪnˈfætʃueɪtɪd/; [a]入迷的,昏头昏脑的; [^]z8;
infernal: [-]/ɪnˈfɜːrnl/; [a]地狱的;恶魔的;可憎的; [^]z8;
infest: [-]/ɪnˈfest/; [v]骚扰,寄生于,大批出没; [^]z8;
infidelity: [-]/ˌɪnfɪˈdeləti/; [n]不忠实,不贞; [^]z8;
infiltrate: [-]/ˈɪnfɪltreɪt/; [v]渗入,潜入 (某地方或组织);(气,液)渗透; [n]渗透物; [^]z8;
infirm: [-]/ɪnˈfɜːrm/; [a]衰弱的;意志薄弱的;不坚固的; [^]z8;
infirmary: [-]/ɪnˈfɜːrməri/; [n]医院,医务室(尤指学校等附设的病房或配药处); [^]z8;
infirmity: [-]/ɪnˈfɜːrməti/; [n]虚弱; [^]z8;
inflame: [-]/ɪnˈfleɪm/; [v]使燃烧,激怒(某人); [^]z8;
inflamed: [-]/ɪnˈfleɪmd/; [a]发炎的,红肿的,激怒的,燃烧的; [^]z8;
inflammable: [-]/ɪnˈflæməbl/; [a]可燃的,易激怒的; [n]易燃物; [^]z8;
inflammation: [-]/ˌɪnfləˈmeɪʃn/; [n]<病理>炎症,<医>发炎,燃烧,发火; [^]z8;
inflammatory: [-]/ɪnˈflæmətɔːri/; [a]炎症性的;煽动性的;激动的; [^]z8;
inflection: [-]/ɪnˈflekʃn/; [n]弯曲,变形,音调变化; [^]z8;
inflexible: [-]/ɪnˈfleksəbl/; [a]顽固的;不可弯曲的;不屈挠的;不可改变的; [^]z8;
inflict: [-]/ɪnˈflɪkt/; [v]使遭受(损伤,痛苦等);使承担(负担等); [^]z8;
influx: [-]/ˈɪnflʌks/; [n]流入,涌入;河口; [^]z8;
infrared: [-]/ˌɪnfrəˈred/; [a]红外线的; [n]红外线; [^]z8;
infrastructure: [-]/ˈɪnfrəstrʌktʃər/; [n]基础设施; [^]z8;
infringe: [-]/ɪnˈfrɪndʒ/; [v]侵犯,违反,侵害; [^]z8;
infuriate: [-]/ɪnˈfjʊrieɪt/; [v]使(人)极为愤怒; [^]z8;
infuse: [-]/ɪnˈfjuːz/; [v]沏(茶),泡(草药);灌输;使充满; [^]z8;
ingratiating: [-]/ɪnˈɡreɪʃieɪtɪŋ/; [a]讨好的,谄媚的; [^]z8;
inhibit: [-]/ɪnˈhɪbɪt/; [v]阻碍;阻止,防止;抑制,约束; [^]z8;
injunction: [-]/ɪnˈdʒʌŋkʃn/; [n]<法>指令,禁令; [^]z8;
injurious: [-]/ɪnˈdʒʊriəs/; [a]有害的,造成伤害的; [^]z8;
inkling: [-]/ˈɪŋklɪŋ/; [n]轻微暗示,小提示,略知; [^]z8;
inmate: [-]/ˈɪnmeɪt/; [n]囚犯;(精神病院等中的)被收容者; [^]z8;
innate: [-]/ɪˈneɪt/; [a]与生俱来的,天生的; [^]z8;
inoculate: [-]/ɪˈnɑːkjuleɪt/; [v]<医>给..接种,给..注射预防针,<植>嫁接,灌输; [^]z8;
inoffensive: [-]/ˌɪnəˈfensɪv/; [a]无害的;不冒犯人的;不令人讨厌的,不引起反对的; [^]z8;
inordinate: [-]/ɪnˈɔːrdɪnət/; [a]过度的,无节制的;紊乱的; [^]z8;
inquisitive: [-]/ɪnˈkwɪzətɪv/; [a]好奇的,好打听的; [^]z8;
insanity: [-]/ɪnˈsænəti/; [n]疯狂;精神错乱,精神病;荒谬,愚蠢; [^]z8;
insatiable: [-]/ɪnˈseɪʃəbl/; [a]不能满足的,贪得无厌的; [^]z8;
insidious: [-]/ɪnˈsɪdiəs/; [a](暗中或逐渐)为害的; [^]z8;
insinuate: [-]/ɪnˈsɪnjueɪt/; [v]暗指,暗示; [^]z8;
insipid: [-]/ɪnˈsɪpɪd/; [a]淡而无味的;枯燥乏味的; [^]z8;
insolent: [-]/ˈɪnsələnt/; [a]傲慢的,粗鲁的,无礼的; [^]z8;
insomnia: [-]/ɪnˈsɑːmniə/; [n]失眠; [^]z8;
instantaneous: [-]/ˌɪnstənˈteɪniəs/; [a]瞬间的;即刻的;猝发的; [^]z8;
instigate: [-]/ˈɪnstɪɡeɪt/; [v]发起,煽动; [^]z8;
insular: [-]/ˈɪnsələr/; [a]岛屿的,与世隔绝的; [^]z8;
insulate: [-]/ˈɪnsəleɪt/; [v]隔离,使隔绝(以免受到影响);使隔热; [^]z8;
insuperable: [-]/ɪnˈsuːpərəbl/; [a]难以克服的,无敌的; [^]z8;
insurgent: [-]/ɪnˈsɜːrdʒənt/; [n]叛乱分子; [a]叛乱的,起事的; [^]z8;
insurmountable: [-]/ˌɪnsərˈmaʊntəbl/; [a]不能克服的,不能超越的,难以对付的; [^]z8;
insurrection: [-]/ˌɪnsəˈrekʃn/; [n]造反,叛乱; [^]z8;
intake: [-]/ˈɪnteɪk/; [n]吸入,收纳;纳入(数量); [^]z8;
intangible: [-]/ɪnˈtændʒəbl/; [a]不可捉摸的,无形的; [n]无形的东西; [^]z8;
integer: [-]/ˈɪntɪdʒər/; [n]整数;整体; [^]z8;
intelligible: [-]/ɪnˈtelɪdʒəbl/; [a]可理解的,明白易懂的; [^]z8;
interface: [-]/ˈɪntərfeɪs/; [n]界面;<地质>分界面,接触面; [v]相互作用(或影响);交流,交谈; [^]z8;
interject: [-]/ˌɪntərˈdʒekt/; [v]突然插入,插嘴; [^]z8;
interjection: [-]/ˌɪntərˈdʒekʃn/; [n]感叹词,插入语; [^]z8;
interlock: [-]/ˌɪntərˈlɑːk/; [v]连锁,连串; [n]〔电信〕结合;联锁装置;相关;联动; [^]z8;
interlocutor: [-]/ˌɪntərˈlɑːkjətər/; [n]对话者,谈话者; [^]z8;
interlude: [-]/ˈɪntərluːd/; [n]插曲;穿插;间歇;幕间节目; [^]z8;
intermediary: [-]/ˌɪntərˈmiːdieri/; [a]中间的;媒介的;中途的; [n]中间人;仲裁者;调解者;媒介物; [^]z8;
interminable: [-]/ɪnˈtɜːrmɪnəbl/; [a]没完没了的,无穷无尽的,冗长的; [^]z8;
intermingle: [-]/ˌɪntərˈmɪŋɡl/; [v]混合,搀杂; [^]z8;
intermittent: [-]/ˌɪntərˈmɪtənt/; [a]断断续续的,间歇的; [^]z8;
intern: [-]/ɪnˈtɜːrn/; [n]实习生;实习医师;被拘留者; [v]作实习医师;拘留; [^]z8;
interrogate: [-]/ɪnˈterəɡeɪt/; [v]审问,审讯; [^]z8;
intestinal: [-]/ɪnˈtestɪnl/; [a]肠的; [^]z8;
intimacy: [-]/ˈɪntɪməsi/; [n]亲密,亲近;亲昵行为;<婉>性行为;<婉辞>私通; [^]z8;
intimidate: [-]/ɪnˈtɪmɪdeɪt/; [v]恫吓,威胁; [^]z8;
intoxicant: [-]/ɪnˈtɑːksɪkənt/; [a]醉人的,麻醉的,沉醉的; [n]酒精饮料,麻醉品; [^]z8;
intoxicate: [-]/ɪnˈtɑːksɪkeɪt/; [v]使醉,使陶醉,使中毒; [a]陶醉的; [^]z8;
intractable: [-]/ɪnˈtræktəbl/; [a]棘手的;难治的;倔强的;不听话的; [^]z8;
intransigent: [-]/ɪnˈtrænzɪdʒənt/; [a]固执的,不妥协的,不让步的; [n]不妥协,不妥协的人; [^]z8;
intrepid: [-]/ɪnˈtrepɪd/; [a]无畏的;刚毅的,勇敢的; [^]z8;
intrigue: [-]/ɪnˈtriːɡ/; [n]阴谋;诡计; [v]密谋;欺骗;引起极大兴趣; [^]z8;
intriguing: [-]/ɪnˈtriːɡɪŋ/; [a]迷人的,有迷惑力的,引起兴趣(或好奇心)的; [^]z8;
intrinsic: [-]/ɪnˈtrɪnsɪk/; [a]固有的; [^]z8;
introvert: [-]/ˈɪntrəvɜːrt/; [v]使内翻,使内向,使内省; [n]内向的人,内弯(内翻)的东西; [^]z8;
intrusive: [-]/ɪnˈtruːsɪv/; [a]侵入的;打扰的; [^]z8;
intuition: [-]/ˌɪntuˈɪʃn/; [n]直觉;感觉; [^]z8;
intuitive: [-]/ɪnˈtuːɪtɪv/; [a]直觉的,凭直觉获知的; [^]z8;
inundate: [-]/ˈɪnʌndeɪt/; [v]淹没,泛滥; [^]z8;
invalidate: [-]/ɪnˈvælɪdeɪt/; [v]使无效;使无价值; [^]z8;
inveterate: [-]/ɪnˈvetərət/; [a]积习已深的,根深蒂固的,长期形成的; [^]z8;
invidious: [-]/ɪnˈvɪdiəs/; [a]惹人反感的,招人嫉妒的,令人厌恶的,诽谤的,不公平的; [^]z8;
invigilate: [-]/ɪnˈvɪdʒɪleɪt/; [v]监考;监视; [^]z8;
invigorate: [-]/ɪnˈvɪɡəreɪt/; [v]鼓舞;提神,使精力充沛; [a]生气勃勃的,精力充沛的,健壮的; [n]滋补;鼓舞; [^]z8;
invincible: [-]/ɪnˈvɪnsəbl/; [a]无敌的;不能征服的; [^]z8;
invocation: [-]/ˌɪnvəˈkeɪʃn/; [n]祈祷;咒语;(法权的)行驶; [^]z8;
invoice: [-]/ˈɪnvɔɪs/; [n]发票; [v]开发票;记清单; [^]z8;
invoke: [-]/ɪnˈvoʊk/; [v]调用,祈求,恳求,引起; [^]z8;
involuntary: [-]/ɪnˈvɑːlənteri/; [a]非自愿的,非出自本意的;无意识的,不自觉的; [^]z8;
invulnerable: [-]/ɪnˈvʌlnərəbl/; [a]无法伤害的;无懈可击的; [^]z8;
iodine: [-]/ˈaɪədaɪn/; [n]碘,碘酒; [^]z8;
ion: [-]/ˈaɪən/; [n]［物］离子; [^]z8;
irascible: [-]/ɪˈræsəbl/; [a]易怒的,性情暴躁的; [^]z8;
iris: [-]/ˈaɪrɪs/; [n]虹膜,鸢尾属植物; [^]z8;
irk: [-]/ɜːrk/; [v]使苦恼,使厌烦; [n]厌烦,厌倦; [^]z8;
irksome: [-]/ˈɜːrksəm/; [a]令人厌烦的,讨厌的; [^]z8;
irradiate: [-]/ɪˈreɪdieɪt/; [vt]照亮;扩散;启发; [vi]发光; [a]发光的; [^]z8;
irreconcilable: [-]/ɪˈrekənsaɪləbl/; [a]不能妥协的,不能和解的,不能协调的; [n]不能和解的人,(政治上的)死硬派; [^]z8;
irreparable: [-]/ɪˈrepərəbl/; [a]不能修复的;不可弥补的; [^]z8;
irrespective: [-]/ˌɪrɪˈspektɪv/; [a]不考虑的,不顾的; [^]z8;
irreverent: [-]/ɪˈrevərənt/; [a]不敬的,无礼的; [^]z8;
irreversible: [-]/ˌɪrɪˈvɜːrsəbl/; [a]不能翻转的;不可撤销的;不可逆的; [^]z8;
irrevocable: [-]/ɪˈrevəkəbl/; [a]不可改变的;不能取消的;不能挽回的; [^]z8;
irritant: [-]/ˈɪrɪtənt/; [a]刺激的,刺激性的; [n]<医>刺激物,刺激剂; [^]z8;
isotope: [-]/ˈaɪsətoʊp/; [n]同位素; [^]z8;
itch: [-]/ɪtʃ/; [n]发痒,渴望; [v]发痒,渴望; [^]z8;
iterate: [-]/ˈɪtəreɪt/; [vt]重申,重复,反复申说; [^]z8;
itinerant: [-]/aɪˈtɪnərənt/; [n]巡回工作者; [a]巡回的;流动的; [^]z8;
itinerary: [-]/aɪˈtɪnəreri/; [n]旅程,路线;旅行计划; [^]z8;
jagged: [-]/ˈdʒæɡɪd/; [a]锯齿状的,参差不齐的;锯齿状的; [^]z8;
jargon: [-]/ˈdʒɑːrɡən/; [n]行话,术语;黄锆石; [^]z8;
javelin: [-]/ˈdʒævlɪn/; [n]标枪,投枪; [^]z8;
jeer: [-]/dʒɪr/; [n]嘲笑,戏弄,揶揄的言语; [v]嘲笑,戏弄; [^]z8;
jellyfish: [-]/ˈdʒelifɪʃ/; [n]水母,海蜇; [^]z8;
jeopardize: [-]/ˈdʒepərdaɪz/; [v]危及,损害(也作jeopardise); [^]z8;
jest: [-]/dʒest/; [n]笑话,俏皮话;玩笑; [v]开玩笑;嘲笑; [^]z8;
jigsaw: [-]/ˈdʒɪɡsɔː/; [n]拼图游戏,竖锯; [vt]用竖锯锯,使互相交错搭接; [^]z8;
jingle: [-]/ˈdʒɪŋɡl/; [n](硬币,铃铛等发出的)叮当声;含有轻松而有节奏的韵律的诗篇; [v]发出叮当声; [^]z8;
jocular: [-]/ˈdʒɑːkjələr/; [a]搞笑的,欢乐的; [^]z8;
jog: [-]/dʒɑːɡ/; [v]慢跑;轻碰; [n]轻推,慢跑,漫步; [^]z8;
jolt: [-]/dʒoʊlt/; [n]猛的一击,摇晃,震惊; [v](使)颠簸,摇晃;使震惊; [^]z8;
jubilant: [-]/ˈdʒuːbɪlənt/; [a]喜悦的,欢呼的; [^]z8;
judicious: [-]/dʒuˈdɪʃəs/; [a]有判断力的;明智的; [^]z8;
juggle: [-]/ˈdʒʌɡl/; [v]玩杂耍;同时做;对.巧妙应付; [^]z8;
jumble: [-]/ˈdʒʌmbl/; [n]混杂;混乱;待义卖的一堆旧什物; [v]使混乱;搞乱; [^]z8;
jumbo: [-]/ˈdʒʌmboʊ/; [a]巨大的,特大的; [n]体大而笨拙的人或物;大型喷气式客机;庞然大物; [^]z8;
juncture: [-]/ˈdʒʌŋktʃər/; [n]连接;交接处,交界;关键时刻;形势; [^]z8;
jurisdiction: [-]/ˌdʒʊrɪsˈdɪkʃn/; [n]司法权,审判权;管辖权;权限,权力; [^]z8;
juror: [-]/ˈdʒʊrər/; [n]审查委员,陪审员; [^]z8;
juvenile: [-]/ˈdʒuːvənl/; [n]青少年;雏鸟; [a]青少年的;幼稚的; [^]z8;
juxtapose: [-]/ˌdʒʌkstəˈpoʊz/; [v]使并排;使并置;使并列; [^]z8;
kennel: [-]/ˈkenl/; [n]狗窝;一群狗;阴沟; [v]使住在狗窝,进狗窝; [^]z8;
kernel: [-]/ˈkɜːrnl/; [n]子粒,谷粒;核心; [^]z8;
kin: [-]/kɪn/; [n]亲属; [^]z8;
kindred: [-]/ˈkɪndrəd/; [n]亲戚,家族,亲属关系,相似; [a]有血缘关系的,同宗的,同源的,类似的; [^]z8;
kinship: [-]/ˈkɪnʃɪp/; [n]<法>亲属关系,家属关系;亲密关系; [^]z8;
kiwi: [-]/ˈkiːwiː/; [n]猕猴桃,奇异果; [a]〈非正式〉与新西兰或新西兰人有关的; [^]z8;
knack: [-]/næk/; [n]诀窍;本领;熟练技术;巧妙手法; [^]z8;
knead: [-]/niːd/; [v]揉捏,塑造; [^]z8;
laborious: [-]/ləˈbɔːriəs/; [a]费时费力的,辛苦的;艰苦的; [^]z8;
lacquer: [-]/ˈlækər/; [n]漆器;天然漆; [v]涂漆; [^]z8;
lagoon: [-]/ləˈɡuːn/; [n]泻湖,环礁湖,咸水湖; [^]z8;
lament: [-]/ləˈment/; [v]哀悼;惋惜;悲叹; [n]悲叹;悼词; [^]z8;
lance: [-]/læns/; [n]长矛; [v]以长矛攻击; [^]z8;
languid: [-]/ˈlæŋɡwɪd/; [a]没精打采的,倦怠的; [^]z8;
languish: [-]/ˈlæŋɡwɪʃ/; [v]凋萎,衰弱,变得消瘦; [^]z8;
lapse: [-]/læps/; [n]失误,过失;行为失检;(时间)流逝; [v]退步,倒退,衰退;失效;背弃,放弃(宗教信仰); [^]z8;
laryngitis: [-]/ˌlærɪnˈdʒaɪtɪs/; [n]喉炎; [^]z8;
larynx: [-]/ˈlærɪŋks/; [n]喉; [^]z8;
latch: [-]/lætʃ/; [n]闩,碰锁,弹簧锁; [v]用闩把..闩上; [^]z8;
lateral: [-]/ˈlætərəl/; [n]侧面部分;支线; [a]侧面的;横向的; [^]z8;
lathe: [-]/leɪð/; [n]车床; [^]z8;
laurel: [-]/ˈlɔːrəl/; [n]月桂树,桂冠,殊荣; [v]使戴桂冠;给以荣誉; [^]z8;
lavish: [-]/ˈlævɪʃ/; [a]奢华的;铺张浪费的; [v]浪费;慷慨给予; [^]z8;
lawsuit: [-]/ˈlɔːsuːt/; [n]诉讼,诉讼案件; [^]z8;
lax: [-]/læks/; [a]松懈的;松弛的;<语>松弛元音的; [n]松元音;泻肚; [^]z8;
ledge: [-]/ledʒ/; [n]暗礁;突出部分; [^]z8;
ledger: [-]/ˈledʒər/; [n]账簿;总账;(手脚架上的)横木;<会计>分类账; [^]z8;
leeway: [-]/ˈliːweɪ/; [n]［海］［空］风压差;余地; [^]z8;
legendary: [-]/ˈledʒənderi/; [a]传说的;传奇的; [n]传说集;圣徒传; [^]z8;
legible: [-]/ˈledʒəbl/; [a]清晰的;易读的;易辨认的; [^]z8;
legislate: [-]/ˈledʒɪsleɪt/; [v]立法,制定法律; [^]z8;
lenience: [-]/'liːnɪəns/; [n]宽大,温和; [^]z8;
lenient: [-]/ˈliːniənt/; [a]宽大的,宽容的,仁慈的; [^]z8;
lesbian: [-]/ˈlezbiən/; [n]女性同性恋者; [a]女同性恋的;女同性恋者的; [^]z8;
lethal: [-]/ˈliːθl/; [a]致命的,致死的;杀伤性的; [n]致死因子; [^]z8;
leverage: [-]/ˈlevərɪdʒ/; [n]杠杆作用;杠杆效率; [v]举债经营;借贷收购;利用; [^]z8;
levity: [-]/ˈlevəti/; [n]轻率,轻浮,多变,不稳定; [^]z8;
lexical: [-]/ˈleksɪkl/; [a]词汇的,词典的; [^]z8;
lieu: [-]/luː/; [n]代替;场所; [^]z8;
liken: [-]/ˈlaɪkən/; [v]把..比作,比拟; [^]z8;
likeness: [-]/ˈlaɪknəs/; [n]相像,相似;画像,写真; [^]z8;
lilac: [-]/ˈlaɪlək/; [n]淡紫色,丁香花; [a]淡紫色的; [^]z8;
lineage: [-]/ˈlɪniɪdʒ/; [n]血统,世系,门第,宗族;传承; [^]z8;
liquidate: [-]/ˈlɪkwɪdeɪt/; [vt]清理,清算,停业清理;清偿,清理,清算(破产的公司等),变卖,杀戮,废除; [^]z8;
literal: [-]/ˈlɪtərəl/; [a]字面上的;照字面的;缺乏想像力的; [^]z8;
literate: [-]/ˈlɪtərət/; [a]受过教育的;精通文学的; [n]学者; [^]z8;
litigation: [-]/ˌlɪtɪˈɡeɪʃn/; [n]诉讼;起诉; [^]z8;
livid: [-]/ˈlɪvɪd/; [a]气急败坏的,铅色的; [^]z8;
loathe: [-]/loʊð/; [v]憎恨,厌恶; [^]z8;
lobe: [-]/loʊb/; [n]耳垂,波瓣,(脑,肺等的)叶,裂片; [^]z8;
loft: [-]/lɔːft/; [n]阁楼,顶楼; [v]把.储放在阁楼内;将球高击;发射(人造卫星等); [^]z8;
logistics: [-]/ləˈdʒɪstɪks/; [n]后勤,后勤学,物流; [^]z8;
loiter: [-]/ˈlɔɪtər/; [v]虚度,闲荡,徘徊,走走停停; [^]z8;
loll: [-]/lɑːl/; [vi]懒洋洋地倚靠;闲荡; [vt]懒洋洋地倚靠着;使悬垂; [^]z8;
lookout: [-]/ˈlʊkaʊt/; [n]眺望台;守望,看守,警戒,守望者,看守者; [^]z8;
loophole: [-]/ˈluːphoʊl/; [n]漏洞;枪眼;换气孔;射弹孔; [vt]钻空子;开孔; [^]z8;
lopsided: [-]/ˌlɑːpˈsaɪdɪd/; [a]不平衡的,倾向一方的; [^]z8;
lotion: [-]/ˈloʊʃn/; [n]洗液,洗涤剂; [^]z8;
lousy: [-]/ˈlaʊzi/; [a]蹩脚的,糟糕的,不清洁的; [^]z8;
lubricant: [-]/ˈluːbrɪkənt/; [n]润滑剂,润滑油; [a]润滑的; [^]z8;
lucid: [-]/ˈluːsɪd/; [a]明晰的;透明的;易懂的;头脑清楚的; [^]z8;
lucrative: [-]/ˈluːkrətɪv/; [a]合算的;获利的;有利可图的; [^]z8;
ludicrous: [-]/ˈluːdɪkrəs/; [a]荒谬的,可笑的,滑稽的; [^]z8;
lug: [-]/lʌɡ/; [n]耳状物;把手;笨家伙; [v]拖拉; [^]z8;
lull: [-]/lʌl/; [v]使平静,使安静,哄骗; [n]间歇,暂停,暂时平静; [^]z8;
lullaby: [-]/ˈlʌləbaɪ/; [n]催眠曲,摇篮曲,轻柔的声音; [v]唱催眠曲使入睡; [^]z8;
luminous: [-]/ˈluːmɪnəs/; [a]发光的;鲜艳的;明亮的;夜光的; [^]z8;
lunacy: [-]/ˈluːnəsi/; [n]精神失常,愚蠢的行为; [^]z8;
lunge: [-]/lʌndʒ/; [n]突然刺(入);突然向前冲〔扑等);套马索; [v](用剑等)刺,戳;猛向前冲,猛扑; [^]z8;
lurch: [-]/lɜːrtʃ/; [n]突然倾斜,挫折,举步蹒跚,徘徊,困境; [v]惨败,倾斜,徘徊,击败; [^]z8;
lure: [-]/lʊr/; [v]引诱;以诱饵吸引; [n]诱惑力;诱惑物;鱼饵; [^]z8;
lurk: [-]/lɜːrk/; [n]潜伏,潜行; [vi]潜伏;潜藏;鬼鬼祟祟地走; [^]z8;
luscious: [-]/ˈlʌʃəs/; [a]美味的;满足感官的; [^]z8;
lush: [-]/lʌʃ/; [a]草木茂盛的,多的,丰富豪华的; [n]酒;醉汉; [^]z8;
lust: [-]/lʌst/; [n]性欲,强烈的欲望; [v]产生性欲,渴望; [^]z8;
luxuriant: [-]/lʌɡˈʒʊriənt/; [a]繁茂的;多产的;绚烂的;奢华的; [^]z8;
lynch: [-]/lɪntʃ/; [v]私刑处死; [n]私刑;私罚; [^]z8;
lyric: [-]/ˈlɪrɪk/; [n]抒情诗;歌词; [a](供)吟唱的;抒情的; [^]z8;
lyrical: [-]/ˈlɪrɪkl/; [a]抒情诗调的;感情丰富的;充满愉悦的; [^]z8;
macho: [-]/ˈmɑːtʃoʊ/; [a]大男子气概的;大男人的; [n]男子汉; [^]z8;
madden: [-]/ˈmædn/; [v]使发疯,使发狂; [^]z8;
magnanimous: [-]/mæɡˈnænɪməs/; [a]宽宏大量的,大度的;慷慨的; [^]z8;
magnate: [-]/ˈmæɡneɪt/; [n]大人物;大亨,巨头;权贵; [^]z8;
magnetism: [-]/ˈmæɡnətɪzəm/; [n]吸引力;磁性; [^]z8;
magnitude: [-]/ˈmæɡnɪtuːd/; [n]巨大;震级;重要性;<数>量值; [^]z8;
magpie: [-]/ˈmæɡpaɪ/; [n]<鸟类>喜鹊,饶舌者; [a]似喜鹊的,喜欢随便收集的; [^]z8;
maim: [-]/meɪm/; [v]使残废; [^]z8;
mainspring: [-]/ˈmeɪnsprɪŋ/; [n]主要动力;主要原因;(钟表)主发条; [^]z8;
mainstay: [-]/ˈmeɪnsteɪ/; [n]支柱,中流砥柱,主要的依靠,主桅支索; [^]z8;
mainstream: [-]/ˈmeɪnstriːm/; [n]主流,主要倾向; [v]使.成为主流;将(残障儿童等)纳入正规班级; [a]主流的; [^]z8;
majestic: [-]/məˈdʒestɪk/; [a]威严的;雄伟的;壮丽的; [^]z8;
makeshift: [-]/ˈmeɪkʃɪft/; [a]临时的,权宜之计的,凑合的; [n]权宜之计,凑合,临时措施,将就; [^]z8;
malfunction: [-]/ˌmælˈfʌŋkʃn/; [v]发生故障;不起作用; [n]故障;失灵;疾病; [^]z8;
malign: [-]/məˈlaɪn/; [v]诽谤,中伤; [a]邪恶的;有害的; [^]z8;
malignant: [-]/məˈlɪɡnənt/; [a]恶性的,恶毒的,充满恨意的; [n]怀有恶意的人;保王党员; [^]z8;
malt: [-]/mɔːlt/; [n]麦芽,麦芽酒; [vt]使(谷物)成为麦芽;制麦芽; [a]麦芽的;含麦芽的;用麦芽作的; [^]z8;
mammoth: [-]/ˈmæməθ/; [n]长毛象,猛犸象,庞然大物; [a]巨大的,庞大的,猛犸似的; [^]z8;
manacle: [-]/ˈmænəkl/; [v]上手铐,束缚; [n]手铐; [^]z8;
managerial: [-]/ˌmænəˈdʒɪriəl/; [a]管理上的,经理的; [^]z8;
mandate: [-]/ˈmændeɪt/; [n]授权;命令,指令;委托管理;受命进行的工作; [v]授权;托管; [^]z8;
mandatory: [-]/ˈmændətɔːri/; [a]命令的,强制性的; [^]z8;
mane: [-]/meɪn/; [n](马,狮子等的)鬃毛,(人的)长头发; [^]z8;
mania: [-]/ˈmeɪniə/; [n]癫狂,狂热; [^]z8;
maniac: [-]/ˈmeɪniæk/; [a]发狂的,癫狂的,疯狂的; [n]燥狂(症)者,疯子; [^]z8;
manicure: [-]/ˈmænɪkjʊr/; [n]修指甲; [v]修剪; [^]z8;
manifestation: [-]/ˌmænɪfeˈsteɪʃn/; [n]表现,表示;显灵;示威运动; [^]z8;
manifesto: [-]/ˌmænɪˈfestoʊ/; [n]宣言,声明;告示; [v]发表宣言; [^]z8;
manoeuvre: [-]/məˈnuːvər/; [n]谨慎或熟练的动作;花招,巧计;(军队)调遣,演习; [^]z8;
mantle: [-]/ˈmæntl/; [n]外壳;披风;地幔; [v]覆盖; [^]z8;
manure: [-]/məˈnʊr/; [n]肥料; [v]施肥于;耕种; [^]z8;
mar: [-]/mɑːr/; [v]毁坏,弄糟,玷污; [^]z8;
mare: [-]/mer/; [n]母马; [^]z8;
marginal: [-]/ˈmɑːrdʒɪnl/; [a]微小的,不重要的;仅以微弱多数票获胜的; [n](议会或地方委员会的)边缘席位; [^]z8;
marijuana: [-]/ˌmærəˈwɑːnə/; [n]大麻,大麻中的毒质; [^]z8;
marital: [-]/ˈmærɪtl/; [a]婚姻的; [^]z8;
marquee: [-]/mɑːrˈkiː/; [n]选取框;大天幕;华盖; [a]〈美〉最重要的; [^]z8;
martial: [-]/ˈmɑːrʃl/; [a]武术的;好战的;军事的; [^]z8;
mash: [-]/mæʃ/; [v]捣碎; [n]糊状物; [^]z8;
masquerade: [-]/ˌmæskəˈreɪd/; [n]化装舞会;伪装,假扮; [vi]假扮; [^]z8;
mastery: [-]/ˈmæstəri/; [n]权力;优势;精通,掌握; [^]z8;
materialize: [-]/məˈtɪriəlaɪz/; [v]赋予形体,具体化,物质化; [^]z8;
matriculate: [-]/məˈtrɪkjuleɪt/; [n]被录取者; [v]准许.入学; [^]z8;
matrix: [-]/ˈmeɪtrɪks/; [n]<数>矩阵,模子; [^]z8;
matron: [-]/ˈmeɪtrən/; [n]妇女;保姆;女舍监; [^]z8;
maverick: [-]/ˈmævərɪk/; [n]独行者,想法与众不同的人; [a]行为不合常规的; [v]用不正当手段获取;迷路; [^]z8;
maxim: [-]/ˈmæksɪm/; [n]格言;准则;座右铭; [^]z8;
maze: [-]/meɪz/; [n]曲径,迷宫,迷津,迷惘,迷惑,糊涂; [v]使迷惘,使混乱,迷失; [^]z8;
meager: [-]/ˈmiːɡər/; [a]瘦的;贫乏的;粗劣的;少量的; [^]z8;
mean: [-]/miːn/; [n]平均值,中庸; [v]意思是,打算,导致; [a]吝啬的,低劣的,刻薄的,卑鄙的,平均的,中等的; [^]z8;
meander: [-]/miˈændər/; [n]蜿蜒曲折,迂回曲折的旅程;漫步; [v]迂回曲折;漫步;漫谈; [^]z8;
measles: [-]/ˈmiːzlz/; [n]<医>麻疹; [^]z8;
measurable: [-]/ˈmeʒərəbl/; [a]可测量的;重要的,重大的; [^]z8;
meddle: [-]/ˈmedl/; [vi]干预,多管闲事; [^]z8;
mediate: [-]/ˈmiːdieɪt/; [v]调解,调停,斡旋; [^]z8;
medication: [-]/ˌmedɪˈkeɪʃn/; [n]药物;药物治疗;药物处理; [^]z8;
mediocre: [-]/ˌmiːdiˈoʊkər/; [a]普通的;平凡的;中等的; [^]z8;
meditate: [-]/ˈmedɪteɪt/; [v]考虑,沉思,冥想; [^]z8;
meek: [-]/miːk/; [a]温顺的,逆来顺受的;谦恭的; [n]温顺的人;谦恭的人; [^]z8;
megaphone: [-]/ˈmeɡəfoʊn/; [n]扩音器,喇叭筒; [v]用扩音器讲; [^]z8;
melodrama: [-]/ˈmelədrɑːmə/; [n]情节剧,传奇剧;音乐戏剧; [^]z8;
membrane: [-]/ˈmembreɪn/; [n]膜;薄膜;羊皮纸; [^]z8;
memento: [-]/məˈmentoʊ/; [n]纪念品; [^]z8;
memorandum: [-]/ˌmeməˈrændəm/; [n]便签,备忘录;报告; [^]z8;
menial: [-]/ˈmiːniəl/; [a]仆人的,乏味的; [n]家仆; [^]z8;
menopause: [-]/ˈmenəpɔːz/; [n]更年期,活动终止期; [^]z8;
mercantile: [-]/ˈmɜːrkəntaɪl/; [a]商人的,商业的; [^]z8;
mercenary: [-]/ˈmɜːrsəneri/; [n]外国雇佣兵;唯利是图者; [a]唯利是图的;雇佣的; [^]z8;
mermaid: [-]/ˈmɜːrmeɪd/; [n]美人鱼(传说中的),女子游泳健将; [^]z8;
mesh: [-]/meʃ/; [n]网,筛孔; [v]相啮合; [^]z8;
mesmerize: [-]/ˈmezməraɪz/; [v]施催眠术;吸引,使神魂颠倒; [^]z8;
metabolism: [-]/məˈtæbəlɪzəm/; [n]新陈代谢; [^]z8;
metallurgy: [-]/ˈmetlɜːrdʒi/; [n]冶金学,冶金术; [^]z8;
metaphysical: [-]/ˌmetəˈfɪzɪkl/; [a]形而上学的;超自然的;玄学派诗歌的; [^]z8;
meteor: [-]/ˈmiːtiər/; [n]流星,大气现象; [^]z8;
meteorology: [-]/ˌmiːtiəˈrɑːlədʒi/; [n]气象学; [^]z8;
methane: [-]/ˈmeθeɪn/; [n]<有化>甲烷,<能源>沼气; [^]z8;
methodical: [-]/məˈθɑːdɪkl/; [a]有系统的,有方法的; [^]z8;
methodology: [-]/ˌmeθəˈdɑːlədʒi/; [n]方法论,方法学;(某一学科的)一套方法; [^]z8;
meticulous: [-]/məˈtɪkjələs/; [a]谨小慎微的;一丝不苟的; [^]z8;
microscope: [-]/ˈmaɪkrəskoʊp/; [n]显微镜; [^]z8;
migraine: [-]/ˈmaɪɡreɪn/; [n]［法］［医］周期性偏头痛; [^]z8;
migrant: [-]/ˈmaɪɡrənt/; [n]候鸟;移民; [^]z8;
mileometer: [-]/maɪˈlɑːmɪtər/; [n]计程表; [^]z8;
militant: [-]/ˈmɪlɪtənt/; [a]好战的,好暴力的; [n]激进分子,斗士; [^]z8;
mime: [-]/maɪm/; [n]哑剧演员,小丑,笑剧,丑角; [v]作摹拟表演; [^]z8;
mimic: [-]/ˈmɪmɪk/; [v]模仿,戏弄; [n]模仿者; [a]模拟的;假的,伪装的; [^]z8;
mince: [-]/mɪns/; [v]切碎,小步走路; [n]切碎物; [^]z8;
mirage: [-]/məˈrɑːʒ/; [n]幻影,海市蜃楼; [^]z8;
mire: [-]/ˈmaɪər/; [n]泥沼,困境; [^]z8;
mirth: [-]/mɜːrθ/; [n]欢乐,欢笑; [^]z8;
misappropriate: [-]/ˌmɪsəˈproʊprieɪt/; [v]滥用,误用; [a]=inappropriate; [^]z8;
miscarriage: [-]/ˈmɪskærɪdʒ/; [n]流产,失败,误送; [^]z8;
miscellaneous: [-]/ˌmɪsəˈleɪniəs/; [a]多种的,混杂的; [n]杂货;杂项; [^]z8;
misgiving: [-]/ˌmɪsˈɡɪvɪŋ/; [n]疑虑; [vt]担忧;使.疑虑;害怕(misgive的变形); [^]z8;
misplace: [-]/ˌmɪsˈpleɪs/; [v]放错地方; [^]z8;
mitigate: [-]/ˈmɪtɪɡeɪt/; [v]减轻,缓和; [^]z8;
mitten: [-]/ˈmɪtn/; [n]连指手套; [^]z8;
moat: [-]/moʊt/; [n]壕沟,护城河; [^]z8;
mobilize: [-]/ˈmoʊbəlaɪz/; [v]动员起来;动员;鼓动起; [^]z8;
mockery: [-]/ˈmɑːkəri/; [n]嘲弄;笑柄;徒劳无功;拙劣可笑的模仿或歪曲; [^]z8;
module: [-]/ˈmɑːdʒuːl/; [n]组件,模件,(航天器的)舱;(组成一门课程的)独立单元; [^]z8;
molest: [-]/məˈlest/; [v]骚扰,干扰; [^]z8;
mollify: [-]/ˈmɑːlɪfaɪ/; [v]安慰,安抚; [^]z8;
momentary: [-]/ˈmoʊmənteri/; [a]短暂的,瞬间的; [^]z8;
momentum: [-]/moʊˈmentəm/; [n](物理)动量;势头;动力; [^]z8;
mongrel: [-]/ˈmʌŋɡrəl/; [n]杂种动物,混血儿; [a]杂种的;杂交的;混血的; [^]z8;
monochrome: [-]/ˈmɑːnəkroʊm/; [a]单色的; [n]单色画;单色照片,黑白照片; [^]z8;
monogamy: [-]/məˈnɑːɡəmi/; [n]一夫一妻制; [^]z8;
monolingual: [-]/ˌmɑːnəˈlɪŋɡwəl/; [n]只用一种语言的人; [a]单语的,仅用一种语言的; [^]z8;
monologue: [-]/ˈmɑːnəlɔːɡ/; [n]独白,个人长篇演说; [^]z8;
monotony: [-]/məˈnɑːtəni/; [n]单调乏味,无聊;无变化; [^]z8;
monsoon: [-]/ˌmɑːnˈsuːn/; [n]季雨,季风,大雨; [^]z8;
montage: [-]/ˌmɑːnˈtɑːʒ/; [n]蒙太奇(电影的基本结构手段和叙事方式),混合画,拼集的照片; [^]z8;
monumental: [-]/ˌmɑːnjuˈmentl/; [a]纪念碑的;不朽的;非常的; [^]z8;
mope: [-]/moʊp/; [v]忧郁,百无聊赖,没精打采地度过; [n]抑郁不乐; [^]z8;
morbid: [-]/ˈmɔːrbɪd/; [a]疾病的;(精神等)病态的;恐怖的; [^]z8;
mores: [-]/ˈmɔːreɪz/; [n]风俗习惯,道德观念; [^]z8;
moribund: [-]/ˈmɔːrɪbʌnd/; [a]濒临失败的,垂死的; [n]垂死的人; [^]z8;
morphine: [-]/ˈmɔːrfiːn/; [n]吗啡; [^]z8;
mortality: [-]/mɔːrˈtæləti/; [n]死亡数,死亡率;必死的命运; [^]z8;
mortar: [-]/ˈmɔːrtər/; [n]小臼,乳钵,迫击炮,(砌砖用的)灰浆; [v]用迫击炮攻击;用灰泥涂抹; [^]z8;
mortgage: [-]/ˈmɔːrɡɪdʒ/; [n]按揭贷款,抵押贷款; [v]抵押; [^]z8;
mortuary: [-]/ˈmɔːrtʃueri/; [n]太平间,停尸间; [a]死的,悲哀的; [^]z8;
mosaic: [-]/moʊˈzeɪɪk/; [n]镶嵌细工,马赛克; [a]摩西的;拼花的; [vt]镶嵌;用马赛克装饰; [^]z8;
motif: [-]/moʊˈtiːf/; [n]基本图案;主题,中心思想,<音>乐旨; [^]z8;
motionless: [-]/ˈmoʊʃnləs/; [a]静止的;不运动的; [^]z8;
motley: [-]/ˈmɑːtli/; [a]混杂的,杂色的; [n]混杂;杂色衣服;小丑; [^]z8;
mound: [-]/maʊnd/; [n]堆,高地,护堤; [v]堆起,积成堆; [^]z8;
movable: [-]/ˈmuːvəbl/; [a]动产的;可移动的;不固定的; [n]动产;可移动的东西; [^]z8;
muddle: [-]/ˈmʌdl/; [n]混乱,杂乱,(头脑的)糊涂; [v](使)混乱,(使)迷惑,混淆; [a]引起困惑的;使人糊涂的;难以理解的; [^]z8;
muffin: [-]/ˈmʌfɪn/; [n]小松饼; [^]z8;
multilateral: [-]/ˌmʌltiˈlætərəl/; [a]<数学>多边的;多国之间的,多国(或多方)参加的; [^]z8;
multitude: [-]/ˈmʌltɪtuːd/; [n]大量;众多;大批;群众; [^]z8;
mumble: [-]/ˈmʌmbl/; [v]含糊地说;抿着嘴嚼; [n]含糊的话;咕噜; [^]z8;
mummy: [-]/ˈmʌmi/; [n]木乃伊,干瘪的人,妈咪(口语); [^]z8;
mumps: [-]/mʌmps/; [n]<内科>流行性腮腺炎; [^]z8;
mundane: [-]/mʌnˈdeɪn/; [a]普通的,平凡的;单调的;现世的,世俗的; [^]z8;
municipality: [-]/mjuːˌnɪsɪˈpæləti/; [n]市民;市政当局;自治市或区; [^]z8;
mural: [-]/ˈmjʊrəl/; [n]壁画;壁饰; [a]墙壁的;挂在墙壁上的; [^]z8;
muse: [-]/mjuːz/; [v]沉思;冥想; [n]<希神>缪斯女神,灵感; [^]z8;
mussel: [-]/ˈmʌsl/; [n]蚌类; [^]z8;
muster: [-]/ˈmʌstər/; [vi]集合;聚集; [vt]集合;召集; [n]集合;集合人员; [^]z8;
mutant: [-]/ˈmjuːtənt/; [n]突变体,突变异种; [a]突变的; [^]z8;
mutilate: [-]/ˈmjuːtɪleɪt/; [v]残害,切断(手足等),使残缺不全; [^]z8;
muzzle: [-]/ˈmʌzl/; [n]动物之鼻口,(动物的)口套,钳制言论的手段,枪口,喷嘴; [vt]戴口络于,上口罩; [^]z8;
myriad: [-]/ˈmɪriəd/; [n]无数;极大数量; [a]无数的; [^]z8;
mythology: [-]/mɪˈθɑːlədʒi/; [n]神话,神话学; [^]z8;
nab: [-]/næb/; [v]逮捕,攫取; [^]z8;
nag: [-]/næɡ/; [n]老马,驽马,劣等竞赛马,(作坐骑的)矮小马,唠叨; [v]不断地唠叨,恼人; [^]z8;
nappy: [-]/ˈnæpi/; [n]尿布; [a]起毛的; [^]z8;
narcissus: [-]/nɑːrˈsɪsəs/; [n]水仙; [^]z8;
nasal: [-]/ˈneɪzl/; [a]鼻的,鼻音的; [n]鼻骨,鼻音,鼻音字; [^]z8;
nautical: [-]/ˈnɔːtɪkl/; [a]航海的;海上的;海员的; [^]z8;
nebulous: [-]/ˈnebjələs/; [a]朦胧的,星云的,星云状的; [^]z8;
nectar: [-]/ˈnektər/; [n]花蜜,甘露; [a]〈古〉充满美酒的,芳香甜蜜的; [^]z8;
negate: [-]/nɪˈɡeɪt/; [vt]取消,使无效;否定,否认; [n]反面,对立面; [vi]否定,否认; [^]z8;
negligent: [-]/ˈneɡlɪdʒənt/; [a]疏忽的,粗心大意的;随意的; [^]z8;
negligible: [-]/ˈneɡlɪdʒəbl/; [a]微不足道的,可忽略不计的; [^]z8;
negotiable: [-]/nɪˈɡoʊʃiəbl/; [a]可谈判的,可商议的;可兑换现金的;可通行的(道路,河流); [^]z8;
neoclassical: [-]/ˌniːoʊˈklæsɪkl/; [a]新古典主义的; [^]z8;
neon: [-]/ˈniːɑːn/; [n]氖;霓虹灯; [a]霓虹的; [^]z8;
nestle: [-]/ˈnesl/; [vt]依偎; [vi](舒适地)安顿;抱; [v]半隐半现地处于;安顿下来; [^]z8;
neural: [-]/ˈnʊrəl/; [a]神经的;神经系统的;背的;神经中枢的; [^]z8;
neurosis: [-]/nʊˈroʊsɪs/; [n]<心理>神经症,神经衰弱症; [^]z8;
neurotic: [-]/nʊˈrɑːtɪk/; [a]神经质的;神经官能病的; [n]神经病患者; [^]z8;
neutralize: [-]/ˈnuːtrəlaɪz/; [v]宣布中立,使中立化;使无效;中和; [^]z8;
nib: [-]/nɪb/; [n]钢笔尖; [^]z8;
nibble: [-]/ˈnɪbl/; [v]一点点地咬,慢慢啃,吹毛求疵; [n]细咬,轻咬,啃; [^]z8;
niche: [-]/nɪtʃ/; [n]壁龛;合适的职业,生活方式;(有利可图的)市场,商机; [vt]放在适当的位置; [^]z8;
nicotine: [-]/ˈnɪkətiːn/; [n]尼古丁; [^]z8;
nimble: [-]/ˈnɪmbl/; [a]敏捷的,灵活的,机智的; [^]z8;
nip: [-]/nɪp/; [v]咬;捏;剪断;冻伤;阻止; [n]夹;捏;刺骨;小饮; [^]z8;
nipple: [-]/ˈnɪpl/; [n]乳头;奶嘴; [^]z8;
nirvana: [-]/nɪrˈvɑːnə/; [n]涅槃,心灵的平静,极乐; [^]z8;
nitrate: [-]/ˈnaɪtreɪt/; [n]硝酸盐,氮肥; [vt]用硝酸处理;使硝化; [^]z8;
node: [-]/noʊd/; [n]节点,瘤,<数>叉点; [^]z8;
nomad: [-]/ˈnoʊmæd/; [n]流浪者,游牧民; [a]游牧的;流浪的; [^]z8;
nomadic: [-]/noʊˈmædɪk/; [a]游牧的;流浪的;游动的; [^]z8;
nomenclature: [-]/ˈnoʊmənkleɪtʃər/; [n]术语,命名系统; [^]z8;
nominal: [-]/ˈnɑːmɪnl/; [a]名义上的;象征性的,很少的;名词性的; [^]z8;
nominee: [-]/ˌnɑːmɪˈniː/; [n]被任命者,被提名的人,代名人; [^]z8;
nonchalant: [-]/ˌnɑːnʃəˈlɑːnt/; [a]若无其事的;满不在乎的;冷静的;冷漠的; [^]z8;
nonstop: [-]/nɒn'stɒp/; [a]直达的,不休息的,不着陆的; [ad]不休息地; [n]直达车,班机; [^]z8;
norm: [-]/nɔːrm/; [n]准则;模范;规范,标准; [^]z8;
nostalgia: [-]/nəˈstældʒə/; [n]怀旧之情,思乡病; [^]z8;
nostalgic: [-]/nəˈstældʒɪk/; [a]乡愁的,怀旧的;怀旧的; [^]z8;
notary: [-]/ˈnoʊtəri/; [n]公证人;公证员; [^]z8;
notation: [-]/noʊˈteɪʃn/; [n]记号;标记法;记录; [^]z8;
notification: [-]/ˌnoʊtɪfɪˈkeɪʃn/; [n]通知,布告,告示; [^]z8;
notwithstanding: [-]/ˌnɑːtwɪθˈstændɪŋ/; prep. 尽管,虽然; [ad]尽管,虽然; [conj]尽管,虽然; [^]z8;
novelty: [-]/ˈnɑːvlti/; [n]新奇;新奇的事物;新颖小巧而廉价的小物品; [a]新奇的;风格独特的; [^]z8;
novice: [-]/ˈnɑːvɪs/; [n]生手,新手; [^]z8;
nuance: [-]/ˈnuːɑːns/; [n]细微差别; [^]z8;
nucleus: [-]/ˈnuːkliəs/; [n]原子核,核心,细胞核; [^]z8;
nude: [-]/nuːd/; [a]赤裸的,与生俱有的,无装饰的; [n]裸体者;裸体画; [v]〈罕〉使裸; [^]z8;
nudge: [-]/nʌdʒ/; [v](用臂肘)轻推(促其注意),鼓动,接近; [n]推动,用肘轻推; [^]z8;
nudity: [-]/ˈnuːdəti/; [n]裸露,裸体像; [^]z8;
numb: [-]/nʌm/; [a]麻木的,失去知觉的; [vt]使麻木,使失去知觉; [^]z8;
nurture: [-]/ˈnɜːrtʃər/; [v]养育,培育;培植; [n]养育,培养;教养;营养物; [^]z8;
nutrient: [-]/ˈnuːtriənt/; [n]营养物;滋养物; [a]营养的;滋养的; [^]z8;
nuzzle: [-]/ˈnʌzl/; [v]用鼻紧挨,用鼻爱抚,紧贴某人; [^]z8;
nymph: [-]/nɪmf/; [n]年轻女神,少女,蛹; [^]z8;
oasis: [-]/oʊˈeɪsɪs/; [n]绿洲;令人欣慰的事物; [^]z8;
obese: [-]/oʊˈbiːs/; [a]肥胖的;过胖的; [^]z8;
obesity: [-]/oʊˈbiːsəti/; [n]肥胖; [^]z8;
obituary: [-]/oʊˈbɪtʃueri/; [n]讣告; [a]关于死者的,讣告的; [^]z8;
obligatory: [-]/əˈblɪɡətɔːri/; [a]强制性的;义务的;必须的; [^]z8;
obliterate: [-]/əˈblɪtəreɪt/; [v]消灭;涂去;冲刷;忘掉; [^]z8;
obscene: [-]/əbˈsiːn/; [a]下流的,淫秽的; [^]z8;
observance: [-]/əbˈzɜːrvəns/; [n](法律习俗等的)遵守;奉行;庆祝,礼仪,仪式; [^]z8;
observant: [-]/əbˈzɜːrvənt/; [a]机警的;严格遵守的;善于观察的; [^]z8;
obsess: [-]/əbˈses/; [vt]迷住,使着迷,使烦扰; [^]z8;
obsessive: [-]/əbˈsesɪv/; [a]强迫性的;着迷的;分神的; [n]强迫症患者; [^]z8;
obsolete: [-]/ˌɑːbsəˈliːt/; [a]已过时的;已废弃的; [v]使过时;使作废; [n]废词;被废弃的事物; [^]z8;
occidental: [-]/ˌɑːksɪˈdentl/; [n]西方,西洋人; [a]西方(的); [^]z8;
octopus: [-]/ˈɑːktəpʊs/; [n]章鱼; [^]z8;
odds: [-]/ɑːdz/; [n]几率;可能性;投注赔率;优势;差异,不平等; [^]z8;
ode: [-]/oʊd/; [n]长诗,颂歌; [^]z8;
odor: [-]/ˈoʊdər/; [n]气味; [^]z8;
offensive: [-]/əˈfensɪv/; [a]冒犯的,进攻的,无礼的,令人不快的,得罪人的; [n]进攻; [^]z8;
ointment: [-]/ˈɔɪntmənt/; [n]药膏,<药>油膏; [^]z8;
omelet: [-]/ˈɑːmlət/; [n]煎蛋卷; [^]z8;
omelette: [-]/ˈɑːmlət/; [n]煎蛋卷,摊鸡蛋,鸡蛋饼; [^]z8;
ominous: [-]/ˈɑːmɪnəs/; [a]不祥的,不吉利的; [^]z8;
omniscient: [-]/ɑːmˈnɪsiənt/; [a]无所不知的,博识的; [n]无所不知者,上帝; [^]z8;
ongoing: [-]/ˈɑːnɡoʊɪŋ/; [n]进行,前进,发展; [a]进行中的,不间断的; [^]z8;
onomatopoeia: [-]/ˌɑːnəˌmætəˈpiːə/; [n]拟声,拟声词; [^]z8;
onset: [-]/ˈɑːnset/; [n]开始;攻击,袭击; [^]z8;
onslaught: [-]/ˈɑːnslɔːt/; [n]猛攻,猛袭; [^]z8;
ooze: [-]/uːz/; [v](使)渗出,流出,泄漏; [n]软泥,渗出物; [^]z8;
opaque: [-]/oʊˈpeɪk/; [a]不透明的;难懂的; [^]z8;
operational: [-]/ˌɑːpəˈreɪʃənl/; [a]操作的,运转的; [^]z8;
operative: [-]/ˈɑːpərətɪv/; [n]技工;特工;侦探; [a]运转着的,从事生产劳动的;有效的; [^]z8;
opt: [-]/ɑːpt/; [v]选择; [^]z8;
optimum: [-]/ˈɑːptɪməm/; [a]最适宜的;最佳的; [n]最适条件;最适宜; [^]z8;
opulent: [-]/ˈɑːpjələnt/; [a]富裕的,充足的; [^]z8;
opus: [-]/ˈoʊpəs/; [n]作品; [^]z8;
oracle: [-]/ˈɔːrəkl/; [n]代神发布神谕的人,神使,圣贤; [^]z8;
orator: [-]/ˈɔːrətər/; [n]演说者,演讲者,雄辩家,原告; [^]z8;
orbital: [-]/ˈɔːrbɪtl/; [a]轨道的;(城市)外环路的; [^]z8;
orchestrate: [-]/ˈɔːrkɪstreɪt/; [v]精心安排,编管弦乐曲,协调; [^]z8;
orchid: [-]/ˈɔːrkɪd/; [n]兰花,淡紫色; [^]z8;
ordain: [-]/ɔːrˈdeɪn/; [v]注定;规定;任命(牧师);颁布命令; [^]z8;
ordinance: [-]/ˈɔːrdɪnəns/; [n]法令;条例;条例;圣餐式; [^]z8;
orgy: [-]/ˈɔːrdʒi/; [n]狂欢;放荡; [^]z8;
orientation: [-]/ˌɔːriənˈteɪʃn/; [n]信仰;倾向;<计>定向;(学生)迎新会;定向,方向;(任职,上学等之前的) 情况介绍;训练; [^]z8;
ornate: [-]/ɔːrˈneɪt/; [a]装饰华丽的;修辞上极考究的; [^]z8;
orthodoxy: [-]/ˈɔːrθədɑːksi/; [n]正统,正教,正统说法; [^]z8;
ostentatious: [-]/ˌɑːstenˈteɪʃəs/; [a]浮华的,虚饰的,外观美丽的; [^]z8;
oust: [-]/aʊst/; [v]罢免,驱逐,剥夺,取代; [^]z8;
outcast: [-]/ˈaʊtkæst/; [n]被逐出者;流浪者; [a]被抛弃的,被逐出的; [^]z8;
outcry: [-]/ˈaʊtkraɪ/; [n]大声喊叫;强烈抗议;拍卖; [^]z8;
outfit: [-]/ˈaʊtfɪt/; [n]装备,全部用品,(协同工作)的一组人; [v]提供装备; [^]z8;
outgoing: [-]/ˈaʊtɡoʊɪŋ/; [a]外向的;外出的;乐于助人的;即将离职的,卸任的; [n]流出;开支; [^]z8;
outgrow: [-]/ˌaʊtˈɡroʊ/; [v]长得过大而不适于;长大成熟而不再;长的比..快; [^]z8;
outlandish: [-]/aʊtˈlændɪʃ/; [a]稀奇古怪的,奇特的;异国风情的; [^]z8;
outlay: [-]/ˈaʊtleɪ/; [v]花费; [n]<会计>费用;支出;经费; [^]z8;
outnumber: [-]/ˌaʊtˈnʌmbər/; [v]在数量上超过; [^]z8;
outright: [-]/ˈaʊtraɪt/; [a]完全的,彻底的,全部地;直率的; [ad]完全地;直率地,痛快地;直截了当地; [^]z8;
outspoken: [-]/aʊtˈspoʊkən/; [a]直言的,坦率的; [^]z8;
outweigh: [-]/ˌaʊtˈweɪ/; [v]比..重要;比..有价值;比.重; [^]z8;
ovation: [-]/oʊˈveɪʃn/; [n]热烈欢迎,欢呼; [^]z8;
overshadow: [-]/ˌoʊvərˈʃædoʊ/; [v]遮蔽,使显得不重要; [^]z8;
oversight: [-]/ˈoʊvərsaɪt/; [n]勘漏,疏忽,失察;监督; [^]z8;
overt: [-]/oʊˈvɜːrt/; [a]明显的;公开的;公然的; [^]z8;
overture: [-]/ˈoʊvərtʃər/; [n]主动表示,姿态;前奏曲;序言,事件的开端;提出问题; [vt]作为一种主动姿态提出;向.提出建议; [^]z8;
overview: [-]/ˈoʊvərvjuː/; [n]综述,概观; [^]z8;
oxidize: [-]/ˈɑːksɪdaɪz/; [v]生锈;氧化; [^]z8;
pacify: [-]/ˈpæsɪfaɪ/; [v]使平静,安慰,抚慰; [^]z8;
padlock: [-]/ˈpædlɑːk/; [n]挂锁,关闭,禁止进入; [v]用挂锁锁上,关闭; [^]z8;
pageant: [-]/ˈpædʒənt/; [n]盛会,历史剧,选美; [^]z8;
painstaking: [-]/ˈpeɪnzteɪkɪŋ/; [a](不辞)劳苦的,辛勤的; [n]辛劳,煞费苦心; [^]z8;
pal: [-]/pæl/; [n]伙伴,好朋友; [v]交友; [^]z8;
palatable: [-]/ˈpælətəbl/; [a]美味的,合口味的,合心意的; [^]z8;
palate: [-]/ˈpælət/; [n]味觉;上颚;趣味; [^]z8;
palette: [-]/ˈpælət/; [n]调色板,一套颜料; [^]z8;
palpable: [-]/ˈpælpəbl/; [a]明显的,易觉察的,可触知的; [^]z8;
pamper: [-]/ˈpæmpər/; [v]纵容,过分关怀,精心照料; [^]z8;
panacea: [-]/ˌpænəˈsiːə/; [n]灵丹妙药,万能药; [^]z8;
pancake: [-]/ˈpænkeɪk/; [n]烙饼,薄饼; [^]z8;
pang: [-]/pæŋ/; [n]剧痛,痛苦; [v]使剧痛,折磨; [^]z8;
panoramic: [-]/ˌpænəˈræmɪk/; [a]全景的; [^]z8;
pant: [-]/pænt/; [v]喘息;气喘吁吁地说;喘气; [n]喘气; [^]z8;
panther: [-]/ˈpænθər/; [n]豹;黑豹; [^]z8;
pantomime: [-]/ˈpæntəmaɪm/; [n]哑剧,〈英〉(圣诞节上演的)童话剧; [vi]打手势,演哑剧; [^]z8;
parable: [-]/ˈpærəbl/; [n]寓言,比喻; [^]z8;
paradigm: [-]/ˈpærədaɪm/; [n]范例,示范; [^]z8;
paralysis: [-]/pəˈræləsɪs/; [n]瘫痪(症),麻痹(症); [^]z8;
parameter: [-]/pəˈræmɪtər/; [n]决定因素;界限;参(变)数;参量; [^]z8;
paramount: [-]/ˈpærəmaʊnt/; [n]元首;最高; [a]最高的,至上的,首要的; [^]z8;
paranoia: [-]/ˌpærəˈnɔɪə/; [n](心理)偏执狂,多疑症; [^]z8;
paranoid: [-]/ˈpærənɔɪd/; [a]偏执狂的,过分怀疑的; [^]z8;
paraphrase: [-]/ˈpærəfreɪz/; [v]解释,释义; [n]转述,释义; [^]z8;
parasite: [-]/ˈpærəsaɪt/; [n]寄生虫;靠他人为生的人; [^]z8;
pare: [-]/per/; [v]削去,剥去; [^]z8;
parenthetical: [-]/ˌpærənˈθetɪkl/; [a]作为插入语的,放在括号里的,［喻］插曲的; [^]z8;
parenthood: [-]/ˈperənthʊd/; [n]亲子关系,父母身份; [^]z8;
parody: [-]/ˈpærədi/; [n]嘲弄文章,拙劣的模仿; [v]拙劣模仿; [^]z8;
parole: [-]/pəˈroʊl/; [n]特别口令;假释; [v]有条件释放,假释;使假释出狱;宣誓后释放; [a]假释的; [^]z8;
parry: [-]/ˈpæri/; [v]挡开,避开(武器,问题等); [^]z8;
parson: [-]/ˈpɑːrsn/; [n]教区牧师; [^]z8;
partake: [-]/pɑːrˈteɪk/; [v]分享,参与,分担; [n]参与者,分担者; [^]z8;
partisan: [-]/ˈpɑːrtəzn/; [a]党派的;效忠的;偏袒的;盲目推崇的; [n]党羽;虔诚信徒;游击队; [^]z8;
pasta: [-]/ˈpɑːstə/; [n]意大利面食; [^]z8;
pastel: [-]/pæˈstel/; [n]柔和的色彩,彩色粉笔画;粉蜡笔; [a]柔和的;彩色蜡笔的,粉蜡笔的; [^]z8;
pastoral: [-]/ˈpæstərəl/; [a]田园生活的,牧师的; [n]牧歌;田园诗;田园景色;牧师写给教区居民的公开信; [^]z8;
pastry: [-]/ˈpeɪstri/; [n]糕点,点心; [^]z8;
patchy: [-]/ˈpætʃi/; [a]断续的,不连贯的;良莠不齐的,好坏掺杂的;不充足的; [^]z8;
patio: [-]/ˈpætioʊ/; [n]屋内庭院,天井;平台; [^]z8;
patriarch: [-]/ˈpeɪtriɑːrk/; [n]家长;族长;创办人;最年长者; [^]z8;
patriarchal: [-]/ˌpeɪtriˈɑːrkl/; [a]族长的;家长的;可尊敬的;德高望重的; [^]z8;
patronage: [-]/ˈpætrənɪdʒ/; [n]惠顾;赞助;任免权; [^]z8;
patronize: [-]/ˈpeɪtrənaɪz/; [v]惠顾;赞助,资助; [^]z8;
patter: [-]/ˈpætər/; [n]行话,轻快脚步声,急速拍打声; [v]滴答地响,急速地说,发出急速轻拍声,使.发出嗒嗒声; [^]z8;
pawn: [-]/pɔːn/; [n]典当;抵押物;兵,卒;人质; [v]当掉;以..担保; [^]z8;
payroll: [-]/ˈpeɪroʊl/; [n]工资单; [^]z8;
peat: [-]/piːt/; [n]泥煤,泥炭块,泥炭色; [^]z8;
pedagogic: [-]/ˌpedəˈɡɑːdʒɪk/; [a]教育学的; [^]z8;
pedestal: [-]/ˈpedɪstl/; [n](雕像等)基座,支座,受人尊敬的地位; [vt]搁在台上,颂扬; [^]z8;
pedigree: [-]/ˈpedɪɡriː/; [n]血统,家谱;出身,门第;(纯种家畜的)血统表;纯种;(语言的)起源; [^]z8;
peek: [-]/piːk/; [v]偷看,窥视; [n]偷看,窥见; [^]z8;
penalize: [-]/ˈpiːnəlaɪz/; [v]置(某人)于不利地位,处罚; [^]z8;
pendant: [-]/ˈpendənt/; [n]吊坠,下垂物; [^]z8;
pendent: [-]/'pendənt/; [a]吊着的,悬挂的; [^]z8;
penis: [-]/ˈpiːnɪs/; [n]阳物,阴茎; [^]z8;
pensioner: [-]/ˈpenʃənər/; [n]领取养老金者,退休的人;随从; [^]z8;
pentathlon: [-]/penˈtæθlən/; [n]五项运动,五项全能运动; [^]z8;
perceptible: [-]/pərˈseptəbl/; [a]可察觉的,可注意到的; [^]z8;
perception: [-]/pərˈsepʃn/; [n]洞察力,理解力;洞察力,理解力,认识,观念,看法; [^]z8;
perceptive: [-]/pərˈseptɪv/; [a]感知的,知觉的;有知觉力的; [^]z8;
percussion: [-]/pərˈkʌʃn/; [n]撞击,敲击;敲打乐器; [^]z8;
perfunctory: [-]/pərˈfʌŋktəri/; [a]草率的,敷衍搪塞的; [^]z8;
perilous: [-]/ˈperələs/; [a]危险的; [^]z8;
perimeter: [-]/pəˈrɪmɪtər/; [n]周长;周界; [^]z8;
peripheral: [-]/pəˈrɪfərəl/; [a]外围的; [n]外围设备; [^]z8;
periphery: [-]/pəˈrɪfəri/; [n]外围,不重要的部份; [^]z8;
perish: [-]/ˈperɪʃ/; [vi]死去;毁灭,灭亡; [v]脆裂,老化,腐烂; [^]z8;
perjury: [-]/ˈpɜːrdʒəri/; [n]伪证,假誓; [^]z8;
perk: [-]/pɜːrk/; [v]昂首,意气洋洋,振作; [n]好处;福利; [a]〈罕〉同"perky"; [^]z8;
permeate: [-]/ˈpɜːrmieɪt/; [v]弥漫;普及;渗透; [^]z8;
permissible: [-]/pərˈmɪsəbl/; [a]容许的;许可的; [^]z8;
pernicious: [-]/pərˈnɪʃəs/; [a]有害的,恶性的,致命的; [^]z8;
perpetrate: [-]/ˈpɜːrpətreɪt/; [vt]犯罪,作恶;干坏事; [^]z8;
perpetrator: [-]/ˈpɜːrpətreɪtər/; [n]作恶者,犯罪者,行凶者; [^]z8;
perpetuate: [-]/pərˈpetʃueɪt/; [a]长存的; [vt]使永久存在,使不朽; [^]z8;
pertain: [-]/pərˈteɪn/; [vi]属于;适合;有关; [^]z8;
pertinent: [-]/ˈpɜːrtnənt/; [a]有关的;适当的;中肯的; [n]附属物;参考; [^]z8;
perturb: [-]/pərˈtɜːrb/; [vt]使不安;烦扰;使紊乱; [^]z8;
pervade: [-]/pərˈveɪd/; [vt]普及;渗透;弥漫; [vi]弥漫;渗透; [^]z8;
pervert: [-]/ˈpɜːrvɜːrt/; [v]使堕落,误导,曲解; [n]变态,色狼; [^]z8;
pester: [-]/ˈpestər/; [v]使烦恼,纠缠; [^]z8;
pesticide: [-]/ˈpestɪsaɪd/; [n]杀虫剂;农药; [^]z8;
pharmaceutical: [-]/ˌfɑːrməˈsuːtɪkl/; [a]制药的,药物的; [n]药物; [^]z8;
pheasant: [-]/ˈfeznt/; [n]野鸡,雉科鸟; [^]z8;
phenomenal: [-]/fəˈnɑːmɪnl/; [a]非凡的;现象的;显著的; [^]z8;
philanthropic: [-]/ˌfɪlənˈθrɑːpɪk/; [a]博爱的,为他人着想的; [^]z8;
phosphorus: [-]/ˈfɑːsfərəs/; [n]磷; [^]z8;
physique: [-]/fɪˈziːk/; [n]体格,体魄; [^]z8;
picket: [-]/ˈpɪkɪt/; [n]警戒哨,纠察队,尖木桩; [v]派..担任纠察,担任纠察; [^]z8;
pickle: [-]/ˈpɪkl/; [n]盐汁;泡菜; [v]腌; [^]z8;
pier: [-]/pɪr/; [n]码头;桥墩; [^]z8;
piety: [-]/ˈpaɪəti/; [n]虔诚,虔诚的行为或语言; [^]z8;
pigsty: [-]/ˈpɪɡstaɪ/; [n]猪圈,脏乱的地方; [^]z8;
pike: [-]/paɪk/; [n]矛,长枪,梭子鱼; [vt]用矛刺穿; [^]z8;
pinch: [-]/pɪntʃ/; [v]捏,掐,夹痛; [n]捏;少量,一撮;困苦; [^]z8;
pinpoint: [-]/ˈpɪnpɔɪnt/; [v]准确地解释或说明; [a]精确的; [n]针尖,极小之物,极不重要的事物; [^]z8;
piracy: [-]/ˈpaɪrəsi/; [n]海上掠夺;剽窃;侵犯版权; [^]z8;
piss: [-]/pɪs/; [int]〈美俚〉呸; [v]小便; [n]小便; [^]z8;
piston: [-]/ˈpɪstən/; [n]活塞,瓣; [^]z8;
pitcher: [-]/ˈpɪtʃər/; [n]<棒球>投手,水罐,<植>瓶状叶; [^]z8;
pitfall: [-]/ˈpɪtfɔːl/; [n]陷阱,未料到的危险或困难; [^]z8;
pivot: [-]/ˈpɪvət/; [n]枢轴,中心; [v]以..为中心转动; [a]枢轴的;关键的; [^]z8;
pivotal: [-]/ˈpɪvətl/; [a]关键的,枢轴的; [^]z8;
plaintiff: [-]/ˈpleɪntɪf/; [n]原告; [^]z8;
plank: [-]/plæŋk/; [n]厚木板;木板制成物;政纲条款;要点; [v]在..上铺板;砰一声放下;用菜板端出; [^]z8;
plaque: [-]/plæk/; [n]饰板,匾,斑块; [^]z8;
plasma: [-]/ˈplæzmə/; [n]血浆;等离子体;深绿玉髓; [^]z8;
plaster: [-]/ˈplæstər/; [n]灰泥,石膏; [v]抹泥; [^]z8;
platoon: [-]/pləˈtuːn/; [n]排,一组,一队人,警察队; [vt]把.分成小队; [^]z8;
plea: [-]/pliː/; [n](法律)抗辩;恳求;请求,托词,口实; [^]z8;
plead: [-]/pliːd/; [v]恳求,辩护,(不)认罪;提出.为理由; [^]z8;
pleat: [-]/pliːt/; [n]褶,褶状物; [^]z8;
plight: [-]/plaɪt/; [n]困境; [v]宣誓,保证; [^]z8;
plumb: [-]/plʌm/; [n]铅锤,测锤; [vi]垂直悬挂; [a]垂直的; [vt]用铅锤测量; [ad]垂直地; [^]z8;
plummet: [-]/ˈplʌmɪt/; [v]垂直或突然地堕下,骤然下降; [n]测锤(钓丝的)坠子;线锤;铅锤线;锤规; [^]z8;
plush: [-]/plʌʃ/; [n]长毛绒; [a]豪华的,长毛绒做的,舒服的; [^]z8;
poach: [-]/poʊtʃ/; [v]水煮;小火煮;偷猎;窃取; [^]z8;
polarity: [-]/pəˈlærəti/; [n](分)极性;相对的观点; [^]z8;
polemic: [-]/pəˈlemɪk/; [n]争论,论战,驳斥; [a]论战的;喜欢争论的; [^]z8;
pollen: [-]/ˈpɑːlən/; [n]花粉; [^]z8;
pollster: [-]/ˈpoʊlstər/; [n]民意测验专家,民意调查人;整理民意测验结果的人; [^]z8;
pompous: [-]/ˈpɑːmpəs/; [a]傲慢的,浮华的; [^]z8;
poplar: [-]/ˈpɑːplər/; [n]白杨; [^]z8;
poppy: [-]/ˈpɑːpi/; [n]罂粟花,罂粟属植物; [^]z8;
populous: [-]/ˈpɑːpjələs/; [a]人口稠密的,人口众多的; [^]z8;
pore: [-]/pɔːr/; [n]毛孔,细孔; [v]深思熟虑,仔细阅读,审视; [^]z8;
portfolio: [-]/pɔːrtˈfoʊlioʊ/; [n]公文包,文件夹,投资组合;股份单; [^]z8;
posthumous: [-]/ˈpɑːstʃəməs/; [a]遗腹的;著作者死后出版的;死后的; [^]z8;
postscript: [-]/ˈpoʊstskrɪpt/; [n]附言;后评; [^]z8;
posture: [-]/ˈpɑːstʃər/; [n]姿势;看法;态度; [v]装模作样; [^]z8;
potent: [-]/ˈpoʊtnt/; [a]强有力的;有权势的;有说服力的; [^]z8;
pouch: [-]/paʊtʃ/; [n]小袋,烟草袋,钱袋,育儿袋; [v]把..装入袋中,使成袋状; [^]z8;
pounce: [-]/paʊns/; [n]猛扑,飞扑; [vi]猛扑,突然袭击; [vt]扑过去抓住; [^]z8;
practicality: [-]/ˌpræktɪˈkæləti/; [n]实用性,实际性;实际,实例; [^]z8;
pragmatic: [-]/præɡˈmætɪk/; [a]国事的,团体事务的;实际的,注重实效的; [n]爱管闲事的人;专断的人;国事诏书;实际家; [^]z8;
precarious: [-]/prɪˈkeriəs/; [a]不稳定的;危险的;可疑的;说不定的; [^]z8;
precinct: [-]/ˈpriːsɪŋkt/; [n]管理区,管辖区;选区;界限,范围; [^]z8;
precipitate: [-]/prɪˈsɪpɪteɪt/; [v]促成,使..沉淀,猛摔;<气象>凝结; [n]沉淀物,冷凝物; [a]突如其来的,仓促的,迅猛的;感情用事的; [^]z8;
precipitous: [-]/prɪˈsɪpɪtəs/; [a]险峻的;急躁的,鲁莽的; [^]z8;
preclude: [-]/prɪˈkluːd/; [v]阻止;排除; [^]z8;
predatory: [-]/ˈpredətɔːri/; [a]掠夺的;捕食生物的; [^]z8;
predicament: [-]/prɪˈdɪkəmənt/; [n]困境,穷境,尴尬的处境; [^]z8;
preferential: [-]/ˌprefəˈrenʃl/; [a]优先的;选择的;特惠的; [^]z8;
premature: [-]/ˌpriːməˈtʃʊr/; [a]早产的,过早的,早熟的; [n]早产儿; [^]z8;
premiere: [-]/prɪˈmɪr/; [n]首次公演; [vi]首次上演; [vt]初次演出; [a]初次的,女主角的; [^]z8;
premium: [-]/ˈpriːmiəm/; [a]高级的;高价的;(汽油)辛烷值高的; [n]额外费用,溢价;保险金; [^]z8;
premonition: [-]/ˌpriːməˈnɪʃn/; [n]预告,征兆,预感; [^]z8;
prenatal: [-]/ˌpriːˈneɪtl/; [a]产前的,胎儿期的,<医>出生以前的; [^]z8;
preoccupied: [-]/priˈɑːkjupaɪd/; [a]全神贯注的,心事重重的,被先占的; [^]z8;
prerequisite: [-]/ˌpriːˈrekwəzɪt/; [n]先决条件,必要条件; [a]必须先具备的,必要的; [^]z8;
preschool: [-]/ˈpriːskuːl/; [a]未满学龄的,就学前的,入学前的; [n]幼儿园,育幼院; [^]z8;
presumption: [-]/prɪˈzʌmpʃn/; [n]放肆,傲慢;推测; [^]z8;
pretentious: [-]/prɪˈtenʃəs/; [a]做作的,自命不凡的,炫耀的; [^]z8;
prevalent: [-]/ˈprevələnt/; [a]普遍的,流行的; [^]z8;
prism: [-]/ˈprɪzəm/; [n]棱镜;棱柱; [^]z8;
pristine: [-]/ˈprɪstiːn/; [a]原始的;古时的;纯朴的;崭新的; [^]z8;
probation: [-]/proʊˈbeɪʃn/; [n]试用;缓刑;察看; [^]z8;
problematic: [-]/ˌprɑːbləˈmætɪk/; [a]问题的;有疑问的;不确定的; [^]z8;
procedural: [-]/prəˈsiːdʒərəl/; [a]程序上的; [^]z8;
procure: [-]/prəˈkjʊr/; [vt](努力)取得;获得;导致;完成; [vi]介绍娼妓;拉皮条; [^]z8;
prod: [-]/prɑːd/; [n]刺针;刺棒;签子; [v]刺;戳;刺激; [^]z8;
prodigal: [-]/ˈprɑːdɪɡl/; [a]挥霍的,十分慷慨的; [n]浪子,挥霍者; [^]z8;
prodigy: [-]/ˈprɑːdədʒi/; [n]天才; [^]z8;
profess: [-]/prəˈfes/; [v]表示,承认;宣称; [^]z8;
profiteer: [-]/ˌprɑːfəˈtɪr/; [n]奸商,牟取暴利者; [^]z8;
projection: [-]/prəˈdʒekʃn/; [n]预测,投射,投影规划; [^]z8;
proliferation: [-]/prəˌlɪfəˈreɪʃn/; [n]增殖;增加; [^]z8;
prolific: [-]/prəˈlɪfɪk/; [a]多育的,多产的;丰富的,富饶的; [^]z8;
prologue: [-]/ˈproʊlɔːɡ/; [n]开场白,序幕; [^]z8;
prominence: [-]/ˈprɑːmɪnəns/; [n]卓越;突出物;显著,突出; [^]z8;
prone: [-]/proʊn/; [a]易于.的;有.倾向的;俯卧的; [^]z8;
propagate: [-]/ˈprɑːpəɡeɪt/; [v]繁殖,增殖; [vt]传播,宣传; [^]z8;
propel: [-]/prəˈpel/; [v]推进,推动,激励; [^]z8;
prophecy: [-]/ˈprɑːfəsi/; [n]预言书;预言,预言能力; [^]z8;
prophesy: [-]/ˈprɑːfəsaɪ/; [v]预言,预报; [^]z8;
proponent: [-]/prəˈpoʊnənt/; [n]支持者;提议者;主张者;提出认证遗嘱者; [a]建议的;支持的;辩护的; [^]z8;
proposition: [-]/ˌprɑːpəˈzɪʃn/; [n]提议,计划,命题; [v]向.求欢; [^]z8;
prospective: [-]/prəˈspektɪv/; [a]未来的;预期的; [n]预期; [^]z8;
protagonist: [-]/prəˈtæɡənɪst/; [n]主角,领导者,积极参加者; [^]z8;
protocol: [-]/ˈproʊtəkɔːl/; [n]外交礼节;草案;外交议定书; [vi]拟定议定书; [vt]把.写入议定书; [^]z8;
prototype: [-]/ˈproʊtətaɪp/; [n]原型,典型,样本; [^]z8;
protrude: [-]/proʊˈtruːd/; [v]伸出,突出,凸出; [^]z8;
provident: [-]/ˈprɑːvɪdənt/; [a]节俭的,深谋远虑的,顾及未来的; [^]z8;
provisional: [-]/prəˈvɪʒənl/; [n]临时邮票; [a]临时的,暂时的,暂定的; [^]z8;
prowess: [-]/ˈpraʊəs/; [n]勇敢,不凡的能力;超凡技术; [^]z8;
proximity: [-]/prɑːkˈsɪməti/; [n]接近;邻近; [^]z8;
prudent: [-]/ˈpruːdnt/; [a]谨慎的,精明的; [^]z8;
psychiatrist: [-]/saɪˈkaɪətrɪst/; [n]精神病医生;精神病学家; [^]z8;
psychotherapy: [-]/ˌsaɪkoʊˈθerəpi/; [n]心理疗法,精神疗法; [^]z8;
puberty: [-]/ˈpjuːbərti/; [n]青春期; [^]z8;
pun: [-]/pʌn/; [n]双关语; [v]说双关语,用双关语; [^]z8;
pungent: [-]/ˈpʌndʒənt/; [a]刺激性的;刺鼻的;尖锐的; [^]z8;
punitive: [-]/ˈpjuːnətɪv/; [a]给予惩罚,刑罚的; [^]z8;
purge: [-]/pɜːrdʒ/; [v]通便,净化,使(身,心)清净; [n]驱赶,泻药,净化; [^]z8;
python: [-]/ˈpaɪθɑːn/; [n]蟒蛇,巨蛇; [^]z8;
quack: [-]/kwæk/; [n]庸医;鸭叫声; [v]嘎嘎叫;吹嘘;大声闲聊; [a]骗人的,江湖医生的; [^]z8;
quadrant: [-]/ˈkwɑːdrənt/; [n]象限,四分之一圆; [^]z8;
quadrilateral: [-]/ˌkwɑːdrɪˈlætərəl/; [a]四边形的; [^]z8;
quail: [-]/kweɪl/; [n]鹌鹑; [v]畏缩;感到恐惧; [^]z8;
quaint: [-]/kweɪnt/; [a]精巧的;古雅的; [^]z8;
qualm: [-]/kwɑːm/; [n]疑惧,紧张不安; [^]z8;
quantum: [-]/ˈkwɑːntəm/; [n]量子论; [^]z8;
quarantine: [-]/ˈkwɔːrəntiːn/; [v]检疫;隔离;使隔离; [n]检疫;隔离;检疫期;封锁; [^]z8;
quartet: [-]/kwɔːrˈtet/; [n]四重奏,四重唱,四件一组; [^]z8;
quartz: [-]/kwɔːrts/; [n]石英; [^]z8;
quash: [-]/kwɔːʃ/; [v]镇压,平息,废除,使无效; [^]z8;
quaver: [-]/ˈkweɪvər/; [v]颤抖,发颤音; [n]八分音符,颤音; [^]z8;
quell: [-]/kwel/; [v]镇压,消除,减轻(激动,恐惧等); [n]镇压,平息,减轻; [^]z8;
quench: [-]/kwentʃ/; [v]扑灭(火);止渴; [^]z8;
querulous: [-]/ˈkwerələs/; [a]抱怨的,挑剔的; [^]z8;
quibble: [-]/ˈkwɪbl/; [n]谬论;双关语;遁辞; [v]诡辩;挑剔;说模棱两可的话; [^]z8;
quick: [-]/kwɪk/; [a]迅速的,快捷的; [ad]迅速地; [n](指甲下的)活肉; [^]z8;
quip: [-]/kwɪp/; [n]妙语,嘲弄,讽刺语; [v]嘲弄,讥讽; [^]z8;
rabid: [-]/ˈræbɪd/; [a]激烈的;狂暴的;偏激的;患狂犬病的; [^]z8;
rabies: [-]/ˈreɪbiːz/; [n](单复同型)狂犬病; [^]z8;
racket: [-]/ˈrækɪt/; [n]吵闹声;球拍; [v]嚷闹,吵闹,纵情欢闹;用球拍打; [^]z8;
radiance: [-]/ˈreɪdiəns/; [n]发光,容光焕发; [^]z8;
radiant: [-]/ˈreɪdiənt/; [a]光芒四射的,绚丽的;喜悦的; [^]z8;
raffle: [-]/ˈræfl/; [n]废物;抽彩票; [v]抽彩票; [^]z8;
raft: [-]/ræft/; [n]木筏;救生艇; [^]z8;
rake: [-]/reɪk/; [n]耙子,耙机; [v]耙;搜索,探索; [^]z8;
ramble: [-]/ˈræmbl/; [vi]瞎扯;溜达;漫步于; [n]漫步; [^]z8;
ramification: [-]/ˌræmɪfɪˈkeɪʃn/; [n]分枝;分枝(或分叉)的结果; [^]z8;
rampage: [-]/ræmˈpeɪdʒ/; [n]粗暴;胡闹; [v]暴跳;暴怒;狂暴地乱冲; [^]z8;
rampant: [-]/ˈræmpənt/; [a]猖獗的,蔓生的; [^]z8;
rampart: [-]/ˈræmpɑːrt/; [n]壁垒,城墙; [vt]用壁垒围绕,防卫;守卫; [^]z8;
rancid: [-]/ˈrænsɪd/; [a]腐臭的;令人作呕的,讨厌的; [^]z8;
randy: [-]/ˈrændi/; [a]好色的; [n]<苏格兰>粗野的女人,强讨的叫花子,莽汉,粗鲁悍妇; [^]z8;
ranger: [-]/ˈreɪndʒər/; [n]游侠,巡逻骑兵,突击队员,护林员,游荡的人,测距仪; [^]z8;
rap: [-]/ræp/; [n]饶舌歌; [v]轻敲;表演说唱;严厉批评; [^]z8;
rapport: [-]/ræˈpɔːr/; [n]密切关系,交往;和谐一致;意见一致; [^]z8;
rapprochement: [-]/ˌræproʊʃˈmɑːn/; [n]和好,恢复邦交; [^]z8;
rapt: [-]/ræpt/; [a]全神贯注的,着迷的;狂喜的; [^]z8;
rapture: [-]/ˈræptʃər/; [n]狂喜; [^]z8;
rarity: [-]/ˈrerəti/; [n]罕见,珍贵,珍品,稀薄; [^]z8;
rationale: [-]/ˌræʃəˈnæl/; [n]基本原理;原理的阐述; [^]z8;
rattle: [-]/ˈrætl/; [n]格格声,发出嘎嘎声的儿童玩具,(响尾蛇)音响器官; [v](使)发出格格声,(人或车)疾驰,使烦扰; [^]z8;
ravine: [-]/rəˈviːn/; [n]山涧,小峡谷; [^]z8;
ravish: [-]/ˈrævɪʃ/; [v]强夺,强奸,使着迷; [^]z8;
reassure: [-]/ˌriːəˈʃʊr/; [v]使放心,使消除疑虑; [^]z8;
rebate: [-]/ˈriːbeɪt/; [vt]减少;打折扣; [vi]退还部分付款,打折扣; [n]折扣; [^]z8;
rebound: [-]/rɪˈbaʊnd/; [v]弹回,恢复,振作; [n]弹回,重新振作,回应; [^]z8;
recipient: [-]/rɪˈsɪpiənt/; [n]接受者;容器;间接宾语; [a]接受的;善于接受的;接受能力强的; [^]z8;
reciprocate: [-]/rɪˈsɪprəkeɪt/; [v]互给;酬答;互换;报答; [^]z8;
recital: [-]/rɪˈsaɪtl/; [n]独奏,吟诵,演奏会; [^]z8;
recline: [-]/rɪˈklaɪn/; [vi]躺,斜倚(常与on,upon或against连用);信赖; [vt]使后靠,使斜倚; [^]z8;
reconciliation: [-]/ˌrekənsɪliˈeɪʃn/; [n]和解,修好,和好,调停,调解; [^]z8;
recount: [-]/rɪˈkaʊnt/; [v]叙述; [n]重新计算; [^]z8;
recoup: [-]/rɪˈkuːp/; [v]收回;恢复;偿还;扣除; [n]获得补偿; [^]z8;
recourse: [-]/ˈriːkɔːrs/; [n]求援(对象),求助(对象,<商><律>追索权; [^]z8;
rectify: [-]/ˈrektɪfaɪ/; [v]纠正;修复; [^]z8;
rectitude: [-]/ˈrektɪtuːd/; [n]正直,公正,正确; [^]z8;
recur: [-]/rɪˈkɜːr/; [v]重新出现;再次发生;重新提起;诉诸;反复; [^]z8;
recurrent: [-]/rɪˈkɜːrənt/; [a]复发的;周期性的,经常发生的; [^]z8;
redemption: [-]/rɪˈdempʃn/; [n]赎回,拯救,偿还,实践; [^]z8;
redolent: [-]/ˈredələnt/; [a]气味强烈的,芬芳的,令人想起..的; [^]z8;
redraw: [-]/ˌriːˈdrɔː/; [v]重画; [^]z8;
redress: [-]/rɪˈdres/; [n]纠正,革除,救济; [v]修正,救济,革除; [^]z8;
redundancy: [-]/rɪˈdʌndənsi/; [n]裁员,<计><数>冗余(等于redundance),人浮于事; [^]z8;
redundant: [-]/rɪˈdʌndənt/; [a]多余的,过剩的;被下岗的; [^]z8;
referendum: [-]/ˌrefəˈrendəm/; [n]公民投票,复决权; [^]z8;
refurbish: [-]/ˌriːˈfɜːrbɪʃ/; [v]刷新,再磨光; [^]z8;
regal: [-]/ˈriːɡl/; [a]帝王的,豪华的,帝王般的; [^]z8;
regeneration: [-]/rɪˌdʒenəˈreɪʃn/; [n]新生,更新,重建; [^]z8;
registrar: [-]/ˌredʒɪˈstrɑːr/; [n]登记员,记录员; [^]z8;
regress: [-]/rɪˈɡres/; [v]后退,退化,恶化; [n]回归;退回; [^]z8;
regressive: [-]/rɪˈɡresɪv/; [a]回归的,后退的,退化的; [^]z8;
regret: [-]/rɪˈɡret/; [n]后悔,遗憾; [vt]懊悔,后悔;抱歉; [vi]感到后悔,感到抱歉; [^]z8;
regularity: [-]/ˌreɡjuˈlærəti/; [n]规律性,整齐,正规事物; [^]z8;
reimburse: [-]/ˌriːɪmˈbɜːrs/; [v]偿还;赔偿;退还(钱),付还; [^]z8;
rein: [-]/reɪn/; [n]缰绳; [v]控制; [^]z8;
reinstate: [-]/ˌriːɪnˈsteɪt/; [vt]使恢复;使复原; [^]z8;
rejuvenate: [-]/rɪˈdʒuːvəneɪt/; [v]使..年轻;使..恢复精神;变年轻; [vi]返老还童,恢复活力,复原; [^]z8;
relapse: [-]/rɪˈlæps/; [n](旧病的)复发,重陷,回复; [vi]重新陷入,回复; [^]z8;
relent: [-]/rɪˈlent/; [v]变温和,变宽厚;减弱;缓和;终于答应;不再拒绝; [^]z8;
relentless: [-]/rɪˈlentləs/; [a]顽强的;持续的;坚定地;冷酷的; [^]z8;
relinquish: [-]/rɪˈlɪŋkwɪʃ/; [v]放弃,让出(权利,财产等),撤回; [^]z8;
relish: [-]/ˈrelɪʃ/; [v]享受;享受.的味道;品味; [n]乐趣;调味品; [^]z8;
remedial: [-]/rɪˈmiːdiəl/; [a]治疗的;补救的;矫正的; [^]z8;
reminiscent: [-]/ˌremɪˈnɪsnt/; [a]怀旧的,回忆的,喜谈往事的,暗示..的,提醒的,使人联想..的; [^]z8;
remission: [-]/rɪˈmɪʃn/; [n]缓解;宽恕;豁免; [^]z8;
remit: [-]/ˈriːmɪt/; [v]汇款,汇寄,饶恕,免除; [n]职权范围,职责; [^]z8;
remittance: [-]/rɪˈmɪtns/; [n]汇款,汇款额; [^]z8;
remnant: [-]/ˈremnənt/; [n]遗迹;边角剩料; [^]z8;
remorse: [-]/rɪˈmɔːrs/; [n]懊悔,自责,同情,怜悯; [^]z8;
remunerate: [-]/rɪˈmjuːnəreɪt/; [v]酬劳;给与报酬;赔偿; [^]z8;
rend: [-]/rend/; [v]撕碎;分裂;强夺; [^]z8;
rendezvous: [-]/ˈrɑːndɪvuː/; [n]集会,幽会,约会地点; [v]约会,幽会,(秘密)集会; [^]z8;
rendition: [-]/renˈdɪʃn/; [n]表演,演奏;译文;给予,提供; [^]z8;
renegade: [-]/ˈrenɪɡeɪd/; [n]叛教者,脱党者,叛徒; [v]背叛,背教,变节; [a]叛教的,背叛的,变节的; [^]z8;
renown: [-]/rɪˈnaʊn/; [n]声誉;名望; [vt]使有声望; [^]z8;
renunciation: [-]/rɪˌnʌnsiˈeɪʃn/; [n]放弃;脱离关系;拒绝承认;抛弃;弃权;出家; [^]z8;
repellent: [-]/rɪˈpelənt/; [a]令人厌恶的; [n]消肿药,驱虫剂; [^]z8;
repentance: [-]/rɪˈpentəns/; [n]悔恨; [^]z8;
repercussion: [-]/ˌriːpərˈkʌʃn/; [n]反响;弹回;反射; [^]z8;
repertoire: [-]/ˈrepərtwɑːr/; [n](剧团,演员等的)全部节目;全部才能; [^]z8;
repine: [-]/rɪ'paɪn/; [v]不满,心中抱怨; [^]z8;
replenish: [-]/rɪˈplenɪʃ/; [v]补充,再装满;把.装满;给.添加燃料; [^]z8;
replica: [-]/ˈreplɪkə/; [n]复制品; [^]z8;
replicate: [-]/ˈreplɪkeɪt/; [v]复制;重复,反复; [^]z8;
repository: [-]/rɪˈpɑːzətɔːri/; [n]储藏室;仓库;智囊人物;知识库; [^]z8;
repress: [-]/rɪˈpres/; [vt]抑制;镇压;约束; [^]z8;
repression: [-]/rɪˈpreʃn/; [n]压抑,压制,镇压; [^]z8;
repressive: [-]/rɪˈpresɪv/; [a]压抑的;抑制的,强制的; [^]z8;
reprimand: [-]/ˈreprɪmænd/; [n](特指当权者进行的)严责,谴责,申斥; [v]申斥,谴责,惩戒; [^]z8;
reprisal: [-]/rɪˈpraɪzl/; [n]报复;报复性劫掠; [^]z8;
reprove: [-]/rɪˈpruːv/; [v]责骂,申斥; [^]z8;
repudiate: [-]/rɪˈpjuːdieɪt/; [v]拒绝,否定,驳斥; [^]z8;
repugnant: [-]/rɪˈpʌɡnənt/; [a]令人厌恶的; [^]z8;
repulse: [-]/rɪˈpʌls/; [n]击退;断然拒绝; [vt]击退;断然拒绝;憎恶; [v]使排斥,使厌恶; [^]z8;
repulsion: [-]/rɪˈpʌlʃn/; [n]排斥;厌恶;反驳; [^]z8;
repulsive: [-]/rɪˈpʌlsɪv/; [a]排斥的,严拒的,令人厌恶的; [^]z8;
reputable: [-]/ˈrepjətəbl/; [a]声誉好的;受尊敬的;卓越的; [^]z8;
repute: [-]/rɪˈpjuːt/; [n]名声,荣誉; [vt]被认为,被称为; [^]z8;
requiem: [-]/ˈrekwiəm/; [n]安魂曲;追思弥撒; [^]z8;
requisite: [-]/ˈrekwɪzɪt/; [n]必需品; [a]需要的,必不可少的,必备的; [^]z8;
requisition: [-]/ˌrekwɪˈzɪʃn/; [n]征用,要求,申请书,引渡要求; [v]征用,申请领取; [^]z8;
reshape: [-]/ˌriːˈʃeɪp/; [v]改造,改变形式; [^]z8;
reshuffle: [-]/ˈriːʃʌfl/; [v]再洗牌,改组,重新安排; [n]改组;重新洗牌; [^]z8;
resigned: [-]/rɪˈzaɪnd/; [a]逆来顺受的;已辞职的;已放弃的; [^]z8;
resilience: [-]/rɪˈzɪliəns/; [n]恢复力;弹力;顺应力; [^]z8;
resin: [-]/ˈrezn/; [n]树脂,松香; [vt]涂树脂,用树脂处理; [^]z8;
respectability: [-]/rɪˌspektəˈbɪləti/; [n]体面,可尊敬,有社会地位; [^]z8;
respite: [-]/ˈrespɪt/; [n]缓解;暂缓;暂时的休息;缓期执行; [v]使缓解;使暂缓;使延期;缓期执行; [^]z8;
resplendent: [-]/rɪˈsplendənt/; [a]华丽的,辉煌的; [^]z8;
restitution: [-]/ˌrestɪˈtuːʃn/; [n]归还,赔偿; [^]z8;
resultant: [-]/rɪˈzʌltənt/; [a]作为结果的; [^]z8;
resurrect: [-]/ˌrezəˈrekt/; [v]复苏,复兴;使复活; [^]z8;
resuscitation: [-]/rɪˌsʌsɪˈteɪʃn/; [n]复活,苏醒; [^]z8;
retainer: [-]/rɪˈteɪnər/; [n]保持器;家臣;保持者;<机>护圈;预付费用; [^]z8;
retaliate: [-]/rɪˈtælieɪt/; [v]报复,反击; [^]z8;
retard: [-]/rɪˈtɑːrd/; [v]延迟,使减速; [n]妨碍,阻碍; [^]z8;
retention: [-]/rɪˈtenʃn/; [n]保留,保持; [^]z8;
reticent: [-]/ˈretɪsnt/; [a]沉默不语的;有保留的;含蓄的; [^]z8;
retribution: [-]/ˌretrɪˈbjuːʃn/; [n]报应,惩罚,报答,报偿; [^]z8;
retrieve: [-]/rɪˈtriːv/; [v]取回,重新得到,挽回,检索; [^]z8;
retrospective: [-]/ˌretrəˈspektɪv/; [a]回顾的;怀旧的;可追溯的; [n]作品回顾展出; [^]z8;
revamp: [-]/ˈriːvæmp/; [v]翻新,整修,升级; [n]改进,换新鞋面; [^]z8;
revel: [-]/ˈrevl/; [n]狂欢; [v]狂欢; [^]z8;
revere: [-]/rɪˈvɪr/; [v]敬畏;尊敬;崇敬; [^]z8;
reverence: [-]/ˈrevərəns/; [n]崇敬,尊严,敬礼; [v]敬畏,尊敬; [^]z8;
reverent: [-]/ˈrevərənt/; [a]虔诚的,恭敬的; [^]z8;
reverie: [-]/ˈrevəri/; [n]幻想,沉思,幻想曲; [^]z8;
reversion: [-]/rɪˈvɜːrʒn/; [n]逆转,回复,归还,<遗>隔代遗传,<法>继承权; [^]z8;
revoke: [-]/rɪˈvoʊk/; [v]撤回,取消;废除; [n]有牌不跟; [^]z8;
revulsion: [-]/rɪˈvʌlʃn/; [n]剧变,厌恶,强烈反感; [^]z8;
rhinoceros: [-]/raɪˈnɑːsərəs/; [n]犀牛; [^]z8;
rickety: [-]/ˈrɪkəti/; [a]佝偻病的;摇晃的;蹒跚的;不结实的; [^]z8;
rift: [-]/rɪft/; [n]裂缝,裂口; [^]z8;
rig: [-]/rɪɡ/; [n]钻井架;装备;帆具;成套器械; [v]操纵;装配;欺骗; [^]z8;
righteous: [-]/ˈraɪtʃəs/; [a]正直的,正当的,公正的; [^]z8;
rigmarole: [-]/ˈrɪɡməroʊl/; [n]冗长无聊的废话; [^]z8;
rigorous: [-]/ˈrɪɡərəs/; [a]严厉的,严格的; [^]z8;
rind: [-]/raɪnd/; [n]壳,外皮; [vt]剥去.的皮; [^]z8;
rink: [-]/rɪŋk/; [n]溜冰场,冰球场,室内溜冰场; [vi]溜冰; [^]z8;
rinse: [-]/rɪns/; [v](用清水)刷,冲洗掉,漂净,漱口; [n]嗽洗,漂洗,漂清,冲洗; [^]z8;
rivet: [-]/ˈrɪvɪt/; [n]铆钉; [v](用铆钉)铆接,敲打(螺栓)使成铆钉头,吸引(注意力); [^]z8;
roach: [-]/roʊtʃ/; [n]蟑螂,蜚蠊; [vt]梳(发)使成拱状,切短(马鬃等)使竖立; [^]z8;
robust: [-]/roʊˈbʌst/; [a]健壮的,强壮的;精力充沛的;坚固的;粗鲁的; [^]z8;
rocker: [-]/ˈrɑːkər/; [n]摇者,摇杆,摇滚乐歌手,镰刀弯,套钩; [^]z8;
rodent: [-]/ˈroʊdnt/; [n]啮齿类动物(如鼠等); [^]z8;
rodeo: [-]/ˈroʊdioʊ/; [n]牧马骑术表演,竞技者; [v]竞技; [^]z8;
rookie: [-]/ˈrʊki/; [n]新手,新兵,新球员; [^]z8;
roost: [-]/ruːst/; [n]鸟窝,巢穴,栖木; [vi]栖息; [^]z8;
rostrum: [-]/ˈrɑːstrəm/; [n]讲坛,讲台; [^]z8;
roundup: [-]/'raʊndˌʌp/; [n]综述,集拢,围捕; [^]z8;
rouse: [-]/raʊz/; [vt]唤醒,唤起;激起; [^]z8;
rove: [-]/roʊv/; [vt]漫游于,漂泊于; [vi]流浪,飘忽不定; [n]流浪,徘徊,粗纺线; [^]z8;
rubble: [-]/ˈrʌbl/; [n]碎石,瓦砾; [^]z8;
ruddy: [-]/ˈrʌdi/; [a]红的,红润的; [ad]极度,非常; [vt]使变红; [^]z8;
rudimentary: [-]/ˌruːdɪˈmentri/; [a]基本的,初期的;发育不完全的;退化的; [^]z8;
rue: [-]/ruː/; [v]后悔,遗憾; [^]z8;
rueful: [-]/ˈruːfl/; [a]悔恨的; [^]z8;
ruffian: [-]/ˈrʌfiən/; [n]流氓,无赖,恶棍; [a]凶狠的,残暴的,无法无天的; [^]z8;
ruffle: [-]/ˈrʌfl/; [vt]弄皱;使生气,扰乱;连续地轻敲;使起波浪; [n]皱纹;生气;混乱; [vi]起皱;愤怒; [^]z8;
ruinous: [-]/ˈruːɪnəs/; [a]毁坏的;毁灭性的,破坏性的; [^]z8;
rumble: [-]/ˈrʌmbl/; [vt]使隆隆响; [v]低沉地说; [n]隆隆声;抱怨声; [vi]隆隆响; [^]z8;
rummage: [-]/ˈrʌmɪdʒ/; [n]杂物,翻寻; [v]彻底搜查,翻箱倒柜; [^]z8;
rupture: [-]/ˈrʌptʃər/; [n]破裂;割裂; [v]使破裂;断绝(关系); [^]z8;
rustle: [-]/ˈrʌsl/; [v]发出沙沙声,使沙沙作响,偷窃; [n]沙沙声; [^]z8;
rut: [-]/rʌt/; [n]发情期,惯例,车辙; [vt]犁; [vi]处于发情发动期; [a]处于发情期的; [^]z8;
sabotage: [-]/ˈsæbətɑːʒ/; [n]怠工,蓄意破坏,妨碍; [v]怠工,从事破坏活动,故意阻挠; [^]z8;
sabre: [-]/ˈseɪbər/; [n]军刀,击剑用刀; [^]z8;
sacrament: [-]/ˈsækrəmənt/; [n]圣礼,圣事; [vt]使立誓,使宣誓; [^]z8;
sacrilegious: [-]/ˌsækrəˈlɪdʒəs/; [a]该受天谴的,亵渎神明的; [^]z8;
safari: [-]/səˈfɑːri/; [n]狩猎旅行(特指在非洲东部〕,长途考察,野生动物园; [^]z8;
sag: [-]/sæɡ/; [v]下跌,下垂,消沉; [n]下垂,下陷,物价下跌; [^]z8;
saga: [-]/ˈsɑːɡə/; [n]传奇故事;冒险故事;一连串的事件(或经历); [^]z8;
sagacious: [-]/səˈɡeɪʃəs/; [a]有洞察力的,有远见的,精明的,敏锐的; [^]z8;
sage: [-]/seɪdʒ/; [a]贤明的,审慎的; [n]圣人,年高望重的人; [^]z8;
salient: [-]/ˈseɪliənt/; [a]显著的;突出的;跳跃的; [n]凸角;突出部分; [^]z8;
saline: [-]/ˈseɪliːn/; [a]咸的,含盐的; [^]z8;
sallow: [-]/ˈsæloʊ/; [a]病黄色的,气色不好的; [n]黄华柳;山毛柳;黄华柳细枝;黄华柳木; [^]z8;
salutary: [-]/ˈsæljəteri/; [a]有益的,有益健康的; [^]z8;
salvage: [-]/ˈsælvɪdʒ/; [n]抢救;从灾难中抢救出的物资; [vt]拯救;打捞; [^]z8;
salvo: [-]/ˈsælvoʊ/; [n]齐射,齐鸣,齐声欢呼喝彩,保留条款,遁辞; [v]齐鸣; [^]z8;
sanctify: [-]/ˈsæŋktɪfaɪ/; [vt]使神圣化,使合法化; [^]z8;
sanctuary: [-]/ˈsæŋktʃueri/; [n]圣堂,避难所; [^]z8;
sanctum: [-]/ˈsæŋktəm/; [n]圣地,密室; [^]z8;
sanguine: [-]/ˈsæŋɡwɪn/; [a]乐观的,(脸色等)有血色的,多血质的; [n]血红色,乐观; [^]z8;
sap: [-]/sæp/; [n]树液,汁液;易上当的人; [v]削弱;逐渐耗竭; [vt]使伤元气; [vi]挖坑道进攻; [^]z8;
sardonic: [-]/sɑːrˈdɑːnɪk/; [a]讽刺的,嘲笑的; [^]z8;
sartorial: [-]/sɑːrˈtɔːriəl/; [a]裁缝匠的,裁缝的;缝纫的; [^]z8;
sash: [-]/sæʃ/; [n]饰带,肩带,腰带; [v]用饰带装饰;给.系上腰带<饰带>;在.上装吊窗;给.装上窗格; [^]z8;
satiate: [-]/ˈseɪʃieɪt/; [v]使饱足,生腻; [a]饱足的;厌腻的; [^]z8;
savant: [-]/sæˈvɑːnt/; [n]博学之士,大学士; [^]z8;
savor: [-]/ˈseɪvər/; [n]味道,气味,特点,趣味; [v]调味,品尝,欣赏,玩味; [^]z8;
scaffold: [-]/ˈskæfoʊld/; [n]支架;断头台;脚手架;脚手架材料; [vt]给.搭脚手架; [^]z8;
scalpel: [-]/ˈskælpəl/; [n]外科手术刀,解剖刀; [^]z8;
scathing: [-]/ˈskeɪðɪŋ/; [a]严厉的;损伤的; [v]损伤;伤害; [^]z8;
scavenge: [-]/ˈskævɪndʒ/; [v](在废物中)寻觅;(动物)食腐肉;打扫;排除废气; [^]z8;
scavenger: [-]/ˈskævɪndʒər/; [n]捡垃圾者;食腐动物;净化剂; [vi]作清道夫; [^]z8;
scenario: [-]/səˈnærioʊ/; [n]剧情梗概;情况,情节;设想; [^]z8;
schizophrenia: [-]/ˌskɪtsəˈfriːniə/; [n]<内科>精神分裂症; [^]z8;
scholarly: [-]/ˈskɑːlərli/; [a]学者气质的,学者风度的,学术的; [^]z8;
scoff: [-]/skɔːf/; [vi]讥笑; [v]嘲笑; [n]愚弄; [^]z8;
scour: [-]/ˈskaʊər/; [v]搜查;洗涤,洗刷,擦洗;冲刷成,冲刷出; [^]z8;
scowl: [-]/skaʊl/; [n]愁容,怒容,暴风雨前的阴沉晦暗; [v]皱眉头,怒目而视; [^]z8;
scrawl: [-]/skrɔːl/; [n]潦草的笔迹; [v]乱涂,乱写,潦草地写; [^]z8;
screech: [-]/skriːtʃ/; [vi]发出尖锐的声音,发出恐惧或痛苦的叫喊声; [n]尖叫声,尖利刺耳的声音,尖声喊叫; [vt]尖着声音讲或喊; [^]z8;
scripture: [-]/ˈskrɪptʃər/; [n]经文;圣经; [^]z8;
scrub: [-]/skrʌb/; [v]用力擦洗;宣布中止; [n]灌木丛;擦洗; [^]z8;
scruple: [-]/ˈskruːpl/; [n]顾虑,不安; [vi]有顾虑,良心上感到不安; [^]z8;
scrupulous: [-]/ˈskruːpjələs/; [a]小心谨慎的;严谨的;细心的; [^]z8;
scrutinize: [-]/ˈskruːtənaɪz/; [v]仔细检查,细看; [^]z8;
scuba: [-]/'skjuːbə/; [n]自携式水下呼吸器; [^]z8;
scuffle: [-]/ˈskʌfl/; [v]混战,扭打,拖着脚步快速行走; [n]混战,扭打; [^]z8;
scum: [-]/skʌm/; [n]浮沫,浮渣; [^]z8;
scurry: [-]/ˈskɜːri/; [v]快速疾走,急跑,急躁不安地来回走动; [n]快步急跑;疾走;仓皇奔跑声;骤雨; [^]z8;
secession: [-]/sɪˈseʃn/; [n]脱离,退出; [^]z8;
seclude: [-]/sɪˈkluːd/; [v]与世隔绝,使隔绝; [^]z8;
secluded: [-]/sɪˈkluːdɪd/; [a]隐遁的,隔绝的; [^]z8;
secrete: [-]/sɪˈkriːt/; [v]藏匿;私下侵吞;分泌; [^]z8;
secretive: [-]/ˈsiːkrətɪv/; [a]秘密的;偷偷摸摸的;促进分泌的; [^]z8;
sedan: [-]/sɪˈdæn/; [n]轿子,轿车,单舱汽艇; [^]z8;
sedative: [-]/ˈsedətɪv/; [a](药物)镇静的,起镇定作用的; [n](药物)镇静剂,起镇定作用的东西; [^]z8;
seduce: [-]/sɪˈduːs/; [v]引诱,诱使,诱惑,勾引;着迷; [^]z8;
seduction: [-]/sɪˈdʌkʃn/; [n]诱惑,魅力;诱惑物; [^]z8;
seductive: [-]/sɪˈdʌktɪv/; [a]有魅力的;性感的;引人注意的; [^]z8;
seedy: [-]/ˈsiːdi/; [a]多种子的,结籽的,破旧的,褴褛的; [^]z8;
seep: [-]/siːp/; [v](液体等)渗漏,(观念等)渗入,(疾病恐惧等)扩散; [n]小泉,水陆两用的吉普车; [^]z8;
seethe: [-]/siːð/; [v]沸腾;汹涌;激动; [^]z8;
segregate: [-]/ˈseɡrɪɡeɪt/; [v]分开,隔离,进行种族隔离; [^]z8;
segregation: [-]/ˌseɡrɪˈɡeɪʃn/; [n]分离,隔离,种族隔离; [^]z8;
selenium: [-]/səˈliːniəm/; [n]硒; [^]z8;
semblance: [-]/ˈsembləns/; [n]相似;外表,外貌; [^]z8;
seminal: [-]/ˈsemɪnl/; [a]重要的,精液的,种子的; [^]z8;
senile: [-]/ˈsiːnaɪl/; [a]年老的,衰老的,因年老发生的(记忆力衰退等); [^]z8;
sensor: [-]/ˈsensər/; [n]传感器,灵敏元件; [^]z8;
sensory: [-]/ˈsensəri/; [a]知觉的;感觉的;知觉器官的;感觉的; [^]z8;
sensual: [-]/ˈsenʃuəl/; [a]感官的;色情的,肉欲的; [^]z8;
sensuous: [-]/ˈsenʃuəs/; [a]感觉上的,依感观的,诉诸美感的; [^]z8;
sentinel: [-]/ˈsentɪnl/; [n]哨兵,看守; [v]守卫,放哨; [^]z8;
sentry: [-]/ˈsentri/; [n]哨兵,警卫; [vi]站岗,放哨; [vt]设岗哨; [^]z8;
sequel: [-]/ˈsiːkwəl/; [n]续集;结局;继续;后果; [^]z8;
serrated: [-]/səˈreɪtɪd/; [a]呈锯齿状的; [^]z8;
servile: [-]/ˈsɜːrvl/; [a]奴颜婢膝的,卑屈的,隶属的; [n]奴隶; [^]z8;
servitude: [-]/ˈsɜːrvətuːd/; [n]劳役,奴役; [^]z8;
severity: [-]/sɪˈverəti/; [n]严格,严肃; [^]z8;
sexism: [-]/ˈseksɪzəm/; [n](针对女性的)性别歧视,男性至上主义; [^]z8;
sexist: [-]/ˈseksɪst/; [n]性别歧视者,男性至上主义者; [a]性别主义者的,性别歧视者的; [^]z8;
shack: [-]/ʃæk/; [n]棚屋;小室; [v]居住; [^]z8;
shag: [-]/ʃæɡ/; [n]粗毛,粗烟丝,蓬乱一团; [v]使杂乱,使蓬松; [a]有粗毛的,蓬乱的; [^]z8;
sham: [-]/ʃæm/; [n]假货;虚假;欺诈; [v]假装; [a]虚假的,假装的; [^]z8;
shamble: [-]/ˈʃæmbl/; [v]蹒跚,拖沓; [n]蹒跚;摇晃的脚步;(pl.)混乱,废墟; [^]z8;
shapely: [-]/ˈʃeɪpli/; [a]定形的;形状美观的;样子好的;有条理的; [^]z8;
shatter: [-]/ˈʃætər/; [v]使粉碎;砸碎;打碎;粉碎; [^]z8;
sheaf: [-]/ʃiːf/; [n]一捆,一束; [v]捆,束; [^]z8;
shear: [-]/ʃɪr/; [vt]剪羊毛;剪头发; [n](复数)大剪刀; [^]z8;
sheath: [-]/ʃiːθ/; [n](刀,剑)鞘,护套,(植)叶鞘; [^]z8;
sheepish: [-]/ˈʃiːpɪʃ/; [a]羞怯的,腼腆的(像绵羊一样)驯顺的,胆怯的,愚钝的; [^]z8;
shimmer: [-]/ˈʃɪmər/; [v]闪烁,微微发亮; [n]微光,闪光; [^]z8;
shin: [-]/ʃɪn/; [n]胫骨; [v]爬,攀,快步走; [^]z8;
shirk: [-]/ʃɜːrk/; [v]逃避;规避(义务,责任等); [n]偷懒者; [^]z8;
shoal: [-]/ʃoʊl/; [n]浅滩,沙洲,一群(鱼); [a](水)浅的; [v]变成浅滩;驶入浅水的地方;(鱼)成群集聚; [^]z8;
shoddy: [-]/ˈʃɑːdi/; [a]劣等的;假的;冒充的;虚有其表的; [n]赝品,不值钱的东西; [^]z8;
shortfall: [-]/ˈʃɔːrtfɔːl/; [n]不足,亏空; [^]z8;
shove: [-]/ʃʌv/; [v]推;猛推; [n]推搡; [^]z8;
showy: [-]/ˈʃoʊi/; [a]华丽的,(过分)艳丽的,浮华的; [^]z8;
shred: [-]/ʃred/; [n]碎片,少量,毁灭; [v]切成细条,撕成碎片; [^]z8;
shrinkage: [-]/ˈʃrɪŋkɪdʒ/; [n]收缩;减低; [^]z8;
shrivel: [-]/ˈʃrɪvl/; [v]枯萎,皱缩; [^]z8;
shroud: [-]/ʃraʊd/; [n]寿衣,覆盖物; [v]覆盖,包以尸衣; [^]z8;
shuffle: [-]/ˈʃʌfl/; [n]拖着脚走路;混淆;洗牌; [vi]拖着脚走;推诿;洗牌; [vt]拖着;弄混;洗牌; [^]z8;
shun: [-]/ʃʌn/; [v](有意或习惯性地)避开,躲开; [^]z8;
shunt: [-]/ʃʌnt/; [n]转轨;<电>分流器; [v]使(火车)转到另一轨道,转移方向; [^]z8;
sibling: [-]/ˈsɪblɪŋ/; [n]兄弟姊妹;同胞;(生物)同科,同属; [^]z8;
sideline: [-]/ˈsaɪdlaɪn/; [n]球场边线,副业; [v]迫使退出; [^]z8;
sidestep: [-]/ˈsaɪdstep/; [n](侧面)台阶;拳击等横跨一步躲避打击;［喻］回避(困难); [v]回避;横跨一步躲避; [^]z8;
sierra: [-]/siˈerə/; [n]锯齿山脊,呈齿状起伏的山脉; [^]z8;
silhouette: [-]/ˌsɪluˈet/; [v]使显出轮廓(或影像); [n]影子,轮廓; [^]z8;
silica: [-]/ˈsɪlɪkə/; [n]二氧化硅,硅石; [^]z8;
silt: [-]/sɪlt/; [n]淤泥,淤沙; [v]淤塞; [^]z8;
simpleton: [-]/ˈsɪmpltən/; [n]傻子;笨蛋; [^]z8;
simulate: [-]/ˈsɪmjuleɪt/; [v]假装;模仿;模拟; [^]z8;
sinew: [-]/ˈsɪnjuː/; [n]腱,筋,中坚力量; [v]用腱连结,(好像使用肌筋似的)给..以力量,支持; [^]z8;
singe: [-]/sɪndʒ/; [n](轻微的)烧焦; [v](轻微地)烧焦,烫焦; [^]z8;
sinuous: [-]/ˈsɪnjuəs/; [a]弯曲的,蜿蜒的; [^]z8;
sip: [-]/sɪp/; [v]啜饮; [n]一小口; [^]z8;
skid: [-]/skɪd/; [v]打滑; [n]打滑; [^]z8;
skinny: [-]/ˈskɪni/; [a]瘦削的,皮包骨的;皮状的,皮质的〈俚〉吝啬的; [n](不公开的)信息,内幕消息; [^]z8;
skipper: [-]/ˈskɪpər/; [n]队长,船长,机长; [v]带领,作.的船长(或机长); [^]z8;
slab: [-]/slæb/; [n]厚片,硬板; [v]把.分成厚片;用石板铺; [^]z8;
slag: [-]/slæɡ/; [n]炉渣,矿渣; [^]z8;
slash: [-]/slæʃ/; [n]砍痕;砍; [v]砍,大幅度削减; [^]z8;
slavish: [-]/ˈsleɪvɪʃ/; [a]照搬的,刻板模仿的;盲从的; [^]z8;
sleazy: [-]/ˈsliːzi/; [a]质地单薄的,低劣的,肮脏的; [^]z8;
sleek: [-]/sliːk/; [a](毛发等)柔滑的;性格油滑的,嘴甜的,圆滑的; [v]使光滑,使有光泽;(口语)滑动(口语)打扮整洁; [^]z8;
sleeper: [-]/ˈsliːpər/; [n]睡眠者;卧车,卧铺;枕木; [^]z8;
slick: [-]/slɪk/; [a]光滑的;圆滑的;顺利的;不费力的; [n]海面浮油;小块湿润的区域; [v]使平滑; [^]z8;
slime: [-]/slaɪm/; [n]烂泥;粘土;黏液; [vi]覆有黏液; [vt]用(稀泥,粘液等)涂抹,使变黏滑; [^]z8;
slimy: [-]/ˈslaɪmi/; [a]黏糊糊的;黏滑的;谄媚的; [^]z8;
slink: [-]/slɪŋk/; [v]潜逃,溜走,早产,潜逃; [n]早产的动物,鬼鬼祟祟的人; [a]早产的; [^]z8;
slit: [-]/slɪt/; [n]投币口,裂缝; [v]切开; [^]z8;
slither: [-]/ˈslɪðər/; [v](蛇)滑动,滑行; [n]滑动;滑行; [^]z8;
sliver: [-]/ˈslɪvər/; [n]长条,细片; [v]裂成细片; [^]z8;
slouch: [-]/slaʊtʃ/; [v]耷拉,低垂,使低垂; [n](帽边等的)下垂,耷拉,萎靡不振的人; [^]z8;
slug: [-]/slʌɡ/; [n]鼻涕虫,子弹,懒汉; [vi]偷懒; [vt]<印刷>在.插嵌片; [^]z8;
slump: [-]/slʌmp/; [v]突然倒下;暴跌; [n]下降;经济萧条时期; [^]z8;
slur: [-]/slɜːr/; [n]含糊的发音,藐视,污点,连线符; [vi]含糊地说; [vt]对.忽略,含糊不清地说出,贬低; [^]z8;
smolder: [-]/ˈsmoʊldər/; [v]无火焰地闷烧,(仇恨,嫉妒,愤怒等)在心里郁积; [n]焖烧,文火,冒烟; [^]z8;
smother: [-]/ˈsmʌðər/; [v]窒息; [^]z8;
smug: [-]/smʌɡ/; [a]自鸣得意的; [^]z8;
snare: [-]/sner/; [n]罗网;陷阱;圈套; [^]z8;
snarl: [-]/snɑːrl/; [v]缠结,混乱,吠,咆哮,怒骂; [n]咆哮,吼叫,怒骂,缠结,混乱; [^]z8;
snigger: [-]/ˈsnɪɡər/; [v]嘻皮笑脸地笑,吃吃地笑,窃笑; [n]窃笑; [^]z8;
snivel: [-]/ˈsnɪvl/; [v]流鼻涕;啜泣; [^]z8;
snooty: [-]/ˈsnuːti/; [a]自大的,傲慢的; [^]z8;
snort: [-]/snɔːrt/; [v]轻蔑或愤怒地发出哼声,喷出蒸汽声,吸毒品; [n]喷鼻息,一小杯酒; [^]z8;
snout: [-]/snaʊt/; [n]猪嘴,猪鼻子; [v]装管嘴; [^]z8;
snub: [-]/snʌb/; [n]冷落,怠慢; [vt]冷落;断然拒绝;掐灭; [a]故意冷落的,断然拒绝的,斥责的; [^]z8;
snuff: [-]/snʌf/; [v](伤风鼻阻时)用鼻子使劲地吸,扑灭; [n]灯花,烛花,鼻吸气息,气息; [^]z8;
sobriety: [-]/səˈbraɪəti/; [n]清醒,冷静,节制,严肃; [^]z8;
sod: [-]/sɑːd/; [n]草地,草皮; [v]铺上草皮,以生草土覆盖,铺草皮于; [int]该死的,该死的; [^]z8;
solace: [-]/ˈsɑːləs/; [n]慰藉,给予安慰的人或事物; [v]安慰,缓和,使开心; [^]z8;
solemnity: [-]/səˈlemnəti/; [n]庄严,肃穆,庄严的仪式; [^]z8;
soliloquy: [-]/səˈlɪləkwi/; [n]自言自语,独白; [^]z8;
solvency: [-]/ˈsɑːlvənsi/; [n]偿付能力;溶解力; [^]z8;
solvent: [-]/ˈsɑːlvənt/; [a]有偿付能力的;有溶解力的; [n]溶剂;解决方法; [^]z8;
somber: [-]/'sɒmbə/; [a]忧郁的;昏暗的,阴天的; [^]z8;
sonata: [-]/səˈnɑːtə/; [n]奏鸣曲; [^]z8;
sophist: [-]/ˈsɑːfɪst/; [n]诡辩家,哲学家; [^]z8;
soprano: [-]/səˈprɑːnoʊ/; [n]女高音,女高音歌手,女高音声部; [a]女高音的,童声高音的,女高音声部的; [^]z8;
sordid: [-]/ˈsɔːrdɪd/; [a]卑鄙的,肮脏的,色彩死气沉沉暗淡的; [^]z8;
spar: [-]/spɑːr/; [n]圆材(如桅,桁等),争论,拳斗; [v]争论,拳击; [^]z8;
sparingly: [-]/ˈsperɪŋli/; [ad]节俭地,有节制地; [^]z8;
spasm: [-]/ˈspæzəm/; [v]痉挛,抽搐; [n]痉挛; [^]z8;
spate: [-]/speɪt/; [n]洪水;一阵;大雨;突然迸发; [^]z8;
spatial: [-]/ˈspeɪʃl/; [a]空间的,关于空间的; [^]z8;
speckle: [-]/ˈspekl/; [n]斑点; [v]使弄上斑点,沾污; [^]z8;
specter: [-]/'spektə/; [n]鬼魂,幽灵,恐惧; [^]z8;
spectrum: [-]/ˈspektrəm/; [n]光谱,范围,系列; [^]z8;
spinner: [-]/ˈspɪnər/; [n]纺纱机,纺纱工人,旋式诱饵; [^]z8;
spleen: [-]/spliːn/; [n]脾,脾气,怒气; [^]z8;
splutter: [-]/ˈsplʌtər/; [n]劈啪声,急忙说出的话,杂乱的声音; [v]喷溅,气急败坏地说; [^]z8;
sporadic: [-]/spəˈrædɪk/; [a]不定时发生的;零星的;分散的; [^]z8;
spout: [-]/spaʊt/; [v]滔滔不绝地讲;喷出;(鲸鱼)喷射; [vt]把.典当掉; [n]喷口;水管;水柱;水龙卷;水落管; [^]z8;
sprawl: [-]/sprɔːl/; [n]四肢伸开的躺卧姿势;蔓生; [v]四肢伸开地坐(或卧);爬行;蔓生; [^]z8;
sprint: [-]/sprɪnt/; [v]疾跑,冲刺; [n]全速奔跑; [^]z8;
spurious: [-]/ˈspjʊriəs/; [a]假的,伪造的,欺骗的; [^]z8;
squabble: [-]/ˈskwɑːbl/; [v]发生口角,大声争吵; [n]争吵,口角; [^]z8;
squalid: [-]/ˈskwɑːlɪd/; [a]污秽的,肮脏的,卑劣的; [^]z8;
squall: [-]/skwɔːl/; [n](通常伴随着雨或雪的)风暴,暴风雪; [v]尖叫; [^]z8;
squalor: [-]/ˈskwɑːlər/; [n]肮脏,邋遢,(道德品质等的)卑劣; [^]z8;
squash: [-]/skwɑːʃ/; [v]压扁,压制; [n]南瓜,易压烂的物品,拥挤的人群,壁球; [^]z8;
squeak: [-]/skwiːk/; [v]尖叫,以短促尖锐声发出,险胜; [n]吱吱声,机会; [^]z8;
squeal: [-]/skwiːl/; [n]长而尖锐的刺耳叫声; [vi]发出长而尖锐的刺耳叫声; [vt]以尖厉刺耳的声音发出; [^]z8;
squeamish: [-]/ˈskwiːmɪʃ/; [a]害怕的,易受惊的,想呕吐的; [n]易心烦意乱的人;神经脆弱的人; [^]z8;
squint: [-]/skwɪnt/; [v]斜视,眯眼睛看; [a]斜着眼的;斜视的;细眯着眼看的;倾斜的;偏移的; [n]斜视眼;斜视斜眼;趋势; [^]z8;
squirm: [-]/skwɜːrm/; [v]蠕动,面容扭曲; [n]蠕动; [^]z8;
squirt: [-]/skwɜːrt/; [v]喷射,喷湿,喷出; [n]喷,细的喷流,讨厌鬼; [^]z8;
staccato: [-]/stəˈkɑːtoʊ/; [a](音乐)断音的,不连贯的; [n]断奏;断续的一段音乐;不连贯的东西(如说话,发动机的声音等); [ad]断音地;不连接地; [^]z8;
stag: [-]/stæɡ/; [n]牡鹿;不带女伴的舞客;阉割过的雄鹿; [a]全是男人的; [v]不带女伴参加晚会; [^]z8;
stalemate: [-]/ˈsteɪlmeɪt/; [n]和棋局面,僵局; [v]使陷入僵局; [^]z8;
stalk: [-]/stɔːk/; [n]茎,梗; [v]隐伏跟踪,(为搜索而)走遍;高视阔步,蔓延; [^]z8;
stallion: [-]/ˈstæliən/; [n]种马,成年公马; [^]z8;
stalwart: [-]/ˈstɔːlwərt/; [n]坚定的成员;健壮的人; [a]强壮的,坚定的,忠诚的; [^]z8;
stamina: [-]/ˈstæmɪnə/; [n]耐力,持久力; [^]z8;
stance: [-]/stæns/; [n]立场,姿态,位置; [^]z8;
stanza: [-]/ˈstænzə/; [n]诗节; [^]z8;
stardom: [-]/ˈstɑːrdəm/; [n]明星地位;演员身份;明星界; [^]z8;
stark: [-]/stɑːrk/; [a]完全的,明显的,荒凉的; [ad]完全,明显地; [^]z8;
stately: [-]/ˈsteɪtli/; [a]雄伟的;庄重的,庄严的; [ad]雄伟,壮观; [^]z8;
stealth: [-]/stelθ/; [n]隐秘,秘密; [^]z8;
stealthily: [-]/ˈstelθɪli/; [ad]暗地里,悄悄地; [^]z8;
steep: [-]/stiːp/; [v]沉浸于..; [a]陡峭的;急剧的;过高的; [n]陡坡; [^]z8;
stereotype: [-]/ˈsteriətaɪp/; [n]老套的模式,陈规,成见; [v]对..产生成见; [^]z8;
sterilize: [-]/ˈsterəlaɪz/; [vt]消毒;使不孕;使(土地)不毛; [^]z8;
stethoscope: [-]/ˈsteθəskoʊp/; [n]听诊器; [v]用听诊器诊察; [^]z8;
stimulant: [-]/ˈstɪmjələnt/; [n]<药>兴奋剂;刺激物;酒精饮料; [a]激励的;使人兴奋的; [^]z8;
stint: [-]/stɪnt/; [n]节约;从事某工作的时间;固定; [v]节省;限制; [^]z8;
stipend: [-]/ˈstaɪpend/; [n]奖学金;固定薪金;定期津贴;养老金; [^]z8;
stipulate: [-]/ˈstɪpjuleɪt/; [v]规定;保证;保证;要求以.为条件; [^]z8;
stoic: [-]/ˈstoʊɪkl/; [n]斯多葛学派哲学家;禁欲主义者;坚守克己之人; [a]斯多葛派的;禁欲主义的; [^]z8;
stoke: [-]/stoʊk/; [v]添加燃料,把(火)拨旺,狼吞虎咽吃; [n]斯托克;<物>沲; [^]z8;
stoppage: [-]/ˈstɑːpɪdʒ/; [n]停止,故障,罢工; [^]z8;
stow: [-]/stoʊ/; [v]装载,收藏,使暂留; [n]斯托; [^]z8;
strained: [-]/streɪnd/; [a]紧张的,不友善的,勉强的,不自然的(态度等),牵强附会的; [^]z8;
strand: [-]/strænd/; [n](线等的)股,缕;一个组成部分;海滨,河岸,海滩,湖滨; [v]使陷入困境;使滞留,使搁浅; [^]z8;
stratify: [-]/ˈstrætɪfaɪ/; [v]分层,成层,阶层化; [^]z8;
stratum: [-]/ˈstreɪtəm/; [n]层次;薄层;地层;阶层; [^]z8;
strenuous: [-]/ˈstrenjuəs/; [a]费力的;奋发的;热心的;艰苦的;紧张的; [^]z8;
strew: [-]/struː/; [vt]撒;把.撒在.上;散播,点缀; [^]z8;
stricture: [-]/ˈstrɪktʃər/; [n]谴责;严厉;束缚; [^]z8;
strident: [-]/ˈstraɪdnt/; [a]尖声的,刺耳的; [^]z8;
stringent: [-]/ˈstrɪndʒənt/; [a]严厉的;迫切的;银根紧的; [^]z8;
strut: [-]/strʌt/; [n]高视阔步,抗压装置; [v]昂首阔步地走,趾高气昂地走; [^]z8;
stub: [-]/stʌb/; [n]存根;烟蒂;树桩;断株; [v]踩熄;连根拔除; [^]z8;
stubble: [-]/ˈstʌbl/; [n]残株,发茬,须茬; [^]z8;
stuffy: [-]/ˈstʌfi/; [a]闷热的;古板的;鼻子不通气的; [^]z8;
stupendous: [-]/stuːˈpendəs/; [a]巨大的,大得惊人的; [^]z8;
stupor: [-]/ˈstuːpər/; [n]恍惚,昏迷,不醒人事; [^]z8;
subjection: [-]/səbˈdʒekʃn/; [n]隶属;服从;支配; [^]z8;
sublime: [-]/səˈblaɪm/; [a]雄伟的,崇高的,极端的,超群的;(行为,态度)极端的,漠不关心的; [n]顶峰,崇高; [v]使.纯化,使.升华,变高尚; [^]z8;
subside: [-]/səbˈsaɪd/; [vi]平息,减弱;减弱;(建筑)下陷;(尤指洪水的水位) 回落; [^]z8;
substantiate: [-]/səbˈstænʃieɪt/; [v]证实;使实体化; [^]z8;
substantive: [-]/səbˈstæntɪv/; [a]有实质的;大量的;真实的;独立存在的; [n]实词,名词,名词性词组; [^]z8;
suburbanite: [-]/səˈbɜːrbənaɪt/; [n]郊区居民; [^]z8;
subversive: [-]/səbˈvɜːrsɪv/; [n]颠覆分子,破坏分子; [a]颠覆性的,破坏性的; [^]z8;
succor: [-]/ˈsʌkər/; [n]救援,援助者,救援人员; [v]援助,救援; [^]z8;
succulent: [-]/ˈsʌkjələnt/; [n]肉质植物; [a]多汁鲜美的;丰富多彩的; [^]z8;
succumb: [-]/səˈkʌm/; [v]屈从,屈服,因.死亡(to); [^]z8;
suffice: [-]/səˈfaɪs/; [v]足够; [^]z8;
suffrage: [-]/ˈsʌfrɪdʒ/; [n]选举权,投票权; [^]z8;
suggestive: [-]/səˈdʒestɪv/; [a]提示的,启发的,暗示的; [^]z8;
suitor: [-]/ˈsuːtər/; [n]求婚者,(法律)原告; [^]z8;
sulk: [-]/sʌlk/; [n]生气,愠怒,愠怒的人; [v]生气,愠怒; [^]z8;
sully: [-]/ˈsʌli/; [v]玷污,污染; [^]z8;
sultan: [-]/ˈsʌltən/; [n]苏丹(某些伊斯兰国家最高统治者称号); [^]z8;
sultry: [-]/ˈsʌltri/; [a]闷热的,狂暴的,淫荡的; [^]z8;
sumptuous: [-]/ˈsʌmptʃuəs/; [a]奢侈的;华丽的; [^]z8;
sunken: [-]/ˈsʌŋkən/; [a]沉没的,凹陷的; [^]z8;
superfluous: [-]/suːˈpɜːrfluəs/; [a]多余的,过剩的;不必要的; [^]z8;
superimpose: [-]/ˌsuːpərɪmˈpoʊz/; [v]添加;重叠;附加;安装; [^]z8;
superintend: [-]/ˌsuːpərɪnˈtend/; [v]监督;主管;指挥; [^]z8;
supersede: [-]/ˌsuːpərˈsiːd/; [v]代替;紧接着而到来; [^]z8;
supplant: [-]/səˈplænt/; [v]代替;排挤掉; [^]z8;
supple: [-]/ˈsʌpl/; [a]柔软的;柔顺的; [^]z8;
supplementary: [-]/ˌsʌplɪˈmentri/; [a]补充的;附加的; [n]补充者; [^]z8;
supremacy: [-]/suːˈpreməsi/; [n]至高;最高权力,霸权; [^]z8;
surcharge: [-]/ˈsɜːrtʃɑːrdʒ/; [n]额外费用,过高的要价; [v]追加罚款;使.装载过多;使.负担过重; [^]z8;
surly: [-]/ˈsɜːrli/; [a]乖戾的;无礼的;阴沉的; [^]z8;
surreptitious: [-]/ˌsɜːrəpˈtɪʃəs/; [a]鬼鬼祟祟的,暗中的,秘密的; [^]z8;
surrogate: [-]/ˈsɜːrəɡət/; [n]代替品,代理人,代孕妈妈; [a]代理的,替代的; [v]代替,代理;指定为自己的代理人,接替; [^]z8;
susceptibility: [-]/səˌseptəˈbɪləti/; [n]易感性的,敏感性,感情; [^]z8;
susceptible: [-]/səˈseptəbl/; [a]易受感染的;易受影响的;多情的; [^]z8;
sustenance: [-]/ˈsʌstənəns/; [n]生计;食物,粮食; [^]z8;
swagger: [-]/ˈswæɡər/; [n]傲慢的态度,大摇大摆; [v]大摇大摆地走,吹牛,傲慢; [a]豪华时髦的; [^]z8;
swap: [-]/swɑːp/; [v]交换;替换;对调; [n]交换;交换物; [^]z8;
swathe: [-]/sweɪð/; [n]带子,绷带;包装品; [vt]包围;紧绑;裹; [^]z8;
sweeping: [-]/ˈswiːpɪŋ/; [n]扫除;垃圾; [a]彻底的;广泛的; [v]扫除; [^]z8;
swine: [-]/swaɪn/; [n]猪,卑鄙的人; [^]z8;
swirl: [-]/swɜːrl/; [n]漩涡;打旋;涡状形; [v]盘绕;打旋;眩晕;大口喝酒; [^]z8;
swoop: [-]/swuːp/; [v]攫取,飞扑,突然袭击; [n]突然下降,猛扑; [^]z8;
syndicate: [-]/ˈsɪndɪkət/; [n]辛迪加;企业联合;财团; [v]联合成辛迪加;组成企业联合组织;在多家报刊上同时发表; [^]z8;
synonymous: [-]/sɪˈnɑːnɪməs/; [a]同义的;同义词的;同义突变的; [^]z8;
synopsis: [-]/sɪˈnɑːpsɪs/; [n]摘要,概要; [^]z8;
synoptic: [-]/sɪˈnɑːptɪk/; [a]天气的,概要的,一览无余的; [^]z8;
systematize: [-]/ˈsɪstəmətaɪz/; [v]使系统化;使组织化;将.分类; [^]z8;
tab: [-]/tæb/; [n]标签,制表,帐单; [v]给.贴标签; [^]z8;
tacit: [-]/ˈtæsɪt/; [a]心照不宣的,静默的; [^]z8;
taciturn: [-]/ˈtæsɪtɜːrn/; [a]沉默寡言的; [^]z8;
tacky: [-]/ˈtæki/; [a]粘而未干的,缺乏教养或风度的,俗气的; [^]z8;
tact: [-]/tækt/; [n]机智,得体,老练,圆滑; [^]z8;
tactful: [-]/ˈtæktfl/; [a]机智的;老练的; [^]z8;
tactical: [-]/ˈtæktɪkl/; [a]手段的,战术的; [^]z8;
taint: [-]/teɪnt/; [n]污点;感染;异味; [vi]腐败,腐烂; [vt]污染;玷污,使受不良影响; [^]z8;
tamper: [-]/ˈtæmpər/; [v]篡改;玩弄;贿赂; [n]填塞者;捣棒; [^]z8;
tangent: [-]/ˈtændʒənt/; [n]切线; [a]无关的; [^]z8;
tanner: [-]/ˈtænər/; [n]制革工人,六便士; [^]z8;
tantalize: [-]/ˈtæntəlaɪz/; [v]逗弄,挑逗,使(看到拿不到而)焦急; [^]z8;
tantamount: [-]/ˈtæntəmaʊnt/; [a]与.相等的; [^]z8;
tantrum: [-]/ˈtæntrəm/; [n](孩子气的)脾气发作; [^]z8;
taper: [-]/ˈteɪpər/; [v]逐渐变细; [n]锥形;渐弱;蜡芯,小蜡烛; [vi]变尖;逐渐减弱; [vt]变尖;逐渐减弱; [a]渐细的;斜的;依次递减的; [^]z8;
tapeworm: [-]/ˈteɪpwɜːrm/; [n]绦虫; [^]z8;
tarnish: [-]/ˈtɑːrnɪʃ/; [n]弄脏;失去光泽,生锈; [v]变灰暗,失去光泽,破坏(形象等); [^]z8;
tarry: [-]/ˈtæri/; [n]逗留,短期滞在; [v]耽搁,踌躇(等待),拖延; [a]柏油的,涂柏油的; [^]z8;
tartan: [-]/ˈtɑːrtn/; [n]单桅三角帆船,格子花,格子织物; [a]格子花呢的; [^]z8;
taunt: [-]/tɔːnt/; [n]辱骂,嘲弄; [vt]嘲弄,奚落; [a]<海>(桅杆)很高的; [ad]扯满风帆; [^]z8;
taut: [-]/tɔːt/; [a]拉紧的;紧张的;整洁的; [^]z8;
tawdry: [-]/ˈtɔːdri/; [a]非常华丽的,廉价而俗丽的; [n]俗丽的东西,廉价而俗丽之物; [ad]俗丽地,华而不实地; [^]z8;
tedium: [-]/ˈtiːdiəm/; [n]单调乏味; [^]z8;
teeter: [-]/ˈtiːtər/; [v]使..摇摆;使..上下晃动;蹒跚; [n]跷跷板;摇摆; [^]z8;
telling: [-]/ˈtelɪŋ/; [a]明显的;生动的; [n]叙述; [^]z8;
tempo: [-]/ˈtempoʊ/; [n]<音>节奏,拍子;行进速度; [^]z8;
temporal: [-]/ˈtempərəl/; [a]现世的,世俗的;当时的,暂时的;<解>颞的;时间的; [n]世间万物;教会财产; [^]z8;
tenet: [-]/ˈtenɪt/; [n]信念,原则,教条; [^]z8;
tenor: [-]/ˈtenər/; [n]男高音,要点,要旨,稳定的进程; [a](乐器)次中音的;(组钟中的)最低音的;男高音的; [^]z8;
tensile: [-]/ˈtensl/; [a]可拉长的,可伸长的,<物>张力的,拉力的; [^]z8;
tentative: [-]/ˈtentətɪv/; [a]试探性的;不确定的;暂时的;犹豫不决的; [^]z8;
tenuous: [-]/ˈtenjuəs/; [a]纤细的;稀薄的;贫乏的;脆弱的; [^]z8;
tenure: [-]/ˈtenjər/; [n]任期;终身职位; [^]z8;
tepid: [-]/ˈtepɪd/; [a]微温的,不热烈的; [^]z8;
terrain: [-]/təˈreɪn/; [n]地面,地形; [^]z8;
terrestrial: [-]/təˈrestriəl/; [a]地球的,陆地的; [n]陆地生物;地球上的人; [^]z8;
terse: [-]/tɜːrs/; [a]简洁的,简明的; [^]z8;
testator: [-]/tes'teɪtə/; [n]立遗嘱者; [^]z8;
tether: [-]/ˈteðər/; [n]范围,系链,拴绳; [v]用绳或链拴住; [^]z8;
thatch: [-]/θætʃ/; [n]草屋顶,盖屋顶的稻草,(茂密的)头发; [v](用稻草等)盖(屋顶); [^]z8;
thee: [-]/ðiː/; [pron]你(古英语thou的宾格); [^]z8;
theorem: [-]/ˈθiːərəm/; [n]<数>定理,法则; [^]z8;
therapeutic: [-]/ˌθerəˈpjuːtɪk/; [a]治疗的;治疗学的;有益于健康的; [n]治疗剂;治疗学家; [^]z8;
thermodynamics: [-]/ˌθɜːrmoʊdaɪˈnæmɪks/; [n]热力学; [^]z8;
threadbare: [-]/ˈθredber/; [a]磨破的,衣衫褴褛的,乏味的,俗套的; [^]z8;
thud: [-]/θʌd/; [n]砰的一声,重击; [v]砰的一声掉下,发出砰声,砰地击中; [^]z8;
thyroid: [-]/ˈθaɪrɔɪd/; [a]［解］甲状腺的; [n]甲状腺; [^]z8;
tilt: [-]/tɪlt/; [v](使)倾斜; [n]倾斜,斜坡; [^]z8;
tinder: [-]/ˈtɪndər/; [n]火绒,火种; [a]易燃的; [^]z8;
tinge: [-]/tɪndʒ/; [n]淡淡的(颜色,神色),轻微,少量; [v]给.染色,轻微地影响; [^]z8;
tinker: [-]/ˈtɪŋkər/; [n](流动的)补锅工人; [v]做拙劣修补; [^]z8;
tint: [-]/tɪnt/; [n]色彩;染发剂;染色; [v]染色,着色于.; [^]z8;
tirade: [-]/ˈtaɪreɪd/; [n]长篇的攻击性演说; [^]z8;
tongs: [-]/tɔːŋz/; [n]夹子,钳子; [v]用钳子(夹); [^]z8;
tonic: [-]/ˈtɑːnɪk/; [n]补药;主调音或基音; [a]滋补的;声调的;使精神振作的; [^]z8;
torrid: [-]/ˈtɔːrɪd/; [a]酷热的,热烈; [^]z8;
torso: [-]/ˈtɔːrsoʊ/; [n](人体的)躯干,躯干像; [^]z8;
totalitarian: [-]/toʊˌtæləˈteriən/; [n]极权主义者; [a]极权主义的; [^]z8;
totter: [-]/ˈtɑːtər/; [n]蹒跚,踉跄; [vi]蹒跚,踉跄,动摇,摇摇欲坠; [^]z8;
tout: [-]/taʊt/; [v]招徕顾客,极力赞扬; [^]z8;
tract: [-]/trækt/; [n]器官系统;一大片地;短文,小册子; [^]z8;
tractable: [-]/ˈtræktəbl/; [a]易于管教的,易驾驭的,易处理的,驯良的; [^]z8;
trait: [-]/treɪt/; [n]特征; [^]z8;
trample: [-]/ˈtræmpl/; [v]踩坏(烂),践踏,蔑视; [n]踩踏,蹂躏; [^]z8;
trance: [-]/træns/; [n](因走神发呆而)恍惚,(医)神志昏迷; [v]使着迷; [^]z8;
transcend: [-]/trænˈsend/; [v]超越(经验,理性,信念等)的范围,超过; [^]z8;
transcribe: [-]/trænˈskraɪb/; [v]抄写,转录; [^]z8;
transfigure: [-]/trænsˈfɪɡjər/; [v]美观,改观; [^]z8;
transfuse: [-]/trænsˈfjuz/; [v]输血,充满; [^]z8;
transient: [-]/ˈtrænʃnt/; [a]短暂的,路过的;转瞬即逝的; [n]过客; [^]z8;
transitory: [-]/ˈtrænsətɔːri/; [a]短暂的,暂时的,瞬息的; [^]z8;
translucent: [-]/trænsˈluːsnt/; [a]半透明的;透亮的,有光泽的;易懂的;真实的; [^]z8;
transmute: [-]/trænzˈmjuːt/; [v]使改变,使变形; [^]z8;
trauma: [-]/ˈtraʊmə/; [n]精神创伤,外伤; [^]z8;
traverse: [-]/trəˈvɜːrs/; [v]横越;穿过; [n]横越; [^]z8;
treacherous: [-]/ˈtretʃərəs/; [a]不牢靠的,危险的;奸诈的,叛逆的,背叛的; [ad]背信弃义地; [n]背信弃义,背叛; [^]z8;
treatise: [-]/ˈtriːtɪs/; [n]论述;论文;专著; [^]z8;
treble: [-]/ˈtrebl/; [n]最高声部; [v]使成三倍; [a]三倍的,最高声部的; [^]z8;
trek: [-]/trek/; [n]艰苦跋涉; [v]拉(货车),搬运; [^]z8;
tremor: [-]/ˈtremər/; [n](小)地震;<医>震颤,战栗,发抖; [^]z8;
trespass: [-]/ˈtrespæs/; [v]侵入;犯罪; [n]罪过;非法侵入; [^]z8;
trestle: [-]/ˈtresl/; [n]高架桥; [^]z8;
tributary: [-]/ˈtrɪbjəteri/; [n]支流;进贡国;附属国; [a]支流的;附属的;辅助的; [^]z8;
trilogy: [-]/ˈtrɪlədʒi/; [n]三部曲; [^]z8;
trinket: [-]/ˈtrɪŋkɪt/; [n]小装饰品,不值钱的珠宝; [^]z8;
tripod: [-]/ˈtraɪpɑːd/; [n]三脚架,三脚桌; [^]z8;
trounce: [-]/traʊns/; [v]打败;痛打,严惩; [^]z8;
truce: [-]/truːs/; [n]停战;休战;休战协定; [^]z8;
trudge: [-]/trʌdʒ/; [n]长途跋涉,沉重的步伐; [v]跋涉,吃力地走; [^]z8;
tulip: [-]/ˈtuːlɪp/; [n]<植>郁金香; [^]z8;
turbid: [-]/ˈtɜːrbɪd/; [a]混浊的,紊乱的; [^]z8;
turbine: [-]/ˈtɜːrbaɪn/; [n]汽轮机,叶轮机; [^]z8;
turmoil: [-]/ˈtɜːrmɔɪl/; [n]骚动,骚乱; [^]z8;
turning: [-]/ˈtɜːrnɪŋ/; [n]转弯处; [^]z8;
turret: [-]/ˈtɜːrət/; [n]塔楼,角塔; [^]z8;
tutelage: [-]/ˈtuːtəlɪdʒ/; [n]监护,指导; [^]z8;
twirl: [-]/twɜːrl/; [n]旋转,转动; [vi]旋转,回旋; [vt]旋转,转动; [^]z8;
twitch: [-]/twɪtʃ/; [v]猛拉,抽筋,痉挛; [n]抽搐,颤动; [^]z8;
tyrannical: [-]/tɪˈrænɪkl/; [a]暴君的,专制的,残酷的; [^]z8;
ubiquitous: [-]/juːˈbɪkwɪtəs/; [a]普遍存在的;无所不在的; [^]z8;
ultrasonic: [-]/ˌʌltrəˈsɑːnɪk/; [a]超声的; [^]z8;
unassuming: [-]/ˌʌnəˈsuːmɪŋ/; [a]谦逊的,不装腔作势的; [^]z8;
uncanny: [-]/ʌnˈkæni/; [a]神秘的,不可思议的; [^]z8;
uncouth: [-]/ʌnˈkuːθ/; [a]笨拙的;粗野的;不舒适的;陌生的; [^]z8;
undercharge: [-]/ˌʌndərˈtʃɑːrdʒ/; [n]索价低于常价;充电不足; [vi]向.少收钱; [vt]向.少收钱; [^]z8;
undercut: [-]/ˌʌndərˈkʌt/; [v]廉价出售;较便宜的工资工作;从下边削球; [n]底切;牛腰部下侧嫩肉;砍口;切球; [a]下部被削去[切去,挖掉,凿去]的; [^]z8;
underdog: [-]/ˈʌndərdɔːɡ/; [n]弱势的一方,受害者,输家; [^]z8;
underlie: [-]/ˌʌndərˈlaɪ/; [v]位于..之下;成为..的基础; [^]z8;
underling: [-]/ˈʌndərlɪŋ/; [n]下属,手下; [^]z8;
underwrite: [-]/ˌʌndərˈraɪt/; [v]给.保险,承诺支付;同意赔款(海上保险); [^]z8;
undulate: [-]/ˈʌndʒəleɪt/; [a]波动的;波浪形的; [v]波动,起伏; [^]z8;
unequivocal: [-]/ˌʌnɪˈkwɪvəkl/; [a]明确的,不含糊的; [^]z8;
unethical: [-]/ʌnˈeθɪkl/; [a]不道德的;缺乏职业道德的; [^]z8;
unforeseen: [-]/ˌʌnfɔːrˈsiːn/; [a]无法预料的; [^]z8;
ungainly: [-]/ʌnˈɡeɪnli/; [a]笨拙的,不雅的; [ad]笨拙地;不雅地; [^]z8;
unicorn: [-]/ˈjuːnɪkɔːrn/; [n]独角兽; [^]z8;
unify: [-]/ˈjuːnɪfaɪ/; [v]使联合,统一;使相同,使一致; [^]z8;
unilateral: [-]/ˌjuːnɪˈlætrəl/; [a]单边的,单方面的;<植>单侧的;单边音;(父母)单系的; [^]z8;
unison: [-]/ˈjuːnɪsn/; [n]一致,(音)齐唱; [a]同音的; [^]z8;
unkempt: [-]/ˌʌnˈkempt/; [a](衣服,头发)不整洁的;蓬乱的; [^]z8;
unnerve: [-]/ˌʌnˈnɜːrv/; [v]使失去勇气,使焦躁,使失常; [^]z8;
unobtrusive: [-]/ˌʌnəbˈtruːsɪv/; [a]不唐突的,谦虚的,不引人注目的; [^]z8;
unpalatable: [-]/ʌnˈpælətəbl/; [a]不可口的,不好吃的;令人不愉快的; 使人难以接受的; [^]z8;
unparalleled: [-]/ʌnˈpærəleld/; [a]无比的,无双的,空前的; [^]z8;
unravel: [-]/ʌnˈrævl/; [v]解开;拆开;阐明;解释; [^]z8;
unruly: [-]/ʌnˈruːli/; [a]不守规矩的;任性的;难驾驭的; [^]z8;
unseemly: [-]/ʌnˈsiːmli/; [a]不适宜的;不得体的; [ad]不适当地; [^]z8;
unsightly: [-]/ʌnˈsaɪtli/; [a]难看的; [^]z8;
untenable: [-]/ʌnˈtenəbl/; [a]防守不住的,站不住脚的; [^]z8;
untold: [-]/ˌʌnˈtoʊld/; [a]无数的,数不清的; [^]z8;
unwieldy: [-]/ʌnˈwiːldi/; [a]使用不便的,不灵巧的,难处理的;笨重的; [^]z8;
unwind: [-]/ˌʌnˈwaɪnd/; [vt]展开,放松,伸直; [^]z8;
unwitting: [-]/ʌnˈwɪtɪŋ/; [a]不知情的;无意的; [^]z8;
upcoming: [-]/ˈʌpkʌmɪŋ/; [a]即将来临的; [^]z8;
upheaval: [-]/ʌpˈhiːvl/; [n]动乱,大变动; [^]z8;
upkeep: [-]/ˈʌpkiːp/; [n]保养,维持;维修费; [^]z8;
upmarket: [-]/ˌʌpˈmɑːrkɪt/; [a]质优价高的;高级的; [ad]在高档之列; [n]高档商品; [v]使进入高消费者市场; [^]z8;
uprising: [-]/ˈʌpraɪzɪŋ/; [n]起义;升起; [a]升起的; [v]起义;升起; [^]z8;
upstart: [-]/ˈʌpstɑːrt/; [n]傲慢自负的人,暴发户,自命不凡的人; [a]暴富的,自命不凡的; [v](使)突然跳起,(使)崛起; [^]z8;
upsurge: [-]/ˈʌpsɜːrdʒ/; [n]高潮,高涨; [^]z8;
uranium: [-]/juˈreɪniəm/; [n]铀; [^]z8;
urinate: [-]/ˈjʊrəneɪt/; [v]小便,撒尿; [^]z8;
usurp: [-]/juːˈzɜːrp/; [vi]篡夺,篡位; [vt]篡夺,强夺; [^]z8;
utilitarian: [-]/ˌjuːtɪlɪˈteriən/; [a]实用的;功利的; [n]实用主义者; [^]z8;
vagabond: [-]/ˈvæɡəbɑːnd/; [n]流浪者; [v]漂泊,流浪; [a]流浪的,流浪者的,漂泊的; [^]z8;
vagrant: [-]/ˈveɪɡrənt/; [n]游民; [a]漂泊的; [^]z8;
validate: [-]/ˈvælɪdeɪt/; [v]使.生效,使合法化;证明正确; [^]z8;
valor: [-]/'vælə/; [n]勇猛,英勇; [^]z8;
valve: [-]/vælv/; [n]阀门,活门; [^]z8;
vandalism: [-]/ˈvændəlɪzəm/; [n](对公物)恶意破坏; [^]z8;
vanguard: [-]/ˈvænɡɑːrd/; [n]先锋,前锋;先驱;领导者; [^]z8;
vanilla: [-]/vəˈnɪlə/; [n]香草子,香草精; [^]z8;
vanquish: [-]/ˈvæŋkwɪʃ/; [v]征服,击败; [^]z8;
vantage: [-]/'vɑːntɪdʒ/; [n]优势;有利情况; [^]z8;
varicose: [-]/'værɪˌkoʊs/; [a]［医］静脉曲张的,治疗静脉曲张用的; [^]z8;
vat: [-]/væt/; [n]大缸,瓮染料制剂; [vt]把.装入大桶; [^]z8;
vault: [-]/vɔːlt/; [n]保险库,金库,拱顶,墓室; [v]越过,跳过; [^]z8;
veal: [-]/viːl/; [n]小牛肉; [^]z8;
veer: [-]/vɪr/; [n]方向的转变; [v]转向,改变(话题等),放松(绳,缆等); [^]z8;
vehement: [-]/ˈviːəmənt/; [a]猛烈的,强烈的; [^]z8;
velocity: [-]/vəˈlɑːsəti/; [n]速度;迅速,快速; [^]z8;
venerable: [-]/ˈvenərəbl/; [a]令人尊敬的;(因历史悠久而) 神圣庄严的; [^]z8;
venerate: [-]/ˈvenəreɪt/; [v]崇敬,敬仰; [^]z8;
vengeance: [-]/ˈvendʒəns/; [n]复仇,报仇; [^]z8;
venison: [-]/ˈvenɪsn/; [n]鹿肉;野味; [^]z8;
venom: [-]/ˈvenəm/; [n]毒液;恶意;怨恨; [vt]使有毒;放毒; [^]z8;
venomous: [-]/ˈvenəməs/; [a]恶毒的;有毒的,分泌毒液的;怨恨的; [^]z8;
verbatim: [-]/vɜːrˈbeɪtɪm/; [a]逐字的; [ad]逐字地; [^]z8;
vermin: [-]/ˈvɜːrmɪn/; [n]害虫,寄生虫; [^]z8;
vernacular: [-]/vərˈnækjələr/; [a]本国的,地方的,用本地语写成的; [n]方言;土语;(建筑的)民间风格; [^]z8;
vernal: [-]/ˈvɜːrnl/; [a]春天的,和煦的,青春的; [^]z8;
versatility: [-]/ˌvɜːrsəˈtɪləti/; [n]多功能;多用途; [^]z8;
verse: [-]/vɜːrs/; [n]诗句,诗节,诗; [^]z8;
vertebrate: [-]/ˈvɜːrtɪbrət/; [a]有脊椎的; [n]脊椎动物; [^]z8;
verve: [-]/vɜːrv/; [n]热情,神韵,活力,气魄; [^]z8;
vestige: [-]/ˈvestɪdʒ/; [n]遗迹,(生)退化的器官,残余,微量(一般用于否定句); [^]z8;
vet: [-]/vet/; [n]兽医; [v]作兽医;诊疗;审查; [^]z8;
vex: [-]/veks/; [v]使烦恼,使苦恼,使恼怒; [^]z8;
vexation: [-]/vekˈseɪʃn/; [n]苦恼,恼怒,令人烦恼的事; [^]z8;
viable: [-]/ˈvaɪəbl/; [a]可行的;能养活的;能生育的; [^]z8;
vial: [-]/ˈvaɪəl/; [n]小瓶,药水瓶; [v]装入小瓶; [^]z8;
vicarious: [-]/vaɪˈkeriəs/; [a]代替别人做的;代理的,代替的;发同感的; [^]z8;
vicinity: [-]/vəˈsɪnəti/; [n]附近地区;近邻;附近; [^]z8;
victimize: [-]/ˈvɪktɪmaɪz/; [v]使受害,使牺牲,欺骗; [^]z8;
vie: [-]/vaɪ/; [v]竞争;使针锋相对;以..作较量; [^]z8;
vignette: [-]/vɪnˈjet/; [n]装饰图案;小插图; [v]把..印放为虚光照,晕映; [^]z8;
vile: [-]/vaɪl/; [a]令人讨厌的,恶心的;可恨的;可耻的;简陋的; [^]z8;
vindicate: [-]/ˈvɪndɪkeɪt/; [vt]证明.无辜;维护,辩护; [^]z8;
vindictive: [-]/vɪnˈdɪktɪv/; [a]报复性的,怀恨的,惩罚的; [^]z8;
viola: [-]/viˈoʊlə/; [n]中提琴; [^]z8;
viral: [-]/ˈvaɪrəl/; [a]滤过性毒菌引起的;滤过性毒菌的; [n]病毒式传播;<经>病毒式营销; [^]z8;
virile: [-]/ˈvɪrəl/; [a]成年男子的,有男子气概的,强壮的; [^]z8;
virtuous: [-]/ˈvɜːrtʃuəs/; [a]善良的,有德行的,贞洁的; [^]z8;
virulent: [-]/ˈvɪrələnt/; [a]剧毒的;恶性的;有恶意的; [^]z8;
visage: [-]/ˈvɪzɪdʒ/; [n]脸,面貌; [^]z8;
visualize: [-]/ˈvɪʒuəlaɪz/; [v]使形象化;想象; [^]z8;
vocalist: [-]/ˈvoʊkəlɪst/; [n]流行歌手,声乐家; [^]z8;
vogue: [-]/voʊɡ/; [n]时髦,时尚; [a]流行的; [^]z8;
void: [-]/vɔɪd/; [n]空间;空洞;空位;空虚感; [a]缺乏的;空的,没有的;<律>无效的; [v]使无效,把.作废, 宣布.作废;腾出,清理; [vi]排泄; [^]z8;
volatile: [-]/ˈvɑːlətl/; [a]易气化的;爆炸性的;反复无常的;短暂的;不稳定的; [^]z8;
voluble: [-]/ˈvɑːljəbl/; [a]健谈的,缠绕的,易旋转的; [^]z8;
voluminous: [-]/vəˈluːmɪnəs/; [a]大量的;长篇的,多产的;庞大的; [ad]宽松地;容量大地;篇幅长地; [n]宽松;容量大,篇幅长; [^]z8;
vortex: [-]/ˈvɔːrteks/; [n]旋涡,气旋;涡流; [^]z8;
vulture: [-]/ˈvʌltʃər/; [n]秃鹰,秃鹫;贪婪的人; [^]z8;
waddle: [-]/ˈwɑːdl/; [v](鸭,矮胖子等)摇摇摆摆地走,蹒跚而行; [n]摇摆的步子; [^]z8;
wade: [-]/weɪd/; [v]涉水而行,淌水;跋涉; [^]z8;
wag: [-]/wæɡ/; [n]摇摆;爱说笑的人; [v]摇动; [^]z8;
wail: [-]/weɪl/; [n]恸哭;哀诉; [vi]恸哭;悲叹; [vt]哀悼; [^]z8;
waive: [-]/weɪv/; [v]放弃;不坚持;推迟;搁置; [vt]抑制;搁置; [^]z8;
wallow: [-]/ˈwɑːloʊ/; [v]打滚;沉迷,沉溺;颠簸; [n]打滚;堕落;泥坑; [^]z8;
wane: [-]/weɪn/; [n]衰退(期);月亏(期);减少; [v](月)缺损;(光,势力,治理等)衰落;减少; [^]z8;
wanton: [-]/ˈwɑːntən/; [n]水性杨花的人,任性的孩子,无节制的人; [v]放肆,胡作非为,挥霍; [a]胡作非为的,淫荡的,无节制的; [^]z8;
warp: [-]/wɔːrp/; [n]弯曲,歪曲,偏见; [v]使变形,使有偏见,曲解; [^]z8;
warranty: [-]/ˈwɔːrənti/; [n]授权;根据;保证书;担保书,保单; [^]z8;
wary: [-]/ˈweri/; [a]谨慎的,小心的,提防的;考虑周到的; [^]z8;
watery: [-]/ˈwɔːtəri/; [a]水的;水分多的;水淋淋的,平淡的,稀薄的,松软的,有雨意的;微弱的,淡薄的; [^]z8;
waver: [-]/ˈweɪvər/; [vi]犹豫;摇摆;颤抖; [^]z8;
wayward: [-]/ˈweɪwərd/; [a]任性的,不规则的,刚愎的; [^]z8;
wean: [-]/wiːn/; [v]断奶,戒掉(off/from),(从早年开始)使用; [n]〈英〉婴儿;小儿; [^]z8;
wedge: [-]/wedʒ/; [v]楔入; [n]楔子; [^]z8;
weird: [-]/wɪrd/; [a]古怪的;荒唐的; [^]z8;
whack: [-]/wæk/; [v]重打;猛击;击败;削减; [n]重击;尝试;份儿;机会; [^]z8;
whiff: [-]/wɪf/; [n]一吹,一吸,一阵香气,一点点,香烟的一口; [v]轻轻地吹,喷气,<棒>三击出局; [^]z8;
whimsical: [-]/ˈwɪmzɪkl/; [a]古怪的,异想天开的; [^]z8;
whirlwind: [-]/ˈwɜːrlwɪnd/; [n]旋风,旋风般的快速行动; [a]旋风般的; [^]z8;
whisk: [-]/wɪsk/; [n]扫帚;毛掸子;搅拌器,打蛋器;拂; [v]扫;拂;挥动;搅拌;飞奔; [^]z8;
whitewash: [-]/ˈwaɪtwɑːʃ/; [v]用石灰水把..刷白; [n]石灰水,白色涂料,白粉胶泥水,涂脂抹粉; [^]z8;
wicked: [-]/ˈwɪkɪd/; [a]邪恶的,恶毒的;淘气的,恶作剧的; [n]恶人;邪恶的人; [ad]用作加强语气用; [^]z8;
wield: [-]/wiːld/; [v]运用,行使;挥; [vt]使用; [^]z8;
wiggle: [-]/ˈwɪɡl/; [v]扭动,蠕动; [n]扭动; [^]z8;
wilt: [-]/wɪlt/; [v]使.凋谢,枯萎; [n]枯萎;憔悴; [^]z8;
wily: [-]/ˈwaɪli/; [a]狡猾的; [^]z8;
wince: [-]/wɪns/; [v]避开,畏缩; [n]畏缩;脸部肌肉的抽搐; [^]z8;
windfall: [-]/ˈwɪndfɔːl/; [n]风吹落果;意外的收获,意外幸运; [^]z8;
withstand: [-]/wɪðˈstænd/; [v]忍受;抵挡; [^]z8;
wizard: [-]/ˈwɪzərd/; [n]男巫,奇才; [a]男巫的,有魔力的; [v]〈罕〉施巫术; [^]z8;
wobble: [-]/ˈwɑːbl/; [v]摇晃;摇摆;游移不定; [n]摆动;摇晃;不稳定; [^]z8;
woe: [-]/woʊ/; [n]悲哀;痛苦; [int]唉(表示痛苦,悲伤或悔恨);咳; [^]z8;
woo: [-]/wuː/; [v]向(女人)求爱,争取.的支持,追求; [^]z8;
wrapper: [-]/ˈræpər/; [n]包装材料;<包装>包装纸;书皮; [^]z8;
wrath: [-]/ræθ/; [n]愤怒; [^]z8;
wreckage: [-]/ˈrekɪdʒ/; [n]残骸;失事;破坏; [^]z8;
wrench: [-]/rentʃ/; [n]扳手;痛苦,难受;猛扭,猛拉; [v]猛拧;挣脱;使扭伤; [^]z8;
wrest: [-]/rest/; [n]扭,拧; [vt]用力拧;强夺;歪曲; [^]z8;
wring: [-]/rɪŋ/; [v]扭,榨取,强求;绞,拧,扭(尤指脖子); [n]扭,榨取,强求;折磨; [^]z8;
writhe: [-]/raɪð/; [v]扭动(身体);扭曲变形;缠绕打结; [n]扭动;翻腾;苦恼; [^]z8;
wry: [-]/raɪ/; [a]歪斜的,扭歪的,歪曲的; [v]歪曲,扭曲;扭转; [^]z8;
xenophobia: [-]/ˌzenəˈfoʊbiə/; [n]仇外,对外国人的恐惧或憎恨; [^]z8;
yeoman: [-]/ˈjoʊmən/; [n]自耕农;自由民;仆人; [a]坚毅的,刚毅的,忠实的; [^]z8;
yoga: [-]/ˈjoʊɡə/; [n]瑜珈,瑜珈术; [^]z8;
yummy: [-]/ˈjʌmi/; [a]美味的,好吃的; [^]z8;
zealot: [-]/ˈzelət/; [n]狂热份子,犹太教狂热信徒; [^]z8;
zenith: [-]/ˈziːnɪθ/; [n]顶点,顶峰;全盛; [^]z8;
zest: [-]/zest/; [n]兴趣,乐趣;滋味,风味; [v]给.调味; [^]z8;
zoom: [-]/zuːm/; [v](镜头)拉近(拉远);急速上升,嗡嗡作响; [n]车辆疾驰的声音,嗡嗡声,(摄影)变焦; [^]z8;
