Antarctic: [-]/ænˈtɑːrktɪk/; [a]南极的; [n]南极区; [^]yshx;
Arctic: [-]/ˈɑːrktɪk/; [n]北极; [a]北极的,极寒的; [^]yshx;
Catholic: [-]/ˈkæθlɪk/; [a](兴趣等)广泛的,(C大写)天主教的; [n](C大写)天主教徒; [^]yshx;
Christian: [-]/ˈkrɪstʃən/; [n]基督教徒; [a]基督教的,基督教徒的; [^]yshx;
Easter: [-]/ˈiːstər/; [n]复活节; [^]yshx;
Fahrenheit: [-]/ˈfærənhaɪt/; [n]华氏度; [a]华氏度的,华氏温度计的; [^]yshx;
abandon: [-]/əˈbændən/; [v]抛弃;放弃;放纵; [^]yshx;
abbreviation: [-]/əˌbriːviˈeɪʃn/; [n]缩短;缩写词;省略号; [^]yshx;
abnormal: [-]/æbˈnɔːrml/; [a]反常的;畸形的; [^]yshx;
abolish: [-]/əˈbɑːlɪʃ/; [v]废除,废止;取消,革除; [^]yshx;
aboriginal: [-]/ˌæbəˈrɪdʒənl/; [a]土著的,原来的; [n]土著居民; [^]yshx;
abort: [-]/əˈbɔːrt/; [v]异常中断,中途失败,流产,发育不全; [^]yshx;
abound: [-]/əˈbaʊnd/; [v]充满,很多,富于; [^]yshx;
above(beyond) reproach: [-]/əˈbʌv bɪˈjɑːnd rɪˈproʊtʃ/; [ad]无可指责,无可厚非; [^]yshx;
abrasion: [-]/əˈbreɪʒn/; [n]表面磨损;擦伤; [^]yshx;
abridge: [-]/əˈbrɪdʒ/; [v]删节;削减; [^]yshx;
abrupt: [-]/əˈbrʌpt/; [a]突然的;唐突的;鲁莽的; [^]yshx;
absorb: [-]/əbˈzɔːrb/; [vt]吸收;汲取;吸引..的注意;理解,掌握;承受; [^]yshx;
abstract: [-]/ˈæbstrækt/; [a]抽象的; [n]摘要,抽象; [v]提取; [^]yshx;
absurd: [-]/əbˈsɜːrd/; [a]荒唐的;可笑的;不合理的; [n]荒唐; [^]yshx;
abundance: [-]/əˈbʌndəns/; [n]丰富;大量; [^]yshx;
abuse: [-]/əˈbjuːs/; [v]虐待;辱骂;(对麻醉毒品,兴奋剂等的)非法服用;滥用; [n]滥用;虐待;辱骂; [^]yshx;
academic: [-]/ˌækəˈdemɪk/; [a]学术的;学院的,大学的;理论的; [n]学者; [^]yshx;
accelerate: [-]/əkˈseləreɪt/; [v]加速,增长;使增速,促进; [^]yshx;
access: [-]/ˈækses/; [n]进入;使用权;通道; [v]进入;访问; [^]yshx;
accessory: [-]/əkˈsesəri/; [n](妇女的)装饰品;附件;附属物;同谋; [a]附属的;辅助的;同谋的; [^]yshx;
accommodate: [-]/əˈkɑːmədeɪt/; [v]向.提供住处(或膳宿);给.提供方便;容纳;使适应,顺应; [^]yshx;
accompany: [-]/əˈkʌmpəni/; [v]陪伴;为..伴奏(或伴唱); [^]yshx;
accomplish: [-]/əˈkɑːmplɪʃ/; [v]完成,做到;实现; [^]yshx;
accord: [-]/əˈkɔːrd/; [n]协议; [v]授予; [^]yshx;
account: [-]/əˈkaʊnt/; [n]账户;原因,理由;叙述; [v]报账,做出说明(或解释),为.负责,受罚;认为,考虑; [^]yshx;
accountable for: [-]/əˈkaʊntəb(ə)l fɔr/; [a]对.应负责任; [^]yshx;
accumulate: [-]/əˈkjuːmjəleɪt/; [vi]聚积,堆积; [vt]积攒,积累; [^]yshx;
accuse: [-]/əˈkjuːz/; [v]指责;控告;把..归咎于; [^]yshx;
achieve: [-]/əˈtʃiːv/; [v]完成,达到,获得,实现; [^]yshx;
acid: [-]/ˈæsɪd/; [n]<化学>酸;酸性物质;尖酸; [a]尖刻的;敏锐的;含酸过多的;酸的;酸味的; [^]yshx;
acknowledge: [-]/əkˈnɑːlɪdʒ/; [v]告知收到;对(人)打招呼,招呼(某人)以示相识,致意;就..表示谢忱,鸣谢,感谢,感激,答谢,对..表示感谢;承认(属实),承认(权威,地位); [^]yshx;
acquaint: [-]/əˈkweɪnt/; [v]使熟悉;使认识;介绍; [^]yshx;
acquire: [-]/əˈkwaɪər/; [v](尤指靠自己的努力或行动或经过一个过程)获得;学到;取得; [^]yshx;
activate: [-]/ˈæktɪveɪt/; [v]使活动起来;使开始起作用; [^]yshx;
acute: [-]/əˈkjut/; [a](疼痛,妒忌等)剧烈的,严重的;敏锐的;急性的;尖声的; [^]yshx;
adapt: [-]/əˈdæpt/; [vi]适应不同情况; [vt]使适合;改编; [^]yshx;
addict: [-]/ˈædɪkt/; [n]上瘾的人;入迷的人; [v]使沉迷,使上瘾; [^]yshx;
address: [-]/əˈdres/; [n]地址;致词; [v]致函;写姓名地址;向..讲话;处理; [^]yshx;
adept: [-]/əˈdept/; [n]专家,能手; [a]熟练的;巧妙的; [^]yshx;
adequate: [-]/ˈædɪkwət/; [a]充足的,充分的,足够的;尚可的,过得去的; [^]yshx;
adhere: [-]/ədˈhɪr/; [v]遵守;坚持;粘附;附着,粘在..上; [^]yshx;
adjacent: [-]/əˈdʒeɪsnt/; [a]邻接的,毗连的;邻近的; [^]yshx;
adjoin: [-]/əˈdʒɔɪn/; [v]与.毗连;贴近; [^]yshx;
adjust: [-]/əˈdʒʌst/; [v]调整,调节;校正;改变.以适应; [^]yshx;
administer: [-]/ədˈmɪnɪstər/; [v]管理;执行;实施;给予;用(药); [^]yshx;
admission: [-]/ədˈmɪʃn/; [n]准许进入;进入权;入场费; [^]yshx;
adolescence: [-]/ˌædəˈlesns/; [n]青春期,青春; [^]yshx;
adopt: [-]/əˈdɑːpt/; [v]收养;采纳,采用; [^]yshx;
adore: [-]/əˈdɔːr/; [v]很喜欢,极喜爱;崇拜;爱慕; [^]yshx;
advent: [-]/ˈædvent/; [n]来临;到来;出现; [^]yshx;
adverse: [-]/ˈædvɜːrs/; [a]不利的;(方向上)逆的;在相反的方向上移动(或运转);相反的; [^]yshx;
advertise: [-]/ˈædvərtaɪz/; [v]为..做广告;公告;公布; [^]yshx;
advocate: [-]/ˈædvəkeɪt/; [v]提倡;主张;为.辩护; [n]辩护者;提倡者;律师; [^]yshx;
aerial: [-]/ˈeriəl/; [a]飞机的,航空的,由飞机进行的;空中的,架空的; [n]天线; [^]yshx;
aesthetic: [-]/esˈθetɪk/; [n]美感;审美观; [a]美学的;审美的;悦目的;雅致的; [^]yshx;
affect: [-]/əˈfekt/; [v]影响,感动,作用; [n]感情,情感,心情;<精神病学>(表露或觉察到的)情绪反应; [^]yshx;
affection: [-]/əˈfekʃn/; [n]关爱,爱慕;感情;作用,影响;疾病; [^]yshx;
affirm: [-]/əˈfɜːrm/; [v]肯定;断定;坚持声称; [^]yshx;
affix: [-]/əˈfɪks/; [v]粘上;署名;将罪责加之于; [n]词缀;附加物; [^]yshx;
afflict: [-]/əˈflɪkt/; [v]使痛苦;使苦恼; [^]yshx;
afford: [-]/əˈfɔːrd/; [v]买得起;抽得出时间;担负得起;提供;产生;赐予; [vi]担负得起;买得起; [^]yshx;
agency: [-]/ˈeɪdʒənsi/; [n]代理(处);政府机构;代理;介入;作用; [^]yshx;
agenda: [-]/əˈdʒendə/; [n]议事日程; [^]yshx;
aggravate: [-]/ˈæɡrəveɪt/; [v]使恶化,加重;使气恼,激怒; [^]yshx;
aggregate: [-]/ˈæɡrɪɡət/; [n]合计;总数;混凝料;总计; [v]集合;聚集;合计; [a]总的,总数的;集合的; [^]yshx;
aggressive: [-]/əˈɡresɪv/; [a]好斗的,挑衅性的;有闯劲的,积极进取的; [^]yshx;
agitation: [-]/ˌædʒɪˈteɪʃn/; [n]摇动;焦虑,忧虑;煽动; [^]yshx;
agony: [-]/ˈæɡəni/; [n]极大痛苦; [^]yshx;
agreeable: [-]/əˈɡriːəbl/; [a](欣然)同意的;愉快的;可以接受的; [^]yshx;
agreement: [-]/əˈɡriːmənt/; [n]协议,协定;一致,相合; [^]yshx;
airing: [-]/ˈerɪŋ/; [n]通风;讨论;晾干; [^]yshx;
aisle: [-]/aɪl/; [n](席位间的)通道,过道; [^]yshx;
alarm: [-]/əˈlɑːrm/; [n]警报器,警报;闹钟;惊恐,忧虑; [v]使惊恐,使忧虑; [^]yshx;
album: [-]/ˈælbəm/; [n]相册;唱片集,专辑;集邮册; [^]yshx;
alien: [-]/ˈeɪliən/; [n]外国人;外星人; [a]陌生的;外国的,外星(人)的;异己的,不相容的; [^]yshx;
all in all: [-]/ɔːl ɪn ɔːl/; [phr]总而言之;总的来说; [^]yshx;
all out: [-]/ˌɔːl ˈaʊt/; [phr]全力以赴; [^]yshx;
all the same to: [-]/ɔl ðə seɪm tu/; [phr]对.说来都一样;无所谓; [^]yshx;
all the time: [-]/ɔl ðə taɪm/; [ad]始终;一直; [^]yshx;
all told: [-]/ɔːl toʊld/; [ad]总共; [^]yshx;
allege: [-]/əˈledʒ/; [v]断言;硬说; [^]yshx;
allegiance: [-]/əˈliːdʒəns/; [n]忠诚,拥护; [^]yshx;
alleviate: [-]/əˈliːvieɪt/; [v]减轻;缓解;缓和; [^]yshx;
alliance: [-]/əˈlaɪəns/; [n]联盟,同盟;盟约;盟国,同盟者;类同; [^]yshx;
allocate: [-]/ˈæləkeɪt/; [v]分配,配给; [^]yshx;
allowance: [-]/əˈlaʊəns/; [v]定量供应(食物,饮料等物品);配给; [n]零用钱;津贴,补贴;限额;免税额;允许,容忍,让步;考虑; [^]yshx;
alloy: [-]/ˈælɔɪ/; [n]合金; [v]使成合金; [^]yshx;
alongside: [-]/əˌlɔːŋˈsaɪd/; [ad]在旁边,并排地,并肩地; prep. 在.旁边,和.并排;和.一起; [^]yshx;
alphabetical: [-]/ˌælfəˈbetɪkl/; [a]字母(表)的;按字母(表)顺序的; [^]yshx;
alter: [-]/ˈɔːltər/; [v]改变;改动,使变样;改做; [^]yshx;
alternate: [-]/ˈɔːltərnət/; [a]交替的,轮流的,间隔的; [v](使)交替,(使)轮流; [n]代替者; [^]yshx;
altitude: [-]/ˈæltɪtuːd/; [n]海拔,高度; [^]yshx;
amateur: [-]/ˈæmətʃər/; [n]业余爱好者;外行; [a]外行的;业余爱好的,业余(身份)的; [^]yshx;
amaze: [-]/əˈmeɪz/; [v]使惊奇,使惊诧; [^]yshx;
ambassador: [-]/æmˈbæsədər/; [n](特命全权)大使;代表; [^]yshx;
ambiguity: [-]/ˌæmbɪˈɡjuːəti/; [n]模棱两可;歧义;误解; [^]yshx;
ambition: [-]/æmˈbɪʃn/; [n]雄心,强烈欲望,抱负;(具体的)追求目标; [vt]追求;有.野心; [^]yshx;
ambulance: [-]/ˈæmbjələns/; [n]救护车; [^]yshx;
amend: [-]/əˈmend/; [v]改进;修订;修正; [^]yshx;
amid: [-]/əˈmɪd/; prep. 在.中间,被.围绕; [^]yshx;
ammunition: [-]/ˌæmjuˈnɪʃn/; [n]弹药;炮弹; [^]yshx;
amount: [-]/əˈmaʊnt/; [n]数量,总额; [v]合计,共计;等同,接近(to); [^]yshx;
amphibian: [-]/æmˈfɪbiən/; [n]两栖动物;水陆两用飞机和车辆; [a]两栖类的;<车辆>水陆两用的;具有双重性格的; [^]yshx;
ample: [-]/ˈæmpl/; [a]富足的,丰满的,宽敞的; [^]yshx;
amplify: [-]/ˈæmplɪfaɪ/; [v]放大(声音等);扩大;增强;详述;进一步阐述; [^]yshx;
amuse: [-]/əˈmjuːz/; [v]娱乐,消遣,使发笑; [^]yshx;
ancestor: [-]/ˈænsestər/; [n]祖宗;祖先;原型; [^]yshx;
anchor: [-]/ˈæŋkər/; [n]担任(广播电视新闻节目)的主持人;支柱;锚; [v]抛锚; [vt]使固定; [^]yshx;
anecdote: [-]/ˈænɪkdoʊt/; [n]轶事,趣闻; [^]yshx;
annihilate: [-]/əˈnaɪəleɪt/; [v]消灭; [^]yshx;
anniversary: [-]/ˌænɪˈvɜːrsəri/; [n]周年纪念日; [a]周年的,(有关)周年纪念的; [^]yshx;
annoy: [-]/əˈnɔɪ/; [v]使烦恼,使生气; [n]烦恼(等于annoyance); [^]yshx;
annual: [-]/ˈænjuəl/; [a]一年一次的,年度的; [n]年鉴,一年生植物,一年一度的事件; [^]yshx;
annuity: [-]/əˈnuːəti/; [n]年金,养老金;年金保险;年金享受权; [^]yshx;
anonymous: [-]/əˈnɑːnɪməs/; [a]匿名的;无名的;不具名的;无特色的;无个性特征; [^]yshx;
antagonism: [-]/ænˈtæɡənɪzəm/; [n]对抗,敌对;敌意; [^]yshx;
antecedent: [-]/ˌæntɪˈsiːdnt/; [a]先行的,先驱的; [n]祖先,前情; [^]yshx;
anthem: [-]/ˈænθəm/; [n]国歌,赞美诗,圣歌; [^]yshx;
antibiotic: [-]/ˌæntibaɪˈɑːtɪk/; [n]抗生素; [a]抗菌的; [^]yshx;
anticipation: [-]/ænˌtɪsɪˈpeɪʃn/; [n]预期,预料;期待;预知; [^]yshx;
antique: [-]/ænˈtiːk/; [n]古董;古玩;古物; [a]古代的;古董的; [^]yshx;
anxiety: [-]/æŋˈzaɪəti/; [n]焦虑;忧虑;担心; [^]yshx;
anyhow: [-]/ˈenihaʊ/; [ad]不论用何种方法,无论如何;随意地;尽管如此; [^]yshx;
apologetic: [-]/əˌpɑːləˈdʒetɪk/; [a]表示歉意的;赔罪的; [^]yshx;
apparatus: [-]/ˌæpəˈrætəs/; [n]装置,仪器;设备;组织,机构; [^]yshx;
apparent: [-]/əˈpærənt/; [a]显然的,明白的,清晰可见的;表面上的,貌似(真实)的; [^]yshx;
appeal: [-]/əˈpiːl/; [vi]呼吁,请求;申诉;有吸引力; [n]呼吁;恳求;(为慈善或好的事业所做的) 筹款努力;(人或物的)吸引力; [^]yshx;
appendix: [-]/əˈpendɪks/; [n]附录;阑尾;附属物; [^]yshx;
appetite: [-]/ˈæpɪtaɪt/; [n]食欲,胃口;欲望; [^]yshx;
applaud: [-]/əˈplɔːd/; [v]鼓掌; [vi]喝彩; [vt]向.鼓掌表示赞赏;给.捧场; [^]yshx;
appliance: [-]/əˈplaɪəns/; [n]家用器具;家用电器;装置;应用; [^]yshx;
applicant: [-]/ˈæplɪkənt/; [n]申请人;请求者; [^]yshx;
apply oneself (to sth.): [-]/əˈplaɪ wʌnˈself tu ˈsʌmθɪŋ/; [v]专心致志于; [^]yshx;
apply: [-]/əˈplaɪ/; [v]涂,敷;应用;申请; [^]yshx;
appointment: [-]/əˈpɔɪntmənt/; [n]约会,会面;委派;任命的职位;接受委派者;制定; [^]yshx;
appraisal: [-]/əˈpreɪzl/; [n]评估;估价;评价; [^]yshx;
appreciable: [-]/əˈpriːʃəbl/; [a]很可观的;可感知的;可察觉的;可评估的; [^]yshx;
apprehension: [-]/ˌæprɪˈhenʃn/; [n]忧虑,担心,疑惧;逮捕;理解; [^]yshx;
apprentice: [-]/əˈprentɪs/; [v]使当学徒; [n]学徒; [^]yshx;
approach: [-]/əˈproʊtʃ/; [v]接近;靠近;着手处理; [n]接近;途径;方法; [^]yshx;
appropriate: [-]/əˈproʊpriət/; [a]合适的;适当的; [v]挪用;拨款;私占; [^]yshx;
approval: [-]/əˈpruːvl/; [n]批准;赞同;试销; [^]yshx;
approximate: [-]/əˈprɑːksɪmət/; [a]近似的,约略的; [v]接近,近似; [^]yshx;
apt: [-]/æpt/; [a]恰当的;有(做某事的)倾向; [^]yshx;
aquarium: [-]/əˈkweriəm/; [n]水族馆,水族箱,鱼缸; [^]yshx;
aquatic: [-]/əˈkwætɪk/; [a]水生的,水栖的,水中的,水上的; [n]水生动物,水生植物;水上运动; [^]yshx;
arbitrary: [-]/ˈɑːrbətreri/; [a]随意的,任性的,随心所欲的;霸道的,专制的,专横的;主观的,武断的; [^]yshx;
arch: [-]/ɑːrtʃ/; [n]拱洞;拱门;拱起; [v]做成拱形; [a]调皮的,淘气的; [^]yshx;
archaic: [-]/ɑːrˈkeɪɪk/; [a]古代的;陈旧的,过时的,老式的;已不通用的; [^]yshx;
architect: [-]/ˈɑːrkɪtekt/; [n]设计师;建筑师; [^]yshx;
archives: [-]/ˈɑːrkaɪvz/; [n]档案室,档案; [^]yshx;
ardent: [-]/ˈɑːrdnt/; [a]热心的,热烈的; [^]yshx;
arduous: [-]/ˈɑːrdʒuəs/; [a]艰巨的;努力的;陡峭的; [^]yshx;
arena: [-]/əˈriːnə/; [n]竞技场,角斗场;(活动,斗争或竞争的)场所,战场,(竞争)舞台; [^]yshx;
argue: [-]/ˈɑːrɡjuː/; [v]争吵;主张,认为;提供.证据,提出证明;表明(原因等); [^]yshx;
arise: [-]/əˈraɪz/; [v]起床;出现;升起;由.引起,发生; [^]yshx;
armour: [-]/ˈɑːrmər/; [n]盔甲; [^]yshx;
array: [-]/əˈreɪ/; [n]一系列;陈列;编队; [v]排列;部署; [^]yshx;
arrogant: [-]/ˈærəɡənt/; [a]傲慢的,妄自尊大的; [^]yshx;
artery: [-]/ˈɑːrtəri/; [n]动脉;干线; [^]yshx;
article: [-]/ˈɑːrtɪkl/; [n]物品;文章;条款;冠词; [^]yshx;
articulate: [-]/ɑːrˈtɪkjuleɪt/; [a]善于表达的;发音清晰的; [v]清晰地发音;清楚地讲话;连接,接合;与.合成整体 ,使相互连贯; [^]yshx;
artificial: [-]/ˌɑːrtɪˈfɪʃl/; [a]人造的,人工的,假的;假装的,虚伪的; [n]人造肥料;<美>假花; [^]yshx;
artillery: [-]/ɑːrˈtɪləri/; [n]大炮,炮兵; [^]yshx;
as for: [-]/əz fɔr/; [phr]至于,就.方面说; [^]yshx;
as opposed to: [-]/æz ə'poʊʊzd tu/; [phr]与.形成对照; [^]yshx;
as well: [-]/əz wel/; [ad]同样地;也; [^]yshx;
ascent: [-]/əˈsent/; [n]上升;上坡路;登高; [^]yshx;
ascertain: [-]/ˌæsərˈteɪn/; [v]探知,弄清,查明(真相等); [^]yshx;
ascribe: [-]/əˈskraɪb/; [v]把.归因于;把.归属于; [^]yshx;
ashamed: [-]/əˈʃeɪmd/; [a]感到羞愧的;害臊的; [^]yshx;
aspire: [-]/əˈspaɪər/; [vi]渴望,有志于(与to,for,after连用或后接不定式); [^]yshx;
aspirin: [-]/ˈæsprɪn/; [n]阿斯匹林; [^]yshx;
assassination: [-]/əˌsæsəˈneɪʃn/; [n]暗杀; [^]yshx;
assault: [-]/əˈsɔːlt/; [n]攻击,袭击; [v]攻击,袭击,殴打; [^]yshx;
assemble: [-]/əˈsembl/; [v]装配(机器等);集合;召集; [^]yshx;
assert: [-]/əˈsɜːrt/; [v]断言;肯定地说;坚持;维护; [^]yshx;
assess: [-]/əˈses/; [v]评估;估值; [^]yshx;
asset: [-]/ˈæset/; [n]财产,资产,有价值的东西或人; [^]yshx;
assign: [-]/əˈsaɪn/; [v]布置;分配;指定;指派;归因;确定; [^]yshx;
assimilate: [-]/əˈsɪməleɪt/; [v]使同化;吸收;消化; [^]yshx;
associate: [-]/əˈsoʊʃieɪt/; [v]联想;联合;联系,交往; [n]伙伴;同事; [a]副的; [^]yshx;
assorted: [-]/əˈsɔːrtəd/; [a]各式各样的; [^]yshx;
assume: [-]/əˈsuːm/; [v]猜想;以为,假设;呈现;就职;(想当然地)认为;承担(责任); [^]yshx;
assure: [-]/əˈʃʊr/; [v]向..保证,使确信;保证,确保; [^]yshx;
astronomy: [-]/əˈstrɑːnəmi/; [n]天文学; [^]yshx;
at a loose end: [-]/ət ə lus end/; [ad]不知做什么好; [^]yshx;
at a stroke: [-]/ət ə stroʊk/; [ad]一下子; [^]yshx;
at all times: [-]/ət ɔl taɪmz/; [ad]经常,一直;无论何时; [^]yshx;
at fault: [-]/ət fɔlt/; [phr]⋯⋯过错,⋯⋯责任; [^]yshx;
at full blast: [-]/æt fʊl blæst/; [ad]最大地; [^]yshx;
at full tilt: [-]/ət fʊl tɪlt/; [ad]全速地;全力以赴地; [^]yshx;
at its best: [-]/ət ɪts best/; [phr]处在最好状态; [^]yshx;
at the mercy of: [-]/ət ðə ˈmɜrsi ɑv/; prep. 在.支配中,任凭.摆布; [^]yshx;
at the outset: [-]/ət ðə ˈaʊtˌset/; [phr]在开头时; [^]yshx;
at the same time: [-]/ət ðə seɪm taɪm/; [ad]同时;然而; [^]yshx;
athlete: [-]/ˈæθliːt/; [n]运动员,体育家,强壮的人; [^]yshx;
atlas: [-]/ˈætləs/; [n]地图集; [^]yshx;
attach: [-]/əˈtætʃ/; [v]系;贴;附上;附加;缚; [^]yshx;
attack: [-]/əˈtæk/; [n](病)发作,攻击; [v]攻击,进攻,抨击;毁坏; [^]yshx;
attain: [-]/əˈteɪn/; [v]获得;达到(某个年纪,水平,条件);实现; [n]成就; [^]yshx;
attempt: [-]/əˈtempt/; [n]尝试;企图; [vt]努力去做;试图,尝试; [^]yshx;
attendant: [-]/əˈtendənt/; [n]服务员,侍者,随从; [a]伴随的,随之而产生的; [^]yshx;
attorney: [-]/əˈtɜːrni/; [n](辩护)律师; [^]yshx;
attractive: [-]/əˈtræktɪv/; [a]有魅力的;吸引人的;引起兴趣的; [^]yshx;
auction: [-]/ˈɔːkʃn/; [n]拍卖; [v]拍卖; [^]yshx;
audible: [-]/ˈɔːdəbl/; [a]听得见的; [^]yshx;
audience: [-]/ˈɔːdiəns/; [n](演讲,音乐会等的)听众,观众;正式会见;拥护者; [^]yshx;
audit: [-]/ˈɔːdɪt/; [v]审计,查账;旁听; [n]审计;查帐; [^]yshx;
audition: [-]/ɔːˈdɪʃn/; [n]听力,听觉;试听;试镜; [vi]试唱; [vt]对.进行面试;让.试唱; [^]yshx;
augment: [-]/ɔːɡˈment/; [v]增加;助长; [^]yshx;
authentic: [-]/ɔːˈθentɪk/; [a]真实的;真正的;可靠的; [^]yshx;
authority: [-]/əˈθɔːrəti/; [n]权威;威信;当局,官方;权力,职权; [^]yshx;
automatic: [-]/ˌɔːtəˈmætɪk/; [a]无意识的;自动的;自发的; [n]自动手枪;自动工具; [^]yshx;
automobile: [-]/ˈɔːtəməbiːl/; [n]汽车,机动车; [v]开汽车;坐汽车; [a]自动的; [^]yshx;
autonomy: [-]/ɔːˈtɑːnəmi/; [n]人身自由;自治;自治权; [^]yshx;
auxiliary: [-]/ɔːɡˈzɪliəri/; [a]备用的,辅助的,协助的; [^]yshx;
available: [-]/əˈveɪləbl/; [a]可得到的,可利用的,有空的,有效的; [^]yshx;
avalanche: [-]/ˈævəlæntʃ/; [n]雪崩;大量拥至; [vi]崩塌; [^]yshx;
avert: [-]/əˈvɜːrt/; [v]转移(目光,注意力等);防止;避开; [^]yshx;
aviation: [-]/ˌeɪviˈeɪʃn/; [n]航空,航空学;飞机制造业; [^]yshx;
avoid: [-]/əˈvɔɪd/; [v]躲开,避开;避免,防止; [^]yshx;
aware: [-]/əˈwer/; [a]意识到的,知道的; [^]yshx;
awful: [-]/ˈɔːfl/; [a]可怕的,极坏的;糟糕的,讨厌的;极其; [ad]极其,非常; [^]yshx;
awkward: [-]/ˈɔːkwərd/; [a]尴尬的;笨拙的;棘手的;不雅观的;不方便的;困难的,危险的; [^]yshx;
axis: [-]/ˈæksɪs/; [n]轴;中心线;坐标轴;基准线; [^]yshx;
bachelor: [-]/ˈbætʃələr/; [n]单身汉;学士学位; [^]yshx;
back down (from): [-]/bæk daʊn frəm/; [phr]投降,认输; [^]yshx;
back sb. up: [-]/bæk ˈsʌmbədi ʌp/; [phr]支持某人; [^]yshx;
bacon: [-]/ˈbeɪkən/; [n]熏猪肉,培根; [^]yshx;
bacterium: [-]/bæk'tɪriəm/; [n]细菌; [^]yshx;
badge: [-]/bædʒ/; [n]徽章;象征;标记; [vt]给予.标记;授予.徽章; [^]yshx;
badminton: [-]/ˈbædmɪntən/; [n]羽毛球;羽毛球运动; [^]yshx;
baffle: [-]/ˈbæfl/; [v]使困惑;难住;阻碍; [n]挡板; [^]yshx;
baggage: [-]/ˈbæɡɪdʒ/; [n]行李; [^]yshx;
bake: [-]/beɪk/; [v]烤,烘焙;烧制; [n]晒;烘烤食品; [^]yshx;
balance: [-]/ˈbæləns/; [n]平衡;称;平静;和谐;余额; [v]保持平衡;使平衡;补偿; [^]yshx;
balcony: [-]/ˈbælkəni/; [n]阳台,剧院楼厅; [^]yshx;
bald: [-]/bɔːld/; [a]秃头的; [^]yshx;
ballet: [-]/bæˈleɪ/; [n]芭蕾舞,芭蕾舞剧;芭蕾舞团; [^]yshx;
ban: [-]/bæn/; [vt]禁止;查禁; [n]禁止,禁令; [^]yshx;
bandage: [-]/ˈbændɪdʒ/; [n]绷带; [v]用绷带绑扎; [^]yshx;
bang: [-]/bæŋ/; [n]巨响;重击;刘海; [ad]准确地,完全地; [v]发出砰的一声;重击;猛敲;砰地关上; [^]yshx;
bankrupt: [-]/ˈbæŋkrʌpt/; [a]破产的;彻底失败的;彻底缺乏的; [n]破产者; [v]使破产;使枯竭; [^]yshx;
banner: [-]/ˈbænər/; [n]旗帜,横幅,大标题; [^]yshx;
banquet: [-]/ˈbæŋkwɪt/; [n](正式的)宴会;盛宴; [a]宴会的; [^]yshx;
bar: [-]/bɑːr/; [n]酒吧;(金属)棒;闩;障碍;柜台; [vt]阻挡;禁止;闩住; prep. 除.之外; [^]yshx;
barbecue: [-]/ˈbɑːrbɪkjuː/; [n]烧烤架;烧烤;烤肉; [v]红烧;烧烤; [^]yshx;
barber: [-]/ˈbɑːrbər/; [n]理发师,理发店; [^]yshx;
bare: [-]/ber/; [a]赤裸的,空的,贫瘠的; [v]使裸露,暴露; [^]yshx;
bargain: [-]/ˈbɑːrɡən/; [n]交易,特价商品;便宜货;契约; [vi]讨价还价,讲价;成交; [vt]经讨价还价成交;用.交换; [a](价格),低廉的; [^]yshx;
bark: [-]/bɑːrk/; [v]狗吠;厉声发令; [n]树皮;吠声; [^]yshx;
barn: [-]/bɑːrn/; [n]谷仓,牲口棚;简陋的大房子; [^]yshx;
barometer: [-]/bəˈrɑːmɪtər/; [n]晴雨表;气压表; [^]yshx;
barrel: [-]/ˈbærəl/; [n]桶;枪管; [vi]快速移动; [^]yshx;
barren: [-]/ˈbærən/; [a]贫瘠的,不孕的; [n]荒原,不毛之地; [^]yshx;
barricade: [-]/ˌbærɪˈkeɪd/; [n]路障;障碍物;栅栏; [v]设路障;挡住; [^]yshx;
barter: [-]/ˈbɑːrtər/; [v]物物交换;以货易货; [n]物物交换;实物交易; [^]yshx;
basement: [-]/ˈbeɪsmənt/; [n]<建筑学>地下室;根基; [^]yshx;
batch: [-]/bætʃ/; [n]一批(人或物);一批生产量; [^]yshx;
bathe: [-]/beɪð/; [v]给..洗澡;洗澡;洗澡,游泳; [^]yshx;
batter: [-]/ˈbætər/; [n](用鸡蛋,牛奶等调制的)面糊; [v]连续猛击; [^]yshx;
battery: [-]/ˈbætəri/; [n]电池(组);排炮;一组,许多,众多; [^]yshx;
bay: [-]/beɪ/; [n]海湾,港湾;困境; [vi](尤指猎犬等)吠,叫,咆哮;筑堤遏(水); [v]穷追,使陷入绝境;阻止(敌人)不使前进;向.吠叫; [a]赤褐色的,栗色的; [^]yshx;
be (go) on board: [-]/biː ɡoʊ ɔːn bɔːrd/; [ad]在船上,在飞机上; [^]yshx;
be all set: [-]/bi ɔl set/; [phr]准备就绪; [^]yshx;
be at odds (with sb.)(over sth.): [-]/biː æt ɑːdz wɪθ ˈsʌmbədi ˈoʊvər ˈsʌmθɪŋ/; [a]与.有争执; [^]yshx;
be bent on: [-]/bi bent ɔn/; [v]专心致志于;决心要; [^]yshx;
be better off: [-]/bi ˈbetər ɑf/; [phr]较富裕;更好; [^]yshx;
be hard to say: [-]/bi hɑrd tu seɪ/; [phr]难以开口; [^]yshx;
be in two minds about sth.: [-]/biː ɪn tuː maɪndz əˈbaʊt ˈsʌmθɪŋ/; [a]犹豫不决; [^]yshx;
be obsessed with: [-]/bi əbˈsest wɪð/; [v](指恐惧等)缠住;使烦扰;对.着迷; [^]yshx;
be on edge: [-]/bi ɑn ɛdʒ/; [phr]紧张不安; [^]yshx;
be on good terms (with sb.): [-]/biː ɔːn ɡʊd tɜːrmz wɪθ ˈsʌmbədi/; [phr]关系好; [^]yshx;
be on to: [-]/bi ɔn tu/; [phr]意识到,识透;找..岔子; [^]yshx;
be set on sth.: [-]/biː set ɔːn ˈsʌmθɪŋ/; [a]决心做某事; [^]yshx;
beam: [-]/biːm/; [n]光线;(房屋等)大梁;(横)梁; [v]发光;照射;发射,播送;微笑;用梁支撑; [^]yshx;
bear sth. in mind: [-]/ber ˈsʌmθɪŋ ɪn maɪnd/; [v]记住某事; [^]yshx;
bear sth.(sb.) out: [-]/ber ˈsʌmθɪŋ ˈsʌmbədi aʊt/; [v]证实; [^]yshx;
bear with (sb.): [-]/ber wɪθ ˈsʌmbədi/; [phr]耐心等待;宽容; [^]yshx;
bear: [-]/ber/; [n]熊;(股市)看跌的人; [v]容忍,忍受;承担;带有;生育;开花结果,结(果实); [^]yshx;
beard: [-]/bɪrd/; [n](下巴上的)胡须; [v]公开反对;抓住胡须; [^]yshx;
bearing: [-]/ˈberɪŋ/; [n]方向;举止;轴承; [^]yshx;
beat about/around the bush: [-]/biːt əˈbaʊt əˈraʊnd ðə bʊʃ/; [v]转弯抹角; [^]yshx;
beat sb. (sth.) off: [-]/biːt ˈsʌmbədi ˈsʌmθɪŋ ɑːf/; [v]击退; [^]yshx;
beat: [-]/biːt/; [v]敲打;打败;打;(心脏)跳动;搅拌; [n]敲打;拍子; [a]精疲力竭的,疲惫不堪的;垮掉的,属于"垮掉的一代"的; [^]yshx;
beautician: [-]/bjuːˈtɪʃn/; [n]美容师; [^]yshx;
become of: [-]/bɪˈkʌm ɑv/; [v](命运等)降临;使遭遇;发生.情况; [^]yshx;
behalf: [-]/bɪˈhæf/; [n]代表(某人),因为某人;利益;赞同,支持; [^]yshx;
behave: [-]/bɪˈheɪv/; [v]举动;举止端正(或良好,适当); [^]yshx;
behind the times: [-]/bɪˈhaɪnd ðə taɪmz/; [ad]过时的; [^]yshx;
behind time: [-]/bɪˈhaɪnd taɪm/; [a]迟到; [^]yshx;
belly: [-]/ˈbeli/; [n]圆形或凸起部分;肚子; [^]yshx;
beloved: [-]/bɪˈlʌvɪd/; [n]爱人; [a]心爱的,所钟爱的;受爱戴的; [^]yshx;
bend: [-]/bend/; [v](使)弯曲,(使)改变(主意),使屈服; [n]弯曲,弯曲处,倾向,屈服;(复数形式)减压症; [^]yshx;
beneficial: [-]/ˌbenɪˈfɪʃl/; [a]有益的,有利的; [^]yshx;
benefit: [-]/ˈbenɪfɪt/; [v]受益,有助于,使受益; [n]好处,益处;救济金; [^]yshx;
bent: [-]/bent/; [a]弯曲的,决心的,不诚实的; [v]弯腰,弯曲(bend过去式); [n]爱好,癖好; [^]yshx;
berth: [-]/bɜːrθ/; [n]停泊处;卧铺;<口语>职业; [v]使停泊; [^]yshx;
beset: [-]/bɪˈset/; [v]困扰;镶嵌;围绕; [^]yshx;
bet: [-]/bet/; [n]赌注;打赌; [v]打赌;敢断定; [^]yshx;
betray: [-]/bɪˈtreɪ/; [v]背叛;失信于;泄露(秘密等);(非故意地)暴露; [^]yshx;
beverage: [-]/ˈbevərɪdʒ/; [n](水,酒等之外的)饮料; [^]yshx;
bewilder: [-]/bɪˈwɪldər/; [v]使不知所措;使迷惑;使变糊涂,弄糊涂; [^]yshx;
bias: [-]/ˈbaɪəs/; [n]倾斜;偏心;偏见; [v]使有偏见; [^]yshx;
bibliography: [-]/ˌbɪbliˈɑːɡrəfi/; [n]参考书目;文献学; [^]yshx;
bid: [-]/bɪd/; [n]出价;投标;努力争取; [v]出价;投标;问候;道别;吩咐; [^]yshx;
bind: [-]/baɪnd/; [v]捆绑;装订;约束;结合; [n]窘境,困境;讨厌的事情;捆绑;植物的藤蔓; [^]yshx;
biography: [-]/baɪˈɑːɡrəfi/; [n]传记文学,传记; [^]yshx;
bite: [-]/baɪt/; [v]咬,叮,螫;剌穿; [n]咬;(咬下的)一口;少量食物;简单的一餐; [^]yshx;
bitumen: [-]/bəˈtuːmən/; [n]沥青; [^]yshx;
bizarre: [-]/bɪˈzɑːr/; [a]稀奇古怪的; [^]yshx;
blame: [-]/bleɪm/; [v]责备,把..归咎于; [n]责备,过失; [^]yshx;
blank: [-]/blæŋk/; [a](纸等)空白的,茫然的; [n]空白,空白处; [v]忽视; [^]yshx;
blast: [-]/blæst/; [n]一阵(疾风等);爆炸;冲击波; [v](用炸药)炸,摧毁; [^]yshx;
blaze: [-]/bleɪz/; [vi]熊熊燃烧;闪耀;怒视;连续射击; [vt]大肆宣扬; [n]火焰; [^]yshx;
bleach: [-]/bliːtʃ/; [v]漂白; [n]漂白剂; [^]yshx;
bleak: [-]/bliːk/; [a]凄凉的;萧瑟的;阴郁的;无希望的; [^]yshx;
bleed: [-]/bliːd/; [vi]流血;散开; [vt]榨取,敲诈;使流血;使..排出液体; [n]出血; [a]<印>出血版的; [^]yshx;
blend: [-]/blend/; [v]混合;把.混成一体; [n]混合物; [^]yshx;
bless: [-]/bles/; [v]保佑,祝福,赐福,有幸具有; [^]yshx;
blink: [-]/blɪŋk/; [v]眨眼睛;闪亮;闪烁; [n]眨眼睛; [^]yshx;
bloc: [-]/blɑːk/; [n]集团; [^]yshx;
block: [-]/blɑːk/; [v]阻挡;妨碍;阻塞; [n]街区;块状物;积木;阻碍;大厦; [^]yshx;
blonde: [-]/blɑːnd/; [a](头发)亚麻色的,金色的; [n]金(浅)发女郎; [^]yshx;
bloom: [-]/bluːm/; [v]开花; [n]开花期;青春时期;花;兴旺时期; [^]yshx;
blot: [-]/blɑːt/; [n]墨水渍;污点;缺点; [v]涂污;(用吸水纸)吸干墨水;遮暗; [^]yshx;
blunder: [-]/ˈblʌndər/; [n]愚蠢之举;大错; [vi]犯大错; [v]失策;绊倒; [^]yshx;
blunt: [-]/blʌnt/; [a]钝的;直率的; [v]使情感,感觉,需求减弱;变钝; [^]yshx;
blur: [-]/blɜːr/; [n]污点,模糊; [v]使.模糊;弄脏;变模糊; [^]yshx;
blush: [-]/blʌʃ/; [v]脸红;害臊; [n]脸红; [^]yshx;
board: [-]/bɔːrd/; [n]木板;董事会;甲板;膳食; [v]乘船,登机;用板铺;供膳食;寄宿; [^]yshx;
boast: [-]/boʊst/; [v]夸耀;吹牛,吹嘘;自负; [n]感到骄傲的事; [^]yshx;
boil down to: [-]/bɔɪl daʊn tu/; [v]归结起来是,问题是; [^]yshx;
boil: [-]/bɔɪl/; [v]烧开,沸腾;用开水煮,在沸水中煮; [n]煮沸,沸腾;疔,疖子;<医>疡肿,脓肿; [^]yshx;
bold: [-]/boʊld/; [a]大胆的,勇敢的;无耻的,放肆的;醒目的; [n]粗体字; [^]yshx;
bolt: [-]/boʊlt/; [n]门栓,螺栓;闪电;弩箭; [v]闩门;(马受惊)脱缰; [ad]突然地;像箭似地;直立地; [^]yshx;
bond: [-]/bɑːnd/; [n]束缚物,联结物;凝聚力;债券;保释金;联系; [vi]结合;团结一致; [^]yshx;
bonus: [-]/ˈboʊnəs/; [n]奖金,额外津贴; [^]yshx;
bookcase: [-]/ˈbʊkkeɪs/; [n]书橱,书架; [^]yshx;
bookkeeper: [-]/ˈbʊkkiːpər/; [n]簿记员;会计员; [^]yshx;
boom: [-]/buːm/; [n]隆隆声;繁荣;景气;激增; [v]发出低沉有回响的声音;迅速发展,蓬勃发展;以低沉有回响的声音发出; [^]yshx;
boost: [-]/buːst/; [v]增加;偷盗; [n]提高;激励;后推;助推发动机; [^]yshx;
booth: [-]/buːθ/; [n]小舍;隔开的小间;公用电话亭;有篷的售货摊;窝棚; [^]yshx;
border on (upon): [-]/ˈbɔːrdər ɔːn əˈpɔːn/; [v]接近,近似; [^]yshx;
border: [-]/ˈbɔːrdər/; [n]边界;花坛;滚边,边沿,包边; [v]近似;毗邻;与..接壤;为..镶边; [^]yshx;
bother: [-]/ˈbɑːðər/; [v]麻烦,打扰;花时间; [n]烦扰,麻烦,打扰; [^]yshx;
bounce: [-]/baʊns/; [vi]弹起,蹦跳; [vt]使弹起; [v]拒付 (支票); [n]弹跳,弹力,活力; [^]yshx;
bound: [-]/baʊnd/; [a]受约束的;有义务的;一定的; [v]束缚;跳跃着前行; [n]跳跃;范围;界限; [^]yshx;
boundary: [-]/ˈbaʊndri/; [n]边界,分界线;使球越过边界线的击球(得加分); [^]yshx;
bounty: [-]/ˈbaʊnti/; [n]慷慨;赠物;奖金; [vt]发给.奖金; [^]yshx;
bouquet: [-]/buˈkeɪ/; [n]花束,(酒的)芳香; [^]yshx;
bowel: [-]/ˈbaʊəl/; [n]肠;内部; [^]yshx;
boycott: [-]/ˈbɔɪkɑːt/; [vt]抵制; [n]抵制; [^]yshx;
brace: [-]/breɪs/; [n]<医学>牙齿定位器; [v]支柱;支撑;加固;使绷紧; [^]yshx;
brake: [-]/breɪk/; [v]刹车; [n]刹车,制动器,闸; [^]yshx;
brand: [-]/brænd/; [n]商标,品牌;烙印; [v]给..打上烙印;归为 (不好的事物); [^]yshx;
brashness: [-]/ˈbræʃnəs/; [n]莽撞,无礼,轻率; [^]yshx;
breach: [-]/briːtʃ/; [n]破裂;裂痕;冲击;违反; [v]使有裂口;破坏; [^]yshx;
break away (from): [-]/breɪk əˈweɪ frʌm/; [v]突然走开;放弃;革除; [^]yshx;
break down: [-]/brek daʊn/; [phr]发生故障;失败;(精神)垮下来; [^]yshx;
break off (sth.): [-]/breɪk ɑːf ˈsʌmθɪŋ/; [v]折断;突然结束; [^]yshx;
break one's heart: [-]/brek wʌnz hɑrt/; [v]使人心碎; [^]yshx;
breakdown: [-]/ˈbreɪkdaʊn/; [n]损坏;故障;分类,明细;倒塌,崩溃;衰退; [^]yshx;
breakthrough: [-]/ˈbreɪkθruː/; [n]突破,突破性进展,重要的新发现; [a]突破性的; [^]yshx;
breed: [-]/briːd/; [n]血统;种类; [v]产仔;繁殖;使繁殖; [^]yshx;
breeze: [-]/briːz/; [n]微风,清风;轻而易举的事; [v]飘然而行;轻松通过; [^]yshx;
brew: [-]/bruː/; [v]调制;酿造;冲泡 (茶,咖啡等);酝酿;筹划; [n]酝酿的饮料;啤酒; [^]yshx;
bribe: [-]/braɪb/; [v]向.行贿;买通; [n]贿赂;行贿物; [^]yshx;
briefcase: [-]/ˈbriːfkeɪs/; [n]公文包; [^]yshx;
brilliant: [-]/ˈbrɪliənt/; [a]聪颖的;卓越的,有才气的;明亮的; [^]yshx;
bring (call) sth. to mind: [-]/brɪŋ kɔːl ˈsʌmθɪŋ tu maɪnd/; [v]想起某事; [^]yshx;
bring about: [-]/brɪŋ əˈbaʊt/; [phr]导致,引起; [^]yshx;
bring back: [-]/briŋbæk/; [phr]拿回来;使.回忆起来; [^]yshx;
bring forward: [-]/brɪŋ ˈfɔrwərd/; [v]提出;提前; [^]yshx;
bring in: [-]/brɪŋ ɪn/; [v]增加,赚取,产生,引进; [^]yshx;
bring up: [-]/brɪŋ ʌp/; [phr]养育;呕出;提出; [^]yshx;
brink: [-]/brɪŋk/; [n](尤指崖边)边缘; [^]yshx;
brisk: [-]/brɪsk/; [a]轻快的;活跃的;寒冷而清新的; [^]yshx;
brittle: [-]/ˈbrɪtl/; [a]易碎的;脆弱的;靠不住的; [n]薄片脆糖; [^]yshx;
brochure: [-]/broʊˈʃʊr/; [n]手册,小册子; [^]yshx;
brood: [-]/bruːd/; [n]一窝,同窝幼崽; [vi]冥思苦想; [vt]孵;默想; [a]传种用的;(母鸡等)抱窝的;(昆虫等)产卵的; [^]yshx;
bruise: [-]/bruːz/; [n](人体组织或表皮等跌,碰撞后产生的)青肿,挫伤;碰伤; [v]撞伤,碰伤,(使)挫伤,擦伤(表皮,表面);打击;擦伤; [^]yshx;
brutal: [-]/ˈbruːtl/; [a]残忍的,粗鲁的;严酷的,难以忍受的;严峻的; [^]yshx;
bubble: [-]/ˈbʌbl/; [v]起泡;兴奋,欢闹;充满生气,情绪高涨; [n]气泡,水泡;虚幻之事;靠不住的计划;泡影;幻想,妄想; [^]yshx;
buck: [-]/bʌk/; [n]雄鹿;年轻男士;美元; [v]反对;马弓背踢后腿挑起; [^]yshx;
bucket: [-]/ˈbʌkɪt/; [n]水桶,(机器上的)桶装物,大量; [v]颠簸行进,下倾盆大雨;装在桶里; [^]yshx;
buckle: [-]/ˈbʌkl/; [v]用扣子,把.扣紧(或扣住,扣上);扣紧,扣住;变弯曲,使弯曲; [n]金属扣,皮带扣; [^]yshx;
bud: [-]/bʌd/; [n]蓓蕾,芽; [v]使发芽; [^]yshx;
budget: [-]/ˈbʌdʒɪt/; [n]预算; [v]预算,安排; [a]廉价的; [^]yshx;
buffet: [-]/bəˈfeɪ/; [n]自助餐,(火车内)餐室,冷餐桌; [v]反复敲打,打击,重击; [^]yshx;
bug: [-]/bʌɡ/; [n]<计算机>(制作软件程序所产生的意料不到的)错误,故障;窃听器;热衷于(某事)者;臭虫,小虫子; [v]使厌烦,打扰;窃听; [vt]使烦恼,纠缠; [^]yshx;
bulb: [-]/bʌlb/; [n]电灯泡;球状物;球茎; [^]yshx;
bulge: [-]/bʌldʒ/; [n]凸出部分; [v]凸出,膨胀; [^]yshx;
bulk: [-]/bʌlk/; [n]大批;容量;体积;大块; [a]大量的;散装的; [v]膨胀;显得重要; [^]yshx;
bull: [-]/bʊl/; [n]公牛,雄性的鲸,象等大动物; [^]yshx;
bulletin: [-]/ˈbʊlətɪn/; [n]公告;公报;公告牌; [^]yshx;
bully: [-]/ˈbʊli/; [n]恃强欺弱者; [v]欺负; [^]yshx;
bump: [-]/bʌmp/; [n]隆起物;撞击;(碰撞造成的)肿块; [v]撞击;颠簸地行驶;凹凸不平;除名,撵走; [^]yshx;
bunch: [-]/bʌntʃ/; [n]束;串;群,伙; [v]集中,挤在一起;使成一束(或一群等); [^]yshx;
bundle: [-]/ˈbʌndl/; [n]捆,包; [vt]捆; [^]yshx;
bungalow: [-]/ˈbʌŋɡəloʊ/; [n]平房,小屋; [^]yshx;
bunk: [-]/bʌŋk/; [n](火车等)床铺,铺位,卧铺;骗人的话,废话; [v]睡(在床铺上),去睡; [^]yshx;
buoyant: [-]/ˈbɔɪənt/; [a]有浮力的;愉快的;(股市)保持高价的; [^]yshx;
bureaucracy: [-]/bjʊˈrɑːkrəsi/; [n]官僚主义;政府机构; [^]yshx;
burgeon: [-]/ˈbɜːrdʒən/; [v]发芽,迅速成长; [n]嫩枝; [^]yshx;
burial: [-]/ˈberiəl/; [n]埋葬,葬礼;掩埋; [^]yshx;
bust: [-]/bʌst/; [n]半身塑像;胸部; [v]打碎;搜捕;降级;终止; [a]破产的;打碎的; [^]yshx;
butcher: [-]/ˈbʊtʃər/; [n]屠夫,肉贩子;刽子手; [v]屠宰;屠戮,残杀; [^]yshx;
buzz: [-]/bʌz/; [v]发出嗡嗡声; [n]嗡嗡声;低沉嘈杂的谈话声; [^]yshx;
bypass: [-]/ˈbaɪpæs/; [v]绕过;回避; [n]旁路;心脏分流手术; [^]yshx;
cabin: [-]/ˈkæbɪn/; [n](简陋的)小屋;船舱;客舱,机舱; [v]住在小屋里; [^]yshx;
cabinet: [-]/ˈkæbɪnət/; [n]橱;柜;内阁; [^]yshx;
cable: [-]/ˈkeɪbl/; [n]电缆,缆,索; [v]拍电报; [^]yshx;
cafe: [-]/kæˈfeɪ/; [n]咖啡馆,餐馆; [^]yshx;
cafeteria: [-]/ˌkæfəˈtɪriə/; [n]自助食堂;自助餐馆; [^]yshx;
calcium: [-]/ˈkælsiəm/; [n]钙; [^]yshx;
calendar: [-]/ˈkælɪndər/; [n]日历;时间表;历法; [vt]把.记入日程表中;把.列入表中;为(文件等)作分类索引;将.排入日程表; [^]yshx;
call (sth.) off: [-]/kɔːl ˈsʌmθɪŋ ɑːf/; [phr]停止; [^]yshx;
call for: [-]/kɔːl fɔr/; [v]需要;邀请;呼吁; [^]yshx;
call it a day: [-]/kɔl ɪt ə deɪ/; [v]收工; [^]yshx;
call on: [-]/kɔːl ɑːn/; [phr]拜访,呼吁,请求; [^]yshx;
call sb. (sth.) up: [-]/kɔːl ˈsʌmbədi ˈsʌmθɪŋ ʌp/; [v]打电话;征召; [^]yshx;
calorie: [-]/ˈkæləri/; [n]卡(热量单位); [^]yshx;
campaign: [-]/kæmˈpeɪn/; [n](社会性,政治性)活动,运动;战役; [v]从事活动,参加运动; [^]yshx;
campus: [-]/ˈkæmpəs/; [n]校园,学校场地; [^]yshx;
canal: [-]/kəˈnæl/; [n]运河,河流;水渠;(人体的)导管,食管,气管; [^]yshx;
candidate: [-]/ˈkændɪdət/; [n](官职,获奖资格等的)候选人;投考人;申请求职者; [^]yshx;
cane: [-]/keɪn/; [n]手杖;茎;藤条;甘蔗; [^]yshx;
cannon: [-]/ˈkænən/; [n]大炮;机关炮; [v]相撞;开炮; [^]yshx;
canteen: [-]/kænˈtiːn/; [n]食堂,小卖部;水壶; [^]yshx;
canvas: [-]/ˈkænvəs/; [n]帆布,(帆布)油画; [^]yshx;
capacity: [-]/kəˈpæsəti/; [n]产能;容量;本领;才能;负载量;职位; [^]yshx;
cape: [-]/keɪp/; [n]斗篷;披肩;岬,海岬,海角; [^]yshx;
capital: [-]/ˈkæpɪtl/; [n]资金,资本;首都;大写(字母); [a]大写的;资本的;优秀的;处以死刑的;致命的; [^]yshx;
capsule: [-]/ˈkæpsl/; [n]胶囊;航天舱,密封舱; [^]yshx;
caption: [-]/ˈkæpʃn/; [n](报刊的)标题;(插图,照片等的)说明文字; [v]给(图片,照片等)加说明文字; [^]yshx;
captive: [-]/ˈkæptɪv/; [a]被捕获的;被俘虏的; [n]俘虏; [^]yshx;
cardinal: [-]/ˈkɑːrdɪnl/; [a]主要的;基本的; [n]<天主教>枢机主教,红衣主教;基数; [^]yshx;
carpenter: [-]/ˈkɑːrpəntər/; [n]木匠;木工; [^]yshx;
carrier: [-]/ˈkæriər/; [n]搬运工,运送人;运输公司;航空母舰; [^]yshx;
carrot: [-]/ˈkærət/; [n]胡萝卜; [^]yshx;
carry on: [-]/'kæriː ɔn/; [v]继续开展;坚持;举止失常; [^]yshx;
carry out: [-]/ˈkærɪ aʊt/; [phr]执行,实行;实现;完成; [^]yshx;
carry through: [-]/ˈkeri θru/; [v]维持;使渡过难关,坚持下去; [^]yshx;
cart: [-]/kɑːrt/; [n]手推车,运货马车; [v]用车装载; [^]yshx;
carton: [-]/ˈkɑːrtn/; [n](尤指装食品和液体的)硬纸盒,纸板箱,塑料箱; [^]yshx;
cartoon: [-]/kɑːrˈtuːn/; [n]卡通(片),动画片;(尤指报刊上讽刺政客或时事的)漫画,幽默画; [^]yshx;
carve: [-]/kɑːrv/; [v]雕刻;(把肉等)切成片;开创,开拓; [^]yshx;
cash crop: [-]/ˈkæʃ krɑːp/; [phr]经济作物; [^]yshx;
cash in on: [-]/kæʃ ɪn ɔn/; [v]以.获利,营利; [^]yshx;
cashier: [-]/kæˈʃɪr/; [n]出纳员,收银员; [v]把..撤职;驱逐,革除,废除; [^]yshx;
cassette: [-]/kəˈset/; [n]磁带盒;录像带,盒式磁带; [^]yshx;
cast off: [-]/kæst ɑf/; [v]解缆放船;抛弃,丢弃; [^]yshx;
cast sb. (sth.) aside: [-]/kæst ˈsʌmbədi ˈsʌmθɪŋ əˈsaɪd/; [v]抛弃,废除; [^]yshx;
cast: [-]/kæst/; [v]投;抛下,投射(光线和阴影);瞥,飞快看(一眼),扫视;掷;放钓;投票;选定演员; [n]投掷物;铸件;演员表,演员阵容; [^]yshx;
casual: [-]/ˈkæʒuəl/; [a]偶然的;临时的;随便的; [n]临时工;便服; [^]yshx;
casualty: [-]/ˈkæʒuəlti/; [n]伤亡人员,死伤者,受害人;急诊室(英); [^]yshx;
catalog: [-]/ˈkætəlɔːɡ/; [n]目录,目录册,商品目录; [v]为..编目录,登记; [^]yshx;
catalyst: [-]/ˈkætəlɪst/; [n]催化剂;造成变化的人或事; [^]yshx;
catch on: [-]/kætʃ ɔn/; [phr]变得流行;理解; [^]yshx;
catch up with sb.: [-]/kætʃ ʌp wɪθ ˈsʌmbədi/; [v]赶上;逮捕; [^]yshx;
catching: [-]/ˈkætʃɪŋ/; [a]传染的;迷人的,有魅力的; [^]yshx;
category: [-]/ˈkætəɡɔːri/; [n]类别;范畴; [^]yshx;
cater: [-]/ˈkeɪtər/; [v]供应伙食;为(集会,婚礼等)承办酒席; [^]yshx;
cathedral: [-]/kəˈθiːdrəl/; [n]大教堂; [a]有权威的;大教堂的; [^]yshx;
caustic: [-]/ˈkɔːstɪk/; [a]腐蚀性的;苛性的;刻薄的;焦散的; [n]腐蚀剂;苛性钠;焦散曲线; [^]yshx;
caution: [-]/ˈkɔːʃn/; [n]小心;警告;告诫; [v]劝.谨慎小心;警告; [^]yshx;
cavity: [-]/ˈkævəti/; [n]洞;龋洞; [^]yshx;
cease: [-]/siːs/; [v]停止,结束; [n]停止,停息; [^]yshx;
cellar: [-]/ˈselər/; [n]地窖;地下室;酒窖; [^]yshx;
cement: [-]/sɪˈment/; [n]水泥,混凝土;胶合剂; [vt]巩固,加强;用水泥涂;接合; [vi]粘牢; [^]yshx;
cemetery: [-]/ˈseməteri/; [n]公墓;墓地; [^]yshx;
cereal: [-]/ˈsɪriəl/; [n]谷物;谷类食物;谷类食品; [a]谷类的;谷类制成的; [^]yshx;
ceremony: [-]/ˈserəmoʊni/; [n]典礼,仪式;礼节; [^]yshx;
certainty: [-]/ˈsɜːrtnti/; [n]必然;确信;必然的事; [^]yshx;
certify: [-]/ˈsɜːrtɪfaɪ/; [v](发给证书)证明;证实; [^]yshx;
challenge: [-]/ˈtʃælɪndʒ/; [n]挑战;质疑; [v]挑战;质疑; [^]yshx;
chamber: [-]/ˈtʃeɪmbər/; [n]会议室;(作特殊用途的)房间;议院; [^]yshx;
champagne: [-]/ʃæmˈpeɪn/; [n]香槟酒; [^]yshx;
champion: [-]/ˈtʃæmpiən/; [n]冠军;拥护者,战士; [v]拥护;保卫;为..而斗争; [a]夺得第一名的;优胜的; [^]yshx;
chant: [-]/tʃænt/; [v]吟唱;诵扬; [n]圣歌;赞美诗;旋律; [^]yshx;
chaos: [-]/ˈkeɪɑːs/; [n]混沌;混乱,纷乱; [^]yshx;
chapel: [-]/ˈtʃæpl/; [n]小教堂;私人祈祷室; [^]yshx;
characteristic: [-]/ˌkærəktəˈrɪstɪk/; [n]特点;特性;特色; [a]典型的;特有的;独特的; [^]yshx;
charge: [-]/tʃɑːrdʒ/; [v]充电,充值;索价;控告;向.冲去; [n]费用;主管;控告; [^]yshx;
charity: [-]/ˈtʃærəti/; [n]慈善团体;慈善;仁慈;施舍; [^]yshx;
charm: [-]/tʃɑːrm/; [n]魅力,吸引力,符咒; [v](使)着迷,施魔法; [^]yshx;
chart: [-]/tʃɑːrt/; [n]图表,表格;航海图;每周排行榜; [v]制成图表;制航海图; [^]yshx;
charter: [-]/ˈtʃɑːrtər/; [n]宪章;特权,豁免权;契约,证书;租赁; [v]包,租(飞机,汽车等); [a]包租的,租用的; [^]yshx;
chase: [-]/tʃeɪs/; [v]追赶;驱逐;追求; [n]追逐;追求; [^]yshx;
chasm: [-]/ˈkæzəm/; [n](地壳,冰上的)隐窟,深坑,峡谷;显著差距,巨大分歧; [^]yshx;
chaste: [-]/tʃeɪst/; [a]贞洁的;纯洁的;朴素的; [^]yshx;
check in: [-]/tʃek ɪn/; [phr]报到,记录;登记入住; [^]yshx;
check out: [-]/tʃek aʊt/; [phr]结账后离开,检验,通过考核,合格; [^]yshx;
cherish: [-]/ˈtʃerɪʃ/; [v]珍爱,珍视;抱有(希望); [^]yshx;
chew: [-]/tʃuː/; [v]嚼,咀嚼; [n]嚼碎,咀嚼; [^]yshx;
chic: [-]/ʃiːk/; [n]时髦,款式别致; [a]别致的;时髦的; [^]yshx;
chief: [-]/tʃiːf/; [n]老板,头子;主管;(部落) 首领;酋长;长官; [a]主要的;首席的; [^]yshx;
chill: [-]/tʃɪl/; [n]寒冷; [v](使)感到冷,使变冷; [a]扫兴的; [^]yshx;
chin: [-]/tʃɪn/; [n]颏;下巴; [v]用下巴夹住;聊天;作引体向上动作; [^]yshx;
chip: [-]/tʃɪp/; [n]木屑,碎片;缺口;圆形筹码;芯片;炸薯条,炸薯片; [v]碎裂;削,凿;将.削成,凿成; [^]yshx;
chisel: [-]/ˈtʃɪzl/; [v]刻,凿; [n]凿子; [^]yshx;
choir: [-]/ˈkwaɪər/; [n](教会的)歌唱队,唱诗班; [^]yshx;
choke: [-]/tʃoʊk/; [v]噎住,(使)窒息,阻塞; [n]窒息,噎住; [^]yshx;
chop: [-]/tʃɑːp/; [v](用力)切,砍;降低;向下猛击;终止; [n]砍;劈;剁;排骨;嘴周围的地方; [^]yshx;
chord: [-]/kɔːrd/; [n]和弦;和音;心弦;(数学)弦; [^]yshx;
chore: [-]/tʃɔːr/; [n]日常家庭杂务,日常工作;琐碎烦人的杂务; [^]yshx;
chorus: [-]/ˈkɔːrəs/; [n]副歌部分;合唱团;合唱曲,合唱句; [v]合唱,齐声说;齐声说; [^]yshx;
chronic: [-]/ˈkrɑːnɪk/; [a](疾病)慢性的;长期的;(人)久病的;积习难改的;严重的; [^]yshx;
chronological: [-]/ˌkrɑːnəˈlɑːdʒɪkl/; [a]按照时间顺序排列的; [^]yshx;
chunk: [-]/tʃʌŋk/; [n]大块;矮而厚的木块;大量; [^]yshx;
circuit: [-]/ˈsɜːrkɪt/; [n]电路,线路;巡游,环形; [^]yshx;
circulate: [-]/ˈsɜːrkjəleɪt/; [v](使)流通;(使)循环;(使)传播,流传; [^]yshx;
circumference: [-]/sərˈkʌmfərəns/; [n]圆周长度,圆周;周围; [^]yshx;
circumstance: [-]/ˈsɜːrkəmstæns/; [n]条件;情况;命运;客观环境; [^]yshx;
circus: [-]/ˈsɜːrkəs/; [n]马戏团;杂技团;环形广场;闹剧(表示不满); [^]yshx;
cite: [-]/saɪt/; [v]引用,引证;传唤,传讯;表彰,嘉奖; [^]yshx;
civic: [-]/ˈsɪvɪk/; [a]城市的;公民的,市民的; [^]yshx;
civilian: [-]/səˈvɪliən/; [n]平民,百姓; [a]平民的,百姓的,民用的; [^]yshx;
claim: [-]/kleɪm/; [v]声称;要求;断言;主张;认领;索赔; [n]索赔;主张;声称;断言;要求; [^]yshx;
clan: [-]/klæn/; [n]家族;氏族;部落;宗派;亲族; [^]yshx;
clarify: [-]/ˈklærəfaɪ/; [v]阐明,澄清;净化; [^]yshx;
clash: [-]/klæʃ/; [vi]发生冲突;发出撞击声;不合,不一致,不调和; [n]冲突;抵触;撞击声; [^]yshx;
clasp: [-]/klæsp/; [v]握紧;扣紧;扣住;抱紧; [n]扣子;钩子;紧抱;紧握; [^]yshx;
classic: [-]/ˈklæsɪk/; [a]经典的;古典的;高雅的;一流的; [n]经典著作;文豪;优秀典范; [^]yshx;
classify: [-]/ˈklæsɪfaɪ/; [v]把.分类; [^]yshx;
clause: [-]/klɔːz/; [n]条款;从句; [^]yshx;
clear away: [-]/klɪr əˈweɪ/; [v]把.除掉; [^]yshx;
clear out: [-]/klɪr aʊt/; [phr]匆忙离开;逃离;清空;腾空; [^]yshx;
clear the air: [-]/klɪr ðə er/; [v]消除误会; [^]yshx;
clear up: [-]/klɪr ʌp/; [v]放晴,清除,整理; [^]yshx;
clearance: [-]/ˈklɪrəns/; [n]清除;清理;清空;许可; [^]yshx;
cliche: [-]/klɪˈʃeɪ/; [n]陈腐思想,陈词滥调; [a]陈腐的; [^]yshx;
click: [-]/klɪk/; [v]点击(鼠标);(使)发出咔哒声;情投意合;博得喝彩; [n]咔哒声,点击; [^]yshx;
client: [-]/ˈklaɪənt/; [n]委托人,当事人,主顾,客户;客户端; [^]yshx;
climax: [-]/ˈklaɪmæks/; [n]高潮,最令人兴奋(或感兴趣)的部分; [v](使)达到顶点,(使)达到高潮; [^]yshx;
cling: [-]/klɪŋ/; [v]紧紧抓住;黏着,挨近;依恋,依附;坚持,墨守,忠实于; [^]yshx;
clinic: [-]/ˈklɪnɪk/; [n]诊所;门诊(部,室); [^]yshx;
clip: [-]/klɪp/; [n]回形针,夹子;(电影,广播,电视节目的)片段; [v]夹住;删剪;剪辑; [^]yshx;
clockwise: [-]/ˈklɑːkwaɪz/; [a]顺时针方向的; [ad]顺时针方向地; [^]yshx;
closet: [-]/ˈklɑːzət/; [n]橱,壁橱,小储藏室; [v]把.引进密室会谈; [a]私下的,秘密的; [^]yshx;
clue: [-]/kluː/; [n]线索;提示;暗示; [vt]为..提供线索; [^]yshx;
clumsy: [-]/ˈklʌmzi/; [a]笨拙的,不灵活的;拙劣的,不得体的; [^]yshx;
cluster: [-]/ˈklʌstər/; [n]一串;一簇; [v]群集;丛生; [^]yshx;
clutch: [-]/klʌtʃ/; [v]抓住;紧握; [n]抓住;离合器; [^]yshx;
coach: [-]/koʊtʃ/; [n]四轮大马车;教练;长途汽车; [v]训练,指导; [^]yshx;
coalition: [-]/ˌkoʊəˈlɪʃn/; [n]结合;联盟;联合; [^]yshx;
coarse: [-]/kɔːrs/; [a]粗糙的;粗俗的;粗鲁的; [^]yshx;
cocaine: [-]/koʊˈkeɪn/; [n]可卡因,古柯碱; [^]yshx;
code: [-]/koʊd/; [n]编码,代码;准则,法典;密码; [v]将.编码; [^]yshx;
coed: [-]/ˌkoʊˈed/; [n]男女同校的女生; [a]男女同校的; [^]yshx;
coerce: [-]/koʊˈɜːrs/; [v]强迫,压制; [^]yshx;
cognitive: [-]/ˈkɑːɡnətɪv/; [a]认识能力的;认知的; [^]yshx;
coil: [-]/kɔɪl/; [n](一)卷,(一)圈;线圈; [v]卷,盘绕; [^]yshx;
coincide: [-]/ˌkoʊɪnˈsaɪd/; [v]巧合,一致,相符; [^]yshx;
collaboration: [-]/kəˌlæbəˈreɪʃn/; [n]合作,协作;勾结; [^]yshx;
collapse: [-]/kəˈlæps/; [v](使)倒塌,(使)崩溃,(使)瓦解; [n]倒塌,崩溃,暴跌; [^]yshx;
collide: [-]/kəˈlaɪd/; [vi]碰撞;互撞;抵触; [^]yshx;
colonial: [-]/kəˈloʊniəl/; [a]殖民地的,关于殖民的; [n]殖民地居民; [^]yshx;
colossal: [-]/kəˈlɑːsl/; [a]巨像(似)的;巨大的,庞大的; [^]yshx;
column: [-]/ˈkɑːləm/; [n]柱,支柱,圆柱;专栏;长队; [^]yshx;
combat: [-]/ˈkɑːmbæt/; [n]战斗,格斗; [v]与.战斗,与.斗争; [a]战斗的; [^]yshx;
combine: [-]/kəmˈbaɪn/; [v]使混合(结合,组合,联合);结合;联合;组合; [n]联合体,联合企业;联合收割机; [^]yshx;
combustible: [-]/kəmˈbʌstəbl/; [a]易燃的;易激动的; [n]可燃物;易燃物; [^]yshx;
come (bring) sth. to light: [-]/kʌm brɪŋ ˈsʌmθɪŋ tu laɪt/; [v]显露,揭露; [^]yshx;
come about: [-]/kʌm ə'baʊt/; [phr]发生; [^]yshx;
come across sb.(sth.): [-]/kʌm əˈkrɑːs ˈsʌmbədi ˈsʌmθɪŋ/; [v]偶然碰见; [^]yshx;
come along: [-]/kʌm ə'lɔːŋ/; [phr]一起;进步;出现; [^]yshx;
come apart: [-]/kʌm əˈpɑrt/; [phr]破碎;瓦解;崩塌; [^]yshx;
come down: [-]/kʌm daʊn/; [phr]倒塌;下降,下来; [^]yshx;
come off: [-]/kʌm ɑf/; [phr]从..掉下,发生,举行,(计划)实现; [^]yshx;
come on: [-]/kʌm ɔn/; [phr]来吧;发展;开始; [^]yshx;
come out: [-]/kʌm aʊt/; [vi]出现,显露,出版,被算出,结果是,公开表态; [^]yshx;
come over sb.: [-]/kʌm ˈoʊvər ˈsʌmbədi/; [v](被感觉等)支配,攥住,拜访; [^]yshx;
come round(around): [-]/kʌm raʊnd əˈraʊnd/; [phr]绕道而来;过访;重又来到;改变主意;苏醒; [^]yshx;
come to nothing: [-]/kʌm tu ˈnʌθɪŋ/; [phr]失败,落空; [^]yshx;
come to nought: [-]/kʌm tu nɔt/; [v]失败; [^]yshx;
come to sb.: [-]/kʌm tu ˈsʌmbədi/; [v]被想到; [^]yshx;
come to terms (with sb.): [-]/kʌm tu tɜːrmz wɪθ ˈsʌmbədi/; [phr]与..达成协议; [^]yshx;
come up against: [-]/kʌm ʌp əˈɡenst/; [v]碰到(困难,反对); [^]yshx;
come up with: [-]/kʌm ʌp wɪð/; [v]提出;想出; [^]yshx;
come up: [-]/kʌm ʌp/; [v]升起;出现;发生;发芽; [^]yshx;
come upon: [-]/kʌm əˈpɑn/; [phr]遇到;对⋯⋯有感觉;突然⋯⋯想做; [^]yshx;
comet: [-]/ˈkɑːmət/; [n]彗星; [^]yshx;
comic: [-]/ˈkɑːmɪk/; [a]滑稽的,喜剧的,漫画的; [n]连环漫画杂志;喜剧演员; [^]yshx;
commemorate: [-]/kəˈmeməreɪt/; [v]纪念,庆祝; [^]yshx;
commence: [-]/kəˈmens/; [v]开始; [^]yshx;
commend: [-]/kəˈmend/; [v]称赞;推荐;委托保管; [^]yshx;
comment: [-]/ˈkɑːment/; [n]评论,议论;批评,意见;注解; [vt]评论; [vi]进行评论;为.作评语; [^]yshx;
commercial: [-]/kəˈmɜːrʃl/; [a]商业性的,贸易的; [n]商业广告; [^]yshx;
commission: [-]/kəˈmɪʃn/; [n]委员会;任务;权限;委任;销售佣金; [v]委任; [^]yshx;
commit: [-]/kəˈmɪt/; [v]犯(罪);进行 (自杀);调拨 (钱,资源);监禁;送交 (到精神病院,监狱等);承诺,保证; [^]yshx;
committee: [-]/kəˈmɪti/; [n]委员会;全体委员; [^]yshx;
commodity: [-]/kəˈmɑːdəti/; [n]商品,货物; [^]yshx;
commonwealth: [-]/ˈkɑːmənwelθ/; [n]联邦; [^]yshx;
commotion: [-]/kəˈmoʊʃn/; [n]骚动,动乱; [^]yshx;
communication: [-]/kəˌmjuːnɪˈkeɪʃn/; [n]沟通方式;交流,通讯;信息; [^]yshx;
commute: [-]/kəˈmjuːt/; [n]在两地之间乘车往返; [v]经常乘车往返于两地之间; [vt]减免; [^]yshx;
compact: [-]/ˈkɑːmpækt/; [a]小巧的,小型的,袖珍的,体积小的;紧密的,紧凑的,密集的; [v]把..压紧;变得坚实; [n]带镜小粉盒;合约,条约; [^]yshx;
compare: [-]/kəmˈper/; [v]比较,比作; [n]比较;对照; [^]yshx;
compass: [-]/ˈkʌmpəs/; [n]罗盘,指南针;圆规; [v]达到;围绕;图谋; [^]yshx;
compatible: [-]/kəmˈpætəbl/; [a]可和谐共存的;兼容的; [^]yshx;
compel: [-]/kəmˈpel/; [v]强迫;迫使屈服;(使)不得已; [^]yshx;
compensate: [-]/ˈkɑːmpenseɪt/; [v]补偿,赔偿,给..报酬; [^]yshx;
competition: [-]/ˌkɑːmpəˈtɪʃn/; [n]比赛;竞争;竞争者; [^]yshx;
compile: [-]/kəmˈpaɪl/; [v]收集,汇编; [^]yshx;
complement: [-]/ˈkɑːmplɪment/; [v]补充;与.相配; [n]补充;互为补充的东西;补语; [^]yshx;
complex: [-]/ˈkɑːmpleks/; [a]复杂的,难解的;复合的; [n]情结;建筑群;综合体,集合体; [^]yshx;
compliance: [-]/kəmˈplaɪəns/; [n]遵守,依从;承诺,答应; [^]yshx;
complicated: [-]/ˈkɑːmplɪkeɪtɪd/; [a]复杂的;难解的; [v]使复杂; [^]yshx;
compliment: [-]/ˈkɑːmplɪmənt/; [n]恭维,问候; [v]赞美,祝贺; [^]yshx;
component: [-]/kəmˈpoʊnənt/; [n]零件; [a]组成的; [^]yshx;
compose: [-]/kəmˈpoʊz/; [v]创作,作曲,形成,构成; [^]yshx;
composite: [-]/kəmˈpɑːzət/; [a]合成的,复合的; [n]合成物,复合材料; [v]使合成,使混合; [^]yshx;
compound: [-]/ˈkɑːmpaʊnd/; [n]复合物;<化学>化合物; [a]合成的;复合的;多功能的; [vi]妥协;和解; [vt]混合;调和;调停;使恶化; [^]yshx;
compress: [-]/kəmˈpres/; [v]压紧,压缩,压榨; [^]yshx;
comprise: [-]/kəmˈpraɪz/; [v]包含,包括;构成; [^]yshx;
compromise: [-]/ˈkɑːmprəmaɪz/; [n]妥协;折中; [v]妥协;使遭受危害; [^]yshx;
compulsory: [-]/kəmˈpʌlsəri/; [a]强制的,必修的; [^]yshx;
compute: [-]/kəmˈpjuːt/; [v]计算,估计; [^]yshx;
conceal: [-]/kənˈsiːl/; [v]隐藏,隐瞒,掩盖; [^]yshx;
concede: [-]/kənˈsiːd/; [v]承认;承认失败;让给,让与;让步; [^]yshx;
conceive: [-]/kənˈsiːv/; [v]怀孕;设想,想出; [^]yshx;
concentrate: [-]/ˈkɑːnsntreɪt/; [v]全神贯注于,集中于;浓缩; [n]浓缩物; [^]yshx;
concern: [-]/kənˈsɜːrn/; [n]关心,担忧; [v]感兴趣,涉及,关心,(使)担忧; [^]yshx;
concerted: [-]/kənˈsɜːrtɪd/; [a]一致的,商定的; [^]yshx;
concise: [-]/kənˈsaɪs/; [a]简明的,简要的;简洁的,简要的; [^]yshx;
concoct: [-]/kənˈkɑːkt/; [v]调合;编造(故事等); [^]yshx;
concrete: [-]/ˈkɑːŋkriːt/; [n]混凝土; [a]具体的,实质性的; [v]给 (道路等) 浇混凝土; [^]yshx;
condemn: [-]/kənˈdem/; [v]谴责,责备;判(某人某罪); [^]yshx;
condense: [-]/kənˈdens/; [v]压缩;精炼;冷凝; [^]yshx;
condolence: [-]/kənˈdoʊləns/; [n]吊唁;哀悼; [^]yshx;
conducive: [-]/kənˈduːsɪv/; [a]有益的,有助于.的; [^]yshx;
confer: [-]/kənˈfɜːr/; [v]授予(奖项,学位,荣誉或权利);商讨,协商; [^]yshx;
confident: [-]/ˈkɑːnfɪdənt/; [a]自信的;确信的,深信的; [^]yshx;
configuration: [-]/kənˌfɪɡjəˈreɪʃn/; [n]配置,布局,构造; [^]yshx;
confine: [-]/kənˈfaɪn/; [v]限制;监禁; [n]范围,界限,约束,限制; [^]yshx;
confirm: [-]/kənˈfɜːrm/; [v]确认;证实;批准; [^]yshx;
conflict: [-]/ˈkɑːnflɪkt/; [n]冲突,(意见)分歧,战斗,斗争; [v]冲突,抵触,争执; [^]yshx;
conform: [-]/kənˈfɔːrm/; [vi]一致;遵照,顺从;符合; [vt]使一致;使遵照; [a]一致的; [^]yshx;
confront: [-]/kənˈfrʌnt/; [v]与某人对峙;与..对抗;正视; [^]yshx;
confuse: [-]/kənˈfjuːz/; [v]混淆;使混乱,使迷糊; [^]yshx;
congestion: [-]/kənˈdʒestʃən/; [n]拥挤,充血; [^]yshx;
congress: [-]/ˈkɑːŋɡrəs/; [n]国会(美);代表大会;议会;立法机关; [^]yshx;
conjunction: [-]/kənˈdʒʌŋkʃn/; [n]连接;联合,结合;连接词; [^]yshx;
conquer: [-]/ˈkɑːŋkər/; [v]征服,攻克;破除; [^]yshx;
conscience: [-]/ˈkɑːnʃəns/; [n]良心,良知; [^]yshx;
conscious: [-]/ˈkɑːnʃəs/; [a]神志清醒的;自觉的;意识到的;有意的; [n]意识; [^]yshx;
consecutive: [-]/kənˈsekjətɪv/; [a]连续的,连贯的; [^]yshx;
consent: [-]/kənˈsent/; [n]同意,准许;赞成; [v]同意; [^]yshx;
consequent: [-]/ˈkɑːnsəkwənt/; [a]作为结果(或后果)的,随之发生的; [n]结果,随后的事; [^]yshx;
conservative: [-]/kənˈsɜːrvətɪv/; [a]保守的;保守估计的;保守党的; [n]保守主义者;保守党党员; [^]yshx;
conserve: [-]/kənˈsɜːrv/; [v]保藏,保存;节约; [n]蜜饯,果酱; [^]yshx;
considerable: [-]/kənˈsɪdərəbl/; [a]相当大的;重要的;可观的; [^]yshx;
consign: [-]/kənˈsaɪn/; [v]托运,托卖,寄存; [^]yshx;
consist of: [-]/kənˈsɪst ɑv/; [phr]由..组成; [^]yshx;
consist: [-]/kənˈsɪst/; [v]由..组成;在于; [^]yshx;
console: [-]/kənˈsoʊl/; [v]安慰,慰问; [n]控制台,仪表板;落地柜; [^]yshx;
consolidate: [-]/kənˈsɑːlɪdeɪt/; [v]巩固,加强;把.合为一体; [^]yshx;
conspicuous: [-]/kənˈspɪkjuəs/; [a]显眼的;显著的;显而易见的; [^]yshx;
conspiracy: [-]/kənˈspɪrəsi/; [n]密谋,阴谋; [^]yshx;
constant: [-]/ˈkɑːnstənt/; [a]不变的,始终如一的;持续不断的; [n]常数,恒量; [^]yshx;
constituent: [-]/kənˈstɪtʃuənt/; [a]组成的;有选举权的; [n]选民;成分; [^]yshx;
constrain: [-]/kənˈstreɪn/; [v]约束;限制;强迫; [^]yshx;
constrict: [-]/kənˈstrɪkt/; [v]约束,收缩,妨碍; [^]yshx;
consult: [-]/kənˈsʌlt/; [v]请教,咨询;查阅;商量; [^]yshx;
consumption: [-]/kənˈsʌmpʃn/; [n]消耗,消费,耗尽;肺痨; [^]yshx;
contact: [-]/ˈkɑːntækt/; [v]接触;联系; [n]接触;联系; [a]保持接触的;由接触引起的;<航>可看见地面景物的; [ad]<航>以目力观察(飞行); [int]开动; [^]yshx;
contaminate: [-]/kənˈtæmɪneɪt/; [v]弄脏,污染; [^]yshx;
contemplate: [-]/ˈkɑːntəmpleɪt/; [v]沉思;对..周密考虑;注视; [^]yshx;
contemporary: [-]/kənˈtempəreri/; [a]同时代的;当代的,现代的; [n]同龄人,同时代的人; [^]yshx;
contempt: [-]/kənˈtempt/; [n]轻视,鄙视; [^]yshx;
contend: [-]/kənˈtend/; [v]争辩;坚决主张;搏斗; [^]yshx;
content: [-]/ˈkɑːntent/; [n]内容,目录;满足; [a]满足的; [v]使满意; [^]yshx;
contest: [-]/ˈkɑːntest/; [n]比赛,竞争; [v]争夺,争论; [^]yshx;
context: [-]/ˈkɑːntekst/; [n]上下文,语境;背景; [^]yshx;
continuity: [-]/ˌkɑːntəˈnuːəti/; [n]连续性;(电影或电视节目中)镜头的连接,衔接; [^]yshx;
contract: [-]/ˈkɑːntrækt/; [n]合同,契约; [v]感染(疾病);招致;订合同;订立(婚约);缩减; [^]yshx;
contradict: [-]/ˌkɑːntrəˈdɪkt/; [v]与..发生矛盾,与..抵触,与..对立; [^]yshx;
contrast: [-]/ˈkɑːntræst/; [n]差异,对照,对比;对照;对比; [v](with)使与..对比; [^]yshx;
contribute: [-]/kənˈtrɪbjuːt/; [v]增进,起促成作用;捐献,捐助;..的原因之一;投稿; [^]yshx;
contrive: [-]/kənˈtraɪv/; [v]发明;设计出;设法做到;谋划;策划; [^]yshx;
controversial: [-]/ˌkɑːntrəˈvɜːrʃl/; [a]引起争论的,有争议的; [^]yshx;
convene: [-]/kənˈviːn/; [v]集合,召集,召唤; [^]yshx;
convenience: [-]/kənˈviːniəns/; [n]方便;便利设施; [^]yshx;
convention: [-]/kənˈvenʃn/; [n]会议;习俗;惯例; [^]yshx;
converge: [-]/kənˈvɜːrdʒ/; [v](向某一点)相交,会合;汇集,聚集,集中; [^]yshx;
conversely: [-]/kənˈvɜːrsli/; [ad]相反地,反过来; [^]yshx;
convert: [-]/kənˈvɜːrt/; [v]可转变为,可变换成;改变,转变,转化;使改变信仰; [n]皈依者;改变宗教信仰者; [^]yshx;
convey: [-]/kənˈveɪ/; [v]传送,运送;表达,传达; [^]yshx;
convict: [-]/ˈkɑːnvɪkt/; [n]犯人; [v](经审讯)证明..有罪,使..知罪; [^]yshx;
convince: [-]/kənˈvɪns/; [v]使确信;使信服; [^]yshx;
cooperate: [-]/koʊˈɑːpəreɪt/; [v]协作,合作; [^]yshx;
coordinate: [-]/koʊˈɔːrdɪneɪt/; [v]使协调,使一致,调整; [n]坐标,同等的人物,配套服装; [a]并列的;同等的; [^]yshx;
cordial: [-]/ˈkɔːrdʒəl/; [a]热情友好的,衷心的; [^]yshx;
cork: [-]/kɔːrk/; [n]软木; [v]塞住,抑制; [^]yshx;
corporate: [-]/ˈkɔːrpərət/; [a]公司的;全体的;共同的;(法人)团体的; [^]yshx;
corps: [-]/kɔːr/; [n](由两个或以上师组成的)军,兵团;一群人;特别小组; [^]yshx;
corpse: [-]/kɔːrps/; [n]尸体,被废弃的东西; [^]yshx;
correspond: [-]/ˌkɔːrəˈspɑːnd/; [v]符合;相符,一致;通信; [^]yshx;
corrode: [-]/kəˈroʊd/; [v]受腐蚀;腐蚀,侵蚀; [^]yshx;
corrupt: [-]/kəˈrʌpt/; [v]变腐败,堕落;贿赂,使腐败; [a]腐败的;堕落的; [^]yshx;
cosmic: [-]/ˈkɑːzmɪk/; [a]宇宙的;广大无边的; [^]yshx;
cosmopolitan: [-]/ˌkɑːzməˈpɑːlɪtən/; [n]游历四方的人; [a]见多识广的;多元的;广泛分布的; [^]yshx;
costume: [-]/ˈkɑːstuːm/; [n]服装,剧装; [vt]提供服装;为 ... 设计服装; [a]服装打扮的; [^]yshx;
couch: [-]/kaʊtʃ/; [n]长沙发;长椅;长榻; [v]表达; [^]yshx;
council: [-]/ˈkaʊnsl/; [n]议会;理事会;委员会; [^]yshx;
counsel: [-]/ˈkaʊnsl/; [n]忠告;律师,法律顾问; [v]劝告,提议; [^]yshx;
counter: [-]/ˈkaʊntər/; [n]柜台;回击,反击; [v]抵消,抗衡; [ad]相反地; [^]yshx;
counterbalance: [-]/ˌkaʊntərˈbæləns/; [n]平衡力;抵销; [v]使平衡;抵消; [^]yshx;
counterfeit: [-]/ˈkaʊntərfɪt/; [n]仿制品,伪造物; [a]仿造的.假冒的; [v]伪造,仿造; [^]yshx;
counterpart: [-]/ˈkaʊntərpɑːrt/; [n]对应的人(物);副本;对手; [^]yshx;
coupon: [-]/ˈkuːpɑːn/; [n](债券等)息券;赠券;配给券;折扣券; [^]yshx;
courier: [-]/ˈkʊriər/; [n]快递员,通讯员,导游; [^]yshx;
courtesy: [-]/ˈkɜːrtəsi/; [n]礼貌; [^]yshx;
coverage: [-]/ˈkʌvərɪdʒ/; [n]新闻报道;可达范围;覆盖范围; [^]yshx;
coward: [-]/ˈkaʊərd/; [n]懦夫,胆小鬼; [a]懦弱的,胆怯的; [^]yshx;
cozy: [-]/ˈkoʊzi/; [a]温暖舒适的,安逸的; [v]取悦; [^]yshx;
crack: [-]/kræk/; [v]敲出裂痕,敲破;垮掉;断裂,折断;说(笑话); [n]裂缝;破裂声;挖苦话;强效纯可卡因; [a]最好的,一流的; [ad]尖锐地; [vi]断裂,折断; [^]yshx;
cradle: [-]/ˈkreɪdl/; [n]摇篮;策源地,发源地; [v]轻轻地抱,捧; [^]yshx;
craft: [-]/kræft/; [n]手工艺,手工制品,船,航天器; [v]手工制作,精心制作; [^]yshx;
crash: [-]/kræʃ/; [n]碰撞,坠落,轰隆声; [v]碰撞,坠落,崩溃; [a]紧急的; [^]yshx;
crater: [-]/ˈkreɪtər/; [n]火山口;弹坑; [v]在.上形成坑;毁坏; [^]yshx;
crawl: [-]/krɔːl/; [v]爬,爬行;缓慢行进; [n]缓慢行进;自由式游泳; [^]yshx;
creation: [-]/kriˈeɪʃn/; [n]创造,创作;创造物,作品; [^]yshx;
credit: [-]/ˈkredɪt/; [n]信用;荣誉;学分;信贷;称赞;债权; [v]信赖;归因于;记学分; [^]yshx;
creep: [-]/kriːp/; [vi]爬行;潜入;蔓延;变形;毛发直竖; [n]卑鄙小人;爬行;变形;毛骨悚然的感觉; [^]yshx;
crevice: [-]/ˈkrevɪs/; [n]缺口,裂缝; [^]yshx;
cricket: [-]/ˈkrɪkɪt/; [n]板球,板球运动;蟋蟀; [^]yshx;
criminal: [-]/ˈkrɪmɪnl/; [n]罪犯; [a]犯罪的,违法的,刑法的;可耻的; [^]yshx;
cripple: [-]/ˈkrɪpl/; [n]跛子,伤残人(或动物); [v]使跛;使受伤致残;严重削弱; [^]yshx;
crisis: [-]/ˈkraɪsɪs/; [n]危机;存亡之际; [^]yshx;
crisp: [-]/krɪsp/; [a]脆的,易碎的,霜冻的,干脆的; [n]油炸马铃薯片; [v](使)发脆; [^]yshx;
criterion: [-]/kraɪˈtɪriən/; [n]标准,准则; [^]yshx;
critical: [-]/ˈkrɪtɪkl/; [a]批评的;文艺评论的;爱挑剔的;危急的;关键的,重要的; [^]yshx;
crooked: [-]/ˈkrʊkɪd/; [a]弯曲的;歪的;不正当的;不正直的; [^]yshx;
crouch: [-]/kraʊtʃ/; [v]蹲;弯腰; [^]yshx;
crown: [-]/kraʊn/; [n]王冠,冕;王权;花冠; [v]加冕; [^]yshx;
crucial: [-]/ˈkruːʃl/; [a]关键的;决定性的; [^]yshx;
crude: [-]/kruːd/; [a]天然的;粗糙的;粗鲁的;简陋的; [n]原油; [^]yshx;
cruise: [-]/kruːz/; [n]巡航;漫游;旅行; [v]航游;巡航;(出租车,船等)缓慢巡行; [^]yshx;
crumble: [-]/ˈkrʌmbl/; [v]弄碎;使破碎;崩溃;破灭; [n]碎屑;面包屑; [^]yshx;
crumple: [-]/ˈkrʌmpl/; [v]把.揉作一团,弄皱;压碎; [^]yshx;
crush: [-]/krʌʃ/; [vt]压坏;压扁;弄皱;弄碎,压碎;榨出;紧抱;挤入;镇压;欺压; [n]压扁;极度拥挤; [vi]被压坏;被揉皱;蜂拥而来; [^]yshx;
crust: [-]/krʌst/; [n]外壳,面包皮,硬外皮; [^]yshx;
crystal: [-]/ˈkrɪstl/; [n]水晶,晶体;结晶;水晶做成的东西; [^]yshx;
cube: [-]/kjuːb/; [n]立方体,立方; [^]yshx;
cucumber: [-]/ˈkjuːkʌmbər/; [n]黄瓜; [^]yshx;
cue: [-]/kjuː/; [n]提示;暗号;球杆; [v]给.提示; [^]yshx;
culminate: [-]/ˈkʌlmɪneɪt/; [v]使达高潮,使结束; [^]yshx;
cultivate: [-]/ˈkʌltɪveɪt/; [v]耕作,养植,栽培;培养,陶冶,发展; [^]yshx;
cumbersome: [-]/ˈkʌmbərsəm/; [a]笨重的;麻烦的; [^]yshx;
cumulative: [-]/ˈkjuːmjəleɪtɪv/; [a]渐增的;累积的; [^]yshx;
cunning: [-]/ˈkʌnɪŋ/; [n]狡猾,精巧; [a]狡猾的,精巧的; [^]yshx;
cupboard: [-]/ˈkʌbərd/; [n]碗橱,衣柜,壁橱; [^]yshx;
curb: [-]/kɜːrb/; [v]勒住;抑制;控制;约束; [n]路缘;控制;约束; [^]yshx;
cure: [-]/kjʊr/; [n]对策,措施;治疗,医治; [v]治愈,治疗; [^]yshx;
curl: [-]/kɜːrl/; [n]卷毛,卷发; [v]使卷曲; [^]yshx;
currency: [-]/ˈkɜːrənsi/; [n]货币;流通;流行; [^]yshx;
curriculum vitae: [-]/kəˌrɪkjələm ˈviːtaɪ/; [phr]简短的履历书; [^]yshx;
curriculum: [-]/kəˈrɪkjələm/; [n]课程,(学校或专业的)全部课程; [^]yshx;
curse: [-]/kɜːrs/; [n]诅咒;咒骂;祸因; [v]诅咒;咒骂;使受罪; [^]yshx;
curtail: [-]/kɜːrˈteɪl/; [vt]截短;削减;剥夺.特权; [^]yshx;
curve: [-]/kɜːrv/; [v]使弯曲; [n]曲线,弯曲; [a]弯曲的;曲线形的; [^]yshx;
cushion: [-]/ˈkʊʃn/; [n]坐垫; [v]减轻,缓和; [^]yshx;
custodian: [-]/kʌˈstoʊdiən/; [n]监护人,保管人,看守人; [^]yshx;
custom: [-]/ˈkʌstəm/; [n]习惯;风俗; [a]定制的; [^]yshx;
cut across: [-]/kʌt əˈkrɔs/; [v]抄近路通过; quant. 与...相抵触;与...相反; [^]yshx;
cut sth. (sb.) down: [-]/kʌt ˈsʌmθɪŋ ˈsʌmbədi daʊn/; [phr]砍倒;削减;说服某人降价; [^]yshx;
cute: [-]/kjuːt/; [a]可爱的;讨人喜爱的;聪明的; [^]yshx;
cylinder: [-]/ˈsɪlɪndər/; [n]圆柱体,圆筒;汽缸,泵(或桶)体; [^]yshx;
cynical: [-]/ˈsɪnɪkl/; [a]愤世嫉俗的;恶意的;悲观的; [^]yshx;
dairy: [-]/ˈderi/; [n]牛奶场;乳制品; [a]牛奶的,奶制的; [^]yshx;
dam: [-]/dæm/; [n]水坝;母兽; [v]用水坝阻止;阻塞,抑制; [^]yshx;
damp: [-]/dæmp/; [a]潮湿的,有湿气的; [^]yshx;
dart: [-]/dɑːrt/; [n]飞镖;猛冲;标枪; [v]快速投掷;突然移动; [^]yshx;
dash: [-]/dæʃ/; [vi]猛冲,突进; [v]猛掷; [n]破折号;猛冲; [^]yshx;
dawn: [-]/dɔːn/; [n]黎明;开始; [v]破晓; [^]yshx;
day in and day out: [-]/deɪ ɪn ənd deɪ aʊt/; [ad]天天,一天又一天; [^]yshx;
dazzle: [-]/ˈdæzl/; [n]光辉;令人赞叹的东西; [v]使眼花;使赞叹不已; [^]yshx;
deadlock: [-]/ˈdedlɑːk/; [vt](使)相持不下; [vi]僵持; [n]僵局;不分胜负; [^]yshx;
deadly: [-]/ˈdedli/; [a]致命的,致死的,十足的; [ad]死一般地;非常; [^]yshx;
deaf: [-]/def/; [a]聋的;不愿听的; [n]聋子;耳聋的人; [^]yshx;
dean: [-]/diːn/; [n](大学的)学院院长;系主任;资格最老者,泰斗;牧师; [^]yshx;
debris: [-]/dəˈbriː/; [n]废墟,残骸; [^]yshx;
decade: [-]/ˈdekeɪd/; [n]十年,十年间; [^]yshx;
decay: [-]/dɪˈkeɪ/; [v]腐烂;衰退;腐朽; [n]腐烂;衰退;腐败; [^]yshx;
deceive: [-]/dɪˈsiːv/; [v]欺骗,行骗; [^]yshx;
decent: [-]/ˈdiːsnt/; [a]体面的;像样的;合宜的;正直的; [^]yshx;
decimal: [-]/ˈdesɪml/; [n]小数; [a]小数的;十进制的; [^]yshx;
decipher: [-]/dɪˈsaɪfər/; [n]密电译文; [vt]解释;破译; [^]yshx;
deck: [-]/dek/; [n]甲板,公共汽车一层的车厢,纸牌; [v]装饰;击倒; [^]yshx;
declare: [-]/dɪˈkler/; [vt]表明;宣布;强调;申报(收益);申报(应纳税品); [vi]板球(在击球员还未全部出局时)宣布结束赛局; [^]yshx;
decline: [-]/dɪˈklaɪn/; [n]下降;衰退; [v]<语>使发生词尾变化,使变格;下降;拒绝; [^]yshx;
decompose: [-]/ˌdiːkəmˈpoʊz/; [v](使)腐烂;分解; [^]yshx;
decorate: [-]/ˈdekəreɪt/; [v]装饰,布置;把(勋章)授给(某人); [^]yshx;
decrease: [-]/dɪˈkriːs/; [v]减少;减; [n]减;减少; [^]yshx;
decree: [-]/dɪˈkriː/; [v]命令,判决,颁布; [n]法令,政令; [^]yshx;
decrepit: [-]/dɪˈkrepɪt/; [a]衰老的,破旧的; [^]yshx;
dedicate: [-]/ˈdedɪkeɪt/; [v]献给,致力于; [^]yshx;
deduce: [-]/dɪˈduːs/; [v]演绎;推论,推断; [^]yshx;
deduct: [-]/dɪˈdʌkt/; [v]减去; [^]yshx;
deem: [-]/diːm/; [v]认为,视为;知道,相信; [^]yshx;
default: [-]/dɪˈfɔːlt/; [n]违约;缺席;缺乏;默认; [vi]不履行义务;拖欠; [vt]不履行;不参加; [^]yshx;
defeat: [-]/dɪˈfiːt/; [n]挫败;击败,战胜; [v]打败;战胜; [^]yshx;
defect: [-]/ˈdiːfekt/; [n]缺陷,缺点,不足之处; [v]背叛,逃跑,开小差; [^]yshx;
defense: [-]/dɪ'fens/; [n]防御,防护; [^]yshx;
defer: [-]/dɪˈfɜːr/; [v]使推迟,使延期;听从,顺从; [vi]延期; [^]yshx;
defiance: [-]/dɪˈfaɪəns/; [n]蔑视;反抗;挑战; [^]yshx;
deficiency: [-]/dɪˈfɪʃnsi/; [n]缺乏,不足;缺陷; [^]yshx;
deficit: [-]/ˈdefɪsɪt/; [n]亏损;赤字;不足额; [^]yshx;
defile: [-]/dɪˈfaɪl/; [v]污损,弄脏;以纵队前进; [n]狭谷;隘路; [^]yshx;
definitive: [-]/dɪˈfɪnətɪv/; [a]可靠的,明确的,权威的;决定性的; [^]yshx;
deflect: [-]/dɪˈflekt/; [v](使)偏斜,(使)偏转; [^]yshx;
defraud: [-]/dɪˈfrɔːd/; [v]欺诈,诈取,骗取; [^]yshx;
deft: [-]/deft/; [a]灵巧的,敏捷的,熟练的; [^]yshx;
degenerate: [-]/dɪˈdʒenəreɪt/; [v]堕落,衰减; [a]腐化的,颓废的,退化的;变质的; [n]堕落者; [^]yshx;
degrade: [-]/dɪˈɡreɪd/; [v]贬低;降低品格(身价,价值等);分解;降低; [^]yshx;
delectable: [-]/dɪˈlektəbl/; [a]令人愉快的;美味的; [^]yshx;
delegate: [-]/ˈdelɪɡət/; [n]代表; [v]委派..为代表,授权; [^]yshx;
delete: [-]/dɪˈliːt/; [v]删除; [^]yshx;
deliberate: [-]/dɪˈlɪbərət/; [a]故意的;深思熟虑的;从容不迫的; [v]仔细考虑;研讨; [^]yshx;
delicate: [-]/ˈdelɪkət/; [a]易碎的,易坏的,脆弱的;(人)娇弱的,体弱多病的;精美的,精致的,精巧的;微妙的,需要谨慎处理的;优美的,优雅的;柔和的,清淡的,淡雅的; [^]yshx;
delinquency: [-]/dɪˈlɪŋkwənsi/; [n]失职,玩忽职守,拖欠债务,缺点,过错;<法律>少年犯罪,不法行为(青少年),行为不当; [^]yshx;
delirium: [-]/dɪˈlɪriəm/; [n]神志不清,极度兴奋; [^]yshx;
deliver: [-]/dɪˈlɪvər/; [v]递送,交付;履行;发表(演讲);分娩;投掷; [^]yshx;
deluge: [-]/ˈdeljuːdʒ/; [n]洪水;暴雨;泛滥; [v]使泛滥;压倒; [^]yshx;
democracy: [-]/dɪˈmɑːkrəsi/; [n]民主制度;民主国家;民主主义;民众; [^]yshx;
demolish: [-]/dɪˈmɑːlɪʃ/; [v]拆毁(建筑物等);毁坏,破坏(组织等);〈俚〉吃光; [^]yshx;
demonstrate: [-]/ˈdemənstreɪt/; [vt](用实例,实验)论证;演示,展示;示范; [vi]示威; [^]yshx;
denial: [-]/dɪˈnaɪəl/; [n]拒绝;否认;拒绝给予; [^]yshx;
denomination: [-]/dɪˌnɑːmɪˈneɪʃn/; [n]名称,名目;(货币的) 面额;单位;教派; [^]yshx;
denote: [-]/dɪˈnoʊt/; [v]是.的标志;指出; [vt]指示;代表(或表示); [^]yshx;
denounce: [-]/dɪˈnaʊns/; [v]谴责,斥责; [^]yshx;
dense: [-]/dens/; [a](物质) 密度大的;稠密的,浓密的;愚钝的;难懂的,费解的; [^]yshx;
dentist: [-]/ˈdentɪst/; [n]牙医; [^]yshx;
depart: [-]/dɪˈpɑːrt/; [v]离开;起程;出发;起程;出发;离职; [^]yshx;
depict: [-]/dɪˈpɪkt/; [v]描绘,描写; [^]yshx;
deplete: [-]/dɪˈpliːt/; [v]使大大减少;耗尽,用尽; [^]yshx;
deplore: [-]/dɪˈplɔːr/; [v]谴责;对...深感遗憾;悲悼;痛惜; [^]yshx;
deposit: [-]/dɪˈpɑːzɪt/; [v]存款,存放;沉淀; [n]存款,定金;沉积物,矿床; [^]yshx;
depress: [-]/dɪˈpres/; [vt]使沮丧;使萧条;压下,压低; [^]yshx;
deprive: [-]/dɪˈpraɪv/; [v]使丧失;剥夺;免去.的职务; [^]yshx;
deputy: [-]/ˈdepjuti/; [n]副手;代表;代表,代理人; [^]yshx;
derive: [-]/dɪˈraɪv/; [v]获取;得自;起源; [^]yshx;
descend: [-]/dɪˈsend/; [vi]走下;降临; [v]下降,下来;突然访问;下移,下降; [^]yshx;
description: [-]/dɪˈskrɪpʃn/; [n]描写,形容,叙述;种类,类型; [^]yshx;
desert: [-]/ˈdezərt/; [n]沙漠; [v]离开; [^]yshx;
deserve: [-]/dɪˈzɜːrv/; [v]值得,应得;应受; [^]yshx;
designate: [-]/ˈdezɪɡneɪt/; [a]已受委派而尚未上任的; [v]标出,说出;委任,任命,提名;指定; [^]yshx;
desirable: [-]/dɪˈzaɪərəbl/; [a]有吸引力的;性感的;令人向往的;令人满意的; [^]yshx;
desolate: [-]/ˈdesələt/; [a]荒凉的;孤单寂寞的; [^]yshx;
despair: [-]/dɪˈsper/; [n]绝望,失望; [v]失望; [^]yshx;
despatch: [-]/dɪˈspætʃ/; [v]发送;派遣;打败; [n](公文)急件;(记者发回的)新闻报道;派遣; [^]yshx;
desperate: [-]/ˈdespərət/; [a]绝望的;孤注一掷的;极需要的,渴望的;(情况) 极严重的;极危险的;很危急的; [^]yshx;
destination: [-]/ˌdestɪˈneɪʃn/; [n]目的地,终点; [a]目的地的; [^]yshx;
destructive: [-]/dɪˈstrʌktɪv/; [a]破坏(性)的,毁灭(性)的; [^]yshx;
detach: [-]/dɪˈtætʃ/; [v]使分开,拆卸;派遣; [^]yshx;
detain: [-]/dɪˈteɪn/; [v]拘留,使延迟; [^]yshx;
detect: [-]/dɪˈtekt/; [v]发现,发觉;侦察,探测; [^]yshx;
deter: [-]/dɪˈtɜːr/; [v]防止,阻止,使踌躇; [^]yshx;
detergent: [-]/dɪˈtɜːrdʒənt/; [n]洗涤剂,清洁剂; [^]yshx;
deteriorate: [-]/dɪˈtɪriəreɪt/; [v]恶化;变质;衰退; [^]yshx;
determination: [-]/dɪˌtɜːrmɪˈneɪʃn/; [n]决定;确定;决心; [^]yshx;
detest: [-]/dɪˈtest/; [vt]厌恶,憎恨,痛恨; [^]yshx;
detrimental: [-]/ˌdetrɪˈmentl/; [a]有害的,不利的; [^]yshx;
devastate: [-]/ˈdevəsteɪt/; [v]摧毁;使垮掉,使不知所措,使陷于混乱; [^]yshx;
deviate: [-]/ˈdiːvieɪt/; [v]偏离;背离; [a]脱离常轨的; [n]脱离常轨的人; [^]yshx;
devise: [-]/dɪˈvaɪz/; [v]设计,想出;密谋;遗赠(不动产); [n]设计,发明,遗赠; [^]yshx;
devote: [-]/dɪˈvoʊt/; [vt]奉献;献身于,专心致力于; [^]yshx;
devour: [-]/dɪˈvaʊər/; [v]狼吞虎咽;毁灭;贪婪地看,贪婪地阅读; [^]yshx;
diagnose: [-]/ˌdaɪəɡˈnoʊs/; [v]诊断(疾病),对(病人)下诊断结论; [^]yshx;
diagram: [-]/ˈdaɪəɡræm/; [n]图解,图表; [^]yshx;
dial: [-]/ˈdaɪəl/; [v]拨(电话号码);打电话; [n]钟面;仪表盘;拨号盘; [^]yshx;
dialect: [-]/ˈdaɪəlekt/; [n]方言;语调; [a]方言的; [^]yshx;
diameter: [-]/daɪˈæmɪtər/; [n]直径; [^]yshx;
dictate: [-]/ˈdɪkteɪt/; [v]规定;命令;口授;听写; [n]命令;指令; [^]yshx;
diet: [-]/ˈdaɪət/; [n]日常饮食;(病人或减肥者的)特种饮食;大量; [v]节食; [^]yshx;
differentiate: [-]/ˌdɪfəˈrenʃieɪt/; [v]使有差异;区别; [^]yshx;
diffuse: [-]/dɪˈfjuːz/; [v]传播;扩散,弥漫;漫射; [a]四散的,散开的;不清楚的; [^]yshx;
digest: [-]/daɪˈdʒest/; [v]消化;领会,理解; [n]摘要; [^]yshx;
digital: [-]/ˈdɪdʒɪtl/; [a]数字显示的;数字的,数码的; [n]键;数字仪表,时钟; [^]yshx;
dignity: [-]/ˈdɪɡnəti/; [n]威严,威风;端庄;尊严,高贵; [^]yshx;
dilapidated: [-]/dɪˈlæpɪdeɪtɪd/; [a]破旧的,破烂的;倾坍的; [^]yshx;
dilemma: [-]/dɪˈlemə/; [n]进退两难的窘境; [^]yshx;
diligent: [-]/ˈdɪlɪdʒənt/; [a]勤奋的;用功的; [^]yshx;
dilute: [-]/daɪˈluːt/; [v]使变淡,稀释;使病弱; [^]yshx;
dim: [-]/dɪm/; [a]暗淡的;模糊的;朦胧的; [v]变暗淡; [^]yshx;
dimension: [-]/dɪˈmenʃn/; [n]维度;尺寸;尺度;方面; [^]yshx;
diminish: [-]/dɪˈmɪnɪʃ/; [v]减少;失势,削弱.的权势, 减弱.的权势; [^]yshx;
din: [-]/dɪn/; [n]喧闹声,嘈杂声; [v]喧闹,喋喋不休地说; [^]yshx;
dine: [-]/daɪn/; [v]吃饭,用餐;招待..吃饭;用正餐(晚餐); [^]yshx;
dingy: [-]/ˈdɪndʒi/; [a]昏暗的,肮脏的;褴褛的; [n]同"dingey"; [^]yshx;
dip: [-]/dɪp/; [v]浸,蘸; [n]倾斜,下降;调味汁; [^]yshx;
diploma: [-]/dɪˈploʊmə/; [n]毕业文凭,毕业证书;文凭课程; [^]yshx;
diplomatic: [-]/ˌdɪpləˈmætɪk/; [a]外交的,从事外交的;老练的,圆滑的; [^]yshx;
directory: [-]/dəˈrektəri/; [n]人名地址录,(电话)号码簿;目录; [^]yshx;
disarray: [-]/ˌdɪsəˈreɪ/; [n]混乱,漫无秩序; [^]yshx;
disc: [-]/dɪsk/; [n]唱片;<计> 磁盘,磁碟片;椎间盘;圆盘,盘状物; [^]yshx;
discard: [-]/dɪsˈkɑːrd/; [v]丢弃;抛弃;遗弃; [^]yshx;
discern: [-]/dɪˈsɜːrn/; [v]辨别;识别;看出; [^]yshx;
discharge: [-]/dɪsˈtʃɑːrdʒ/; [n]发射;释放;解雇;放电; [v]卸掉负担;发射;放电;卸(货);使爆炸;履行;解雇;允许.离开;排出,放出;清偿(债务); [^]yshx;
discipline: [-]/ˈdɪsəplɪn/; [n]纪律;学科;训练; [v]训练;惩罚;管制; [^]yshx;
disclose: [-]/dɪsˈkloʊz/; [v]公开,揭露,泄露; [^]yshx;
discord: [-]/ˈdɪskɔːrd/; [n]不和,争吵;(声音)不和谐; [^]yshx;
discount: [-]/ˈdɪskaʊnt/; [n](价格,债款等)折扣; [v]打折扣,不全信,怀疑地看待; [^]yshx;
discreet: [-]/dɪˈskriːt/; [a]谨慎的;思虑周全的,小心的; [^]yshx;
discrepancy: [-]/dɪsˈkrepənsi/; [n]不一致,差异,不符; [^]yshx;
discrete: [-]/dɪˈskriːt/; [a]分开的;不连续的; [^]yshx;
discriminate: [-]/dɪˈskrɪmɪneɪt/; [v]区别,辨别;歧视; [^]yshx;
disdain: [-]/dɪsˈdeɪn/; [n]蔑视,鄙视; [vt]鄙视;不屑; [^]yshx;
disguise: [-]/dɪsˈɡaɪz/; [v]伪装;掩饰; [n]伪装物;伪装; [^]yshx;
disgust: [-]/dɪsˈɡʌst/; [v]使作呕,使厌恶; [n]恶心; [^]yshx;
dismay: [-]/dɪsˈmeɪ/; [n]失望;沮丧;惊愕; [v]使惊恐; [^]yshx;
dismiss: [-]/dɪsˈmɪs/; [v]开除;解散;摒除,不再考虑; [^]yshx;
disorder: [-]/dɪsˈɔːrdər/; [n]混乱;紊乱;动乱; [vt]使混乱;使紊乱; [^]yshx;
dispatch: [-]/dɪˈspætʃ/; [v]派遣,调遣;发送(信件,电报等);结束,摆脱掉;匆匆办完; [vt]处决; [n]派遣,调遣;发送;快信,急件;迅速,敏捷; [^]yshx;
disperse: [-]/dɪˈspɜːrs/; [v]使散开;分散,散开; [^]yshx;
display: [-]/dɪˈspleɪ/; [v]展示;显示;陈列; [n]表现,流露,展示;显示,显示器;陈列品; [^]yshx;
dispose: [-]/dɪˈspoʊz/; [v]处理,处置,除去;使愿意; [^]yshx;
dispute: [-]/dɪˈspjuːt/; [n]争论,争端; [v]争执,驳斥; [^]yshx;
disregard: [-]/ˌdɪsrɪˈɡɑːrd/; [v]不理会;漠视; [n]忽视,漠视; [^]yshx;
disrupt: [-]/dɪsˈrʌpt/; [v]扰乱; [^]yshx;
dissertation: [-]/ˌdɪsərˈteɪʃn/; [n](博士学位)论文;学术演讲;专题; [^]yshx;
dissipate: [-]/ˈdɪsɪpeɪt/; [v]消散,消失;浪费; [^]yshx;
dissolve: [-]/dɪˈzɑːlv/; [v]使溶解;废除,使解散; [^]yshx;
distend: [-]/dɪˈstend/; [v]膨胀;胀大;扩张; [^]yshx;
distill: [-]/dɪˈstɪl/; [v]抽出..的精华;蒸馏; [^]yshx;
distinct: [-]/dɪˈstɪŋkt/; [a]截然不同的;独特的;明显的;清晰的; [^]yshx;
distinguish: [-]/dɪˈstɪŋɡwɪʃ/; [v]区别,识别,辨别,使显著; [^]yshx;
distort: [-]/dɪˈstɔːrt/; [v]扭曲,使变形;歪曲,曲解; [^]yshx;
distress: [-]/dɪˈstres/; [n]悲伤,疼痛;痛苦,焦虑;困难,困境; [a]受灾的;受灾造成的,焦虑的; [v]使痛苦,使焦急;因紧张而困恼;使困苦;迫使; [^]yshx;
distribute: [-]/dɪˈstrɪbjuːt/; [v]分发,分配,配送;散布; [^]yshx;
disturb: [-]/dɪˈstɜːrb/; [v]打扰,妨碍;弄乱;使烦恼; [^]yshx;
ditch: [-]/dɪtʃ/; [n]沟,沟渠; [v]迫降海上; [vt]丢弃;旷课; [^]yshx;
diverse: [-]/daɪˈvɜːrs/; [a]不同的,差异的,多种多样的; [^]yshx;
divert: [-]/daɪˈvɜːrt/; [v]使转向,使改道(或绕道);转移,转移.的注意力;使娱乐,使消遣; [^]yshx;
dividend: [-]/ˈdɪvɪdend/; [n](股份的)红利,回报,效益,被除数; [^]yshx;
divine: [-]/dɪˈvaɪn/; [a]神的,神圣的;极好的; [v](凭直觉)发现,猜到; [n]神学家;圣职人员;教士;上帝; [^]yshx;
dizzy: [-]/ˈdɪzi/; [a]眩晕的,头晕目眩的,头昏眼花的; [vt]使头晕目眩;使困惑; [^]yshx;
do away with: [-]/doʊ əˈweɪ wɪθ/; [phr]废除;消灭;去掉; [^]yshx;
do sb. a favour: [-]/duːˈsʌmbədi ə ˈfeɪvər/; [v]为某人帮个忙; [^]yshx;
do sth. with a bad grace: [-]/duː ˈsʌmθɪŋ wɪð ə bæd ɡreɪs/; [phr]勉强做某事; [^]yshx;
do with: [-]/duː wɪθ/; [phr]需要; [^]yshx;
dock: [-]/dɑːk/; [n]码头;船埠;被告席; [v](船)进港;扣工资;剪短(动物的尾巴); [^]yshx;
doctrine: [-]/ˈdɑːktrɪn/; [n]教条,学说,信条,原则; [^]yshx;
dodge: [-]/dɑːdʒ/; [n]托词;躲闪,躲避; [v]回避,规避;躲避,避开; [^]yshx;
domain: [-]/doʊˈmeɪn/; [n]域名;领土;管区,势力圈; [^]yshx;
dome: [-]/doʊm/; [n]圆屋顶,穹顶; [^]yshx;
domestic: [-]/dəˈmestɪk/; [a]国产的;国内的;家庭的;驯养的; [n]家仆;家庭纷争; [^]yshx;
dominate: [-]/ˈdɑːmɪneɪt/; [v]在.中占首要地位;支配,统治,控制;耸立于,俯视;处于支配地位,拥有优势; [^]yshx;
donate: [-]/ˈdoʊneɪt/; [v]捐献;捐赠; [vi]捐献;捐赠; [^]yshx;
doom: [-]/duːm/; [v]注定;命定; [n]毁灭;厄运;劫数; [^]yshx;
dormant: [-]/ˈdɔːrmənt/; [a]睡眠的,休眠的;静止的,隐伏的; [^]yshx;
dose: [-]/doʊs/; [n](药)剂量,用量,一剂; [vt]给..服药; [^]yshx;
dot: [-]/dɑːt/; [n]点,圆点; [v]点缀,作小点记号; [^]yshx;
doubtful: [-]/ˈdaʊtfl/; [a]怀疑的,疑惑的; [^]yshx;
downpour: [-]/ˈdaʊnpɔːr/; [n]倾盆大雨; [^]yshx;
downtown: [-]/ˈdaʊntaʊn/; [a]商业区的,闹市区的; [ad]在商业区,在市中心; [n]市中心区,市中心; [^]yshx;
draft: [-]/dræft/; [n]气流;通风,通风装置;草稿;汇票;征兵; [v]起草;征兵; [^]yshx;
drain: [-]/dreɪn/; [vi]排出,排水; [v]流干,沥干;喝光,耗尽,减少,消逝; [vt]使流出,排掉水; [n]下水道,排水管;消耗,排水; [^]yshx;
dramatic: [-]/drəˈmætɪk/; [a]戏剧的,戏剧性的;引人注目的;逼真的,刺激的; [^]yshx;
drastic: [-]/ˈdræstɪk/; [a]极端的;猛烈的;激烈的; [^]yshx;
drawback: [-]/ˈdrɔːbæk/; [n]缺点;障碍,不利条件; [^]yshx;
dread: [-]/dred/; [v]惧怕,害怕; [n]畏惧,恐惧; [a]恐怖的,使人敬畏的; [^]yshx;
dreary: [-]/ˈdrɪri/; [a]沉闷的;乏味的;凄凉的; [^]yshx;
drench: [-]/drentʃ/; [v]使淋透;使湿透; [n]淋透;雨淋;浸渍液;(制革时浸泡熟皮的)脱灰水; [^]yshx;
drift: [-]/drɪft/; [v]漂流;游荡;使漂流;使堆积; [n]漂流;漂流物;趋势;主旨;漂移; [^]yshx;
drill: [-]/drɪl/; [n]训练;反复操练;钻头; [v]在..上钻孔;钻孔; [^]yshx;
drought: [-]/draʊt/; [n]干旱,旱灾; [^]yshx;
drown: [-]/draʊn/; [v]淹死;淹没; [^]yshx;
drowse: [-]/draʊz/; [v]打瞌睡;发呆;昏昏沉沉地消磨(时光); [n]瞌睡; [^]yshx;
drudgery: [-]/ˈdrʌdʒəri/; [n]苦工;苦差事;单调乏味的工作; [^]yshx;
dual: [-]/ˈduːəl/; [a]双的;双重的; [^]yshx;
dub: [-]/dʌb/; [v]授予(称号);为(电影)配音;混录录制(音乐); [n](西印度群岛的)强节奏音乐; [^]yshx;
dubious: [-]/ˈduːbiəs/; [a]可疑的;怀疑的;无把握的; [^]yshx;
due: [-]/duː/; [ad]直接地,确切地; [a]拖欠的;到期的,预期的;应得的;由于;适当的; [n]会费;应有的权利,应得到的东西; [^]yshx;
dull: [-]/dʌl/; [a]愚笨的,迟钝的;枯燥的,沉闷的;不清晰的,吵闹的; [v]缓和;减轻;使阴暗; [^]yshx;
duly: [-]/ˈduːli/; [ad]适当地;按时地; [^]yshx;
dumb: [-]/dʌm/; [a]哑的,暂不说话的,愚笨的; [v]使沉默; [^]yshx;
dump: [-]/dʌmp/; [v]倾倒,丢弃;抛弃(某人); [n]垃圾场,废物堆;军需品临时堆放的地方; [^]yshx;
duplicate: [-]/ˈduːplɪkeɪt/; [n]复制品; [v]复制;重复; [a]完全一样的; [^]yshx;
durable: [-]/ˈdʊrəbl/; [a]耐用的,长久的; [n]耐用品; [^]yshx;
dwarf: [-]/dwɔːrf/; [n]侏儒; [v]变矮;发育不全; [a]矮生动物或植物的;矮小的;发育不全的; [vt]使矮小;阻碍.的发育; [^]yshx;
dwell: [-]/dwel/; [v](尤指作为常住居民)居住; [^]yshx;
dynamic: [-]/daɪˈnæmɪk/; [a]有活力的,有生气的;不断变化的;动态的; [n]活力,动力; [^]yshx;
earnest: [-]/ˈɜːrnɪst/; [a]真诚的,诚挚的,认真的; [n]认真,严肃; [^]yshx;
ease: [-]/iːz/; [n]安逸;容易;不拘束; [v]解除痛苦;缓解;顺利进出; [^]yshx;
eclipse: [-]/ɪˈklɪps/; [n](日,月)食;黯然失色; [v]掩盖..的重要性;使暗淡; [^]yshx;
ecology: [-]/iˈkɑːlədʒi/; [n]生态,生态学; [^]yshx;
economic: [-]/ˌekəˈnɑːmɪk/; [a]经济上的,经济学的;合算的;有利可图的; [^]yshx;
eddy: [-]/ˈedi/; [n]漩涡; [v]旋转;起漩涡; [^]yshx;
edible: [-]/ˈedəbl/; [a]可食的; [^]yshx;
edit: [-]/ˈedɪt/; [v]剪辑;编辑;校订; [n]编辑<校订>工作; [^]yshx;
edition: [-]/ɪˈdɪʃn/; [n]版,版本,版次; [^]yshx;
efficient: [-]/ɪˈfɪʃnt/; [a]效率高的;有能力的;能胜任的; [^]yshx;
ego: [-]/ˈiːɡoʊ/; [n]自我;自负;自尊心; [^]yshx;
eject: [-]/iˈdʒekt/; [v](使)弹出;喷射;放逐; [^]yshx;
eke: [-]/iːk/; [v](极小幅度地)增加;放长;(艰难地)取得; [^]yshx;
elaborate: [-]/ɪˈlæbəreɪt/; [a]精心设计的,精巧的;复杂的; [v]详细说明,详尽阐述; [vt]变得复杂; [^]yshx;
elastic: [-]/ɪˈlæstɪk/; [a]有弹性的;可伸缩的,(系统或计划)灵活的;弹力材料制成的; [n]松紧带,橡皮圈; [^]yshx;
elated: [-]/iˈleɪtɪd/; [a]得意洋洋的;振奋的; [^]yshx;
elbow: [-]/ˈelboʊ/; [n]手肘;衣服肘部; [v]用肘推,挤; [^]yshx;
elderly: [-]/ˈeldərli/; [a]年老的,年长的;上年纪的人; [^]yshx;
electrical: [-]/ɪˈlektrɪkl/; [a]有关电的;电气科学的; [^]yshx;
elegant: [-]/ˈelɪɡənt/; [a]优美的,文雅的,漂亮雅致的,陈设讲究的; [^]yshx;
elementary: [-]/ˌelɪˈmentri/; [a]基本的;初级的;非常简单的; [^]yshx;
elevate: [-]/ˈelɪveɪt/; [v]上升;提高;举起;提拔; [^]yshx;
elicit: [-]/iˈlɪsɪt/; [v]引出;诱出;探出; [^]yshx;
eligible: [-]/ˈelɪdʒəbl/; [a]适合被选的,符合条件的;(尤指婚姻等)合适的,合意的; [^]yshx;
eliminate: [-]/ɪˈlɪmɪneɪt/; [v]消灭,铲除;消除,根除;(在比赛中)淘汰; [^]yshx;
elite: [-]/ɪˈliːt/; [n]精英; [a]高级的; [^]yshx;
eloquent: [-]/ˈeləkwənt/; [a]有口才的;雄辩的;演说动人的; [^]yshx;
elsewhere: [-]/ˌelsˈwer/; [ad]在别处,向别处; [^]yshx;
embargo: [-]/ɪmˈbɑːrɡoʊ/; [v]禁止出入港口;禁止或限制贸易;征用或扣押; [n]禁令;禁止;封港令; [^]yshx;
embark: [-]/ɪmˈbɑːrk/; [v]上船或飞机;开始,着手,从事; [^]yshx;
embarrass: [-]/ɪmˈbærəs/; [vt]使窘迫,使尴尬(尤指在社交场合);困窘,困扰; [^]yshx;
embassy: [-]/ˈembəsi/; [n]大使馆;大使馆全体人员; [^]yshx;
embed: [-]/ɪmˈbed/; [v]把.嵌入;使嵌入; [^]yshx;
embody: [-]/ɪmˈbɑːdi/; [v]包含;体现,象征; [^]yshx;
embrace: [-]/ɪmˈbreɪs/; [v]拥抱;包含;欣然接受,乐意采纳; [n]拥抱;接受;领会; [^]yshx;
emerge: [-]/iˈmɜːrdʒ/; [v]冲出,冒出;浮现;出现; [^]yshx;
emergency: [-]/iˈmɜːrdʒənsi/; [n]紧急情况;突发事件; [^]yshx;
emigrate: [-]/ˈemɪɡreɪt/; [v]移居国外(或外地); [^]yshx;
eminent: [-]/ˈemɪnənt/; [a]显赫的;杰出的;有名的;(品质)优良的; [^]yshx;
emit: [-]/iˈmɪt/; [v]发表;散发;发射,发出; [^]yshx;
emotion: [-]/ɪˈmoʊʃn/; [n]感情;情绪;强烈的感情;激动; [^]yshx;
emphasize: [-]/ˈemfəsaɪz/; [v]强调;着重;使突出; [^]yshx;
employment: [-]/ɪmˈplɔɪmənt/; [n]职业;雇佣;就业;运用; [^]yshx;
enclose: [-]/ɪnˈkloʊz/; [v]围住;圈起;装入信封;附有; [^]yshx;
encounter: [-]/ɪnˈkaʊntər/; [v]邂逅,遭遇,偶遇; [n]偶然碰见,遭遇; [^]yshx;
encyclopedia: [-]/ɪnˌsaɪkləˈpiːdiə/; [n]百科全书; [^]yshx;
end up: [-]/end ʌp/; [phr]以.告终; [^]yshx;
endeavour: [-]/ɪnˈdevər/; [n]尝试; [v]努力; [^]yshx;
endorse: [-]/ɪnˈdɔːrs/; [v]赞同,认可;签注(文件); [^]yshx;
endurance: [-]/ɪnˈdʊrəns/; [n]忍耐力,耐性,耐用度; [^]yshx;
energetic: [-]/ˌenərˈdʒetɪk/; [a]精力充沛的,充满活力的;有力的,积极的; [^]yshx;
enforce: [-]/ɪnˈfɔːrs/; [v]实施;执行;强制; [^]yshx;
engage: [-]/ɪnˈɡeɪdʒ/; [vt]吸引住(注意力,兴趣);雇,聘; [vi]使加入,使融入;订婚; [v](军队)交战;啮合; [^]yshx;
engrave: [-]/ɪnˈɡreɪv/; [v]雕刻;铭记; [^]yshx;
engross: [-]/ɪnˈɡroʊs/; [v]独占;正式誊写;使全神贯注于;用大字体书写; [^]yshx;
enhance: [-]/ɪnˈhæns/; [v]提高(强度,力量,数量等);增加,加强; [^]yshx;
enlighten: [-]/ɪnˈlaɪtn/; [v]启发,开导; [^]yshx;
enormous: [-]/ɪˈnɔːrməs/; [a]极大的,极大量的;巨大的;庞大的; [^]yshx;
enrich: [-]/ɪnˈrɪtʃ/; [v]使丰富;使富裕; [^]yshx;
enrolment: [-]/ɪnˈroʊlmənt/; [n]登记,注册;入会,入学; [^]yshx;
ensemble: [-]/ɑːnˈsɑːmbl/; [n]合唱团,表演团体;总效果;全套服装;全套家具; [^]yshx;
ensue: [-]/ɪnˈsuː/; [v]跟着发生,接踵而来;因而产生; [^]yshx;
entangle: [-]/ɪnˈtæŋɡl/; [v]使纠缠,卷入; [^]yshx;
enterprise: [-]/ˈentərpraɪz/; [n]企业(或事业)单位,公司;事业;事业心; [^]yshx;
entertainment: [-]/ˌentərˈteɪnmənt/; [n]娱乐;招待,款待; [^]yshx;
enthusiastic: [-]/ɪnˌθuːziˈæstɪk/; [a]狂热的,极感兴趣的,热情的; [^]yshx;
entitle: [-]/ɪnˈtaɪtl/; [v]给(书)题名;给予.权利; [^]yshx;
entrepreneur: [-]/ˌɑːntrəprəˈnɜːr/; [n]企业家,演出承包人; [^]yshx;
entry: [-]/ˈentri/; [n]入口处;登记;进入; [^]yshx;
envisage: [-]/ɪnˈvɪzɪdʒ/; [v]想象,设想; [^]yshx;
envy: [-]/ˈenvi/; [n]妒忌;妒忌的对象; [v]嫉妒,羡慕; [^]yshx;
enzyme: [-]/ˈenzaɪm/; [n]<生化>酶; [^]yshx;
ephemeral: [-]/ɪˈfemərəl/; [a]短暂的,短命的; [n]生存极短时间的事物; [^]yshx;
epidemic: [-]/ˌepɪˈdemɪk/; [a]流行性的,传染的; [n]流行病,传染病,(犯罪等的)盛行; [^]yshx;
episode: [-]/ˈepɪsoʊd/; [n]插曲,片断;连续剧的一集;一段经历; [^]yshx;
epoch: [-]/ˈepək/; [n]时期;新时代; [^]yshx;
equal: [-]/ˈiːkwəl/; [a]相等的;平等的; [v]等于;比得上; [n]对手; [^]yshx;
equator: [-]/ɪˈkweɪtər/; [n]赤道; [^]yshx;
equitable: [-]/ˈekwɪtəbl/; [a]公正的,公平的; [^]yshx;
equivalent: [-]/ɪˈkwɪvələnt/; [a]相等的;等值的; [n]同义词;等价物; [^]yshx;
erase: [-]/ɪˈreɪs/; [v](计算机)擦除;抹去;擦掉; [^]yshx;
erect: [-]/ɪˈrekt/; [v]搭建,竖起;建造,建立; [a]直立的,垂直的; [^]yshx;
erosion: [-]/ɪˈroʊʒn/; [n]侵蚀;腐蚀;磨损;削弱;减少; [^]yshx;
errand: [-]/ˈerənd/; [n]差使;差事;使命; [^]yshx;
erratic: [-]/ɪˈrætɪk/; [a]古怪的;反复无常的,不稳定的; [^]yshx;
erroneous: [-]/ɪˈroʊniəs/; [a]错误的; [^]yshx;
erupt: [-]/ɪˈrʌpt/; [v]爆发;(火山,喷泉,蒸汽等)喷发;使迸发;喷射出; [^]yshx;
escalate: [-]/ˈeskəleɪt/; [v]逐步升高,逐步增强,加剧恶化; [^]yshx;
escort: [-]/ˈeskɔːrt/; [n]护送者; [v]护送; [^]yshx;
essay: [-]/ˈeseɪ/; [n]文章;论文;尝试;随笔; [v]尝试; [^]yshx;
essential: [-]/ɪˈsenʃl/; [a]必不可少的,必要的;本质的;重要的;基本的; [n]要素;必需品; [^]yshx;
establish: [-]/ɪˈstæblɪʃ/; [v]建立;确立;使安全;使成为; [^]yshx;
estate: [-]/ɪˈsteɪt/; [n]地产,(上有大片建筑物的)土地,住宅,财产,遗产; [^]yshx;
esteem: [-]/ɪˈstiːm/; [n]尊敬;尊重; [vt]尊敬;认为;考虑;估计; [^]yshx;
estimate: [-]/ˈestɪmət/; [v]估价,估计,评价; [n]估计,评价; [^]yshx;
eternal: [-]/ɪˈtɜːrnl/; [a]永恒的,永不改变的; [^]yshx;
ethnic: [-]/ˈeθnɪk/; [a]种族的,少数民族的; [n]少数民族成员;人种学; [^]yshx;
etiquette: [-]/ˈetɪket/; [n]礼仪; [^]yshx;
evacuate: [-]/ɪˈvækjueɪt/; [v]撤离,疏散,排清; [^]yshx;
evade: [-]/ɪˈveɪd/; [v]躲避,回避; [^]yshx;
evaluate: [-]/ɪˈvæljueɪt/; [v]评价;评估; [^]yshx;
evaporate: [-]/ɪˈvæpəreɪt/; [v]蒸发,失去水分;消失; [^]yshx;
everlasting: [-]/ˌevərˈlæstɪŋ/; [a]永恒的,持久的;无止境的;耐用的; [^]yshx;
evict: [-]/ɪˈvɪkt/; [v]驱逐,逐出; [^]yshx;
evoke: [-]/ɪˈvoʊk/; [v]唤起;引起;使人想起; [^]yshx;
evolution: [-]/ˌevəˈluːʃn/; [n]进化,演变;发展; [^]yshx;
exacerbate: [-]/ɪɡˈzæsərbeɪt/; [v]加重;恶化;激怒; [^]yshx;
exaggerate: [-]/ɪɡˈzædʒəreɪt/; [vi]夸张; [vt]夸大,夸张;使扩大; [^]yshx;
exasperate: [-]/ɪɡˈzæspəreɪt/; [vt]激怒;加剧; [^]yshx;
excavate: [-]/ˈekskəveɪt/; [v]挖掘,挖出;挖(空),挖(洞); [^]yshx;
exceed: [-]/ɪkˈsiːd/; [v]超过;胜过;超出; [^]yshx;
excel: [-]/ɪkˈsel/; [vi]胜出; [vt]优于; [^]yshx;
exceptional: [-]/ɪkˈsepʃənl/; [a]优越的,杰出的;异常的; [^]yshx;
excerpt: [-]/ˈeksɜːrpt/; [n]摘录,节选; [v]摘,选;引用; [^]yshx;
excess: [-]/ɪkˈses/; [a]额外的,过量的,过度的,附加的; [n]超越,超过,过度; [^]yshx;
exchange: [-]/ɪksˈtʃeɪndʒ/; [v]交换,互换;交流;进行易货贸易; [n]交换;交易所;(货币的)兑换; [^]yshx;
exclaim: [-]/ɪkˈskleɪm/; [v]呼叫,惊叫; [^]yshx;
excrement: [-]/ˈekskrɪmənt/; [n]排泄物,粪便; [^]yshx;
excursion: [-]/ɪkˈskɜːrʒn/; [n]远足;短途旅行; [^]yshx;
execute: [-]/ˈeksɪkjuːt/; [v]处决;完成(动作);实行;执行(计划); [^]yshx;
exemplify: [-]/ɪɡˈzemplɪfaɪ/; [v]举例说明;例示,是..的典范; [^]yshx;
exert: [-]/ɪɡˈzɜːrt/; [v]尽(力),运用,发挥; [^]yshx;
exhaust: [-]/ɪɡˈzɔːst/; [v]使筋疲力尽;耗尽;详尽论述; [n]排气装置;废气; [^]yshx;
exhilarate: [-]/ɪɡˈzɪləreɪt/; [v]使高兴;使兴奋; [a]使人高兴的,令人兴奋的; [^]yshx;
exhort: [-]/ɪɡˈzɔːrt/; [vt]敦促,劝告; [vi]规劝,劝告; [^]yshx;
exorbitant: [-]/ɪɡˈzɔːrbɪtənt/; [a]要价过高的,过分的; [^]yshx;
exotic: [-]/ɪɡˈzɑːtɪk/; [a]奇异的,珍奇的,来自异国的; [^]yshx;
expand: [-]/ɪkˈspænd/; [v]膨胀;扩大; [vt]详细展开; [^]yshx;
expedient: [-]/ɪkˈspiːdiənt/; [n]权宜之计,手段; [a]有利的,方便的;权宜之计的; [^]yshx;
expedition: [-]/ˌekspəˈdɪʃn/; [n]远征队;探险;短途旅行;迅速; [^]yshx;
expel: [-]/ɪkˈspel/; [v]罚出,开除;排出;开除;驱逐; [^]yshx;
expend: [-]/ɪkˈspend/; [v]消费,用尽; [^]yshx;
expertise: [-]/ˌekspɜːrˈtiːz/; [n]专门知识,专门技能; [^]yshx;
expire: [-]/ɪkˈspaɪər/; [v]期满,(期限)终止;断气,死亡; [^]yshx;
explicit: [-]/ɪkˈsplɪsɪt/; [a]充分表达清楚的,明确的;直率的,直截了当的;〔描绘性或暴力的语言或画面〕清晰露骨的; [^]yshx;
explode: [-]/ɪkˈsploʊd/; [v]爆炸;激增;爆发;使爆炸;驳倒; [^]yshx;
exploit: [-]/ɪkˈsplɔɪt/; [v]剥削,利用;开发,开拓; [n]辉煌功绩; [^]yshx;
explore: [-]/ɪkˈsplɔːr/; [v]探险,探索,尝试; [^]yshx;
export: [-]/ˈekspɔːrt/; [v]出口,输出; [n]输出,出口,输出品; [^]yshx;
expose: [-]/ɪkˈspoʊz/; [v]暴露;揭露;使遭受; [^]yshx;
expulsion: [-]/ɪkˈspʌlʃn/; [n]驱逐;开除; [^]yshx;
exquisite: [-]/ɪkˈskwɪzɪt/; [a]精致的,精选的;细腻的;强烈的; [n]过分讲究穿戴的人; [^]yshx;
extend: [-]/ɪkˈstend/; [v]伸展,展开;延伸;涉及;扩展;提供;使.竭尽全力; [^]yshx;
exterior: [-]/ɪkˈstɪriər/; [n]外表;外貌,外观; [a]外部的;外界的;位于外边的;外交上的; [^]yshx;
exterminate: [-]/ɪkˈstɜːrmɪneɪt/; [v]消灭,灭绝;根除; [^]yshx;
external: [-]/ɪkˈstɜːrnl/; [a]外面的,外部的;外国的; [^]yshx;
extinct: [-]/ɪkˈstɪŋkt/; [a]灭绝的;破灭了的,消亡了的; [^]yshx;
extinguish: [-]/ɪkˈstɪŋɡwɪʃ/; [v]熄灭,扑灭;根除,消灭; [^]yshx;
extort: [-]/ɪkˈstɔːrt/; [vt]敲诈,勒索; [^]yshx;
extra: [-]/ˈekstrə/; [a]额外的,附加的;特优的; [ad]额外地; [n]附加物品;临时演员;(报纸)号外; [^]yshx;
extract: [-]/ɪkˈstrækt/; [v]取出;提取;摘录;设法得到;索取; [n]摘录;提出物; [^]yshx;
extravagant: [-]/ɪkˈstrævəɡənt/; [a]奢侈的,无节制的; [^]yshx;
extreme: [-]/ɪkˈstriːm/; [a]极端的;极远的;极限的;极度的;偏激的; [n]极端;极度(状态),最大程度; [^]yshx;
exuberant: [-]/ɪɡˈzuːbərənt/; [a](植物)茂盛的,(人)充满活力的; [^]yshx;
fabric: [-]/ˈfæbrɪk/; [n]布料,织物;质地,结构; [^]yshx;
fabulous: [-]/ˈfæbjələs/; [a]极好的;极妙的;极为巨大的;寓言中的;传说中的; [^]yshx;
facet: [-]/ˈfæsɪt/; [n](多面体的)面,小平面;琢面,侧面; [vt]在.上琢面; [^]yshx;
facilitate: [-]/fəˈsɪlɪteɪt/; [v]为他人提供方便;使便利; [vt]促进; [^]yshx;
facility: [-]/fəˈsɪləti/; [n]设施(车间等),设备;灵巧;才能,资质; [^]yshx;
factor: [-]/ˈfæktər/; [n]因素;<数>因子,商; [^]yshx;
faculty: [-]/ˈfæklti/; [n]教职工,全体教员;系;科;能力; [^]yshx;
fade: [-]/feɪd/; [vi]褪色,褪去;失去;逐渐消失; [vt]使褪色; [n]淡入,淡出; [a]乏味的; [^]yshx;
faint: [-]/feɪnt/; [vi]昏倒,晕厥;变得模糊; [n]晕厥,昏倒; [a]虚弱的;微弱的;眩晕的; [^]yshx;
faith: [-]/feɪθ/; [n]信任;信心;信仰; [int]实在,确实; [^]yshx;
fake: [-]/feɪk/; [a]假的,伪造的; [n]骗子;假货,赝品; [v]假造,杜撰;伪造;冒充,假装;假装; [^]yshx;
fall back on: [-]/fɔl bæk ɔn/; [phr]求助于; [^]yshx;
fall behind: [-]/fɔl bɪˈhaɪnd/; [v]落后; [^]yshx;
fallacy: [-]/ˈfæləsi/; [n]谬论,谬见;错误,谬误; [^]yshx;
falter: [-]/ˈfɔːltər/; [v]蹒跚,摇摆;踌躇;畏缩; [n]踌躇;支吾;颤抖; [^]yshx;
fame: [-]/feɪm/; [n]名望,名声,声誉; [vt]使有名,使著名; [^]yshx;
familiar: [-]/fəˈmɪliər/; [a]熟悉的;不拘礼节的;亲密的;随便的; [n]密友;常客;高级官吏的家属; [^]yshx;
famine: [-]/ˈfæmɪn/; [n]饥荒;严重的缺乏; [^]yshx;
fanatic: [-]/fəˈnætɪk/; [n]狂热者,盲信者; [a]狂热的,入迷的,盲信的; [^]yshx;
fancy: [-]/ˈfænsi/; [a]华丽装饰的,别致的,引人注目的;昂贵的,阔气的; [n]喜爱,幻想,想像力; [vt]想象,幻想;迷恋; [^]yshx;
fantastic: [-]/fænˈtæstɪk/; [a]极好的;极大的;不真实的;荒诞离奇的;不可思议的; [n]〈古〉古怪的人; [^]yshx;
fare: [-]/fer/; [n]交通费;票价;食物;出租车乘客; [v](事情)进行得(好或坏); [^]yshx;
farewell: [-]/ˌferˈwel/; [a]告别的; [n]再见;告别,离别; [^]yshx;
fascinate: [-]/ˈfæsɪneɪt/; [v]使着迷;使神魂颠倒;吸引注意; [^]yshx;
fastidious: [-]/fæˈstɪdiəs/; [a]难讨好的,爱挑剔的; [^]yshx;
fatal: [-]/ˈfeɪtl/; [a]致命的;毁灭性的;决定性的; [^]yshx;
fatigue: [-]/fəˈtiːɡ/; [n]疲乏,劳累; [^]yshx;
fatuous: [-]/ˈfætʃuəs/; [a]愚昧而不自知的; [^]yshx;
fault: [-]/fɔːlt/; [n]过失,过错;弱点,缺点;故障,缺陷;(地质学)断层;发球失误; [v]责备,挑错; [^]yshx;
favor: [-]/ˈfeɪvər/; [n]偏爱,帮助,特权,赞成; [vt]偏爱,支持,利于,长得像; [^]yshx;
feasible: [-]/ˈfiːzəbl/; [a]可行的,行得通的; [^]yshx;
feast: [-]/fiːst/; [n]盛宴;筵席;节日; [v]尽情地吃; [^]yshx;
feature: [-]/ˈfiːtʃər/; [n]面貌,相貌;特征,特点;特辑; [vt]使突出,以.为特色; [vi]起重要作用,作为主要角色; [^]yshx;
federation: [-]/ˌfedəˈreɪʃn/; [n]同盟,联盟,联邦; [^]yshx;
fee: [-]/fiː/; [n]费用,酬金; [^]yshx;
feeble: [-]/ˈfiːbl/; [a]虚弱的; [^]yshx;
feedback: [-]/ˈfiːdbæk/; [n]反馈,反馈意见; [^]yshx;
feel for: [-]/fil fɔr/; [phr]同情; [^]yshx;
feel like: [-]/fil laɪk/; [v]想要; quant. 像要.似的;觉得;摸起来像.似的; [^]yshx;
fellowship: [-]/ˈfeloʊʃɪp/; [n]友谊;伙伴关系;交情;团体;奖学金; [^]yshx;
female: [-]/ˈfiːmeɪl/; [a]女性的;雌性的; [n]女子;雌性动物;雌性植物; [^]yshx;
fend: [-]/fend/; [v](靠自己)照顾,照料;保护;力争; [^]yshx;
ferocious: [-]/fəˈroʊʃəs/; [a]凶猛的;强烈的,严重的; [^]yshx;
ferry: [-]/ˈferi/; [n]渡船,渡轮;渡口; [v]运送;渡运(人,车或物等); [^]yshx;
fertile: [-]/ˈfɜːrtl/; [a]肥沃的;多产的; [^]yshx;
fervent: [-]/ˈfɜːrvənt/; [a]热烈的,满怀热情的;狂热的; [^]yshx;
fester: [-]/ˈfestər/; [v]溃烂;化脓;使..痛苦;使..恶化; [n]溃烂;脓疮,脓疱; [^]yshx;
fetch: [-]/fetʃ/; [v]取来;接来;使发出;售得;带来;接住; [n]拿来,取来;诡计;风浪区; [^]yshx;
fetter: [-]/ˈfetər/; [n]脚镣;束缚; [vt]给.上脚镣;束缚; [^]yshx;
fickle: [-]/ˈfɪkl/; [a](在感情等方面)反复无常的,轻浮的,善变的; [^]yshx;
fidelity: [-]/fɪˈdeləti/; [n]忠诚;逼真度,保真度; [^]yshx;
fierce: [-]/fɪrs/; [a]凶猛的;激烈的;猛烈的; [^]yshx;
file: [-]/faɪl/; [n]文件夹,档案,文件; [vi]把文件归档,提交(申请等); [vt]把(文件等)归档; [^]yshx;
filter: [-]/ˈfɪltər/; [n]过滤器,滤纸; [v]过滤,渗透; [^]yshx;
filth: [-]/fɪlθ/; [n]污秽图片;污物;对警察的冒犯言辞; [^]yshx;
finance: [-]/ˈfaɪnæns/; [v]资金供给,筹措资金; [n]金融,财政,资金; [^]yshx;
find fault with: [-]/faɪnd fɔlt wɪθ/; [phr]埋怨,挑剔; [^]yshx;
find one's bearings: [-]/faɪnd wʌnz ˈberɪŋs/; [v]指明方向;信心十足; [^]yshx;
finite: [-]/ˈfaɪnaɪt/; [a]有限的;限定的; [^]yshx;
first and foremost: [-]/fɜrst ənd ˈfɔrˌmoʊst/; [ad]首先; [^]yshx;
fist: [-]/fɪst/; [n]拳头;笔迹; [vt]用拳头打;握成拳;紧握; [^]yshx;
fixture: [-]/ˈfɪkstʃər/; [n]固定装置;体育项目; [^]yshx;
flabby: [-]/ˈflæbi/; [a](肌肉)松软的,意志薄弱的; [ad]肌肉松垂地,肥胖地; [n](肌肉等)不结实,松弛; [^]yshx;
flake: [-]/fleɪk/; [n]薄片; [v]使成薄片;剥落;雪片般落下; [^]yshx;
flame: [-]/fleɪm/; [v]脸变红;燃烧; [n]火焰;热情; [^]yshx;
flank: [-]/flæŋk/; [v]位于.的侧面; [n]肋,肋腹,侧翼; [^]yshx;
flap: [-]/flæp/; [n]慌乱(状态);拍打,挥动;(一端固定,可自由掀动的布或皮的) 垂悬平片; [v]拍打,挥动; [^]yshx;
flare: [-]/fler/; [v]燃烧(摇曳着);突然发怒; [n]照明弹;摇曳的火焰;闪光信号; [^]yshx;
flash: [-]/flæʃ/; [n]闪光;刹那; [v]闪光,掠过;发火花;快速发送; [a]炫耀的;浮夸的;一闪而过的; [^]yshx;
flask: [-]/flæsk/; [n]烧瓶;长颈瓶;扁瓶; [^]yshx;
flatter: [-]/ˈflætər/; [v]阿谀,使高兴;(肖像等)胜过(真人真物);自鸣得意,自以为是; [^]yshx;
flaunt: [-]/flɔːnt/; [n]招摇;飘扬;藐视; [vi]炫耀;飘扬; [vt]炫耀; [^]yshx;
flavor: [-]/ˈfleɪvər/; [n]味,风味;调味品; [v]给..调味; [^]yshx;
flaw: [-]/flɔː/; [n]瑕疵;缺点; [v]使有缺陷;使不完美;有瑕疵; [^]yshx;
fleeting: [-]/ˈfliːtɪŋ/; [a]短暂的,飞逝的; [^]yshx;
flesh: [-]/fleʃ/; [n]肉,肉体;果肉; [^]yshx;
flexible: [-]/ˈfleksəbl/; [a]易曲的,柔软的,灵活的; [^]yshx;
flicker: [-]/ˈflɪkər/; [v]闪烁,摇曳;颤动;扑动翅膀;假装昏倒; [n]闪烁,闪光; [^]yshx;
fling: [-]/flɪŋ/; [v]掷,抛;猛烈地移动;投入; [n]尽情欢乐的一阵,一时的放纵; [^]yshx;
flip: [-]/flɪp/; [v]把.往上抛;掷;抽打;用指轻弹;空翻; [a]轻率的,无礼的; [^]yshx;
flirt: [-]/flɜːrt/; [n]急扔;调情者; [vi]卖弄风情,调情;戏弄,不认真地对待;摆动; [vt]急速摆动,挥动; [^]yshx;
float: [-]/floʊt/; [vi]漂浮,飘浮,浮现;散布;漂泊; [vt]使漂浮;散布; [n]浮标,漂浮物,漂浮; [^]yshx;
flock: [-]/flɑːk/; [n](鸟兽)群;一群人;(对牧师而言的)教徒; [v]聚集,成群而行; [^]yshx;
flour: [-]/ˈflaʊər/; [n]面粉;粉状物质; [v]撒上粉; [^]yshx;
flourish: [-]/ˈflɜːrɪʃ/; [vi]繁荣,茂盛,兴旺; [vt]挥舞;夸耀; [n]兴旺;茂盛;炫耀;挥舞; [^]yshx;
flu: [-]/fluː/; [n]流感; [^]yshx;
fluctuate: [-]/ˈflʌktʃueɪt/; [v]波动;起伏;涨落; [^]yshx;
fluent: [-]/ˈfluːənt/; [a]流畅的,(说话)流利的;顺畅的,流畅熟练的; [^]yshx;
fluid: [-]/ˈfluːɪd/; [n]流体,液体; [a]流动的;易变的;流畅的; [^]yshx;
flutter: [-]/ˈflʌtər/; [n]激动不安,紧张; [v]飘动,飘扬;(鸟等)振翼,拍翅而飞; [vi](心脏等)快速跳动; [^]yshx;
flux: [-]/flʌks/; [n]流动,不断的变动; [^]yshx;
foam: [-]/foʊm/; [n]泡沫;泡沫体;泡沫塑料; [vi]吐白沫,起泡沫; [^]yshx;
focus: [-]/ˈfoʊkəs/; [n]焦点,聚焦;焦距;关注; [v]使聚焦,集中注意力; [^]yshx;
foil: [-]/fɔɪl/; [n]箔;锡箔纸;衬托; [v]挫败;使受挫折; [^]yshx;
for good (and all): [-]/fɔːr ɡʊd ənd ɔːl/; [ad]永久地,一劳永逸地; [^]yshx;
for one thing: [-]/fɔr wʌn θɪŋ/; [phr]首先;一则; [^]yshx;
for the most part: [-]/fɔr ðə moʊst pɑrt/; [phr]多半;通常;在极大程度上; [^]yshx;
for the sake of: [-]/fɔr ði sek ʌv/; prep. 为.起见;为了.的利益; [^]yshx;
forecast: [-]/ˈfɔːrkæst/; [n]预测;预报; [v]预报,预测; [^]yshx;
foremost: [-]/ˈfɔːrmoʊst/; [a](位置或时间),最先的;首要的; [ad]首先,第一; [^]yshx;
forerunner: [-]/ˈfɔːrʌnər/; [n]先驱;祖先;前兆;预兆; [^]yshx;
foresee: [-]/fɔːrˈsiː/; [v]预知,预料,预测; [^]yshx;
forge: [-]/fɔːrdʒ/; [n]熔炉;锻工车间;铁匠店; [v]锻造;经锻炼而形成;伪造;推进,加强; [^]yshx;
forgive: [-]/fərˈɡɪv/; [v]原谅,饶恕,宽恕;(国家,银行等)免除(债务); [^]yshx;
format: [-]/ˈfɔːrmæt/; [n]版式;设计;格式; [v]设计一个版式;使格式化;设计.的版面; [^]yshx;
formidable: [-]/ˈfɔːrmɪdəbl/; [a]令人畏惧的;可怕的;难以克服的;难应付的; [^]yshx;
formulate: [-]/ˈfɔːrmjuleɪt/; [v]构想出(计划,方法等);系统地阐述; [^]yshx;
fort: [-]/fɔːrt/; [n]堡垒,要塞; [^]yshx;
forte: [-]/fɔːrt/; [n]长处,特长; [a]强音的;响的; [ad]响亮地; [^]yshx;
forthcoming: [-]/ˌfɔːrθˈkʌmɪŋ/; [a]即将出现的,即将到来的;唾手可得的,可用的;乐于提供信息的; [^]yshx;
fortnight: [-]/ˈfɔːrtnaɪt/; [n]两星期,十四日; [^]yshx;
forum: [-]/ˈfɔːrəm/; [n]论坛;讨论会; [^]yshx;
fossil: [-]/ˈfɑːsl/; [n]化石; [a]从地下发掘出来的;化石的;属于旧时代的;陈腐的; [^]yshx;
foul: [-]/faʊl/; [a]难闻的,发臭的;糟透了的;污秽的;犯规的; [n]犯规; [vi]犯规; [vt]弄脏,使污秽;使纠缠; [^]yshx;
fountain: [-]/ˈfaʊntn/; [n]泉水,喷泉;源泉;人造喷泉装置; [^]yshx;
fraction: [-]/ˈfrækʃn/; [n]部分,片断,碎片;分数; [^]yshx;
fracture: [-]/ˈfræktʃər/; [n]骨折;折断;裂口; [v]使折断;使骨折; [^]yshx;
fragment: [-]/ˈfræɡmənt/; [n]片段;碎片; [v]使成碎片; [^]yshx;
fragrance: [-]/ˈfreɪɡrəns/; [n]香水;香味;芳香; [^]yshx;
frail: [-]/freɪl/; [a]脆弱的,不坚实的; [n]少妇;灯心草篓;灯心草篓的容量; [^]yshx;
framework: [-]/ˈfreɪmwɜːrk/; [n]构架,框架,结构;体制,体系; [^]yshx;
frantic: [-]/ˈfræntɪk/; [a]疯狂的;狂乱的;慌乱的; [^]yshx;
freak: [-]/friːk/; [n]怪人,怪物,奇事; [a]反常的,怪诞的; [vt]使强烈反应(震惊;畏惧); [vi]在药物影响下变得异乎寻常; [^]yshx;
freight: [-]/freɪt/; [n]货运;货物;运费; [v]运送; [^]yshx;
fret: [-]/fret/; [v]使烦恼,使焦急;使腐蚀;使磨损; [n](斑卓琴,吉他,曼陀林琴等弦乐器指板上定音的)档;侵蚀; [^]yshx;
friction: [-]/ˈfrɪkʃn/; [n]摩擦,摩擦力;争执,冲突; [^]yshx;
from the outset: [-]/frɒm ðə ˈaʊtˌset/; [ad]从一开始; [^]yshx;
frontier: [-]/frʌnˈtɪr/; [n]边境,边疆;新领域;<美>边远地区,边界地区; [a]开拓的; [^]yshx;
frost: [-]/frɔːst/; [n]霜冻,严寒; [v]结霜,冻死; [^]yshx;
frown: [-]/fraʊn/; [n]皱眉;不悦; [v]皱眉;不赞成;使哑口无言; [^]yshx;
frugal: [-]/ˈfruːɡl/; [a]节俭的,俭朴的;不昂贵的,廉价的,花钱少的,不充足的; [^]yshx;
fruition: [-]/fruˈɪʃn/; [n]享有;最后完成,实现,取得成果; [^]yshx;
frustrate: [-]/ˈfrʌstreɪt/; [v]使灰心;挫败;阻挠; [^]yshx;
fry: [-]/fraɪ/; [v]油煎;油炸; [n]鱼苗,鱼秧;弗赖伊(姓氏);油炸食物;(口语)烦恼,愤激; [a]油炸的,油煎的(fried); [^]yshx;
fulfill: [-]/fʊl'fɪl/; [v]履行,实现,完成;满足(愿望,要求等),使满意; [^]yshx;
function: [-]/ˈfʌŋkʃn/; [n]功能,作用;函数;应变量;盛大聚会;职务,职责; [v]起作用;正常运转; [^]yshx;
fundamental: [-]/ˌfʌndəˈmentl/; [a]基本的,根本的;重要的;基础的; [n]基本原理;基本原则; [^]yshx;
funeral: [-]/ˈfjuːnərəl/; [n]丧葬,葬礼; [^]yshx;
funnel: [-]/ˈfʌnl/; [n]漏斗;烟囱; [v]汇集;通过漏斗等;(使)成漏斗形; [^]yshx;
furious: [-]/ˈfjʊriəs/; [a]狂怒的;愤怒的;猛烈的; [^]yshx;
furnace: [-]/ˈfɜːrnɪs/; [n]炉子,熔炉; [^]yshx;
furnish: [-]/ˈfɜːrnɪʃ/; [v](用家具等)布置(房间,公寓等);供应,提供; [^]yshx;
fuse: [-]/fjuːz/; [n]导火线,引信,保险丝; [v](使)因保险丝熔断而中断工作,熔合,合并; [^]yshx;
fuss: [-]/fʌs/; [n]大惊小怪,小题大做; [v](为小事)烦恼,过于忧虑; [^]yshx;
gaily: [-]/ˈɡeɪli/; [ad]快乐地,愉快地;装饰华丽地; [^]yshx;
galaxy: [-]/ˈɡæləksi/; [n]星系; [^]yshx;
gale: [-]/ɡeɪl/; [n]狂风,一阵(笑声); [^]yshx;
gallery: [-]/ˈɡæləri/; [n]美术馆,画廊;(大厅的)旁听席,边座; [^]yshx;
gamble: [-]/ˈɡæmbl/; [v]赌博;投机;打赌; [n]赌博;冒险; [vt]赌输; [^]yshx;
gang: [-]/ɡæŋ/; [n]以某种方式结合的一群人;帮派; [v]成帮结伙;使集合成一群;使成套排列; [^]yshx;
gape: [-]/ɡeɪp/; [n]裂口,张嘴,打哈欠; [v]目瞪口呆地凝视,打哈欠,张开,裂开; [^]yshx;
garbage: [-]/ˈɡɑːrbɪdʒ/; [n]垃圾桶;垃圾; [^]yshx;
garment: [-]/ˈɡɑːrmənt/; [n]服装; [vt]给 ... 披上衣服;覆上...; [^]yshx;
gasp: [-]/ɡæsp/; [v]喘气;渴望;气喘吁吁地说出; [n]喘气; [^]yshx;
gaudy: [-]/ˈɡɔːdi/; [n]华丽而俗气的廉价饰物; [a](服饰,装饰,文风等)华丽而俗气的;浮华的;过分显眼的; [^]yshx;
gauge: [-]/ɡeɪdʒ/; [n]测量仪;尺度,标准; [v]估计,判断;计量; [^]yshx;
gaunt: [-]/ɡɔːnt/; [a]憔悴的,瘦削的; [n]憔悴,荒凉; [^]yshx;
gear: [-]/ɡɪr/; [n]档位;齿轮;装备;衣物; [v]使适合; [^]yshx;
generate: [-]/ˈdʒenəreɪt/; [v]产生(热,电等能量),创造; [^]yshx;
generic: [-]/dʒəˈnerɪk/; [n]无注册商标产品;通名; [a]一般的;非商标的;属的,类的; [^]yshx;
generous: [-]/ˈdʒenərəs/; [a]慷慨的;充裕的,宽厚的;肥沃的; [^]yshx;
genetic: [-]/dʒəˈnetɪk/; [a]遗传的,起源的; [^]yshx;
genius: [-]/ˈdʒiːniəs/; [n]天才;天资,天赋;才华; [^]yshx;
gentle: [-]/ˈdʒentl/; [a]温和的,轻柔的,文雅的; [^]yshx;
genuine: [-]/ˈdʒenjuɪn/; [a]真正的;真的;真诚的; [^]yshx;
geology: [-]/dʒiˈɑːlədʒi/; [n]地质学,(某一地区的)地质; [^]yshx;
geometry: [-]/dʒiˈɑːmətri/; [n]几何学;几何形状; [^]yshx;
germ: [-]/dʒɜːrm/; [n]微生物,细菌;(某事的)发端,萌芽; [v]萌芽;发生; [^]yshx;
gesture: [-]/ˈdʒestʃər/; [n]手势,表情;姿态; [v]做手势,用动作示意; [vt]用手势表达; [^]yshx;
get along: [-]/ɡet əˈlɔŋ/; [v]与.和睦相处;进展; [^]yshx;
get at sb.(sth.): [-]/ɡet æt ˈsʌmbədi ˈsʌmθɪŋ/; [v]到达,得到;接近; [^]yshx;
get away: [-]/ɡet, əˈweɪ/; [phr]离开,逃脱; [^]yshx;
get down to business: [-]/ɡet daʊn tu ˈbɪznəs/; [phr]着手干正事; [^]yshx;
get down to: [-]/ɡet daʊn tu/; [phr]开始认真对待;着手处理; [^]yshx;
get into: [-]/ɡet ˈɪntu/; [phr]穿上;陷入,染上(习惯);对.有兴趣; [^]yshx;
get nowhere: [-]/ɡet ˈnoʊˌhwer/; [phr](使)无进展;行不通; [^]yshx;
get off: [-]/ɡet ɑf/; [phr]动身;免于受罚;从..下来;把手拿开; [^]yshx;
get on: [-]/ɡet ɔːn/; [phr]上车(飞机,船),进展,使前进; [^]yshx;
get out: [-]/ɡet aʊt/; [phr]出去;逃脱;泄露; [^]yshx;
get over: [-]/ɡet ˈoʊvər/; [phr]克服;恢复;熬过;原谅; [^]yshx;
get round sth.: [-]/ɡet raʊnd ˈsʌmθɪŋ/; [v]规避(法律),避开; [^]yshx;
get round to doing sth: [-]/ɡet raʊnd tu ˈduːɪŋ ˈsʌmθɪŋ/; [phr]抽出时间做; [^]yshx;
get somewhere: [-]/ɡet ˈsʌmwer/; [v]有所成就; [^]yshx;
get sth. down: [-]/ɡet ˈsʌmθɪŋ daʊn/; [v]吞下;写下; [^]yshx;
get the better of: [-]/ɡet ðə ˈbetər ɑv/; [phr]打败; [^]yshx;
get through (sth.): [-]/ɡet θruː ˈsʌmθɪŋ/; [v]通过(考试等); [^]yshx;
get through: [-]/ɡet θru/; [v]完成;穿过;(成功)渡过(困难时期);打通(电话); [^]yshx;
ghastly: [-]/ˈɡæstli/; [a]苍白的,可怕的,令人不快的; [ad]恐怖地,惨白地; [^]yshx;
gigantic: [-]/dʒaɪˈɡæntɪk/; [a]巨大的; [^]yshx;
giggle: [-]/ˈɡɪɡl/; [v]咯咯地笑,傻笑; [n]咯咯地笑,傻笑; [^]yshx;
gist: [-]/dʒɪst/; [n]主旨,要点;依据; [^]yshx;
give (sth.) off: [-]/ɡɪv ˈsʌmθɪŋ ɑːf/; [v]发出(烟,气); [^]yshx;
give in (to sb.): [-]/ɡɪv ɪn tu ˈsʌmbədi/; [v]屈服,投降; [^]yshx;
give oneself (put on) airs: [-]/ɡɪv wʌnˈself pʊt ɔːn erz/; [v]装腔作势; [^]yshx;
give oneself up: [-]/ɡɪv wʌnˈself ʌp/; [phr]自首;投降; [^]yshx;
give out: [-]/ɡɪv aʊt/; [v]停止;耗尽;分发;产生;发出; [^]yshx;
give sth. up: [-]/ɡɪv ˈsʌmθɪŋ ʌp/; [v]放弃;戒烟; [^]yshx;
give way (to sb.): [-]/ɡɪv weɪ tu ˈsʌmbədi/; [v]让步,屈服; [^]yshx;
give way (to sth.): [-]/ɡɪv weɪ tuː ˈsʌmθɪŋ/; [phr]给.让路;为.所代替; [^]yshx;
glacier: [-]/ˈɡleɪʃər/; [n]冰川,冰河; [^]yshx;
glamour: [-]/ˈɡlæmər/; [n]魅力;诱惑力; [^]yshx;
glare: [-]/ɡler/; [v]怒目而视;发出强光; [n]眩目的光;瞪眼; [^]yshx;
gleam: [-]/ɡliːm/; [vi]闪烁;使发出微光; [n]闪光;微光;闪现; [^]yshx;
glide: [-]/ɡlaɪd/; [v]滑翔;滑动; [n]滑音,延音;滑行; [^]yshx;
glimmer: [-]/ˈɡlɪmər/; [n]微光;闪光;少许; [v]闪烁;发微光; [^]yshx;
glimpse: [-]/ɡlɪmps/; [n]一瞥;初步的感受; [v]一瞥,瞥见; [^]yshx;
glitter: [-]/ˈɡlɪtər/; [v]闪闪发光,闪耀; [n]灿烂的光辉,闪光; [^]yshx;
global: [-]/ˈɡloʊbl/; [a]全球的;全面的; [^]yshx;
gloomy: [-]/ˈɡluːmi/; [a]愁容满面的,阴暗的,没有希望的; [^]yshx;
glorious: [-]/ˈɡlɔːriəs/; [a]辉煌的,壮丽的;光荣的,荣耀的; [^]yshx;
gloss: [-]/ɡlɑːs/; [n]光泽;假象;唇膏; [vt]使有光彩;掩盖; [^]yshx;
glossary: [-]/ˈɡlɑːsəri/; [n]词汇表,术语汇编; [^]yshx;
glow: [-]/ɡloʊ/; [n]光辉,红光,热情; [v]发光,发红光,发热; [^]yshx;
glue: [-]/ɡluː/; [n]胶水; [v]用胶粘; [^]yshx;
go (very) far: [-]/ɡoʊ ˈveri fɑːr/; [phr]成功;扬名;大有前途; [^]yshx;
go about: [-]/ɡoʊ əˈbaʊt/; [v]着手做;四处走动;传开;从事; [^]yshx;
go after sb. (sth.): [-]/ɡoʊ ˈæftər ˈsʌmbədi ˈsʌmθɪŋ/; [phr]追求,追逐; [^]yshx;
go back: [-]/ɡoʊ bæk/; [phr]回去;追溯; [^]yshx;
go by: [-]/ɡoʊ baɪ/; [phr]走过,过去;(时间)流逝; [^]yshx;
go down: [-]/ɡoʊ daʊn/; [phr]下降;平静下来;被接受; [^]yshx;
go for sb.: [-]/ɡoʊ fɔːr ˈsʌmbədi/; [v]去请(人);袭击; [^]yshx;
go into: [-]/ɡoʊ ˈɪntu/; [phr]进入;加入;变得;探究; [^]yshx;
go off: [-]/ɡoʊ ɑf/; [phr]爆炸;进行;变质; [^]yshx;
go on about sth.: [-]/ɡoʊ ɔːn əˈbaʊt ˈsʌmθɪŋ/; [v]喋喋不休; [^]yshx;
go out: [-]/ɡoʊ aʊt/; [v]外出,参加社交活动,熄灭,(衣服式样)过时,出去,交往; [^]yshx;
go over: [-]/ɡoʊ ˈoʊvər/; [v]仔细检查; [phr]复习,重温; [^]yshx;
go round: [-]/ɡoʊ raʊnd/; [v]足够分配;绕道走,到处走动; [^]yshx;
go through (sth.): [-]/ɡoʊ θruː ˈsʌmθɪŋ/; [v]仔细讨论;搜查;经受;用光(钱);穿过; [^]yshx;
go up: [-]/ɡoʊ ʌp/; [phr]上升;被建立;被炸毁; [^]yshx;
go with sb. (sth.): [-]/ɡoʊ wɪθ ˈsʌmbədi ˈsʌmθɪŋ/; [phr]陪伴.去;与.相配; [^]yshx;
go without (sth.): [-]/ɡoʊ wɪˈðaʊt ˈsʌmθɪŋ/; [v]在缺少.的情况下勉强对付; [^]yshx;
go without saying: [-]/ɡoʊ wɪðˈaʊt ˈseɪɪŋ/; [v]不言而喻,理所当然; [^]yshx;
goad: [-]/ɡoʊd/; [vt]驱赶;刺激;鼓励; [n](赶牛用的)刺棒; [^]yshx;
goal: [-]/ɡoʊl/; [n]目标;球门;(进球)得分; [^]yshx;
gorgeous: [-]/ˈɡɔːrdʒəs/; [a]绚丽的;极好的;令人愉快的; [^]yshx;
gossip: [-]/ˈɡɑːsɪp/; [n]流言蜚语,爱传流言的人; [v]闲聊,传播流言蜚语; [^]yshx;
gown: [-]/ɡaʊn/; [n]女礼服;女裙服;长袍; [^]yshx;
grab: [-]/ɡræb/; [v]攫取,抓取,掠夺;赶紧做;吸引; [n]抓取,非法所得; [^]yshx;
gracious: [-]/ˈɡreɪʃəs/; [a]和善的;亲切的;优美的;奢华的; [^]yshx;
gradual: [-]/ˈɡrædʒuəl/; [a]逐渐的,逐步的,平缓的; [^]yshx;
granary: [-]/ˈɡrænəri/; [n]谷仓,粮仓;产粮区;主要来源; [^]yshx;
grand: [-]/ɡrænd/; [a]壮丽的,宏伟的,重大的;傲慢的;极好的; [n]一千美元;大钢琴; [^]yshx;
grant: [-]/ɡrænt/; [v]给予,许可,授予;承认; [n]许可;拨款,补助金; [^]yshx;
granular: [-]/ˈɡrænjələr/; [a]粒状的,含颗粒的; [^]yshx;
graphic: [-]/ˈɡræfɪk/; [a]形象的;图表的; [n]图,图表; [^]yshx;
grate: [-]/ɡreɪt/; [n]壁炉;格栅; [v]磨碎,使人烦燥; [^]yshx;
gratitude: [-]/ˈɡrætɪtuːd/; [n]感激,感谢; [^]yshx;
gratuity: [-]/ɡrəˈtuːəti/; [n]赏钱,小费; [^]yshx;
grave: [-]/ɡreɪv/; [a]严重的;严肃的,庄重的; [n]墓; [ad]沉重地,庄重地;极慢地; [vt]雕刻;铭记; [^]yshx;
gravel: [-]/ˈɡrævl/; [n]沙砾,小石,砾石; [a]粗重而沙哑的,刺耳的; [vt]用砾石铺;使困惑; [^]yshx;
graze: [-]/ɡreɪz/; [v](牲畜)吃草;放牧;擦过; [n]擦,擦伤; [^]yshx;
grease: [-]/ɡriːs/; [n]油脂;动物脂;润滑脂; [v]抹油;使润滑; [^]yshx;
greedy: [-]/ˈɡriːdi/; [a]贪婪的,贪心的,贪吃的; [^]yshx;
grid: [-]/ɡrɪd/; [n]格子,地图坐标; [^]yshx;
grieve: [-]/ɡriːv/; [v]伤心,悲痛; [vi]使悲伤,使伤心; [^]yshx;
grill: [-]/ɡrɪl/; [n]烤架; [v]烤;拷问; [^]yshx;
grim: [-]/ɡrɪm/; [a]严酷的,无情的;令人沮丧的,令人失望的;讨厌的,糟糕的; [^]yshx;
grin: [-]/ɡrɪn/; [v]露齿而笑,咧嘴一笑; [n]龇牙笑; [^]yshx;
grind: [-]/ɡraɪnd/; [v]磨碎,碾碎;折磨;摩擦得吱吱作响; [n]苦差事,苦活儿;磨; [^]yshx;
grip: [-]/ɡrɪp/; [v]握紧,抓牢; [n]紧握,握力; [^]yshx;
grit: [-]/ɡrɪt/; [n]沙粒;决心,勇气; [v]研磨;在.上铺砂砾;下定决心,咬紧牙关; [^]yshx;
groan: [-]/ɡroʊn/; [v]呻吟;抱怨; [n]呻吟; [^]yshx;
grope: [-]/ɡroʊp/; [v]摸索,探索,动手动脚; [^]yshx;
gross: [-]/ɡroʊs/; [a]总的,毛重的;恶心的;粗鲁的; [n]总量,总额; [ad]总共地; [vt]总共赚得; [^]yshx;
growl: [-]/ɡraʊl/; [v](动物)咆哮,吼叫; [n]咆哮声,怨言,打嗝声; [^]yshx;
grudge: [-]/ɡrʌdʒ/; [n]怨恨;妒嫉;恶意;忿忿不平; [v]怨恨;嫉妒;不情愿做; [^]yshx;
grumble: [-]/ˈɡrʌmbl/; [v]埋怨;发牢骚;咕哝; [n]隆隆响声;抱怨,怨言; [^]yshx;
guarantee: [-]/ˌɡærənˈtiː/; [v]保证;担保;提供保修; [n]保证;担保;保修单;保证金; [^]yshx;
guardian: [-]/ˈɡɑːrdiən/; [n]保护人;监护人; [^]yshx;
guideline: [-]/ˈɡaɪdlaɪn/; [n]指导路线,准则; [^]yshx;
gush: [-]/ɡʌʃ/; [v]涌出;滔滔不绝地说,洋洋洒洒地写; [n]迸发; [^]yshx;
gust: [-]/ɡʌst/; [n]阵风,(感情的)迸发,汹涌; [v]猛吹; [^]yshx;
gymnasium: [-]/dʒɪmˈneɪziəm/; [n]体育馆,健身房; [^]yshx;
had better: [-]/hæd ˈbetər/; [v]最好还是; [^]yshx;
hail: [-]/heɪl/; [n]冰雹;一阵; [v]下冰雹;歌颂; [^]yshx;
halt: [-]/hɔːlt/; [v]停止,止步,暂停; [n]停住,终止; [^]yshx;
hamper: [-]/ˈhæmpər/; [v]阻碍,妨碍,牵制; [n](有盖的)大篮子; [^]yshx;
hand sth. down to sb.: [-]/hænd ˈsʌmθɪŋ daʊn tu ˈsʌmbədi/; [v](作为传统)传下,传给; [^]yshx;
hand sth. out: [-]/hænd ˈsʌmθɪŋ aʊt/; [phr]分发; [^]yshx;
hand sth. over to sb.: [-]/hænd ˈsʌmθɪŋ ˈoʊvər tu ˈsʌmbədi/; [phr]移交; [^]yshx;
handbook: [-]/ˈhændbʊk/; [n]手册;指南; [^]yshx;
handicap: [-]/ˈhændikæp/; [n]障碍,阻碍,不利条件,不利因素;残疾,缺陷,生理缺陷;<高尔夫>给弱者增加的杆数(按击球次数计数,并随参赛者的进步而减少); [v]使不利,妨碍; [^]yshx;
hang on: [-]/hæŋ ɔn/; [phr]坚持下去;不挂断;稍等;握住不放; [^]yshx;
hang up: [-]/hæŋ ʌp/; [phr]挂断电话; [^]yshx;
haphazard: [-]/hæpˈhæzərd/; [a]偶然的;随意的;凑合的;胡乱的; [^]yshx;
harass: [-]/həˈræs/; [v]使困扰,使烦恼,反复袭击; [^]yshx;
harbor: [-]/'hɑːbə/; [n]海港;港口;避风港; [v]庇护;藏匿;心怀(怨恨等); [^]yshx;
hard and fast: [-]/hɑrd ənd fæst/; [phr](规则等)严格的,不容改变的; [^]yshx;
hardware: [-]/ˈhɑːrdwer/; [n]五金器具,(总称)金属器材;硬件; [^]yshx;
harmony: [-]/ˈhɑːrməni/; [n]和谐;和声;和睦;协调; [^]yshx;
harness: [-]/ˈhɑːrnɪs/; [n]挽具,马具,降落伞背带; [v]上挽具;治理(河流等);利用; [^]yshx;
harsh: [-]/hɑːrʃ/; [a]严厉的;刺耳的;条件艰苦的; [^]yshx;
hasty: [-]/ˈheɪsti/; [a]匆忙的;仓促完成的;草率的; [^]yshx;
hatch: [-]/hætʃ/; [n]船舱盖; [v]孵出,孵;策划; [^]yshx;
haul: [-]/hɔːl/; [n]一次获得;拖运路程; [v]硬拖,硬拉,用力拖;拖,拉,拽;强迫(某人)去某处; [^]yshx;
haunt: [-]/hɔːnt/; [v]常去,萦绕于..;(鬼,魂)常出没于;(思想)萦绕; [n]常去的地方; [^]yshx;
have (get) the upper hand: [-]/hæv ɡet ði ˈʌpər hænd/; [v]取得优势,占上风; [^]yshx;
have one's hands full: [-]/hæv wʌnz hændz fʊl/; [phr]忙得不可开交;手头事情应接不暇;离不开手; [^]yshx;
have one's say: [-]/hæv wʌnz seɪ/; [phr]利用机会发表意见; [^]yshx;
have the makings of: [-]/həv ðə ˈmeɪkɪŋz ɑv/; [v]具有成为.所需要的素质; [^]yshx;
have to do with: [-]/hæv tə dʊ wɪð/; [v]与.有关; [^]yshx;
haven: [-]/ˈheɪvn/; [n]港湾;避难所; [vt]为.提供庇护所; [^]yshx;
havoc: [-]/ˈhævək/; [n](天灾,战争等造成的)大破坏,大毁灭; [vi]损毁; [vt]严重破坏; [^]yshx;
hawk: [-]/hɔːk/; [n]鹰;鹰派成员(以强硬态度或手段维护国家民族利益的个人,团体或势力); [v]叫卖,兜售;散播; [^]yshx;
hazardous: [-]/ˈhæzərdəs/; [a]有危险的;碰运气的; [ad]冒险地,有危险地; [n]冒险,危险; [^]yshx;
headstrong: [-]/ˈhedstrɔːŋ/; [a]任性的;顽固的; [^]yshx;
heal: [-]/hiːl/; [v]治愈,治疗;痊愈;恢复; [^]yshx;
heap: [-]/hiːp/; [n](一)堆;大量; [v]堆;堆积; [^]yshx;
hearing: [-]/ˈhɪrɪŋ/; [n]听觉;听距;听证会;申辩的机会; [v]听到; [^]yshx;
heave: [-]/hiːv/; [v]用力举起;掷扔;发出叹息;恶心; [n]举起,升降; [^]yshx;
hectic: [-]/ˈhektɪk/; [a]紧张的,忙碌的;患肺病的;(因患肺病等)发烧的,有病态潮红的;脸上发红,发热的,兴奋的,狂热的,肺病的; [^]yshx;
hedge: [-]/hedʒ/; [v]防范,规避;避免直接答复,避免直接回答;围住;用树篱围起; [n]篱笆,树篱;保障; [^]yshx;
heighten: [-]/ˈhaɪtn/; [v]加强,增加,提高; [^]yshx;
heir: [-]/er/; [n]继承人;后继者; [^]yshx;
helicopter: [-]/ˈhelɪkɑːptər/; [n]直升机; [v]用直升飞机载送,乘直升机; [^]yshx;
hell: [-]/hel/; [n]地狱,阴间;苦境,极大的痛苦; [^]yshx;
hemisphere: [-]/ˈhemɪsfɪr/; [n](地球的)半球;大脑半球; [^]yshx;
herb: [-]/ɜːrb/; [n]草本植物;药草; [^]yshx;
herd: [-]/hɜːrd/; [n]兽群,牧群; [v]放牧,群集; [^]yshx;
hereditary: [-]/həˈredɪteri/; [a]世袭的,遗传的; [^]yshx;
heritage: [-]/ˈherɪtɪdʒ/; [n]遗产;继承物;传统;文化遗产; [^]yshx;
hierarchy: [-]/ˈhaɪərɑːrki/; [n]阶层,等级制度; [^]yshx;
highlight: [-]/ˈhaɪlaɪt/; [vt]使突出,强调,高亮; [n]最精彩的部分,最重要的事件; [^]yshx;
hijack: [-]/ˈhaɪdʒæk/; [v]劫持,劫机,拦路抢劫;操纵(会议等,以推销自己的意图); [n]劫持;敲诈;威逼; [^]yshx;
hike: [-]/haɪk/; [n]远足,徒步旅行;(数量,价格等)增加,上升; [v]作长途徒步旅行;使高涨,提高(价格); [^]yshx;
hilarious: [-]/hɪˈleriəs/; [a]有趣的;令人捧腹的;滑稽的;欢闹的; [^]yshx;
hinder: [-]/ˈhɪndər/; [v]阻碍,妨碍; [a]后面的,后方的; [^]yshx;
hinge: [-]/hɪndʒ/; [n]铰链; [v]靠铰链转动; [^]yshx;
hint: [-]/hɪnt/; [v]作暗示;透露; [n]暗示,示意;建议; [^]yshx;
historic: [-]/hɪˈstɔːrɪk/; [a]历史上著名的,有历史意义的;历史性的; [^]yshx;
hit it off (with sb./together): [-]/hɪt ɪt ɑːf wɪθ ˈsʌmbədi təˈɡeðər/; [v]一见如故,合得来; [^]yshx;
hit on (upon): [-]/hɪt ɔːn əˈpɔːn/; [v]碰巧打到,偶然发现; [^]yshx;
hitchhike: [-]/ˈhɪtʃhaɪk/; [v]免费搭乘他人便车; [n]搭便车(旅行); [^]yshx;
hoist: [-]/hɔɪst/; [v]升起,吊起;向上推; [n]起重机;举起; [^]yshx;
hold back: [-]/hoʊld bæk/; [phr]阻挡,抑制,控制; [v]隐瞒; [^]yshx;
hold on: [-]/həʊld ɒn/; [phr]坚持;不挂断;稍等;紧紧抓住; [^]yshx;
hold one's ground: [-]/hold wʌnz ɡraʊnd/; [phr]坚持立场; [^]yshx;
hold onto: [-]/hoʊld ˈɑntə/; [v]抓住,不放;不卖掉; [^]yshx;
hold out (against): [-]/hoʊld aʊt əˈɡeɪnst/; [phr]坚持(反抗),顶住; [^]yshx;
hold the line: [-]/hoʊld ðə laɪn/; [phr]坚持下去;不挂断电话; [^]yshx;
holocaust: [-]/ˈhɑːləkɔːst/; [n]大屠杀,浩劫; [^]yshx;
homestay: [-]/ˈhoʊmsteɪ/; [n]在当地居民家中居住的时期;寄宿家庭; [^]yshx;
horizon: [-]/həˈraɪzn/; [n]地平线;眼界,见识; [^]yshx;
horrible: [-]/ˈhɔːrəbl/; [a]可怕的,恐怖的;讨厌的,糟糕的;粗鲁的,不友好的; [^]yshx;
horticulture: [-]/ˈhɔːrtɪkʌltʃər/; [n]园艺;园艺学; [^]yshx;
hose: [-]/hoʊz/; [n]输水软管; [v]用水管冲洗(汽车等); [^]yshx;
hospitality: [-]/ˌhɑːspɪˈtæləti/; [n]好客;款待; [^]yshx;
host: [-]/hoʊst/; [n]东道主,主持人;大量; [v]主持,主办; [^]yshx;
hostage: [-]/ˈhɑːstɪdʒ/; [n]人质; [^]yshx;
hostile: [-]/ˈhɑːstl/; [a]敌对的,敌方的;怀敌意的; [^]yshx;
hound: [-]/haʊnd/; [n]猎犬; [v]追逼;烦扰;纠缠; [^]yshx;
hover: [-]/ˈhʌvər/; [v](鸟,直升机)盘旋,翱翔;(人)逗留在附近,徘徊; [^]yshx;
howl: [-]/haʊl/; [v](狼,狗等)嗥叫;(风等)呼啸;(因愤怒,痛苦等)吼叫,哀号; [n]嚎叫,哀号; [^]yshx;
hubbub: [-]/ˈhʌbʌb/; [n]嘈杂,喧哗; [^]yshx;
hug: [-]/hʌɡ/; [v]紧抱;拥抱; [n]拥抱; [^]yshx;
hum: [-]/hʌm/; [v]发出嗡嗡声,哼(歌曲); [n]轰鸣声,嗡嗡营营声; [^]yshx;
humanity: [-]/hjuːˈmænəti/; [n]人性;人类;人道;慈爱;(复)人文学科; [^]yshx;
humble: [-]/ˈhʌmbl/; [a]卑微的;(级别或地位)低下的,简陋的;谦逊的; [v]使⋯谦逊,使⋯卑下;轻松打败(尤指强大的对手); [^]yshx;
humdrum: [-]/ˈhʌmdrʌm/; [a]单调的;乏味的; [n]平凡;单调; [vi]单调乏味地进行; [^]yshx;
humidity: [-]/hjuːˈmɪdəti/; [n]潮湿;湿气;湿度; [^]yshx;
humiliate: [-]/hjuːˈmɪlieɪt/; [vt]使蒙耻;使丢脸;羞辱; [^]yshx;
hurl: [-]/hɜːrl/; [v]用力投掷; [n]猛投; [^]yshx;
hydrogen: [-]/ˈhaɪdrədʒən/; [n]氢,氢气; [^]yshx;
hygiene: [-]/ˈhaɪdʒiːn/; [n]卫生;卫生学;保健学; [^]yshx;
hypothesis: [-]/haɪˈpɑːθəsɪs/; [n]假说;假设; [^]yshx;
hysterical: [-]/hɪˈsterɪkl/; [a]歇斯底里的,情绪激动的; [^]yshx;
ideal: [-]/aɪˈdiːəl/; [a]理想的;完美的;空想的;观念的; [n]理想;典范;目标; [^]yshx;
identify: [-]/aɪˈdentɪfaɪ/; [v]认出,联系;识别;确定,鉴定,发现;认为.等同,认为.关系紧密;表明.的身份;认同,有共鸣,有同感; [^]yshx;
ideology: [-]/ˌaɪdiˈɑːlədʒi/; [n]意识形态,思想(体系); [^]yshx;
idiot: [-]/ˈɪdiət/; [n]愚蠢的人,白痴; [^]yshx;
idle: [-]/ˈaɪdl/; [a]空闲的;懒散的; [v]无所事事;虚度;空转;使空转; [vt]虚度; [^]yshx;
ignite: [-]/ɪɡˈnaɪt/; [v]点燃,发光,燃烧; [^]yshx;
ignorance: [-]/ˈɪɡnərəns/; [n]不知,不懂;愚昧,无知; [^]yshx;
illiterate: [-]/ɪˈlɪtərət/; [n]文盲,目不识丁者; [a]不识字的;缺乏(某方面)知识的;语法错误的; [^]yshx;
illuminate: [-]/ɪˈluːmɪneɪt/; [vt]照亮;阐释;说明; [^]yshx;
illusion: [-]/ɪˈluːʒn/; [n]假象,幻象;幻想;错误观念; [^]yshx;
illustrate: [-]/ˈɪləstreɪt/; [v]举例说明,阐明;图解,加插图; [^]yshx;
imaginative: [-]/ɪˈmædʒɪnətɪv/; [a]想象的;富于想象力的;虚构的; [^]yshx;
imitate: [-]/ˈɪmɪteɪt/; [v]模仿; [^]yshx;
immense: [-]/ɪˈmens/; [a]巨大的,广大的; [^]yshx;
immerse: [-]/ɪˈmɜːrs/; [v]沉浸,沉浸于;使陷入; [^]yshx;
immigrant: [-]/ˈɪmɪɡrənt/; [n]移民; [a]移民的;迁入的; [^]yshx;
imminent: [-]/ˈɪmɪnənt/; [a]迫近的,紧迫的,即将来临的; [^]yshx;
immune: [-]/ɪˈmjuːn/; [a]免疫的,有免疫力的;不受影响的;免除的; [^]yshx;
impact: [-]/ˈɪmpækt/; [n]碰撞,冲击;冲击力;影响; [v]冲击;压紧;产生影响;塞满; [^]yshx;
impair: [-]/ɪmˈper/; [v]损害;削弱; [^]yshx;
impart: [-]/ɪmˈpɑːrt/; [v]传授,给予,将(某性质)给予或赋予某事物; [^]yshx;
impede: [-]/ɪmˈpiːd/; [v]妨碍,阻碍; [^]yshx;
imperative: [-]/ɪmˈperətɪv/; [a]必要的;祈使的;急需的; [n]命令;必要的事;义务;驱使; [^]yshx;
impetus: [-]/ˈɪmpɪtəs/; [n]推动力;促进; [^]yshx;
implement: [-]/ˈɪmplɪment/; [n]工具;器具; [v]实施,执行;执行; [^]yshx;
impose: [-]/ɪmˈpoʊz/; [v]把.强加;强制实行,强迫接受; [^]yshx;
impressive: [-]/ɪmˈpresɪv/; [a]给人深刻印象的;引人注目的; [^]yshx;
impromptu: [-]/ɪmˈprɑːmptuː/; [a]一触即发的;即席的,即兴的; [ad]即席地,即兴地; [n]即兴之作; [^]yshx;
improvise: [-]/ˈɪmprəvaɪz/; [v]即席创作,临时凑成; [^]yshx;
impulse: [-]/ˈɪmpʌls/; [n]冲动,脉冲,驱使; [^]yshx;
in favour of: [-]/ɪn ˈfeɪvər ɑv/; prep. 赞成;以.为收款人; [^]yshx;
in hand: [-]/ɪn hænd/; [ad]可以动用的;在处理中;在控制中; [^]yshx;
in line for: [-]/ɪn laɪn fɔr/; [ad]即可得到;排队; [^]yshx;
in no time: [-]/ɪn noʊ taɪm/; [ad]立刻; [^]yshx;
in one's face: [-]/ɪn wʌnz feɪs/; [ad]公开地;当着某人的面; [^]yshx;
in one: [-]/ɪn wʌn/; [phr]成为一体;只试一次; [^]yshx;
in sb.'s favour: [-]/ɪn ˈsʌmbədiz ˈfeɪvər/; [phr]对某人有利;偏爱; [^]yshx;
in stock: [-]/ɪn stɒk/; [phr]有存货; [^]yshx;
in the air: [-]/ɪn ðə er/; [phr]在空中;悬而未决;在流传中; [^]yshx;
in the hands of: [-]/ɪn ðə hændz ʌv/; prep. 在.掌握中; [^]yshx;
in time: [-]/ɪn taɪm/; [ad]及时;总有一天; [^]yshx;
inaugurate: [-]/ɪˈnɔːɡjəreɪt/; [v]为..揭幕;为.举行就职典礼;开展; [^]yshx;
incidence: [-]/ˈɪnsɪdəns/; [n]发生率,入射角度; [^]yshx;
incipient: [-]/ɪnˈsɪpiənt/; [a]初期的;刚出现的; [^]yshx;
inclination: [-]/ˌɪnklɪˈneɪʃn/; [n]点头;做.的倾向;意愿;倾斜; [^]yshx;
incline: [-]/ɪnˈklaɪn/; [n]倾斜,斜坡,斜面; [v](使)倾斜,(使)倾向于; [^]yshx;
inclusive: [-]/ɪnˈkluːsɪv/; [a]包含..在内的,包罗广泛的; [^]yshx;
incorporate: [-]/ɪnˈkɔːrpəreɪt/; [v]包含;使并入; [^]yshx;
increment: [-]/ˈɪŋkrəmənt/; [n]增长;增值; [^]yshx;
incur: [-]/ɪnˈkɜːr/; [v]遭受;招致;引起; [^]yshx;
indemnity: [-]/ɪnˈdemnəti/; [n]赔偿物;补偿,赔偿;保障; [^]yshx;
indicative: [-]/ɪnˈdɪkətɪv/; [a]指示的;暗示的;陈述的; [n]陈述语气; [^]yshx;
indifferent: [-]/ɪnˈdɪfrənt/; [a]不感兴趣的,不关心的;平庸的;冷漠的; [^]yshx;
indigenous: [-]/ɪnˈdɪdʒənəs/; [a]土生土长的,本土的; [^]yshx;
indignant: [-]/ɪnˈdɪɡnənt/; [a]愤慨的,愤愤不平的; [^]yshx;
indispensable: [-]/ˌɪndɪˈspensəbl/; [a]必不可少的;必需的; [^]yshx;
individual: [-]/ˌɪndɪˈvɪdʒuəl/; [a]个别的,独特的;单独的; [n]独立的个体; [^]yshx;
induce: [-]/ɪnˈduːs/; [v]引导,劝诱,诱导; [^]yshx;
indulge: [-]/ɪnˈdʌldʒ/; [v]沉迷于;放纵;满足; [^]yshx;
inept: [-]/ɪˈnept/; [a]无能的;不称职的;笨拙的; [^]yshx;
inert: [-]/ɪˈnɜːrt/; [a]不动的,惰性的;行动迟钝的;无生气的; [^]yshx;
inevitable: [-]/ɪnˈevɪtəbl/; [a]不可避免的,必然的; [n]必然发生的事; [^]yshx;
infant: [-]/ˈɪnfənt/; [n]幼儿,婴儿; [a]婴儿的;初期的,初创的; [^]yshx;
infect: [-]/ɪnˈfekt/; [v]传染,感染;使受影响; [^]yshx;
inferior: [-]/ɪnˈfɪriər/; [a](等级,地位等)下等的,低等的;低劣的; [n]部下,地位低的人;次品; [^]yshx;
infest: [-]/ɪnˈfest/; [v]骚扰,寄生于,大批出没; [^]yshx;
infirmary: [-]/ɪnˈfɜːrməri/; [n]医院,医务室(尤指学校等附设的病房或配药处); [^]yshx;
inflation: [-]/ɪnˈfleɪʃn/; [n]通货膨胀;(充气后)膨胀;自负; [^]yshx;
inflict: [-]/ɪnˈflɪkt/; [v]使遭受(损伤,痛苦等);使承担(负担等); [^]yshx;
influx: [-]/ˈɪnflʌks/; [n]流入,涌入;河口; [^]yshx;
infringe: [-]/ɪnˈfrɪndʒ/; [v]侵犯,违反,侵害; [^]yshx;
ingenious: [-]/ɪnˈdʒiːniəs/; [a]聪明的;有发明天才的;有独创性的,别出心裁的; [^]yshx;
ingredient: [-]/ɪnˈɡriːdiənt/; [n](烹调的)原料;(构成的)要素,因素; [^]yshx;
inhabit: [-]/ɪnˈhæbɪt/; [v]居住于; [^]yshx;
inherent: [-]/ɪnˈhɪrənt/; [a]内在的,固有的;生来就有的; [^]yshx;
inherit: [-]/ɪnˈherɪt/; [v]经遗传而得(特性等);接受遗产;沿袭;继任; [^]yshx;
inhibit: [-]/ɪnˈhɪbɪt/; [v]阻碍;阻止,防止;抑制,约束; [^]yshx;
initial: [-]/ɪˈnɪʃl/; [a]第一的;最初的;开始的; [n]首字母; [^]yshx;
initiate: [-]/ɪˈnɪʃieɪt/; [v]开始,发动; [n]新加入组织的人; [^]yshx;
inject: [-]/ɪnˈdʒekt/; [v]给.注射;注入;引入;射入轨道; [^]yshx;
inland: [-]/ˈɪnlænd/; [ad]在内陆地; [a]内陆的,国内的; [n]内陆; [^]yshx;
innocent: [-]/ˈɪnəsnt/; [a]天真的,单纯的;无辜的,清白的;无恶意的; [n]天真无邪的人; [^]yshx;
innovation: [-]/ˌɪnəˈveɪʃn/; [n]创新,革新,新设施,新发明; [^]yshx;
innumerable: [-]/ɪˈnuːmərəbl/; [a]数不清的;无数的; [^]yshx;
inquire: [-]/ɪn'kwaɪər/; [v]打听,询问;调查; [^]yshx;
insane: [-]/ɪnˈseɪn/; [a]精神失常的,疯狂的;精神病患者的;荒唐的; [n]精神失常的人;精神错乱的人; [^]yshx;
insert: [-]/ɪnˈsɜːrt/; [vt]插入,嵌入; [n]插入物;插页; [^]yshx;
insight: [-]/ˈɪnsaɪt/; [n]深刻的理解,洞察力,见识; [^]yshx;
insipid: [-]/ɪnˈsɪpɪd/; [a]淡而无味的;枯燥乏味的; [^]yshx;
insolvent: [-]/ɪnˈsɑːlvənt/; [n]无力清偿债务者,破产者; [a]无清偿能力的,破产的; [^]yshx;
inspection: [-]/ɪnˈspekʃn/; [n]检查,细看; [^]yshx;
inspire: [-]/ɪnˈspaɪər/; [v]使生灵感;启示;激发,激励; [^]yshx;
install: [-]/ɪnˈstɔːl/; [v]安装,安置,使就职; [^]yshx;
instantaneous: [-]/ˌɪnstənˈteɪniəs/; [a]瞬间的;即刻的;猝发的; [^]yshx;
instinct: [-]/ˈɪnstɪŋkt/; [n]天性;本能;直觉; [a]充满的; [^]yshx;
insulate: [-]/ˈɪnsəleɪt/; [v]隔离,使隔绝(以免受到影响);使隔热; [^]yshx;
insult: [-]/ɪnˈsʌlt/; [v]侮辱,凌辱; [n]侮辱的言词或行为; [^]yshx;
insurance: [-]/ɪnˈʃʊrəns/; [n]保险;保险费;保险业;安全保证; [^]yshx;
intact: [-]/ɪnˈtækt/; [a]原封未动的,未受损的,完整无缺的; [^]yshx;
integral: [-]/ˈɪntɪɡrəl/; [a](用于构成整体)必需的,不可缺少的,必不可少的;基本的,作为组成部分的,内置的;整体的,完整的; [^]yshx;
integrity: [-]/ɪnˈteɡrəti/; [n]正直,真诚;完整; [^]yshx;
intellectual: [-]/ˌɪntəˈlektʃuəl/; [n]知识分子; [a]智力的;理智的;需用智力的;聪明的; [^]yshx;
intelligible: [-]/ɪnˈtelɪdʒəbl/; [a]可理解的,明白易懂的; [^]yshx;
intensify: [-]/ɪnˈtensɪfaɪ/; [v]增强;加剧; [^]yshx;
intent: [-]/ɪnˈtent/; [a]全神贯注的;专心致志的; [n]意图;意向;目的; [^]yshx;
interact: [-]/ˌɪntərˈækt/; [v]交流,沟通,互动;互相作用,互相影响; [^]yshx;
intermediate: [-]/ˌɪntərˈmiːdiət/; [a]中间的,居间的;中级的; [n]中间体,媒介物; [v]调解,干涉; [^]yshx;
interpret: [-]/ɪnˈtɜːrprɪt/; [v]口译;解释;把..理解为; [^]yshx;
interrogate: [-]/ɪnˈterəɡeɪt/; [v]审问,审讯; [^]yshx;
intersection: [-]/ˌɪntərˈsekʃn/; [n]交点,十字路口; [^]yshx;
interval: [-]/ˈɪntərvl/; [n]间隔;中场休息,幕间休息;间距; [^]yshx;
intimate: [-]/ˈɪntɪmət/; [a]亲密的,密切的;详细的; [v]暗示;宣布,通知; [n]密友,知己; [^]yshx;
intimidate: [-]/ɪnˈtɪmɪdeɪt/; [v]恫吓,威胁; [^]yshx;
intricate: [-]/ˈɪntrɪkət/; [a]错综复杂的; [^]yshx;
intrigue: [-]/ɪnˈtriːɡ/; [n]阴谋;诡计; [v]密谋;欺骗;引起极大兴趣; [^]yshx;
intrinsic: [-]/ɪnˈtrɪnsɪk/; [a]固有的; [^]yshx;
intuition: [-]/ˌɪntuˈɪʃn/; [n]直觉;感觉; [^]yshx;
inundate: [-]/ˈɪnʌndeɪt/; [v]淹没,泛滥; [^]yshx;
invade: [-]/ɪnˈveɪd/; [v]侵略;侵犯;侵害;涌入;渗透;侵略,侵犯; [^]yshx;
invalid: [-]/ɪnˈvælɪd/; [a]不能识别的;无效的;作废的,不能成立的; [n]病人,残疾人; [^]yshx;
invaluable: [-]/ɪnˈvæljuəbl/; [a]非常宝贵的,极为贵重的,无价的; [^]yshx;
invariably: [-]/ɪnˈveriəbli/; [ad]总是;不变地,永恒地; [^]yshx;
inventory: [-]/ˈɪnvəntɔːri/; [n]详细目录;存货清单; [^]yshx;
invert: [-]/ɪnˈvɜːrt/; [v]倒置;倒转;颠倒; [^]yshx;
invest: [-]/ɪnˈvest/; [v]投资,投入;赋予,给予; [^]yshx;
investigate: [-]/ɪnˈvestɪɡeɪt/; [v]调查,研究; [^]yshx;
invigilate: [-]/ɪnˈvɪdʒɪleɪt/; [v]监考;监视; [^]yshx;
invisible: [-]/ɪnˈvɪzəbl/; [a]看不见的,无形的; [^]yshx;
invoice: [-]/ˈɪnvɔɪs/; [n]发票; [v]开发票;记清单; [^]yshx;
involve: [-]/ɪnˈvɑːlv/; [v]牵涉,涉及;卷入,使参与;吸引;包含,需要,影响; [^]yshx;
irony: [-]/ˈaɪrəni/; [n]反语;冷嘲;具有讽刺意味的事; [^]yshx;
irrespective: [-]/ˌɪrɪˈspektɪv/; [a]不考虑的,不顾的; [^]yshx;
irrigation: [-]/ˌɪrɪˈɡeɪʃn/; [n]灌溉; [^]yshx;
irritate: [-]/ˈɪrɪteɪt/; [v]使烦躁;激怒;使难受; [^]yshx;
isle: [-]/aɪl/; [n]岛,小岛; [^]yshx;
isolate: [-]/ˈaɪsəleɪt/; [v]使隔离;使孤立; [a]孤立的;单独的; [^]yshx;
issue: [-]/ˈɪʃuː/; [n]问题;议题;发行物;子女; [v]发行;发布;分配,分发,给; [^]yshx;
item: [-]/ˈaɪtəm/; [n]物品;条,条款,项目; [^]yshx;
itinerary: [-]/aɪˈtɪnəreri/; [n]旅程,路线;旅行计划; [^]yshx;
ivory: [-]/ˈaɪvəri/; [n]象牙,象牙制品;乳白色; [^]yshx;
jagged: [-]/ˈdʒæɡɪd/; [a]锯齿状的,参差不齐的;锯齿状的; [^]yshx;
jail: [-]/dʒeɪl/; [n]监狱;看守所; [v]监禁;拘留; [^]yshx;
jam: [-]/dʒæm/; [n]果酱;阻塞; [v](使)阻塞,使塞满; [^]yshx;
janitor: [-]/ˈdʒænɪtər/; [n]看门人;清洁工; [^]yshx;
jealous: [-]/ˈdʒeləs/; [a]妒忌的,妒羡的; [^]yshx;
jeer: [-]/dʒɪr/; [n]嘲笑,戏弄,揶揄的言语; [v]嘲笑,戏弄; [^]yshx;
jeopardise: [-]/'dʒepədaɪz/; [v]使受危害,使陷险境; [^]yshx;
jog: [-]/dʒɑːɡ/; [v]慢跑;轻碰; [n]轻推,慢跑,漫步; [^]yshx;
jolt: [-]/dʒoʊlt/; [n]猛的一击,摇晃,震惊; [v](使)颠簸,摇晃;使震惊; [^]yshx;
journalist: [-]/ˈdʒɜːrnəlɪst/; [n]记者,新闻工作者; [^]yshx;
judicial: [-]/dʒuˈdɪʃl/; [a]司法的,法庭的,法律的,审判(上)的; [^]yshx;
jumble: [-]/ˈdʒʌmbl/; [n]混杂;混乱;待义卖的一堆旧什物; [v]使混乱;搞乱; [^]yshx;
junction: [-]/ˈdʒʌŋkʃn/; [n]连接,接合;接合处;路口; [^]yshx;
jungle: [-]/ˈdʒʌŋɡl/; [n]丛林,密林;危险地带;丛林音乐; [^]yshx;
junior: [-]/ˈdʒuːniər/; [a]年少的;下级的;低年级的; [n]年少者,晚辈;(美国四年制大学)三年级学生;职位较低者; [^]yshx;
junk: [-]/dʒʌŋk/; [n]废旧物品,垃圾,假货; [v]把.(当废物)丢弃; [^]yshx;
jury: [-]/ˈdʒʊri/; [n]陪审团;全体评审员,评判委员会; [^]yshx;
juvenile: [-]/ˈdʒuːvənl/; [n]青少年;雏鸟; [a]青少年的;幼稚的; [^]yshx;
keen: [-]/kiːn/; [a]敏锐的;热衷的,热心的;强烈的,渴望的; [v]恸哭; [n]〈英〉号哭,恸哭; [ad]如饥似渴地; [^]yshx;
keep an eye on: [-]/kiːp æn aɪɑːn/; [phr]密切注视; [^]yshx;
keep at: [-]/kip ət/; [v]不断地做; [^]yshx;
keep away (from): [-]/kiːp əˈweɪ frʌm/; [phr]远离,回避; [^]yshx;
keep in with sb.: [-]/kiːp ɪn wɪθ ˈsʌmbədi/; [phr]与(某人)友好相处; [^]yshx;
keep off: [-]/kip ɑf/; [phr]让开;不接近; [^]yshx;
keep on (doing sth.): [-]/kiːp ɔːn ˈduːɪŋ ˈsʌmθɪŋ/; [v]继续做某事; [^]yshx;
keep sb. (sth.) out (of): [-]/kiːp ˈsʌmbədi ˈsʌmθɪŋ aʊt ʌv/; [v]不让.入内; [^]yshx;
keep sb. down: [-]/kiːp ˈsʌmbədi daʊn/; [v]控制;为难;压制; [^]yshx;
keep sb. on: [-]/kiːp ˈsʌmbədi ɔːn/; [v]继续雇用某人; [^]yshx;
keep sb. up: [-]/kiːp ˈsʌmbədi ʌp/; [v]坚持,继续; [^]yshx;
keep sth. (back) from: [-]/kiːp ˈsʌmθɪŋ bæk frʌm/; [v]不让某事.;离开; [^]yshx;
keep sth. in mind: [-]/kiːp ˈsʌmθɪŋ ɪn maɪnd/; [v]记住; [^]yshx;
keep sth. to oneself: [-]/kiːp ˈsʌmθɪŋ tu wʌnˈself/; [v]不让他人分享,独自享用; [^]yshx;
keep to the beaten track: [-]/kip tu ðə ˈbit(ə)n træk/; [phr]循规蹈矩; [^]yshx;
keep to: [-]/kip tu/; [v]履行诺言;限制自己;坚持; [^]yshx;
kernel: [-]/ˈkɜːrnl/; [n]子粒,谷粒;核心; [^]yshx;
kidnap: [-]/ˈkɪdnæp/; [v]诱拐;绑架; [^]yshx;
kidney: [-]/ˈkɪdni/; [n]肾,腰子; [^]yshx;
kin: [-]/kɪn/; [n]亲属; [^]yshx;
kindle: [-]/ˈkɪndl/; [v]点燃,激起;着火;照亮;煽动; [^]yshx;
kit: [-]/kɪt/; [n]成套工具;工具箱;装备; [vt]装备; [^]yshx;
knit: [-]/nɪt/; [v]编结,针织; [n]编织的衣服;针织衫; [^]yshx;
knob: [-]/nɑːb/; [n]圆形把手,旋钮,圆形突出物; [v]突出;使有球形突出物;在.上生疖(长瘤);给(门等)装球形捏手; [^]yshx;
knot: [-]/nɑːt/; [n]绳结,结合,树的节; [v]打结; [^]yshx;
know better (than): [-]/noʊ ˈbetər ðən/; [v]很明白(而不至于); [^]yshx;
lace: [-]/leɪs/; [n]鞋带;花边; [v]加以修饰;结带子; [^]yshx;
laden: [-]/ˈleɪdn/; [a]装满的;负载的;苦恼的,沉重的; [^]yshx;
lag: [-]/læɡ/; [n]落后,延迟; [v]落后;缓慢进行,减退; [^]yshx;
lame: [-]/leɪm/; [a]跛的;瘸的;差劲的,乏味的;〔解释或借口〕无说服力的,站不住脚的,蹩脚的; [v](使)变跛; [^]yshx;
lament: [-]/ləˈment/; [v]哀悼;惋惜;悲叹; [n]悲叹;悼词; [^]yshx;
landscape: [-]/ˈlændskeɪp/; [n]风景;风景画;景观;横向打印格式; [v]美化环境; [^]yshx;
lane: [-]/leɪn/; [n]小径,巷,行车道; [^]yshx;
languid: [-]/ˈlæŋɡwɪd/; [a]没精打采的,倦怠的; [^]yshx;
lap: [-]/læp/; [n]腰以下及大腿的前面部分;(跑道的)一圈; [v](赛跑中)比(某人)领先一圈;轻拍; [^]yshx;
lapse: [-]/læps/; [n]失误,过失;行为失检;(时间)流逝; [v]退步,倒退,衰退;失效;背弃,放弃(宗教信仰); [^]yshx;
lash: [-]/læʃ/; [v]鞭打;猛烈抨击;捆绑;摆动;猛击; [n]鞭梢;鞭打; [^]yshx;
latent: [-]/ˈleɪtnt/; [a]潜在的,隐伏的,不易察觉的; [^]yshx;
later on: [-]/'leɪtər ɔn/; [ad]后来;稍后; [^]yshx;
lateral: [-]/ˈlætərəl/; [n]侧面部分;支线; [a]侧面的;横向的; [^]yshx;
latitude: [-]/ˈlætɪtuːd/; [n]纬度;地区;(言论,行动的)自由; [^]yshx;
laudable: [-]/ˈlɔːdəbl/; [a]值得称赞的; [^]yshx;
launch: [-]/lɔːntʃ/; [v]发射;出海;创办,开始从事; [n]发射,投放市场;(游艇,汽艇)下水;发行; [^]yshx;
laundry: [-]/ˈlɔːndri/; [n]洗衣;送洗的衣物;洗衣店;洗衣房; [^]yshx;
lavish: [-]/ˈlævɪʃ/; [a]奢华的;铺张浪费的; [v]浪费;慷慨给予; [^]yshx;
lawn: [-]/lɔːn/; [n]草地;草坪;(衣服用)细麻; [^]yshx;
lax: [-]/læks/; [a]松懈的;松弛的;<语>松弛元音的; [n]松元音;泻肚; [^]yshx;
lay (sth.) bare: [-]/leɪ ˈsʌmθɪŋ ber/; [phr]显示;揭露; [^]yshx;
lay (sth.) out: [-]/leɪ ˈsʌmθɪŋ aʊt/; [v]展示,摆开;布置,设计; [^]yshx;
lay bare: [-]/leɪ ber/; [phr]揭发;暴露;公开; [^]yshx;
lay sth. aside: [-]/leɪ ˈsʌmθɪŋ əˈsaɪd/; [phr]储蓄;放一边; [^]yshx;
layer: [-]/ler/; [n]层;层次;阶层; [v]把.分层堆放;借助压条法;将(头发)剪成不同层次; [^]yshx;
layman: [-]/ˈleɪmən/; [n]门外汉;俗人;外行; [^]yshx;
layoff: [-]/'leɪˌɔːf/; [n]活动停止期间;裁员;临时解雇;操作停止;失业期; [^]yshx;
layout: [-]/ˈleɪaʊt/; [n]布局;(版面)设计; [^]yshx;
leak: [-]/liːk/; [v]漏;泄露; [n]漏洞;泄漏,裂缝; [^]yshx;
leap: [-]/liːp/; [v]跳跃;暴涨; [n]跳跃;跳动;上涨; [^]yshx;
learn sth. the hard way: [-]/lɜːrn ˈsʌmθɪŋ ðə hɑːrd weɪ/; [phr]经过艰难困苦而学到; [^]yshx;
learn/know sth. by heart: [-]/lɜːrn noʊ ˈsʌmθɪŋ baɪ hɑːrt/; [phr]记住,背下; [^]yshx;
lease: [-]/liːs/; [v]出租,租得; [n]租约,租契; [^]yshx;
leave for: [-]/liv fɔr/; [v]动身去; [^]yshx;
leave off: [-]/liv ɑf/; [v](使)停止; [^]yshx;
leave sb. (sth.) alone: [-]/liːv ˈsʌmbədi ˈsʌmθɪŋ əˈloʊn/; [phr]不干涉某人(某事); [^]yshx;
leave sb. (sth.) behind: [-]/liːv ˈsʌmbədi ˈsʌmθɪŋ bɪˈhaɪnd/; [phr]忘带,留下; [^]yshx;
leave sth. (sb.) out: [-]/liːv ˈsʌmθɪŋ ˈsʌmbədi aʊt/; [phr]遗漏,不考虑; [^]yshx;
legal: [-]/ˈliːɡl/; [a]合法的,法定的;法律的; [^]yshx;
legitimate: [-]/lɪˈdʒɪtɪmət/; [a]合法的;合理的; [vt]使合法;授权;宣布..为合法; [^]yshx;
lenient: [-]/ˈliːniənt/; [a]宽大的,宽容的,仁慈的; [^]yshx;
lens: [-]/lenz/; [n]镜头;透镜;镜片;晶状体; [^]yshx;
let alone: [-]/let əˈloʊn/; [phr]听任;不打扰;更别说; [^]yshx;
let oneself go: [-]/let wʌnˈself ɡoʊ/; [v]尽情,情不自禁; [^]yshx;
let sb. down: [-]/let ˈsʌmbədi daʊn/; [n]使失望; [^]yshx;
lethal: [-]/ˈliːθl/; [a]致命的,致死的;杀伤性的; [n]致死因子; [^]yshx;
lever: [-]/ˈlevər/; [n]杠杆;控制杆;施加影响的手段; [v]用杠杆移动;撬开; [^]yshx;
levy: [-]/ˈlevi/; [v]征收(税等); [n]征税;税款; [^]yshx;
liable: [-]/ˈlaɪəbl/; [a](for)有责任的;有义务的;(to)有.倾向的;易于.的,有可能.; [^]yshx;
license: [-]/ˈlaɪsns/; [n]许可;执照; [v]许可,准许;发许可证; [^]yshx;
lick: [-]/lɪk/; [v]舔;卷烧;战胜;使无法理解;轻轻拍打; [vi]舔; [n]舔;舌头一次舔的量;狠揍; [^]yshx;
likelihood: [-]/ˈlaɪklihʊd/; [n]可能;可能性; [^]yshx;
likewise: [-]/ˈlaɪkwaɪz/; [ad]同样地,此外; [^]yshx;
limb: [-]/lɪm/; [n]肢体;臂;枝干;树枝; [v]肢解; [^]yshx;
limp: [-]/lɪmp/; [n]跛行; [vi]一瘸一拐地走,跛行;慢腾腾地进行; [a]无力的,无生气的;柔软的,软弱的; [^]yshx;
linear: [-]/ˈlɪniər/; [a]线的,线性的;直线的;长度的; [^]yshx;
linen: [-]/ˈlɪnɪn/; [n]亚麻桌布;亚麻布; [^]yshx;
liner: [-]/ˈlaɪnər/; [n]眼线笔;班轮;班机;内衬; [^]yshx;
linger: [-]/ˈlɪŋɡər/; [v]逗留,留恋; [^]yshx;
liquor: [-]/ˈlɪkər/; [n]酒;烈性酒;液剂; [^]yshx;
literacy: [-]/ˈlɪtərəsi/; [n]读写能力;识字;有文化;教养; [^]yshx;
literature: [-]/ˈlɪtrətʃər/; [n]文学;宣传册;文献; [^]yshx;
litter: [-]/ˈlɪtər/; [n]垃圾;杂乱; [v]乱丢; [^]yshx;
live it up: [-]/lɪv ɪt ʌp/; [v]过着逍遥的日子;狂欢一场; [^]yshx;
live on: [-]/liːv ɑːn/; [phr]以.为主食;靠.生活; [^]yshx;
live through: [-]/lɪv θru/; [phr]度过; [^]yshx;
live up to: [-]/lɪv ʌp tu/; [phr]不辜负;做到; [^]yshx;
live with: [-]/lɪv wɪθ/; [phr]接受,忍受;同居; [^]yshx;
livestock: [-]/ˈlaɪvstɑːk/; [n]家畜,牲畜; [^]yshx;
loaf: [-]/loʊf/; [n](一条)面包; [v]虚度光阴; [^]yshx;
loan: [-]/loʊn/; [n]贷款;暂借; [v]借贷; [^]yshx;
loath: [-]/loʊθ/; [a]不愿意的; [^]yshx;
locality: [-]/loʊˈkæləti/; [n]地区;地点;位置;方位; [^]yshx;
locomotive: [-]/ˌloʊkəˈmoʊtɪv/; [n]机车,火车头; [a]运动的; [^]yshx;
lodging: [-]/ˈlɑːdʒɪŋ/; [n]住所;寄宿;(大学生的)校外宿舍; [^]yshx;
lofty: [-]/ˈlɔːfti/; [a]极高的,巍峨的;崇高的;高傲的; [^]yshx;
log: [-]/lɔːɡ/; [n]原木;航海日志; [v]伐木;航行;记录;登录; [^]yshx;
logic: [-]/ˈlɑːdʒɪk/; [n]逻辑,推理;逻辑性;逻辑学; [^]yshx;
loll: [-]/lɑːl/; [vi]懒洋洋地倚靠;闲荡; [vt]懒洋洋地倚靠着;使悬垂; [^]yshx;
look after: [-]/lʊk ˈæftər/; [phr]照顾,照看; [^]yshx;
look at: [-]/lʊk ət/; [phr]看,浏览,检查; [^]yshx;
look back (on sth.): [-]/lʊk bæk ɒn ˈsʌmθɪŋ/; [phr]回顾; [^]yshx;
look down on: [-]/lʊk daʊn ɑːn/; [phr]轻视; [^]yshx;
look for: [-]/lʊk fɔr/; [phr]寻找;期待; [^]yshx;
look forward to: [-]/lʊk ˈfɔːrwərd tu/; [phr]盼望; [^]yshx;
look in (on sb.): [-]/lʊk ɪn ɔːn ˈsʌmbədi/; [v](顺便)看望; [^]yshx;
look into: [-]/lʊk ˈɪntu/; [v]研究;调查; [^]yshx;
look on (sb.) as: [-]/lʊk ɔːn ˈsʌmbədi æz/; [v]当作..看待; [^]yshx;
look one's best: [-]/lʊk wʌnz bɛst/; [v]表现出最好的状态; [^]yshx;
look out for sb.(sth.): [-]/lʊk aʊt fɔːrˈ sʌmbədi ˈsʌmθɪŋ/; [v]注意; [^]yshx;
look over: [-]/lʊk ˈoʊvər/; [phr]检查; [^]yshx;
look round: [-]/lʊk raʊnd/; [phr]四处看;寻找; [^]yshx;
look sth. up: [-]/lʊk ˈsʌmθɪŋ ʌp/; [phr]查字典; [^]yshx;
loom: [-]/luːm/; [n]织布机; [v]阴森地逼近;隐现;即将来临; [^]yshx;
loop: [-]/luːp/; [n](用线,绳,带等打成的)环;环状物;环线; [vi]成圈; [vt]打成环状; [^]yshx;
lose face: [-]/luz feɪs/; [phr]丢面子; [^]yshx;
lose heart: [-]/luz hɑrt/; [v]丧失信心; [^]yshx;
lose one's bearings: [-]/luːz wʌnz ˈberɪŋs/; [phr]迷失方向;不知所措; [^]yshx;
lottery: [-]/ˈlɑːtəri/; [n]彩票;碰运气的事,难算计的事;抽彩给奖法; [^]yshx;
lounge: [-]/laʊndʒ/; [n]候机室,休息室,酒吧间;沙发,躺椅;懒散的步子; [v](懒散地)倚,躺;闲逛; [^]yshx;
loyal: [-]/ˈlɔɪəl/; [a]忠心的;忠诚的; [n]效忠(君主)的臣民; [^]yshx;
lubricate: [-]/ˈluːbrɪkeɪt/; [v]使.润滑;给.加润滑油; [^]yshx;
lucid: [-]/ˈluːsɪd/; [a]明晰的;透明的;易懂的;头脑清楚的; [^]yshx;
lucrative: [-]/ˈluːkrətɪv/; [a]合算的;获利的;有利可图的; [^]yshx;
ludicrous: [-]/ˈluːdɪkrəs/; [a]荒谬的,可笑的,滑稽的; [^]yshx;
lull: [-]/lʌl/; [v]使平静,使安静,哄骗; [n]间歇,暂停,暂时平静; [^]yshx;
lump: [-]/lʌmp/; [n]团;肿块;粗笨的人;一小方块 (糖); [v]成团,成堆;使成块; [^]yshx;
lunar: [-]/ˈluːnər/; [a]月亮的; [^]yshx;
lure: [-]/lʊr/; [v]引诱;以诱饵吸引; [n]诱惑力;诱惑物;鱼饵; [^]yshx;
lurk: [-]/lɜːrk/; [n]潜伏,潜行; [vi]潜伏;潜藏;鬼鬼祟祟地走; [^]yshx;
luxury: [-]/ˈlʌkʃəri/; [a]奢侈的,豪华的; [n]奢侈,奢华; [^]yshx;
mackintosh: [-]/ˈmækɪntɑːʃ/; [n]雨衣,防水胶布; [^]yshx;
madden: [-]/ˈmædn/; [v]使发疯,使发狂; [^]yshx;
magistrate: [-]/ˈmædʒɪstreɪt/; [n]法官; [^]yshx;
magnanimous: [-]/mæɡˈnænɪməs/; [a]宽宏大量的,大度的;慷慨的; [^]yshx;
magnate: [-]/ˈmæɡneɪt/; [n]大人物;大亨,巨头;权贵; [^]yshx;
magnificent: [-]/mæɡˈnɪfɪsnt/; [a]华丽的,宏伟的,壮丽的; [^]yshx;
magnify: [-]/ˈmæɡnɪfaɪ/; [v]放大,扩大;夸大,夸张; [^]yshx;
magnitude: [-]/ˈmæɡnɪtuːd/; [n]巨大;震级;重要性;<数>量值; [^]yshx;
maiden: [-]/ˈmeɪdn/; [n](文学)少女,未嫁女子; [a]未婚的,处女的,初次的; [^]yshx;
maim: [-]/meɪm/; [v]使残废; [^]yshx;
maintain: [-]/meɪnˈteɪn/; [v]维持,保持;断言,宣称;供养,赡养; [^]yshx;
maize: [-]/meɪz/; [n]玉米; [a]黄色的,玉米色的; [^]yshx;
majestic: [-]/məˈdʒestɪk/; [a]威严的;雄伟的;壮丽的; [^]yshx;
majority: [-]/məˈdʒɔːrəti/; [n]多数,大多数,多数票;法定成年年龄; [^]yshx;
make (sth. )out: [-]/meɪk ˈsʌmθɪŋ aʊt/; [v]写;辨认出;理解;歪曲; [^]yshx;
make for sb.(sth.): [-]/meɪk fɔːr ˈsʌmbədi ˈsʌmθɪŋ/; [phr]有助于;促进;走向; [^]yshx;
make light of: [-]/meɪk laɪt ɑv/; [v]轻视; [^]yshx;
make off: [-]/meɪk ɑf/; [phr]逃走;离开;匆忙离开; [^]yshx;
make one's day: [-]/meɪk wʌnz deɪ/; [phr]使某人快活; [^]yshx;
make sb. out to be: [-]/meɪk ˈsʌmbədi aʊt tu bi/; [v]把.说成; [^]yshx;
make sb. up: [-]/meɪk ˈsʌmbədi ʌp/; [v]化妆; [^]yshx;
make sth. up: [-]/meɪk ˈsʌmθɪŋ ʌp/; [phr]补足;弥补;编造;虚构;组成;准备; [^]yshx;
make the best of a bad job: [-]/meɪk ðə best ɑv ə bæd dʒɑb/; [v]尽力把损失减少到最小; [^]yshx;
make the most of: [-]/meɪk ðə moʊst ɑv/; [v]充分利用; [^]yshx;
make up for: [-]/meɪk ʌp fɔr/; [v]补偿,弥补; [^]yshx;
make up with sb.: [-]/meɪk ʌp wɪθ ˈsʌmbədi/; [v]与.和解; [^]yshx;
making: [-]/ˈmeɪkɪŋ/; [n]制作,形成,发展; [^]yshx;
malice: [-]/ˈmælɪs/; [n]恶意,怨恨; [^]yshx;
malignant: [-]/məˈlɪɡnənt/; [a]恶性的,恶毒的,充满恨意的; [n]怀有恶意的人;保王党员; [^]yshx;
mall: [-]/mɔːl/; [n]购物商场; [^]yshx;
malleable: [-]/ˈmæliəbl/; [a](金属)可锻的;有延展性的;(性格)可训练的;易适应的; [^]yshx;
malnutrition: [-]/ˌmælnuːˈtrɪʃn/; [n]营养不良; [^]yshx;
maltreat: [-]/ˌmælˈtriːt/; [v]虐待;滥用; [^]yshx;
mammal: [-]/ˈmæml/; [n]哺乳动物; [^]yshx;
manacle: [-]/ˈmænəkl/; [v]上手铐,束缚; [n]手铐; [^]yshx;
mandatory: [-]/ˈmændətɔːri/; [a]命令的,强制性的; [^]yshx;
maneuver: [-]/məˈnʊvər/; [v]操纵; [n]操纵;花招;调遣;策略; [^]yshx;
mania: [-]/ˈmeɪniə/; [n]癫狂,狂热; [^]yshx;
manifest: [-]/ˈmænɪfest/; [a]显然的,明白无误的,明了的; [v]使显现,使显露,表明; [n]货单,旅客名单; [^]yshx;
manipulate: [-]/məˈnɪpjuleɪt/; [v]操纵,影响;正骨; [^]yshx;
mannerism: [-]/ˈmænərɪzəm/; [n](说话,举止等的)习气,癖性,矫揉造作; [^]yshx;
mansion: [-]/ˈmænʃn/; [n]官邸;巨宅;大厦; [^]yshx;
manual: [-]/ˈmænjuəl/; [n]手册;指南; [a]手的;手制的;手工的;体力的; [^]yshx;
manufacture: [-]/ˌmænjuˈfæktʃər/; [v]生产;制造; [n]制造,生产;制造业;(复)产品; [^]yshx;
manure: [-]/məˈnʊr/; [n]肥料; [v]施肥于;耕种; [^]yshx;
manuscript: [-]/ˈmænjuskrɪpt/; [n]手稿;底稿;手抄本; [^]yshx;
mar: [-]/mɑːr/; [v]毁坏,弄糟,玷污; [^]yshx;
marble: [-]/ˈmɑːrbl/; [n]大理石;(游戏用的)玻璃弹子; [^]yshx;
margin: [-]/ˈmɑːrdʒən/; [n]页边的空白,边缘;优势;利润; [^]yshx;
marine: [-]/məˈriːn/; [a]海洋的,航海的,海产的,海军的; [n]海军士兵; [^]yshx;
marital: [-]/ˈmærɪtl/; [a]婚姻的; [^]yshx;
maritime: [-]/ˈmærɪtaɪm/; [a]海事的,海上的,沿海的,近海的;海员的,水手的; [^]yshx;
martial: [-]/ˈmɑːrʃl/; [a]武术的;好战的;军事的; [^]yshx;
martyr: [-]/ˈmɑːrtər/; [n]烈士;受难者;乞怜者; [v]迫害,折磨; [^]yshx;
marvelous: [-]/ˈmɑːrvələs/; [a]非凡的;叹为观止的,令人惊奇的; [n]怪事; [^]yshx;
masculine: [-]/ˈmæskjəlɪn/; [a]男性的;男子气概的; [^]yshx;
mask: [-]/mæsk/; [n]面具;遮蔽物;伪装; [v]隐藏(感情);掩盖,掩饰,掩护;伪装; [^]yshx;
massacre: [-]/ˈmæsəkər/; [n]大屠杀,残杀;惨败; [v]屠杀;彻底击败; [^]yshx;
massive: [-]/ˈmæsɪv/; [a]巨大的;大规模的;大量的; [^]yshx;
maternal: [-]/məˈtɜːrnl/; [a]母亲的,母性的;母方的,母系的; [^]yshx;
mature: [-]/məˈtʃʊr/; [a]成熟的;到期的; [vt]使成熟; [vi]成熟; [^]yshx;
maximum: [-]/ˈmæksɪməm/; [n]最大值;最大限度; [a]最大的; [^]yshx;
meadow: [-]/ˈmedoʊ/; [n]草地; [^]yshx;
meagre: [-]/ˈmiːɡər/; [a]瘦的;贫弱的;贫乏的; [^]yshx;
measure: [-]/ˈmeʒər/; [v]测量;估量; [n]措施;方法;尺寸;量度标准; [^]yshx;
mechanism: [-]/ˈmekənɪzəm/; [n]机械装置;机制,机理,原理; [^]yshx;
medal: [-]/ˈmedl/; [n]奖牌;勋章; [v]授予奖章; [^]yshx;
meddle: [-]/ˈmedl/; [vi]干预,多管闲事; [^]yshx;
mediate: [-]/ˈmiːdieɪt/; [v]调解,调停,斡旋; [^]yshx;
mediocre: [-]/ˌmiːdiˈoʊkər/; [a]普通的;平凡的;中等的; [^]yshx;
meditate: [-]/ˈmedɪteɪt/; [v]考虑,沉思,冥想; [^]yshx;
medium: [-]/ˈmiːdiəm/; [a]中等的;适中的; [n]手段;媒介;材料; [^]yshx;
meek: [-]/miːk/; [a]温顺的,逆来顺受的;谦恭的; [n]温顺的人;谦恭的人; [^]yshx;
melancholy: [-]/ˈmelənkɑːli/; [n]忧郁,悲哀; [a]忧郁的,令人伤感的; [^]yshx;
melodious: [-]/məˈloʊdiəs/; [a]音调悦耳的;旋律优美的; [^]yshx;
memento: [-]/məˈmentoʊ/; [n]纪念品; [^]yshx;
menace: [-]/ˈmenəs/; [v]威胁,威吓; [n]威胁;具有危险性的人(或物); [^]yshx;
mentality: [-]/menˈtæləti/; [n]脑力;思想;心理; [^]yshx;
mercantile: [-]/ˈmɜːrkəntaɪl/; [a]商人的,商业的; [^]yshx;
mercenary: [-]/ˈmɜːrsəneri/; [n]外国雇佣兵;唯利是图者; [a]唯利是图的;雇佣的; [^]yshx;
mercy: [-]/ˈmɜːrsi/; [n]宽恕,仁慈,怜悯,恩惠; [^]yshx;
merge into: [-]/mɜrdʒ ˈɪntu/; [phr]合并;结合; [^]yshx;
merge: [-]/mɜːrdʒ/; [v]合并;融合; [^]yshx;
merit: [-]/ˈmerɪt/; [n]优点;价值;功绩; [v]值得;应得; [^]yshx;
mesh: [-]/meʃ/; [n]网,筛孔; [v]相啮合; [^]yshx;
mess: [-]/mes/; [n]凌乱状态,混乱状态;肮脏,污秽;困境;食堂;大量某物; [v]弄脏,弄乱;浪费时间,瞎闹; [^]yshx;
metabolism: [-]/məˈtæbəlɪzəm/; [n]新陈代谢; [^]yshx;
metaphor: [-]/ˈmetəfər/; [n]暗喻,隐喻; [^]yshx;
meteoric: [-]/ˌmiːtiˈɔːrɪk/; [a]流星的,转瞬即逝的,突然的; [^]yshx;
meteorology: [-]/ˌmiːtiəˈrɑːlədʒi/; [n]气象学; [^]yshx;
meticulous: [-]/məˈtɪkjələs/; [a]谨小慎微的;一丝不苟的; [^]yshx;
microbe: [-]/ˈmaɪkroʊb/; [n]微生物;细菌; [^]yshx;
microcosm: [-]/ˈmaɪkroʊkɑːzəm/; [n]微观世界,缩影; [^]yshx;
microfilm: [-]/ˈmaɪkroʊfɪlm/; [n]微缩胶片; [v]缩微拍摄; [^]yshx;
migrate: [-]/ˈmaɪɡreɪt/; [vi]迁徙;迁移,移往;迁移; [^]yshx;
mildew: [-]/ˈmɪlduː/; [vt]使发霉; [vi]发霉,长霉; [n]霉,霉菌; [a]发霉的; [^]yshx;
militant: [-]/ˈmɪlɪtənt/; [a]好战的,好暴力的; [n]激进分子,斗士; [^]yshx;
millennium: [-]/mɪˈleniəm/; [n]千禧年;太平盛世; [^]yshx;
mimic: [-]/ˈmɪmɪk/; [v]模仿,戏弄; [n]模仿者; [a]模拟的;假的,伪装的; [^]yshx;
mind one's own business: [-]/maɪnd wʌnz oʊn ˈbɪznəs/; [v]少管闲事;各人自扫门前雪; [^]yshx;
minimal: [-]/ˈmɪnɪməl/; [a]最低限度的; [^]yshx;
minimum: [-]/ˈmɪnɪməm/; [a]最少的,最低程度的; [n]最低限度,最小量; [^]yshx;
minister: [-]/ˈmɪnɪstər/; [v]给予援助,救助;照料,服侍; [n]部长,大臣;公使,外交使节;牧师; [^]yshx;
minority: [-]/maɪˈnɔːrəti/; [n]少数;少数民族;未成年; [a]构成少数的; [^]yshx;
mint: [-]/mɪnt/; [n]薄荷,薄荷糖,造币厂; [v]铸造(硬币); [^]yshx;
minus: [-]/ˈmaɪnəs/; prep. 减(去); [a]负的; [n]减号;劣势; [^]yshx;
miracle: [-]/ˈmɪrəkl/; [n]奇迹; [^]yshx;
mire: [-]/ˈmaɪər/; [n]泥沼,困境; [^]yshx;
misappropriate: [-]/ˌmɪsəˈproʊprieɪt/; [v]滥用,误用; [a]=inappropriate; [^]yshx;
mischance: [-]/ˌmɪsˈtʃæns/; [n]不幸,灾难; [^]yshx;
mischief: [-]/ˈmɪstʃɪf/; [n]伤害;恶作剧;顽皮; [^]yshx;
misdeed: [-]/ˌmɪsˈdiːd/; [n]不端行为,罪行; [^]yshx;
miserable: [-]/ˈmɪzrəbl/; [a]悲惨的,痛苦的;使人难受的;不快乐的,不友善的,暴躁的(人);极少的; [^]yshx;
misfortune: [-]/ˌmɪsˈfɔːrtʃuːn/; [n]不幸,灾祸; [^]yshx;
misgiving: [-]/ˌmɪsˈɡɪvɪŋ/; [n]疑虑; [vt]担忧;使.疑虑;害怕(misgive的变形); [^]yshx;
misguided: [-]/ˌmɪsˈɡaɪdɪd/; [a]被引入歧途的;被误导的; [v]使入歧途; [^]yshx;
mishap: [-]/ˈmɪshæp/; [n]不幸的事,灾祸;晦气; [^]yshx;
misrepresent: [-]/ˌmɪsˌreprɪˈzent/; [vi]作虚假陈述; [vt]歪曲;误传; [^]yshx;
missile: [-]/ˈmɪsl/; [n]导弹;投射出的物体或武器; [a]导弹的;可投掷的;用以发射导弹的; [^]yshx;
mission: [-]/ˈmɪʃn/; [n]任务,使命;代表团,使团; [vi]派遣..执行任务; [^]yshx;
mist: [-]/mɪst/; [n]薄雾,朦胧; [v]使模糊,下雾; [^]yshx;
misuse: [-]/ˌmɪsˈjuːs/; [v]误用;滥用; [n]误用;滥用; [^]yshx;
mitigate: [-]/ˈmɪtɪɡeɪt/; [v]减轻,缓和; [^]yshx;
mobilize: [-]/ˈmoʊbəlaɪz/; [v]动员起来;动员;鼓动起; [^]yshx;
mock: [-]/mɑːk/; [v]嘲笑;轻蔑,蔑视; [a]不真诚的;伪造的; [n]模拟考; [^]yshx;
mode: [-]/moʊd/; [n]模式;方式; [^]yshx;
moderate: [-]/ˈmɑːdərət/; [a]适度的,适中的,温和的,稳健的,中等的; [v]使减轻,使缓和; [n]温和主义者;稳健的人; [^]yshx;
modest: [-]/ˈmɑːdɪst/; [a]谦虚的,谦逊的;端庄的,羞怯的;不太大(或太贵,太重要)的,适度的; [^]yshx;
modify: [-]/ˈmɑːdɪfaɪ/; [v]改装,修改,更改;修饰,限定; [^]yshx;
module: [-]/ˈmɑːdʒuːl/; [n]组件,模件,(航天器的)舱;(组成一门课程的)独立单元; [^]yshx;
moist: [-]/mɔɪst/; [a](表面)潮湿的,湿润的; [^]yshx;
mold: [-]/moʊld/; [vt]塑造;使形成; [v]把..塑造成; [n]霉菌;模子;气质; [^]yshx;
molecule: [-]/ˈmɑːlɪkjuːl/; [n]分子,微粒; [^]yshx;
molest: [-]/məˈlest/; [v]骚扰,干扰; [^]yshx;
momentum: [-]/moʊˈmentəm/; [n](物理)动量;势头;动力; [^]yshx;
monarchy: [-]/ˈmɑːnərki/; [n]君主,最高统治者;君主政体;君主国; [^]yshx;
monetary: [-]/ˈmɑːnɪteri/; [a]货币的,金融的;金钱的; [^]yshx;
monitor: [-]/ˈmɑːnɪtər/; [n]显示器;监视器;班长; [v]监视;监督;监测; [^]yshx;
monologue: [-]/ˈmɑːnəlɔːɡ/; [n]独白,个人长篇演说; [^]yshx;
monopoly: [-]/məˈnɑːpəli/; [n]垄断;专卖;垄断商品;专卖商品; [^]yshx;
monotonous: [-]/məˈnɑːtənəs/; [a]单调的,无聊的; [^]yshx;
monsoon: [-]/ˌmɑːnˈsuːn/; [n]季雨,季风,大雨; [^]yshx;
monster: [-]/ˈmɑːnstər/; [n]怪物,怪兽,妖怪;巨兽,巨大的东西,庞然大物;极其残酷的人,恶人,恶魔;小恶棍,捣蛋鬼〔幽默用法〕; [a]巨大的;庞大的; [^]yshx;
moped: [-]/ˈmoʊped/; [n]机动脚踏车; [^]yshx;
morality: [-]/məˈræləti/; [n]道德,道德观;道德规范,伦理体系; [^]yshx;
morbid: [-]/ˈmɔːrbɪd/; [a]疾病的;(精神等)病态的;恐怖的; [^]yshx;
moreover: [-]/mɔːrˈoʊvər/; [ad]此外,而且; [^]yshx;
mortal: [-]/ˈmɔːrtl/; [a]必有一死的;致命的;极端的; [n]人类; [^]yshx;
mortgage: [-]/ˈmɔːrɡɪdʒ/; [n]按揭贷款,抵押贷款; [v]抵押; [^]yshx;
mosaic: [-]/moʊˈzeɪɪk/; [n]镶嵌细工,马赛克; [a]摩西的;拼花的; [vt]镶嵌;用马赛克装饰; [^]yshx;
motif: [-]/moʊˈtiːf/; [n]基本图案;主题,中心思想,<音>乐旨; [^]yshx;
motion: [-]/ˈmoʊʃn/; [n]运动,移动;手势;提议; [v]示意; [^]yshx;
motivate: [-]/ˈmoʊtɪveɪt/; [vt]激励;使有动机;促进;促动;激发..的积极性; [^]yshx;
motto: [-]/ˈmɑːtoʊ/; [n]座右铭;格言;箴言;口号; [^]yshx;
mount: [-]/maʊnt/; [v]登上;爬上;骑上;增长;组织,安排; [n]山;峰; [^]yshx;
mourn: [-]/mɔːrn/; [v]哀悼,哀伤; [^]yshx;
mucous: [-]/ˈmjuːkəs/; [a]黏液的,似黏液的; [^]yshx;
muddle: [-]/ˈmʌdl/; [n]混乱,杂乱,(头脑的)糊涂; [v](使)混乱,(使)迷惑,混淆; [a]引起困惑的;使人糊涂的;难以理解的; [^]yshx;
multiply: [-]/ˈmʌltɪplaɪ/; [v]乘;繁殖;增加; [^]yshx;
multitude: [-]/ˈmʌltɪtuːd/; [n]大量;众多;大批;群众; [^]yshx;
mundane: [-]/mʌnˈdeɪn/; [a]普通的,平凡的;单调的;现世的,世俗的; [^]yshx;
murmur: [-]/ˈmɜːrmər/; [v]低声说,低语;低声抱怨; [n]低语;喃喃说话声; [^]yshx;
muscular: [-]/ˈmʌskjələr/; [a]肌肉的;肌肉发达的;强有力的; [^]yshx;
mushroom: [-]/ˈmʌʃrʊm/; [n]蘑菇; [vi]迅速发展;采蘑菇; [^]yshx;
mustache: [-]/ˈmʌstæʃ/; [n]髭,小胡子;触须; [^]yshx;
muster: [-]/ˈmʌstər/; [vi]集合;聚集; [vt]集合;召集; [n]集合;集合人员; [^]yshx;
mutter: [-]/ˈmʌtər/; [n]低语;小声抱怨; [v]低声说;小声抱怨; [vt]低声说;抱怨地说; [^]yshx;
mutual: [-]/ˈmjuːtʃuəl/; [a]互相的;彼此的;共同的; [^]yshx;
myriad: [-]/ˈmɪriəd/; [n]无数;极大数量; [a]无数的; [^]yshx;
myth: [-]/mɪθ/; [n]神话;虚构的信念(或观念,理论);杜撰出来的人(或事物); [^]yshx;
mythology: [-]/mɪˈθɑːlədʒi/; [n]神话,神话学; [^]yshx;
naive: [-]/naɪˈiːv/; [a]天真的; [n]天真的人; [^]yshx;
naked: [-]/ˈneɪkɪd/; [a]裸体的,无遮蔽的; [^]yshx;
narcotic: [-]/nɑːrˈkɑːtɪk/; [n]麻醉药;镇静剂;毒品; [a]麻醉的;催眠的; [^]yshx;
narrative: [-]/ˈnærətɪv/; [n]叙述; [a]叙述的; [^]yshx;
nasty: [-]/ˈnæsti/; [a]令人讨厌的;严重的;恶劣的;下流的; [n](复数形式)令人不愉快或对人有害的事物; [^]yshx;
natal: [-]/ˈneɪtl/; [a]出生的;分娩的;与生俱来的; [^]yshx;
nausea: [-]/ˈnɔːziə/; [n]作呕,恶心; [^]yshx;
nautical: [-]/ˈnɔːtɪkl/; [a]航海的;海上的;海员的; [^]yshx;
naval: [-]/ˈneɪvl/; [a]海军的,军舰的; [^]yshx;
navigable: [-]/ˈnævɪɡəbl/; [a](江河,海洋)可航行的,可通航的;(船)适航的; [^]yshx;
neat: [-]/niːt/; [a]整洁的;灵巧的;纯的;不掺水的;干净利索的 (行动); [^]yshx;
neglect: [-]/nɪˈɡlekt/; [v]忽视;忽略;疏忽; [n]疏忽;忽视; [^]yshx;
negotiable: [-]/nɪˈɡoʊʃiəbl/; [a]可谈判的,可商议的;可兑换现金的;可通行的(道路,河流); [^]yshx;
neurosis: [-]/nʊˈroʊsɪs/; [n]<心理>神经症,神经衰弱症; [^]yshx;
neurotic: [-]/nʊˈrɑːtɪk/; [a]神经质的;神经官能病的; [n]神经病患者; [^]yshx;
neutralize: [-]/ˈnuːtrəlaɪz/; [v]宣布中立,使中立化;使无效;中和; [^]yshx;
nevertheless: [-]/ˌnevərðəˈles/; [ad]然而,不过;尽管如此,不过,仍然; [^]yshx;
nibble: [-]/ˈnɪbl/; [v]一点点地咬,慢慢啃,吹毛求疵; [n]细咬,轻咬,啃; [^]yshx;
nicety: [-]/ˈnaɪsəti/; [n]细节,讲究; [^]yshx;
nickel: [-]/ˈnɪkl/; [n]镍;美国五分镍币;五分钱; [^]yshx;
nil: [-]/nɪl/; [n]零;无; [^]yshx;
nobility: [-]/noʊˈbɪləti/; [n]贵族;高贵;高尚;高尚的精神; [^]yshx;
nominal: [-]/ˈnɑːmɪnl/; [a]名义上的;象征性的,很少的;名词性的; [^]yshx;
nominate sb. for: [-]/ˈnɑːmɪneɪt ˈsʌmbədi fɔːr/; [v]提名,推荐; [^]yshx;
nominate: [-]/ˈnɑːmɪneɪt/; [v]提名;任命; [a]有特定名字的;被提名的;被指定的; [^]yshx;
norm: [-]/nɔːrm/; [n]准则;模范;规范,标准; [^]yshx;
nostalgia: [-]/nəˈstældʒə/; [n]怀旧之情,思乡病; [^]yshx;
not to say: [-]/nɑːt tə seɪ/; [phr]并不是说; [^]yshx;
notable: [-]/ˈnoʊtəbl/; [n]著名人士; [a]值得注意的,显著的,显要的; [^]yshx;
notary: [-]/ˈnoʊtəri/; [n]公证人;公证员; [^]yshx;
notation: [-]/noʊˈteɪʃn/; [n]记号;标记法;记录; [^]yshx;
notch: [-]/nɑːtʃ/; [n]刻痕,凹口;等级;峡谷; [v]赢得;用刻痕计算;在.上刻凹痕; [^]yshx;
nothing to do with: [-]/ˈnʌθɪŋ tu doʊ wɪθ/; [v]与.无关; [^]yshx;
notify: [-]/ˈnoʊtɪfaɪ/; [v]通知,告知;报告; [^]yshx;
notion: [-]/ˈnoʊʃn/; [n]概念,观念;观点,看法;突然的念头;意图; [^]yshx;
notorious: [-]/noʊˈtɔːriəs/; [a]臭名昭著的,声名狼藉的; [^]yshx;
nought: [-]/nɔːt/; [n]无;零; [^]yshx;
nourish: [-]/ˈnɜːrɪʃ/; [v]养育;培育(希望);增强(希望); [^]yshx;
nourishment: [-]/ˈnɜːrɪʃmənt/; [n]食物,营养品; [^]yshx;
novel: [-]/ˈnɑːvl/; [n]小说,长篇故事; [a]新奇的,新颖的,不同的; [^]yshx;
novice: [-]/ˈnɑːvɪs/; [n]生手,新手; [^]yshx;
nowhere: [-]/ˈnoʊwer/; [ad]任何地方都不;没有任何地方,无处;找不到;在不重要的地方;突然(发生); [n]无名之地;任何地方; [^]yshx;
noxious: [-]/ˈnɑːkʃəs/; [a]有害的,有毒的; [^]yshx;
nuance: [-]/ˈnuːɑːns/; [n]细微差别; [^]yshx;
nucleus: [-]/ˈnuːkliəs/; [n]原子核,核心,细胞核; [^]yshx;
nuisance: [-]/ˈnuːsns/; [n]讨厌的人;麻烦事;伤害; [^]yshx;
null and void: [-]/nʌl ənd vɔɪd/; [phr]无效的; [^]yshx;
null: [-]/nʌl/; [a]无效的;不存在的; [n]零; [^]yshx;
nullify: [-]/ˈnʌlɪfaɪ/; [v]使无效,废弃,取消; [^]yshx;
numb: [-]/nʌm/; [a]麻木的,失去知觉的; [vt]使麻木,使失去知觉; [^]yshx;
numerate: [-]/ˈnuːmərət/; [v]列举;读(数); [a]有计算能力的,数学基础好的; [^]yshx;
numerical: [-]/nuːˈmerɪkl/; [a]数字的,用数字表示的; [^]yshx;
numerous: [-]/ˈnuːmərəs/; [a]为数众多的,许多的; [^]yshx;
nursery: [-]/ˈnɜːrsəri/; [n]托儿所;保育室;苗圃; [^]yshx;
nurture: [-]/ˈnɜːrtʃər/; [v]养育,培育;培植; [n]养育,培养;教养;营养物; [^]yshx;
nutrition: [-]/nuˈtrɪʃn/; [n]营养,营养学; [^]yshx;
nylon: [-]/ˈnaɪlɑːn/; [n]尼龙,尼龙长袜; [^]yshx;
oar: [-]/ɔːr/; [n]桨,橹; [^]yshx;
oasis: [-]/oʊˈeɪsɪs/; [n]绿洲;令人欣慰的事物; [^]yshx;
oath: [-]/oʊθ/; [n]誓言;誓约;咒骂;咒语; [^]yshx;
obedient: [-]/oʊˈbiːdiənt/; [a]服从的,顺从的;孝顺的; [^]yshx;
objective: [-]/əbˈdʒektɪv/; [n]目标;目的; [a]客观的; [^]yshx;
obligatory: [-]/əˈblɪɡətɔːri/; [a]强制性的;义务的;必须的; [^]yshx;
oblige: [-]/əˈblaɪdʒ/; [v]迫使,使感激,施恩于,帮忙,使.成为必要; [^]yshx;
oblique: [-]/əˈbliːk/; [a]斜的,非直角的,隐射的; [v]倾斜; [n]<解>斜肌(尤指腹部的肌肉);倾斜物;<军>倾斜航空照片; [ad]<军>以45度角; [^]yshx;
oblivious: [-]/əˈblɪviəs/; [a]不在意的;忘却的,健忘的; [^]yshx;
oblong: [-]/ˈɑːblɔːŋ/; [n]长方形,椭圆形; [a]椭圆形的;长方形的; [^]yshx;
obnoxious: [-]/əbˈnɑːkʃəs/; [a]非常讨厌的;可憎的; [^]yshx;
obscene: [-]/əbˈsiːn/; [a]下流的,淫秽的; [^]yshx;
obscure: [-]/əbˈskjʊr/; [v]隐藏,使.模糊;使变暗;遮掩; [a]不清楚的;难以理解的; [n]某种模糊的或不清楚的东西; [^]yshx;
observance: [-]/əbˈzɜːrvəns/; [n](法律习俗等的)遵守;奉行;庆祝,礼仪,仪式; [^]yshx;
observatory: [-]/əbˈzɜːrvətɔːri/; [n]天文台,气象台,瞭望台; [^]yshx;
obsess: [-]/əbˈses/; [vt]迷住,使着迷,使烦扰; [^]yshx;
obsolete: [-]/ˌɑːbsəˈliːt/; [a]已过时的;已废弃的; [v]使过时;使作废; [n]废词;被废弃的事物; [^]yshx;
obstacle: [-]/ˈɑːbstəkl/; [n]障碍;障碍物;妨碍; [^]yshx;
obstinate: [-]/ˈɑːbstɪnət/; [a]顽固的;较难治愈的; [^]yshx;
obstruct: [-]/əbˈstrʌkt/; [v]阻碍,妨碍,阻塞,堵塞; [^]yshx;
obvious: [-]/ˈɑːbviəs/; [a]明显的,显然的;了无新意的;显而易见的; [^]yshx;
occasion: [-]/əˈkeɪʒn/; [n]场合,时候;活动;时机,机会; [v]导致;引起; [^]yshx;
occupy: [-]/ˈɑːkjupaɪ/; [v]占领,占据,侵占;住在,居住,住进;担任(职务),任职;占用(时间,空间等),占有;使用(房屋,建筑); [^]yshx;
occur: [-]/əˈkɜːr/; [vi]发生;出现,存在; [^]yshx;
odd: [-]/ɑːd/; [a]奇怪的;古怪的;奇数的;多种多样的;临时的; [n]奇特的事物;怪人;<高尔夫球>多于对方的一次击球; [ad](用于数字后)大约,左右,略多; [^]yshx;
odor: [-]/ˈoʊdər/; [n]气味; [^]yshx;
odyssey: [-]/ˈɑːdəsi/; [n]长途冒险旅行;一连串的冒险;奥德赛; [^]yshx;
off-hand: [-]/'ɔːfh'ænd/; [a]不拘礼节的;临时的,未经准备的; [ad]当即,立即; [^]yshx;
offend: [-]/əˈfend/; [v]冒犯,得罪,伤害.的感情; [^]yshx;
offer: [-]/ˈɔːfər/; [n]提供;特价;出价;录取(用)通知书;提议; [vt]给予,奉上;表示愿意 (做某事);提供;出价; [^]yshx;
offset: [-]/ˈɔːfset/; [v]抵消; [a]胶印的,透印版印刷的; [n]分支;抵销; [^]yshx;
offshore: [-]/ˌɔːfˈʃɔːr/; [a]近海的,海岸的;(公司) 设在海外的; [ad]离岸地,近海地; [^]yshx;
offspring: [-]/ˈɔːfsprɪŋ/; [n]后代; [^]yshx;
omen: [-]/ˈoʊmən/; [n]征兆,预兆; [vt]预示;预告;有.的前兆; [^]yshx;
ominous: [-]/ˈɑːmɪnəs/; [a]不祥的,不吉利的; [^]yshx;
omit: [-]/əˈmɪt/; [v]删去,省去,忽略;遗漏; [^]yshx;
on account of: [-]/ɑːn ə'kaʊnt əv/; [phr]因为; [^]yshx;
on and off: [-]/ɔn ənd ɑf/; quant. 断断续续地; [^]yshx;
on and on: [-]/ɔn ənd ɔn/; [phr]继续不停地; [^]yshx;
on behalf of: [-]/ɔn bɪˈhæf ɑv/; [phr]代表.,为了.; [^]yshx;
on end: [-]/ɔn end/; [ad]直立; [^]yshx;
on hand: [-]/ɔn hænd/; [ad]手头现有; [^]yshx;
on no account: [-]/ɔn noʊ əˈkaʊnt/; [ad]决不; [^]yshx;
on the air: [-]/ɔn ðə er/; [phr]直播中; [^]yshx;
on time: [-]/ɑːn taɪm/; [ad]准时; [^]yshx;
once (and) for all: [-]/wʌns ənd fɔːr ɔːl/; [ad]只此一次,彻底地; [^]yshx;
once more: [-]/wʌns mɔr/; [ad]再一次; [^]yshx;
one another: [-]/ˌwʌn əˈnʌðər/; [pron]彼此; [^]yshx;
ongoing: [-]/ˈɑːnɡoʊɪŋ/; [n]进行,前进,发展; [a]进行中的,不间断的; [^]yshx;
onset: [-]/ˈɑːnset/; [n]开始;攻击,袭击; [^]yshx;
opaque: [-]/oʊˈpeɪk/; [a]不透明的;难懂的; [^]yshx;
open one's eyes to: [-]/ˈoʊpən wʌnz aɪz tu/; [phr]使某人看清; [^]yshx;
opening: [-]/ˈoʊpnɪŋ/; [n]开口;孔;开始;开幕;职位空缺; [a]开始的,开场的; [^]yshx;
opinion: [-]/əˈpɪnjən/; [n]意见,看法,主张; [^]yshx;
opportunity: [-]/ˌɑːpərˈtuːnəti/; [n]机会,良机; [^]yshx;
oppose: [-]/əˈpoʊz/; [v]反对;反抗; [^]yshx;
opposite: [-]/ˈɑːpəzɪt/; [a]相反的;对立的;对面的; [ad]对立地;反面地; [n]对立物;反义词; prep. 与.相对;在.对面;与.合演;与.联袂演出; [^]yshx;
opt: [-]/ɑːpt/; [v]选择; [^]yshx;
optimism: [-]/ˈɑːptɪmɪzəm/; [n]乐观,乐观主义; [^]yshx;
optimum: [-]/ˈɑːptɪməm/; [a]最适宜的;最佳的; [n]最适条件;最适宜; [^]yshx;
orbit: [-]/ˈɔːrbɪt/; [v]环绕..的轨道运行; [n]轨道; [vi]环绕..的轨道运行; [^]yshx;
orchestra: [-]/ˈɔːrkɪstrə/; [n]管弦乐队; [a]管弦乐队的; [^]yshx;
ordeal: [-]/ɔːrˈdiːl/; [n]严峻考验,苦难的经历,折磨; [^]yshx;
orderly: [-]/ˈɔːrdərli/; [a]有秩序的,整齐的,有条不紊的; [^]yshx;
ore: [-]/ɔːr/; [n]矿石;矿砂;矿,矿石; [^]yshx;
organ: [-]/ˈɔːrɡən/; [n]器官;风琴; [^]yshx;
organism: [-]/ˈɔːrɡənɪzəm/; [n]生物,有机体;有机的组织; [^]yshx;
oriental: [-]/ˌɔːriˈentl/; [a]东方的; [n]东方人; [^]yshx;
orientate oneself: [-]/ˈɔriənˌteɪt wʌnˈself/; [v]确认方位,地址; [^]yshx;
orientate: [-]/ˈɔːriənteɪt/; [v]给.定位;使适应; [^]yshx;
original: [-]/əˈrɪdʒənl/; [a]有独创性的,原始的,最初的,新颖的; [n]原件;怪人; [^]yshx;
originate: [-]/əˈrɪdʒɪneɪt/; [vi]起源;开始; [vt]开创; [^]yshx;
ornament: [-]/ˈɔːrnəmənt/; [n]装饰; [v]装饰; [^]yshx;
orthodox: [-]/ˈɔːrθədɑːks/; [a]正统的;传统的;(Orthodox)东正教的; [^]yshx;
ostensible: [-]/ɑːˈstensəbl/; [a]表面上的,伪装的; [^]yshx;
ostentation: [-]/ˌɑːstenˈteɪʃn/; [n]卖弄,炫耀; [^]yshx;
oust: [-]/aʊst/; [v]罢免,驱逐,剥夺,取代; [^]yshx;
out of line (with): [-]/aʊt ʌv laɪn wɪθ/; [phr]跟.(不)一致; [^]yshx;
out of stock: [-]/aʊt ɑv stɒk/; [v]无存货,已脱销; [^]yshx;
outbreak: [-]/ˈaʊtbreɪk/; [n](战争,叛乱,感情等的)爆发;突然发生; [vi]爆发; [^]yshx;
outcast: [-]/ˈaʊtkæst/; [n]被逐出者;流浪者; [a]被抛弃的,被逐出的; [^]yshx;
outcome: [-]/ˈaʊtkʌm/; [n]结果,后果; [^]yshx;
outcry: [-]/ˈaʊtkraɪ/; [n]大声喊叫;强烈抗议;拍卖; [^]yshx;
outdated: [-]/ˌaʊtˈdeɪtɪd/; [a]过时的,老式的;落伍的; [^]yshx;
outfit: [-]/ˈaʊtfɪt/; [n]装备,全部用品,(协同工作)的一组人; [v]提供装备; [^]yshx;
outlaw: [-]/ˈaʊtlɔː/; [n]歹徒,逃犯,丧失公权者; [v]将..放逐,宣布..为不合法; [^]yshx;
outlet: [-]/ˈaʊtlet/; [n]出口;插座;表现机会,发泄方法;廉价经销店; [^]yshx;
outline: [-]/ˈaʊtlaɪn/; [n]外形,轮廓;大纲,概要; [v]描绘,画出..的轮廓; [^]yshx;
outlying: [-]/ˈaʊtlaɪɪŋ/; [a]远离中心的;边远的; [^]yshx;
output: [-]/ˈaʊtpʊt/; [n]产量,输出; [vt]生产,出产,制造;输出; [vi]生产,出产,制造;输出; [^]yshx;
outrageous: [-]/aʊtˈreɪdʒəs/; [a]粗暴的,无礼的; [^]yshx;
outright: [-]/ˈaʊtraɪt/; [a]完全的,彻底的,全部地;直率的; [ad]完全地;直率地,痛快地;直截了当地; [^]yshx;
outset: [-]/ˈaʊtset/; [n]开始,开端; [^]yshx;
outskirts: [-]/ˈaʊtskɜːrts/; [n](尤指城市)郊区; [^]yshx;
outspoken: [-]/aʊtˈspoʊkən/; [a]直言的,坦率的; [^]yshx;
outweigh: [-]/ˌaʊtˈweɪ/; [v]比..重要;比..有价值;比.重; [^]yshx;
oval: [-]/ˈoʊvl/; [a]椭圆形的; [n]椭圆形; [^]yshx;
ovation: [-]/oʊˈveɪʃn/; [n]热烈欢迎,欢呼; [^]yshx;
overall: [-]/ˌoʊvərˈɔːl/; [a]全面的,全部的; [n]罩衫,工装裤; [ad]总的来说;总共; [^]yshx;
overcome: [-]/ˌoʊvərˈkʌm/; [v]战胜;克服;压倒;得胜,征服; [^]yshx;
overdue: [-]/ˌoʊvərˈduː/; [a]过期的;迟到的;未兑的; [^]yshx;
overflow: [-]/ˌoʊvərˈfloʊ/; [v]满得外溢,外流,泛滥;充满,洋溢; [n]溢流口,溢流管;容纳不下的物(或人);溢出,满出;超出额; [a]充满的; [^]yshx;
overhaul: [-]/ˌoʊvərˈhɔːl/; [n]大修;全面检查;彻底革新; [vt]解体检修,大修;彻底革新; [^]yshx;
overhear: [-]/ˌoʊvərˈhɪr/; [v]无意中听到,偷听到; [^]yshx;
overlap: [-]/ˌoʊvərˈlæp/; [n]重叠,重复; [v](部分地)重叠; [^]yshx;
overlook: [-]/ˌoʊvərˈlʊk/; [v]忽视,未注意到;眺望,俯视; [n]忽视,远眺; [^]yshx;
overrule: [-]/ˌoʊvərˈruːl/; [v]否决,驳回;统治;对...施加影响; [^]yshx;
overrun: [-]/ˈoʊvərʌn/; [v]溢出,泛滥;(侵略军)横行; [n]泛滥成灾;超出限度; [^]yshx;
oversee: [-]/ˌoʊvərˈsiː/; [v]监督;偷看到,无意中看到;审查;俯瞰; [^]yshx;
overt: [-]/oʊˈvɜːrt/; [a]明显的;公开的;公然的; [^]yshx;
overtake: [-]/ˌoʊvərˈteɪk/; [v]超过,赶上;突然降临; [^]yshx;
overture: [-]/ˈoʊvərtʃər/; [n]主动表示,姿态;前奏曲;序言,事件的开端;提出问题; [vt]作为一种主动姿态提出;向.提出建议; [^]yshx;
overwhelm: [-]/ˌoʊvərˈwelm/; [v]压垮;不知所措;淹没;打败,压倒; [^]yshx;
overwrought: [-]/ˌoʊvərˈrɔːt/; [a]过分紧张的,过度兴奋的; [^]yshx;
owe: [-]/oʊ/; [v]感谢;欠;把.归于;占有;欠钱; [^]yshx;
ownership: [-]/ˈoʊnərʃɪp/; [n]所有权; [^]yshx;
pace: [-]/peɪs/; [n]速度;步,步伐; [v]踱步; [^]yshx;
pad: [-]/pæd/; [n]衬垫;护具;便笺簿;(动物的)脚;浮叶; [v]填塞; [^]yshx;
paddle: [-]/ˈpædl/; [n]桨; [v]用脚(手)划水,荡桨; [^]yshx;
pageant: [-]/ˈpædʒənt/; [n]盛会,历史剧,选美; [^]yshx;
painstaking: [-]/ˈpeɪnzteɪkɪŋ/; [a](不辞)劳苦的,辛勤的; [n]辛劳,煞费苦心; [^]yshx;
palatable: [-]/ˈpælətəbl/; [a]美味的,合口味的,合心意的; [^]yshx;
palm: [-]/pɑːm/; [n]手掌,手心,棕榈树; [^]yshx;
palpitate: [-]/ˈpælpɪteɪt/; [v](心脏)悸动,发抖; [^]yshx;
pamper: [-]/ˈpæmpər/; [v]纵容,过分关怀,精心照料; [^]yshx;
pamphlet: [-]/ˈpæmflət/; [n]小册子; [^]yshx;
panel: [-]/ˈpænl/; [n]讨论小组;仪表板;面,板; [v]嵌镶; [^]yshx;
panic: [-]/ˈpænɪk/; [n]恐慌;惊慌;慌乱; [v](使)恐慌;使..惊慌失措; [a]恐慌的,惊慌的; [^]yshx;
panorama: [-]/ˌpænəˈræmə/; [n]全景,概观; [^]yshx;
pant: [-]/pænt/; [v]喘息;气喘吁吁地说;喘气; [n]喘气; [^]yshx;
pants: [-]/pænts/; [n]裤子,短裤; [^]yshx;
parachute: [-]/ˈpærəʃuːt/; [n]降落伞; [v]跳伞; [^]yshx;
parade: [-]/pəˈreɪd/; [n]游行,检阅; [v]游行,(使)列队行进,炫耀; [^]yshx;
paradise: [-]/ˈpærədaɪs/; [n]天国;天堂;极乐世界; [^]yshx;
paradox: [-]/ˈpærədɑːks/; [n]矛盾;似矛盾而正确的说法; [^]yshx;
parallel: [-]/ˈpærəlel/; [a]平行的;相似的; [n]相似物;平行线; [v]与..相似;与..匹配; [ad]并行地,平行地; [^]yshx;
paralyze: [-]/ˈperəˌlaɪz/; [vt]使瘫痪;使麻痹;使不能活动; [^]yshx;
paramount: [-]/ˈpærəmaʊnt/; [n]元首;最高; [a]最高的,至上的,首要的; [^]yshx;
paranoia: [-]/ˌpærəˈnɔɪə/; [n](心理)偏执狂,多疑症; [^]yshx;
paraphrase: [-]/ˈpærəfreɪz/; [v]解释,释义; [n]转述,释义; [^]yshx;
parasite: [-]/ˈpærəsaɪt/; [n]寄生虫;靠他人为生的人; [^]yshx;
parliament: [-]/ˈpɑːrləmənt/; [n]议会;国会; [^]yshx;
partial: [-]/ˈpɑːrʃl/; [a]偏爱的,特别喜欢的;偏袒的,不公平的,有偏见的;部分的;不完全的; [n]<数学>偏微商; [^]yshx;
participate: [-]/pɑːrˈtɪsɪpeɪt/; [v]参与,加入; [^]yshx;
particle: [-]/ˈpɑːrtɪkl/; [n]粒子,微粒;<语>小品词; [^]yshx;
pass away: [-]/pæs əˈweɪ/; [v]死,逝世; [^]yshx;
pass off: [-]/pæs ɑf/; [v]冒充,误导使把.当做.;发生; [^]yshx;
pass on: [-]/pæs ɔn/; [phr]传给;去世; [^]yshx;
pass over: [-]/pæs ˈoʊvər/; [v]忽略;不注意; [^]yshx;
pass sb. (sth.) by: [-]/pæs ˈsʌmbədi ˈsʌmθɪŋ baɪ/; [phr]经过,走过;打..旁边走过;忽视; [^]yshx;
pass sth. off: [-]/pæs ˈsʌmθɪŋ ɔːf/; [phr]冒充,假装;蒙混过去,敷衍过去,搪塞过去; [^]yshx;
pass sth. on to: [-]/pæs ˈsʌmθɪŋ ɔːn tu/; [v]把.交给.; [^]yshx;
pass the time of day with: [-]/pæs ðə taɪm ɑv deɪ wɪθ/; [v]交谈;共渡; [^]yshx;
passion: [-]/ˈpæʃn/; [n]激情; [^]yshx;
passive: [-]/ˈpæsɪv/; [a]被动的;消极的; [n]被动语态; [^]yshx;
pastime: [-]/ˈpæstaɪm/; [n]消遣,娱乐; [^]yshx;
pasture: [-]/ˈpæstʃər/; [n]牧场,草地;生活状况; [v]放牧; [^]yshx;
patch: [-]/pætʃ/; [n]补丁;眼罩;斑点; [v]打补丁;修补;匆忙拼凑; [^]yshx;
patent: [-]/ˈpætnt/; [n]专利; [a]显然的,明显的;专利的;独创的; [v]取得.的专利权; [^]yshx;
pathetic: [-]/pəˈθetɪk/; [a]可怜的;不足的; [^]yshx;
pathos: [-]/ˈpeɪθɑːs/; [n]悲怆,哀婉;痛苦; [^]yshx;
patio: [-]/ˈpætioʊ/; [n]屋内庭院,天井;平台; [^]yshx;
patriotism: [-]/ˈpeɪtriətɪzəm/; [n]爱国主义,爱国心,爱国精神; [^]yshx;
patrol: [-]/pəˈtroʊl/; [n]巡逻兵;巡逻; [v]巡逻;巡查,巡游; [^]yshx;
patron: [-]/ˈpeɪtrən/; [n]老主顾;赞助人;支持者; [^]yshx;
pave: [-]/peɪv/; [v]铺(路),铺筑; [^]yshx;
pay for: [-]/peɪ fɔr/; [phr]付出代价,出钱;因.受处罚,为.而付钱; [^]yshx;
pay off: [-]/peɪ ɔːf/; [v]付清;取得成功,使得益;贿赂;报复; [^]yshx;
pay sb. back for sth.: [-]/peɪ ˈsʌmbədi bæk fɔːr ˈsʌmθɪŋ/; [phr]向.报复,报答; [^]yshx;
pay sb. back: [-]/peɪ ˈsʌmbədi bæk/; [v]还债;受到惩罚; [^]yshx;
pay up: [-]/peɪ ʌp/; [v]付清,结账; [^]yshx;
peculiar: [-]/pɪˈkjuːliər/; [a]奇怪的,古怪的;特有的,特别的; [^]yshx;
pedal: [-]/ˈpedl/; [n]踏脚板; [v]踏踩板; [a]脚踏的; [vt]踏.的踏板; [^]yshx;
peel: [-]/piːl/; [v]剥皮,削皮,去壳; [n]果皮,外皮; [^]yshx;
peer: [-]/pɪr/; [n]同龄人,同等地位的人;贵族; [v]仔细看,费力地看; [^]yshx;
penalty: [-]/ˈpenəlti/; [n]惩罚,处罚,不利,罚球; [a]处罚的; [^]yshx;
pendulum: [-]/ˈpendʒələm/; [n]摆,钟摆;摇摆不定的事态(或局面); [^]yshx;
penetrate: [-]/ˈpenətreɪt/; [v]刺穿,穿透;进入;了解; [^]yshx;
pension: [-]/ˈpenʃn/; [n]养老金,抚恤金;廉租屋; [v]发给..养老金; [^]yshx;
perceive: [-]/pərˈsiːv/; [v]意识到,察觉,发觉;看待,理解; [^]yshx;
percussion: [-]/pərˈkʌʃn/; [n]撞击,敲击;敲打乐器; [^]yshx;
perennial: [-]/pəˈreniəl/; [a]终年的,永久的;四季不断的;反复的; [n]多年生植物; [^]yshx;
performance: [-]/pərˈfɔːrməns/; [n]表演,演出;表现;执行;性能; [^]yshx;
perfume: [-]/pərˈfjuːm/; [n]香水;香气; [v]使充满芳香;洒香水于; [^]yshx;
peril: [-]/ˈperəl/; [n]危险; [vt]置.于危险中;危及; [^]yshx;
perimeter: [-]/pəˈrɪmɪtər/; [n]周长;周界; [^]yshx;
periodical: [-]/ˌpɪriˈɑːdɪkl/; [n]期刊;杂志; [^]yshx;
periscope: [-]/ˈperɪskoʊp/; [n]潜望镜; [^]yshx;
perish: [-]/ˈperɪʃ/; [vi]死去;毁灭,灭亡; [v]脆裂,老化,腐烂; [^]yshx;
permanent: [-]/ˈpɜːrmənənt/; [a]永久的,持久的; [n]电烫发; [^]yshx;
permeate through (among): [-]/ˈpɜːrmieɪt θruː əˈmʌŋ/; [phr]渗透,透入; [^]yshx;
permeate: [-]/ˈpɜːrmieɪt/; [v]弥漫;普及;渗透; [^]yshx;
permissible: [-]/pərˈmɪsəbl/; [a]容许的;许可的; [^]yshx;
perpendicular: [-]/ˌpɜːrpənˈdɪkjələr/; [a]成直角的,垂直的;直立的; [n]垂直线; [^]yshx;
perpetual: [-]/pərˈpetʃuəl/; [a]永远的,永恒的;不断的; [^]yshx;
perplex: [-]/pərˈpleks/; [v]使困惑; [^]yshx;
persecute: [-]/ˈpɜːrsɪkjuːt/; [v](尤指因宗教或政治信仰不同)迫害;烦扰,纠缠; [^]yshx;
persevere with: [-]/ˌpɜːrsəˈvɪr wɪð/; [v]坚持,不屈不挠; [^]yshx;
persevere: [-]/ˌpɜːrsəˈvɪr/; [v]坚持,不屈不挠; [^]yshx;
persist: [-]/pərˈsɪst/; [v]坚持,固执;继续存留; [^]yshx;
personality: [-]/ˌpɜːrsəˈnæləti/; [n]个性,性格;个性鲜明的人;(娱乐界或体育界的)名人; [^]yshx;
personnel: [-]/ˌpɜːrsəˈnel/; [n]人事部门,员工,人员; [^]yshx;
perspective: [-]/pərˈspektɪv/; [n]角度,视角,观点,想法;(对事物的)合理判断,正确认识;远景;透视图,透视法,透视效果; [a]透视的; [^]yshx;
perspire: [-]/pərˈspaɪər/; [v]出汗,流汗; [^]yshx;
pertain: [-]/pərˈteɪn/; [vi]属于;适合;有关; [^]yshx;
pertinent: [-]/ˈpɜːrtnənt/; [a]有关的;适当的;中肯的; [n]附属物;参考; [^]yshx;
perturb: [-]/pərˈtɜːrb/; [vt]使不安;烦扰;使紊乱; [^]yshx;
pervade: [-]/pərˈveɪd/; [vt]普及;渗透;弥漫; [vi]弥漫;渗透; [^]yshx;
perverse: [-]/pərˈvɜːrs/; [a]邪恶的;堕落的;倔强的;违反常情的; [^]yshx;
pervert: [-]/ˈpɜːrvɜːrt/; [v]使堕落,误导,曲解; [n]变态,色狼; [^]yshx;
pessimism: [-]/ˈpesɪmɪzəm/; [n]悲观,悲观主义; [^]yshx;
pester: [-]/ˈpestər/; [v]使烦恼,纠缠; [^]yshx;
pesticide: [-]/ˈpestɪsaɪd/; [n]杀虫剂;农药; [^]yshx;
petal: [-]/ˈpetl/; [n]花瓣; [^]yshx;
petition: [-]/pəˈtɪʃn/; [n]请愿;请愿书;祈求; [v]请愿; [^]yshx;
petroleum: [-]/pəˈtroʊliəm/; [n]石油; [^]yshx;
petty: [-]/ˈpeti/; [a]价值不大的;小的;器量小的;琐碎的; [^]yshx;
pharmaceutical: [-]/ˌfɑːrməˈsuːtɪkl/; [a]制药的,药物的; [n]药物; [^]yshx;
phase out: [-]/feɪz aʊt/; [v]逐渐淘汰; [^]yshx;
phenomenal: [-]/fəˈnɑːmɪnl/; [a]非凡的;现象的;显著的; [^]yshx;
phobia: [-]/ˈfoʊbiə/; [n]恐惧症; [^]yshx;
phonetic: [-]/fəˈnetɪk/; [a]语音的; [^]yshx;
physician: [-]/fɪˈzɪʃn/; [n]内科医生; [^]yshx;
physiological: [-]/ˌfɪziəˈlɑːdʒɪkl/; [a]生理的,生理学的; [^]yshx;
physique: [-]/fɪˈziːk/; [n]体格,体魄; [^]yshx;
pick sb. (sth.) out: [-]/pɪk ˈsʌmbədi ˈsʌmθɪŋ aʊt/; [v]选出;认出,挑选; [^]yshx;
pick sb. up: [-]/pɪk ˈsʌmbədi ʌp/; [v]结识;中途搭乘;举起; [^]yshx;
pick sth. up: [-]/pɪk ˈsʌmθɪŋ ʌp/; [v]买;得到;知道;捡起; [^]yshx;
picturesque: [-]/ˌpɪktʃəˈresk/; [a]似画的,生动的; [^]yshx;
piecemeal: [-]/ˈpiːsmiːl/; [n]片;块; [v]粉碎; [ad]零碎地;逐个地; [a]零碎的;逐渐的; [^]yshx;
pier: [-]/pɪr/; [n]码头;桥墩; [^]yshx;
pierce: [-]/pɪrs/; [v]穿(孔);贯穿;突破; [^]yshx;
pigment: [-]/ˈpɪɡmənt/; [n]天然色素,颜料; [^]yshx;
pilgrim: [-]/ˈpɪlɡrɪm/; [n]朝圣客;香客; [^]yshx;
pillar: [-]/ˈpɪlər/; [n]柱,台柱,栋梁; [^]yshx;
pillow: [-]/ˈpɪloʊ/; [n]枕头; [v]垫,枕着; [^]yshx;
pilot: [-]/ˈpaɪlət/; [n]领航员;飞行员; [a]试验性的; [v]给..领航,驾驶;试验; [^]yshx;
pimple: [-]/ˈpɪmpl/; [n]丘疹,脓疱; [^]yshx;
pin: [-]/pɪn/; [v]别住,钉住,固定住; [n]别针,饰针; [^]yshx;
pinch: [-]/pɪntʃ/; [v]捏,掐,夹痛; [n]捏;少量,一撮;困苦; [^]yshx;
pine: [-]/paɪn/; [n]松树; [v](因死亡,离别等)难过,悲伤; [^]yshx;
pinnacle: [-]/ˈpɪnəkl/; [n](哥德式建筑的)小尖塔,顶峰; [v]置于尖顶上,置于高处; [^]yshx;
pinpoint: [-]/ˈpɪnpɔɪnt/; [v]准确地解释或说明; [a]精确的; [n]针尖,极小之物,极不重要的事物; [^]yshx;
piracy: [-]/ˈpaɪrəsi/; [n]海上掠夺;剽窃;侵犯版权; [^]yshx;
piston: [-]/ˈpɪstən/; [n]活塞,瓣; [^]yshx;
pit: [-]/pɪt/; [n]大坑,矿井;(赛车道旁的) 检修加油站; [v]除去(水果的)核;使凹陷; [^]yshx;
pitch: [-]/pɪtʃ/; [v]投掷;用沥青覆盖;<音>为...定音高;扎营;搭帐篷; [n]投掷;球场;沥青;音高; [^]yshx;
pivot: [-]/ˈpɪvət/; [n]枢轴,中心; [v]以..为中心转动; [a]枢轴的;关键的; [^]yshx;
placid: [-]/ˈplæsɪd/; [a]安静的,平和的; [^]yshx;
plagiarize: [-]/ˈpleɪdʒəraɪz/; [v]剽窃,抄袭(别人学说,著作); [^]yshx;
plague: [-]/pleɪɡ/; [n]瘟疫;灾难;麻烦; [v]折磨;烦扰;造成麻烦; [^]yshx;
plaintive: [-]/ˈpleɪntɪv/; [a]表示悲痛的,伤心的; [^]yshx;
planetarium: [-]/ˌplænɪˈteriəm/; [n]天文馆,行星仪; [^]yshx;
plank: [-]/plæŋk/; [n]厚木板;木板制成物;政纲条款;要点; [v]在..上铺板;砰一声放下;用菜板端出; [^]yshx;
plantation: [-]/plænˈteɪʃn/; [n]农场;种植园;栽植; [^]yshx;
plaster: [-]/ˈplæstər/; [n]灰泥,石膏; [v]抹泥; [^]yshx;
plateau: [-]/plæˈtoʊ/; [n]高原; [vi]到达平稳阶段; [^]yshx;
platform: [-]/ˈplætfɔːrm/; [n]站台;平台;讲台;舞台;论坛; [^]yshx;
platitude: [-]/ˈplætɪtuːd/; [n]陈词滥调,老生常谈;单调; [^]yshx;
plausible: [-]/ˈplɔːzəbl/; [a]似乎有理的;巧嘴的; [^]yshx;
plea: [-]/pliː/; [n](法律)抗辩;恳求;请求,托词,口实; [^]yshx;
plead for sb.: [-]/pliːd fɔːr ˈsʌmbədi/; [v]恳求;为.辩护; [^]yshx;
plead guilty (not guilty): [-]/pliːd ˈɡɪlti nɑːt ˈɡɪlti/; [v]服罪(不服罪); [^]yshx;
pledge: [-]/pledʒ/; [v]发誓,保证,以.抵押,向.祝酒; [n]保证,誓言; [^]yshx;
pliable: [-]/ˈplaɪəbl/; [a]易弯的;柔韧的;圆滑的; [^]yshx;
plight: [-]/plaɪt/; [n]困境; [v]宣誓,保证; [^]yshx;
plot: [-]/plɑːt/; [n]情节,阴谋,小块土地; [v]密谋,计划,为小说写情节; [^]yshx;
plow: [-]/plau/; [v]犁,耕; [n]犁; [^]yshx;
plug: [-]/plʌɡ/; [vi]堵塞;插入(插头); [vt]塞; [n]塞子;插头; [^]yshx;
plummet: [-]/ˈplʌmɪt/; [v]垂直或突然地堕下,骤然下降; [n]测锤(钓丝的)坠子;线锤;铅锤线;锤规; [^]yshx;
plunder: [-]/ˈplʌndər/; [v]抢劫,掠夺; [n]抢劫,战利品; [^]yshx;
plunge: [-]/plʌndʒ/; [v]跳进,(使)投入;使陷入;暴跌; [n]卷入,参与;暴跌,骤减; [^]yshx;
plus: [-]/plʌs/; prep. 加,加上; [n]加号;有利因素; [a]正的,多的;有利的;阳性的; [conj]此外,而且,况且; [^]yshx;
pointed: [-]/ˈpɔɪntɪd/; [a]尖锐的;率直的; [^]yshx;
poise: [-]/pɔɪz/; [v]使相等,使平衡; [n]泰然自若,信心; [^]yshx;
poke: [-]/poʊk/; [v]刺,戳;拨开,拨(弄);探(出),露出; [n]戳,捅; [^]yshx;
pole: [-]/poʊl/; [n]杆,竿极(点);磁极;电极; [^]yshx;
policy: [-]/ˈpɑːləsi/; [n]保险单;政策,方针;原则,策略; [^]yshx;
polish: [-]/ˈpɑːlɪʃ/; [v]磨光,擦亮;润饰,使优美; [n]擦光剂;优美,完善; [a]波兰的;波兰人的;波兰语的; [^]yshx;
pollinate: [-]/ˈpɑːləneɪt/; [vt]传花粉给.; [^]yshx;
pompous: [-]/ˈpɑːmpəs/; [a]傲慢的,浮华的; [^]yshx;
ponder: [-]/ˈpɑːndər/; [v]仔细考虑,沉思; [^]yshx;
ponderous: [-]/ˈpɑːndərəs/; [a]笨重的,笨拙的,沉闷的; [^]yshx;
porcelain: [-]/ˈpɔːrsəlɪn/; [a]瓷的;精美的;易碎的; [n]瓷,瓷器; [^]yshx;
porch: [-]/pɔːrtʃ/; [n]门廊;走廊; [^]yshx;
porous: [-]/ˈpɔːrəs/; [a]可渗透的,多孔的,可穿越的; [^]yshx;
port: [-]/pɔːrt/; [n]舷窗;舱门;港口城市;葡萄酒;港,港口; [^]yshx;
portfolio: [-]/pɔːrtˈfoʊlioʊ/; [n]公文包,文件夹,投资组合;股份单; [^]yshx;
portion: [-]/ˈpɔːrʃn/; [n]一部分,份额,分担的责任; [v]把.分成份额,分配; [^]yshx;
pose: [-]/poʊz/; [n]姿势;装腔作势,伪装; [vi]摆造型; [vt]主张,提出;引起,导致; [^]yshx;
positive: [-]/ˈpɑːzətɪv/; [a]积极的;肯定的,明确的;正面的;阳性的; [n]正面;肯定;优点;正数; [^]yshx;
possession: [-]/pəˈzeʃn/; [n]财产,所有物,拥有;控球; [^]yshx;
postage: [-]/ˈpoʊstɪdʒ/; [n]邮费,邮资; [^]yshx;
poster: [-]/ˈpoʊstər/; [n]海报,张贴的大幅广告;贴标语的人; [^]yshx;
postgraduate: [-]/ˌpoʊstˈɡrædʒuət/; [n]研究生; [a]大学毕业后的,研究生的; [^]yshx;
posthumous: [-]/ˈpɑːstʃəməs/; [a]遗腹的;著作者死后出版的;死后的; [^]yshx;
postmortem: [-]/ˌpoʊs(t)ˈmɔrtəm/; [n]验尸,尸体解剖; [a]事后的,死后的,事后检查或详论的; [^]yshx;
postpone: [-]/poʊˈspoʊn/; [v]延迟,推迟,延缓; [^]yshx;
postscript: [-]/ˈpoʊstskrɪpt/; [n]附言;后评; [^]yshx;
potent: [-]/ˈpoʊtnt/; [a]强有力的;有权势的;有说服力的; [^]yshx;
potential: [-]/pəˈtenʃl/; [n]潜力,潜能; [a]潜在的,可能的; [^]yshx;
potion: [-]/ˈpoʊʃn/; [n]一剂,一服;毒药,魔药; [^]yshx;
pottery: [-]/ˈpɑːtəri/; [n]陶器;陶艺;陶艺厂; [^]yshx;
poultry: [-]/ˈpoʊltri/; [n]家禽(肉); [^]yshx;
pounce: [-]/paʊns/; [n]猛扑,飞扑; [vi]猛扑,突然袭击; [vt]扑过去抓住; [^]yshx;
pour: [-]/pɔːr/; [v]注,倒,灌;下(雨);不断地大量投入,倾注; [n]倾泻;倾盆大雨; [^]yshx;
poverty: [-]/ˈpɑːvərti/; [n]贫困;贫穷; [^]yshx;
practicable: [-]/ˈpræktɪkəbl/; [a]能实行的,行得通的;适用的,能用的;可通行的; [^]yshx;
practical: [-]/ˈpræktɪkl/; [a]实际的,实用的,实践的,切合实际的;〔人〕注重实际的,务实的;〔计划,方法等〕有效的,切实可行的;心灵手巧的; [n]实习课;实践课;实验考核; [^]yshx;
practitioner: [-]/prækˈtɪʃənər/; [n](医生或律师等)开业者;实践者,从事者; [^]yshx;
pragmatic: [-]/præɡˈmætɪk/; [a]国事的,团体事务的;实际的,注重实效的; [n]爱管闲事的人;专断的人;国事诏书;实际家; [^]yshx;
preach: [-]/priːtʃ/; [v]传教,布道;说教;宣扬; [^]yshx;
precarious: [-]/prɪˈkeriəs/; [a]不稳定的;危险的;可疑的;说不定的; [^]yshx;
precaution: [-]/prɪˈkɔːʃn/; [n]预防措施; [^]yshx;
preceding: [-]/prɪˈsiːdɪŋ/; [a]在前的,在先的; [^]yshx;
precious: [-]/ˈpreʃəs/; [n]<口>宝贝,心爱的人; [ad]强调极少或太少; [a]珍贵的,宝贵的; [^]yshx;
precipice: [-]/ˈpresəpɪs/; [n]危险的处境,灾难的边缘,濒危点;悬崖; [^]yshx;
precipitate: [-]/prɪˈsɪpɪteɪt/; [v]促成,使..沉淀,猛摔;<气象>凝结; [n]沉淀物,冷凝物; [a]突如其来的,仓促的,迅猛的;感情用事的; [^]yshx;
precise: [-]/prɪˈsaɪs/; [a]精确的;恰好的; [^]yshx;
predecessor: [-]/ˈpredəsesər/; [n]前辈;(被取代的)原有事物; [^]yshx;
predictable: [-]/prɪˈdɪktəbl/; [a]可预料的;可预报的;可预言的; [^]yshx;
predisposition: [-]/ˌpriːdɪspəˈzɪʃn/; [n]倾向;素质;易染病体质; [^]yshx;
predominant: [-]/prɪˈdɑːmɪnənt/; [a]占主导地位的;显著的; [^]yshx;
preface: [-]/ˈprefəs/; [n]序言,前言,开端; [^]yshx;
pregnant: [-]/ˈpreɡnənt/; [a]怀孕的;充满的,意味深长的; [^]yshx;
prejudice: [-]/ˈpredʒudɪs/; [n]偏见;成见;损害;侵害; [vt]使抱偏见; [^]yshx;
preliminary: [-]/prɪˈlɪmɪneri/; [a]初步的,预备的; [n]预赛;预考,初试;初步措施; [^]yshx;
prelude: [-]/ˈpreljuːd/; [n]序幕,前奏; [^]yshx;
premise: [-]/ˈpremɪs/; [n]前提;房屋地基; [v]假定; [^]yshx;
premium: [-]/ˈpriːmiəm/; [a]高级的;高价的;(汽油)辛烷值高的; [n]额外费用,溢价;保险金; [^]yshx;
prerogative: [-]/prɪˈrɑːɡətɪv/; [n]权利;特权; [^]yshx;
prescribe: [-]/prɪˈskraɪb/; [v]给..开药;命令,指示; [^]yshx;
presence: [-]/ˈprezns/; [n]出席,到场;存在;风度,仪态; [^]yshx;
presentation: [-]/ˌpriːzenˈteɪʃn/; [n]演讲;报告;介绍;颁奖仪式; [^]yshx;
preserve: [-]/prɪˈzɜːrv/; [v]贮鲜,保鲜;保存;保护; [n]独揽之事,独占的活动; [^]yshx;
prestige: [-]/preˈstiːʒ/; [n]威望,声望; [^]yshx;
pretentious: [-]/prɪˈtenʃəs/; [a]做作的,自命不凡的,炫耀的; [^]yshx;
pretext: [-]/ˈpriːtekst/; [n]借口,托词; [^]yshx;
prevail: [-]/prɪˈveɪl/; [v]流行,盛行;战胜,压倒; [^]yshx;
prevalent: [-]/ˈprevələnt/; [a]普遍的,流行的; [^]yshx;
previous: [-]/ˈpriːviəs/; [a]以前的;早先的;过早的; [^]yshx;
prime: [-]/praɪm/; [a]首要的,主要的;最好的,第一流的; [n]青春,全盛期,青壮年时期; [v]使准备好; [^]yshx;
primitive: [-]/ˈprɪmətɪv/; [a]原始的;简陋的; [n]原始人; [^]yshx;
principal: [-]/ˈprɪnsəpl/; [n]校长,负责人;本金,资本; [a]主要的,首要的; [^]yshx;
prior: [-]/ˈpraɪər/; [a]在先的;优先的; [n]上司; [^]yshx;
privacy: [-]/ˈpraɪvəsi/; [n]隐私;秘密;私生活; [^]yshx;
privilege: [-]/ˈprɪvəlɪdʒ/; [n]特权,优待;荣幸; [v]给..特权; [^]yshx;
probation: [-]/proʊˈbeɪʃn/; [n]试用;缓刑;察看; [^]yshx;
probe: [-]/proʊb/; [v]探测,探索; [n]探索,调查;探针,探测器; [^]yshx;
procedure: [-]/prəˈsiːdʒər/; [n]步骤,过程;程序;手续; [^]yshx;
proceed: [-]/proʊˈsiːd/; [v]前进(尤指停止后继续进行);继续进行,继续做; [n]收入,获利; [^]yshx;
proclaim: [-]/prəˈkleɪm/; [v]声明,声称;宣告;表明; [^]yshx;
procure: [-]/prəˈkjʊr/; [vt](努力)取得;获得;导致;完成; [vi]介绍娼妓;拉皮条; [^]yshx;
prodigious: [-]/prəˈdɪdʒəs/; [a]异常的,奇妙的;巨大的; [^]yshx;
productive: [-]/prəˈdʌktɪv/; [a]多产的;产生..的;富有成效的; [^]yshx;
profane: [-]/prəˈfeɪn/; [a]亵渎神圣的,不敬的,粗俗的,污秽的; [v]亵渎,玷污(神圣),滥用; [n]未受秘传的人; [^]yshx;
professional: [-]/prəˈfeʃənl/; [a]职业的;专业的; [n]专业人员; [^]yshx;
proficiency: [-]/prəˈfɪʃnsi/; [n]熟练;精通; [^]yshx;
profile: [-]/ˈproʊfaɪl/; [n]侧面像;外形,轮廓; [v]描绘..的轮廓,扼要描述; [^]yshx;
profit: [-]/ˈprɑːfɪt/; [n]利润,盈利;益处; [v]得益,有益于; [^]yshx;
profuse: [-]/prəˈfjuːs/; [a]很多的,浪费的;丰富的; [^]yshx;
prohibit: [-]/prəˈhɪbɪt/; [v]禁止; [^]yshx;
project: [-]/ˈprɑːdʒekt/; [n]项目,工程;专题研究;课题方案; [v]映射,放映;计划,设计,打算,拟订方案;投掷,发射,喷射;表明..的特性,使呈现特性;阐述;突出,伸出;估计,预估; [^]yshx;
prolific: [-]/prəˈlɪfɪk/; [a]多育的,多产的;丰富的,富饶的; [^]yshx;
promise: [-]/ˈprɑːmɪs/; [n]诺言;有成功希望的预示;允诺的事; [vt]保证,允诺; [vi]有指望;允诺,保证; [^]yshx;
promote: [-]/prəˈmoʊt/; [v]提升;促进;发扬;促销; [^]yshx;
prompt: [-]/prɑːmpt/; [v]提示;激起;促进,推动;敦促; [a]迅速的,及时的; [n]提示; [^]yshx;
prone: [-]/proʊn/; [a]易于.的;有.倾向的;俯卧的; [^]yshx;
propaganda: [-]/ˌprɑːpəˈɡændə/; [n]宣传;宣传方法; [^]yshx;
propagate: [-]/ˈprɑːpəɡeɪt/; [v]繁殖,增殖; [vt]传播,宣传; [^]yshx;
propel: [-]/prəˈpel/; [v]推进,推动,激励; [^]yshx;
property: [-]/ˈprɑːpərti/; [n]房产;财产;特性;性能; [^]yshx;
prophecy: [-]/ˈprɑːfəsi/; [n]预言书;预言,预言能力; [^]yshx;
proportion: [-]/prəˈpɔːrʃn/; [n]比例;部分;相称; [v]使成比例;分配; [^]yshx;
propose: [-]/prəˈpoʊz/; [v]提议;求婚; [^]yshx;
propriety: [-]/prəˈpraɪəti/; [n]正当(的行为);礼节;适当; [^]yshx;
propulsion: [-]/prəˈpʌlʃn/; [n]推进力; [^]yshx;
prosecute: [-]/ˈprɑːsɪkjuːt/; [v]起诉;做检察官;从事; [^]yshx;
prospect: [-]/ˈprɑːspekt/; [n]前景,展望;视野;景象; [v]勘察;有前途;勘探;对..进行仔细调查; [^]yshx;
prospectus: [-]/prəˈspektəs/; [n]章程,内容简介;样张;创办计划书; [^]yshx;
protein: [-]/ˈproʊtiːn/; [n]蛋白质; [a]蛋白质的; [^]yshx;
protest: [-]/ˈproʊtest/; [v]抗议;反对; [n]声明,反对; [^]yshx;
protocol: [-]/ˈproʊtəkɔːl/; [n]外交礼节;草案;外交议定书; [vi]拟定议定书; [vt]把.写入议定书; [^]yshx;
prototype: [-]/ˈproʊtətaɪp/; [n]原型,典型,样本; [^]yshx;
protract: [-]/proʊ'trækt/; [v]绘制;延长;伸展; [^]yshx;
protrude: [-]/proʊˈtruːd/; [v]伸出,突出,凸出; [^]yshx;
provided: [-]/prəˈvaɪdɪd/; [conj]假如,如果,以..为条件; [a]预备好的,提供的; [^]yshx;
provision: [-]/prəˈvɪʒn/; [n](法律等)条款;供应;预备,存粮;必需品; [v]为..提供必需品; [^]yshx;
provisional: [-]/prəˈvɪʒənl/; [n]临时邮票; [a]临时的,暂时的,暂定的; [^]yshx;
provoke: [-]/prəˈvoʊk/; [v]激怒;对.挑衅;引起; [^]yshx;
proximity: [-]/prɑːkˈsɪməti/; [n]接近;邻近; [^]yshx;
proxy: [-]/ˈprɑːksi/; [n]代理权,代表权,代理人; [a]代理的; [^]yshx;
pry: [-]/praɪ/; [v]刺探,打听,撬开; [n]窥探;杠杆;爱打探的人; [^]yshx;
psychiatry: [-]/saɪˈkaɪətri/; [n]精神病学;精神病治疗法; [^]yshx;
psychology: [-]/saɪˈkɑːlədʒi/; [n]心理学;心理状态;心理; [^]yshx;
publicity: [-]/pʌbˈlɪsəti/; [n]公开(性),公众的关注;宣传;名声; [^]yshx;
pull oneself together: [-]/pʊl wʌnˈself təˈɡeðər/; [v]振作起来;恢复镇定; [^]yshx;
pull over: [-]/pʊl ˈoʊvər/; [v]开到路边; [^]yshx;
pull sth. down: [-]/pʊl ˈsʌmθɪŋ daʊn/; [phr]摧毁;破坏;拆除; [^]yshx;
pull sth. off: [-]/pʊl ˈsʌmθɪŋ ɑːf/; [phr]努力实现; [^]yshx;
pull through: [-]/pʊl θru/; [phr]渡过难关;恢复健康; [^]yshx;
pulp: [-]/pʌlp/; [n]果肉;果肉酱;纸浆; [v]去除果肉,捣成浆状; [^]yshx;
pump: [-]/pʌmp/; [v]抽水,抽取;用泵输送;向.灌注;盘问; [n]打气筒;泵,抽水(机);胶底帆布鞋; [^]yshx;
punctual: [-]/ˈpʌŋktʃuəl/; [a]准时的,守时的; [^]yshx;
puncture: [-]/ˈpʌŋktʃər/; [v]刺破(车胎等),扎,穿孔; [n]刺孔,刺; [^]yshx;
pungent: [-]/ˈpʌndʒənt/; [a]刺激性的;刺鼻的;尖锐的; [^]yshx;
purity: [-]/ˈpjʊrəti/; [n]纯洁;纯净;纯正;纯粹; [^]yshx;
pursuit: [-]/pərˈsuːt/; [n]追求,寻找;追赶,跟踪;事业,消遣; [v]追踪,追击; [^]yshx;
put an end to: [-]/pʊt ən end tu/; [v]停止,消灭; [^]yshx;
puzzle: [-]/ˈpʌzl/; [n]拼图;谜;迷惑;难题; [v]使迷惑; [^]yshx;
quaint: [-]/kweɪnt/; [a]精巧的;古雅的; [^]yshx;
qualification: [-]/ˌkwɑːlɪfɪˈkeɪʃn/; [n]资格证明;条件;合格证书;资格;限制性条件; [^]yshx;
qualitative: [-]/ˈkwɑːləteɪtɪv/; [a](性)质的,定性的; [^]yshx;
quantitative: [-]/ˈkwɑːntəteɪtɪv/; [a]定量的; [^]yshx;
quarry: [-]/ˈkwɔːri/; [n]采石场;猎物;来源; [v]挖出;努力挖掘; [^]yshx;
queer: [-]/kwɪr/; [a]怪异的;〈贬〉同性恋的; [n]〈贬〉同性恋者; [v]破坏.的计划; [^]yshx;
quench: [-]/kwentʃ/; [v]扑灭(火);止渴; [^]yshx;
quest: [-]/kwest/; [n]探索,寻求; [v]寻找,搜索; [^]yshx;
questionnaire: [-]/ˌkwestʃəˈner/; [n]调查表,问卷; [^]yshx;
quit: [-]/kwɪt/; [vt]辞职;停止;离开; [a]被释放的;自由的;摆脱了.的;了清债务的; [^]yshx;
quiver: [-]/ˈkwɪvər/; [n]颤抖;箭袋; [vi]颤抖; [^]yshx;
quota: [-]/ˈkwoʊtə/; [n]配额;限额;定额; [^]yshx;
rack: [-]/ræk/; [n]挂架,搁架; [v]使痛苦; [^]yshx;
racket: [-]/ˈrækɪt/; [n]吵闹声;球拍; [v]嚷闹,吵闹,纵情欢闹;用球拍打; [^]yshx;
radar: [-]/ˈreɪdɑːr/; [n]雷达,无线电探测器; [^]yshx;
radiate: [-]/ˈreɪdieɪt/; [v]辐射,发出(光或热);流露,显示;(使)从中心发散; [^]yshx;
radical: [-]/ˈrædɪkl/; [n]激进分子;基础;原子团;根数,根式; [a]重大的,彻底的;激进的; [^]yshx;
radius: [-]/ˈreɪdiəs/; [n]半径;范围; [^]yshx;
raft: [-]/ræft/; [n]木筏;救生艇; [^]yshx;
rage: [-]/reɪdʒ/; [n]极怒;盛怒; [v]迅速蔓延,快速扩散;(战争等)激烈地进行; [^]yshx;
ragged: [-]/ˈræɡɪd/; [a]破旧的;参差不齐的;未梳理的;粗糙的;精疲力竭的; [^]yshx;
raid: [-]/reɪd/; [n]突袭;袭击; [v]袭击;劫掠;攫取;突然搜捕; [^]yshx;
rail: [-]/reɪl/; [n]铁轨;扶手,栏杆; [v]咒骂; [^]yshx;
rally: [-]/ˈræli/; [n]集会;公路汽车赛; [v]集合;恢复(健康等),重新振作; [^]yshx;
ramble: [-]/ˈræmbl/; [vi]瞎扯;溜达;漫步于; [n]漫步; [^]yshx;
rampant: [-]/ˈræmpənt/; [a]猖獗的,蔓生的; [^]yshx;
random: [-]/ˈrændəm/; [a]随机的;任意的;胡乱的; [^]yshx;
range: [-]/reɪndʒ/; [n]排;变动范围;山脉;放牧场;射程;范围; [vi]排成一排; [vt]排列; [a]牧场的; [^]yshx;
ransom: [-]/ˈrænsəm/; [n]赎金,赎身; [v]赎回,解救; [^]yshx;
rarely: [-]/ˈrerli/; [ad]很少,难得; [^]yshx;
ratio: [-]/ˈreɪʃioʊ/; [n]比率,比例; [^]yshx;
rational: [-]/ˈræʃnəl/; [a]理性的;理智的;合理的; [^]yshx;
ravage: [-]/ˈrævɪdʒ/; [n]毁坏,荒废,破坏的残迹; [v]摧残,破坏; [^]yshx;
raw: [-]/rɔː/; [a]生的,未煮过的;未加工的;(因皮肤开裂)疼痛的; [^]yshx;
readily: [-]/ˈredɪli/; [ad]容易地;乐意地;欣然地; [^]yshx;
realm: [-]/relm/; [n]王国;领域;国土; [^]yshx;
reap: [-]/riːp/; [v]收割;获得;收获; [^]yshx;
reasonable: [-]/ˈriːznəbl/; [a]适当的;合理的;通情达理的;(价格)公道的; [^]yshx;
reassure: [-]/ˌriːəˈʃʊr/; [v]使放心,使消除疑虑; [^]yshx;
recall: [-]/rɪˈkɔːl/; [v]回想起,记起,回忆;召回; [n]召回(有问题的产品); [^]yshx;
recede: [-]/rɪˈsiːd/; [vi]退去;渐渐远去;(尤指问题,感情或品质)逐渐减弱;(头发)从前向后减少;向后倾斜; [^]yshx;
receipt: [-]/rɪˈsiːt/; [n]收据,收条;收入;收到; [^]yshx;
reception: [-]/rɪˈsepʃn/; [n]前台,接待处,接收,欢迎,招待会; [^]yshx;
recession: [-]/rɪˈseʃn/; [n](经济)衰退,不景气;后退,撤回;凹处; [^]yshx;
recipe: [-]/ˈresəpi/; [n]方法;食谱; [^]yshx;
recipient: [-]/rɪˈsɪpiənt/; [n]接受者;容器;间接宾语; [a]接受的;善于接受的;接受能力强的; [^]yshx;
reciprocal: [-]/rɪˈsɪprəkl/; [a]相互的,互惠的; [n]倒数;互相关联的事物; [^]yshx;
recital: [-]/rɪˈsaɪtl/; [n]独奏,吟诵,演奏会; [^]yshx;
recite: [-]/rɪˈsaɪt/; [vi]背诵;朗诵; [vt]背诵;朗诵;叙述;列举; [^]yshx;
reckless: [-]/ˈrekləs/; [a]不顾虑的;鲁莽的,不顾后果的; [^]yshx;
reckon on: [-]/ˈrekən ɔn/; [phr]依赖;估计;计划;指望; [^]yshx;
reckon with sb.: [-]/ˈrekən wɪθ ˈsʌmbədi/; [v]清算;将.加以考虑,认真对待; [^]yshx;
reckon: [-]/ˈrekən/; [vt]计算;想,指望;把.看做; [v]认为; [vi]计算;估计; [^]yshx;
reclaim: [-]/rɪˈkleɪm/; [v]开拓,开垦;感化;取回;改造;废物回收利用; [^]yshx;
recline: [-]/rɪˈklaɪn/; [vi]躺,斜倚(常与on,upon或against连用);信赖; [vt]使后靠,使斜倚; [^]yshx;
recommendation: [-]/ˌrekəmenˈdeɪʃn/; [n]推荐,建议,介绍,推荐信; [^]yshx;
reconcile: [-]/ˈrekənsaɪl/; [v]和解;调解;调和; [^]yshx;
recover: [-]/rɪˈkʌvər/; [v]恢复;痊愈,恢复健康;收回;换回;重新获得;重新找到; [^]yshx;
recruit: [-]/rɪˈkruːt/; [v]招募(新兵),招收(新成员); [n]新兵,新成员; [^]yshx;
rectify: [-]/ˈrektɪfaɪ/; [v]纠正;修复; [^]yshx;
recycle: [-]/ˌriːˈsaɪkl/; [v]回收利用;改建; [n]再循环; [^]yshx;
redeem: [-]/rɪˈdiːm/; [vt]赎回;挽回;恢复;偿还;弥补;履行;兑换; [^]yshx;
redundant: [-]/rɪˈdʌndənt/; [a]多余的,过剩的;被下岗的; [^]yshx;
reel: [-]/riːl/; [n]卷盘; [v]旋转;感到震惊;眩晕; [^]yshx;
reference: [-]/ˈrefrəns/; [n]参考书;提及;推荐人;参考;证明;推荐信; [v]附.以供参考;引用; [^]yshx;
referendum: [-]/ˌrefəˈrendəm/; [n]公民投票,复决权; [^]yshx;
refine: [-]/rɪˈfaɪn/; [v]精炼,改进; [^]yshx;
refrain: [-]/rɪˈfreɪn/; [v]抑制,避免; [n]歌曲的反复句,叠句; [^]yshx;
refreshing: [-]/rɪˈfreʃɪŋ/; [a]使精神振作的,使人清爽的;清新悦目的; [^]yshx;
refugee: [-]/ˌrefjuˈdʒiː/; [n]避难者,难民; [v]避难; [a]避难的; [^]yshx;
refusal: [-]/rɪˈfjuːzl/; [n]拒绝,回绝; [^]yshx;
regardless: [-]/rɪˈɡɑːrdləs/; [a]不顾的,不注意的; [ad]不顾一切地; [^]yshx;
regime: [-]/reɪˈʒiːm/; [n]政权;政治制度;养生法,生活规则; [^]yshx;
registrar: [-]/ˌredʒɪˈstrɑːr/; [n]登记员,记录员; [^]yshx;
regulate: [-]/ˈreɡjuleɪt/; [v]管制,调整,控制; [^]yshx;
rehabilitate: [-]/ˌriːəˈbɪlɪteɪt/; [v]使康复,使恢复名誉,使恢复原状; [^]yshx;
reign: [-]/reɪn/; [v]占主导地位,统治,当政; [n](君主)统治时期; [^]yshx;
reimburse: [-]/ˌriːɪmˈbɜːrs/; [v]偿还;赔偿;退还(钱),付还; [^]yshx;
reinforce: [-]/ˌriːɪnˈfɔːrs/; [v]加固;加强;增援;支持; [^]yshx;
rejoice: [-]/rɪˈdʒɔɪs/; [v]欣喜,高兴; [^]yshx;
relay: [-]/ˈriːleɪ/; [n]替班;转播;接力赛跑; [v]转播;传递; [^]yshx;
release: [-]/rɪˈliːs/; [v]释放;解放;发行; [n]解除;免除;发表; [^]yshx;
relevant: [-]/ˈreləvənt/; [a]有关的;恰当的;贴切的; [^]yshx;
reliable: [-]/rɪˈlaɪəbl/; [a]可靠的;可信赖的;确实的; [^]yshx;
relief: [-]/rɪˈliːf/; [n]安慰;解脱;减轻;浮雕;凸显,起伏;救济金;救济物资;换班人;接替人; [^]yshx;
relinquish: [-]/rɪˈlɪŋkwɪʃ/; [v]放弃,让出(权利,财产等),撤回; [^]yshx;
reluctant: [-]/rɪˈlʌktənt/; [a]不情愿的;勉强的; [^]yshx;
rely: [-]/rɪˈlaɪ/; [v]依赖,依靠;信赖; [^]yshx;
remedy: [-]/ˈremədi/; [v]治疗;恢复;补救; [n]治疗;补救;矫正; [^]yshx;
remind: [-]/rɪˈmaɪnd/; [v]提醒,使想起; [^]yshx;
remittance: [-]/rɪˈmɪtns/; [n]汇款,汇款额; [^]yshx;
remnant: [-]/ˈremnənt/; [n]遗迹;边角剩料; [^]yshx;
render: [-]/ˈrendər/; [v]使成为,致使,使处于(某种状态);提供,给予,以.回报;(以某种方式)表达,表现;翻译;粉刷,往(墙上)抹灰;将(脂肪)熬成油,使熔化; [n]粉刷,打底,交纳; [^]yshx;
rendezvous: [-]/ˈrɑːndɪvuː/; [n]集会,幽会,约会地点; [v]约会,幽会,(秘密)集会; [^]yshx;
renovation: [-]/ˌrenəˈveɪʃn/; [n]修理;恢复; [^]yshx;
renowned: [-]/rɪˈnaʊnd/; [a]著名的;有名的; [^]yshx;
repel: [-]/rɪˈpel/; [v]击退,驱逐;排斥,抵制;使厌恶,使反感;使恐惧; [^]yshx;
repent: [-]/rɪˈpent/; [v](对某事或行为感到)悔恨;后悔;悔改; [a]<植>匍匐生根的;<动>爬行的; [^]yshx;
repetition: [-]/ˌrepəˈtɪʃn/; [n]重复,反复; [^]yshx;
represent: [-]/ˌreprɪˈzent/; [v]代表;象征;表示;描述;阐明;说明;演绎; [^]yshx;
reproach: [-]/rɪˈproʊtʃ/; [v]责备,指责; [n]指责; [^]yshx;
reptile: [-]/ˈreptaɪl/; [n]爬行动物,爬虫; [a]爬行的,爬虫类的; [^]yshx;
reputation: [-]/ˌrepjuˈteɪʃn/; [n]名声;声誉; [^]yshx;
request: [-]/rɪˈkwest/; [n]请求;要求; [v]请求;要求; [^]yshx;
rescue: [-]/ˈreskjuː/; [v]营救,援救; [n]营救,救援; [^]yshx;
resemble: [-]/rɪˈzembl/; [v]像,相像,相似; [^]yshx;
reserve: [-]/rɪˈzɜːrv/; [n]储备;保留;保护区; [v]保留;预定;储备; [^]yshx;
residence: [-]/ˈrezɪdəns/; [n]住宅,居住,居留权; [^]yshx;
resign: [-]/rɪˈzaɪn/; [v]辞职; [^]yshx;
resilience: [-]/rɪˈzɪliəns/; [n]恢复力;弹力;顺应力; [^]yshx;
resolution: [-]/ˌrezəˈluːʃn/; [n]决心,决定,解决,决议,分辨率; [^]yshx;
resonant: [-]/ˈrezənənt/; [a]洪亮的,共振的,共鸣的; [^]yshx;
resort: [-]/rɪˈzɔːrt/; [vi]采取;求助; [n]求助;凭借;诉诸,采取;度假胜地; [^]yshx;
resource: [-]/ˈriːsɔːrs/; [n]资源,财力,办法; [v]向.提供资金(或设备); [^]yshx;
respiration: [-]/ˌrespəˈreɪʃn/; [n]呼吸; [^]yshx;
responsive: [-]/rɪˈspɑːnsɪv/; [a]反应积极的,反应敏捷的;反应热烈的;响应的; [^]yshx;
restless: [-]/ˈrestləs/; [a]烦躁不安的,焦虑的;得不到休息的;不安宁的; [^]yshx;
restore: [-]/rɪˈstɔːr/; [v]恢复;修补;归还; [^]yshx;
restrain: [-]/rɪˈstreɪn/; [v]制止(做);抑制(愤怒等),控制;监禁; [^]yshx;
resume: [-]/ˈrezəmeɪ/; [n]简历; [v]重新开始;继续; [vt]回到;恢复;重新开始; [^]yshx;
retail: [-]/ˈriːteɪl/; [a]零售的; [n]零售; [v]零售,零售价是; [ad]以零售方式,以零售形式; [^]yshx;
retain: [-]/rɪˈteɪn/; [v]保持,保留,保存;聘请; [^]yshx;
reticent: [-]/ˈretɪsnt/; [a]沉默不语的;有保留的;含蓄的; [^]yshx;
retort: [-]/rɪˈtɔːrt/; [v]反驳; [n]反驳,反击,回嘴; [^]yshx;
retreat: [-]/rɪˈtriːt/; [v]撤退,撤离,(被迫)退却,后退; [n]撤退,退却,隐退;休养所,收容所;躲藏处; [^]yshx;
retrieve: [-]/rɪˈtriːv/; [v]取回,重新得到,挽回,检索; [^]yshx;
revelation: [-]/ˌrevəˈleɪʃn/; [n]揭露;揭示;(出乎意料的)被揭示的真相; [^]yshx;
revenge: [-]/rɪˈvendʒ/; [n]报仇;报复; [v]为.报仇,报.之仇; [^]yshx;
revenue: [-]/ˈrevənuː/; [n]收入;财政收入;国家的税收; [^]yshx;
reverent: [-]/ˈrevərənt/; [a]虔诚的,恭敬的; [^]yshx;
reverse: [-]/rɪˈvɜːrs/; [n]失败,挫折,倒退;相反,背面; [v]颠倒,翻转; [a]相反的,反面的,颠倒的; [^]yshx;
review: [-]/rɪˈvjuː/; [v]温习,复习;评论;回顾,反思; [n]复习,回顾;检讨;评审,审查; [^]yshx;
revise: [-]/rɪˈvaɪz/; [v]修订;修改;温习(功课); [^]yshx;
revive: [-]/rɪˈvaɪv/; [v](使)苏醒;(使)复苏;再兴起;重做; [^]yshx;
revolt: [-]/rɪˈvoʊlt/; [v]反抗,叛乱,厌恶;造反;反抗;厌恶; [n]背叛;厌恶;反叛; [^]yshx;
revolve: [-]/rɪˈvɑːlv/; [v](使)旋转;(使)绕转; [^]yshx;
reward: [-]/rɪˈwɔːrd/; [n]奖品,报酬,回报;悬赏; [v]报答,酬谢; [^]yshx;
rhetoric: [-]/ˈretərɪk/; [n]修辞学,浮夸的言语;雄辩术; [^]yshx;
rhythm: [-]/ˈrɪðəm/; [n]节奏;韵律;格律; [^]yshx;
ribbon: [-]/ˈrɪbən/; [n]缎带,丝带,带状物; [^]yshx;
ridge: [-]/rɪdʒ/; [n]脊,岭,山脉,垄; [^]yshx;
ridiculous: [-]/rɪˈdɪkjələs/; [a]可笑的,荒谬的; [^]yshx;
rig: [-]/rɪɡ/; [n]钻井架;装备;帆具;成套器械; [v]操纵;装配;欺骗; [^]yshx;
righteous: [-]/ˈraɪtʃəs/; [a]正直的,正当的,公正的; [^]yshx;
rigid: [-]/ˈrɪdʒɪd/; [a]坚硬的;僵硬的;死板的; [^]yshx;
riot: [-]/ˈraɪət/; [v]闹事; [n]骚乱;暴乱;骚动;放纵; [^]yshx;
rip: [-]/rɪp/; [n]裂缝,裂口; [v]撕开,扯破,裂开,敲诈; [^]yshx;
ripple: [-]/ˈrɪpl/; [n]涟漪,波纹; [v](使)泛起层层细浪; [^]yshx;
rise to the occasion: [-]/raɪz tu ði əˈkeʒən/; [v]应付自如; [^]yshx;
ritual: [-]/ˈrɪtʃuəl/; [n](宗教等的)仪式,例行公事,老规矩; [a]作为仪式一部分的,例行的; [^]yshx;
rival: [-]/ˈraɪvl/; [n]竞争者,对手; [v]与.竞争,与.匹敌; [a]竞争的,敌对的; [^]yshx;
rivet: [-]/ˈrɪvɪt/; [n]铆钉; [v](用铆钉)铆接,敲打(螺栓)使成铆钉头,吸引(注意力); [^]yshx;
roam: [-]/roʊm/; [v]闲逛,漫步,徘徊;眼睛或手(缓慢地)扫遍; [n]漫步,漫游; [^]yshx;
roar: [-]/rɔːr/; [n]吼叫声,怒号声,轰鸣声; [vi]吼叫;咆哮; [vt]大声呼喊; [^]yshx;
roast: [-]/roʊst/; [v]烤,炙,烘;挖苦;逗乐; [n]烤肉; [a]烤的,烘的; [^]yshx;
robust: [-]/roʊˈbʌst/; [a]健壮的,强壮的;精力充沛的;坚固的;粗鲁的; [^]yshx;
roll: [-]/roʊl/; [v]滚动,转动;卷;使摇摆;使平坦,压平; [n]卷;卷状物;隆隆声; [^]yshx;
rot: [-]/rɑːt/; [v](使)腐烂; [n]胡话;腐烂;腐朽,腐败; [^]yshx;
rotate: [-]/ˈroʊteɪt/; [v]以..轴转动,使旋转,使..轮流;轮换; [^]yshx;
rough: [-]/rʌf/; [a]粗糙的;大致的,粗略的;(海)波涛汹涌的;困难的,令人不快的; [n]草稿; [ad]粗暴地; [v]艰苦生活; [^]yshx;
rouse: [-]/raʊz/; [vt]唤醒,唤起;激起; [^]yshx;
routine: [-]/ruːˈtiːn/; [n]常规,例行公事,一套固定舞步(或动作); [a]例行的,普通的,惯例的; [^]yshx;
rub: [-]/rʌb/; [v]抚摸;摩擦;擦破; [n]蹭;障碍;磨损处; [^]yshx;
ruffle: [-]/ˈrʌfl/; [vt]弄皱;使生气,扰乱;连续地轻敲;使起波浪; [n]皱纹;生气;混乱; [vi]起皱;愤怒; [^]yshx;
ruinous: [-]/ˈruːɪnəs/; [a]毁坏的;毁灭性的,破坏性的; [^]yshx;
rule of thumb: [-]/rul ɑv θʌm/; [n]单凭经验的做法;经验法则; [^]yshx;
rumor: [-]/'ruːmə/; [n]谣言;传闻; [^]yshx;
rupture: [-]/ˈrʌptʃər/; [n]破裂;割裂; [v]使破裂;断绝(关系); [^]yshx;
rural: [-]/ˈrʊrəl/; [a]乡村的,农村的,田园的; [^]yshx;
rust: [-]/rʌst/; [v]生锈;氧化; [n]锈; [^]yshx;
ruthless: [-]/ˈruːθləs/; [a]无情的;残忍的; [^]yshx;
sabotage: [-]/ˈsæbətɑːʒ/; [n]怠工,蓄意破坏,妨碍; [v]怠工,从事破坏活动,故意阻挠; [^]yshx;
sack: [-]/sæk/; [n]一袋;麻袋;开除; [v]开除;劫掠;掠夺; [^]yshx;
sacred: [-]/ˈseɪkrɪd/; [a]神圣的,宗教(性)的;神圣不可侵犯的; [^]yshx;
sacrifice: [-]/ˈsækrɪfaɪs/; [vt]牺牲;祭献; [vi]奉献;做出牺牲; [n]祭品;牺牲; [^]yshx;
saddle: [-]/ˈsædl/; [n]鞍;鞍部; [v]给马装鞍具;装鞍具;使负重担; [^]yshx;
safeguard: [-]/ˈseɪfɡɑːrd/; [v]保护,维护; [n]防卫措施,防范措施; [^]yshx;
saline: [-]/ˈseɪliːn/; [a]咸的,含盐的; [^]yshx;
salute: [-]/səˈluːt/; [n]致意;致敬,欢迎; [v]向..行举手礼;敬礼; [^]yshx;
salvage: [-]/ˈsælvɪdʒ/; [n]抢救;从灾难中抢救出的物资; [vt]拯救;打捞; [^]yshx;
sanction: [-]/ˈsæŋkʃn/; [n]批准;制裁,处罚; [v]批准,支持,对..实施制裁; [^]yshx;
sanitary: [-]/ˈsænəteri/; [a]卫生的;清洁的; [^]yshx;
sanity: [-]/ˈsænəti/; [n]心智健全,神智正常;头脑清楚; [^]yshx;
sarcasm: [-]/ˈsɑːrkæzəm/; [n]讽刺,挖苦,嘲笑; [^]yshx;
saturate: [-]/ˈsætʃəreɪt/; [v]使充满,使饱和,使湿透; [^]yshx;
sauce: [-]/sɔːs/; [n]酱,调味汁;莽撞,冒失; [^]yshx;
savage: [-]/ˈsævɪdʒ/; [n]野蛮人,粗鲁的人; [a]凶猛的,猛烈的;野蛮的;未驯化的; [v](狗等)乱咬;激烈抨击; [^]yshx;
say to oneself: [-]/seɪ tu wʌnˈself/; [phr]心中暗想;自言自语; [^]yshx;
scale up (down): [-]/skeɪl ʌp daʊn/; [phr]按比例增加(或降低); [^]yshx;
scale: [-]/skeɪl/; [n]天平,磅秤;刻度,尺度,标度;等级,级别, 等级体系;鳞片,鳞状物;规模;水垢,牙垢; [v]攀登;按比例决定;称重;刮鳞,剥落; [^]yshx;
scalpel: [-]/ˈskælpəl/; [n]外科手术刀,解剖刀; [^]yshx;
scan: [-]/skæn/; [v]细看;浏览;扫描; [n]扫描;浏览; [^]yshx;
scandal: [-]/ˈskændl/; [n]丑闻;丢脸;流言蜚语;反感;愤慨; [v]诋毁; [^]yshx;
scant: [-]/skænt/; [a]不足的,缺乏的;勉强够的; [v]减少;节省;限制; [^]yshx;
scar: [-]/skɑːr/; [n]伤疤,伤痕;内心创伤; [v](给.)留下伤痕; [^]yshx;
scatter: [-]/ˈskætər/; [v](使)分散,撒开,散播; [^]yshx;
scenery: [-]/ˈsiːnəri/; [n]风景;布景; [^]yshx;
scent: [-]/sent/; [n]气味;香味;迹象; [v]嗅到;察觉; [^]yshx;
schedule: [-]/ˈskedʒuːl/; [n]时间表,日程,计划表;清单,节目表; [v]预定,安排; [^]yshx;
scheme: [-]/skiːm/; [n]方案,计划;阴谋,诡计; [v]图谋,密谋; [a]计划的; [^]yshx;
scholarship: [-]/ˈskɑːlərʃɪp/; [n]学问;奖学金;学术界;学术成就; [^]yshx;
scissors: [-]/ˈsɪzərz/; [n]剪刀; [^]yshx;
scold: [-]/skoʊld/; [v]怒骂,责骂,训斥; [n]斥责;爱责骂的人; [^]yshx;
scoop: [-]/skuːp/; [n]勺,铲子,独家新闻; [v]挖,掘; [a](女服领口)汤匙式的; [^]yshx;
scorch: [-]/skɔːrtʃ/; [v]烧焦;枯萎; [vi]高速行驶,疾驰,飞驰; [^]yshx;
score: [-]/skɔːr/; [n]得分;刻痕;二十;配乐; [vi]刻痕; [v]得分; [vt]在.上刻痕; [^]yshx;
scorn: [-]/skɔːrn/; [n]鄙视; [v]轻蔑;对.不屑一顾; [^]yshx;
scout: [-]/skaʊt/; [v]侦察;监视;嘲笑; [n]童子军,侦察员,守卫; [^]yshx;
scrap: [-]/skræp/; [n]碎片;口角,吵架;小块,小片;废金属;残羹冷炙; [v]报废;舍弃;打架; [^]yshx;
scrape: [-]/skreɪp/; [n]擦伤;刮,擦; [v]刮,擦; [^]yshx;
scratch: [-]/skrætʃ/; [n]抓痕,擦伤; [v]划破,擦伤,挠; [^]yshx;
screw: [-]/skruː/; [n]螺旋;螺丝; [v]拧紧; [vi]敲诈勒索; [vt]用螺钉固定;把.拧紧; [^]yshx;
script: [-]/skrɪpt/; [n]剧本,脚本,手稿;文字系统; [v]为电影(或戏剧等)写剧本; [^]yshx;
scrupulous: [-]/ˈskruːpjələs/; [a]小心谨慎的;严谨的;细心的; [^]yshx;
scrutiny: [-]/ˈskruːtəni/; [n]监视,细看,详细检查,仔细观察; [^]yshx;
sculpture: [-]/ˈskʌlptʃər/; [n]雕刻艺术;雕刻,雕塑; [^]yshx;
scum: [-]/skʌm/; [n]浮沫,浮渣; [^]yshx;
seal: [-]/siːl/; [n]海豹;邮戳;封条;火漆印; [v]封(信封),密封,盖章;封锁;缄口; [^]yshx;
seam: [-]/siːm/; [n]缝;接缝;地层; [^]yshx;
seclude: [-]/sɪˈkluːd/; [v]与世隔绝,使隔绝; [^]yshx;
secondary: [-]/ˈsekənderi/; [a]次要的,第二的;(疾病,感染等) 继发性的;中学的; [^]yshx;
secretion: [-]/sɪˈkriːʃn/; [n]分泌,分泌物;隐藏; [^]yshx;
section: [-]/ˈsekʃn/; [n]部分;区域;章节;截面;阶层;部门;路段,地段; [v]划分;切开; [^]yshx;
sector: [-]/ˈsektər/; [n](经济等)部门,部分;战区,防区;扇形,扇区; [^]yshx;
sediment: [-]/ˈsedɪmənt/; [n]沉渣,沉淀物,沉淀; [^]yshx;
see eye to eye (with): [-]/siː aɪ tu aɪ wɪθ/; [v]看法完全一致; [^]yshx;
segment: [-]/ˈseɡmənt/; [n]部分;片段;(橘子等的)瓣; [v]分割; [^]yshx;
segregate: [-]/ˈseɡrɪɡeɪt/; [v]分开,隔离,进行种族隔离; [^]yshx;
seismic: [-]/ˈsaɪzmɪk/; [a]地震的;地震引起的;剧烈的; [^]yshx;
semblance: [-]/ˈsembləns/; [n]相似;外表,外貌; [^]yshx;
sensible: [-]/ˈsensəbl/; [a]明智的,理智的;可觉察的;实用耐穿的; [^]yshx;
sensitive: [-]/ˈsensətɪv/; [a]敏感的,过敏的;灵敏的;善解人意的,体恤的; [^]yshx;
sentiment: [-]/ˈsentɪmənt/; [n]感情;情绪; [^]yshx;
sequence: [-]/ˈsiːkwəns/; [n]顺序,次序;连续,继续; [^]yshx;
series: [-]/ˈsɪriːz/; [n]系列,系列节目;连续比赛;连续,接连; [^]yshx;
session: [-]/ˈseʃn/; [n]一段时间的(活动);(法庭的)开庭;(议会等的)开会;学期;讲习会; [a]为录音的歌手或乐队伴奏的; [^]yshx;
set about sth.: [-]/siː əˈbaʊt ˈsʌmθɪŋ/; [v]着手; [^]yshx;
set in: [-]/set ɪn/; [phr]开始;到来;生效;流行;设置(戏剧,小说等的)背景;上涨;插入; [^]yshx;
set off: [-]/set ɑf/; [phr]出发; [^]yshx;
set on sb.: [-]/set ɔːn ˈsʌmbədi/; [v]攻击; [^]yshx;
set out: [-]/set aʊt/; [v]出发; [^]yshx;
set sth. back: [-]/set ˈsʌmθɪŋ bæk/; [v]把(钟,表)向回拨; [^]yshx;
set sth. off: [-]/set ˈsʌmθɪŋ ɑːf/; [v]使爆炸;平衡; [^]yshx;
setback: [-]/ˈsetbæk/; [n]挫折;失败; [^]yshx;
setting: [-]/ˈsetɪŋ/; [n]设置,调整;环境,背景; [^]yshx;
settle (sb.) in: [-]/ˈsetl ˈsʌmbədi ɪn/; [phr]迁入(新居),(使)习惯; [^]yshx;
settle down: [-]/ˈset(ə)l daʊn/; [phr]定居,安定下来; [^]yshx;
settle on (upon) sth.: [-]/ˈsetl ɑːn əˈpɔːn ˈsʌmθɪŋ/; [v]决定; [^]yshx;
severe: [-]/sɪˈvɪr/; [a]严重的;严厉的;严酷的;剧烈的; [^]yshx;
sewer: [-]/ˈsuːər/; [n]排水沟,下水道,缝纫者; [v]用下水道排污水;铺设污水管道; [^]yshx;
shabby: [-]/ˈʃæbi/; [a]破烂的,卑鄙的,衣衫褴褛的; [^]yshx;
shaft: [-]/ʃæft/; [n]柄;轴;杆状物; [v]苛刻地对待; [vt]给.装杆; [^]yshx;
shallow: [-]/ˈʃæloʊ/; [a]浅的;肤浅的; [v]变浅;使变浅; [n]浅滩;浅处; [^]yshx;
shamble: [-]/ˈʃæmbl/; [v]蹒跚,拖沓; [n]蹒跚;摇晃的脚步;(pl.)混乱,废墟; [^]yshx;
shanty: [-]/ˈʃænti/; [n]简陋的小木屋;(水手唱的)劳动号子; [^]yshx;
shatter: [-]/ˈʃætər/; [v]使粉碎;砸碎;打碎;粉碎; [^]yshx;
shave: [-]/ʃeɪv/; [v]剃,刮; [n]剃须,修面,剃刀; [^]yshx;
shed: [-]/ʃed/; [v]流出(眼泪);蜕皮;脱落;使清晰;流下;去除,摆脱; [n]棚屋; [^]yshx;
sheer: [-]/ʃɪr/; [a]陡峭的;纯粹的; [v](off)急转向,偏离; [n]透明薄纱,透明布料的衣服; [ad]完全地,全然;垂直地,陡峭地; [^]yshx;
sheet: [-]/ʃiːt/; [n]被单;纸张;薄板; [^]yshx;
shell: [-]/ʃel/; [n]炮弹;骨架;壳,外壳;贝壳; [v]剥壳;炮击; [^]yshx;
shelter: [-]/ˈʃeltər/; [n]隐蔽处,躲避处(常用来指住处);庇护; [v]遮蔽,掩护,庇护; [^]yshx;
shepherd: [-]/ˈʃepərd/; [n]牧羊人; [v]带领; [^]yshx;
shield: [-]/ʃiːld/; [n]盾牌;防护物; [v]保护; [^]yshx;
shift: [-]/ʃɪft/; [n]转移;替换;轮值; [v]移动;售卖(难卖的物品);换挡;改换,替换; [^]yshx;
shimmer: [-]/ˈʃɪmər/; [v]闪烁,微微发亮; [n]微光,闪光; [^]yshx;
shiver: [-]/ˈʃɪvər/; [v]颤抖,打战;颤动; [n]颤抖,打战; [^]yshx;
shoal: [-]/ʃoʊl/; [n]浅滩,沙洲,一群(鱼); [a](水)浅的; [v]变成浅滩;驶入浅水的地方;(鱼)成群集聚; [^]yshx;
shock: [-]/ʃɑːk/; [v](使)震惊,(使)震动; [n]震动,震惊,冲击,休克; [^]yshx;
shovel: [-]/ˈʃʌvl/; [n]铁锨,铲; [v]铲起; [^]yshx;
shred: [-]/ʃred/; [n]碎片,少量,毁灭; [v]切成细条,撕成碎片; [^]yshx;
shrewd: [-]/ʃruːd/; [a]精明的;机灵的; [n]精明;精明者; [^]yshx;
shrink: [-]/ʃrɪŋk/; [v]收缩;缩小;退缩; [n](非正式用法)心理医生,精神病医生; [^]yshx;
shrub: [-]/ʃrʌb/; [n]灌木; [^]yshx;
shrug: [-]/ʃrʌɡ/; [n]耸肩; [v](为表示厌恶,轻漠,冷淡,怀疑等)耸肩;以耸肩表示(厌恶,轻蔑,冷淡,怀疑等); [^]yshx;
shutter: [-]/ˈʃʌtər/; [n]百叶窗;照相机快门; [^]yshx;
shuttle: [-]/ˈʃʌtl/; [n]短程穿梭运行的车辆,接驳车;梭子;穿梭;航天飞机; [v]穿梭移动;穿梭往返;往返于两地之间; [^]yshx;
sicken: [-]/ˈsɪkən/; [vi]患病;恶心;厌倦; [vt]使生病;令.恶心;使厌恶; [^]yshx;
siege: [-]/siːdʒ/; [n]围困;包围; [^]yshx;
sieve: [-]/sɪv/; [n]筛子,粗篮; [v]筛,滤; [^]yshx;
sigh: [-]/saɪ/; [n]叹气,叹息; [v]叹息,叹气; [^]yshx;
sightseeing: [-]/ˈsaɪtsiːɪŋ/; [n]观光;游览; [a]观光的,浏览的; [^]yshx;
sign: [-]/saɪn/; [v]签署;使眼色;做暗号;做手势; [n]记号,符号;标志,手势; [^]yshx;
signal: [-]/ˈsɪɡnəl/; [n]信号;预兆; [v]发信号;标志; [a]显著的,优越的;暗号的,作信号用的; [^]yshx;
signature: [-]/ˈsɪɡnətʃər/; [n]签名,署名;识别标志,鲜明特色;个人特色; [^]yshx;
signify: [-]/ˈsɪɡnɪfaɪ/; [vi]具有重要性; [vt]表示; [^]yshx;
simplify: [-]/ˈsɪmplɪfaɪ/; [v]精简,使单纯; [^]yshx;
simulate: [-]/ˈsɪmjuleɪt/; [v]假装;模仿;模拟; [^]yshx;
simultaneous: [-]/ˌsaɪmlˈteɪniəs/; [a]同时发生的; [^]yshx;
sincere: [-]/sɪnˈsɪr/; [a]真诚的,诚恳的; [^]yshx;
single out: [-]/ˈsɪŋɡ(ə)l aʊt/; [v]挑选,选出; [^]yshx;
singular: [-]/ˈsɪŋɡjələr/; [a]单独的,单个的;奇怪的;非凡的,卓越的,显著的; [n]单数;单数形式; [^]yshx;
sink: [-]/sɪŋk/; [n]水槽,洗碗池; [v](使)下沉,(使)降低;淹没,下落;使沉没; [a]贫民窟的; [^]yshx;
site: [-]/saɪt/; [n]场所;地点;网站;现场; [vt]给.造址,坐落于; [^]yshx;
situated: [-]/ˈsɪtʃueɪtɪd/; [a]坐落在.的;处于某种境地的; [^]yshx;
skeleton: [-]/ˈskelɪtn/; [n]骨骼,梗概;骨瘦如柴的人或动物; [^]yshx;
skeptical: [-]/ˈskeptɪkl/; [a]表示怀疑的; [^]yshx;
sketch: [-]/sketʃ/; [n]梗概,素描; [v]速写,打草稿; [^]yshx;
skim: [-]/skɪm/; [v]掠过;浏览,略读;抹去; [n]撇去浮沫;脱脂乳;(为逃税)隐匿的部分收入; [a]撇去奶油的;用脱脂乳做的; [^]yshx;
skip: [-]/skɪp/; [v]跳过;略过;遗漏; [n]跳跃;跳读;省略; [^]yshx;
slab: [-]/slæb/; [n]厚片,硬板; [v]把.分成厚片;用石板铺; [^]yshx;
slack: [-]/slæk/; [a]松弛的;懈怠的;萧条的; [n]松弛的部分,松散; [v]变松弛,逃避工作; [^]yshx;
slag: [-]/slæɡ/; [n]炉渣,矿渣; [^]yshx;
slam: [-]/slæm/; [v]砰地关上;猛力拉,扔;砰地放下;猛烈抨击; [n]砰的一声;大满贯; [^]yshx;
slander: [-]/ˈslændər/; [n]诽谤,诋毁; [v]讲坏话,污蔑,诽谤; [^]yshx;
slap: [-]/slæp/; [v]掌掴,拍打,侮辱; [n]侮辱,掴,拍击声; [ad]猛然;径直;恰好;正好; [^]yshx;
slate: [-]/sleɪt/; [n]黑板,石板,候选人名单; [v]提名; [^]yshx;
slaughter: [-]/ˈslɔːtər/; [v]屠杀,屠宰; [n]屠宰,屠杀; [^]yshx;
slender: [-]/ˈslendər/; [a]苗条的,修长的,纤细的; [^]yshx;
slice: [-]/slaɪs/; [v]把..切成片;大幅度削减;切开; [n]薄片;份额,部分; [^]yshx;
slide: [-]/slaɪd/; [n]滑行;下落;滑面;幻灯片; [v]使滑动;使滑入;滑动;滑倒;滑落;下跌; [^]yshx;
slim: [-]/slɪm/; [a]细长的;苗条的; [v](用运动,节食等)减轻体重,变苗条; [^]yshx;
slip: [-]/slɪp/; [v]滑倒,跌落,溜走,疏忽;偷偷地给;被遗忘; [n]溜走;疏忽,错误;纸条; [a]打有活结的;可拆卸的;滑动的; [^]yshx;
slit: [-]/slɪt/; [n]投币口,裂缝; [v]切开; [^]yshx;
slogan: [-]/ˈsloʊɡən/; [n]标语;口号;广告语; [^]yshx;
slope: [-]/sloʊp/; [n]山坡,斜坡,倾斜; [v]倾斜; [^]yshx;
slot: [-]/slɑːt/; [n]狭缝,狭槽,(机构的)职位; [v]把.放入狭长开口中,把.纳入; [^]yshx;
sluggish: [-]/ˈslʌɡɪʃ/; [a]行动迟缓的,迟钝的;偷懒的; [^]yshx;
slum: [-]/slʌm/; [n]贫民窟,贫民区,陋巷; [v]去贫民窟,到贫民区去(参观,游玩等); [^]yshx;
smash: [-]/smæʃ/; [v]粉碎,猛冲,击溃; [n]破碎(声),猛撞,巨大的成功; [a]极为成功的; [^]yshx;
smooth: [-]/smuːð/; [a]光滑的;平稳的; [v]使光滑;使平稳; [^]yshx;
smuggle: [-]/ˈsmʌɡl/; [v]非法偷运;走私; [^]yshx;
snack: [-]/snæk/; [n]零食,小吃,快餐; [^]yshx;
snap at sb.: [-]/snæp æt ˈsʌmbədi/; [v]对人厉声说; [^]yshx;
snap at sth.: [-]/snæp æt ˈsʌmθɪŋ/; [v]咬住; [^]yshx;
snatch: [-]/snætʃ/; [v]强夺;攫取; [n]片断; [^]yshx;
soak: [-]/soʊk/; [v]浸泡,渗透,吸入; [n]浸泡; [^]yshx;
soar: [-]/sɔːr/; [v]高飞,翱翔;飞腾;猛增;高飞越过; [n]高飞;高涨; [^]yshx;
sober: [-]/ˈsoʊbər/; [vi]变得冷静; [a]未饮醉的,清醒的;有节制的;严肃的; [v]使清醒;使冷静; [^]yshx;
sociable: [-]/ˈsoʊʃəbl/; [a]好交际的; [^]yshx;
sociology: [-]/ˌsoʊsiˈɑːlədʒi/; [n]社会学; [^]yshx;
soil: [-]/sɔɪl/; [n]泥土,土壤;土地,国土; [v]弄脏;污损; [^]yshx;
sole: [-]/soʊl/; [n]脚底,鞋底,袜底; [a]唯一的;独有的;单独的; [v]装鞋底; [^]yshx;
solemn: [-]/ˈsɑːləm/; [a]严肃的;庄严的,隆重的;神圣的; [^]yshx;
solidarity: [-]/ˌsɑːlɪˈdærəti/; [n]团结一致; [^]yshx;
solitary: [-]/ˈsɑːləteri/; [a]孤独的,单独的,隐居的; [n]独居者,隐士;单独禁闭; [^]yshx;
solo: [-]/ˈsoʊloʊ/; [n]独唱; [a]独奏的;单独的; [ad]独奏地;单独地; [v]放单飞; [^]yshx;
soluble: [-]/ˈsɑːljəbl/; [a]可溶解的;可解决的; [^]yshx;
solvent: [-]/ˈsɑːlvənt/; [a]有偿付能力的;有溶解力的; [n]溶剂;解决方法; [^]yshx;
somewhat: [-]/ˈsʌmwʌt/; [ad]有点儿,稍微,有些; [pron]某物;一些; [^]yshx;
sophisticated: [-]/səˈfɪstɪkeɪtɪd/; [a](仪器)精密的,复杂的;老于世故的,老练的,富有经验的;高雅的,精致的; [^]yshx;
sore: [-]/sɔːr/; [a]疼痛的,酸痛的;恼火的; [n]疮; [ad]〈古,诗〉同"sorely. a sore throat"; [^]yshx;
sort sth. out: [-]/sɔːrt ˈsʌmθɪŋ aʊt/; [phr]分类,拣选,整理;解决;消除误会; [^]yshx;
sort: [-]/sɔːrt/; [v]把..分类,挑选;修理,整理; [n]种类; [^]yshx;
sour: [-]/ˈsaʊər/; [a]酸的;(人)尖酸刻薄的,不友好的; [v](友谊,局势,态度等)变坏;使恶化; [^]yshx;
souvenir: [-]/ˈsuːvənɪr/; [n]纪念物,纪念品; [vt]把.留作纪念; [^]yshx;
sovereign: [-]/ˈsɑːvrən/; [a]至高无上的,具有独立主权的,有最高统治权的; [n]最高统治者,君主,元首; [^]yshx;
sow: [-]/soʊ/; [v]播种;散布;煽动; [n]母猪; [^]yshx;
spacious: [-]/ˈspeɪʃəs/; [a]宽敞的,广阔的; [^]yshx;
span: [-]/spæn/; [n]跨度;时间段;范围;持续时间; [v]持续;横跨;包括; [^]yshx;
spare: [-]/sper/; [a]备用的;多余的,闲置的;瘦的; [n]零件,备件; [v]抽出,腾出;免去; [^]yshx;
sparkle: [-]/ˈspɑːrkl/; [vi]闪耀;焕发,活跃,才华横溢; [n]光亮;活力; [^]yshx;
sparse: [-]/spɑːrs/; [a]稀少的;稀疏的; [^]yshx;
spatial: [-]/ˈspeɪʃl/; [a]空间的,关于空间的; [^]yshx;
speak one's mind: [-]/spik wʌnz maɪnd/; [phr]直言不讳,吐露心声; [^]yshx;
specialize: [-]/ˈspeʃəlaɪz/; [v]专门研究,专门从事; [^]yshx;
species: [-]/ˈspiːʃiːz/; [n](单复同)物种;种类;人类; [a]物种上的; [^]yshx;
specification: [-]/ˌspesɪfɪˈkeɪʃn/; [n]规格,载明,详述; [^]yshx;
specimen: [-]/ˈspesɪmən/; [n]标本,样本,样品; [^]yshx;
spectacular: [-]/spekˈtækjələr/; [a]壮观的,引人入胜的; [n]壮观的场面,精彩的表演; [^]yshx;
spectator: [-]/ˈspekteɪtər/; [n]旁观者;观众;目击者; [^]yshx;
spectrum: [-]/ˈspektrəm/; [n]光谱,范围,系列; [^]yshx;
speculate: [-]/ˈspekjuleɪt/; [vi]推测,猜测;投机,做投机买卖; [vt]推测; [^]yshx;
sphere: [-]/sfɪr/; [n]球;球形;领域; [^]yshx;
spill: [-]/spɪl/; [v]使溢出;使流出;撒;浇(花等); [n]溢出,溅出;溢出量;摔下; [^]yshx;
spin: [-]/spɪn/; [v](使)旋转;纺织;疾驰;眩晕; [n]旋转;纺织;眩晕; [^]yshx;
spiral: [-]/ˈspaɪrəl/; [n]螺旋,螺线; [v]不断急剧地上升(或下降),螺旋形行进; [a]螺旋的; [^]yshx;
spiritual: [-]/ˈspɪrɪtʃuəl/; [a]精神(上)的;宗教(上)的; [^]yshx;
spit: [-]/spɪt/; [v]吐(唾沫); [n]唾液,唾沫,叉子; [^]yshx;
splash: [-]/splæʃ/; [v]泼洒,溅,使成斑驳状;将.置于显眼位置; [n]污点;飞溅的水;卖弄;拍打水的声音; 落入水的声音; [^]yshx;
splendid: [-]/ˈsplendɪd/; [a]壮观的,辉煌的,华丽的;极好的,出色的; [^]yshx;
split: [-]/splɪt/; [n]劈裂;裂缝;碎片;分裂;不和; [a]分裂的;不一致的; [v]分开;裂开;被撕破;劈开;割开;撕裂;分配;分担;使分裂; [^]yshx;
spoil: [-]/spɔɪl/; [v]溺爱;娇惯;(食物)变质;毁坏; [n]溺爱;战利品;犒劳;成功所带来的好处; [^]yshx;
spokesman: [-]/ˈspoʊksmən/; [n]发言人; [^]yshx;
sponge: [-]/spʌndʒ/; [n]海绵,多孔布丁,松蛋糕; [v]用湿海绵(或布)擦,揩; [^]yshx;
sponsor: [-]/ˈspɑːnsər/; [n]倡导者;提案人;赞助人;担保人;教父,教母; [vt]发起;倡议;做.的保人;赞助;资助; [^]yshx;
spontaneous: [-]/spɑːnˈteɪniəs/; [a]自发的,无意识的;自然的,天真率直的; [^]yshx;
sporadic: [-]/spəˈrædɪk/; [a]不定时发生的;零星的;分散的; [^]yshx;
spotlight: [-]/ˈspɑːtlaɪt/; [n]聚光灯; [v]聚光照明,使显著; [^]yshx;
spouse: [-]/spaʊs/; [n]配偶,夫妇;夫,妻; [v]和.结婚; [^]yshx;
sprawl: [-]/sprɔːl/; [n]四肢伸开的躺卧姿势;蔓生; [v]四肢伸开地坐(或卧);爬行;蔓生; [^]yshx;
spray: [-]/spreɪ/; [n]浪花;水雾;喷雾; [vi]飞溅,喷; [vt]喷;向..扫射;散布; [^]yshx;
sprint: [-]/sprɪnt/; [v]疾跑,冲刺; [n]全速奔跑; [^]yshx;
sprout: [-]/spraʊt/; [v]发芽,开始生长;发展; [n]苗芽; [^]yshx;
spur: [-]/spɜːr/; [v]策马,用踢马刺驱马前进;激励,鞭策;推动; [n]踢马刺,靴刺;刺激,鞭策,鼓励;尖坡; [^]yshx;
square: [-]/skwer/; [n]正方形;广场; [a]正方形的;平方的;直角的; [v]把..弄成方形; [ad]直接地; [^]yshx;
squeeze: [-]/skwiːz/; [v](常指用手)挤压;挤进,塞进;用力挤压榨取;减少,压缩; [n]榨;压榨;挤,塞; [^]yshx;
stabilize: [-]/ˈsteɪbəlaɪz/; [v]使稳定; [^]yshx;
stack: [-]/stæk/; [n]堆,一大堆;烟囱; [v]堆积,堆放; [^]yshx;
stadium: [-]/ˈsteɪdiəm/; [n](周围有看台的)体育场,露天大型运动场; [^]yshx;
staff: [-]/stæf/; [n]全体职员,员工;参谋;拐杖;五线谱; [a]行政工作的;参谋的;职员的;作为正式工作人员的; [v]雇用工作人员;给.配备员工; [^]yshx;
stagger: [-]/ˈstæɡər/; [v]蹒跚;(使)错开(时间),交错安排;使吃惊; [n]蹒跚; [^]yshx;
stagnant: [-]/ˈstæɡnənt/; [a]不流动的;停滞的;萧条的; [^]yshx;
stain: [-]/steɪn/; [n]污渍,污迹;染色; [v]弄脏;玷污;染色; [^]yshx;
stake: [-]/steɪk/; [n]木桩;赌注;利害关系;股份,股本;(赛马)奖金; [v]下注,以桩来支撑; [^]yshx;
stale: [-]/steɪl/; [a]不新鲜的;走了味的;陈腐的; [v]变得不新鲜;使陈旧; [n](猎人做掩蔽用的)假马;笑柄;受人愚弄成为笑谈的人;畜尿; [^]yshx;
stall: [-]/stɔːl/; [n]分隔栏;售货摊;厩; [v]停止(因故障); [^]yshx;
stand by sb.: [-]/stænd baɪ ˈsʌmbədi/; [v]支持某人; [^]yshx;
stand by sth.: [-]/stænd baɪ ˈsʌmθɪŋ/; [phr]信守;支持; [^]yshx;
stand for sth.: [-]/stænd fɔːr ˈsʌmθɪŋ/; [v]表示;代表; [^]yshx;
stand in (for sb.): [-]/stænd ɪn fɔːr ˈsʌmbədi/; [v]代替; [^]yshx;
stand in line: [-]/stænd ɪn laɪn/; [v]排队; [^]yshx;
stand off: [-]/stænd ɑf/; [phr]远离;疏远; [^]yshx;
stand out: [-]/stænd aut/; [phr]突出;继续抵抗; [^]yshx;
standard: [-]/ˈstændərd/; [n]标准,规格;规范; [a]标准的; [^]yshx;
staple: [-]/ˈsteɪpl/; [v]用订书钉订; [n]订书钉;主食;主要产品; [a]主要的;基本的;标准的; [^]yshx;
starch: [-]/stɑːrtʃ/; [n]淀粉; [v]给.上浆; [^]yshx;
starve: [-]/stɑːrv/; [v](使)饿死,挨饿; [^]yshx;
statesman: [-]/ˈsteɪtsmən/; [n]政治家; [^]yshx;
static: [-]/ˈstætɪk/; [a]静电的,静态的,静止的; [n]静电,静电干扰; [^]yshx;
stationary: [-]/ˈsteɪʃəneri/; [a]静止的;固定的; [n]定居者,驻军; [^]yshx;
stationery: [-]/ˈsteɪʃəneri/; [n]文具;(有配套信封的)信纸; [^]yshx;
statistics: [-]/stəˈtɪstɪks/; [n]统计;统计数字,数据;统计学; [^]yshx;
status: [-]/ˈsteɪtəs/; [n]地位;状态;身份; [^]yshx;
statute: [-]/ˈstætʃuːt/; [n]法令,法规,条例; [^]yshx;
steadfast: [-]/ˈstedfæst/; [a]坚定的;不变的; [^]yshx;
steady: [-]/ˈstedi/; [a]稳定的,不变的;坚定的,扎实的,镇定的; [v](使)稳固,(使)稳定;使..冷静; [^]yshx;
steak: [-]/steɪk/; [n]牛排;肉块;鱼块; [^]yshx;
steamer: [-]/ˈstiːmər/; [n]蒸汽船;蒸锅; [^]yshx;
steep: [-]/stiːp/; [v]沉浸于..; [a]陡峭的;急剧的;过高的; [n]陡坡; [^]yshx;
steer: [-]/stɪr/; [v]操纵,驾驶,掌舵,引导; [n]公牛,食用牛; [^]yshx;
stem: [-]/stem/; [n]茎,(树)干; [v]阻止;起源于;遏制,抑制; [^]yshx;
stereo: [-]/ˈsterioʊ/; [n]立体声(装置); [a]立体声的; [^]yshx;
stereotype: [-]/ˈsteriətaɪp/; [n]老套的模式,陈规,成见; [v]对..产生成见; [^]yshx;
sterilize: [-]/ˈsterəlaɪz/; [vt]消毒;使不孕;使(土地)不毛; [^]yshx;
sterling: [-]/ˈstɜːrlɪŋ/; [n]英国货币; [a]高尚的;出色的,优秀的;英币的; [^]yshx;
stern: [-]/stɜːrn/; [a]严厉的;严峻的;苛刻的;坚决的; [n]船尾; [^]yshx;
steward: [-]/ˈstuːərd/; [n]乘务员,服务员;管家; [^]yshx;
stick around: [-]/stɪk ə'raʊnd/; [v]逗留; [^]yshx;
stick sth. out: [-]/stɪk ˈsʌmθɪŋ aʊt/; [v]伸出; [^]yshx;
stick to sb. (sth.): [-]/stɪk tu ˈsʌmbədi (ˈsʌmθɪŋ)/; [phr]忠于; [^]yshx;
stick up: [-]/stɪk ʌp/; [phr]竖起; [^]yshx;
stiff: [-]/stɪf/; [a]僵直的,酸痛的;硬的;困难的; [^]yshx;
stimulus: [-]/ˈstɪmjələs/; [n]刺激物;鼓励;促进因素; [^]yshx;
sting: [-]/stɪŋ/; [v]叮;刺疼;使苦闷;蜇; [n](因被刺而引起的)疼痛;(警方为抓捕罪犯精心设计的)圈套; [^]yshx;
stipulate: [-]/ˈstɪpjuleɪt/; [v]规定;保证;保证;要求以.为条件; [^]yshx;
stitch: [-]/stɪtʃ/; [v]缝,绣; [n]一针,线迹;缝法,编结法;(肋部的)突然剧痛;缝合(伤口); [^]yshx;
stock: [-]/stɑːk/; [n]股票;股份;存货;储备;家畜; [v]给..装满;储存; [a]储备的; [^]yshx;
stoop: [-]/stuːp/; [v]弯腰,俯身;屈从;堕落,沦为; [n]弯腰; [^]yshx;
story: [-]/ˈstɔːri/; [n]故事,小说;叙述,描述;新闻报道;谎言,假话;楼层; [^]yshx;
straightforward: [-]/ˌstreɪtˈfɔːrwərd/; [a]坦率的,笔直的,正直的,直接的; [^]yshx;
strain: [-]/streɪn/; [n]负担;紧张;拉力;(生物体)品种,种类; [v]拉紧;劳累;过分使用; [^]yshx;
strait: [-]/streɪt/; [n]海峡;窘迫; [^]yshx;
strap: [-]/stræp/; [v]捆扎; [n]带子; [^]yshx;
strategic: [-]/strəˈtiːdʒɪk/; [a]战略(上)的,对全局有重要意义的,关键的; [^]yshx;
strengthen: [-]/ˈstreŋθn/; [v]加强,变坚固,变强大; [^]yshx;
strenuous: [-]/ˈstrenjuəs/; [a]费力的;奋发的;热心的;艰苦的;紧张的; [^]yshx;
stress: [-]/stres/; [n]强调;节拍;紧迫;压力; [vt]给.加压力;使紧张;强调; [^]yshx;
stretch: [-]/stretʃ/; [v]伸展,延伸,张开,夸大,超越; [n]伸展,张开;一段时间;一段路程; [a]可伸缩的;弹性的; [^]yshx;
stride: [-]/straɪd/; [v]大步走;越过;跨越; [vt]大步走过;跨骑在.上; [n]大步;阔步行走的姿势;一大步;跨越;正常的进展; [^]yshx;
striking: [-]/ˈstraɪkɪŋ/; [a]容貌出众的,吸引人的;显著的,突出的; [n]罢工; [^]yshx;
string: [-]/strɪŋ/; [n]弦,线,细绳,一系列;一行; [v]串起;悬挂;使紧张; [a]线的,线织的;由弦乐器组成的; [^]yshx;
strip: [-]/strɪp/; [v]剥;夺去;脱衣服; [n]长条;长条形土地; [a]脱衣舞的;被剥去外皮的; [^]yshx;
strive: [-]/straɪv/; [v]斗争;努力,奋斗; [^]yshx;
stroke: [-]/stroʊk/; [n]击打;一击,一次,一举;中风;抚摸;笔画; [v]拭去;轻抚; [^]yshx;
structural: [-]/ˈstrʌktʃərəl/; [a]结构的,构造的,建筑的; [^]yshx;
stubborn: [-]/ˈstʌbərn/; [a]顽固的;倔强的;难对付的; [^]yshx;
stuff: [-]/stʌf/; [n]东西;材料;原料; [v]塞满;把..装进; [a]毛织品做的; [^]yshx;
stumble: [-]/ˈstʌmbl/; [v]绊跌,绊倒;结结巴巴说话; [n]绊倒;失足;失误;失败; [^]yshx;
sturdy: [-]/ˈstɜːrdi/; [a]结实的;坚固的;强壮的;健壮的; [n](羊的)晕倒病; [^]yshx;
style: [-]/staɪl/; [n]风格;样式; [v]称呼;设计; [^]yshx;
subdue: [-]/səbˈduː/; [v]征服,压制,减轻; [^]yshx;
submerge: [-]/səbˈmɜːrdʒ/; [v]沉没,淹没;遮掩; [^]yshx;
submit: [-]/səbˈmɪt/; [v]提交;屈服,使...服从;建议,主张; [^]yshx;
subordinate: [-]/səˈbɔːrdɪnət/; [n]部下;下属; [a]次要的;从属的;下级的; [v]使从属于;使处于次要地位; [^]yshx;
subscribe: [-]/səbˈskraɪb/; [vi]捐款;订阅;认购(股份); [vt]申请; [^]yshx;
subsequent: [-]/ˈsʌbsɪkwənt/; [a]随后的; [^]yshx;
subside: [-]/səbˈsaɪd/; [vi]平息,减弱;减弱;(建筑)下陷;(尤指洪水的水位) 回落; [^]yshx;
substantiate: [-]/səbˈstænʃieɪt/; [v]证实;使实体化; [^]yshx;
substitute: [-]/ˈsʌbstɪtuːt/; [v]代替; [n]代替者,代用品,替补队员; [^]yshx;
subtle: [-]/ˈsʌtl/; [a]微妙的;敏锐的;不明显的;精细的;狡猾的; [^]yshx;
subtract: [-]/səbˈtrækt/; [v]减少;减去;扣除; [vt]减去; [^]yshx;
succession: [-]/səkˈseʃn/; [n]连续,继续;一连串;继承权; [^]yshx;
succumb: [-]/səˈkʌm/; [v]屈从,屈服,因.死亡(to); [^]yshx;
suck: [-]/sʌk/; [v]啜,吸入,吸收;使卷入;糟糕,差劲; [n]吸吮,吸力; [^]yshx;
sue: [-]/suː/; [v]控告,提起诉讼;控告;起诉; [n]女子名(Sue); [^]yshx;
sufficient: [-]/səˈfɪʃnt/; [a]足够的;充分的; [^]yshx;
suicide: [-]/ˈsuːɪsaɪd/; [n]自杀;自毁; [^]yshx;
suitcase: [-]/ˈsuːtkeɪs/; [n]小提箱,手提箱; [^]yshx;
summary: [-]/ˈsʌməri/; [n]摘要,总结; [a]简略的,概要的,即决的; [^]yshx;
summit: [-]/ˈsʌmɪt/; [n]山顶,顶点;(政府间的)峰会; [^]yshx;
summon: [-]/ˈsʌmən/; [v]召唤;召集;聚集; [^]yshx;
superb: [-]/suːˈpɜːrb/; [a]极好的;壮丽的; [^]yshx;
superficial: [-]/ˌsuːpərˈfɪʃl/; [a]肤浅的;表面的;微不足道的; [n]表面文章; [^]yshx;
superfluous: [-]/suːˈpɜːrfluəs/; [a]多余的,过剩的;不必要的; [^]yshx;
superintend: [-]/ˌsuːpərɪnˈtend/; [v]监督;主管;指挥; [^]yshx;
supersede: [-]/ˌsuːpərˈsiːd/; [v]代替;紧接着而到来; [^]yshx;
superstition: [-]/ˌsuːpərˈstɪʃn/; [n]迷信,盲目恐惧; [^]yshx;
supervise: [-]/ˈsuːpərvaɪz/; [v]监督;指导;管理; [^]yshx;
suppress: [-]/səˈpres/; [v]镇压;禁止发表;抑制(感情等);阻止.的生长; [^]yshx;
supreme: [-]/suːˈpriːm/; [a]至高的;最重要的;极度的; [^]yshx;
surcharge: [-]/ˈsɜːrtʃɑːrdʒ/; [n]额外费用,过高的要价; [v]追加罚款;使.装载过多;使.负担过重; [^]yshx;
surge: [-]/sɜːrdʒ/; [n]波涛汹涌;波动;激增; [v]波浪般汹涌奔腾;激增; [^]yshx;
surgeon: [-]/ˈsɜːrdʒən/; [n]外科医生; [^]yshx;
surgery: [-]/ˈsɜːrdʒəri/; [n]外科手术;外科; [^]yshx;
surmount: [-]/sərˈmaʊnt/; [v]克服,战胜,越过; [^]yshx;
surpass: [-]/sərˈpæs/; [v]胜过;超出; [^]yshx;
surplus: [-]/ˈsɜːrplʌs/; [a]过剩的,多余的; [n]过剩,盈余;顺差; [^]yshx;
surrender: [-]/səˈrendər/; [v]投降;屈服;放弃;交出;自首; [n]投降;放弃;屈服;(保险的)解约; [^]yshx;
survey: [-]/ˈsɜːrveɪ/; [n]调查;测量;鉴定; [v]测量,勘测;鉴定;调查; [^]yshx;
survival: [-]/sərˈvaɪvl/; [n]存活;生存; [^]yshx;
susceptible: [-]/səˈseptəbl/; [a]易受感染的;易受影响的;多情的; [^]yshx;
suspect: [-]/səˈspekt/; [n]嫌疑犯,可疑分子; [v]怀疑,猜疑;推测; [a]可疑的; [^]yshx;
suspend: [-]/səˈspend/; [v]悬挂,吊;中止;推迟; [^]yshx;
suspense: [-]/səˈspens/; [n]悬疑;焦虑;悬念;悬而未决; [a]令人挂心的,令人心焦的,产生悬念的; [^]yshx;
suspicious: [-]/səˈspɪʃəs/; [a]可疑的,引起怀疑的;怀疑的,猜疑的; [^]yshx;
sustain: [-]/səˈsteɪn/; [v]维持;支撑,承受;供养;忍受;遭受,蒙受; [^]yshx;
sustenance: [-]/ˈsʌstənəns/; [n]生计;食物,粮食; [^]yshx;
swallow: [-]/ˈswɑːloʊ/; [n]吞咽;燕子;一次吞咽的量; [vi]做吞咽动作,咽口水; [v]咽下,吞下; [vt]相信; [^]yshx;
swamp: [-]/swɑːmp/; [n]沼泽; [v]淹没,浸没;使困惑,压倒; [^]yshx;
swarm: [-]/swɔːrm/; [n]蜂群;一群,一批人; [v]蜂拥;密集; [vt]蜂拥;挤满; [^]yshx;
sway: [-]/sweɪ/; [v]摇摆,摇曳;动摇(某人); [n]摇摆;支配,影响; [^]yshx;
swear: [-]/swer/; [v]发誓,郑重地说;咒骂; [^]yshx;
sweater: [-]/ˈswetər/; [n]毛衣,厚运动衫,羊毛衫; [^]yshx;
sweep: [-]/swiːp/; [v]打扫;快速移动; [n]清扫;一挥(手,胳膊等);范围,广度;绵延弯曲的地带; [^]yshx;
swell: [-]/swel/; [v](使)膨胀,(使)鼓起; [n]增大,膨胀,肿胀,汹涌; [a]时髦的;一流的;很好的; [^]yshx;
swerve: [-]/swɜːrv/; [v]转弯,突然改变方向; [n]转向;滑出;逸出;背离; [^]yshx;
swift: [-]/swɪft/; [a]敏捷的,矫健的;快速的,迅速的; [n]雨燕; [^]yshx;
swirl: [-]/swɜːrl/; [n]漩涡;打旋;涡状形; [v]盘绕;打旋;眩晕;大口喝酒; [^]yshx;
sympathetic: [-]/ˌsɪmpəˈθetɪk/; [a]有同情心的,同情的;支持的;称心的; [^]yshx;
synchronize: [-]/ˈsɪŋkrənaɪz/; [v]校准时间;使协调;与......同步; [^]yshx;
synonym: [-]/ˈsɪnənɪm/; [n]同义词;同义密码子; [^]yshx;
synthesis: [-]/ˈsɪnθəsɪs/; [n]合成; [^]yshx;
synthetic: [-]/sɪnˈθetɪk/; [a]合成的,人造的;<语>综合型的,综合性的,借助词尾变化表示句法关系的; [n]合成物; [^]yshx;
systematic: [-]/ˌsɪstəˈmætɪk/; [a]有系统的,系统化的,有条理的;有计划有步骤的,有条不紊的; [^]yshx;
tablet: [-]/ˈtæblət/; [n]药片;便笺簿;碑,匾; [^]yshx;
taboo: [-]/təˈbuː/; [n]禁忌,(宗教)戒律; [a](因不道德或危险而)讳忌的,戒律的; [^]yshx;
tacit: [-]/ˈtæsɪt/; [a]心照不宣的,静默的; [^]yshx;
tackle: [-]/ˈtækl/; [v]对付,处理;(足球等比赛中)阻截; [n]阻截;钓具;滑轮(组); [^]yshx;
tactic: [-]/ˈtæktɪk/; [n](达到目的)手段,战术,策略; [a]按顺序的;依次排列的; [^]yshx;
take after sb.: [-]/teɪk ˈæftər ˈsʌmbədi/; [v]像某人; [^]yshx;
take off: [-]/teɪk, ɒf/; [phr](飞机)起飞;拿掉;取消;脱衣;(事业)突然成功,突然蹿红; [^]yshx;
take one's time (over sth.): [-]/teɪk wʌnz taɪm ˈoʊvər ˈsʌmθɪŋ/; [v]慢慢做; [^]yshx;
take pains to do: [-]/teɪk peɪnz tu doʊ/; [phr]尽力去做;费劲苦心做某事; [^]yshx;
take sb. in: [-]/teɪk ˈsʌmbədi ɪn/; [phr]收留;欺骗;带到警察局; [^]yshx;
take sb. off: [-]/teɪk ˈsʌmbədi ɑːf/; [phr]带走; [^]yshx;
take sb. out: [-]/teɪk ˈsʌmbədi aʊt/; [phr]带.出去;淘汰出局; [^]yshx;
take sth. apart: [-]/teɪk ˈsʌmθɪŋ əˈpɑːrt/; [phr]拆开; [^]yshx;
take sth. back: [-]/teɪk ˈsʌmθɪŋ bæk/; [phr]收回;取回; [^]yshx;
take sth. down: [-]/teɪk ˈsʌmθɪŋ daʊn/; [v]记录下来;拆除; [^]yshx;
take sth. in: [-]/teɪk ˈsʌmθɪŋ ɪn/; [v]承接;领会;改小尺寸; [^]yshx;
take sth. into account: [-]/teɪk ˈsʌmθɪŋ ˈɪntu əˈkaʊnt/; [v]考虑到某事; [^]yshx;
take sth. off: [-]/teɪk ˈsʌmθɪŋ ɑːf/; [phr]除去;取消;脱掉; [^]yshx;
take sth. out: [-]/teɪk ˈsʌmθɪŋ aʊt/; [v]去掉;取得,取出; [^]yshx;
take sth. over: [-]/teɪk ˈsʌmθɪŋ ˈoʊvər/; [v]接管; [^]yshx;
take sth. to heart: [-]/teɪk ˈsʌmθɪŋ tu hɑːrt/; [phr]牢记;为某事耿耿于怀; [^]yshx;
take sth. upon oneself: [-]/teɪk ˈsʌmθɪŋ əˈpɔːn wʌnˈself/; [phr]承担;担任; [^]yshx;
take stock of: [-]/teɪk stɒk ɑv/; [v]估量;观察; [^]yshx;
take to sth.(sb.): [-]/teɪk tu ˈsʌmθɪŋ ˈsʌmbədi/; [phr]喜欢;养成.习惯; [^]yshx;
take-away: [-]/teɪk əˈweɪ/; [phr]外带,外卖; [^]yshx;
talented: [-]/ˈtæləntɪd/; [a]有才能的,天资高的; [^]yshx;
tame: [-]/teɪm/; [a]驯服的,温顺的;顺从的;枯燥的; [v]驯服; [^]yshx;
tamper: [-]/ˈtæmpər/; [v]篡改;玩弄;贿赂; [n]填塞者;捣棒; [^]yshx;
tangle: [-]/ˈtæŋɡl/; [v](使)缠结;(使)乱作一团; [n]纠缠;纠结;复杂的问题;困惑; [^]yshx;
tap: [-]/tæp/; [n]塞子;水龙头;轻敲; [v]轻叩,轻敲;监听,窃听 (电话);开发,发掘;利用; [^]yshx;
taxation: [-]/tækˈseɪʃn/; [n]税制,税项,税款; [^]yshx;
tear: [-]/ter/; [v]撕裂,撕碎; [n]眼泪; [^]yshx;
tease: [-]/tiːz/; [v]取笑;挑逗;逗弄;使..渴望;逆梳; [n]爱戏弄别人者; [^]yshx;
technician: [-]/tekˈnɪʃn/; [n]技术员,技师;技术专家; [^]yshx;
technique: [-]/tekˈniːk/; [n]技巧,技能;方法;技术; [^]yshx;
tedious: [-]/ˈtiːdiəs/; [a]沉闷的,冗长乏味的; [^]yshx;
teem: [-]/tiːm/; [vi]充满;大量存在于; [vt]生下; [^]yshx;
telecommunication: [-]/ˌtelikəˌmjuːnɪˈkeɪʃn/; [n]远程通讯; [a]与电信有关的; [^]yshx;
telling: [-]/ˈtelɪŋ/; [a]明显的;生动的; [n]叙述; [^]yshx;
temporary: [-]/ˈtempəreri/; [a]暂时的,临时的; [^]yshx;
temptation: [-]/tempˈteɪʃn/; [n]引诱,诱惑; [^]yshx;
tenable: [-]/ˈtenəbl/; [a]站得住脚的;无懈可击的;合理的; [^]yshx;
tenacious: [-]/təˈneɪʃəs/; [a]坚忍不拔的,固执的,顽强的; [^]yshx;
tenancy: [-]/ˈtenənsi/; [n]租赁;租期; [^]yshx;
tendency: [-]/ˈtendənsi/; [n]趋向,趋势,倾向;癖好,意向;派别; [^]yshx;
tender: [-]/ˈtendər/; [a]温柔的;嫩的;柔弱的,脆弱的;痛的; [n]煤水车,附属船;投标; [v]提出(希望对方接受的意见等); [^]yshx;
tension: [-]/ˈtenʃn/; [n](精神上的)紧张,不安;紧张局面;拉紧;张力;电压; [v]绷紧; [^]yshx;
tentative: [-]/ˈtentətɪv/; [a]试探性的;不确定的;暂时的;犹豫不决的; [^]yshx;
terminal: [-]/ˈtɜːrmɪnl/; [n]终点,终端;航站楼;终点站; [a]末端的;晚期的; [^]yshx;
terminate: [-]/ˈtɜːrmɪneɪt/; [a]终止的;可结尾的; [vi]结束;结尾; [v]使结束,终止; [^]yshx;
terrace: [-]/ˈterəs/; [n]阳台;梯田;走廊; [vi]成阶地; [a]梯形的; [vt]使成梯田; [^]yshx;
terrestrial: [-]/təˈrestriəl/; [a]地球的,陆地的; [n]陆地生物;地球上的人; [^]yshx;
terrific: [-]/təˈrɪfɪk/; [a]极好的;可怕的;(尺寸或程度)极其巨大的,大的惊人的; [^]yshx;
terse: [-]/tɜːrs/; [a]简洁的,简明的; [^]yshx;
tertiary: [-]/ˈtɜːrʃieri/; [a]第三的,第三级的;第三品级的; [n]<地质学>第三纪;第三品级的神职人员; [^]yshx;
the accused: [-]/ði əˈkjuːzd/; [n]被告; [^]yshx;
the gist: [-]/ðə dʒɪst/; [n]要旨; [^]yshx;
the pick of: [-]/ðə pɪk ɑv/; [phr]精华,最好部分; [^]yshx;
the present day: [-]/ˌpreznt ˈdeɪ/; [phr]现代; [^]yshx;
theft: [-]/θeft/; [n]偷盗,失窃; [^]yshx;
theme: [-]/θiːm/; [n]主题;主旨;主旋律; [a]主题的; [v]赋予.某种主题; [^]yshx;
thermal: [-]/ˈθɜːrml/; [a]保暖的;温泉的;热的; [n]保暖内衣裤; [^]yshx;
thermometer: [-]/θərˈmɑːmɪtər/; [n]温度计; [^]yshx;
thermostat: [-]/ˈθɜːrməstæt/; [n]恒温器; [^]yshx;
thesaurus: [-]/θɪˈsɔːrəs/; [n]词典,分类词汇汇编; [^]yshx;
thesis: [-]/ˈθiːsɪs/; [n](学位)论文,论题,论点; [^]yshx;
thigh: [-]/θaɪ/; [n]大腿; [^]yshx;
think nothing of: [-]/θɪŋk ˈnʌθɪŋ ɑv/; [v]把.看作平常; [^]yshx;
thirst: [-]/θɜːrst/; [n]渴;干渴,缺水;渴求,渴望; [v]渴求; [^]yshx;
thorough: [-]/ˈθɜːroʊ/; [a]彻底的,完全的;详尽的,细致深入的; [^]yshx;
thoughtful: [-]/ˈθɔːtfl/; [a]体贴的;沉思的; [^]yshx;
threshold: [-]/ˈθreʃhoʊld/; [n]门槛;开端; [^]yshx;
thrill: [-]/θrɪl/; [n]兴奋,激动,引起激动的事物; [v](使)非常兴奋,(使)非常激动; [^]yshx;
thrive: [-]/θraɪv/; [v]茁壮成长;繁荣,兴旺; [^]yshx;
throat: [-]/θroʊt/; [n]咽喉,嗓子;口子; [^]yshx;
throbbing: [-]/ˈθrɑːbɪŋ/; [a]跳动的,悸动的; [^]yshx;
throng: [-]/θrɔːŋ/; [v]群集,蜂拥; [n]一大群人; [vt]挤向; [^]yshx;
throughout: [-]/θruːˈaʊt/; prep. 在..期间,贯穿;遍及; [ad]自始至终;到处; [^]yshx;
thrust: [-]/θrʌst/; [v]猛冲,猛推;刺,戳; [n]猛冲,推进;推力;主要观点; [^]yshx;
thumb: [-]/θʌm/; [n]拇指; [vt]以拇指示意;迅速翻阅; [vi]<口语>作手势要求搭车; [^]yshx;
thunder: [-]/ˈθʌndər/; [n]雷,雷声;轰隆声; [v]打雷;大声抱怨,吼叫; [^]yshx;
tick: [-]/tɪk/; [n]勾号,(钟表)滴答声,一刹那; [v]用勾作为记号,发出滴答声; [^]yshx;
tide: [-]/taɪd/; [n]潮,潮汐;潮流; [vi]随潮漂浮; [^]yshx;
tighten: [-]/ˈtaɪtn/; [v]拉紧;使..更严格; [^]yshx;
tilt: [-]/tɪlt/; [v](使)倾斜; [n]倾斜,斜坡; [^]yshx;
timely: [-]/ˈtaɪmli/; [a]适时的,及时的; [ad]及时地; [^]yshx;
timidity: [-]/tɪˈmɪdəti/; [n]胆怯; [^]yshx;
tinge: [-]/tɪndʒ/; [n]淡淡的(颜色,神色),轻微,少量; [v]给.染色,轻微地影响; [^]yshx;
tire: [-]/ˈtaɪər/; [v](使)疲倦,(使)厌倦; [n]轮胎,车胎; [^]yshx;
tissue: [-]/ˈtɪʃuː/; [n]面巾纸,(动植物的)组织,纱布; [^]yshx;
title: [-]/ˈtaɪtl/; [n]标题;头衔;权利; [vt]加标题于;授予.称号; [a]标题的,题目的;称呼的; [^]yshx;
to one's face: [-]/tu wʌnz feɪs/; [phr]坦白地;当面; [^]yshx;
toast: [-]/toʊst/; [n]敬酒;烤面包,吐司; [v]为..祝酒;烤;烘; [^]yshx;
toddle: [-]/ˈtɑːdl/; [v](如小孩)蹒跚学步; [n]东倒西歪的走路;刚学走步的小孩; [^]yshx;
toil: [-]/tɔɪl/; [v]苦干;跋涉;费力地做; [n]辛苦;苦工;罗网; [^]yshx;
token: [-]/ˈtoʊkən/; [n]象征;礼券,代金券;筹码,代币; [a]象征性的; [^]yshx;
tolerance: [-]/ˈtɑːlərəns/; [n]容忍,宽恕;忍耐力; [^]yshx;
toll: [-]/toʊl/; [n]伤亡人数;(道路等的)通行费;钟声; [v]敲钟; [^]yshx;
toneless: [-]/ˈtoʊnləs/; [a]单调的;缺乏声调的; [ad]声调平板地; [^]yshx;
tonic: [-]/ˈtɑːnɪk/; [n]补药;主调音或基音; [a]滋补的;声调的;使精神振作的; [^]yshx;
torch: [-]/tɔːrtʃ/; [n]手电筒;火把,火炬; [v]放火烧,纵火烧(建筑物或汽车); [^]yshx;
torrent: [-]/ˈtɔːrənt/; [n]湍流,洪流,奔流;迸发,连发,爆发;倾盆大雨; [^]yshx;
torture: [-]/ˈtɔːrtʃər/; [v]对.施以酷刑,拷问,折磨; [n]酷刑,折磨; [a]遭受重创的;饱受煎熬的; [^]yshx;
toss: [-]/tɔːs/; [v]扔,抛,掷; [n]掷,掷钱币来决定,猛抬头; [^]yshx;
tough: [-]/tʌf/; [a]坚韧的;健壮的;嚼不动的;棘手的;困难的; [ad]强硬地,顽强地; [n]暴徒,恶棍; [v]坚持,忍受; [^]yshx;
tourism: [-]/ˈtʊrɪzəm/; [n]旅游,旅游业; [^]yshx;
tournament: [-]/ˈtʊrnəmənt/; [n]锦标赛,联赛;比赛; [^]yshx;
towel: [-]/ˈtaʊəl/; [n]毛巾,手巾; [v]用毛巾擦; [^]yshx;
toxic: [-]/ˈtɑːksɪk/; [n]毒物; [a]有毒的;中毒的; [^]yshx;
track: [-]/træk/; [v]跟踪追赶;用纤拉船; [n]跑道;小路;行动路线;足迹;轨道; [^]yshx;
tract: [-]/trækt/; [n]器官系统;一大片地;短文,小册子; [^]yshx;
traction: [-]/ˈtrækʃn/; [n]拽;牵引;牵引力;附着磨擦力; [^]yshx;
trail: [-]/treɪl/; [n]小径,路径;记号,痕迹,线索; [v]拽;跟;落后于;追赶;(烟等)袅袅升起; [^]yshx;
trait: [-]/treɪt/; [n]特征; [^]yshx;
traitor: [-]/ˈtreɪtər/; [n]卖国贼,叛徒; [^]yshx;
tramp: [-]/træmp/; [n]流浪汉;无业游民;沉重的脚步声;长途跋涉; [v]重步行走;踏;践踏; [^]yshx;
transaction: [-]/trænˈzækʃn/; [n]交易;办理;事务;学报; [^]yshx;
transcend: [-]/trænˈsend/; [v]超越(经验,理性,信念等)的范围,超过; [^]yshx;
transfer: [-]/trænsˈfɜːr/; [v]转移;调任;换乘;转变;改编; [n]转让;转移;调任;汇兑; [^]yshx;
transform: [-]/trænsˈfɔːrm/; [v]将..变形,改变,转换; [^]yshx;
transgress: [-]/trænzˈɡres/; [v]冒犯,违背;侵犯;越界; [^]yshx;
transistor: [-]/trænˈzɪstər/; [n]晶体管;半导体收音机; [^]yshx;
transit: [-]/ˈtrænzɪt/; [n]运输;运送; [v]运送;通过; [^]yshx;
translucent: [-]/trænsˈluːsnt/; [a]半透明的;透亮的,有光泽的;易懂的;真实的; [^]yshx;
transmission: [-]/trænsˈmɪʃn/; [n]发射,转播,传播,变速器; [^]yshx;
transparent: [-]/trænsˈpærənt/; [a]透明的,清澈的,明净的;易识破的,显而易见的; [^]yshx;
transplant: [-]/trænsˈplænt/; [n]移种;移植; [v]移植(器官),使移居,移种(植物等); [^]yshx;
transport: [-]/ˈtrænspɔːrt/; [v]运输;使狂喜;流放; [n]运输;运输工具;流放犯; [^]yshx;
trap: [-]/træp/; [n]陷阱;捕兽夹;圈套,诡计;双轮轻便马车;嘴; [v]诱骗;困住; [^]yshx;
trauma: [-]/ˈtraʊmə/; [n]精神创伤,外伤; [^]yshx;
traverse: [-]/trəˈvɜːrs/; [v]横越;穿过; [n]横越; [^]yshx;
treatise: [-]/ˈtriːtɪs/; [n]论述;论文;专著; [^]yshx;
treble: [-]/ˈtrebl/; [n]最高声部; [v]使成三倍; [a]三倍的,最高声部的; [^]yshx;
trek: [-]/trek/; [n]艰苦跋涉; [v]拉(货车),搬运; [^]yshx;
tremble: [-]/ˈtrembl/; [v]发抖;哆嗦;摇动; [n]发抖;震颤; [^]yshx;
tremendous: [-]/trəˈmendəs/; [a]巨大的;极大的;惊人的; [^]yshx;
trend: [-]/trend/; [n]趋势;倾向;时尚; [v]倾向;走向;转向;使趋向; [^]yshx;
trespass: [-]/ˈtrespæs/; [v]侵入;犯罪; [n]罪过;非法侵入; [^]yshx;
trial: [-]/ˈtraɪəl/; [n]审判,审理;试验;试用;磨炼,苦难; [a]试验的,试验性的;考验的;审判的; [v]测试; [^]yshx;
triangle: [-]/ˈtraɪæŋɡl/; [n]三角形; [^]yshx;
trick: [-]/trɪk/; [v]哄骗;捉弄,戏弄; [n]恶作剧,诡计;技艺,戏法; [a]虚弱的; [^]yshx;
trickle: [-]/ˈtrɪkl/; [v]一滴滴地流;徐徐地流; [n]细流;徐徐地流;稀稀疏疏缓慢来往的东西; [^]yshx;
trifle: [-]/ˈtraɪfl/; [n]蛋糕;琐事,小事,无价值的东西; [v]嘲笑,轻视; [^]yshx;
trigger: [-]/ˈtrɪɡər/; [n](枪等的)扳机,诱因; [v]触发,引起,激发,扣扳机; [^]yshx;
trim: [-]/trɪm/; [n]修剪;整齐;装饰; [v]修剪;整理;装饰; [a](人)苗条的;整洁的; [ad]整齐<整洁>地; [^]yshx;
triumph: [-]/ˈtraɪʌmf/; [n]喜悦,狂喜;凯旋,胜利; [v]成功,获胜; [^]yshx;
tropic: [-]/ˈtrɑːpɪk/; [n]热带,回归线; [a]热带的; [^]yshx;
trumpet: [-]/ˈtrʌmpɪt/; [n]喇叭,小号;小号声;小号手;传声筒; [v]吹喇叭;发出喇叭般的声音;用喇叭吹出;发喇叭似的声音;大声宣布;宣扬; [^]yshx;
trunk: [-]/trʌŋk/; [n]树干;象鼻;(人)躯干;大衣箱;主体;(车的)后备箱;汽车车尾的行李箱; [^]yshx;
trustworthy: [-]/ˈtrʌstwɜːrði/; [a]可信赖的,可靠的; [^]yshx;
try one's hand at: [-]/traɪ wʌnz hænd æt/; [v]尝试着做.; [^]yshx;
tuck: [-]/tʌk/; [v]把(衬衫,餐巾等的)边塞到里面;把.夹入,把.藏入; [n](衣服等的)褶,裥; [^]yshx;
tug: [-]/tʌɡ/; [v]用力拖(或拉); [n]猛拉;牵引; [^]yshx;
tuition: [-]/tuˈɪʃn/; [n]学费,教学,讲授; [^]yshx;
tumble: [-]/ˈtʌmbl/; [v]翻滚;不由自主地卷入;(价格等)暴跌;跌倒,摔下,滚下; [n]跌倒,摔倒; [^]yshx;
tune: [-]/tuːn/; [n]曲调,旋律,协调,调动; [v]<电子><通信>调谐;协调; [^]yshx;
tunnel: [-]/ˈtʌnl/; [n]隧道; [v]挖地道; [^]yshx;
turbulent: [-]/ˈtɜːrbjələnt/; [a]湍急的;混乱的,动荡的;骚动的; [^]yshx;
turf: [-]/tɜːrf/; [n]草地,草皮; [v]覆草皮; [^]yshx;
turmoil: [-]/ˈtɜːrmɔɪl/; [n]骚动,骚乱; [^]yshx;
turnover: [-]/ˈtɜːrnoʊvər/; [n]成交量;营业收入;人员更替率;半圆卷饼; [^]yshx;
tweezers: [-]/ˈtwiːzərz/; [n]镊子,小钳子; [^]yshx;
twilight: [-]/ˈtwaɪlaɪt/; [n]黄昏,薄暮,黎明;晚期,没落时期; [a]微明的;界限不清的; [^]yshx;
twinkle: [-]/ˈtwɪŋkl/; [vi]闪烁;闪闪发光; [^]yshx;
twist: [-]/twɪst/; [v]捻,搓;扭;歪曲; [n]搓,扭拧;意外进展;弯曲处; [^]yshx;
typical: [-]/ˈtɪpɪkl/; [a]典型的;代表性的; [^]yshx;
ultimatum: [-]/ˌʌltɪˈmeɪtəm/; [n]最后通牒; [^]yshx;
ultraviolet: [-]/ˌʌltrəˈvaɪələt/; [a]紫外线;紫外线的; [^]yshx;
unanimous: [-]/juˈnænɪməs/; [a]全体一致的;一致同意的; [^]yshx;
uncalled-for: [-]/ʌn'kɔːldˌfɔː/; [a]没有必要的,不合适的; [^]yshx;
unconditional: [-]/ˌʌnkənˈdɪʃənl/; [a]绝对的,无条件的; [^]yshx;
unconscious: [-]/ʌnˈkɑːnʃəs/; [a]不省人事的;无意识的;未察觉的; [^]yshx;
undercharge: [-]/ˌʌndərˈtʃɑːrdʒ/; [n]索价低于常价;充电不足; [vi]向.少收钱; [vt]向.少收钱; [^]yshx;
underestimate: [-]/ˌʌndərˈestɪmeɪt/; [v]低估;对.估计不足; [^]yshx;
undergo: [-]/ˌʌndərˈɡoʊ/; [v]经历;遭受; [^]yshx;
underline: [-]/ˌʌndərˈlaɪn/; [v]划线于.之下;突出显示;强调; [n]下划线;下期节目预告;图下说明文字; [^]yshx;
underlying: [-]/ˌʌndərˈlaɪɪŋ/; [a]基本的;潜在的;在下面的; [^]yshx;
undermine: [-]/ˌʌndərˈmaɪn/; [v]暗中破坏;逐渐削弱;侵蚀.的基础;在...下挖坑道,从根基处损害; [^]yshx;
underneath: [-]/ˌʌndərˈniːθ/; [ad]在.下面,在.底下; prep. 在下面; [^]yshx;
undertake: [-]/ˌʌndərˈteɪk/; [v]保证;承担,承包; [^]yshx;
underwrite: [-]/ˌʌndərˈraɪt/; [v]给.保险,承诺支付;同意赔款(海上保险); [^]yshx;
undo: [-]/ʌnˈduː/; [v]松开,解开;取消; [^]yshx;
undue: [-]/ˌʌnˈduː/; [a]过分的,不适当的;过度的;尚未到期的; [^]yshx;
uneasy: [-]/ʌnˈiːzi/; [a]心神不安,不稳定的,不舒服; [^]yshx;
uneven: [-]/ʌnˈiːvn/; [a]不平坦的;不均匀的,不规则的;不公正的; [^]yshx;
unfold: [-]/ʌnˈfoʊld/; [v]展开,伸展;表露,显露; [^]yshx;
ungainly: [-]/ʌnˈɡeɪnli/; [a]笨拙的,不雅的; [ad]笨拙地;不雅地; [^]yshx;
unify: [-]/ˈjuːnɪfaɪ/; [v]使联合,统一;使相同,使一致; [^]yshx;
unique: [-]/juˈniːk/; [a]独特的,独一无二的;(唯一的)特有的;不同寻常的; [^]yshx;
universal: [-]/ˌjuːnɪˈvɜːrsl/; [a]普遍存在的;全体的;通用的;宇宙的; [n]普遍原则; [^]yshx;
unrest: [-]/ʌnˈrest/; [n]不安,骚动;动荡的局面;不安的状态; [^]yshx;
untold: [-]/ˌʌnˈtoʊld/; [a]无数的,数不清的; [^]yshx;
upbringing: [-]/ˈʌpbrɪŋɪŋ/; [n]抚育,抚养,教养; [^]yshx;
update: [-]/ˌʌpˈdeɪt/; [v]更新;为..提供最新信息; [n]更新;最新的情况; [^]yshx;
upkeep: [-]/ˈʌpkiːp/; [n]保养,维持;维修费; [^]yshx;
upright: [-]/ˈʌpraɪt/; [a]垂直的;正直的; [ad]直立地; [n]立柱; [^]yshx;
uprising: [-]/ˈʌpraɪzɪŋ/; [n]起义;升起; [a]升起的; [v]起义;升起; [^]yshx;
utility: [-]/juːˈtɪləti/; [n]功用,用途,公用事业,物业; [a]实用的;通用性的; [^]yshx;
utmost: [-]/ˈʌtmoʊst/; [a]最大的;极度的;最远的; [n]极限; [^]yshx;
vacant: [-]/ˈveɪkənt/; [a]空的,未被占用的;闲置的;空缺的;茫然的; [^]yshx;
vacation: [-]/veɪˈkeɪʃn/; [n]休假,假期; [v]休假,度假; [^]yshx;
vacuum: [-]/ˈvækjuəm/; [n]真空吸尘器;真空;空虚,茫然若失; [v]用吸尘器打扫; [^]yshx;
vain: [-]/veɪn/; [a]爱虚荣的;徒劳的;没有真正意义的,没有真正价值的,无关紧要的;自负的,自高自大的;无益的; [^]yshx;
valuation: [-]/ˌvæljuˈeɪʃn/; [n]估价,评价,鉴定;估定的价值,定价; [^]yshx;
valve: [-]/vælv/; [n]阀门,活门; [^]yshx;
vanish: [-]/ˈvænɪʃ/; [vi]消失;突然不见;消灭; [v]使消失;使不见; [n]<语音学>消失音,弱化音; [^]yshx;
vanity: [-]/ˈvænəti/; [n]自负;无价值的东西;(带镜子的)梳妆台; [^]yshx;
vanquish: [-]/ˈvæŋkwɪʃ/; [v]征服,击败; [^]yshx;
variable: [-]/ˈveriəbl/; [a]易变的,可变的; [n]变量,可变物; [^]yshx;
vehicle: [-]/ˈviːəkl/; [n]交通工具,机动车;传播媒介;工具,手段; [^]yshx;
venerate: [-]/ˈvenəreɪt/; [v]崇敬,敬仰; [^]yshx;
vent: [-]/vent/; [n]发泄;通风口,排气口;(上衣背部或两侧的)开衩;(小型动物的)排泄口; [v]发泄(情绪),开孔,泄露; [^]yshx;
ventilate: [-]/ˈventɪleɪt/; [v]使.通风,透风;公开讨论; [^]yshx;
venture: [-]/ˈventʃər/; [n]企业;(商业)冒险;投机,风险投资; [vi]冒险前进; [vt]冒.的危险;以.做赌注; [^]yshx;
verbal: [-]/ˈvɜːrbl/; [a]言语的,口头的,动词的; [^]yshx;
verdict: [-]/ˈvɜːrdɪkt/; [n](陪审团)裁决;定论;意见; [^]yshx;
verge: [-]/vɜːrdʒ/; [n]边缘;边界; [v]接近;濒临; [^]yshx;
versatile: [-]/ˈvɜːrsətl/; [a]万能的,综合的,多才多艺的; [^]yshx;
versed: [-]/vɜːrst/; [a]熟练的,精通的; [^]yshx;
versus: [-]/ˈvɜːrsəs/; prep. 以..为对手;与..相对,与..相比; [^]yshx;
vertical: [-]/ˈvɜːrtɪkl/; [a]垂直的;顶点的; [n]垂直线,垂直面; [^]yshx;
vessel: [-]/ˈvesl/; [n]船,容器,血管; [^]yshx;
veto: [-]/ˈviːtoʊ/; [v]否决;投反对票; [n]否决;否决权;禁止; [^]yshx;
vex: [-]/veks/; [v]使烦恼,使苦恼,使恼怒; [^]yshx;
via: [-]/ˈvaɪə/; prep. 经过,通过; [^]yshx;
viable: [-]/ˈvaɪəbl/; [a]可行的;能养活的;能生育的; [^]yshx;
vice: [-]/vaɪs/; [n]缺点;恶习;邪恶;罪行;生理缺陷; [a]副的;代理的; pref. 代理的; [vt]用老虎钳夹紧;钳制; [^]yshx;
vicinity: [-]/vəˈsɪnəti/; [n]附近地区;近邻;附近; [^]yshx;
vicious: [-]/ˈvɪʃəs/; [a]罪恶的;恶意的;凶猛的,残忍的; [^]yshx;
vigilant: [-]/ˈvɪdʒɪlənt/; [a]警戒的,警惕的; [^]yshx;
vigorous: [-]/ˈvɪɡərəs/; [a]精力充沛的;强有力的,有活力的;强健的; [^]yshx;
vindicate: [-]/ˈvɪndɪkeɪt/; [vt]证明.无辜;维护,辩护; [^]yshx;
violate: [-]/ˈvaɪəleɪt/; [v]违反,违背;侵犯,妨碍;亵渎; [^]yshx;
violent: [-]/ˈvaɪələnt/; [a]强烈的,猛烈的;暴力的,粗暴的; [^]yshx;
virtually: [-]/ˈvɜːrtʃuəli/; [ad]几乎;虚拟地;整个;实际上; [^]yshx;
virtuous: [-]/ˈvɜːrtʃuəs/; [a]善良的,有德行的,贞洁的; [^]yshx;
virus: [-]/ˈvaɪrəs/; [n]病毒;(计算机) 病毒;病毒性疾病; [^]yshx;
visible: [-]/ˈvɪzəbl/; [a]看得见的,可见的;显然的,明显的; [^]yshx;
visualize: [-]/ˈvɪʒuəlaɪz/; [v]使形象化;想象; [^]yshx;
vital: [-]/ˈvaɪtl/; [a]生命所必需的;必不可少的;至关重要的;有活力的;生命攸关的; [n]要害;重要部分; [^]yshx;
vivid: [-]/ˈvɪvɪd/; [a](颜色)鲜艳的,强烈的(颜色,光);生动的,清晰的(记忆,描述); [^]yshx;
vocational: [-]/voʊˈkeɪʃənl/; [a]职业的;业务的; [^]yshx;
vogue: [-]/voʊɡ/; [n]时髦,时尚; [a]流行的; [^]yshx;
volatile: [-]/ˈvɑːlətl/; [a]易气化的;爆炸性的;反复无常的;短暂的;不稳定的; [^]yshx;
volcano: [-]/vɑːlˈkeɪnoʊ/; [n]火山; [^]yshx;
voltage: [-]/ˈvoʊltɪdʒ/; [n]电压; [^]yshx;
voluntary: [-]/ˈvɑːlənteri/; [a]自愿的;无偿的;志愿的; [n]即兴曲; [^]yshx;
vomit: [-]/ˈvɑːmɪt/; [n]呕吐物,呕吐; [v]呕吐;吐出;涌出;喷出; [^]yshx;
voucher: [-]/ˈvaʊtʃər/; [n]代金券;证明人;收据;教育补助金券; [vt]为.准备凭据;证实.的可靠性; [^]yshx;
vow: [-]/vaʊ/; [n]誓约; [v]宣誓;立誓;发誓; [^]yshx;
vulgar: [-]/ˈvʌlɡər/; [a]粗俗的;下流的;平民的;通俗的; [n]平民;方言; [^]yshx;
vulnerable: [-]/ˈvʌlnərəbl/; [a]易受伤的;脆弱的;易受攻击的; [^]yshx;
wage: [-]/weɪdʒ/; [n]薪水,报酬; [v]开展,进行(战争,运动); [^]yshx;
wail: [-]/weɪl/; [n]恸哭;哀诉; [vi]恸哭;悲叹; [vt]哀悼; [^]yshx;
wander: [-]/ˈwɑːndər/; [v]漫游;蜿蜒;迷路;离题; [n]游荡;闲逛;失散; [^]yshx;
wane: [-]/weɪn/; [n]衰退(期);月亏(期);减少; [v](月)缺损;(光,势力,治理等)衰落;减少; [^]yshx;
warden: [-]/ˈwɔːrdn/; [n]看守人,管理员; [^]yshx;
wardrobe: [-]/ˈwɔːrdroʊb/; [n]衣橱;全部服装;剧服; [^]yshx;
warehouse: [-]/ˈwerhaʊs/; [n]仓库; [^]yshx;
wary: [-]/ˈweri/; [a]谨慎的,小心的,提防的;考虑周到的; [^]yshx;
weary: [-]/ˈwɪri/; [a]疲倦的,困乏的,令人厌倦的; [v]使疲倦;使厌倦; [^]yshx;
weave: [-]/wiːv/; [v]织;编织;编进;织布; [n]织法;织物; [^]yshx;
web: [-]/web/; [n]网;蜘蛛网; [^]yshx;
wedge: [-]/wedʒ/; [v]楔入; [n]楔子; [^]yshx;
weird: [-]/wɪrd/; [a]古怪的;荒唐的; [^]yshx;
weld: [-]/weld/; [v]焊接;使结合,使成整体; [n]焊接; [^]yshx;
welfare: [-]/ˈwelfer/; [n]福利;幸福,健康; [^]yshx;
well-to-do: [-]/ˌwel tə ˈduː/; [a]富有的,有钱的,生活优裕的,小康的; [^]yshx;
whilst: [-]/waɪlst/; [conj]当..的时候; [n]一会儿;一段时间; [^]yshx;
whip: [-]/wɪp/; [vt]鞭打,抽打;突然拿取,猛然抓住;痛责;驱使;怂恿; [v]一下子猛地移动,急走,急冲; [n]鞭子;抽打;组织秘书;蛋奶水果甜点心; [^]yshx;
whirl: [-]/wɜːrl/; [v]回旋;使旋转; [n]回旋;一个接一个的活动; [^]yshx;
wholesale: [-]/ˈhoʊlseɪl/; [n]批发; [ad]大批大批地; [a]大规模的;批发的; [v]批发; [^]yshx;
wholesome: [-]/ˈhoʊlsəm/; [a]有益于健康的;有益的; [^]yshx;
wicked: [-]/ˈwɪkɪd/; [a]邪恶的,恶毒的;淘气的,恶作剧的; [n]恶人;邪恶的人; [ad]用作加强语气用; [^]yshx;
width: [-]/wɪdθ/; [n]宽度,广度,宽阔; [^]yshx;
wield: [-]/wiːld/; [v]运用,行使;挥; [vt]使用; [^]yshx;
wilderness: [-]/ˈwɪldərnəs/; [n]荒野,荒地; [^]yshx;
wisdom: [-]/ˈwɪzdəm/; [n]智慧,学问;明智,正确判断; [^]yshx;
wit: [-]/wɪt/; [n]富有机智的人;智力,才智;机智;风趣,措辞巧妙的能力; [^]yshx;
withdraw: [-]/wɪðˈdrɔː/; [v]取款;撤退,收回,撤离; [^]yshx;
wither: [-]/ˈwɪðər/; [v]枯萎;凋谢; [vt]使枯萎,使凋谢,萎缩;使人感觉羞惭或迷惑; [^]yshx;
withhold: [-]/wɪðˈhoʊld/; [v]抑制,拒绝给某事物; [^]yshx;
withstand: [-]/wɪðˈstænd/; [v]忍受;抵挡; [^]yshx;
witness: [-]/ˈwɪtnəs/; [n]目击者,证人; [v]目击,亲眼看见;为..作证; [^]yshx;
worthwhile: [-]/ˌwɜːrθˈwaɪl/; [a]值得(花时间,精力)的,有意义的; [^]yshx;
wrap: [-]/ræp/; [v]裹,包,捆;覆盖; [n]包裹物,覆盖物;外衣; [^]yshx;
wreck: [-]/rek/; [n]沉船,失事船;失事;(事故中)遭严重损坏的汽车(飞机等); [v]破坏,使毁灭; [^]yshx;
wrench: [-]/rentʃ/; [n]扳手;痛苦,难受;猛扭,猛拉; [v]猛拧;挣脱;使扭伤; [^]yshx;
wrestle: [-]/ˈresl/; [v]摔跤,角斗;斗争,努力; [n]摔跤,角力,扭斗; [^]yshx;
wretched: [-]/ˈretʃɪd/; [a]可怜的;恶劣的;身心疲惫的; [^]yshx;
wrought: [-]/rɔːt/; [a]锻造的;加工的;精细的; [^]yshx;
yacht: [-]/jɑːt/; [n]游艇;帆船; [^]yshx;
yarn: [-]/jɑːrn/; [n]纱线,故事,奇谈; [^]yshx;
yawn: [-]/jɔːn/; [v]打呵欠;裂开;打着呵欠说; [n]呵欠;乏味或枯燥的事物; [^]yshx;
yearn: [-]/jɜːrn/; [v]渴望,向往; [^]yshx;
yield: [-]/jiːld/; [v]出产;屈服;弯曲;让行; [n]收益; [^]yshx;
yoke: [-]/joʊk/; [n]牛轭;枷锁;纽带; [v]结合;连结; [^]yshx;
zeal: [-]/ziːl/; [n]热情,热心; [^]yshx;
zest: [-]/zest/; [n]兴趣,乐趣;滋味,风味; [v]给.调味; [^]yshx;
zoology: [-]/zuˈɑːlədʒi/; [n]动物学;动物区系; [^]yshx;
