Armada: [-]/ɑːrˈmɑːdə/; [n](西班牙的)无敌舰队; [^]sat;
Baroque: [-]/bəˈroʊk/; [a]巴洛克式的,结构复杂的,形式怪样的; [n]巴洛克风格,巴洛克艺术; [^]sat;
Catholic: [-]/ˈkæθlɪk/; [a](兴趣等)广泛的,(C大写)天主教的; [n](C大写)天主教徒; [^]sat;
Spartan: [-]/ˈspɑːrtn/; [a]斯巴达式的,简朴的,刻苦的; [n]斯巴达人;勇士; [^]sat;
Titanic: [-]/taɪˈtænɪk/; [a]巨人的,力大无比的; [n]泰坦尼克号; [^]sat;
Utopia: [-]/juːˈtoʊpiə/; [n]乌托邦(理想中最美好的社会),理想国; [^]sat;
abase: [-]/əˈbeɪs/; [v]贬抑;使卑下;降低.的地位; [n]贬低;屈辱;贬低别人的人; [^]sat;
abash: [-]/ə'bæʃ/; [v]使局促不安;使羞愧; [a]窘迫的,尴尬的; [ad]窘迫地,尴尬地; [n]窘迫,尴尬; [^]sat;
abbreviate: [-]/əˈbriːvieɪt/; [v]缩写,使省略,使用缩写词; [n]使用缩写词的人;缩短,缩写(词,短语,名字,名称); [^]sat;
abdicate: [-]/ˈæbdɪkeɪt/; [a]放弃权力的;退位的; [n]放弃权力者;退位者; [vi]退位,辞职; [vt]辞;放弃; [^]sat;
aberrant: [-]/æˈberənt/; [n]离开正路的人,反常的人; [a]偏离正轨的;异常的,畸变的; [^]sat;
abet: [-]/əˈbet/; [vt]唆使,怂恿;支持; [^]sat;
abeyance: [-]/əˈbeɪəns/; [n]中止,搁置; [^]sat;
abhor: [-]/əbˈhɔːr/; [v]痛恨;憎恶; [^]sat;
abject: [-]/ˈæbdʒekt/; [a]糟糕透顶的;可怜的,不幸的; [^]sat;
abjure: [-]/əbˈdʒʊr/; [v]发誓放弃,公开放弃,避免; [^]sat;
ablution: [-]/əb'luːʃən/; [n](宗教的)净礼,沐浴; [^]sat;
abnegation: [-]/ˌæbnɪˈɡeɪʃn/; [n]克制,自我克制,放弃; [^]sat;
abolish: [-]/əˈbɑːlɪʃ/; [v]废除,废止;取消,革除; [^]sat;
abominable: [-]/əˈbɑːmɪnəbl/; [a]讨厌的,令人憎恶的,糟透的; [n]讨厌,可恶; [ad]恶劣地,令人厌恶地; [^]sat;
aboriginal: [-]/ˌæbəˈrɪdʒənl/; [a]土著的,原来的; [n]土著居民; [^]sat;
abortive: [-]/əˈbɔːrtɪv/; [a]无结果的,失败的; [^]sat;
abrade: [-]/əˈbreɪd/; [v]磨损,擦伤; [^]sat;
abrasive: [-]/əˈbreɪsɪv/; [a]粗糙的;有研磨作用的;伤人感情的; [n]研磨料; [^]sat;
abridge: [-]/əˈbrɪdʒ/; [v]删节;削减; [^]sat;
abrogate: [-]/ˈæbrəɡeɪt/; [v]废止,废除; [n]取消,废除; [^]sat;
abscond: [-]/əbˈskɑːnd/; [v]逃匿,潜逃;避债; [^]sat;
absolute: [-]/ˈæbsəluːt/; [a]完全的;绝对的;纯粹的; [^]sat;
absolve: [-]/əbˈzɑːlv/; [v]赦免,宽恕;免除,解除; [^]sat;
absorb: [-]/əbˈzɔːrb/; [vt]吸收;汲取;吸引..的注意;理解,掌握;承受; [^]sat;
abstain: [-]/əbˈsteɪn/; [v]戒掉(烟\酒等);避开;弃权; [^]sat;
abstemious: [-]/əbˈstiːmiəs/; [a](吃喝等)有节制的,节俭的; [^]sat;
abstinence: [-]/ˈæbstɪnəns/; [n]节制,禁欲; [^]sat;
abstract: [-]/ˈæbstrækt/; [a]抽象的; [n]摘要,抽象; [v]提取; [^]sat;
abstruse: [-]/əbˈstruːs/; [a]难懂的,深奥的; [^]sat;
abundant: [-]/əˈbʌndənt/; [a]丰富的;大量的; [^]sat;
abusive: [-]/əˈbjuːsɪv/; [a]辱骂的;滥用的;虐待的; [^]sat;
abut: [-]/əˈbʌt/; [v]紧靠; [^]sat;
abysmal: [-]/əˈbɪzməl/; [a]极低的或极可怜的,(程度)很深的,极端的; [^]sat;
abyss: [-]/əˈbɪs/; [n]深渊;深不可测的事物,绝境;深海;深邃;炼狱; [^]sat;
academic: [-]/ˌækəˈdemɪk/; [a]学术的;学院的,大学的;理论的; [n]学者; [^]sat;
accede: [-]/əkˈsiːd/; [v]同意,就任,加入; [^]sat;
accelerate: [-]/əkˈseləreɪt/; [v]加速,增长;使增速,促进; [^]sat;
accentuate: [-]/əkˈsentʃueɪt/; [v]强调;重读; [^]sat;
accessible: [-]/əkˈsesəbl/; [a]可使用的;可到达的;可进入的;易懂的; [^]sat;
accessory: [-]/əkˈsesəri/; [n](妇女的)装饰品;附件;附属物;同谋; [a]附属的;辅助的;同谋的; [^]sat;
acclaim: [-]/əˈkleɪm/; [n]欢呼,赞扬,称赞; [v]欢呼,喝彩,鼓掌欢迎; [vt]鼓掌欢迎,向.欢呼,为.喝彩;推选; [^]sat;
acclimate: [-]/ˈækləmeɪt/; [v]服水土,适应新环境; [^]sat;
acclivity: [-]/ə'klɪvətɪ/; [n]向上的陡坡; [^]sat;
accolade: [-]/ˈækəleɪd/; [n]同意,赞赏; [v]赞扬; [^]sat;
accommodate: [-]/əˈkɑːmədeɪt/; [v]向.提供住处(或膳宿);给.提供方便;容纳;使适应,顺应; [^]sat;
accomplice: [-]/əˈkɑːmplɪs/; [n]同谋者,帮凶; [^]sat;
accord: [-]/əˈkɔːrd/; [n]协议; [v]授予; [^]sat;
accost: [-]/əˈkɔːst/; [v]搭讪;引诱;面对;勾引; [^]sat;
accretion: [-]/əˈkriːʃn/; [n]自然的增加,增加物; [^]sat;
accrue: [-]/əˈkruː/; [v](利息等)增大,增多; [^]sat;
acerbity: [-]/əˈsɜːrbəti/; [n]苦涩,刻薄; [^]sat;
acetic: [-]/ə'siːtɪk/; [a]酸的,醋的; [^]sat;
acidulous: [-]/əˈsɪdʒələs/; [a]有酸味的,刻薄的; [^]sat;
acknowledge: [-]/əkˈnɑːlɪdʒ/; [v]告知收到;对(人)打招呼,招呼(某人)以示相识,致意;就..表示谢忱,鸣谢,感谢,感激,答谢,对..表示感谢;承认(属实),承认(权威,地位); [^]sat;
acme: [-]/ˈækmi/; [n]顶点,极点; [^]sat;
acoustics: [-]/əˈkuːstɪks/; [n]声学; [^]sat;
acquiesce: [-]/ˌækwiˈes/; [v]默许;勉强同意; [a]默认的; [^]sat;
acquire: [-]/əˈkwaɪər/; [v](尤指靠自己的努力或行动或经过一个过程)获得;学到;取得; [^]sat;
acquittal: [-]/əˈkwɪtl/; [n]宣告无罪,开释; [^]sat;
acrid: [-]/ˈækrɪd/; [a]辛辣的,(言语或语调)刻薄的; [^]sat;
acrimonious: [-]/ˌækrɪˈmoʊniəs/; [a]严厉的;辛辣的;刻薄的; [^]sat;
acrophobia: [-]/ˌækrə'foʊbɪə/; [n]恐高症; [^]sat;
actuate: [-]/ˈæktʃueɪt/; [v]开动(机器);激励,驱使; [^]sat;
acumen: [-]/ˈækjəmən/; [n]聪明,敏锐; [^]sat;
acute: [-]/əˈkjut/; [a](疼痛,妒忌等)剧烈的,严重的;敏锐的;急性的;尖声的; [^]sat;
adamant: [-]/ˈædəmənt/; [a]强硬的,固执的; [n]坚硬的东西;坚石; [^]sat;
adapt: [-]/əˈdæpt/; [vi]适应不同情况; [vt]使适合;改编; [^]sat;
addendum: [-]/əˈdendəm/; [n]附录,附件;补遗;附加物; [^]sat;
addiction: [-]/əˈdɪkʃn/; [n]沉溺,上瘾; [^]sat;
addle: [-]/ˈædl/; [v]使腐坏,使昏乱; [a]腐坏的;糊涂的,昏乱的; [^]sat;
address: [-]/əˈdres/; [n]地址;致词; [v]致函;写姓名地址;向..讲话;处理; [^]sat;
adept: [-]/əˈdept/; [n]专家,能手; [a]熟练的;巧妙的; [^]sat;
adhere: [-]/ədˈhɪr/; [v]遵守;坚持;粘附;附着,粘在..上; [^]sat;
adherent: [-]/ədˈhɪrənt/; [n]拥护者;党徒;提倡者; [^]sat;
adjacent: [-]/əˈdʒeɪsnt/; [a]邻接的,毗连的;邻近的; [^]sat;
adjunct: [-]/ˈædʒʌŋkt/; [n]附属物,配件,添加剂;助手,部下; [a]附加的,辅助的,下级的; [^]sat;
admonish: [-]/ədˈmɑːnɪʃ/; [v]训诫,警告; [^]sat;
admonition: [-]/ˌædməˈnɪʃn/; [n]告诫,劝告,警告; [^]sat;
adorn: [-]/əˈdɔːrn/; [v]装饰; [^]sat;
adroit: [-]/əˈdrɔɪt/; [a]熟练的,灵巧的; [^]sat;
adulation: [-]/ˌædʒəˈleɪʃn/; [n]奉承,恭维; [^]sat;
adulterate: [-]/əˈdʌltəreɪt/; [v]掺假; [a]通奸的;搀杂的; [n]掺假; [^]sat;
advent: [-]/ˈædvent/; [n]来临;到来;出现; [^]sat;
adventitious: [-]/ˌædvenˈtɪʃəs/; [a]外来的,偶然的; [^]sat;
adversary: [-]/ˈædvərseri/; [n]对手,敌手; [^]sat;
adverse: [-]/ˈædvɜːrs/; [a]不利的;(方向上)逆的;在相反的方向上移动(或运转);相反的; [^]sat;
adversity: [-]/ədˈvɜːrsəti/; [n]逆境,不幸,灾难; [^]sat;
advocacy: [-]/ˈædvəkəsi/; [n]主张;拥护;辩护; [^]sat;
advocate: [-]/ˈædvəkeɪt/; [v]提倡;主张;为.辩护; [n]辩护者;提倡者;律师; [^]sat;
aesthetic: [-]/esˈθetɪk/; [n]美感;审美观; [a]美学的;审美的;悦目的;雅致的; [^]sat;
affable: [-]/ˈæfəbl/; [a]易于交谈的,和蔼的; [^]sat;
affected: [-]/əˈfektɪd/; [a]受到影响的,受(疾病)侵袭的;假装的,做作的; [^]sat;
affidavit: [-]/ˌæfəˈdeɪvɪt/; [n]<法律>宣誓书,书面陈述; [^]sat;
affiliation: [-]/əˌfɪliˈeɪʃn/; [n]联系,从属关系; [^]sat;
affinity: [-]/əˈfɪnəti/; [n]姻亲关系;密切关系;近似,类似关系;亲近; [^]sat;
affirmation: [-]/ˌæfərˈmeɪʃn/; [n]肯定;断言;主张; [^]sat;
affix: [-]/əˈfɪks/; [v]粘上;署名;将罪责加之于; [n]词缀;附加物; [^]sat;
affliction: [-]/əˈflɪkʃn/; [n]苦恼,折磨;痛苦; [^]sat;
affluence: [-]/ˈæfluəns/; [n]丰富,富裕,流入; [^]sat;
affront: [-]/əˈfrʌnt/; [v]冒犯,有意冒犯,公开侮辱;面对; [n]轻蔑;公开侮辱; [^]sat;
aftermath: [-]/ˈæftərmæθ/; [n]不幸事件之后果,余波; [^]sat;
agenda: [-]/əˈdʒendə/; [n]议事日程; [^]sat;
agent: [-]/ˈeɪdʒənt/; [n]政府特工;代理商,代理人; [^]sat;
aggrandize: [-]/ə'grænˌdaɪz/; [v]增大;夸大;吹捧; [^]sat;
aggregate: [-]/ˈæɡrɪɡət/; [n]合计;总数;混凝料;总计; [v]集合;聚集;合计; [a]总的,总数的;集合的; [^]sat;
aggressor: [-]/əˈɡresər/; [n]侵略者,侵略国,挑衅者; [^]sat;
aghast: [-]/əˈɡæst/; [a]惊骇的,吓呆的; [^]sat;
agility: [-]/əˈdʒɪləti/; [n]敏捷;灵活; [^]sat;
agitate: [-]/ˈædʒɪteɪt/; [v](尤指为法律,社会状况的改变而)激烈争论,鼓动,煽动;搅动(液体);激怒; [^]sat;
agnostic: [-]/æɡˈnɑːstɪk/; [a]不可知论的; [n]不可知论者; [^]sat;
agrarian: [-]/əˈɡreriən/; [a]耕地的; [^]sat;
alacrity: [-]/əˈlækrəti/; [n]反应迅速,乐意; [^]sat;
alchemy: [-]/ˈælkəmi/; [n]炼金术;魔力; [^]sat;
alcove: [-]/ˈælkoʊv/; [n]凹室,壁龛; [^]sat;
alias: [-]/ˈeɪliəs/; [n]别名,化名; [ad]别名为,化名为; [^]sat;
alienate: [-]/ˈeɪliəneɪt/; [v]疏远;挑拨; [^]sat;
alimony: [-]/ˈælɪmoʊni/; [n](法)赡养费,生活费; [^]sat;
allay: [-]/əˈleɪ/; [v]减轻;使缓和;使平静; [^]sat;
allege: [-]/əˈledʒ/; [v]断言;硬说; [^]sat;
allegiance: [-]/əˈliːdʒəns/; [n]忠诚,拥护; [^]sat;
allegory: [-]/ˈæləɡɔːri/; [n]讽喻;寓意;寓言; [^]sat;
alleviate: [-]/əˈliːvieɪt/; [v]减轻;缓解;缓和; [^]sat;
alliteration: [-]/əˌlɪtəˈreɪʃn/; [n]头韵; [^]sat;
allocate: [-]/ˈæləkeɪt/; [v]分配,配给; [^]sat;
alloy: [-]/ˈælɔɪ/; [n]合金; [v]使成合金; [^]sat;
allude: [-]/əˈluːd/; [v]间接提到,暗指,暗示; [^]sat;
allure: [-]/əˈlʊr/; [v]吸引;诱使; [n]诱惑力; [^]sat;
allusion: [-]/əˈluːʒn/; [n]暗示;提及; [^]sat;
aloft: [-]/əˈlɔːft/; [ad]在空中,在高处,在上面; prep. 在 ... 上; [^]sat;
aloof: [-]/əˈluːf/; [a]远离的;冷漠的,冷淡的; [ad]远离,避开; [^]sat;
altercation: [-]/ˌɔːltərˈkeɪʃn/; [n]争吵,争论; [^]sat;
altruistic: [-]/ˌæltruˈɪstɪk/; [a]利他的;无私心的; [^]sat;
amalgamate: [-]/əˈmælɡəmeɪt/; [v]合并,混合; [^]sat;
amass: [-]/əˈmæs/; [vi]聚集; [vt]收集;积累,积聚; [^]sat;
ambidextrous: [-]/ˌæmbiˈdekstrəs/; [a]双手都灵巧; [^]sat;
ambience: [-]/ˈæmbiəns/; [n]气氛,环境,氛围; [^]sat;
ambiguous: [-]/æmˈbɪɡjuəs/; [a]含糊不清的,引起歧义的,模棱两可的; [^]sat;
ambivalence: [-]/æmˈbɪvələns/; [n]矛盾心理; [^]sat;
amble: [-]/ˈæmbl/; [v]漫步,缓行; [n]缓行,漫步; [^]sat;
ameliorate: [-]/əˈmiːliəreɪt/; [v]改善,减轻(痛苦等),改良; [^]sat;
amenable: [-]/əˈmiːnəbl/; [a]愿意的,顺从的,服从的;经得起检验的; [^]sat;
amend: [-]/əˈmend/; [v]改进;修订;修正; [^]sat;
amiable: [-]/ˈeɪmiəbl/; [a]和蔼的,亲切的;温和的; [^]sat;
amicable: [-]/ˈæmɪkəbl/; [a]友善的,温和的,平心静气的; [^]sat;
amiss: [-]/əˈmɪs/; [a]有毛病的,有缺陷的;出差错的; [ad]错误地; [^]sat;
amity: [-]/ˈæməti/; [n]友好,亲善关系,友好关系; [^]sat;
amnesia: [-]/æmˈniːʒə/; [n]<医学>遗忘症; [^]sat;
amnesty: [-]/ˈæmnəsti/; [n]赦免; [v]对.实行大赦; [^]sat;
amoral: [-]/ˌeɪˈmɔːrəl/; [a]不知是非的; [^]sat;
amorous: [-]/ˈæmərəs/; [a]容易动情的,情爱的; [^]sat;
amorphous: [-]/əˈmɔːrfəs/; [a]无定形的;无组织的;<物>非晶形的; [^]sat;
amphibian: [-]/æmˈfɪbiən/; [n]两栖动物;水陆两用飞机和车辆; [a]两栖类的;<车辆>水陆两用的;具有双重性格的; [^]sat;
amphitheater: [-]/ˈæmfɪˌθiətər/; [n]竞技场,圆形露天剧场,古罗马剧场; [^]sat;
ample: [-]/ˈæmpl/; [a]富足的,丰满的,宽敞的; [^]sat;
amplify: [-]/ˈæmplɪfaɪ/; [v]放大(声音等);扩大;增强;详述;进一步阐述; [^]sat;
amputate: [-]/ˈæmpjuteɪt/; [v]切除;截肢;切断; [^]sat;
amulet: [-]/ˈæmjʊlət/; [n]护身符; [^]sat;
anachronistic: [-]/əˌnækrəˈnɪstɪk/; [a]时代错误的; [^]sat;
analgesic: [-]/ˌænəlˈdʒiːzɪk/; [n]镇痛药; [a]止痛的; [^]sat;
analogous: [-]/əˈnæləɡəs/; [a]类似的,可比拟的;<昆>同功的; [^]sat;
analogy: [-]/əˈnælədʒi/; [n]比拟,比喻;类比;相似;类似; [^]sat;
anarchist: [-]/ˈænərkɪst/; [n]无政府主义者; [^]sat;
anarchy: [-]/ˈænərki/; [n]无政府状态,政治混乱; [^]sat;
anathema: [-]/əˈnæθəmə/; [n](基督教的)咒诅,被诅咒者,令人厌恶的人; [^]sat;
ancestry: [-]/ˈænsestri/; [n]祖先;血统; [^]sat;
anchor: [-]/ˈæŋkər/; [n]担任(广播电视新闻节目)的主持人;支柱;锚; [v]抛锚; [vt]使固定; [^]sat;
ancillary: [-]/ˈænsəleri/; [a]辅助的,副的; [n]助手;辅助设备; [^]sat;
anecdote: [-]/ˈænɪkdoʊt/; [n]轶事,趣闻; [^]sat;
anemia: [-]/ə'niːmiːə/; [n]贫血,贫血症; [^]sat;
anesthetic: [-]/ˌænəs'θetɪk/; [n]麻醉剂,麻药; [a]麻醉的,感觉缺失的; [^]sat;
anguish: [-]/ˈæŋɡwɪʃ/; [n]痛苦;苦恼; [v]感到极度痛苦; [^]sat;
angular: [-]/ˈæŋɡjələr/; [a]消瘦的;有角的;笨拙的; [^]sat;
animated: [-]/ˈænɪmeɪtɪd/; [a]有活力的,活生生的;活泼的,充满生气的;有生命的;动画(片)的; [^]sat;
animosity: [-]/ˌænɪˈmɑːsəti/; [n]憎恶,仇恨; [^]sat;
animus: [-]/ˈænɪməs/; [n]憎恨,敌意; [^]sat;
annals: [-]/ˈænlz/; [n]年报;年鉴; [^]sat;
annex: [-]/əˈneks/; [n]附加物;附属的建筑物; [vt]附加;并吞,强行占取;获得; [^]sat;
annihilate: [-]/əˈnaɪəleɪt/; [v]消灭; [^]sat;
annotate: [-]/ˈænəteɪt/; [v]注释,评注; [n]注释者; [^]sat;
annuity: [-]/əˈnuːəti/; [n]年金,养老金;年金保险;年金享受权; [^]sat;
annul: [-]/əˈnʌl/; [v]取消,废除,宣告无效; [^]sat;
anoint: [-]/əˈnɔɪnt/; [v]神圣化; [^]sat;
anomalous: [-]/əˈnɑːmələs/; [a]反常的,不规则的,不恰当的; [^]sat;
anomaly: [-]/əˈnɑːməli/; [n]异常,不规则,反常事物; [^]sat;
anonymity: [-]/ˌænəˈnɪməti/; [n]匿名,作者不明(或不详),无名之辈; [^]sat;
anonymous: [-]/əˈnɑːnɪməs/; [a]匿名的;无名的;不具名的;无特色的;无个性特征; [^]sat;
antagonism: [-]/ænˈtæɡənɪzəm/; [n]对抗,敌对;敌意; [^]sat;
antecede: [-]/ˌæntɪ'siːd/; [v]胜过,居前; [^]sat;
antediluvian: [-]/ˌæntidɪˈluːviən/; [a]史前的,陈旧的; [n]大洪水以前的人;年迈的人;不合时宜的人; [^]sat;
anthem: [-]/ˈænθəm/; [n]国歌,赞美诗,圣歌; [^]sat;
anthology: [-]/ænˈθɑːlədʒi/; [n](诗,文,曲,画等的)选集; [^]sat;
anthropoid: [-]/ˈænθrəpɔɪd/; [a]像人类的,类人猿的; [n]类人猿;灵长类动物的类人猿亚目; [^]sat;
anthropologist: [-]/ˌænθrəˈpɑːlədʒɪst/; [n]人类学家,人类学者; [^]sat;
anthropomorphic: [-]/ˌænθrəpəˈmɔːrfɪk/; [a]拟人的,拟人化; [^]sat;
antidote: [-]/ˈæntidoʊt/; [n]<药>解毒剂,解药;矫正方法; [^]sat;
antipathy: [-]/ænˈtɪpəθi/; [n]反感,厌恶,憎恶; [^]sat;
antiquated: [-]/ˈæntɪkweɪtɪd/; [a]陈旧的,过时的; [v]使古旧,废弃; [^]sat;
antiseptic: [-]/ˌæntiˈseptɪk/; [n]杀菌剂; [a]防腐的,抗菌的; [^]sat;
antithesis: [-]/ænˈtɪθəsɪs/; [n]对立面,对照; [^]sat;
apathy: [-]/ˈæpəθi/; [n]冷漠,无兴趣;漠不关心,无感情; [^]sat;
ape: [-]/eɪp/; [n]无尾猿,类人猿;模仿者;粗野的大汉; [a]〈俚〉疯狂的; [v]模仿; [^]sat;
aperture: [-]/ˈæpərtʃər/; [n]孔,穴;(照相机,望远镜等的)光圈,孔径;缝隙; [^]sat;
apex: [-]/ˈeɪpeks/; [n]顶点;尖端; [^]sat;
aphasia: [-]/əˈfeɪziə/; [n]失语症; [^]sat;
aphorism: [-]/ˈæfərɪzəm/; [n]格言,警句; [^]sat;
apiary: [-]/ˈeɪpieri/; [n]蜂房;养蜂场; [^]sat;
aplomb: [-]/əˈplɑːm/; [n]沉着,镇静; [^]sat;
apocalyptic: [-]/əˌpɑːkəˈlɪptɪk/; [a]预示灾祸的,启示的; [^]sat;
apocryphal: [-]/əˈpɑːkrɪfl/; [a]伪的;可疑; [^]sat;
apolitical: [-]/ˌeɪpəˈlɪtɪkl/; [a]不问政治的; [^]sat;
apostate: [-]/əˈpɑːsteɪt/; [a]变节的,脱党的,背教的; [n]脱党者,变节者,叛教者; [^]sat;
apotheosis: [-]/əˌpɑːθiˈoʊsɪs/; [n]神化,典范,崇拜,颂扬; [^]sat;
apparatus: [-]/ˌæpəˈrætəs/; [n]装置,仪器;设备;组织,机构; [^]sat;
apparition: [-]/ˌæpəˈrɪʃn/; [n]幽灵,神奇的现象; [^]sat;
appease: [-]/əˈpiːz/; [v]抚慰;平息; [^]sat;
appellation: [-]/ˌæpəˈleɪʃn/; [n]称呼,名称,名目; [^]sat;
application: [-]/ˌæplɪˈkeɪʃn/; [n]运用;申请(书);应用程序; [^]sat;
appraise: [-]/əˈpreɪz/; [v]评价,鉴定;估价; [^]sat;
appreciate: [-]/əˈpriːʃieɪt/; [v]赏识;为..表示感激;领会;使增值;增值; [^]sat;
apprehend: [-]/ˌæprɪˈhend/; [vt]理解,领会;逮捕;对.忧虑;把.视作; [vi]忧虑; [^]sat;
apprehension: [-]/ˌæprɪˈhenʃn/; [n]忧虑,担心,疑惧;逮捕;理解; [^]sat;
apprenticeship: [-]/əˈprentɪʃɪp/; [n]学徒期;学徒身份;学徒期;学徒身份; [^]sat;
apprise: [-]/əˈpraɪz/; [v]通知,报告; [^]sat;
approbation: [-]/ˌæprəˈbeɪʃn/; [n]称赞,认可;批准; [^]sat;
appropriate: [-]/əˈproʊpriət/; [a]合适的;适当的; [v]挪用;拨款;私占; [^]sat;
aptitude: [-]/ˈæptɪtuːd/; [n]天资;自然倾向;适宜; [^]sat;
aquatic: [-]/əˈkwætɪk/; [a]水生的,水栖的,水中的,水上的; [n]水生动物,水生植物;水上运动; [^]sat;
aquiline: [-]/ˈækwɪlaɪn/; [a]鹰的,似鹰的;钩状的; [^]sat;
arable: [-]/ˈærəbl/; [a]可耕的,适合种植的; [n]耕地; [^]sat;
arbiter: [-]/ˈɑːrbɪtər/; [n]<法>仲裁者;裁决人; [^]sat;
arbitrary: [-]/ˈɑːrbətreri/; [a]随意的,任性的,随心所欲的;霸道的,专制的,专横的;主观的,武断的; [^]sat;
arbitrator: [-]/ˈɑːrbɪtreɪtər/; [n]公断人; [^]sat;
arboretum: [-]/ˌɑːrbəˈriːtəm/; [n]植物园; [^]sat;
arcade: [-]/ɑːrˈkeɪd/; [n]拱廊;有拱廊的街道;游乐场所,游戏厅; [^]sat;
arcane: [-]/ɑːrˈkeɪn/; [a]神秘的;秘传的;晦涩难解的; [^]sat;
archaeology: [-]/ˌɑːrkiˈɑːlədʒi/; [n]考古学; [^]sat;
archaic: [-]/ɑːrˈkeɪɪk/; [a]古代的;陈旧的,过时的,老式的;已不通用的; [^]sat;
archetype: [-]/ˈɑːrkitaɪp/; [n]原型,典型; [^]sat;
archipelago: [-]/ˌɑːrkɪˈpeləɡoʊ/; [n]群岛; [^]sat;
archives: [-]/ˈɑːrkaɪvz/; [n]档案室,档案; [^]sat;
ardent: [-]/ˈɑːrdnt/; [a]热心的,热烈的; [^]sat;
arduous: [-]/ˈɑːrdʒuəs/; [a]艰巨的;努力的;陡峭的; [^]sat;
aria: [-]/ˈɑːriə/; [n]独唱曲,咏叹调; [^]sat;
arid: [-]/ˈærɪd/; [a](土地或气候)干燥的,干旱的,贫瘠的,荒芜的;无创见的,无新意的; [^]sat;
aristocracy: [-]/ˌærɪˈstɑːkrəsi/; [n]贵族;贵族统治;贵族政治;贵族品质; [^]sat;
aromatic: [-]/ˌærəˈmætɪk/; [a]芳香的; [n]芳香植物;芳香族化合物; [^]sat;
arousal: [-]/əˈraʊzl/; [n]觉醒,激励,唤起; [^]sat;
arraign: [-]/əˈreɪn/; [v]指责,控告; [^]sat;
array: [-]/əˈreɪ/; [n]一系列;陈列;编队; [v]排列;部署; [^]sat;
arrears: [-]/əˈrɪrz/; [n]债,欠债; [^]sat;
arrest: [-]/əˈrest/; [v]逮捕,拘留;吸引; [n]逮捕,拘留; [^]sat;
arrogance: [-]/ˈærəɡəns/; [n]自大;傲慢态度; [^]sat;
arsenal: [-]/ˈɑːrsənl/; [n]兵工厂,军械库;储藏; [^]sat;
articulate: [-]/ɑːrˈtɪkjuleɪt/; [a]善于表达的;发音清晰的; [v]清晰地发音;清楚地讲话;连接,接合;与.合成整体 ,使相互连贯; [^]sat;
artifact: [-]/ˈɑːrtɪfækt/; [n]人工制品;手工艺品; [^]sat;
artifice: [-]/ˈɑːrtɪfɪs/; [n]诡计;欺骗;巧妙的办法; [^]sat;
artisan: [-]/ˈɑːrtəzn/; [n]工匠,手艺人; [^]sat;
ascertain: [-]/ˌæsərˈteɪn/; [v]探知,弄清,查明(真相等); [^]sat;
ascetic: [-]/əˈsetɪk/; [a]禁欲的;苦行的; [n]禁欲者;苦行者; [^]sat;
ascribe: [-]/əˈskraɪb/; [v]把.归因于;把.归属于; [^]sat;
aseptic: [-]/ˌeɪˈseptɪk/; [a]无菌的,洁净的; [^]sat;
ashen: [-]/ˈæʃn/; [a]灰色; [^]sat;
asinine: [-]/ˈæsɪnaɪn/; [a]愚笨的;固执的; [^]sat;
askew: [-]/əˈskjuː/; [a]歪斜的; [ad]歪斜地,斜地; [^]sat;
asperity: [-]/æˈsperəti/; [n](表面的)粗糙;(气候等的)严酷;艰苦的条件;(性格)粗暴; [^]sat;
aspirant: [-]/əˈspaɪərənt/; [n]有抱负的人,野心家; [a]上进的,有野心的; [^]sat;
aspire: [-]/əˈspaɪər/; [vi]渴望,有志于(与to,for,after连用或后接不定式); [^]sat;
assail: [-]/əˈseɪl/; [v]攻击;质问;着手解决; [^]sat;
assay: [-]/əˈseɪ/; [n]化验,试验; [v]分析,化验,鉴定; [^]sat;
assent: [-]/əˈsent/; [v]同意,赞成; [n]同意;赞成; [^]sat;
assert: [-]/əˈsɜːrt/; [v]断言;肯定地说;坚持;维护; [^]sat;
assessment: [-]/əˈsesmənt/; [n]评估;评价;估价; [^]sat;
assiduous: [-]/əˈsɪdʒuəs/; [a]勤勉的,刻苦的; [^]sat;
assimilate: [-]/əˈsɪməleɪt/; [v]使同化;吸收;消化; [^]sat;
assuage: [-]/əˈsweɪdʒ/; [v]缓和,减轻; [n]缓和,减轻;减轻.的人; [^]sat;
assumption: [-]/əˈsʌmpʃn/; [n]假定,设想;采取;承担; [^]sat;
assurance: [-]/əˈʃʊrəns/; [n]信心,自信;保证;保险; [^]sat;
asteroid: [-]/ˈæstərɔɪd/; [n]小行星; [a]星状的; [^]sat;
astigmatism: [-]/əˈstɪɡmətɪzəm/; [n]散光; [^]sat;
astringent: [-]/əˈstrɪndʒənt/; [a]止血的,收敛性的;涩的;严厉的; [n]收缩剂,止血药; [^]sat;
astronomical: [-]/ˌæstrəˈnɑːmɪkl/; [a]天文学的; [^]sat;
astute: [-]/əˈstuːt/; [a]机敏的,精明的,狡猾的; [^]sat;
asunder: [-]/əˈsʌndər/; [ad]分离;化为碎片; [^]sat;
asylum: [-]/əˈsaɪləm/; [n]精神病院,疯人院;避难所; [^]sat;
asymmetric: [-]/ˌeɪsɪˈmetrɪk/; [a]不对称的,不匀称的; [^]sat;
atlas: [-]/ˈætləs/; [n]地图集; [^]sat;
atone: [-]/əˈtoʊn/; [v]赎罪,补偿; [^]sat;
atrocity: [-]/əˈtrɑːsəti/; [n]残暴,暴行; [^]sat;
atrophy: [-]/ˈætrəfi/; [v]萎缩;衰退;虚脱; [n]萎缩;衰退;萎缩症; [^]sat;
attain: [-]/əˈteɪn/; [v]获得;达到(某个年纪,水平,条件);实现; [n]成就; [^]sat;
attentive: [-]/əˈtentɪv/; [a]留意的,注意的,肯帮忙的; [^]sat;
attenuate: [-]/əˈtenjueɪt/; [v]变薄,变弱,变纤细; [a]稀薄的;细小的;减弱的;减少的; [^]sat;
attest: [-]/əˈtest/; [vt]证明;证实;为.作证; [vi]证明;作证; [^]sat;
audacious: [-]/ɔːˈdeɪʃəs/; [a]大胆的,鲁莽的,大胆创新的; [^]sat;
audit: [-]/ˈɔːdɪt/; [v]审计,查账;旁听; [n]审计;查帐; [^]sat;
auditory: [-]/ˈɔːdətɔːri/; [a]听觉的; [^]sat;
augment: [-]/ɔːɡˈment/; [v]增加;助长; [^]sat;
augury: [-]/ˈɔːɡjʊri/; [n]预言,征兆,占卜; [^]sat;
auspicious: [-]/ɔːˈspɪʃəs/; [a]吉兆的,幸运的; [^]sat;
austere: [-]/ɔːˈstɪr/; [a]严峻的;简朴的;苦行的;无装饰的; [^]sat;
authenticate: [-]/ɔːˈθentɪkeɪt/; [v]鉴定;证明.是真实的; [^]sat;
authoritarian: [-]/əˌθɔːrəˈteriən/; [a]独裁主义的,权力主义的; [n]权力主义者,独裁主义者; [^]sat;
authoritative: [-]/əˈθɔːrəteɪtɪv/; [a]权威性的;可信的;命令式的,专断的; [^]sat;
autocratic: [-]/ˌɔːtəˈkrætɪk/; [a]独裁的,专断的; [^]sat;
automaton: [-]/ɔːˈtɑːmətən/; [n]自动机;机器人; [^]sat;
autonomous: [-]/ɔːˈtɑːnəməs/; [a]自动驾驶的;自治的,独立自主的;自主的; [^]sat;
autopsy: [-]/ˈɔːtɑːpsi/; [n]验尸;<病理><特医>剖检; [^]sat;
auxiliary: [-]/ɔːɡˈzɪliəri/; [a]备用的,辅助的,协助的; [^]sat;
avalanche: [-]/ˈævəlæntʃ/; [n]雪崩;大量拥至; [vi]崩塌; [^]sat;
avarice: [-]/ˈævərɪs/; [n]贪财,贪婪; [^]sat;
avenge: [-]/əˈvendʒ/; [v]报复,报仇; [^]sat;
averse: [-]/əˈvɜːrs/; [a]不乐意的,不情愿的; [^]sat;
aversion: [-]/əˈvɜːrʒn/; [n]厌恶;讨厌的人,(或东西); [^]sat;
avert: [-]/əˈvɜːrt/; [v]转移(目光,注意力等);防止;避开; [^]sat;
aviary: [-]/ˈeɪvieri/; [n]鸟类饲养场,大型鸟舍; [^]sat;
avid: [-]/ˈævɪd/; [a]渴望的,贪婪的;热心的; [^]sat;
avocation: [-]/ˌævoʊˈkeɪʃn/; [n]业余爱好;副业;嗜好; [^]sat;
avow: [-]/əˈvaʊ/; [vt]公开宣称,坦率承认;断言; [a]可明言的;公开声明的,承认的; [n]公开宣布; [^]sat;
avuncular: [-]/əˈvʌŋkjələr/; [a]伯父的;叔伯的;慈祥的; [^]sat;
awe: [-]/ɔː/; [n]敬畏;畏怯;(壮观等引起的)惊叹,惊奇; [vt]使敬畏,令人敬畏,使充满畏惧; [^]sat;
awry: [-]/əˈraɪ/; [a]扭曲的,走样的; [ad]歪曲地;歪斜地;错误地; [^]sat;
axiom: [-]/ˈæksiəm/; [n]公理,定理; [^]sat;
azure: [-]/ˈæʒər/; [a]天蓝色的; [n]碧空; [v]使成天蓝色; [^]sat;
babble: [-]/ˈbæbl/; [v]呀呀学语,喋喋不休,作潺潺声;泄露(秘密); [n]儿语,胡言乱语,潺潺声; [^]sat;
bacchanalian: [-]/ˌbækəˈneɪliən/; [a]狂欢的,行为放纵的; [^]sat;
badger: [-]/ˈbædʒər/; [n]獾;獾皮毛; [v]纠缠;烦扰(反复提提出问题或要求); [^]sat;
badinage: [-]/ˌbædənˈɑːʒ/; [n]开玩笑,嘲弄,揶揄; [^]sat;
baffle: [-]/ˈbæfl/; [v]使困惑;难住;阻碍; [n]挡板; [^]sat;
bait: [-]/beɪt/; [n]饵,诱惑物; [v]装饵;辱骂,欺侮; [^]sat;
baleful: [-]/ˈbeɪlfl/; [a]邪恶的,恶意的; [ad]凶恶地,有害地; [^]sat;
balk: [-]/bɔːk/; [v]畏缩;阻止;停止; [n]障碍;错误; [^]sat;
ballast: [-]/ˈbæləst/; [n](船等)压舱物;稳定因素;<比喻>沉着; [vt]给某物装上压舱物;给.铺道渣;使稳定;使沉着; [^]sat;
balm: [-]/bɑːm/; [n]香油,止痛膏,安慰物,香气; [^]sat;
balmy: [-]/ˈbɑːmi/; [a](气候)温和的; [^]sat;
banal: [-]/bəˈnɑːl/; [a]陈腐的;平庸的;老一套的; [^]sat;
bane: [-]/beɪn/; [n]祸根; [^]sat;
barb: [-]/bɑːrb/; [n]箭头鱼钩等的倒钩;伤人的话; [v]装倒钩于; [a]具倒刺的;(话)带刺的; [^]sat;
bard: [-]/bɑːrd/; [n]吟游诗人; [^]sat;
barrage: [-]/bəˈrɑːʒ/; [n]大量;阻塞;齐射式攻击;<水利>拦河坝; [v]以密集火力阻击; [^]sat;
barren: [-]/ˈbærən/; [a]贫瘠的,不孕的; [n]荒原,不毛之地; [^]sat;
barricade: [-]/ˌbærɪˈkeɪd/; [n]路障;障碍物;栅栏; [v]设路障;挡住; [^]sat;
bask: [-]/bæsk/; [vi]晒太阳(享受温暖),感到温暖,愉快或舒适; [n]晒太阳,取暖;沉浸于; [^]sat;
bastion: [-]/ˈbæstiən/; [n]堡垒;棱堡; [^]sat;
bauble: [-]/ˈbɔːbl/; [n]廉价珠宝;小玩意; [^]sat;
bawdy: [-]/ˈbɔːdi/; [a]说黄色笑话的;淫猥的,下流的; [^]sat;
beam: [-]/biːm/; [n]光线;(房屋等)大梁;(横)梁; [v]发光;照射;发射,播送;微笑;用梁支撑; [^]sat;
beatific: [-]/ˌbiːəˈtɪfɪk/; [a]祝福的,有福的; [^]sat;
beatitude: [-]/bi'ætɪtuːd/; [n]祝福;至福; [^]sat;
beget: [-]/bɪˈɡet/; [v]产生,引起; [^]sat;
begrudge: [-]/bɪˈɡrʌdʒ/; [v]嫉妒,吝惜,舍不得给; [^]sat;
beguile: [-]/bɪˈɡaɪl/; [v]欺骗,迷住,吸引; [^]sat;
behemoth: [-]/bɪˈhiːmɔːθ/; [n]怪物;怪兽; [^]sat;
belabor: [-]/bɪˈleɪbər/; [v]抨击;反复讨论,啰啰嗦嗦地说明; [^]sat;
belated: [-]/bɪˈleɪtɪd/; [a]迟来的;误期的; [^]sat;
beleaguer: [-]/bɪ'liːgə/; [v]围攻; [^]sat;
belie: [-]/bɪˈlaɪ/; [vt]与.不符;矛盾,误解; [^]sat;
belittle: [-]/bɪˈlɪtl/; [v]轻视,贬抑; [^]sat;
bellicose: [-]/ˈbelɪkoʊs/; [a]好战的,好斗的; [^]sat;
belligerent: [-]/bəˈlɪdʒərənt/; [a](国家等)交战的,挑斗的; [n]交战国,交战者;参加斗殴的人或集团; [^]sat;
bemoan: [-]/bɪˈmoʊn/; [v]哀悼;为..恸哭;哀叹,对..表示惋惜; [^]sat;
bemused: [-]/bɪˈmjuːzd/; [a]困惑的,发呆的; [^]sat;
benediction: [-]/ˌbenɪˈdɪkʃn/; [n]祝福,祈祷; [^]sat;
benefactor: [-]/ˈbenɪfæktər/; [n]恩人;捐助者;施主; [^]sat;
beneficial: [-]/ˌbenɪˈfɪʃl/; [a]有益的,有利的; [^]sat;
beneficiary: [-]/ˌbenɪˈfɪʃieri/; [n]<金融>受益人,受惠者;封臣; [a]拥有封地的;受圣俸的; [^]sat;
benevolent: [-]/bəˈnevələnt/; [a]慈爱的,仁慈的;乐善好施的;慈善的; [^]sat;
benign: [-]/bɪˈnaɪn/; [a]仁慈的;慈祥的;(病)良性的; [^]sat;
bent: [-]/bent/; [a]弯曲的,决心的,不诚实的; [v]弯腰,弯曲(bend过去式); [n]爱好,癖好; [^]sat;
bequeath: [-]/bɪˈkwiːð/; [v]遗赠(留); [^]sat;
berate: [-]/bɪˈreɪt/; [v]猛烈责骂; [^]sat;
bereft: [-]/bɪˈreft/; [a]丧失的;被剥夺的;失去亲人的; [^]sat;
berserk: [-]/bərˈzɜːrk/; [a]狂暴的,疯的的; [ad]狂暴地,狂怒地; [n]同"berserker"; [^]sat;
beseech: [-]/bɪˈsiːtʃ/; [v]恳求,哀求; [a]恳求的;哀求的;乞求的; [^]sat;
beset: [-]/bɪˈset/; [v]困扰;镶嵌;围绕; [^]sat;
besiege: [-]/bɪˈsiːdʒ/; [v]围攻,困扰; [^]sat;
besmirch: [-]/bɪˈsmɜːrtʃ/; [v]诽谤,玷污; [^]sat;
bestow: [-]/bɪˈstoʊ/; [v]给予; [^]sat;
betray: [-]/bɪˈtreɪ/; [v]背叛;失信于;泄露(秘密等);(非故意地)暴露; [^]sat;
betroth: [-]/bɪ'trɔːθ/; [v]同.订婚,许配; [^]sat;
bevy: [-]/ˈbevi/; [n]一群(少女或鸟); [^]sat;
biased: [-]/ˈbaɪəst/; [a]有偏见的,结果偏倚的,有偏的; [^]sat;
bicameral: [-]/ˌbaɪˈkæmərəl/; [a]两院制的; [^]sat;
bicker: [-]/ˈbɪkər/; [v]斗嘴,流动,闪动; [n]口角,流水声; [^]sat;
biennial: [-]/baɪˈeniəl/; [a]两年一次的;二年生植物的; [n]两年生植物;两年一次的事; [^]sat;
bilious: [-]/ˈbɪliəs/; [a]多胆汁的,坏脾气的; [^]sat;
bilk: [-]/bɪlk/; [v]骗; [^]sat;
billowing: [-]/ˈbɪloʊɪŋ/; [a]波涛翻滚; [^]sat;
bizarre: [-]/bɪˈzɑːr/; [a]稀奇古怪的; [^]sat;
blanch: [-]/blæntʃ/; [v]变白;漂白; [n]铅矿石; [a]漂白的;银白色的; [^]sat;
bland: [-]/blænd/; [vi]变得平淡无奇,变得枯燥无味; [a]温和的;(食物等)清淡的;漠不关心的; [vt]使变得淡而无味,使变得枯燥无味;除掉.的特性; [^]sat;
blandishment: [-]/ˈblændɪʃmənt/; [n]甜言蜜语,奉承;谄媚;哄诱; [^]sat;
blare: [-]/bler/; [v]高声鸣叫,发嘟嘟声; [n]嘟嘟声,号声,巨响; [^]sat;
blatant: [-]/ˈbleɪtnt/; [a]喧哗的;露骨的;公然的;明目张胆的; [^]sat;
bleak: [-]/bliːk/; [a]凄凉的;萧瑟的;阴郁的;无希望的; [^]sat;
blighted: [-]/ˈblaɪtɪd/; [a]完蛋了的,生病了的; [^]sat;
blithe: [-]/blaɪð/; [a]愉快的;快乐无忧的; [^]sat;
bloated: [-]/ˈbloʊtɪd/; [a]浮肿的,发胀的,傲慢的; [^]sat;
bludgeon: [-]/ˈblʌdʒən/; [v]用棍棒击打;恫吓; [n]大头狼牙棒; [^]sat;
bluff: [-]/blʌf/; [a]直率的; [v]虚张声势,吓唬; [n]虚张声势;吓唬;断崖,绝壁; [^]sat;
blunder: [-]/ˈblʌndər/; [n]愚蠢之举;大错; [vi]犯大错; [v]失策;绊倒; [^]sat;
blurt: [-]/blɜːrt/; [v]突然说出,冲动地说; [^]sat;
bluster: [-]/ˈblʌstər/; [v]咆哮;狂吹;夸口;威吓;气势汹汹地说; [n]怒号;吓唬; [^]sat;
bode: [-]/boʊd/; [v]预示,为.的兆头,停留,继续,遭到; [^]sat;
bogus: [-]/ˈboʊɡəs/; [a]假的,假装的; [n]伪币;冒牌货; [^]sat;
boisterous: [-]/ˈbɔɪstərəs/; [a]喧闹的,欢闹的; [^]sat;
bolster: [-]/ˈboʊlstər/; [n]枕垫; [v]支持,鼓励,增强; [^]sat;
bolt: [-]/boʊlt/; [n]门栓,螺栓;闪电;弩箭; [v]闩门;(马受惊)脱缰; [ad]突然地;像箭似地;直立地; [^]sat;
bombardment: [-]/bɑːmˈbɑːrdmənt/; [n]炮轰; [^]sat;
booming: [-]/ˈbuːmɪŋ/; [a]快速增长的,欣欣向荣;深刻的; [^]sat;
boon: [-]/buːn/; [n]恩惠,福利,利益; [a]愉快的; [^]sat;
boorish: [-]/ˈbʊrɪʃ/; [a]粗野的;乡土气的;笨拙的; [^]sat;
boundless: [-]/ˈbaʊndləs/; [a]无限的;无边无际的; [^]sat;
bountiful: [-]/ˈbaʊntɪfl/; [a]充足的,慷慨的,丰裕的; [^]sat;
bourgeois: [-]/ˌbʊrˈʒwɑː/; [n]中产阶级;资产阶级; [a]中产阶级的; [^]sat;
bovine: [-]/ˈboʊvaɪn/; [a](似)牛的,迟钝的; [n]牛科动物; [^]sat;
boycott: [-]/ˈbɔɪkɑːt/; [vt]抵制; [n]抵制; [^]sat;
brandish: [-]/ˈbrændɪʃ/; [v]挥舞;炫耀的挥舞(武器); [n]挥舞; [^]sat;
bravado: [-]/brəˈvɑːdoʊ/; [n]故作勇敢,逞能; [^]sat;
brazen: [-]/ˈbreɪzn/; [a]厚脸皮的,厚颜无耻的;黄铜(制)的; [v]厚着脸皮干,使变得无耻; [^]sat;
breach: [-]/briːtʃ/; [n]破裂;裂痕;冲击;违反; [v]使有裂口;破坏; [^]sat;
breadth: [-]/bredθ/; [n]宽度;广度; [^]sat;
brevity: [-]/ˈbrevəti/; [n]简短,短小,精炼; [^]sat;
brindled: [-]/ˈbrɪnd(ə)ld/; [a]有斑纹的; [^]sat;
brittle: [-]/ˈbrɪtl/; [a]易碎的;脆弱的;靠不住的; [n]薄片脆糖; [^]sat;
broach: [-]/broʊtʃ/; [v]提出;钻孔;开始讨论;给.开口; [^]sat;
brochure: [-]/broʊˈʃʊr/; [n]手册,小册子; [^]sat;
browbeat: [-]/ˈbraʊbiːt/; [v]恫吓,吓唬;欺侮; [^]sat;
browse: [-]/braʊz/; [v]浏览;随意翻阅;(牛,羊等)吃草; [^]sat;
brunt: [-]/brʌnt/; [n]冲击,主要冲力; [^]sat;
brusque: [-]/brʌsk/; [a]唐突的,直率的,无礼的; [^]sat;
bucolic: [-]/bjuːˈkɑːlɪk/; [a]乡村的;牧羊的; [^]sat;
buffet: [-]/bəˈfeɪ/; [n]自助餐,(火车内)餐室,冷餐桌; [v]反复敲打,打击,重击; [^]sat;
bullion: [-]/ˈbʊliən/; [n](造币用)金块;纯金,纯银;条形金属; [^]sat;
bulwark: [-]/ˈbʊlwɜːrk/; [n]堡垒,壁垒;保障;防波堤; [v]防御,保护;筑垒保卫; [^]sat;
bumptious: [-]/ˈbʌmpʃəs/; [a]专横傲慢的,自以为是的; [^]sat;
bungalow: [-]/ˈbʌŋɡəloʊ/; [n]平房,小屋; [^]sat;
bungle: [-]/ˈbʌŋɡl/; [v]办糟,失败; [n]粗劣,失败,笨拙; [^]sat;
buoyant: [-]/ˈbɔɪənt/; [a]有浮力的;愉快的;(股市)保持高价的; [^]sat;
bureaucracy: [-]/bjʊˈrɑːkrəsi/; [n]官僚主义;政府机构; [^]sat;
burgeon: [-]/ˈbɜːrdʒən/; [v]发芽,迅速成长; [n]嫩枝; [^]sat;
burlesque: [-]/bɜːrˈlesk/; [a]滑稽的,可笑的; [v]讥笑; [n]脱衣舞,打油诗,滑稽戏,笑剧,杂耍,漫画; [^]sat;
burly: [-]/ˈbɜːrli/; [a]结实的;率直的;粗鲁的; [n]〈美〉滑稽戏;〈美俚〉身材魁伟的人; [^]sat;
burnish: [-]/ˈbɜːrnɪʃ/; [v]擦亮,磨光; [^]sat;
bustle: [-]/ˈbʌsl/; [n]喧闹,熙攘;腰垫;奔走,奔忙; [v]喧闹;忙乱,奔忙; [^]sat;
buttress: [-]/ˈbʌtrəs/; [n]扶墙,拱壁; [v]支持; [^]sat;
buxom: [-]/ˈbʌksəm/; [a]体态丰满的; [^]sat;
cache: [-]/kæʃ/; [n]隐藏处所,隐藏的粮食或物资,贮藏物; [vt]贮藏; [vi]躲藏; [^]sat;
cadaver: [-]/kəˈdævər/; [n]尸体; [^]sat;
cadaverous: [-]/kəˈdævərəs/; [a]像尸体的,(形容)枯槁的; [^]sat;
cadence: [-]/ˈkeɪdns/; [n](声音的)抑扬顿挫;韵律; [vt]使有节奏; [^]sat;
cajole: [-]/kəˈdʒoʊl/; [v]以甜言蜜语哄骗,勾引; [^]sat;
calamity: [-]/kəˈlæməti/; [n]大灾祸,不幸之事; [^]sat;
caliber: [-]/'kæləbə/; [n]<军>口径;才干;水准(等于calibre);器量; [^]sat;
calligraphy: [-]/kəˈlɪɡrəfi/; [n]笔迹,墨宝,书法; [^]sat;
callous: [-]/ˈkæləs/; [a]无情的,铁石心肠的,硬结的; [vt](使)变硬,(使)起茧;(使)冷酷无情; [^]sat;
callow: [-]/ˈkæloʊ/; [a](鸟)未生羽毛的;年轻而无经验的; [^]sat;
calorific: [-]/ˌkæləˈrɪfɪk/; [a]发热的,富含卡路里的; [^]sat;
calumny: [-]/ˈkæləmni/; [n]诽谤,中伤; [^]sat;
camaraderie: [-]/ˌkɑːməˈrɑːdəri/; [n]友情; [^]sat;
cameo: [-]/ˈkæmioʊ/; [n]石雕,贝雕;浮雕玉石;文学小品; [^]sat;
camouflage: [-]/ˈkæməflɑːʒ/; [n]伪装;掩饰; [v]使改头换面,伪装,掩饰;欺瞒; [^]sat;
candor: [-]/'kændə/; [n]坦白,直率,诚挚; [^]sat;
canine: [-]/ˈkeɪnaɪn/; [a]犬的,似犬的,犬科的,犬齿的; [n]<解剖>犬齿; [^]sat;
canny: [-]/ˈkæni/; [a]精明的,谨慎的,节约的; [ad]<苏格兰>仔细地; [^]sat;
cantankerous: [-]/kænˈtæŋkərəs/; [a]脾气坏的,好争吵的; [^]sat;
cantata: [-]/kænˈtɑːtə/; [n]大合唱;清唱剧;(一种声乐套曲)康塔塔; [^]sat;
canter: [-]/ˈkæntər/; [n]慢跑(多用于马); [^]sat;
canto: [-]/ˈkæntoʊ/; [n](长诗的)分篇; [^]sat;
canvass: [-]/ˈkænvəs/; [v]仔细检查或详尽地讨论;审查,游说; [n]讨论;细查;劝诱; [^]sat;
capacious: [-]/kəˈpeɪʃəs/; [a]宽敞的;广阔的;容积大的; [^]sat;
capacity: [-]/kəˈpæsəti/; [n]产能;容量;本领;才能;负载量;职位; [^]sat;
capitulate: [-]/kəˈpɪtʃuleɪt/; [vi]有条件投降,认输,屈服,让步,停止抵抗; [^]sat;
caprice: [-]/kəˈpriːs/; [n]任性,反复无常,随想曲; [^]sat;
capricious: [-]/kəˈprɪʃəs/; [a]变化无常的,任性的; [^]sat;
caption: [-]/ˈkæpʃn/; [n](报刊的)标题;(插图,照片等的)说明文字; [v]给(图片,照片等)加说明文字; [^]sat;
captivate: [-]/ˈkæptɪveɪt/; [v]吸引,迷惑; [^]sat;
carat: [-]/ˈkærət/; [n]公制克拉;(金子)开; [^]sat;
cardinal: [-]/ˈkɑːrdɪnl/; [a]主要的;基本的; [n]<天主教>枢机主教,红衣主教;基数; [^]sat;
careen: [-]/kəˈriːn/; [n](船的)倾侧; [v](船)倾斜,使倾斜; [^]sat;
caricature: [-]/ˈkærɪkətʃər/; [n]讽刺画,滑稽模仿;扭曲,夸张的描述; [^]sat;
carnage: [-]/ˈkɑːrnɪdʒ/; [n]大屠杀,残杀,大量绝灭; [^]sat;
carnal: [-]/ˈkɑːrnl/; [a]肉体的,肉欲的,性欲的,色欲的,淫荡的; [^]sat;
carnivorous: [-]/kɑːrˈnɪvərəs/; [a]食肉的,肉食性的; [^]sat;
cartographer: [-]/kɑːrˈtɑːɡrəfər/; [n]制图师;地图制作者; [^]sat;
cascade: [-]/kæˈskeɪd/; [n]层叠;小瀑布;喷流; [v]像瀑布般冲下或倾泻; [^]sat;
castigate: [-]/ˈkæstɪɡeɪt/; [v]严惩;苛评;矫正;修订; [^]sat;
casualty: [-]/ˈkæʒuəlti/; [n]伤亡人员,死伤者,受害人;急诊室(英); [^]sat;
cataclysm: [-]/ˈkætəklɪzəm/; [n]灾难(常指大洪水或地震),剧变; [^]sat;
catalyst: [-]/ˈkætəlɪst/; [n]催化剂;造成变化的人或事; [^]sat;
catapult: [-]/ˈkætəpʌlt/; [n]弹弓;石弩;飞机弹射器;(飞机上的)座椅弹射器; [v]用弹弓射;用弹射器发射;猛投;快速移动; [^]sat;
cataract: [-]/ˈkætərækt/; [n]<眼科>白内障,大瀑布,暴雨,洪水,奔流; [v]倾注; [^]sat;
catastrophe: [-]/kəˈtæstrəfi/; [n]大灾难; [^]sat;
categorical: [-]/ˌkætəˈɡɔːrɪkl/; [a]绝对的;直接了当的;无条件的;属于某一范畴的; [^]sat;
catharsis: [-]/kəˈθɑːrsɪs/; [n]泻法,净化,精神发泄; [^]sat;
caucus: [-]/ˈkɔːkəs/; [n]政党高层会议,核心人物; [^]sat;
caulk: [-]/kɔːk/; [v]填隙使不渗水,捻缝,凿密; [n]捻缝材料,填料; [^]sat;
causal: [-]/ˈkɔːzl/; [a]因果关系的,有原因的; [n]表示原因的连词; [^]sat;
caustic: [-]/ˈkɔːstɪk/; [a]腐蚀性的;苛性的;刻薄的;焦散的; [n]腐蚀剂;苛性钠;焦散曲线; [^]sat;
cavalcade: [-]/ˌkævlˈkeɪd/; [n]行列,队伍,骑兵队; [^]sat;
cavalier: [-]/ˌkævəˈlɪr/; [n]骑士,武士; [a]满不在乎的,无忧无虑的,漫不经心的,目中无人的; [^]sat;
cavil: [-]/ˈkævl/; [v]吹毛求疵,挑剔,无端指摘;挑毛病,无端抱怨; [n]吹毛求疵,苛责,无端的指责; [^]sat;
cede: [-]/siːd/; [v]放弃;割让(领土); [^]sat;
celebrated: [-]/ˈselɪbreɪtɪd/; [a]著名的,有名望的; [v]庆祝; [^]sat;
celerity: [-]/sə'lerətɪ/; [n]快速,敏捷; [^]sat;
celestial: [-]/səˈlestʃl/; [a]天体的,天上的; [n]天人,神仙;(指封建时代的)中国人,天朝之人; [^]sat;
celibate: [-]/ˈselɪbət/; [n]独身者,独身主义者; [a]独身的,未婚的,禁欲的; [^]sat;
censor: [-]/ˈsensər/; [n]检查员; [vt]审查,检查;修改; [^]sat;
censorious: [-]/senˈsɔːriəs/; [a]爱挑剔的,吹毛求疵的,严厉批评的; [^]sat;
censure: [-]/ˈsenʃər/; [v]责难,责备; [n]责难,责备; [^]sat;
centigrade: [-]/ˈsentɪɡreɪd/; [a]百分度的;摄氏的; [n]摄氏度; [^]sat;
centrifugal: [-]/ˌsentrɪˈfjuːɡl/; [a]离心的;远中的; [n]离心机; [^]sat;
centurion: [-]/senˈtʃʊriən/; [n]百夫长;百人队队长; [^]sat;
cerebral: [-]/səˈriːbrəl/; [a]大脑的,深思的; [^]sat;
cerebration: [-]/ˌserə'breɪʃən/; [n]思考,精神活动,脑髓作用; [^]sat;
ceremonious: [-]/ˌserəˈmoʊniəs/; [a]隆重的;讲究仪式的;正式的; [^]sat;
certitude: [-]/ˈsɜːrtɪtuːd/; [n]确实;确信;必然性; [^]sat;
cessation: [-]/seˈseɪʃn/; [n]停止,中止,中断; [^]sat;
chafe: [-]/tʃeɪf/; [v]擦破;擦热;擦痛;激怒; [n]急躁;摩擦,擦伤;(防止擦伤马的)马鞍环套皮; [^]sat;
chaff: [-]/tʃæf/; [n]谷物的皮壳,米糠;草料,干草;小玩笑; [v]开玩笑; [^]sat;
chagrin: [-]/ʃəˈɡrɪn/; [n]懊恼;委屈;气愤; [v]使.懊恼; [^]sat;
chalice: [-]/ˈtʃælɪs/; [n](高脚)酒杯;圣餐杯;［植］杯状花; [^]sat;
chameleon: [-]/kəˈmiːliən/; [n]蜥蜴;变色龙;善变的人; [^]sat;
champion: [-]/ˈtʃæmpiən/; [n]冠军;拥护者,战士; [v]拥护;保卫;为..而斗争; [a]夺得第一名的;优胜的; [^]sat;
chaotic: [-]/keɪˈɑːtɪk/; [a]混沌的,混乱的;混乱的;无秩序的; [^]sat;
charisma: [-]/kəˈrɪzmə/; [n]魅力; [^]sat;
charlatan: [-]/ˈʃɑːrlətən/; [n]骗子;假内行; [^]sat;
chary: [-]/ˈtʃeri/; [a]小心的,谨慎的; [^]sat;
chasm: [-]/ˈkæzəm/; [n](地壳,冰上的)隐窟,深坑,峡谷;显著差距,巨大分歧; [^]sat;
chassis: [-]/ˈʃæsi/; [n]底盘; [^]sat;
chaste: [-]/tʃeɪst/; [a]贞洁的;纯洁的;朴素的; [^]sat;
chastise: [-]/tʃæˈstaɪz/; [v]严厉惩罚,遣责; [^]sat;
check: [-]/tʃek/; [v]检查;阻止; [n]支票;阻止;检查;阻止物; [^]sat;
cherubic: [-]/tʃəˈruːbɪk/; [a]可爱的;天使的;无邪的; [^]sat;
chicanery: [-]/ʃɪˈkeɪnəri/; [n]诡计,诈骗,欺骗; [^]sat;
chide: [-]/tʃaɪd/; [v]叱责,指责; [^]sat;
chimerical: [-]/kaɪ'merɪkəl/; [a]空想的,妄想的;荒唐的; [^]sat;
chisel: [-]/ˈtʃɪzl/; [v]刻,凿; [n]凿子; [^]sat;
chivalrous: [-]/ˈʃɪvəlrəs/; [a]像骑士的,侠义的,大侠的; [^]sat;
choleric: [-]/ˈkɑːlərɪk/; [a]易怒的,暴躁的,胆汁质的; [^]sat;
choreography: [-]/ˌkɔːriˈɑːɡrəfi/; [n]编舞艺术;舞蹈编排;舞蹈编排; [^]sat;
chortle: [-]/ˈtʃɔːrtl/; [v]咯咯笑; [n]得意的高笑; [^]sat;
chronic: [-]/ˈkrɑːnɪk/; [a](疾病)慢性的;长期的;(人)久病的;积习难改的;严重的; [^]sat;
chronicle: [-]/ˈkrɑːnɪkl/; [n]编年史,年代记,记录; [v]记录,把.载入编年史; [^]sat;
churlish: [-]/ˈtʃɜːrlɪʃ/; [a]脾气暴躁的;没有礼貌的; [^]sat;
cipher: [-]/ˈsaɪfər/; [n]密码,暗号,不重要的人; [^]sat;
circuitous: [-]/sərˈkjuːɪtəs/; [a]迂回的,绕圈子的; [^]sat;
circumlocution: [-]/ˌsɜːrkəmləˈkjuːʃn/; [n]婉转曲折的说法,累赘的陈述,遁辞; [^]sat;
circumscribe: [-]/ˈsɜːrkəmskraɪb/; [v]限制;在.周围画线;<数>使外接,使外切; [^]sat;
circumspect: [-]/ˈsɜːrkəmspekt/; [a]慎重的,仔细的; [^]sat;
circumvent: [-]/ˌsɜːrkəmˈvent/; [v]用计避免,规避; [^]sat;
cistern: [-]/ˈsɪstərn/; [n]水箱;水池;贮水器; [^]sat;
citadel: [-]/ˈsɪtədəl/; [n]堡垒;避难所; [^]sat;
cite: [-]/saɪt/; [v]引用,引证;传唤,传讯;表彰,嘉奖; [^]sat;
civil: [-]/ˈsɪvl/; [a]公民的,民用的;国内的;有礼貌的,客气的; [^]sat;
clairvoyant: [-]/klerˈvɔɪənt/; [n]千里眼,透视眼;有洞察力的人; [a]千里眼的;有洞察力的;透视的;有洞察力的; [^]sat;
clamber: [-]/ˈklæmbər/; [v]攀登,爬上; [n]攀登,攀爬; [^]sat;
clamor: [-]/ˈklæmər/; [n]喧闹;强烈的要求; [v]喧嚷;强烈的要求; [^]sat;
clandestine: [-]/klænˈdestɪn/; [a]秘密的,私下的,暗中的; [^]sat;
clapper: [-]/ˈklæpər/; [n]拍手者;铃舌;响板;唠唠叨叨的嘴巴; [^]sat;
clasp: [-]/klæsp/; [v]握紧;扣紧;扣住;抱紧; [n]扣子;钩子;紧抱;紧握; [^]sat;
claustrophobia: [-]/ˌklɔːstrəˈfoʊbiə/; [n]幽闭恐怖症; [^]sat;
cleave: [-]/kliːv/; [v]劈开,分裂; [^]sat;
cleft: [-]/kleft/; [n]裂缝; [a]分裂的;劈开的; [^]sat;
clench: [-]/klentʃ/; [v]紧握,(拳头)牢牢地抓住;确定;敲弯;咬紧(牙关); [n]紧抓;咬紧牙关;咬牙切齿;敲弯的钉头; [^]sat;
cliche: [-]/klɪˈʃeɪ/; [n]陈腐思想,陈词滥调; [a]陈腐的; [^]sat;
clientele: [-]/ˌklaɪənˈtel/; [n]顾客,常客; [^]sat;
clip: [-]/klɪp/; [n]回形针,夹子;(电影,广播,电视节目的)片段; [v]夹住;删剪;剪辑; [^]sat;
clique: [-]/kliːk/; [n]朋党派系,小集团; [vi]结派,结党; [^]sat;
cloister: [-]/ˈklɔɪstər/; [n]修道院; [a]隐居的;躲开尘世纷争的; [^]sat;
cloying: [-]/ˈklɔɪɪŋ/; [a]甜得发腻的;厌烦的;倒胃口的; [^]sat;
clump: [-]/klʌmp/; [n]土块; [v]丛生; [^]sat;
coagulate: [-]/koʊˈæɡjuleɪt/; [v]凝结,使凝结; [^]sat;
coalesce: [-]/ˌkoʊəˈles/; [v]联合,合并,结合; [^]sat;
coalition: [-]/ˌkoʊəˈlɪʃn/; [n]结合;联盟;联合; [^]sat;
coddle: [-]/ˈkɑːdl/; [v]溺爱;用文火煮; [n]〈口〉娇生惯养的人; [^]sat;
codicil: [-]/ˈkɑːdəsl/; [n]遗嘱的附录,附加条款; [^]sat;
codify: [-]/ˈkɑːdɪfaɪ/; [v]编纂;将..编成法典; [^]sat;
coercion: [-]/koʊˈɜːrʒn/; [n]胁迫,威压; [^]sat;
cogent: [-]/ˈkoʊdʒənt/; [a]有说服力的; [^]sat;
cogitate: [-]/ˈkɑːdʒɪteɪt/; [v]慎重思考,思索; [^]sat;
cognate: [-]/ˈkɑːɡneɪt/; [a]同词源的,同类的; [^]sat;
cognitive: [-]/ˈkɑːɡnətɪv/; [a]认识能力的;认知的; [^]sat;
cohesion: [-]/koʊˈhiːʒn/; [n]凝聚,凝聚力;结合;<力>内聚力; [^]sat;
coincidence: [-]/koʊˈɪnsɪdəns/; [n]一致;巧合,巧事;同时发生; [^]sat;
colander: [-]/ˈkɑːləndər/; [n]滤器,漏勺; [^]sat;
collaborate: [-]/kəˈlæbəreɪt/; [v]合作; [^]sat;
collage: [-]/kəˈlɑːʒ/; [n]抽象拚贴画(用报纸,布,压平的花等碎片拼合而成的); [^]sat;
collate: [-]/kəˈleɪt/; [v]核对,校对;校勘; [^]sat;
collateral: [-]/kəˈlætərəl/; [a]间接的,旁系的; [n]抵押品; [^]sat;
colloquial: [-]/kəˈloʊkwiəl/; [a]口语的,白话的,通俗的,口语体; [^]sat;
collusion: [-]/kəˈluːʒn/; [n]勾结;共谋; [^]sat;
colossal: [-]/kəˈlɑːsl/; [a]巨像(似)的;巨大的,庞大的; [^]sat;
comatose: [-]/ˈkoʊmətoʊs/; [a]昏迷的,昏睡状态的,麻木的,怠惰的; [^]sat;
combustible: [-]/kəmˈbʌstəbl/; [a]易燃的;易激动的; [n]可燃物;易燃物; [^]sat;
comely: [-]/ˈkʌmli/; [a]动人的,美丽的; [^]sat;
comeuppance: [-]/kʌmˈʌpəns/; [n]应得的惩罚,因果报应; [^]sat;
commemorate: [-]/kəˈmeməreɪt/; [v]纪念,庆祝; [^]sat;
commensurate: [-]/kəˈmenʃərət/; [a]相称的,相应的;同量的;同样大小的; [^]sat;
commiserate: [-]/kəˈmɪzəreɪt/; [v]同情,怜悯; [^]sat;
commodious: [-]/kəˈmoʊdiəs/; [a]宽敞的; [^]sat;
communal: [-]/kəˈmjuːnl/; [a]公社的;公共的; [^]sat;
compact: [-]/ˈkɑːmpækt/; [a]小巧的,小型的,袖珍的,体积小的;紧密的,紧凑的,密集的; [v]把..压紧;变得坚实; [n]带镜小粉盒;合约,条约; [^]sat;
comparable: [-]/ˈkɑːmpərəbl/; [a]类似的,比得上的,可比较的; [^]sat;
compatible: [-]/kəmˈpætəbl/; [a]可和谐共存的;兼容的; [^]sat;
compelling: [-]/kəmˈpelɪŋ/; [a]引人注目的;紧迫的;令人信服的; [^]sat;
compensatory: [-]/kəmˈpensətɔːri/; [a]补偿的,赔偿的; [^]sat;
compile: [-]/kəmˈpaɪl/; [v]收集,汇编; [^]sat;
complacency: [-]/kəmˈpleɪsnsi/; [n]自满,自鸣得意;满足; [^]sat;
complaisant: [-]/kəmˈpleɪzənt/; [a]彬彬有礼的,殷勤的,柔顺的; [^]sat;
complement: [-]/ˈkɑːmplɪment/; [v]补充;与.相配; [n]补充;互为补充的东西;补语; [^]sat;
complementary: [-]/ˌkɑːmplɪˈmentri/; [a]补足的,补充的,互补的; [^]sat;
compliance: [-]/kəmˈplaɪəns/; [n]遵守,依从;承诺,答应; [^]sat;
compliant: [-]/kəmˈplaɪənt/; [a]顺从的,服从的,应允的; [^]sat;
complicity: [-]/kəmˈplɪsəti/; [n]同谋关系,共犯关系; [^]sat;
component: [-]/kəmˈpoʊnənt/; [n]零件; [a]组成的; [^]sat;
composure: [-]/kəmˈpoʊʒər/; [n]镇静,沉着; [^]sat;
compound: [-]/ˈkɑːmpaʊnd/; [n]复合物;<化学>化合物; [a]合成的;复合的;多功能的; [vi]妥协;和解; [vt]混合;调和;调停;使恶化; [^]sat;
comprehensive: [-]/ˌkɑːmprɪˈhensɪv/; [a]综合的;有充分理解力的,悟性好的;全面的,完整的;详尽的;广泛的,无所不包的;广义的; [n]综合测验;综合学校; [^]sat;
compress: [-]/kəmˈpres/; [v]压紧,压缩,压榨; [^]sat;
comprise: [-]/kəmˈpraɪz/; [v]包含,包括;构成; [^]sat;
compromise: [-]/ˈkɑːmprəmaɪz/; [n]妥协;折中; [v]妥协;使遭受危害; [^]sat;
compunction: [-]/kəmˈpʌŋkʃn/; [n]懊悔,良心不安; [^]sat;
compute: [-]/kəmˈpjuːt/; [v]计算,估计; [^]sat;
concave: [-]/kɑːnˈkeɪv/; [a]凹面的; [n]凹面; [vt]使成凹形; [^]sat;
concede: [-]/kənˈsiːd/; [v]承认;承认失败;让给,让与;让步; [^]sat;
conceit: [-]/kənˈsiːt/; [n]自负;狂妄;想法,观点;构想,幻想; [^]sat;
concentric: [-]/kənˈsentrɪk/; [a]同中心的; [ad]同一中心地;同轴地; [^]sat;
conception: [-]/kənˈsepʃn/; [n]怀孕,构想,设想,思想,观念; [^]sat;
concerted: [-]/kənˈsɜːrtɪd/; [a]一致的,商定的; [^]sat;
concession: [-]/kənˈseʃn/; [n]让步;特许,特许权;承认; [^]sat;
concise: [-]/kənˈsaɪs/; [a]简明的,简要的;简洁的,简要的; [^]sat;
contrived: [-]/kənˈtraɪvd/; [a]人为的;做作的;不自然的; [^]sat;
conundrum: [-]/kəˈnʌndrəm/; [n](答案有双关意义的)谜语;机智问答;难题; [^]sat;
convene: [-]/kənˈviːn/; [v]集合,召集,召唤; [^]sat;
convention: [-]/kənˈvenʃn/; [n]会议;习俗;惯例; [^]sat;
conventional: [-]/kənˈvenʃənl/; [a]普通的,常规的;依照惯例的,依照传统的; [^]sat;
converge: [-]/kənˈvɜːrdʒ/; [v](向某一点)相交,会合;汇集,聚集,集中; [^]sat;
conversant: [-]/kənˈvɜːrsnt/; [a]熟悉的;精通的;亲近的; [^]sat;
converse: [-]/kənˈvɜːrs/; [v]交谈; [a]相反的,颠倒的; [n]相反的事物; [^]sat;
convert: [-]/kənˈvɜːrt/; [v]可转变为,可变换成;改变,转变,转化;使改变信仰; [n]皈依者;改变宗教信仰者; [^]sat;
convex: [-]/ˈkɑːnveks/; [a]中凸的;凸圆的;凸面的; [n]凸面体;凸状; [^]sat;
conveyance: [-]/kənˈveɪəns/; [n]运输;运输工具;财产让与; [^]sat;
conviction: [-]/kənˈvɪkʃn/; [n]定罪;信服;坚强信念; [^]sat;
convivial: [-]/kənˈvɪviəl/; [a]欢乐的;欢宴的;酒宴的; [^]sat;
convoke: [-]/kənˈvoʊk/; [v]召集会议; [^]sat;
convoluted: [-]/ˈkɑːnvəluːtɪd/; [a]旋绕的,费解的; [^]sat;
copious: [-]/ˈkoʊpiəs/; [a]丰富的,多产的; [^]sat;
coquette: [-]/koʊˈket/; [n]调情的女子; [v]不认真对待; [^]sat;
cordial: [-]/ˈkɔːrdʒəl/; [a]热情友好的,衷心的; [^]sat;
cordon: [-]/ˈkɔːrdn/; [n]哨兵线,警戒线;饰带; [v]布设警戒线;封锁交通; [^]sat;
cornucopia: [-]/ˌkɔːrnjuˈkoʊpiə/; [n]象征丰收的羊角;装满花果及谷穗表丰饶的羊角状物;丰饶的象征; [^]sat;
corollary: [-]/ˈkɔːrəleri/; [n]推论;必然的结果; [^]sat;
coronation: [-]/ˌkɔːrəˈneɪʃn/; [n]加冕,加冕礼; [^]sat;
corporeal: [-]/kɔːrˈpɔːriəl/; [a]物质的,有形的,肉体的; [^]sat;
corpulent: [-]/ˈkɔːrpjələnt/; [a]肥胖的; [^]sat;
correlation: [-]/ˌkɔːrəˈleɪʃn/; [n]相互关系,相关(性); [^]sat;
corroborate: [-]/kəˈrɑːbəreɪt/; [v]支持或证实,强化; [n]确证者,证物; [^]sat;
corrode: [-]/kəˈroʊd/; [v]受腐蚀;腐蚀,侵蚀; [^]sat;
corrosive: [-]/kəˈroʊsɪv/; [a]腐蚀的;腐蚀性的;蚀坏的; [n]腐蚀剂; [^]sat;
corrugated: [-]/ˈkɔːrəɡeɪtɪd/; [a]褶皱的; [^]sat;
cosmic: [-]/ˈkɑːzmɪk/; [a]宇宙的;广大无边的; [^]sat;
cosmopolitan: [-]/ˌkɑːzməˈpɑːlɪtən/; [n]游历四方的人; [a]见多识广的;多元的;广泛分布的; [^]sat;
countenance: [-]/ˈkaʊntənəns/; [n]面容,表情,气色; [v]支持,赞成; [^]sat;
countermand: [-]/ˈkaʊntərmænd/; [vt]撤回,取消; [^]sat;
cumbersome: [-]/ˈkʌmbərsəm/; [a]笨重的;麻烦的; [^]sat;
cumulative: [-]/ˈkjuːmjəleɪtɪv/; [a]渐增的;累积的; [^]sat;
cupidity: [-]/kjuːˈpɪdəti/; [n]贪婪; [^]sat;
curator: [-]/kjʊˈreɪtər/; [n]馆长;监护人;管理者; [^]sat;
curmudgeon: [-]/kɜːrˈmʌdʒən/; [n]脾气暴躁之人; [^]sat;
cursive: [-]/ˈkɜːrsɪv/; [n]草书;草书原稿; [a]草书的;草书体的; [^]sat;
cursory: [-]/ˈkɜːrsəri/; [a]匆忙的,不注意细节的;草率地;粗略地; [^]sat;
curtail: [-]/kɜːrˈteɪl/; [vt]截短;削减;剥夺.特权; [^]sat;
cynical: [-]/ˈsɪnɪkl/; [a]愤世嫉俗的;恶意的;悲观的; [^]sat;
dabble: [-]/ˈdæbl/; [v]涉足;浅赏,溅湿;浸入水中; [^]sat;
dais: [-]/ˈdeɪɪs/; [n]主席台,嘉宾席; [^]sat;
dank: [-]/dæŋk/; [a]潮湿的,阴湿的;透水的; [^]sat;
dapper: [-]/ˈdæpər/; [a]干净利落的,衣冠楚楚的; [^]sat;
dappled: [-]/ˈdæpld/; [a]有斑点的,斑驳的; [^]sat;
daub: [-]/dɔːb/; [v]涂抹,乱画; [n]涂抹,涂料,拙劣的画; [^]sat;
daunt: [-]/dɔːnt/; [v]使气馁,使畏缩,威吓; [^]sat;
dauntless: [-]/ˈdɔːntləs/; [a]勇敢的,无畏的;不屈不挠的; [^]sat;
dawdle: [-]/ˈdɔːdl/; [v]闲荡,浪费时间; [^]sat;
deadlock: [-]/ˈdedlɑːk/; [vt](使)相持不下; [vi]僵持; [n]僵局;不分胜负; [^]sat;
deadpan: [-]/ˈdedpæn/; [a]面无表情的; [ad]面无表情地; [^]sat;
dearth: [-]/dɜːrθ/; [n]缺乏,供应不足; [^]sat;
debacle: [-]/dɪˈbɑːkl/; [n]解冻,崩溃;灾害; [^]sat;
debase: [-]/dɪˈbeɪs/; [v]贬值,降低; [^]sat;
debauch: [-]/dɪ'bɔːtʃ/; [v]诱骗;使堕落; [n]放荡; [^]sat;
debilitate: [-]/dɪˈbɪlɪteɪt/; [v]使衰弱; [^]sat;
debonair: [-]/ˌdebəˈner/; [a]温文尔雅的; [^]sat;
debris: [-]/dəˈbriː/; [n]废墟,残骸; [^]sat;
debunk: [-]/ˌdiːˈbʌŋk/; [v]揭穿真面目,证明为假; [^]sat;
decadence: [-]/ˈdekədəns/; [n]堕落,颓废;衰落; [^]sat;
decapitate: [-]/dɪˈkæpɪteɪt/; [vt]将.斩首;把.强行解雇;使无效; [n]斩首,杀头;刽子手; [^]sat;
decelerate: [-]/ˌdiːˈseləreɪt/; [v](使)减速; [^]sat;
deciduous: [-]/dɪˈsɪdʒuəs/; [a]落叶性的,脱落性的;非永久性的; [^]sat;
decimate: [-]/ˈdesɪmeɪt/; [v]大量杀死,十中抽一,大量毁灭; [^]sat;
decipher: [-]/dɪˈsaɪfər/; [n]密电译文; [vt]解释;破译; [^]sat;
declivity: [-]/dɪ'klɪvətɪ/; [n]下坡;倾斜; [^]sat;
decomposition: [-]/ˌdiːkɑːmpəˈzɪʃn/; [n]腐败,腐烂;分解; [^]sat;
decorum: [-]/dɪˈkɔːrəm/; [n]礼节,礼貌,端庄,正派; [^]sat;
decoy: [-]/dɪˈkɔɪ/; [n]诱饵;诱骗; [v]诱骗; [^]sat;
decrepit: [-]/dɪˈkrepɪt/; [a]衰老的,破旧的; [^]sat;
decrepitude: [-]/dɪˈkrepɪtuːd/; [n]衰老,破旧; [^]sat;
decry: [-]/dɪˈkraɪ/; [v]谴责,责难,诽谤; [^]sat;
deducible: [-]/dɪˈduːsəbl/; [a]可推论的; [^]sat;
deface: [-]/dɪˈfeɪs/; [v]损伤外观,丑化; [^]sat;
defame: [-]/dɪˈfeɪm/; [v]诽谤,中伤; [^]sat;
default: [-]/dɪˈfɔːlt/; [n]违约;缺席;缺乏;默认; [vi]不履行义务;拖欠; [vt]不履行;不参加; [^]sat;
defer: [-]/dɪˈfɜːr/; [v]使推迟,使延期;听从,顺从; [vi]延期; [^]sat;
deference: [-]/ˈdefərəns/; [n]尊敬,尊重;顺从; [^]sat;
defiance: [-]/dɪˈfaɪəns/; [n]蔑视;反抗;挑战; [^]sat;
defile: [-]/dɪˈfaɪl/; [v]污损,弄脏;以纵队前进; [n]狭谷;隘路; [^]sat;
definitive: [-]/dɪˈfɪnətɪv/; [a]可靠的,明确的,权威的;决定性的; [^]sat;
deflect: [-]/dɪˈflekt/; [v](使)偏斜,(使)偏转; [^]sat;
defoliate: [-]/ˌdiːˈfoʊlieɪt/; [v]落叶; [a]〈罕〉落了叶的; [^]sat;
defray: [-]/dɪˈfreɪ/; [v]支出;支付; [^]sat;
deft: [-]/deft/; [a]灵巧的,敏捷的,熟练的; [^]sat;
defunct: [-]/dɪˈfʌŋkt/; [a]已故的,不复存在的;不再使用的; [^]sat;
defuse: [-]/ˌdiːˈfjuːz/; [vi]平息,变弱; [vt]拆除;使消除危险性,平息; [^]sat;
degenerate: [-]/dɪˈdʒenəreɪt/; [v]堕落,衰减; [a]腐化的,颓废的,退化的;变质的; [n]堕落者; [^]sat;
degradation: [-]/ˌdeɡrəˈdeɪʃn/; [n]降级,降格;退化;恶化; [^]sat;
dehydrate: [-]/diːˈhaɪdreɪt/; [v]除去水份,脱水; [^]sat;
deify: [-]/ˈdeɪɪfaɪ/; [v]奉为神;崇拜; [^]sat;
deign: [-]/deɪn/; [v]屈尊,惠允(做某事); [^]sat;
delectable: [-]/dɪˈlektəbl/; [a]令人愉快的;美味的; [^]sat;
delete: [-]/dɪˈliːt/; [v]删除; [^]sat;
deleterious: [-]/ˌdeləˈtɪriəs/; [a]有害的;有毒的; [^]sat;
deliberate: [-]/dɪˈlɪbərət/; [a]故意的;深思熟虑的;从容不迫的; [v]仔细考虑;研讨; [^]sat;
delineate: [-]/dɪˈlɪnieɪt/; [v]描画;画出..轮廓; [^]sat;
delirium: [-]/dɪˈlɪriəm/; [n]神志不清,极度兴奋; [^]sat;
delude: [-]/dɪˈluːd/; [v]欺骗,哄骗; [^]sat;
deluge: [-]/ˈdeljuːdʒ/; [n]洪水;暴雨;泛滥; [v]使泛滥;压倒; [^]sat;
delusion: [-]/dɪˈluːʒn/; [n]错觉; [^]sat;
delve: [-]/delv/; [v]钻研;探究;挖; [n]穴;洞; [^]sat;
demagogue: [-]/ˈdeməɡɑːɡ/; [n]煽动者; [^]sat;
demean: [-]/dɪˈmiːn/; [v]贬抑,降低; [^]sat;
demeanor: [-]/dɪ'miːnə/; [n]举止,行为,风度; [^]sat;
demented: [-]/dɪˈmentɪd/; [a]发狂的,精神错乱的; [v]精神错乱;变得痴呆; [^]sat;
demise: [-]/dɪˈmaɪz/; [n]死亡,终结; [^]sat;
demolition: [-]/ˌdeməˈlɪʃn/; [n]拆除(等于demolishment);破坏,毁坏; [^]sat;
demoniac: [-]/dɪˈmoʊnɪæk/; [n]着魔的人; [a]魔鬼的;着魔的; [^]sat;
demur: [-]/dɪˈmɜːr/; [n]异议; [v]异议,反对,拒绝; [^]sat;
demure: [-]/dɪˈmjʊr/; [a]严肃的;端庄的,娴静的;假装正直的; [^]sat;
denigrate: [-]/ˈdenɪɡreɪt/; [v]抹黑,贬低; [^]sat;
denizen: [-]/ˈdenɪzn/; [n]居民,外籍居民; [^]sat;
denouement: [-]/ˌdeɪnuːˈmɑ̃ː/; [n]结局,终场; [^]sat;
denounce: [-]/dɪˈnaʊns/; [v]谴责,斥责; [^]sat;
depict: [-]/dɪˈpɪkt/; [v]描绘,描写; [^]sat;
deplete: [-]/dɪˈpliːt/; [v]使大大减少;耗尽,用尽; [^]sat;
deplore: [-]/dɪˈplɔːr/; [v]谴责;对...深感遗憾;悲悼;痛惜; [^]sat;
deploy: [-]/dɪˈplɔɪ/; [v]部署,设置;展开,散开; [^]sat;
depose: [-]/dɪˈpoʊz/; [v]免职,废黜,作证; [^]sat;
deposition: [-]/ˌdepəˈzɪʃn/; [n]证言,沉积物,矿床,革职; [^]sat;
depravity: [-]/dɪˈprævəti/; [n][n]恶劣行为;堕落,腐败,邪恶;腐败;邪恶;恶劣行为,腐化堕落的行为; [^]sat;
deprecate: [-]/ˈdeprəkeɪt/; [v]反对;轻视; [^]sat;
depreciate: [-]/dɪˈpriːʃieɪt/; [v]贬低,轻视;贬值;折旧; [^]sat;
depredation: [-]/ˌdeprəˈdeɪʃn/; [n]掠夺,破坏; [^]sat;
deranged: [-]/dɪˈreɪndʒd/; [a]不理智;疯狂的; [^]sat;
derelict: [-]/ˈderəlɪkt/; [a]渎职的,荒废的,被弃置的; [n]失业贫穷的无家可归者; [^]sat;
deride: [-]/dɪˈraɪd/; [v]嘲弄,愚弄; [^]sat;
derivative: [-]/dɪˈrɪvətɪv/; [n]派生物;<化学>衍生物; [a]被引申出的,被诱导的;衍生的;第二手的; [^]sat;
dermatologist: [-]/ˌdɜːrməˈtɑːlədʒɪst/; [n]皮肤科; [^]sat;
derogatory: [-]/dɪˈrɑːɡətɔːri/; [a]不敬的,诽谤的; [^]sat;
descry: [-]/dɪˈskraɪ/; [v]远远看到,望见; [^]sat;
desecrate: [-]/ˈdesɪkreɪt/; [v]亵渎,玷污; [^]sat;
desiccate: [-]/'desɪˌkeɪt/; [v](使)完全干涸,脱水; [^]sat;
desolate: [-]/ˈdesələt/; [a]荒凉的;孤单寂寞的; [^]sat;
despise: [-]/dɪˈspaɪz/; [vt]轻视,蔑视,看不起; [^]sat;
despoil: [-]/dɪˈspɔɪl/; [v]掠夺,剥夺;夺取; [^]sat;
despondent: [-]/dɪˈspɑːndənt/; [a]失望的,意气消沉的,没有精神的; [^]sat;
despot: [-]/ˈdespɑːt/; [n]专制君主,暴君;独裁者; [^]sat;
destitute: [-]/ˈdestɪtuːt/; [a]贫穷的,缺乏的; [^]sat;
desultory: [-]/ˈdesəltɔːri/; [a]散漫的,无目的的,断断续续的; [^]sat;
detached: [-]/dɪˈtætʃt/; [a]孤立的,分开的,超然公平的; [^]sat;
detergent: [-]/dɪˈtɜːrdʒənt/; [n]洗涤剂,清洁剂; [^]sat;
determination: [-]/dɪˌtɜːrmɪˈneɪʃn/; [n]决定;确定;决心; [^]sat;
deterrent: [-]/dɪˈtɜːrənt/; [n]威慑物; [v]威慑的; [^]sat;
detonation: [-]/ˌdetəˈneɪʃn/; [n]爆炸;爆炸声;爆发; [^]sat;
detrimental: [-]/ˌdetrɪˈmentl/; [a]有害的,不利的; [^]sat;
deviate: [-]/ˈdiːvieɪt/; [v]偏离;背离; [a]脱离常轨的; [n]脱离常轨的人; [^]sat;
devious: [-]/ˈdiːviəs/; [a]迂回弯曲的,狡猾的; [^]sat;
devise: [-]/dɪˈvaɪz/; [v]设计,想出;密谋;遗赠(不动产); [n]设计,发明,遗赠; [^]sat;
devoid: [-]/dɪˈvɔɪd/; [a]全无的,缺乏的; [^]sat;
devotee: [-]/ˌdevəˈtiː/; [n]爱好者;信徒; [^]sat;
devout: [-]/dɪˈvaʊt/; [a]虔诚的,真挚的,诚恳的; [n]虔诚;真挚,诚恳; [^]sat;
dexterous: [-]/ˈdekstrəs/; [a]灵巧的,熟练的; [^]sat;
diabolical: [-]/ˌdaɪəˈbɑːlɪkl/; [a]恶毒的,狠毒的; [^]sat;
diagnosis: [-]/ˌdaɪəɡˈnoʊsɪs/; [n]诊断; [^]sat;
discomfit: [-]/dɪsˈkʌmfɪt/; [v]挫败,扰乱,破坏,使.为难; [^]sat;
discomposure: [-]/ˌdɪskəmˈpoʊʒər/; [n]不安,心乱,狼狈; [^]sat;
disconcert: [-]/ˌdɪskənˈsɜːrt/; [v]使仓皇失措;使困惑;破坏; [^]sat;
disconsolate: [-]/dɪsˈkɑːnsələt/; [a]郁郁不乐的,孤独的,前途黯淡的; [^]sat;
discord: [-]/ˈdɪskɔːrd/; [n]不和,争吵;(声音)不和谐; [^]sat;
discordant: [-]/dɪsˈkɔːrdənt/; [a]不和谐的,刺耳的,不一致的; [^]sat;
discount: [-]/ˈdɪskaʊnt/; [n](价格,债款等)折扣; [v]打折扣,不全信,怀疑地看待; [^]sat;
discourse: [-]/ˈdɪskɔːrs/; [n]交谈,演讲,论述,讲道; [v]演讲,谈论; [^]sat;
discredit: [-]/dɪsˈkredɪt/; [v]使不相信,使怀疑;败坏.的名声; [n]丧失信誉,丧失名誉;败坏名声的人或事,耻辱; [^]sat;
discrepancy: [-]/dɪsˈkrepənsi/; [n]不一致,差异,不符; [^]sat;
discrete: [-]/dɪˈskriːt/; [a]分开的;不连续的; [^]sat;
discretion: [-]/dɪˈskreʃn/; [n]自由裁量权;谨慎;判断力;判定;考虑周到; [^]sat;
discursive: [-]/dɪsˈkɜːrsɪv/; [a](谈话内容)杂乱的,东拉西扯的,无层次的; [^]sat;
disdain: [-]/dɪsˈdeɪn/; [n]蔑视,鄙视; [vt]鄙视;不屑; [^]sat;
disembark: [-]/ˌdɪsɪmˈbɑːrk/; [vi]上岸,登陆,下车,下飞机; [vt]使上岸;使登陆; [^]sat;
disengage: [-]/ˌdɪsɪnˈɡeɪdʒ/; [v]分开; [^]sat;
disfigure: [-]/dɪsˈfɪɡjər/; [v]损伤外貌,使变丑; [^]sat;
disgorge: [-]/dɪsˈɡɔːrdʒ/; [v]涌出,流出;吐出; [^]sat;
dishearten: [-]/dɪsˈhɑːrtn/; [v]使灰心,使沮丧; [^]sat;
disheveled: [-]/dɪ'ʃevəld/; [a]不整洁的;凌乱的; [v]使(头发等)蓬松; [^]sat;
disinclination: [-]/ˌdɪsˌɪnklɪˈneɪʃn/; [n]不感兴趣,厌恶; [^]sat;
disinter: [-]/ˌdɪsɪnˈtɜːr/; [v]掘出;发掘;显露; [^]sat;
disinterested: [-]/dɪsˈɪntrəstɪd/; [a]公正的;不感兴趣的;无私的;廉洁的; [^]sat;
disjointed: [-]/dɪsˈdʒɔɪntɪd/; [a]杂乱的,无逻辑的,脱节的; [^]sat;
dislodge: [-]/dɪsˈlɑːdʒ/; [v]驱逐;移去;取出; [^]sat;
dismantle: [-]/dɪsˈmæntl/; [v]拆开;拆除; [^]sat;
dismay: [-]/dɪsˈmeɪ/; [n]失望;沮丧;惊愕; [v]使惊恐; [^]sat;
dismember: [-]/dɪsˈmembər/; [v]肢解;瓜分; [^]sat;
dismiss: [-]/dɪsˈmɪs/; [v]开除;解散;摒除,不再考虑; [^]sat;
disparage: [-]/dɪˈspærɪdʒ/; [v]蔑视;贬损; [^]sat;
disparate: [-]/ˈdɪspərət/; [a]迥然不同的; [^]sat;
disparity: [-]/dɪˈspærəti/; [n]不同,不一致,不等; [^]sat;
dispassionate: [-]/dɪsˈpæʃənət/; [a]平心静气的,不带感情的; [^]sat;
dispatch: [-]/dɪˈspætʃ/; [v]派遣,调遣;发送(信件,电报等);结束,摆脱掉;匆匆办完; [vt]处决; [n]派遣,调遣;发送;快信,急件;迅速,敏捷; [^]sat;
dispel: [-]/dɪˈspel/; [v]驱散,驱逐;消除(烦恼等); [^]sat;
disperse: [-]/dɪˈspɜːrs/; [v]使散开;分散,散开; [^]sat;
dispirited: [-]/dɪˈspɪrɪtɪd/; [a]沮丧的;消沉的;情绪低落的;灰心的; [^]sat;
disputatious: [-]/ˌdɪspjʊ'teɪʃəs/; [a]好争辩的; [^]sat;
disquiet: [-]/dɪsˈkwaɪət/; [n]担心,焦虑; [v]使不安,使忧虑; [^]sat;
dissemble: [-]/dɪˈsembl/; [v]掩饰;假装;隐藏,掩饰; [^]sat;
disseminate: [-]/dɪˈsemɪneɪt/; [v]宣传,传播;散布; [^]sat;
dissent: [-]/dɪˈsent/; [v]不同意;不信奉国教; [n]异议;(大写)不信奉国教; [^]sat;
dissertation: [-]/ˌdɪsərˈteɪʃn/; [n](博士学位)论文;学术演讲;专题; [^]sat;
dissident: [-]/ˈdɪsɪdənt/; [n]唱反调者;持不同政见者,意见不同的人; [a]持不同政见的,意见不同的; [^]sat;
dissipate: [-]/ˈdɪsɪpeɪt/; [v]消散,消失;浪费; [^]sat;
dissolute: [-]/ˈdɪsəluːt/; [a]无节制的;放荡的; [^]sat;
dissolution: [-]/ˌdɪsəˈluːʃn/; [n](婚姻,组织,议会等的) 解散;毁灭,消失; [^]sat;
dissonance: [-]/ˈdɪsənəns/; [n]不一致;不调和;不和谐音; [^]sat;
dissuade: [-]/dɪˈsweɪd/; [v]劝阻,阻止; [^]sat;
distant: [-]/ˈdɪstənt/; [a]遥远的;远方的;疏远的; [^]sat;
distend: [-]/dɪˈstend/; [v]膨胀;胀大;扩张; [^]sat;
distill: [-]/dɪˈstɪl/; [v]抽出..的精华;蒸馏; [^]sat;
distinction: [-]/dɪˈstɪŋkʃn/; [n]差别,区分;优秀,卓越,杰出;特性,独特,不同凡响;优等评分,荣誉分数,殊荣; [^]sat;
distort: [-]/dɪˈstɔːrt/; [v]扭曲,使变形;歪曲,曲解; [^]sat;
distraught: [-]/dɪˈstrɔːt/; [a]发狂的;心烦意乱的; [^]sat;
diurnal: [-]/daɪˈɜːrnl/; [a]白天的;每日的;日间活动的; [^]sat;
diva: [-]/ˈdiːvə/; [n]著名女歌唱家,歌剧女主角; [^]sat;
diverge: [-]/daɪˈvɜːrdʒ/; [v]分歧,分开; [^]sat;
divergent: [-]/daɪˈvɜːrdʒənt/; [a]叉开的;分歧的; [^]sat;
diverse: [-]/daɪˈvɜːrs/; [a]不同的,差异的,多种多样的; [^]sat;
diversion: [-]/daɪˈvɜːrʒn/; [n]绕行路;转移,改变方向;分心,消遣;分水渠; [^]sat;
diversity: [-]/daɪˈvɜːrsəti/; [n]多样性,差异,分集; [^]sat;
divest: [-]/daɪˈvest/; [v]剥夺;使脱去;迫使放弃; [^]sat;
divine: [-]/dɪˈvaɪn/; [a]神的,神圣的;极好的; [v](凭直觉)发现,猜到; [n]神学家;圣职人员;教士;上帝; [^]sat;
divulge: [-]/daɪˈvʌldʒ/; [v]泄露,透露; [^]sat;
docile: [-]/ˈdɑːsl/; [a]驯服的,温顺的; [^]sat;
doctrinaire: [-]/ˌdɑːktrəˈner/; [a]教条主义的,空谈理论的; [n]空论家,纯理论家; [^]sat;
doctrine: [-]/ˈdɑːktrɪn/; [n]教条,学说,信条,原则; [^]sat;
document: [-]/ˈdɑːkjumənt/; [n]文件,公文;(计算机的)文档; [v]记录;证明; [^]sat;
doff: [-]/dɑːf/; [v]脱掉(外衣,帽子); [^]sat;
dogged: [-]/ˈdɔːɡɪd/; [a]顽强的;顽固的; [vt]跟踪;尾随; [^]sat;
doggerel: [-]/ˈdɔːɡərəl/; [n]糟糕的诗歌; [^]sat;
dogmatic: [-]/dɔːɡˈmætɪk/; [a]教条的,武断的; [^]sat;
doldrums: [-]/ˈdoʊldrəmz/; [n](海洋上的)无风带,情绪低沉; [^]sat;
doleful: [-]/ˈdoʊlfl/; [a]寂寞的;悲哀的;阴沉的; [^]sat;
dolt: [-]/doʊlt/; [n]笨蛋,傻瓜; [^]sat;
domicile: [-]/ˈdɑːmɪsaɪl/; [n]住宅;永久居住地;期票支付场所; [v]居住;使在指定的场所支付(期票等; [a]定居;在固定住所生活; [^]sat;
don: [-]/dɑːn/; [n]指导教师,大学教师;先生,阁下; [vt]穿上; [^]sat;
doodle: [-]/ˈduːdl/; [v](无目的地)乱画,漫无目的地打发时光; [n]涂鸦; [^]sat;
dormant: [-]/ˈdɔːrmənt/; [a]睡眠的,休眠的;静止的,隐伏的; [^]sat;
dossier: [-]/ˈdɔːsieɪ/; [n]档案,卷宗;病历表册; [^]sat;
dote: [-]/doʊt/; [v]溺爱;昏愦; [^]sat;
douse: [-]/daʊs/; [v]把.浸入水中,用水泼; [^]sat;
dowdy: [-]/ˈdaʊdi/; [a]懒散的,过时的,寒酸的; [n]邋遢女人; [^]sat;
downcast: [-]/ˈdaʊnkæst/; [a]意志消沉的,垂头丧气的,朝下的; [n]没落;俯视;<地>下落;<矿>通风井; [^]sat;
drab: [-]/dræb/; [a]枯黄色的,无聊的,单调的; [n]单调;淡褐色;[印,纺]淡褐色厚呢;邋遢女人; [^]sat;
draconian: [-]/drəˈkoʊniən/; [a]严峻的,苛刻的; [^]sat;
dregs: [-]/dreɡz/; [n]渣滓;少量;沉淀物; [^]sat;
drivel: [-]/ˈdrɪvl/; [n]胡言乱语; [v]胡言乱语,说傻话; [^]sat;
droll: [-]/droʊl/; [a]滑稽的;好笑的;逗趣的; [n]逗人发笑的人;滑稽演员;小丑; [v]开玩笑; [ad]古里古怪地,滑稽地; [^]sat;
drone: [-]/droʊn/; [n]无人机,无人驾驶飞机;雄蜂;单调的低音; [v]嗡嗡地响; [vi]混日子; [^]sat;
dross: [-]/drɔːs/; [n]废料,浮渣,渣滓; [vt]除去.上的浮渣; [^]sat;
drudgery: [-]/ˈdrʌdʒəri/; [n]苦工;苦差事;单调乏味的工作; [^]sat;
dubious: [-]/ˈduːbiəs/; [a]可疑的;怀疑的;无把握的; [^]sat;
ductile: [-]/ˈdʌktaɪl/; [a](某些金属)有延展性的;可塑的;易受影响的; [^]sat;
dulcet: [-]/ˈdʌlsɪt/; [a]美妙的;悦耳的;怡人的; [^]sat;
dupe: [-]/duːp/; [n]受骗的人,上当者; [v]欺骗,愚弄; [^]sat;
duplicity: [-]/duːˈplɪsəti/; [n]口是心非;表里不一;不诚实; [^]sat;
duration: [-]/duˈreɪʃn/; [n]持续;持续期间;持续的时间; [^]sat;
dutiful: [-]/ˈduːtɪfl/; [a]顺从的,尽职的;有责任心的; [^]sat;
dwarf: [-]/dwɔːrf/; [n]侏儒; [v]变矮;发育不全; [a]矮生动物或植物的;矮小的;发育不全的; [vt]使矮小;阻碍.的发育; [^]sat;
dwindle: [-]/ˈdwɪndl/; [v]日渐减少,变小,缩小; [^]sat;
dynamic: [-]/daɪˈnæmɪk/; [a]有活力的,有生气的;不断变化的;动态的; [n]活力,动力; [^]sat;
ebb: [-]/eb/; [n]退潮;退潮期;衰退; [v]退潮;衰退; [^]sat;
ebullient: [-]/ɪˈbʌliənt/; [a]热情洋溢的,沸腾的; [^]sat;
eccentricity: [-]/ˌeksenˈtrɪsəti/; [n]古怪;怪癖;<数>离心率; [^]sat;
eclectic: [-]/ɪˈklektɪk/; [a]折衷主义的;选择的; [n]折衷主义者,折衷派的人; [^]sat;
eclipse: [-]/ɪˈklɪps/; [n](日,月)食;黯然失色; [v]掩盖..的重要性;使暗淡; [^]sat;
ecologist: [-]/iˈkɑːlədʒɪst/; [n]生态学家,生态学者; [^]sat;
economy: [-]/ɪˈkɑːnəmi/; [n]经济,经济制度;节约; [^]sat;
ecstasy: [-]/ˈekstəsi/; [n]狂喜,心醉神怡; [^]sat;
eddy: [-]/ˈedi/; [n]漩涡; [v]旋转;起漩涡; [^]sat;
edict: [-]/ˈiːdɪkt/; [n]法令,布告; [^]sat;
edify: [-]/ˈedɪfaɪ/; [vt]教诲,启发,熏陶; [^]sat;
eerie: [-]/ˈɪri/; [a]胆怯的,引起恐惧的; [^]sat;
efface: [-]/ɪˈfeɪs/; [v]擦掉,抹去;消去; [^]sat;
efficacy: [-]/ˈefɪkəsi/; [n]功效,效力; [^]sat;
effigy: [-]/ˈefɪdʒi/; [n]肖像,模拟像; [^]sat;
effrontery: [-]/ɪˈfrʌntəri/; [n]厚颜无耻; [^]sat;
effusive: [-]/ɪˈfjuːsɪv/; [a]流出的;感情奔放的; [^]sat;
egregious: [-]/ɪˈɡriːdʒiəs/; [a]非常恶劣的,过分的;恶名昭彰的;惊人的; [^]sat;
egress: [-]/ˈiːɡres/; [n]出去,出口; [^]sat;
elated: [-]/iˈleɪtɪd/; [a]得意洋洋的;振奋的; [^]sat;
elegy: [-]/ˈelədʒi/; [n]挽歌,哀歌; [^]sat;
elicit: [-]/iˈlɪsɪt/; [v]引出;诱出;探出; [^]sat;
elixir: [-]/ɪˈlɪksər/; [n]不老长寿药;万能药;炼金药; [^]sat;
ellipsis: [-]/ɪˈlɪpsɪs/; [n]省略,省略符号; [^]sat;
elliptical: [-]/ɪˈlɪptɪkl/; [a]椭圆的;省略的; [^]sat;
eloquence: [-]/ˈeləkwəns/; [n]雄辩,口才;文采; [^]sat;
elucidate: [-]/iˈluːsɪdeɪt/; [v]阐明,说明; [^]sat;
elusive: [-]/iˈluːsɪv/; [a]难懂的;难捉摸的;难找的;难懂的;易忘的;逃避的;难捉摸的; [^]sat;
emaciated: [-]/ɪˈmeɪʃieɪtɪd/; [a]瘦弱的;憔悴的; [^]sat;
emanate: [-]/ˈeməneɪt/; [v]发出;放射; [^]sat;
emancipate: [-]/ɪˈmænsɪpeɪt/; [v]解放;释放; [^]sat;
embargo: [-]/ɪmˈbɑːrɡoʊ/; [v]禁止出入港口;禁止或限制贸易;征用或扣押; [n]禁令;禁止;封港令; [^]sat;
embark: [-]/ɪmˈbɑːrk/; [v]上船或飞机;开始,着手,从事; [^]sat;
embed: [-]/ɪmˈbed/; [v]把.嵌入;使嵌入; [^]sat;
embellish: [-]/ɪmˈbelɪʃ/; [vt]装饰; [v]吹嘘;润色(文章); [vi]装饰起来;加以润色;添加细节,对...添枝加叶; [^]sat;
embezzlement: [-]/ɪmˈbezlmənt/; [n]贪污;侵占;挪用; [^]sat;
embody: [-]/ɪmˈbɑːdi/; [v]包含;体现,象征; [^]sat;
embrace: [-]/ɪmˈbreɪs/; [v]拥抱;包含;欣然接受,乐意采纳; [n]拥抱;接受;领会; [^]sat;
embroider: [-]/ɪmˈbrɔɪdər/; [v]刺绣,绣花;润色,渲染; [^]sat;
embroil: [-]/ɪmˈbrɔɪl/; [v]使卷入;使混乱; [^]sat;
embryonic: [-]/ˌembriˈɑːnɪk/; [a]<生物学>胚胎的;初期的; [^]sat;
eminent: [-]/ˈemɪnənt/; [a]显赫的;杰出的;有名的;(品质)优良的; [^]sat;
emissary: [-]/ˈemɪseri/; [n]代理,信使,使者; [^]sat;
emollient: [-]/iˈmɑːliənt/; [n]润肤剂; [^]sat;
empathy: [-]/ˈempəθi/; [n]共鸣,同感;移情作用; [^]sat;
emulate: [-]/ˈemjuleɪt/; [v]努力赶上(超过),仿效; [n]仿真; [^]sat;
enamored: [-]/ɪˈnæmə(r)d/; [a]迷恋的;倾心的; [^]sat;
enclave: [-]/ˈenkleɪv/; [n]飞地(指在本国境内的隶属另一国的一块领土),被包围的领土,被包围物; [^]sat;
encomium: [-]/enˈkoʊmiəm/; [n]赞美; [^]sat;
encompass: [-]/ɪnˈkʌmpəs/; [vt]环绕,包围;包含;完成; [^]sat;
encumber: [-]/ɪnˈkʌmbər/; [v]阻塞,妨害,拖累; [^]sat;
endemic: [-]/enˈdemɪk/; [a]地方性的; [n]地方病; [^]sat;
endorse: [-]/ɪnˈdɔːrs/; [v]赞同,认可;签注(文件); [^]sat;
enduring: [-]/ɪnˈdʊrɪŋ/; [a]持久的,不朽的;能忍受的; [^]sat;
energize: [-]/ˈenərdʒaɪz/; [v]使活跃;给予精力;使兴奋; [^]sat;
enervate: [-]/ˈenərveɪt/; [v]使虚弱;使无力; [^]sat;
enfranchise: [-]/ɪnˈfræntʃaɪz/; [v]给予选举权,释放(奴隶); [^]sat;
engage: [-]/ɪnˈɡeɪdʒ/; [vt]吸引住(注意力,兴趣);雇,聘; [vi]使加入,使融入;订婚; [v](军队)交战;啮合; [^]sat;
engaging: [-]/ɪnˈɡeɪdʒɪŋ/; [a]迷人的; [^]sat;
engender: [-]/ɪnˈdʒendər/; [v]产生; [^]sat;
engross: [-]/ɪnˈɡroʊs/; [v]独占;正式誊写;使全神贯注于;用大字体书写; [^]sat;
enhance: [-]/ɪnˈhæns/; [v]提高(强度,力量,数量等);增加,加强; [^]sat;
enigma: [-]/ɪˈnɪɡmə/; [n]谜,哑谜;闷葫芦; [^]sat;
enigmatic: [-]/ˌenɪɡˈmætɪk/; [a]神秘的,高深莫测的,谜一般的; [^]sat;
enmity: [-]/ˈenməti/; [n]敌意,憎恨; [^]sat;
enormity: [-]/ɪˈnɔːrməti/; [n]巨大;暴行;极恶; [^]sat;
enrapture: [-]/ɪnˈræptʃər/; [v]使狂喜,使高兴; [^]sat;
ensconce: [-]/ɪnˈskɑːns/; [v]安置;安顿下来;使.隐藏; [^]sat;
ensemble: [-]/ɑːnˈsɑːmbl/; [n]合唱团,表演团体;总效果;全套服装;全套家具; [^]sat;
enterprising: [-]/ˈentərpraɪzɪŋ/; [a]有事业心的,有进取心的,有魅力的,有胆量的;有魄力的; [^]sat;
enthrall: [-]/ɪnˈθrɔl/; [v]迷惑,迷住; [^]sat;
entice: [-]/ɪnˈtaɪs/; [v]怂恿,引诱; [^]sat;
entitlement: [-]/ɪnˈtaɪtlmənt/; [n]权利,津贴; [^]sat;
entomology: [-]/ˌentəˈmɑːlədʒi/; [n]昆虫学; [^]sat;
entourage: [-]/ˈɑːnturɑːʒ/; [n]随从,周围,环境; [^]sat;
entrance: [-]/ˈentrəns/; [n]入口,通道,大门口;出场,登场;进入权; [v]使出神,使入迷; [^]sat;
entreat: [-]/ɪnˈtriːt/; [v]恳求,请求; [^]sat;
entrepreneur: [-]/ˌɑːntrəprəˈnɜːr/; [n]企业家,演出承包人; [^]sat;
enumerate: [-]/ɪˈnuːməreɪt/; [v]列举; [^]sat;
enunciate: [-]/əˈnʌnsieɪt/; [v]发音,阐明,宣布; [^]sat;
ephemeral: [-]/ɪˈfemərəl/; [a]短暂的,短命的; [n]生存极短时间的事物; [^]sat;
epic: [-]/ˈepɪk/; [a]史诗的,叙事诗的;壮丽的,宏大的; [n]史诗;叙事诗;史诗般的作品; [^]sat;
epicure: [-]/ˈepɪkjʊr/; [n]美食家;享乐主义者; [^]sat;
epigram: [-]/ˈepɪɡræm/; [n]机智的言语; [^]sat;
epilogue: [-]/ˈepɪlɔːɡ/; [n]收场白;尾声; [^]sat;
epitaph: [-]/ˈepɪtæf/; [n]碑文,墓志铭; [^]sat;
epithet: [-]/ˈepɪθet/; [n]外号,绰号; [^]sat;
epitome: [-]/ɪˈpɪtəmi/; [n]摘要,缩影; [^]sat;
epoch: [-]/ˈepək/; [n]时期;新时代; [^]sat;
equable: [-]/ˈekwəbl/; [a]温和,平均,稳定的,不变的,(脾气)温和的; [^]sat;
equanimity: [-]/ˌekwəˈnɪməti/; [n]平静,镇定,沉着; [^]sat;
equestrian: [-]/ɪˈkwestriən/; [a]骑马的;骑术的; [n]骑手,马术家; [^]sat;
equilibrium: [-]/ˌiːkwɪˈlɪbriəm/; [n](心态情感等)平静;平衡; [^]sat;
equine: [-]/ˈiːkwaɪn/; [a]马的;似马的;马科的; [n]马;马科动物; [^]sat;
equinox: [-]/ˈiːkwɪnɑːks/; [n]春分;秋分;昼夜平分点; [^]sat;
equitable: [-]/ˈekwɪtəbl/; [a]公正的,公平的; [^]sat;
equity: [-]/ˈekwəti/; [n]公平,公正;衡平法;普通股;抵押资产的净值; [^]sat;
equivocal: [-]/ɪˈkwɪvəkl/; [a]模棱两可的,不明确的,可疑的; [^]sat;
equivocate: [-]/ɪˈkwɪvəkeɪt/; [v]模棱两可地说,支吾其词; [^]sat;
erode: [-]/ɪˈroʊd/; [v]腐蚀;遭侵蚀,腐蚀,侵蚀;削弱; [vt]损害; [^]sat;
erotic: [-]/ɪˈrɑːtɪk/; [a]性爱的,性欲的,色情的; [n]好色之徒; [ad]引起性欲地; [^]sat;
erratic: [-]/ɪˈrætɪk/; [a]古怪的;反复无常的,不稳定的; [^]sat;
erroneous: [-]/ɪˈroʊniəs/; [a]错误的; [^]sat;
erudite: [-]/ˈerudaɪt/; [a]博学的,有学问的; [n]饱学之士,有学问的人; [^]sat;
escapade: [-]/ˌeskəˈpeɪd/; [n]越轨行为,恶作剧; [^]sat;
eschew: [-]/ɪsˈtʃuː/; [v]避开;戒绝; [^]sat;
esoteric: [-]/ˌesəˈterɪk/; [a]秘传的,神秘的,限于少数人的; [n]受秘传的人; [^]sat;
espionage: [-]/ˈespiənɑːʒ/; [n]间谍活动,侦查,监视; [^]sat;
espouse: [-]/ɪˈspaʊz/; [v]支持,拥护; [^]sat;
esteem: [-]/ɪˈstiːm/; [n]尊敬;尊重; [vt]尊敬;认为;考虑;估计; [^]sat;
ethereal: [-]/iˈθɪriəl/; [a]太空的,轻巧的,像空气的; [^]sat;
ethnic: [-]/ˈeθnɪk/; [a]种族的,少数民族的; [n]少数民族成员;人种学; [^]sat;
ethos: [-]/ˈiːθɑːs/; [n]民族精神,气质,社会思潮; [^]sat;
etymology: [-]/ˌetɪˈmɑːlədʒi/; [n]语源,语源学; [^]sat;
eulogy: [-]/ˈjuːlədʒi/; [n]颂词,赞美词; [^]sat;
euphemism: [-]/ˈjuːfəmɪzəm/; [n]婉言,委婉的说法; [^]sat;
euphonious: [-]/juːˈfoʊniəs/; [a]悦耳的;好听的;声音和谐的; [^]sat;
euphoria: [-]/juːˈfɔːriə/; [n]幸福愉快感; [^]sat;
evanescent: [-]/ˌevəˈnesnt/; [a]短暂的,容易消散的,(印象等)逐渐消失的,会凋零的; [^]sat;
evasive: [-]/ɪˈveɪsɪv/; [a]逃避的;托辞的,推托的; [^]sat;
evince: [-]/ɪˈvɪns/; [v]表明,表示,引起; [^]sat;
evocative: [-]/ɪˈvɑːkətɪv/; [a]唤起的;唤出的; [^]sat;
ewe: [-]/juː/; [n]<畜牧>母羊; [^]sat;
exacerbate: [-]/ɪɡˈzæsərbeɪt/; [v]加重;恶化;激怒; [^]sat;
exacting: [-]/ɪɡˈzæktɪŋ/; [a]苛求的,要求严格的,强索的; [^]sat;
exalt: [-]/ɪɡˈzɔːlt/; [v]提升,提拔,赞扬,使得意; [^]sat;
exasperate: [-]/ɪɡˈzæspəreɪt/; [vt]激怒;加剧; [^]sat;
exceptionable: [-]/ɪk'sepʃənəbəl/; [a]引起反感的,可反对的,会引起抗议的; [^]sat;
excerpt: [-]/ˈeksɜːrpt/; [n]摘录,节选; [v]摘,选;引用; [^]sat;
excise: [-]/ˈeksaɪz/; [v]切除,删去; [n]消费税,货物税,国产税; [^]sat;
exclaim: [-]/ɪkˈskleɪm/; [v]呼叫,惊叫; [^]sat;
excoriate: [-]/ˌeksˈkɔːrieɪt/; [v]严厉批评,擦伤(皮肤等); [^]sat;
exculpate: [-]/ˈekskʌlpeɪt/; [v]声明无罪,开脱,使无罪; [^]sat;
execrable: [-]/ˈeksɪkrəbl/; [a]极坏的; [^]sat;
execute: [-]/ˈeksɪkjuːt/; [v]处决;完成(动作);实行;执行(计划); [^]sat;
exemplary: [-]/ɪɡˈzempləri/; [a]模范的,可仿效的; [^]sat;
exemplify: [-]/ɪɡˈzemplɪfaɪ/; [v]举例说明;例示,是..的典范; [^]sat;
exertion: [-]/ɪɡˈzɜːrʃn/; [n]用力;运用; [^]sat;
exhaustive: [-]/ɪɡˈzɔːstɪv/; [a]详尽的;彻底的;消耗的; [^]sat;
exhilarating: [-]/ɪɡˈzɪləreɪtɪŋ/; [a]令人高兴的; [v]使高兴;使兴奋; [^]sat;
exhort: [-]/ɪɡˈzɔːrt/; [vt]敦促,劝告; [vi]规劝,劝告; [^]sat;
exhume: [-]/ɪɡˈzuːm/; [v]发掘,出土; [^]sat;
exigency: [-]/ˈeksɪdʒənsi/; [n]紧急(状态);危急(关头);事变; [^]sat;
exodus: [-]/ˈeksədəs/; [n]大批离去,成群外出; [^]sat;
exonerate: [-]/ɪɡˈzɑːnəreɪt/; [v]使免罪; [^]sat;
exorbitant: [-]/ɪɡˈzɔːrbɪtənt/; [a]要价过高的,过分的; [^]sat;
exorcise: [-]/ˈeksɔːrsaɪz/; [v]驱邪;除怪; [^]sat;
exotic: [-]/ɪɡˈzɑːtɪk/; [a]奇异的,珍奇的,来自异国的; [^]sat;
expansive: [-]/ɪkˈspænsɪv/; [a]广阔的,扩张的,豪爽的; [^]sat;
expatriate: [-]/ˌeksˈpeɪtriət/; [v](使)移居国外;(使)放弃国籍;流放,放逐; [n]被流放者;移居国外者; [a]移居国外的;被流放的; [^]sat;
expedient: [-]/ɪkˈspiːdiənt/; [n]权宜之计,手段; [a]有利的,方便的;权宜之计的; [^]sat;
expedite: [-]/ˈekspədaɪt/; [v]加快;促进;发出; [a]畅通的;迅速的;方便的; [^]sat;
expenditure: [-]/ɪkˈspendɪtʃər/; [n](时间,金钱等的)花费,支出,消耗; [^]sat;
expertise: [-]/ˌekspɜːrˈtiːz/; [n]专门知识,专门技能; [^]sat;
expiate: [-]/ˈekspieɪt/; [v]赎罪,补偿; [^]sat;
expletive: [-]/ˈeksplətɪv/; [n]填补物;咒骂语; [a]附加的;填补的; [^]sat;
explicate: [-]/ˈeksplɪkeɪt/; [v]详细解说; [^]sat;
explicit: [-]/ɪkˈsplɪsɪt/; [a]充分表达清楚的,明确的;直率的,直截了当的;〔描绘性或暴力的语言或画面〕清晰露骨的; [^]sat;
exploit: [-]/ɪkˈsplɔɪt/; [v]剥削,利用;开发,开拓; [n]辉煌功绩; [^]sat;
exposure: [-]/ɪkˈspoʊʒər/; [n]暴露,受寒;揭露,揭发;亮相,报道;曝光,曝光时间; [^]sat;
expunge: [-]/ɪkˈspʌndʒ/; [v]删除; [^]sat;
expurgate: [-]/ˈekspərɡeɪt/; [v]净化,删去; [^]sat;
extant: [-]/ekˈstænt/; [a]现存的;显著的; [^]sat;
extent: [-]/ɪkˈstent/; [n]范围;程度;宽度;长度; [^]sat;
extenuate: [-]/ɪk'stenjʊˌeɪt/; [v]减轻,低估,为.找借口,使人原谅; [^]sat;
extol: [-]/ɪkˈstoʊl/; [v]赞美,称赞,颂扬; [^]sat;
extort: [-]/ɪkˈstɔːrt/; [vt]敲诈,勒索; [^]sat;
extricate: [-]/ˈekstrɪkeɪt/; [v]拯救,救出; [n]解脱;解脱者; [^]sat;
extrinsic: [-]/eksˈtrɪnzɪk/; [a]外在的,外部的; [^]sat;
extrovert: [-]/ˈekstrəvɜːrt/; [v]变成外向性格;使成外向性格; [n]性格外向者; [a]性格外向的; [^]sat;
extrude: [-]/ɪkˈstruːd/; [v]挤压出;伸出;逐出; [^]sat;
exude: [-]/ɪɡˈzuːd/; [v]慢慢流出,四溢,渗出,散发; [^]sat;
exult: [-]/ɪɡˈzʌlt/; [v]狂喜,欢欣鼓舞; [^]sat;
fabricate: [-]/ˈfæbrɪkeɪt/; [v]建造,制造,伪造(文件等),捏造,编造(谎言,借口等); [^]sat;
facade: [-]/fəˈsɑːd/; [n]建筑物的正面,外表; [^]sat;
facet: [-]/ˈfæsɪt/; [n](多面体的)面,小平面;琢面,侧面; [vt]在.上琢面; [^]sat;
facetious: [-]/fəˈsiːʃəs/; [a]滑稽的,诙谐的,开玩笑的; [^]sat;
facilitate: [-]/fəˈsɪlɪteɪt/; [v]为他人提供方便;使便利; [vt]促进; [^]sat;
facsimile: [-]/fækˈsɪməli/; [n]复制本,摹本; [a]复制的; [v]传真;临摹; [^]sat;
faction: [-]/ˈfækʃn/; [n]派别,小集团,小派系;派系斗争,内讧; [^]sat;
faculty: [-]/ˈfæklti/; [n]教职工,全体教员;系;科;能力; [^]sat;
fallacious: [-]/fəˈleɪʃəs/; [a]谬误的,易误解的,虚妄的; [^]sat;
fallible: [-]/ˈfæləbl/; [a]会犯错的,易犯错的; [^]sat;
fallow: [-]/ˈfæloʊ/; [a]休耕的;不活跃的;休闲地,休闲的; [n]休耕地;休耕; [v]使(翻耕后的土地)休闲; [^]sat;
falter: [-]/ˈfɔːltər/; [v]蹒跚,摇摆;踌躇;畏缩; [n]踌躇;支吾;颤抖; [^]sat;
fanaticism: [-]/fəˈnætɪsɪzəm/; [n]狂热,盲信; [^]sat;
fancy: [-]/ˈfænsi/; [a]华丽装饰的,别致的,引人注目的;昂贵的,阔气的; [n]喜爱,幻想,想像力; [vt]想象,幻想;迷恋; [^]sat;
fanfare: [-]/ˈfænfer/; [n]夸耀,嘹亮的喇叭声; [v]热闹地介绍<宣布>; [^]sat;
farce: [-]/fɑːrs/; [n]闹剧;胡闹;笑剧; [^]sat;
fastidious: [-]/fæˈstɪdiəs/; [a]难讨好的,爱挑剔的; [^]sat;
fatalism: [-]/ˈfeɪtəlɪzəm/; [n]宿命论; [^]sat;
fathom: [-]/ˈfæðəm/; [n]英寻(=6英尺); [vi]测量深度; [vt]彻底了解,测深; [^]sat;
fatuous: [-]/ˈfætʃuəs/; [a]愚昧而不自知的; [^]sat;
fauna: [-]/ˈfɔːnə/; [n]动物区系,动物群; [^]sat;
faze: [-]/feɪz/; [v]打扰,折磨,使狼狈,使担忧; [^]sat;
feasible: [-]/ˈfiːzəbl/; [a]可行的,行得通的; [^]sat;
feign: [-]/feɪn/; [v]假装,装作; [^]sat;
feint: [-]/feɪnt/; [v]佯攻,虚击; [n]佯攻; [a]虚假的; [^]sat;
felicity: [-]/fəˈlɪsəti/; [n]幸福,快乐,幸运; [^]sat;
felon: [-]/ˈfelən/; [n]重罪犯; [^]sat;
feral: [-]/ˈferəl/; [a]未驯服的,野生的;凶猛的; [^]sat;
ferret: [-]/ˈferɪt/; [n]雪貂;白鼬;侦探; [v]搜寻;查获;驱出;用雪貂猎取; [a]雪貂似的;搜索者般的;爱窥探的; [^]sat;
fervent: [-]/ˈfɜːrvənt/; [a]热烈的,满怀热情的;狂热的; [^]sat;
fervid: [-]/ˈfɜːrvɪd/; [a]热的;热心的; [^]sat;
fervor: [-]/ˈfɜrvər/; [n]强烈感情,激情,热情; [^]sat;
fester: [-]/ˈfestər/; [v]溃烂;化脓;使..痛苦;使..恶化; [n]溃烂;脓疮,脓疱; [^]sat;
festive: [-]/ˈfestɪv/; [a]庆祝的,喜庆的,欢乐的,节日似的; [^]sat;
fetid: [-]/ˈfetɪd/; [a]有恶臭的; [^]sat;
fetter: [-]/ˈfetər/; [n]脚镣;束缚; [vt]给.上脚镣;束缚; [^]sat;
fiasco: [-]/fiˈæskoʊ/; [n]大失败,惨败; [^]sat;
fickle: [-]/ˈfɪkl/; [a](在感情等方面)反复无常的,轻浮的,善变的; [^]sat;
fictitious: [-]/fɪkˈtɪʃəs/; [a]虚构的; [^]sat;
fidelity: [-]/fɪˈdeləti/; [n]忠诚;逼真度,保真度; [^]sat;
figment: [-]/ˈfɪɡmənt/; [n]空想;虚构的理论,故事等; [^]sat;
figurative: [-]/ˈfɪɡərətɪv/; [a]比喻的,修饰丰富的,形容多的; [^]sat;
figurine: [-]/ˌfɪɡjəˈriːn/; [n]小塑像,小雕像; [^]sat;
filament: [-]/ˈfɪləmənt/; [n]灯丝,细丝; [^]sat;
filch: [-]/fɪltʃ/; [vt]偷窃; [^]sat;
filial: [-]/ˈfɪliəl/; [a]子女的,孝顺的;<生物>子代的,后代的; [ad]子女地; [^]sat;
filibuster: [-]/ˈfɪlɪbʌstər/; [n]冗长演说; [v]拖延议事; [^]sat;
finesse: [-]/fɪˈnes/; [n]技巧,计谋,策略; [v]以技巧取胜; [^]sat;
finicky: [-]/ˈfɪnɪki/; [a]苛求的,过份讲究的; [^]sat;
fissure: [-]/ˈfɪʃər/; [v]裂开,龟裂; [n]裂缝,裂隙; [^]sat;
fitful: [-]/ˈfɪtfl/; [a]发作的,间歇的,不定的; [^]sat;
flaccid: [-]/ˈflæsɪd/; [a]软弱的,无活力的,没气力的,松弛的; [^]sat;
flagrant: [-]/ˈfleɪɡrənt/; [a]罪恶昭彰的,残暴的,丑恶可耻的,明目张胆的; [^]sat;
flair: [-]/fler/; [n]天资,特别的本领;敏锐的洞察力;嗜好;格调; [^]sat;
flamboyant: [-]/flæmˈbɔɪənt/; [a]辉耀的;华丽的,艳丽的;火焰似的; [^]sat;
flaunt: [-]/flɔːnt/; [n]招摇;飘扬;藐视; [vi]炫耀;飘扬; [vt]炫耀; [^]sat;
fleck: [-]/flek/; [n]斑点,斑纹;雀斑;微粒,小片; [v]使起斑点;使有斑纹; [^]sat;
fledgling: [-]/ˈfledʒlɪŋ/; [n]刚学飞的幼鸟,无经验的人; [a]刚开始的;无经验的; [^]sat;
fleece: [-]/fliːs/; [n]羊毛,羊毛状物; [v]剪羊毛,诈取; [^]sat;
flick: [-]/flɪk/; [n]轻弹,轻打;轻弹声; [v]轻弹;轻轻拂去;(翅)拍动;(旗)飘扬; [^]sat;
flinch: [-]/flɪntʃ/; [v]畏缩,退缩; [n]退缩,畏惧; [^]sat;
flippant: [-]/ˈflɪpənt/; [a]无礼的,轻率的,随意的; [^]sat;
flit: [-]/flɪt/; [n]轻快的飞行;迁移; [vi]掠过;轻快地飞过;偷偷溜走;去世; [^]sat;
flora: [-]/ˈflɔːrə/; [n]植物群; [^]sat;
florid: [-]/ˈflɔːrɪd/; [a]涨红的,华丽的,红润的; [^]sat;
flounder: [-]/ˈflaʊndər/; [n]比目鱼;踉跄前进; [v]踉跄前行;(在水或泥浆中)挣扎,陷入困境; [^]sat;
flourish: [-]/ˈflɜːrɪʃ/; [vi]繁荣,茂盛,兴旺; [vt]挥舞;夸耀; [n]兴旺;茂盛;炫耀;挥舞; [^]sat;
flout: [-]/flaʊt/; [n]表示轻蔑的言行;嘲弄;嘲笑; [vi]藐视;嘲弄;嘲笑; [vt]嘲弄;嘲笑;藐视; [^]sat;
fluctuate: [-]/ˈflʌktʃueɪt/; [v]波动;起伏;涨落; [^]sat;
fluency: [-]/ˈfluːənsi/; [n]流畅,流利; [^]sat;
fluke: [-]/fluːk/; [n]侥幸成功;意外的挫折; [v]侥幸做成;意外受挫; [^]sat;
fluster: [-]/ˈflʌstər/; [n]慌乱,狼狈,混乱; [v]使困惑,慌乱; [^]sat;
flux: [-]/flʌks/; [n]流动,不断的变动; [^]sat;
fodder: [-]/ˈfɑːdər/; [n]饲料,草料;(创作的)素材;弹药; [v]喂; [^]sat;
foible: [-]/ˈfɔɪbl/; [n]弱点,小缺点,癖好; [^]sat;
foil: [-]/fɔɪl/; [n]箔;锡箔纸;衬托; [v]挫败;使受挫折; [^]sat;
foliage: [-]/ˈfoʊliɪdʒ/; [n]叶子(总称); [^]sat;
foment: [-]/foʊˈment/; [v]煽动,助长(坏事); [^]sat;
foolhardy: [-]/ˈfuːlhɑːrdi/; [a]莽撞的,有勇无谋的; [^]sat;
fop: [-]/fɑːp/; [n]花花公子,纨绔子弟; [^]sat;
forbearance: [-]/fɔːrˈberəns/; [n]自制,忍耐;宽容; [^]sat;
ford: [-]/fɔːrd/; [v]涉水,渡河; [n]浅滩; [^]sat;
foreboding: [-]/fɔːrˈboʊdɪŋ/; [n]预感,预兆; [a]预感的,不祥之兆的; [^]sat;
forensic: [-]/fəˈrensɪk/; [a]科学手段的,法庭的,辩论的; [n]辩论练习;辩论学,辩论术; [^]sat;
foreshadow: [-]/fɔːrˈʃædoʊ/; [v]预示; [n]预兆; [^]sat;
foresight: [-]/ˈfɔːrsaɪt/; [n]先见,预见;远见,深谋远虑; [^]sat;
forestall: [-]/fɔːrˈstɔːl/; [v]领先;占先一步;先发制人,阻止,妨碍;垄断;占先一步; [^]sat;
forgo: [-]/fɔːrˈɡoʊ/; [v]放弃;停止;对.断念; [^]sat;
forlorn: [-]/fərˈlɔːrn/; [a]被遗弃的; [^]sat;
formality: [-]/fɔːrˈmæləti/; [n]得体;程序;拘谨;礼节;一丝不苟;单纯为形式而做的事; [^]sat;
formidable: [-]/ˈfɔːrmɪdəbl/; [a]令人畏惧的;可怕的;难以克服的;难应付的; [^]sat;
forsake: [-]/fərˈseɪk/; [v]放弃;抛弃,离开; [^]sat;
forswear: [-]/fɔːrˈswer/; [v]誓绝,放弃; [^]sat;
forte: [-]/fɔːrt/; [n]长处,特长; [a]强音的;响的; [ad]响亮地; [^]sat;
forthright: [-]/ˈfɔːrθraɪt/; [a]直接的,直率的,坦白的,豪爽的; [ad]马上,立即; [n]直路; [^]sat;
fortitude: [-]/ˈfɔːrtətuːd/; [n]坚强意志(精神),坚忍,刚毅; [^]sat;
fortuitous: [-]/fɔːrˈtuːɪtəs/; [a]偶然的;幸运的; [^]sat;
forum: [-]/ˈfɔːrəm/; [n]论坛;讨论会; [^]sat;
foster: [-]/ˈfɔːstər/; [a]收养的; [vt]养育;培养,促进; [^]sat;
founder: [-]/ˈfaʊndər/; [n]奠基者;创始人; [v](船)沉没,浸水而沉没;(计划等)失败,受挫折; [^]sat;
fracas: [-]/ˈfreɪkəs/; [n]喧嚷,吵闹,争论,论战; [^]sat;
fractious: [-]/ˈfrækʃəs/; [a]易怒的;难以对待的;倔强的;好争吵的; [^]sat;
frail: [-]/freɪl/; [a]脆弱的,不坚实的; [n]少妇;灯心草篓;灯心草篓的容量; [^]sat;
franchise: [-]/ˈfræntʃaɪz/; [n]特许(经营权),公民权,选举权; [v]赋予特权,赋予公民权; [^]sat;
frantic: [-]/ˈfræntɪk/; [a]疯狂的;狂乱的;慌乱的; [^]sat;
fraudulent: [-]/ˈfrɔːdʒələnt/; [a]欺诈的,欺骗性的,骗得的; [^]sat;
fraught: [-]/frɔːt/; [a]担心的,忧虑的;充满.的; [n]货物,装载物; [vt]装货于; [^]sat;
fray: [-]/freɪ/; [n]吵架,打斗,磨损处; [v]磨损,摩擦,使关系紧张; [^]sat;
frenetic: [-]/frəˈnetɪk/; [a]狂乱的;非常激动的; [n]疯子;狂人; [^]sat;
fresco: [-]/ˈfreskoʊ/; [n]壁画;壁画法; [v]在..上做壁画;用壁画法画出; [^]sat;
fret: [-]/fret/; [v]使烦恼,使焦急;使腐蚀;使磨损; [n](斑卓琴,吉他,曼陀林琴等弦乐器指板上定音的)档;侵蚀; [^]sat;
friction: [-]/ˈfrɪkʃn/; [n]摩擦,摩擦力;争执,冲突; [^]sat;
frigid: [-]/ˈfrɪdʒɪd/; [a]寒冷的,冷淡的,死板的,呆板的,性冷淡的; [^]sat;
frivolous: [-]/ˈfrɪvələs/; [a]轻佻的,不重要的,缺乏基础的; [^]sat;
frolicsome: [-]/ˈfrɑːlɪksəm/; [a]快活的;爱闹着玩的; [^]sat;
frond: [-]/frɑːnd/; [n](羊齿,棕榈等的)叶子;叶状体; [^]sat;
frugality: [-]/fruˈɡæləti/; [n]节约,节俭; [^]sat;
fruition: [-]/fruˈɪʃn/; [n]享有;最后完成,实现,取得成果; [^]sat;
frustrate: [-]/ˈfrʌstreɪt/; [v]使灰心;挫败;阻挠; [^]sat;
fugitive: [-]/ˈfjuːdʒətɪv/; [a]逃亡的,易逝的; [n]逃犯,逃亡者; [^]sat;
fulcrum: [-]/ˈfʊlkrəm/; [n]<机>支点,(植)叶附属物; [^]sat;
fundamental: [-]/ˌfʌndəˈmentl/; [a]基本的,根本的;重要的;基础的; [n]基本原理;基本原则; [^]sat;
furlough: [-]/ˈfɜːrloʊ/; [n](军人,官吏的)休假;暂时解雇;放假; [v]准假;暂时解雇; [^]sat;
furor: [-]/ˈfjʊˌrɔr/; [n]狂热;激怒;喧闹;感动; [^]sat;
furtive: [-]/ˈfɜːrtɪv/; [a]偷偷的,秘密的,鬼鬼祟祟的,; [^]sat;
fusion: [-]/ˈfjuːʒn/; [n]融合,合并,核聚变; [^]sat;
futile: [-]/ˈfjuːtl/; [a]无益的,无用的; [^]sat;
gadfly: [-]/ˈɡædflaɪ/; [n]牛虻,令人生厌的人; [^]sat;
gaffe: [-]/ɡæf/; [n](社交上令人不快的)失言,失态,失礼; [^]sat;
gainsay: [-]/ˌɡeɪnˈseɪ/; [v]否认,否定,反驳; [n]否认,反驳; [^]sat;
gait: [-]/ɡeɪt/; [n]步态,步法,速度; [^]sat;
galaxy: [-]/ˈɡæləksi/; [n]星系; [^]sat;
gale: [-]/ɡeɪl/; [n]狂风,一阵(笑声); [^]sat;
gall: [-]/ɡɔːl/; [n]粗鲁,无礼; [v]使恼怒; [^]sat;
galvanize: [-]/ˈɡælvənaɪz/; [v]镀锌,通电,刺激; [^]sat;
gambit: [-]/ˈɡæmbɪt/; [n](常指带风险的)策略,弃兵局(指国际象棋开局弃一卒以取得优势),话题,开始,开场白; [^]sat;
gamut: [-]/'ɡæmət/; [n]全音阶,长音域,整个领域,全体; [^]sat;
gape: [-]/ɡeɪp/; [n]裂口,张嘴,打哈欠; [v]目瞪口呆地凝视,打哈欠,张开,裂开; [^]sat;
gargantuan: [-]/ɡɑːrˈɡæntʃuən/; [a]巨大的,庞大的; [^]sat;
garish: [-]/ˈɡerɪʃ/; [a]炫耀的;过分装饰的;过分鲜艳的; [^]sat;
garner: [-]/ˈɡɑːrnər/; [v]收藏,积累,储存; [n]积蓄,积累物; [^]sat;
garnish: [-]/ˈɡɑːrnɪʃ/; [v]装饰(于食品上); [n]为增加色香味而添加的配菜;装饰品; [^]sat;
garrulous: [-]/ˈɡærələs/; [a]唠叨的,喋喋不休的;聒噪的; [^]sat;
gauche: [-]/ɡoʊʃ/; [a]笨拙的,不会社交的,偏转的; [^]sat;
gaudy: [-]/ˈɡɔːdi/; [n]华丽而俗气的廉价饰物; [a](服饰,装饰,文风等)华丽而俗气的;浮华的;过分显眼的; [^]sat;
gaunt: [-]/ɡɔːnt/; [a]憔悴的,瘦削的; [n]憔悴,荒凉; [^]sat;
gavel: [-]/ˈɡævl/; [n]小木槌; [v]敲小槌(催促通过议案,要求注意等);要求(注意); [^]sat;
gawk: [-]/ɡɔːk/; [v]张着嘴呆看; [^]sat;
genealogy: [-]/ˌdʒiːniˈælədʒi/; [n]宗谱,血统,家系,系谱学; [^]sat;
generate: [-]/ˈdʒenəreɪt/; [v]产生(热,电等能量),创造; [^]sat;
generic: [-]/dʒəˈnerɪk/; [n]无注册商标产品;通名; [a]一般的;非商标的;属的,类的; [^]sat;
genesis: [-]/ˈdʒenəsɪs/; [n](事物的)起源,发生; [^]sat;
geniality: [-]/ˌdʒiːniˈæləti/; [n]和蔼,温和,亲切; [^]sat;
genre: [-]/ˈʒɑːnrə/; [n]类型,流派; [a]风俗画的,以日常情景为主题的; [^]sat;
genteel: [-]/dʒenˈtiːl/; [a]有教养的,文雅的;高雅的;假斯文的,装作体面的; [^]sat;
gentility: [-]/dʒenˈtɪləti/; [n]上流阶层;文雅;有教养; [^]sat;
gentry: [-]/ˈdʒentri/; [n]人们(多用贬义),贵族们,(英)上流社会人士; [^]sat;
germane: [-]/dʒɜːrˈmeɪn/; [a]有密切关系的;贴切的;恰当的; [^]sat;
germinate: [-]/ˈdʒɜːrmɪneɪt/; [v]发芽,发展,生长; [^]sat;
ghastly: [-]/ˈɡæstli/; [a]苍白的,可怕的,令人不快的; [ad]恐怖地,惨白地; [^]sat;
gibberish: [-]/ˈdʒɪbərɪʃ/; [n]乱语;快速而不清楚的言语; [^]sat;
gibe: [-]/dʒaɪb/; [n]嘲弄,讥笑; [v]嘲笑; [^]sat;
giddy: [-]/ˈɡɪdi/; [a]眼花缭乱的,头晕的,轻率的; [v](使)眼花,(使)眩晕; [^]sat;
gingerly: [-]/ˈdʒɪndʒərli/; [ad]小心翼翼地,慎重地; [a]小心翼翼的;兢兢业业的; [^]sat;
gist: [-]/dʒɪst/; [n]主旨,要点;依据; [^]sat;
glacial: [-]/ˈɡleɪʃl/; [a]冰的;冰冷的;冰河时代的; [^]sat;
glaze: [-]/ɡleɪz/; [n](浇在糕点上的)糖浆,蛋浆,釉;<气>雨淞; [v](眼睛)变呆滞;浇浆汁于 (食物) 表面;给.安装玻璃; [^]sat;
glib: [-]/ɡlɪb/; [a]口齿伶俐的;油嘴滑舌的; [^]sat;
glimmer: [-]/ˈɡlɪmər/; [n]微光;闪光;少许; [v]闪烁;发微光; [^]sat;
gloat: [-]/ɡloʊt/; [v]幸灾乐祸地看,窃喜; [^]sat;
glossary: [-]/ˈɡlɑːsəri/; [n]词汇表,术语汇编; [^]sat;
glossy: [-]/ˈɡlɑːsi/; [a]光泽的,光滑的; [^]sat;
glower: [-]/ˈɡlaʊər/; [v]怒目而视; [^]sat;
glut: [-]/ɡlʌt/; [n]供过于求,过多; [vt]使吃饱;使充斥; [vi]过量地吃; [^]sat;
glutton: [-]/ˈɡlʌtn/; [n]贪吃者,对..贪婪的人; [^]sat;
gnarled: [-]/nɑːrld/; [a]多节的,粗糙的;多瘤的;弯曲的; [^]sat;
gnome: [-]/noʊm/; [n]地下宝藏的守护神,土地神;格言;侏儒; [^]sat;
goad: [-]/ɡoʊd/; [vt]驱赶;刺激;鼓励; [n](赶牛用的)刺棒; [^]sat;
gorge: [-]/ɡɔːrdʒ/; [n]峡谷;胃;暴食;咽喉;障碍物; [v]拼命吃;吞下,狼吞虎咽;塞满,填满; [^]sat;
gory: [-]/ˈɡɔːri/; [a]血淋淋的,血污的,满是血的; [^]sat;
gouge: [-]/ɡaʊdʒ/; [n]半圆凿,洞; [v]挖洞,敲竹杠; [^]sat;
gourmand: [-]/ˈɡʊrmɑːnd/; [n]贪食者; [a]贪食的; [^]sat;
gourmet: [-]/ˈɡʊrmeɪ/; [n]美食家,讲究吃喝的人; [a]菜肴精美的; [^]sat;
graft: [-]/ɡræft/; [n]嫁接;嫁接株;移植; [vi]接枝; [vt]将.嫁接;移植(器官); [^]sat;
grandeur: [-]/ˈɡrændʒər/; [n]壮观,宏伟,庄严; [^]sat;
grandiloquent: [-]/ɡrænˈdɪləkwənt/; [a](语言等)夸张的,夸大的; [^]sat;
grandiose: [-]/ˈɡrændioʊs/; [a]浮夸的,夸大的,宏伟的; [^]sat;
graphic: [-]/ˈɡræfɪk/; [a]形象的;图表的; [n]图,图表; [^]sat;
grapple: [-]/ˈɡræpl/; [v]抓住;格斗; [n]抓住;格斗; [^]sat;
grate: [-]/ɡreɪt/; [n]壁炉;格栅; [v]磨碎,使人烦燥; [^]sat;
gratify: [-]/ˈɡrætɪfaɪ/; [v]使高兴,使满足; [^]sat;
gratis: [-]/ˈɡrætɪs/; [a]免费的; [^]sat;
gratuitous: [-]/ɡrəˈtuːɪtəs/; [a]无根据的,无理由的,无报酬的,免费的,多余的; [^]sat;
gravity: [-]/ˈɡrævəti/; [n]重力,引力;严重性;庄重,严肃; [^]sat;
gregarious: [-]/ɡrɪˈɡeriəs/; [a]群居的,爱社交的; [^]sat;
grievance: [-]/ˈɡriːvəns/; [n]牢骚,委屈,抱怨; [^]sat;
grill: [-]/ɡrɪl/; [n]烤架; [v]烤;拷问; [^]sat;
grimace: [-]/ˈɡrɪməs/; [v]做鬼脸,面部歪扭; [n]愁眉苦脸,怪相,鬼脸; [^]sat;
grisly: [-]/ˈɡrɪzli/; [a]恐怖的;令人震惊的;厉害的; [^]sat;
grotesque: [-]/ɡroʊˈtesk/; [a]奇形怪状的,奇异的; [n]奇形怪状的人(或物,图案等);奇异风格; [^]sat;
grouse: [-]/ɡraʊs/; [v]埋怨; [n]松鸡;雷鸟科的猎鸟;怨言; [^]sat;
grove: [-]/ɡroʊv/; [n]小树林;果园; [^]sat;
grovel: [-]/ˈɡrɑːvl/; [v]摇尾乞怜;奴颜婢膝;匍匐; [^]sat;
grudging: [-]/ˈɡrʌdʒɪŋ/; [a]勉强的,吝啬的; [^]sat;
gruel: [-]/ˈɡruːəl/; [n]稀粥; [v]使极度疲劳;累垮; [^]sat;
grueling: [-]/'gruːəlɪŋ/; [n]惩罚,劳累; [a]累垮人的,折磨人的; [^]sat;
gruesome: [-]/ˈɡruːsəm/; [a]阴森的;可怕的; [^]sat;
gruff: [-]/ɡrʌf/; [a]粗暴的,粗哑的,脾气坏的; [vt]粗鲁地说,生硬地说; [vi]粗鲁地说,生硬地说话; [^]sat;
guffaw: [-]/ɡəˈfɔː/; [n]哄笑;大笑; [v]哄笑;大笑; [^]sat;
guile: [-]/ɡaɪl/; [n]狡猾,诡计,欺诈; [^]sat;
guise: [-]/ɡaɪz/; [n]外观,姿态,装束,伪装; [v]伪装; [^]sat;
gullible: [-]/ˈɡʌləbl/; [a]易受骗的;轻信的; [^]sat;
gusto: [-]/ˈɡʌstoʊ/; [n]由衷的高兴;爱好,嗜好; [^]sat;
gusty: [-]/ˈɡʌsti/; [a]多阵风的,起大风的,迸发的; [^]sat;
hackneyed: [-]/ˈhæknid/; [a]陈腐的,平常的; [^]sat;
haggard: [-]/ˈhæɡərd/; [a]憔悴的,消瘦的; [n]哈格德;未驯服的鹰;悍鹰; [^]sat;
haggle: [-]/ˈhæɡl/; [n]讨价还价; [v]争论,讨价还价; [^]sat;
hallowed: [-]/ˈhæloʊd/; [a]神圣的; [^]sat;
hallucination: [-]/həˌluːsɪˈneɪʃn/; [n]幻觉,幻想; [^]sat;
halting: [-]/ˈhɔːltɪŋ/; [a]犹豫的,蹒跚的,迟缓的; [v]停止;蹒跚,犹豫; [^]sat;
hamper: [-]/ˈhæmpər/; [v]阻碍,妨碍,牵制; [n](有盖的)大篮子; [^]sat;
haphazard: [-]/hæpˈhæzərd/; [a]偶然的;随意的;凑合的;胡乱的; [^]sat;
harangue: [-]/həˈræŋ/; [n]长篇大论; [v]高谈阔论;大声训斥; [^]sat;
harass: [-]/həˈræs/; [v]使困扰,使烦恼,反复袭击; [^]sat;
harbinger: [-]/ˈhɑːrbɪndʒər/; [n]先驱,先兆; [vt]预告;充做.的前驱; [^]sat;
harbor: [-]/'hɑːbə/; [n]海港;港口;避风港; [v]庇护;藏匿;心怀(怨恨等); [^]sat;
hardy: [-]/ˈhɑːrdi/; [a](植物)耐寒的;能吃苦耐劳的;勇敢的; [n]强壮的人; [^]sat;
harrowing: [-]/ˈhæroʊɪŋ/; [a]悲痛的,难受的; [^]sat;
haughtiness: [-]/ˈhɔːtinəs/; [n]傲慢; [^]sat;
hazardous: [-]/ˈhæzərdəs/; [a]有危险的;碰运气的; [ad]冒险地,有危险地; [n]冒险,危险; [^]sat;
hazy: [-]/ˈheɪzi/; [a]朦胧的,烟雾弥漫的,模糊的; [^]sat;
headstrong: [-]/ˈhedstrɔːŋ/; [a]任性的;顽固的; [^]sat;
heckler: [-]/ˈheklər/; [n]激烈质问者; [^]sat;
hedonist: [-]/ˈhiːdənɪst/; [n]享乐主义者,［心］欢乐主义者; [a]享乐主义者的; [^]sat;
heed: [-]/hiːd/; [vt]注意;留心; [v]注意; [vi]留心; [n]注意;留心; [^]sat;
heinous: [-]/ˈheɪnəs/; [a]可憎的;极凶恶的; [^]sat;
herbivorous: [-]/ɜːrˈbɪvərəs/; [a]食草的; [^]sat;
heresy: [-]/ˈherəsi/; [n]异端邪说;异教; [^]sat;
hermetic: [-]/hɜːrˈmetɪk/; [a]密封的;与外界隔绝的;不透气的;炼金术的; [^]sat;
hermitage: [-]/ˈhɜːrmɪtɪdʒ/; [n]隐士生活;隐士住处; [^]sat;
heterogeneous: [-]/ˌhetərəˈdʒiːniəs/; [a]多相的,异种的,不均匀的,由不同成分形成的; [^]sat;
heyday: [-]/ˈheɪdeɪ/; [n]全盛期; [int]嘿(表喜悦或惊奇等); [^]sat;
hiatus: [-]/haɪˈeɪtəs/; [n]空隙,裂缝,中断; [^]sat;
hibernate: [-]/ˈhaɪbərneɪt/; [vi]冬眠,蛰居; [^]sat;
hierarchy: [-]/ˈhaɪərɑːrki/; [n]阶层,等级制度; [^]sat;
hindrance: [-]/ˈhɪndrəns/; [n]妨碍;障碍物; [^]sat;
histrionic: [-]/ˌhɪstriˈɑːnɪk/; [a]戏剧的,装腔作势的,作戏的; [n]演员;戏剧表演;舞台艺术;戏剧似的言行; [^]sat;
hoard: [-]/hɔːrd/; [v]贮藏,秘藏; [n]贮藏物; [^]sat;
hoary: [-]/ˈhɔːri/; [a]年纪高迈的;(头发等)灰白的;古老的; [^]sat;
hoax: [-]/hoʊks/; [n]骗局;恶作剧; [vt]愚弄;欺骗; [^]sat;
hodgepodge: [-]/ˈhɑːdʒpɑːdʒ/; [n]大杂烩,混煮,一团糟; [^]sat;
holster: [-]/ˈhoʊlstər/; [n]手枪皮套; [^]sat;
homage: [-]/ˈhɑːmɪdʒ/; [n]敬意;尊敬;效忠; [^]sat;
homogeneous: [-]/ˌhoʊməˈdʒiːniəs/; [a]同类的,同质的,有相同特征的; [^]sat;
hone: [-]/hoʊn/; [n]细磨刀石; [v]磨刀; [^]sat;
hoodwink: [-]/ˈhʊdwɪŋk/; [v]欺骗,遮眼,蒙蔽; [^]sat;
horde: [-]/hɔːrd/; [n]一大群,群,游牧部落; [v]成群;结成部落而居; [^]sat;
host: [-]/hoʊst/; [n]东道主,主持人;大量; [v]主持,主办; [^]sat;
hostility: [-]/hɑːˈstɪləti/; [n]虐待,敌意;不友善;敌对; [^]sat;
hovel: [-]/ˈhʌvl/; [n]茅舍,肮脏的小屋; [^]sat;
hover: [-]/ˈhʌvər/; [v](鸟,直升机)盘旋,翱翔;(人)逗留在附近,徘徊; [^]sat;
hue: [-]/hjuː/; [n]色彩;色度,颜色;叫声; [^]sat;
hulking: [-]/ˈhʌlkɪŋ/; [a]笨重的; [^]sat;
humane: [-]/hjuːˈmeɪn/; [a]人道的;仁慈的; [^]sat;
humdrum: [-]/ˈhʌmdrʌm/; [a]单调的;乏味的; [n]平凡;单调; [vi]单调乏味地进行; [^]sat;
humid: [-]/ˈhjuːmɪd/; [a]潮湿的;湿润的;多湿气的; [^]sat;
humility: [-]/hjuːˈmɪləti/; [n]谦逊,谦恭; [^]sat;
hurtle: [-]/ˈhɜːrtl/; [v]猛冲,猛烈碰撞,使冲向; [n]碰撞;碰撞声;猛冲; [^]sat;
hybrid: [-]/ˈhaɪbrɪd/; [n]杂种,混血儿,混合物; [a]混合的;杂种的; [^]sat;
hydrophobia: [-]/ˌhaɪdrəˈfoʊbiə/; [n]狂犬病,恐水病; [^]sat;
hyperbole: [-]/haɪˈpɜːrbəli/; [n]夸张的语句;夸张法; [^]sat;
hypochondriac: [-]/ˌhaɪpəˌkɑːnˈdraɪəkl/; [n]疑病患者,忧郁症患者; [^]sat;
hypocritical: [-]/ˌhɪpəˈkrɪtɪkl/; [a]虚伪的;伪善的; [^]sat;
hypothetical: [-]/ˌhaɪpəˈθetɪkl/; [a]假设的,假定的; [^]sat;
icon: [-]/ˈaɪkɑːn/; [n]图标,肖像,偶像; [^]sat;
ideology: [-]/ˌaɪdiˈɑːlədʒi/; [n]意识形态,思想(体系); [^]sat;
idiom: [-]/ˈɪdiəm/; [n]习语;成语;惯用语法; [^]sat;
idiosyncrasy: [-]/ˌɪdiəˈsɪŋkrəsi/; [n]特殊癖性或行为; [^]sat;
ignite: [-]/ɪɡˈnaɪt/; [v]点燃,发光,燃烧; [^]sat;
ignominy: [-]/ˈɪɡnəmɪni/; [n]耻辱,不体面,丑行; [^]sat;
illicit: [-]/ɪˈlɪsɪt/; [a]违法的,违禁的; [^]sat;
illuminate: [-]/ɪˈluːmɪneɪt/; [vt]照亮;阐释;说明; [^]sat;
illusion: [-]/ɪˈluːʒn/; [n]假象,幻象;幻想;错误观念; [^]sat;
illusory: [-]/ɪˈluːsəri/; [a]错觉的,幻影的,虚假的,产生幻觉的; [^]sat;
imbalance: [-]/ɪmˈbæləns/; [n]不平衡,不均衡;失调; [^]sat;
imbibe: [-]/ɪmˈbaɪb/; [v]喝,饮;吸收,接受; [^]sat;
immaculate: [-]/ɪˈmækjələt/; [a]完美的,无瑕疵的;洁净的; [^]sat;
imminent: [-]/ˈɪmɪnənt/; [a]迫近的,紧迫的,即将来临的; [^]sat;
immobility: [-]/ˌɪməˈbɪləti/; [n]不动,固定; [^]sat;
immune: [-]/ɪˈmjuːn/; [a]免疫的,有免疫力的;不受影响的;免除的; [^]sat;
immutable: [-]/ɪˈmjuːtəbl/; [a]永远不变的,永恒的; [^]sat;
impair: [-]/ɪmˈper/; [v]损害;削弱; [^]sat;
impale: [-]/ɪmˈpeɪl/; [v]刺穿,刺住; [^]sat;
impart: [-]/ɪmˈpɑːrt/; [v]传授,给予,将(某性质)给予或赋予某事物; [^]sat;
impartial: [-]/ɪmˈpɑːrʃl/; [a]公平的,不偏不倚的; [^]sat;
impasse: [-]/ˈɪmpæs/; [n]僵局;死路; [^]sat;
impassive: [-]/ɪmˈpæsɪv/; [a]无动于衷的,冷漠的; [^]sat;
impeach: [-]/ɪmˈpiːtʃ/; [v]指摘,弹劾; [^]sat;
impeccable: [-]/ɪmˈpekəbl/; [a]无瑕疵的,没有缺点的; [^]sat;
impecunious: [-]/ˌɪmpɪˈkjuːniəs/; [a]贫困的,一文不名的; [^]sat;
impede: [-]/ɪmˈpiːd/; [v]妨碍,阻碍; [^]sat;
impediment: [-]/ɪmˈpedɪmənt/; [n]妨碍,阻碍;障碍物;(言语)障碍;口吃; [^]sat;
impel: [-]/ɪmˈpel/; [v]推进,驱使; [^]sat;
impending: [-]/ɪmˈpendɪŋ/; [a]即将到来的;迫在眉睫的,紧急的; [^]sat;
impenetrable: [-]/ɪmˈpenɪtrəbl/; [a]难以渗透的,坚不可摧的; [^]sat;
impenitent: [-]/ɪmˈpenɪtənt/; [a]不悔悟的; [^]sat;
imperative: [-]/ɪmˈperətɪv/; [a]必要的;祈使的;急需的; [n]命令;必要的事;义务;驱使; [^]sat;
imperceptible: [-]/ˌɪmpərˈseptəbl/; [a]极细微的,觉察不到的,感觉不到的,; [^]sat;
imperial: [-]/ɪmˈpɪriəl/; [a]帝王的,壮丽的,至尊的; [n]帝国,皇家; [^]sat;
imperious: [-]/ɪmˈpɪriəs/; [a]傲慢的,专横的; [^]sat;
impermeable: [-]/ɪmˈpɜːrmiəbl/; [a]不渗透的;(水等)不能渗透的; [^]sat;
impertinent: [-]/ɪmˈpɜːrtnənt/; [a]不恰当的,粗鲁的; [^]sat;
imperturbable: [-]/ˌɪmpərˈtɜːrbəbl/; [a]冷静的,沉着的; [^]sat;
impervious: [-]/ɪmˈpɜːrviəs/; [a]不能渗透的,不为所动的; [^]sat;
impetuous: [-]/ɪmˈpetʃuəs/; [a]冲动的,鲁莽的; [^]sat;
impetus: [-]/ˈɪmpɪtəs/; [n]推动力;促进; [^]sat;
impinge: [-]/ɪmˈpɪndʒ/; [v]侵犯,撞击,碰撞; [^]sat;
impious: [-]/ɪmˈpaɪəs/; [a]不敬神的,不虔诚的,不孝的; [^]sat;
implacable: [-]/ɪmˈplækəbl/; [a]难以满足的,难平息的; [^]sat;
implement: [-]/ˈɪmplɪment/; [n]工具;器具; [v]实施,执行;执行; [^]sat;
implicate: [-]/ˈɪmplɪkeɪt/; [vt]使牵连其中,暗示,含有.的意思; [n]包含的东西; [^]sat;
implication: [-]/ˌɪmplɪˈkeɪʃn/; [n]暗示;含意;牵连;卷入;可能的后果; [^]sat;
implicit: [-]/ɪmˈplɪsɪt/; [a]隐含的;盲目的;完全的,绝对的;成为一部分的; [^]sat;
implore: [-]/ɪmˈplɔːr/; [v]恳求; [^]sat;
imply: [-]/ɪmˈplaɪ/; [vt]暗示;暗指;意味着; [^]sat;
importunate: [-]/ɪmˈpɔːrtʃənət/; [a]讨厌的,急切的,缠扰不休的; [^]sat;
importune: [-]/ˌɪmpɔːrˈtuːn/; [v]强求,胡搅蛮缠; [a]同"importunate"; [^]sat;
impostor: [-]/ɪmˈpɑːstər/; [n]骗子;冒充者; [^]sat;
impotent: [-]/ˈɪmpətənt/; [a]无力的,无能的,阳痿的; [n]虚弱者;阳痿者; [^]sat;
impoverished: [-]/ɪmˈpɑːvərɪʃt/; [a]穷困的,用尽了的,无创造性的; [^]sat;
impregnable: [-]/ɪmˈpreɡnəbl/; [a]攻不破的,征服不了的; [^]sat;
impromptu: [-]/ɪmˈprɑːmptuː/; [a]一触即发的;即席的,即兴的; [ad]即席地,即兴地; [n]即兴之作; [^]sat;
impropriety: [-]/ˌɪmprəˈpraɪəti/; [n]不当行为;不适当;不正确; [^]sat;
improvident: [-]/ɪmˈprɑːvɪdənt/; [a]浪费的,无远见的,无先见之明的; [^]sat;
improvise: [-]/ˈɪmprəvaɪz/; [v]即席创作,临时凑成; [^]sat;
imprudent: [-]/ɪmˈpruːdnt/; [a]轻率的,鲁莽的; [^]sat;
impugn: [-]/ɪmˈpjuːn/; [v]指责,对.表示怀疑; [^]sat;
impunity: [-]/ɪmˈpjuːnəti/; [n]不受惩罚;无患; [^]sat;
inadvertently: [-]/ˌɪnədˈvɜːrtəntli/; [ad]不经意地;不经意的; [^]sat;
inalienable: [-]/ɪnˈeɪliənəbl/; [a]不可分割的; [^]sat;
inane: [-]/ɪˈneɪn/; [a]无意义的,空洞的;愚蠢的; [^]sat;
inanimate: [-]/ɪnˈænɪmət/; [a]无生命的;无生气的; [^]sat;
inaugurate: [-]/ɪˈnɔːɡjəreɪt/; [v]为..揭幕;为.举行就职典礼;开展; [^]sat;
incandescent: [-]/ˌɪnkænˈdesnt/; [a]白热的,热烈的; [^]sat;
incantation: [-]/ˌɪnkænˈteɪʃn/; [n]咒语; [^]sat;
incapacitate: [-]/ˌɪnkəˈpæsɪteɪt/; [v]使不能;使瘫痪;使无能力;使不适合; [^]sat;
incarcerate: [-]/ɪnˈkɑːrsəreɪt/; [v]把..关进监狱,监禁,幽闭; [^]sat;
incarnation: [-]/ˌɪnkɑːrˈneɪʃn/; [n]赋与肉体,具人形,化身; [^]sat;
incendiary: [-]/ɪnˈsendieri/; [n]放火者,纵火者,燃烧弹,煽动者; [a]放火的,纵火的,能燃烧的,煽动性的; [^]sat;
incense: [-]/ˈɪnsens/; [n]焚香时的烟,香味; [v]激怒; [^]sat;
incentive: [-]/ɪnˈsentɪv/; [n]刺激,激励;鼓励; [^]sat;
inception: [-]/ɪnˈsepʃn/; [n]起初;获得学位; [^]sat;
incessant: [-]/ɪnˈsesnt/; [a]无间断的,连续的; [^]sat;
inchoate: [-]/ɪnˈkoʊət/; [a]早期的;刚开始的;未充分发展的; [^]sat;
incidence: [-]/ˈɪnsɪdəns/; [n]发生率,入射角度; [^]sat;
incipient: [-]/ɪnˈsɪpiənt/; [a]初期的;刚出现的; [^]sat;
incisive: [-]/ɪnˈsaɪsɪv/; [a]一针见血的,敏锐的; [^]sat;
incite: [-]/ɪnˈsaɪt/; [v]刺激;煽动; [^]sat;
inclement: [-]/ɪnˈklemənt/; [a]险恶的;气候严酷的;狂风暴雨的; [^]sat;
incline: [-]/ɪnˈklaɪn/; [n]倾斜,斜坡,斜面; [v](使)倾斜,(使)倾向于; [^]sat;
inclined: [-]/ɪnˈklaɪnd/; [a]倾向..的,有..意向的;斜着的; [^]sat;
inclusive: [-]/ɪnˈkluːsɪv/; [a]包含..在内的,包罗广泛的; [^]sat;
incoherent: [-]/ˌɪnkoʊˈhɪrənt/; [a]语无伦次的;不合逻辑的;不连贯的; [^]sat;
incompatible: [-]/ˌɪnkəmˈpætəbl/; [a]不兼容的,矛盾的,不调和的; [^]sat;
incongruous: [-]/ɪnˈkɑːŋɡruəs/; [a]不调和的,不相称的; [^]sat;
inconsequential: [-]/ɪnˌkɑːnsɪˈkwenʃl/; [a]不重要的,不合理的,不合逻辑的; [^]sat;
incontrovertible: [-]/ˌɪnkɑːntrəˈvɜːrtəbl/; [a]无可争议的; [^]sat;
incorporeal: [-]/ˌɪnkɔːrˈpɔːriəl/; [a]灵魂的,无实体的,非物质的; [^]sat;
incorrigible: [-]/ɪnˈkɔːrɪdʒəbl/; [a]积习难改的,不可救药的; [^]sat;
incredulous: [-]/ɪnˈkredʒələs/; [a]怀疑的,不轻信的; [^]sat;
increment: [-]/ˈɪŋkrəmənt/; [n]增长;增值; [^]sat;
incriminate: [-]/ɪnˈkrɪmɪneɪt/; [v]控告,暗示..有罪; [^]sat;
incubate: [-]/ˈɪŋkjubeɪt/; [v]孵卵; [^]sat;
inculcate: [-]/ɪnˈkʌlkeɪt/; [v]灌输,谆谆教诲; [^]sat;
incumbent: [-]/ɪnˈkʌmbənt/; [n]在职者,现任者; [a]现任的;依靠的;负有职责的; [^]sat;
incur: [-]/ɪnˈkɜːr/; [v]遭受;招致;引起; [^]sat;
incursion: [-]/ɪnˈkɜːrʒn/; [n]入侵,侵犯; [^]sat;
indefatigable: [-]/ˌɪndɪˈfætɪɡəbl/; [a]不知疲倦的;不屈不挠的;有耐性的; [^]sat;
indelible: [-]/ɪnˈdeləbl/; [a](印记等)无法擦除的,无法忘怀的; [^]sat;
indentation: [-]/ˌɪndenˈteɪʃn/; [n]空格,缩进;呈锯齿形;海岸线凹入处; [^]sat;
indicative: [-]/ɪnˈdɪkətɪv/; [a]指示的;暗示的;陈述的; [n]陈述语气; [^]sat;
indices: [-]/ˈɪndɪsiːz/; [n]目录,指数; [^]sat;
indict: [-]/ɪnˈdaɪt/; [v]控诉,起诉; [^]sat;
indifferent: [-]/ɪnˈdɪfrənt/; [a]不感兴趣的,不关心的;平庸的;冷漠的; [^]sat;
indigenous: [-]/ɪnˈdɪdʒənəs/; [a]土生土长的,本土的; [^]sat;
indigent: [-]/ˈɪndɪdʒənt/; [a]贫困的,贫穷的; [^]sat;
indignation: [-]/ˌɪndɪɡˈneɪʃn/; [n]愤慨; [^]sat;
indignity: [-]/ɪnˈdɪɡnəti/; [n]侮辱,有伤尊严,无礼举动; [^]sat;
indiscretion: [-]/ˌɪndɪˈskreʃn/; [n]轻率;言行失检; [^]sat;
indiscriminate: [-]/ˌɪndɪˈskrɪmɪnət/; [a]任意的;不加区别的,不加选择的; [^]sat;
indisputable: [-]/ˌɪndɪˈspjuːtəbl/; [a]没有争论余地,非常清楚的; [^]sat;
indoctrinate: [-]/ɪnˈdɑːktrɪneɪt/; [v]灌输思想; [^]sat;
indolent: [-]/ˈɪndələnt/; [a]懒惰的,懒洋洋的; [^]sat;
indomitable: [-]/ɪnˈdɑːmɪtəbl/; [a]不屈不挠的;不服输的;不气馁的; [^]sat;
induce: [-]/ɪnˈduːs/; [v]引导,劝诱,诱导; [^]sat;
indulgent: [-]/ɪnˈdʌldʒənt/; [a]放纵的;宽容的;任性的; [^]sat;
industrious: [-]/ɪnˈdʌstriəs/; [a]勤劳的,勤奋的; [^]sat;
ineffable: [-]/ɪnˈefəbl/; [a]不可言喻的,不应说出的,难以形容的; [^]sat;
inept: [-]/ɪˈnept/; [a]无能的;不称职的;笨拙的; [^]sat;
inequity: [-]/ɪnˈekwəti/; [n]不公平; [^]sat;
inert: [-]/ɪˈnɜːrt/; [a]不动的,惰性的;行动迟钝的;无生气的; [^]sat;
inevitable: [-]/ɪnˈevɪtəbl/; [a]不可避免的,必然的; [n]必然发生的事; [^]sat;
inexorable: [-]/ɪnˈeksərəbl/; [a]不为所动的,坚决不变的; [n]坚定不移的人; [^]sat;
infamous: [-]/ˈɪnfəməs/; [a]声名狼藉的,无耻的; [^]sat;
infantile: [-]/ˈɪnfəntaɪl/; [a]婴儿的,幼稚的,初期的; [^]sat;
infer: [-]/ɪnˈfɜːr/; [vt]做出推论,推断;推理;暗示; [vi]推断; [^]sat;
infernal: [-]/ɪnˈfɜːrnl/; [a]地狱的;恶魔的;可憎的; [^]sat;
infidel: [-]/ˈɪnfɪdəl/; [n]不信教者,异教徒; [^]sat;
infiltrate: [-]/ˈɪnfɪltreɪt/; [v]渗入,潜入 (某地方或组织);(气,液)渗透; [n]渗透物; [^]sat;
infinitesimal: [-]/ˌɪnfɪnɪˈtesɪml/; [a]无穷小的,无限小的,极小的; [ad]无限小地; [n]无限小;极微量;极小量; [^]sat;
infirmity: [-]/ɪnˈfɜːrməti/; [n]虚弱; [^]sat;
inflated: [-]/ɪnˈfleɪtɪd/; [a]通货膨胀的,充了气的,价格飞涨的,(植物)肿胀的; [^]sat;
influx: [-]/ˈɪnflʌks/; [n]流入,涌入;河口; [^]sat;
informal: [-]/ɪnˈfɔːrml/; [a]非正式的;不拘礼节的;通俗的; [^]sat;
infraction: [-]/ɪnˈfrækʃn/; [n]违法; [^]sat;
infuriate: [-]/ɪnˈfjʊrieɪt/; [v]使(人)极为愤怒; [^]sat;
infusion: [-]/ɪnˈfjuːʒn/; [n]灌输;注入物;输入; [^]sat;
ingenious: [-]/ɪnˈdʒiːniəs/; [a]聪明的;有发明天才的;有独创性的,别出心裁的; [^]sat;
inherent: [-]/ɪnˈhɪrənt/; [a]内在的,固有的;生来就有的; [^]sat;
inhibit: [-]/ɪnˈhɪbɪt/; [v]阻碍;阻止,防止;抑制,约束; [^]sat;
inimical: [-]/ɪˈnɪmɪkl/; [a]敌意的,有害的; [^]sat;
inimitable: [-]/ɪˈnɪmɪtəbl/; [a]独特的,无比的,无法仿效的; [^]sat;
iniquitous: [-]/ɪˈnɪkwɪtəs/; [a]邪恶的;不公正的; [^]sat;
initiate: [-]/ɪˈnɪʃieɪt/; [v]开始,发动; [n]新加入组织的人; [^]sat;
injurious: [-]/ɪnˈdʒʊriəs/; [a]有害的,造成伤害的; [^]sat;
inkling: [-]/ˈɪŋklɪŋ/; [n]轻微暗示,小提示,略知; [^]sat;
innate: [-]/ɪˈneɪt/; [a]与生俱来的,天生的; [^]sat;
innocuous: [-]/ɪˈnɑːkjuəs/; [a]无伤大雅的;无害的; [^]sat;
innovation: [-]/ˌɪnəˈveɪʃn/; [n]创新,革新,新设施,新发明; [^]sat;
innovative: [-]/ˈɪnəveɪtɪv/; [a]创新的,革新的; [^]sat;
innuendo: [-]/ˌɪnjuˈendoʊ/; [n]暗讽,讽刺,影射; [vt]暗示,旁敲侧击地表达; [vi]影射,说讽刺话; [^]sat;
inordinate: [-]/ɪnˈɔːrdɪnət/; [a]过度的,无节制的;紊乱的; [^]sat;
insatiable: [-]/ɪnˈseɪʃəbl/; [a]不能满足的,贪得无厌的; [^]sat;
inscrutable: [-]/ɪnˈskruːtəbl/; [a]高深莫测的,神秘的; [^]sat;
insensible: [-]/ɪnˈsensəbl/; [a]昏迷的,无知觉的,麻木不仁的; [^]sat;
insidious: [-]/ɪnˈsɪdiəs/; [a](暗中或逐渐)为害的; [^]sat;
insightful: [-]/ˈɪnsaɪtfʊl/; [a]有深刻见解的,富有洞察力的; [^]sat;
insinuate: [-]/ɪnˈsɪnjueɪt/; [v]暗指,暗示; [^]sat;
insipid: [-]/ɪnˈsɪpɪd/; [a]淡而无味的;枯燥乏味的; [^]sat;
insolvent: [-]/ɪnˈsɑːlvənt/; [n]无力清偿债务者,破产者; [a]无清偿能力的,破产的; [^]sat;
insomnia: [-]/ɪnˈsɑːmniə/; [n]失眠; [^]sat;
instigate: [-]/ˈɪnstɪɡeɪt/; [v]发起,煽动; [^]sat;
insuperable: [-]/ɪnˈsuːpərəbl/; [a]难以克服的,无敌的; [^]sat;
insurgent: [-]/ɪnˈsɜːrdʒənt/; [n]叛乱分子; [a]叛乱的,起事的; [^]sat;
insurmountable: [-]/ˌɪnsərˈmaʊntəbl/; [a]不能克服的,不能超越的,难以对付的; [^]sat;
insurrection: [-]/ˌɪnsəˈrekʃn/; [n]造反,叛乱; [^]sat;
intangible: [-]/ɪnˈtændʒəbl/; [a]不可捉摸的,无形的; [n]无形的东西; [^]sat;
integral: [-]/ˈɪntɪɡrəl/; [a](用于构成整体)必需的,不可缺少的,必不可少的;基本的,作为组成部分的,内置的;整体的,完整的; [^]sat;
integrity: [-]/ɪnˈteɡrəti/; [n]正直,真诚;完整; [^]sat;
intellect: [-]/ˈɪntəlekt/; [n]智力,理解力;非凡的才智;才华出众的人; [^]sat;
intemperate: [-]/ɪnˈtempərət/; [a]放纵的;酗酒的;酷烈的; [^]sat;
inter: [-]/ɪnˈtɜːr/; [v]埋葬; prep. 在内; [^]sat;
interim: [-]/ˈɪntərɪm/; [n]中间时期,过渡时期; [a]暂时的; [^]sat;
interminable: [-]/ɪnˈtɜːrmɪnəbl/; [a]没完没了的,无穷无尽的,冗长的; [^]sat;
intermittent: [-]/ˌɪntərˈmɪtənt/; [a]断断续续的,间歇的; [^]sat;
interrogate: [-]/ɪnˈterəɡeɪt/; [v]审问,审讯; [^]sat;
intervene: [-]/ˌɪntərˈviːn/; [v]干涉;介入;调停;干预,阻挠; [^]sat;
intimacy: [-]/ˈɪntɪməsi/; [n]亲密,亲近;亲昵行为;<婉>性行为;<婉辞>私通; [^]sat;
intimate: [-]/ˈɪntɪmət/; [a]亲密的,密切的;详细的; [v]暗示;宣布,通知; [n]密友,知己; [^]sat;
intimidate: [-]/ɪnˈtɪmɪdeɪt/; [v]恫吓,威胁; [^]sat;
intractable: [-]/ɪnˈtræktəbl/; [a]棘手的;难治的;倔强的;不听话的; [^]sat;
intrepid: [-]/ɪnˈtrepɪd/; [a]无畏的;刚毅的,勇敢的; [^]sat;
intricate: [-]/ˈɪntrɪkət/; [a]错综复杂的; [^]sat;
intrinsic: [-]/ɪnˈtrɪnsɪk/; [a]固有的; [^]sat;
introspective: [-]/ˌɪntrəˈspektɪv/; [a]内省的,反省的; [^]sat;
intrude: [-]/ɪnˈtruːd/; [vi]闯入,侵入; [vt]强挤入,把(自己的思想)强加于人; [^]sat;
intuition: [-]/ˌɪntuˈɪʃn/; [n]直觉;感觉; [^]sat;
inundate: [-]/ˈɪnʌndeɪt/; [v]淹没,泛滥; [^]sat;
invalidate: [-]/ɪnˈvælɪdeɪt/; [v]使无效;使无价值; [^]sat;
invasive: [-]/ɪnˈveɪsɪv/; [a]扩散性的;<医>开刀的; [^]sat;
invective: [-]/ɪnˈvektɪv/; [n]猛烈抨击,恶言漫骂; [a]谩骂的;恶言的;诽谤的; [^]sat;
inverse: [-]/ˌɪnˈvɜːrs/; [a]相反的;反面的;倒转的; [n](the inverse)反面; [^]sat;
invert: [-]/ɪnˈvɜːrt/; [v]倒置;倒转;颠倒; [^]sat;
invidious: [-]/ɪnˈvɪdiəs/; [a]惹人反感的,招人嫉妒的,令人厌恶的,诽谤的,不公平的; [^]sat;
invigorate: [-]/ɪnˈvɪɡəreɪt/; [v]鼓舞;提神,使精力充沛; [a]生气勃勃的,精力充沛的,健壮的; [n]滋补;鼓舞; [^]sat;
invincible: [-]/ɪnˈvɪnsəbl/; [a]无敌的;不能征服的; [^]sat;
inviolable: [-]/ɪnˈvaɪələbl/; [a]神圣的;不可侵犯的,不可亵渎的;不可违背的; [^]sat;
invocation: [-]/ˌɪnvəˈkeɪʃn/; [n]祈祷;咒语;(法权的)行驶; [^]sat;
invoke: [-]/ɪnˈvoʊk/; [v]调用,祈求,恳求,引起; [^]sat;
invulnerable: [-]/ɪnˈvʌlnərəbl/; [a]无法伤害的;无懈可击的; [^]sat;
irascible: [-]/ɪˈræsəbl/; [a]易怒的,性情暴躁的; [^]sat;
irate: [-]/aɪˈreɪt/; [a]发怒的,愤怒的; [^]sat;
iridescent: [-]/ˌɪrɪˈdesnt/; [a]彩虹色的;闪光的,闪色的; [^]sat;
irksome: [-]/ˈɜːrksəm/; [a]令人厌烦的,讨厌的; [^]sat;
ironic: [-]/aɪˈrɑːnɪk/; [a]讽刺的; [^]sat;
irony: [-]/ˈaɪrəni/; [n]反语;冷嘲;具有讽刺意味的事; [^]sat;
irrational: [-]/ɪˈræʃənl/; [a]无理性的,失去理性的; [^]sat;
irreconcilable: [-]/ɪˈrekənsaɪləbl/; [a]不能妥协的,不能和解的,不能协调的; [n]不能和解的人,(政治上的)死硬派; [^]sat;
irrelevant: [-]/ɪˈreləvənt/; [a]不相关的; [^]sat;
irremediable: [-]/ˌɪrɪˈmiːdiəbl/; [a]不能挽回的,不能补救的; [^]sat;
irreparable: [-]/ɪˈrepərəbl/; [a]不能修复的;不可弥补的; [^]sat;
irreproachable: [-]/ˌɪrɪˈproʊtʃəbl/; [a]不可指责的;无过失的;无缺点的; [^]sat;
irresolute: [-]/ɪˈrezəluːt/; [a]优柔寡断的;踌躇不定的; [^]sat;
irreverence: [-]/ɪˈrevərəns/; [n]无礼;不敬的行为; [a]不尊敬的; [^]sat;
irrevocable: [-]/ɪˈrevəkəbl/; [a]不可改变的;不能取消的;不能挽回的; [^]sat;
itinerant: [-]/aɪˈtɪnərənt/; [n]巡回工作者; [a]巡回的;流动的; [^]sat;
itinerary: [-]/aɪˈtɪnəreri/; [n]旅程,路线;旅行计划; [^]sat;
jabber: [-]/ˈdʒæbər/; [v]急急忙忙地说,急促不清地说; [n]急促不清地话,无意义的话; [^]sat;
jaded: [-]/ˈdʒeɪdɪd/; [a]疲倦的,精疲力竭的;厌倦的; [^]sat;
jargon: [-]/ˈdʒɑːrɡən/; [n]行话,术语;黄锆石; [^]sat;
jaunt: [-]/dʒɔːnt/; [v]远足;做短程游览; [n]短途游览; [^]sat;
jaunty: [-]/ˈdʒɔːnti/; [a]愉快的,满足的;斯文的;时髦的; [ad]心满意足地,洋洋得意地; [n]心满意足;洋洋得意; [^]sat;
jeopardize: [-]/ˈdʒepərdaɪz/; [v]危及,损害(也作jeopardise); [^]sat;
jettison: [-]/ˈdʒetɪsn/; [v]向外抛弃,投弃(船舶遇难时投弃货物以为减轻负载); [n]抛弃的货物; [^]sat;
jingoist: [-]/dʒɪŋɡə'ʊɪst/; [n]沙文主义者,侵略主义者; [^]sat;
jocose: [-]/dʒoʊˈkoʊs/; [a]开玩笑的,引人发笑的,诙谐的; [^]sat;
jocular: [-]/ˈdʒɑːkjələr/; [a]搞笑的,欢乐的; [^]sat;
jollity: [-]/ˈdʒɑːləti/; [n]欢乐,酒宴,欢庆; [^]sat;
jovial: [-]/ˈdʒoʊviəl/; [a]天性快活的,主神朱庇特的; [n]左威尔牌手表; [^]sat;
jubilation: [-]/ˌdʒuːbɪˈleɪʃn/; [n]喜悦,欢呼,庆祝; [^]sat;
judicious: [-]/dʒuˈdɪʃəs/; [a]有判断力的;明智的; [^]sat;
juncture: [-]/ˈdʒʌŋktʃər/; [n]连接;交接处,交界;关键时刻;形势; [^]sat;
junta: [-]/ˈhʊntə/; [n]团体,派别; [^]sat;
jurisprudence: [-]/ˌdʒʊrɪsˈpruːdns/; [n]法律学,法学,法律体系,法学分支; [^]sat;
kaleidoscope: [-]/kəˈlaɪdəskoʊp/; [n]万花筒;千变万化; [^]sat;
kernel: [-]/ˈkɜːrnl/; [n]子粒,谷粒;核心; [^]sat;
kindle: [-]/ˈkɪndl/; [v]点燃,激起;着火;照亮;煽动; [^]sat;
kindred: [-]/ˈkɪndrəd/; [n]亲戚,家族,亲属关系,相似; [a]有血缘关系的,同宗的,同源的,类似的; [^]sat;
kinetic: [-]/kɪˈnetɪk/; [a]运动的; [^]sat;
knave: [-]/neɪv/; [n]不诚实的人;无赖;<古>仆人;(纸牌中的)杰克; [^]sat;
knit: [-]/nɪt/; [v]编结,针织; [n]编织的衣服;针织衫; [^]sat;
knoll: [-]/noʊl/; [n]小圆丘,小山;土墩; [^]sat;
knotty: [-]/ˈnɑːti/; [a]有节疤的,有结的;棘手的; [^]sat;
kudos: [-]/ˈkuːdəʊs/; [n]荣誉;名望;称赞; [^]sat;
laborious: [-]/ləˈbɔːriəs/; [a]费时费力的,辛苦的;艰苦的; [^]sat;
labyrinth: [-]/ˈlæbərɪnθ/; [n]迷宫; [^]sat;
laceration: [-]/ˌlæsəˈreɪʃn/; [n]撕裂,割破,裂口,伤口,痛苦; [^]sat;
lachrymose: [-]/ˈlækrɪmoʊs/; [a]落泪的,好哭的;催泪的;悲哀的; [^]sat;
lackadaisical: [-]/ˌlækəˈdeɪzɪkl/; [a]懒散的,无精打采的;无兴趣的;伤感的; [^]sat;
lackluster: [-]/ˈlækˌlʌstər/; [n]无光泽;暗淡; [a]无光泽的;平凡的; [^]sat;
laconic: [-]/ləˈkɑːnɪk/; [a](用词)简洁的;简明的; [ad]简短地,简洁地; [^]sat;
laggard: [-]/ˈlæɡərd/; [a]缓慢的,落后的; [n]落后者;迟钝者; [^]sat;
lament: [-]/ləˈment/; [v]哀悼;惋惜;悲叹; [n]悲叹;悼词; [^]sat;
lampoon: [-]/læmˈpuːn/; [n]讽刺文章; [v]讽刺,写文章讽刺; [^]sat;
languid: [-]/ˈlæŋɡwɪd/; [a]没精打采的,倦怠的; [^]sat;
languish: [-]/ˈlæŋɡwɪʃ/; [v]凋萎,衰弱,变得消瘦; [^]sat;
languor: [-]/ˈlæŋɡər/; [n]身心疲惫;柔情;呆滞; [^]sat;
lap: [-]/læp/; [n]腰以下及大腿的前面部分;(跑道的)一圈; [v](赛跑中)比(某人)领先一圈;轻拍; [^]sat;
larceny: [-]/ˈlɑːrsəni/; [n]盗窃; [^]sat;
lassitude: [-]/ˈlæsɪtuːd/; [n]困乏,厌倦,无精打采; [^]sat;
latent: [-]/ˈleɪtnt/; [a]潜在的,隐伏的,不易察觉的; [^]sat;
lateral: [-]/ˈlætərəl/; [n]侧面部分;支线; [a]侧面的;横向的; [^]sat;
latitude: [-]/ˈlætɪtuːd/; [n]纬度;地区;(言论,行动的)自由; [^]sat;
laud: [-]/lɔːd/; [v]赞美,称赞; [^]sat;
lavish: [-]/ˈlævɪʃ/; [a]奢华的;铺张浪费的; [v]浪费;慷慨给予; [^]sat;
lax: [-]/læks/; [a]松懈的;松弛的;<语>松弛元音的; [n]松元音;泻肚; [^]sat;
leaven: [-]/ˈlevn/; [n]发酵剂,影响力; [v]发酵,影响,渐变; [^]sat;
lechery: [-]/ˈletʃəri/; [n]好色,纵欲; [^]sat;
leery: [-]/ˈlɪri/; [a]机警的,狡猾的; [^]sat;
legacy: [-]/ˈleɡəsi/; [n]遗赠(物);遗产; [^]sat;
legend: [-]/ˈledʒənd/; [n]传说,传奇人物;(奖章纪念牌等的)铭文;地图的图例,插图的说明; [^]sat;
legerdemain: [-]/ˈledʒərdəmeɪn/; [n]手法;骗术;巧妙的花招; [^]sat;
lethal: [-]/ˈliːθl/; [a]致命的,致死的;杀伤性的; [n]致死因子; [^]sat;
lethargic: [-]/ləˈθɑːrdʒɪk/; [a]困倦的,无力的,无兴趣的; [^]sat;
levitate: [-]/ˈlevɪteɪt/; [v](使)轻轻浮起,(使)飘浮空中; [^]sat;
levity: [-]/ˈlevəti/; [n]轻率,轻浮,多变,不稳定; [^]sat;
levy: [-]/ˈlevi/; [v]征收(税等); [n]征税;税款; [^]sat;
lewd: [-]/luːd/; [a]好色的,淫荡的,猥亵的; [^]sat;
lexicographer: [-]/ˌleksɪˈkɑːɡrəfər/; [n]词典编纂人; [^]sat;
lexicon: [-]/ˈleksɪkən/; [n]词典,语言,文字; [^]sat;
liability: [-]/ˌlaɪəˈbɪləti/; [n]责任;债务;倾向;可能性;不利因素;惹麻烦的人(或事); [^]sat;
liaison: [-]/ˈliːəzɑːn/; [n]联系,暧昧关系; [^]sat;
libel: [-]/ˈlaɪbl/; [n]诽谤,中伤,诋毁;毁坏名誉的东西;控诉书; [v]中伤;控告;对.进行诽谤; [^]sat;
liberator: [-]/ˈlɪbəreɪtər/; [n]解放者;释放者; [^]sat;
libretto: [-]/lɪˈbretoʊ/; [n]歌词,歌剧剧本,剧本,歌词集; [^]sat;
licentious: [-]/laɪˈsenʃəs/; [a]纵欲的,放肆的; [^]sat;
lilliputian: [-]/ˌlɪlɪˈpjuːʃn/; [a]小人国的,气量小的; [n]侏儒,小人国居民; [^]sat;
limber: [-]/ˈlɪmbər/; [a]松软的,柔软的;可塑的; [n](炮车的)拖车; [^]sat;
limerick: [-]/ˈlɪmərɪk/; [n]五行打油诗; [^]sat;
limpid: [-]/ˈlɪmpɪd/; [a]清澈的,透明的,平静的; [^]sat;
lineage: [-]/ˈlɪniɪdʒ/; [n]血统,世系,门第,宗族;传承; [^]sat;
linger: [-]/ˈlɪŋɡər/; [v]逗留,留恋; [^]sat;
linguistic: [-]/lɪŋˈɡwɪstɪk/; [a]语言的,语言上的; [^]sat;
lionize: [-]/ˈlaɪənaɪz/; [v]崇拜,把..奉为名人; [^]sat;
liquidate: [-]/ˈlɪkwɪdeɪt/; [vt]清理,清算,停业清理;清偿,清理,清算(破产的公司等),变卖,杀戮,废除; [^]sat;
listless: [-]/ˈlɪstləs/; [a]无精打采的,倦怠的,情绪低落的;冷漠的; [^]sat;
lithe: [-]/laɪð/; [a]轻盈的(等于lithesome);柔软的;易弯曲的; [^]sat;
litigation: [-]/ˌlɪtɪˈɡeɪʃn/; [n]诉讼;起诉; [^]sat;
livid: [-]/ˈlɪvɪd/; [a]气急败坏的,铅色的; [^]sat;
loath: [-]/loʊθ/; [a]不愿意的; [^]sat;
loathe: [-]/loʊð/; [v]憎恨,厌恶; [^]sat;
lofty: [-]/ˈlɔːfti/; [a]极高的,巍峨的;崇高的;高傲的; [^]sat;
log: [-]/lɔːɡ/; [n]原木;航海日志; [v]伐木;航行;记录;登录; [^]sat;
loiter: [-]/ˈlɔɪtər/; [v]虚度,闲荡,徘徊,走走停停; [^]sat;
loll: [-]/lɑːl/; [vi]懒洋洋地倚靠;闲荡; [vt]懒洋洋地倚靠着;使悬垂; [^]sat;
longevity: [-]/lɔːnˈdʒevəti/; [n]长寿,长命;寿命; [^]sat;
loom: [-]/luːm/; [n]织布机; [v]阴森地逼近;隐现;即将来临; [^]sat;
lope: [-]/loʊp/; [n]轻快的步伐,大步慢跑; [v]轻快地迈着大步; [^]sat;
lout: [-]/laʊt/; [n]粗人,笨拙的人; [^]sat;
lucid: [-]/ˈluːsɪd/; [a]明晰的;透明的;易懂的;头脑清楚的; [^]sat;
lucrative: [-]/ˈluːkrətɪv/; [a]合算的;获利的;有利可图的; [^]sat;
ludicrous: [-]/ˈluːdɪkrəs/; [a]荒谬的,可笑的,滑稽的; [^]sat;
lugubrious: [-]/ləˈɡuːbriəs/; [a]闷闷不乐的;郁郁寡欢的,悲哀的; [^]sat;
lull: [-]/lʌl/; [v]使平静,使安静,哄骗; [n]间歇,暂停,暂时平静; [^]sat;
lumber: [-]/ˈlʌmbər/; [v]缓慢地移动;拖累,迫使担负;伐木;杂乱地堆积;隆隆地行进; [n]木材;废旧家具,不用的大件物品;无用的杂物;隆隆声; [^]sat;
luminary: [-]/ˈluːmɪneri/; [n]杰出人物,发光体; [^]sat;
luminous: [-]/ˈluːmɪnəs/; [a]发光的;鲜艳的;明亮的;夜光的; [^]sat;
lunar: [-]/ˈluːnər/; [a]月亮的; [^]sat;
lunge: [-]/lʌndʒ/; [n]突然刺(入);突然向前冲〔扑等);套马索; [v](用剑等)刺,戳;猛向前冲,猛扑; [^]sat;
lurid: [-]/ˈlʊrɪd/; [a](暴力,性爱等)耸人听闻的; [^]sat;
lurk: [-]/lɜːrk/; [n]潜伏,潜行; [vi]潜伏;潜藏;鬼鬼祟祟地走; [^]sat;
luscious: [-]/ˈlʌʃəs/; [a]美味的;满足感官的; [^]sat;
luster: [-]/ˈlʌstər/; [n]光泽,光彩; [v](使)有光泽;发亮; [^]sat;
lustrous: [-]/ˈlʌstrəs/; [a]有光泽的;光辉的; [^]sat;
luxuriant: [-]/lʌɡˈʒʊriənt/; [a]繁茂的;多产的;绚烂的;奢华的; [^]sat;
madrigal: [-]/ˈmædrɪɡl/; [n]情歌,小曲; [^]sat;
maelstrom: [-]/ˈmeɪlstrɑːm/; [n]大漩涡;灾祸;不可抗的破坏力; [^]sat;
magnanimous: [-]/mæɡˈnænɪməs/; [a]宽宏大量的,大度的;慷慨的; [^]sat;
magnate: [-]/ˈmæɡneɪt/; [n]大人物;大亨,巨头;权贵; [^]sat;
magnitude: [-]/ˈmæɡnɪtuːd/; [n]巨大;震级;重要性;<数>量值; [^]sat;
maim: [-]/meɪm/; [v]使残废; [^]sat;
maladroit: [-]/ˌmæləˈdrɔɪt/; [a]笨拙的; [^]sat;
malady: [-]/ˈmælədi/; [n]疾病,弊病; [^]sat;
malaise: [-]/məˈleɪz/; [n]不舒服;心神不安; [^]sat;
malcontent: [-]/ˌmælkənˈtent/; [n]不满分子,反抗者; [a]不满的,不服的; [^]sat;
malediction: [-]/ˌmæləˈdɪkʃən/; [n]诅咒;坏话; [^]sat;
malefactor: [-]/ˈmælɪfæktər/; [n]罪犯,犯人; [^]sat;
malevolent: [-]/məˈlevələnt/; [a]有恶意的,恶毒的; [^]sat;
malicious: [-]/məˈlɪʃəs/; [a]怀恶意的,恶毒的; [^]sat;
malign: [-]/məˈlaɪn/; [v]诽谤,中伤; [a]邪恶的;有害的; [^]sat;
malignant: [-]/məˈlɪɡnənt/; [a]恶性的,恶毒的,充满恨意的; [n]怀有恶意的人;保王党员; [^]sat;
malleable: [-]/ˈmæliəbl/; [a](金属)可锻的;有延展性的;(性格)可训练的;易适应的; [^]sat;
malodorous: [-]/ˌmælˈoʊdərəs/; [a]有恶臭的;令人极为反感的;不合法的; [^]sat;
mammal: [-]/ˈmæml/; [n]哺乳动物; [^]sat;
mammoth: [-]/ˈmæməθ/; [n]长毛象,猛犸象,庞然大物; [a]巨大的,庞大的,猛犸似的; [^]sat;
mandate: [-]/ˈmændeɪt/; [n]授权;命令,指令;委托管理;受命进行的工作; [v]授权;托管; [^]sat;
mandatory: [-]/ˈmændətɔːri/; [a]命令的,强制性的; [^]sat;
manifest: [-]/ˈmænɪfest/; [a]显然的,明白无误的,明了的; [v]使显现,使显露,表明; [n]货单,旅客名单; [^]sat;
manifesto: [-]/ˌmænɪˈfestoʊ/; [n]宣言,声明;告示; [v]发表宣言; [^]sat;
manipulate: [-]/məˈnɪpjuleɪt/; [v]操纵,影响;正骨; [^]sat;
mannered: [-]/ˈmænərd/; [a]装模作样的,矫揉造作的,墨守成规的,中规中矩的; [^]sat;
marital: [-]/ˈmærɪtl/; [a]婚姻的; [^]sat;
maritime: [-]/ˈmærɪtaɪm/; [a]海事的,海上的,沿海的,近海的;海员的,水手的; [^]sat;
marked: [-]/mɑːrkt/; [a]有记号的;显著的;被监视的;引人注目的; [v]作记号; [^]sat;
marquee: [-]/mɑːrˈkiː/; [n]选取框;大天幕;华盖; [a]〈美〉最重要的; [^]sat;
marshal: [-]/ˈmɑːrʃl/; [v]整理,排列,集结; [n]元帅;司仪,主持人; [^]sat;
marsupial: [-]/mɑːrˈsuːpiəl/; [n]有袋哺乳动物(袋鼠,袋熊,袋狼); [^]sat;
martial: [-]/ˈmɑːrʃl/; [a]武术的;好战的;军事的; [^]sat;
martinet: [-]/ˌmɑːrtnˈet/; [n]纪律严明之人; [^]sat;
martyr: [-]/ˈmɑːrtər/; [n]烈士;受难者;乞怜者; [v]迫害,折磨; [^]sat;
material: [-]/məˈtɪriəl/; [n]材料,原料,资料; [a]物质的,实体的; [^]sat;
materialism: [-]/məˈtɪriəlɪzəm/; [n]唯物主义,物质主义; [^]sat;
maternal: [-]/məˈtɜːrnl/; [a]母亲的,母性的;母方的,母系的; [^]sat;
matriculate: [-]/məˈtrɪkjuleɪt/; [n]被录取者; [v]准许.入学; [^]sat;
maudlin: [-]/ˈmɔːdlɪn/; [a]感情脆弱的;容易流泪的;酒后伤感的; [^]sat;
maverick: [-]/ˈmævərɪk/; [n]独行者,想法与众不同的人; [a]行为不合常规的; [v]用不正当手段获取;迷路; [^]sat;
mawkish: [-]/ˈmɔːkɪʃ/; [a]令人厌恶的,伤感的; [^]sat;
maxim: [-]/ˈmæksɪm/; [n]格言;准则;座右铭; [^]sat;
meager: [-]/ˈmiːɡər/; [a]瘦的;贫乏的;粗劣的;少量的; [^]sat;
meander: [-]/miˈændər/; [n]蜿蜒曲折,迂回曲折的旅程;漫步; [v]迂回曲折;漫步;漫谈; [^]sat;
meddlesome: [-]/ˈmedlsəm/; [a]爱管闲事的,好事的,好插手的; [^]sat;
mediate: [-]/ˈmiːdieɪt/; [v]调解,调停,斡旋; [^]sat;
mediocre: [-]/ˌmiːdiˈoʊkər/; [a]普通的;平凡的;中等的; [^]sat;
meditation: [-]/ˌmedɪˈteɪʃn/; [n]沉思,冥想; [^]sat;
medley: [-]/ˈmedli/; [a]大杂烩,混合物; [n]混合;混杂;混合物; [^]sat;
meek: [-]/miːk/; [a]温顺的,逆来顺受的;谦恭的; [n]温顺的人;谦恭的人; [^]sat;
melancholy: [-]/ˈmelənkɑːli/; [n]忧郁,悲哀; [a]忧郁的,令人伤感的; [^]sat;
mellifluous: [-]/meˈlɪfluəs/; [a](曲调)优美的;流畅的;如蜜般的; [^]sat;
membrane: [-]/ˈmembreɪn/; [n]膜;薄膜;羊皮纸; [^]sat;
memento: [-]/məˈmentoʊ/; [n]纪念品; [^]sat;
menagerie: [-]/məˈnædʒəri/; [n]形形色色,动物园,野生动物(总称); [^]sat;
mendacious: [-]/menˈdeɪʃəs/; [a]撒谎的,虚假的; [^]sat;
menial: [-]/ˈmiːniəl/; [a]仆人的,乏味的; [n]家仆; [^]sat;
mentor: [-]/ˈmentɔːr/; [n]导师,指导; [vt]做.的良师;指导; [^]sat;
mercenary: [-]/ˈmɜːrsəneri/; [n]外国雇佣兵;唯利是图者; [a]唯利是图的;雇佣的; [^]sat;
mercurial: [-]/mɜːrˈkjʊriəl/; [a](情绪)善变的; [^]sat;
merger: [-]/ˈmɜːrdʒər/; [n](企业等的)合并;并购;吸收(如刑法中重罪吸收轻罪); [^]sat;
mesmerize: [-]/ˈmezməraɪz/; [v]施催眠术;吸引,使神魂颠倒; [^]sat;
metamorphosis: [-]/ˌmetəˈmɔːrfəsɪs/; [n]变形,变质,变异;<生物学>变态; [^]sat;
metaphor: [-]/ˈmetəfər/; [n]暗喻,隐喻; [^]sat;
metaphysical: [-]/ˌmetəˈfɪzɪkl/; [a]形而上学的;超自然的;玄学派诗歌的; [^]sat;
methodical: [-]/məˈθɑːdɪkl/; [a]有系统的,有方法的; [^]sat;
meticulous: [-]/məˈtɪkjələs/; [a]谨小慎微的;一丝不苟的; [^]sat;
metropolis: [-]/məˈtrɑːpəlɪs/; [n]大城市; [^]sat;
mettle: [-]/ˈmetl/; [n]勇气,毅力,耐力; [^]sat;
microcosm: [-]/ˈmaɪkroʊkɑːzəm/; [n]微观世界,缩影; [^]sat;
migrant: [-]/ˈmaɪɡrənt/; [n]候鸟;移民; [^]sat;
migratory: [-]/ˈmaɪɡrətɔːri/; [a]迁移的;流浪的; [^]sat;
milieu: [-]/mɪlˈjuː/; [n]周围环境;背景;周围;出身背景; [^]sat;
militant: [-]/ˈmɪlɪtənt/; [a]好战的,好暴力的; [n]激进分子,斗士; [^]sat;
mimicry: [-]/ˈmɪmɪkri/; [n]模仿;拟态; [^]sat;
minuscule: [-]/ˈmɪnəskjuːl/; [a]极小的,微型的; [^]sat;
mirage: [-]/məˈrɑːʒ/; [n]幻影,海市蜃楼; [^]sat;
mire: [-]/ˈmaɪər/; [n]泥沼,困境; [^]sat;
mirth: [-]/mɜːrθ/; [n]欢乐,欢笑; [^]sat;
misanthrope: [-]/ˈmɪsənθroʊp/; [n]愤世嫉俗者;厌世者;厌恶人类的人; [^]sat;
misapprehension: [-]/ˌmɪsæprɪˈhenʃn/; [n]错误的理解,错误的判断; [^]sat;
miscellany: [-]/ˈmɪsəleɪni/; [n]混合物,混杂; [^]sat;
mischance: [-]/ˌmɪsˈtʃæns/; [n]不幸,灾难; [^]sat;
misconception: [-]/ˌmɪskənˈsepʃn/; [n]误解;错误想法; [^]sat;
misconstrue: [-]/ˌmɪskənˈstruː/; [v]误解,曲解; [^]sat;
misdemeanor: [-]/ˌmɪsdɪ'miːnə/; [n]轻罪,品行不端; [^]sat;
miserly: [-]/ˈmaɪzərli/; [a]贪财的,吝啬的; [^]sat;
mishap: [-]/ˈmɪshæp/; [n]不幸的事,灾祸;晦气; [^]sat;
misrepresent: [-]/ˌmɪsˌreprɪˈzent/; [vi]作虚假陈述; [vt]歪曲;误传; [^]sat;
missile: [-]/ˈmɪsl/; [n]导弹;投射出的物体或武器; [a]导弹的;可投掷的;用以发射导弹的; [^]sat;
missive: [-]/ˈmɪsɪv/; [n]公文,公函; [a]送出的; [^]sat;
mite: [-]/maɪt/; [n]极小量,小虫; [^]sat;
mitigate: [-]/ˈmɪtɪɡeɪt/; [v]减轻,缓和; [^]sat;
mobile: [-]/ˈmoʊbl/; [n]风铃,悬挂饰物;手机,移动电话; [a]可移动的;行动方便的; [^]sat;
mock: [-]/mɑːk/; [v]嘲笑;轻蔑,蔑视; [a]不真诚的;伪造的; [n]模拟考; [^]sat;
mode: [-]/moʊd/; [n]模式;方式; [^]sat;
modulate: [-]/ˈmɑːdʒəleɪt/; [v]调整(音调);变调;调节(使平衡); [^]sat;
molecule: [-]/ˈmɑːlɪkjuːl/; [n]分子,微粒; [^]sat;
mollify: [-]/ˈmɑːlɪfaɪ/; [v]安慰,安抚; [^]sat;
molt: [-]/moʊlt/; [v]脱毛,换毛; [n]换羽期,脱毛期; [^]sat;
molten: [-]/ˈmoʊltən/; [a]熔化的; [^]sat;
momentum: [-]/moʊˈmentəm/; [n](物理)动量;势头;动力; [^]sat;
monarchy: [-]/ˈmɑːnərki/; [n]君主,最高统治者;君主政体;君主国; [^]sat;
monastic: [-]/məˈnæstɪk/; [n]僧侣; [a]修道院的,寺院的;僧侣的;克己的; [^]sat;
monetary: [-]/ˈmɑːnɪteri/; [a]货币的,金融的;金钱的; [^]sat;
monochromatic: [-]/ˌmɑːnəkroʊˈmætɪk/; [a]<物>单色的; [^]sat;
monolithic: [-]/ˌmɑːnəˈlɪθɪk/; [a]巨石的,庞大的;千篇一律的; [^]sat;
monotony: [-]/məˈnɑːtəni/; [n]单调乏味,无聊;无变化; [^]sat;
montage: [-]/ˌmɑːnˈtɑːʒ/; [n]蒙太奇(电影的基本结构手段和叙事方式),混合画,拼集的照片; [^]sat;
monumental: [-]/ˌmɑːnjuˈmentl/; [a]纪念碑的;不朽的;非常的; [^]sat;
moratorium: [-]/ˌmɔːrəˈtɔːriəm/; [n]暂停,中止;<金融>延期偿付; [^]sat;
morbid: [-]/ˈmɔːrbɪd/; [a]疾病的;(精神等)病态的;恐怖的; [^]sat;
mores: [-]/ˈmɔːreɪz/; [n]风俗习惯,道德观念; [^]sat;
moribund: [-]/ˈmɔːrɪbʌnd/; [a]濒临失败的,垂死的; [n]垂死的人; [^]sat;
morose: [-]/məˈroʊs/; [a]脾气坏的,乖戾的,不高兴的; [^]sat;
mortician: [-]/mɔːrˈtɪʃn/; [n]丧事承办人; [^]sat;
mortify: [-]/ˈmɔːrtɪfaɪ/; [v]使屈辱;抑制;苦修;约束; [^]sat;
mosaic: [-]/moʊˈzeɪɪk/; [n]镶嵌细工,马赛克; [a]摩西的;拼花的; [vt]镶嵌;用马赛克装饰; [^]sat;
mote: [-]/moʊt/; [n]微粒,微尘; [^]sat;
motif: [-]/moʊˈtiːf/; [n]基本图案;主题,中心思想,<音>乐旨; [^]sat;
motley: [-]/ˈmɑːtli/; [a]混杂的,杂色的; [n]混杂;杂色衣服;小丑; [^]sat;
mottled: [-]/ˈmɑːtld/; [a]有杂色的,斑驳的; [^]sat;
muddle: [-]/ˈmʌdl/; [n]混乱,杂乱,(头脑的)糊涂; [v](使)混乱,(使)迷惑,混淆; [a]引起困惑的;使人糊涂的;难以理解的; [^]sat;
muggy: [-]/ˈmʌɡi/; [a](天气)闷热而潮湿的; [^]sat;
multifaceted: [-]/ˌmʌltiˈfæsɪtɪd/; [a]多层面的; [^]sat;
multifarious: [-]/ˌmʌltɪˈferiəs/; [a]多种的,各式各样的; [^]sat;
multilingual: [-]/ˌmʌltiˈlɪŋɡwəl/; [n]懂多种语言的人; [a]使用多种语言的,懂几国文字的; [^]sat;
multiplicity: [-]/ˌmʌltɪˈplɪsəti/; [n]多样性;许多,大量; [^]sat;
mundane: [-]/mʌnˈdeɪn/; [a]普通的,平凡的;单调的;现世的,世俗的; [^]sat;
munificent: [-]/mjuːˈnɪfɪsnt/; [a]慷慨的,大方的; [^]sat;
mural: [-]/ˈmjʊrəl/; [n]壁画;壁饰; [a]墙壁的;挂在墙壁上的; [^]sat;
murky: [-]/ˈmɜːrki/; [a]黑暗的,朦胧的; [ad]阴暗地,混浊地,可疑地; [n]阴暗;昏暗;混浊;可疑; [^]sat;
muse: [-]/mjuːz/; [v]沉思;冥想; [n]<希神>缪斯女神,灵感; [^]sat;
mushroom: [-]/ˈmʌʃrʊm/; [n]蘑菇; [vi]迅速发展;采蘑菇; [^]sat;
muster: [-]/ˈmʌstər/; [vi]集合;聚集; [vt]集合;召集; [n]集合;集合人员; [^]sat;
mutinous: [-]/ˈmjuːtənəs/; [a]加入叛变的,反抗的; [^]sat;
myopic: [-]/maɪˈɑːpɪk/; [n]近视; [a]近视的;目光短浅的; [^]sat;
myriad: [-]/ˈmɪriəd/; [n]无数;极大数量; [a]无数的; [^]sat;
mystify: [-]/ˈmɪstɪfaɪ/; [v]使神秘化,使迷惑,使困惑; [^]sat;
nadir: [-]/ˈneɪdɪr/; [n]最低点,无底; [^]sat;
narrative: [-]/ˈnærətɪv/; [n]叙述; [a]叙述的; [^]sat;
nascent: [-]/ˈnæsnt/; [a]初生的,萌芽的;发生中的; [^]sat;
natty: [-]/ˈnæti/; [a]整洁的,干净的,潇洒的; [^]sat;
nauseate: [-]/ˈnɔːzieɪt/; [v]使作呕,产生恶感; [^]sat;
nautical: [-]/ˈnɔːtɪkl/; [a]航海的;海上的;海员的; [^]sat;
navigable: [-]/ˈnævɪɡəbl/; [a](江河,海洋)可航行的,可通航的;(船)适航的; [^]sat;
nebulous: [-]/ˈnebjələs/; [a]朦胧的,星云的,星云状的; [^]sat;
necromancy: [-]/ˈnekroʊmænsi/; [n]巫术,通灵术; [^]sat;
nefarious: [-]/nɪˈferiəs/; [a]违法的,邪恶的; [^]sat;
negate: [-]/nɪˈɡeɪt/; [vt]取消,使无效;否定,否认; [n]反面,对立面; [vi]否定,否认; [^]sat;
negligence: [-]/ˈneɡlɪdʒəns/; [n]疏忽; [^]sat;
negligible: [-]/ˈneɡlɪdʒəbl/; [a]微不足道的,可忽略不计的; [^]sat;
nemesis: [-]/ˈneməsɪs/; [n]报应,天罚,主要敌人,强硬对手; [^]sat;
neologism: [-]/niˈɑːlədʒɪzəm/; [n]新生词; [^]sat;
neophyte: [-]/ˈniːəfaɪt/; [n]新信徒;新入教者;初学者; [^]sat;
nepotism: [-]/ˈnepətɪzəm/; [n]偏袒的人(亲戚); [^]sat;
nettle: [-]/ˈnetl/; [v]刺激;惹恼;用荨麻刺; [n]荨麻; [^]sat;
neutral: [-]/ˈnuːtrəl/; [a]中立的;中性的; [n]中立国;中性色; [^]sat;
nicety: [-]/ˈnaɪsəti/; [n]细节,讲究; [^]sat;
nip: [-]/nɪp/; [v]咬;捏;剪断;冻伤;阻止; [n]夹;捏;刺骨;小饮; [^]sat;
nirvana: [-]/nɪrˈvɑːnə/; [n]涅槃,心灵的平静,极乐; [^]sat;
nocturnal: [-]/nɑːkˈtɜːrnl/; [a]夜晚的,夜间发生的; [^]sat;
noisome: [-]/ˈnɔɪsəm/; [a]恶臭的;令人不快的; [^]sat;
nomadic: [-]/noʊˈmædɪk/; [a]游牧的;流浪的;游动的; [^]sat;
nomenclature: [-]/ˈnoʊmənkleɪtʃər/; [n]术语,命名系统; [^]sat;
nominal: [-]/ˈnɑːmɪnl/; [a]名义上的;象征性的,很少的;名词性的; [^]sat;
nonchalance: [-]/ˌnɑːnʃəˈlɑːns/; [n]无动于衷,冷淡; [^]sat;
noncommittal: [-]/ˌnɒnkə'mɪtəl/; [a]态度不明朗的;不承担义务的;无明确意义的; [^]sat;
nondescript: [-]/ˈnɑːndɪskrɪpt/; [a]没有特征的,难以形容的,难以归类的; [n]难以名状,不属任何型类的人; [^]sat;
nonentity: [-]/nɑːˈnentəti/; [n]不存在,虚无;无能力之人,无足轻重的人; [^]sat;
nonplus: [-]/ˌnɒn'plʌs/; [v]使窘困;使迷惑;狼狈不堪; [n]迷惑,困惑; [^]sat;
nostalgia: [-]/nəˈstældʒə/; [n]怀旧之情,思乡病; [^]sat;
notable: [-]/ˈnoʊtəbl/; [n]著名人士; [a]值得注意的,显著的,显要的; [^]sat;
novelty: [-]/ˈnɑːvlti/; [n]新奇;新奇的事物;新颖小巧而廉价的小物品; [a]新奇的;风格独特的; [^]sat;
novice: [-]/ˈnɑːvɪs/; [n]生手,新手; [^]sat;
noxious: [-]/ˈnɑːkʃəs/; [a]有害的,有毒的; [^]sat;
nuance: [-]/ˈnuːɑːns/; [n]细微差别; [^]sat;
nullify: [-]/ˈnʌlɪfaɪ/; [v]使无效,废弃,取消; [^]sat;
numismatist: [-]/nuːˈmɪzmətɪst/; [n]钱币学家,钱币收藏家; [^]sat;
nuptial: [-]/ˈnʌpʃl/; [a]婚姻的,婚礼的; [n]婚礼; [^]sat;
nurture: [-]/ˈnɜːrtʃər/; [v]养育,培育;培植; [n]养育,培养;教养;营养物; [^]sat;
nutrient: [-]/ˈnuːtriənt/; [n]营养物;滋养物; [a]营养的;滋养的; [^]sat;
oaf: [-]/oʊf/; [n]愚蠢的人; [^]sat;
obdurate: [-]/ˈɑːbdərət/; [a]固执的,冷酷无情的; [^]sat;
obese: [-]/oʊˈbiːs/; [a]肥胖的;过胖的; [^]sat;
obfuscate: [-]/ˈɑːbfʌskeɪt/; [v]使复杂;使迷乱,使模糊;弄暗; [^]sat;
obituary: [-]/oʊˈbɪtʃueri/; [n]讣告; [a]关于死者的,讣告的; [^]sat;
objective: [-]/əbˈdʒektɪv/; [n]目标;目的; [a]客观的; [^]sat;
obligatory: [-]/əˈblɪɡətɔːri/; [a]强制性的;义务的;必须的; [^]sat;
oblique: [-]/əˈbliːk/; [a]斜的,非直角的,隐射的; [v]倾斜; [n]<解>斜肌(尤指腹部的肌肉);倾斜物;<军>倾斜航空照片; [ad]<军>以45度角; [^]sat;
obliterate: [-]/əˈblɪtəreɪt/; [v]消灭;涂去;冲刷;忘掉; [^]sat;
oblivious: [-]/əˈblɪviəs/; [a]不在意的;忘却的,健忘的; [^]sat;
obnoxious: [-]/əbˈnɑːkʃəs/; [a]非常讨厌的;可憎的; [^]sat;
obscure: [-]/əbˈskjʊr/; [v]隐藏,使.模糊;使变暗;遮掩; [a]不清楚的;难以理解的; [n]某种模糊的或不清楚的东西; [^]sat;
obsequious: [-]/əbˈsiːkwiəs/; [a]逢迎的,谄媚的; [^]sat;
obsessive: [-]/əbˈsesɪv/; [a]强迫性的;着迷的;分神的; [n]强迫症患者; [^]sat;
obsolete: [-]/ˌɑːbsəˈliːt/; [a]已过时的;已废弃的; [v]使过时;使作废; [n]废词;被废弃的事物; [^]sat;
obstetrician: [-]/ˌɑːbstəˈtrɪʃn/; [n]产科医师; [^]sat;
obstinate: [-]/ˈɑːbstɪnət/; [a]顽固的;较难治愈的; [^]sat;
obstreperous: [-]/əbˈstrepərəs/; [a]吵闹的,喧嚣的;难驾驭的; [^]sat;
obtuse: [-]/əbˈtuːs/; [a]迟钝的;圆头的;不锋利的; [^]sat;
obviate: [-]/ˈɑːbvieɪt/; [v]排除,避免,消除; [^]sat;
odious: [-]/ˈoʊdiəs/; [a]可憎的,讨厌的; [ad]令人作呕地; [n]可憎,讨厌; [^]sat;
odium: [-]/ˈoʊdiəm/; [n]憎恶,反感; [^]sat;
odyssey: [-]/ˈɑːdəsi/; [n]长途冒险旅行;一连串的冒险;奥德赛; [^]sat;
offensive: [-]/əˈfensɪv/; [a]冒犯的,进攻的,无礼的,令人不快的,得罪人的; [n]进攻; [^]sat;
officious: [-]/əˈfɪʃəs/; [a]多管闲事的,非官方的; [ad]过分殷勤地; [n]过分殷勤,爱管闲事; [^]sat;
ogle: [-]/ˈoʊɡl/; [v]送秋波,施媚眼; [n]秋波,媚眼; [^]sat;
olfactory: [-]/ɑːlˈfæktəri/; [a]嗅觉的; [^]sat;
oligarchy: [-]/ˈɑːləɡɑːrki/; [n]寡头政治; [^]sat;
ominous: [-]/ˈɑːmɪnəs/; [a]不祥的,不吉利的; [^]sat;
omnipotent: [-]/ɑːmˈnɪpətənt/; [a]全能的,万能的; [n]全能者; [^]sat;
omnipresent: [-]/ˌɑːmnɪˈpreznt/; [a]无所不在的; [^]sat;
omniscient: [-]/ɑːmˈnɪsiənt/; [a]无所不知的,博识的; [n]无所不知者,上帝; [^]sat;
omnivorous: [-]/ɑːmˈnɪvərəs/; [a]杂食的,兴趣广泛的; [^]sat;
onerous: [-]/ˈɑːnərəs/; [a]繁重的,麻烦的;负有义务的;负有法律责任的; [^]sat;
onset: [-]/ˈɑːnset/; [n]开始;攻击,袭击; [^]sat;
onus: [-]/ˈoʊnəs/; [n]义务,责任,负担; [^]sat;
opalescent: [-]/ˌoʊpəˈlesnt/; [a]乳白色的;发乳白光的; [^]sat;
opaque: [-]/oʊˈpeɪk/; [a]不透明的;难懂的; [^]sat;
opiate: [-]/ˈoʊpiət/; [n]鸦片制剂,麻醉剂,镇静剂; [a]含鸦片的,安眠的; [v]用鸦片麻醉,使缓和; [^]sat;
opportune: [-]/ˌɑːpərˈtuːn/; [a]适当的,恰好的,合时宜的; [^]sat;
opportunist: [-]/ˌɑːpərˈtuːnɪst/; [n]机会主义者;投机取巧者; [a]机会主义的;投机的;见风转舵的; [^]sat;
optician: [-]/ɑːpˈtɪʃn/; [n]光学仪器商,眼镜商; [^]sat;
optimist: [-]/ˈɑːptɪmɪst/; [n]乐天派,乐观者; [^]sat;
optimum: [-]/ˈɑːptɪməm/; [a]最适宜的;最佳的; [n]最适条件;最适宜; [^]sat;
optional: [-]/ˈɑːpʃənl/; [a]可选择的; [^]sat;
opulence: [-]/ˈɑːpjələns/; [n]富裕,丰富; [^]sat;
opus: [-]/ˈoʊpəs/; [n]作品; [^]sat;
oracular: [-]/əˈrækjələr/; [a]神谕的,意义模糊的,玄妙深奥的; [^]sat;
orator: [-]/ˈɔːrətər/; [n]演说者,演讲者,雄辩家,原告; [^]sat;
ordain: [-]/ɔːrˈdeɪn/; [v]注定;规定;任命(牧师);颁布命令; [^]sat;
ordeal: [-]/ɔːrˈdiːl/; [n]严峻考验,苦难的经历,折磨; [^]sat;
ordinance: [-]/ˈɔːrdɪnəns/; [n]法令;条例;条例;圣餐式; [^]sat;
ordination: [-]/ˌɔːrdnˈeɪʃn/; [n]神职授任; [^]sat;
orgy: [-]/ˈɔːrdʒi/; [n]狂欢;放荡; [^]sat;
orient: [-]/ˈɔːrient/; [n][the Orient]东方; [v]定..的方位; [a]东方的;(太阳等)上升的,新生的;闪闪发光的; [^]sat;
orientation: [-]/ˌɔːriənˈteɪʃn/; [n]信仰;倾向;<计>定向;(学生)迎新会;定向,方向;(任职,上学等之前的) 情况介绍;训练; [^]sat;
ornate: [-]/ɔːrˈneɪt/; [a]装饰华丽的;修辞上极考究的; [^]sat;
ornithologist: [-]/ˌɔːrnɪˈθɑːlədʒɪst/; [n]鸟类学者; [^]sat;
ornithology: [-]/ˌɔːrnɪˈθɑːlədʒi/; [n]鸟类学;鸟学论文; [^]sat;
orthodox: [-]/ˈɔːrθədɑːks/; [a]正统的;传统的;(Orthodox)东正教的; [^]sat;
oscillate: [-]/ˈɑːsɪleɪt/; [v]摆动,犹豫; [^]sat;
ossify: [-]/ˈɑːsɪfaɪ/; [v]硬化,骨化; [^]sat;
ostensible: [-]/ɑːˈstensəbl/; [a]表面上的,伪装的; [^]sat;
ostentatious: [-]/ˌɑːstenˈteɪʃəs/; [a]浮华的,虚饰的,外观美丽的; [^]sat;
ostracize: [-]/ˈɑːstrəsaɪz/; [v]放逐,排斥,(古希腊)按贝壳流放法放逐; [^]sat;
oust: [-]/aʊst/; [v]罢免,驱逐,剥夺,取代; [^]sat;
outlandish: [-]/aʊtˈlændɪʃ/; [a]稀奇古怪的,奇特的;异国风情的; [^]sat;
outmoded: [-]/ˌaʊtˈmoʊdɪd/; [a]不再流行的,过时的; [^]sat;
outskirts: [-]/ˈaʊtskɜːrts/; [n](尤指城市)郊区; [^]sat;
outspoken: [-]/aʊtˈspoʊkən/; [a]直言的,坦率的; [^]sat;
outstrip: [-]/ˌaʊtˈstrɪp/; [v]比.优越,胜过,比.跑得快; [^]sat;
outwit: [-]/ˌaʊtˈwɪt/; [v]以机智胜过; [^]sat;
ovation: [-]/oʊˈveɪʃn/; [n]热烈欢迎,欢呼; [^]sat;
overbearing: [-]/ˌoʊvərˈberɪŋ/; [a]专横的,独断的,傲慢的; [^]sat;
overt: [-]/oʊˈvɜːrt/; [a]明显的;公开的;公然的; [^]sat;
overwrought: [-]/ˌoʊvərˈrɔːt/; [a]过分紧张的,过度兴奋的; [^]sat;
pachyderm: [-]/ˈpækidɜːrm/; [n]迟钝的人;厚脸皮的人;厚皮类动物; [^]sat;
pacifist: [-]/ˈpæsɪfɪst/; [n]和平主义者; [a]非战主义的; [^]sat;
pacify: [-]/ˈpæsɪfaɪ/; [v]使平静,安慰,抚慰; [^]sat;
pact: [-]/pækt/; [n]合同;协约; [^]sat;
paean: [-]/ˈpiːən/; [n]欢乐颂,赞美歌; [^]sat;
painstaking: [-]/ˈpeɪnzteɪkɪŋ/; [a](不辞)劳苦的,辛勤的; [n]辛劳,煞费苦心; [^]sat;
palatable: [-]/ˈpælətəbl/; [a]美味的,合口味的,合心意的; [^]sat;
palette: [-]/ˈpælət/; [n]调色板,一套颜料; [^]sat;
pall: [-]/pɔːl/; [n]幕;棺罩;遮盖物; [v]覆盖;使乏味;走味; [^]sat;
palliate: [-]/ˈpælieɪt/; [v]减轻,掩饰,辩解; [^]sat;
pallid: [-]/ˈpælɪd/; [a]苍白的,病态的,无生气的; [^]sat;
palpable: [-]/ˈpælpəbl/; [a]明显的,易觉察的,可触知的; [^]sat;
palpitate: [-]/ˈpælpɪteɪt/; [v](心脏)悸动,发抖; [^]sat;
paltry: [-]/ˈpɔːltri/; [a]不足取的,无价值的,琐碎的,卑鄙的; [^]sat;
pan: [-]/pæn/; [n]平底锅; [v]严厉批评;淘金; [^]sat;
panacea: [-]/ˌpænəˈsiːə/; [n]灵丹妙药,万能药; [^]sat;
panache: [-]/pəˈnæʃ/; [n]羽饰,神气十足; [^]sat;
pandemic: [-]/pænˈdemɪk/; [a]全国流行的;普遍的; [^]sat;
pandemonium: [-]/ˌpændəˈmoʊniəm/; [n]地狱,混乱; [^]sat;
panegyric: [-]/ˌpænəˈdʒɪrɪk/; [n]颂词,赞词; [^]sat;
panoramic: [-]/ˌpænəˈræmɪk/; [a]全景的; [^]sat;
pantomime: [-]/ˈpæntəmaɪm/; [n]哑剧,〈英〉(圣诞节上演的)童话剧; [vi]打手势,演哑剧; [^]sat;
papyrus: [-]/pəˈpaɪrəs/; [n]纸莎草;纸莎草纸; [^]sat;
parable: [-]/ˈpærəbl/; [n]寓言,比喻; [^]sat;
paradigm: [-]/ˈpærədaɪm/; [n]范例,示范; [^]sat;
paradox: [-]/ˈpærədɑːks/; [n]矛盾;似矛盾而正确的说法; [^]sat;
paragon: [-]/ˈpærəɡɑːn/; [n]模范;完美之物;优秀之人; [a]完美的; [^]sat;
paramount: [-]/ˈpærəmaʊnt/; [n]元首;最高; [a]最高的,至上的,首要的; [^]sat;
paranoia: [-]/ˌpærəˈnɔɪə/; [n](心理)偏执狂,多疑症; [^]sat;
paraphrase: [-]/ˈpærəfreɪz/; [v]解释,释义; [n]转述,释义; [^]sat;
parasite: [-]/ˈpærəsaɪt/; [n]寄生虫;靠他人为生的人; [^]sat;
parched: [-]/pɑːrtʃt/; [a]干旱的,干渴的; [^]sat;
pariah: [-]/pəˈraɪə/; [n]被排斥或鄙视的人; [^]sat;
parity: [-]/ˈpærəti/; [n]相等;同等;平价; [^]sat;
parochial: [-]/pəˈroʊkiəl/; [a]教区的;地方范围的; [^]sat;
parody: [-]/ˈpærədi/; [n]嘲弄文章,拙劣的模仿; [v]拙劣模仿; [^]sat;
paroxysm: [-]/ˈpærəksɪzəm/; [n]突发,阵发; [a]发作性的,爆发性的; [^]sat;
parry: [-]/ˈpæri/; [v]挡开,避开(武器,问题等); [^]sat;
partial: [-]/ˈpɑːrʃl/; [a]偏爱的,特别喜欢的;偏袒的,不公平的,有偏见的;部分的;不完全的; [n]<数学>偏微商; [^]sat;
partisan: [-]/ˈpɑːrtəzn/; [a]党派的;效忠的;偏袒的;盲目推崇的; [n]党羽;虔诚信徒;游击队; [^]sat;
partition: [-]/pɑːrˈtɪʃn/; [n]划分;隔开物,隔墙,隔板; [v]隔开; [vt]瓜分;分割; [^]sat;
passive: [-]/ˈpæsɪv/; [a]被动的;消极的; [n]被动语态; [^]sat;
pastoral: [-]/ˈpæstərəl/; [a]田园生活的,牧师的; [n]牧歌;田园诗;田园景色;牧师写给教区居民的公开信; [^]sat;
patent: [-]/ˈpætnt/; [n]专利; [a]显然的,明显的;专利的;独创的; [v]取得.的专利权; [^]sat;
pathetic: [-]/pəˈθetɪk/; [a]可怜的;不足的; [^]sat;
pathological: [-]/ˌpæθəˈlɑːdʒɪkl/; [a]病理学的;病态的;由疾病引起的(等于pathologic); [^]sat;
pathos: [-]/ˈpeɪθɑːs/; [n]悲怆,哀婉;痛苦; [^]sat;
patina: [-]/pəˈtiːnə/; [n]绿锈,光亮的外表,神态,圣餐盘; [^]sat;
patriarch: [-]/ˈpeɪtriɑːrk/; [n]家长;族长;创办人;最年长者; [^]sat;
patrician: [-]/pəˈtrɪʃn/; [n]贵族; [a]贵族的;显贵的;(相貌等)贵族似的; [^]sat;
patronize: [-]/ˈpeɪtrənaɪz/; [v]惠顾;赞助,资助; [^]sat;
paucity: [-]/ˈpɔːsəti/; [n]小量,缺乏; [^]sat;
pauper: [-]/ˈpɔːpər/; [n]贫民,乞丐; [^]sat;
pecuniary: [-]/pɪˈkjuːnieri/; [a]金钱(上)的; [^]sat;
pedagogy: [-]/ˈpedəɡɑːdʒi/; [n]教育学,教学法; [^]sat;
pedant: [-]/ˈpednt/; [n]学究式人物,书呆子,卖弄学问的人; [^]sat;
pedestrian: [-]/pəˈdestriən/; [n]步行者,行人; [a]步行的;平庸无奇的,无聊的; [^]sat;
pediatrician: [-]/ˌpiːdiəˈtrɪʃn/; [n]儿科医师(等于pediatrist); [^]sat;
peerless: [-]/ˈpɪrləs/; [a]无与伦比的;无可匹敌的; [^]sat;
pejorative: [-]/pɪˈdʒɔːrətɪv/; [n]轻蔑语; [a]带有轻蔑意义的,贬低的; [^]sat;
pellucid: [-]/pəˈluːsɪd/; [a]透明的,清晰的,明了的; [^]sat;
penchant: [-]/ˈpentʃənt/; [n]倾向,爱好; [^]sat;
pendant: [-]/ˈpendənt/; [n]吊坠,下垂物; [^]sat;
penitent: [-]/ˈpenɪtənt/; [a]后悔的,忏悔的; [n]改过迁善的人;忏悔的人;悔罪者; [^]sat;
pensive: [-]/ˈpensɪv/; [a]沉思的,心事重重的,忧郁的; [^]sat;
penury: [-]/ˈpenjəri/; [n]贫穷; [^]sat;
perceptive: [-]/pərˈseptɪv/; [a]感知的,知觉的;有知觉力的; [^]sat;
percussion: [-]/pərˈkʌʃn/; [n]撞击,敲击;敲打乐器; [^]sat;
peremptory: [-]/pəˈremptəri/; [a]专横的,不容反抗的; [^]sat;
perennial: [-]/pəˈreniəl/; [a]终年的,永久的;四季不断的;反复的; [n]多年生植物; [^]sat;
perfidious: [-]/pərˈfɪdiəs/; [a]不忠的,背信弃义的; [^]sat;
perforate: [-]/ˈpɜːrfəreɪt/; [vt]穿孔于,打孔穿透;在.上打齿孔; [vi]穿过,贯穿;穿孔; [^]sat;
perfunctory: [-]/pərˈfʌŋktəri/; [a]草率的,敷衍搪塞的; [^]sat;
perimeter: [-]/pəˈrɪmɪtər/; [n]周长;周界; [^]sat;
peripheral: [-]/pəˈrɪfərəl/; [a]外围的; [n]外围设备; [^]sat;
periphery: [-]/pəˈrɪfəri/; [n]外围,不重要的部份; [^]sat;
perjury: [-]/ˈpɜːrdʒəri/; [n]伪证,假誓; [^]sat;
permeable: [-]/ˈpɜːrmiəbl/; [a]可渗透的;可穿透的; [^]sat;
permeate: [-]/ˈpɜːrmieɪt/; [v]弥漫;普及;渗透; [^]sat;
pernicious: [-]/pərˈnɪʃəs/; [a]有害的,恶性的,致命的; [^]sat;
perpetrate: [-]/ˈpɜːrpətreɪt/; [vt]犯罪,作恶;干坏事; [^]sat;
perpetual: [-]/pərˈpetʃuəl/; [a]永远的,永恒的;不断的; [^]sat;
perpetuate: [-]/pərˈpetʃueɪt/; [a]长存的; [vt]使永久存在,使不朽; [^]sat;
perquisite: [-]/ˈpɜːrkwɪzɪt/; [n]固定津贴,福利; [^]sat;
persona: [-]/pərˈsoʊnə/; [n]人物,角色; [^]sat;
personable: [-]/ˈpɜːrsənəbl/; [a]英俊的,风度好的; [^]sat;
perspicacious: [-]/ˌpɜːrspɪˈkeɪʃəs/; [a]独具慧眼的,聪颖的; [^]sat;
pertinacious: [-]/ˌpɜːrtnˈeɪʃəs/; [a]顽固的,执拗的; [^]sat;
pertinent: [-]/ˈpɜːrtnənt/; [a]有关的;适当的;中肯的; [n]附属物;参考; [^]sat;
perturb: [-]/pərˈtɜːrb/; [vt]使不安;烦扰;使紊乱; [^]sat;
peruse: [-]/pəˈruːz/; [v]详细考察;精读; [^]sat;
pervasive: [-]/pərˈveɪsɪv/; [a]深入人心的,普遍的; [^]sat;
perverse: [-]/pərˈvɜːrs/; [a]邪恶的;堕落的;倔强的;违反常情的; [^]sat;
pessimism: [-]/ˈpesɪmɪzəm/; [n]悲观,悲观主义; [^]sat;
petrify: [-]/ˈpetrɪfaɪ/; [v]石化,使僵化,使惊呆; [^]sat;
petty: [-]/ˈpeti/; [a]价值不大的;小的;器量小的;琐碎的; [^]sat;
petulant: [-]/ˈpetʃələnt/; [a]性急的,易怒的,爱闹气的; [^]sat;
phenomena: [-]/fə'nɒmɪnə/; [n]现象; [^]sat;
philology: [-]/fɪˈlɑːlədʒi/; [n]语言学; [^]sat;
phlegmatic: [-]/fleɡˈmætɪk/; [a]冷淡的;迟钝的; [^]sat;
phobia: [-]/ˈfoʊbiə/; [n]恐惧症; [^]sat;
phoenix: [-]/ˈfiːnɪks/; [n]凤凰;死而复生的人; [^]sat;
physiological: [-]/ˌfɪziəˈlɑːdʒɪkl/; [a]生理的,生理学的; [^]sat;
piebald: [-]/ˈpaɪbɔːld/; [a]花斑的;杂色的; [^]sat;
piecemeal: [-]/ˈpiːsmiːl/; [n]片;块; [v]粉碎; [ad]零碎地;逐个地; [a]零碎的;逐渐的; [^]sat;
pied: [-]/paɪd/; [a]杂色的;斑驳的;穿花衣服的; [^]sat;
piety: [-]/ˈpaɪəti/; [n]虔诚,虔诚的行为或语言; [^]sat;
pigment: [-]/ˈpɪɡmənt/; [n]天然色素,颜料; [^]sat;
pillage: [-]/ˈpɪlɪdʒ/; [n]掠夺;掠夺物; [vt]掠夺,抢劫; [^]sat;
pine: [-]/paɪn/; [n]松树; [v](因死亡,离别等)难过,悲伤; [^]sat;
pinnacle: [-]/ˈpɪnəkl/; [n](哥德式建筑的)小尖塔,顶峰; [v]置于尖顶上,置于高处; [^]sat;
pious: [-]/ˈpaɪəs/; [a]虔诚的;难以实现的;尽责的; [^]sat;
piquant: [-]/ˈpiːkənt/; [a]辛辣的,开胃的;活泼有趣的; [^]sat;
pique: [-]/piːk/; [v]引起(好奇心,兴趣等),不悦,愤怒; [n]不悦,生气; [^]sat;
pitfall: [-]/ˈpɪtfɔːl/; [n]陷阱,未料到的危险或困难; [^]sat;
pithy: [-]/ˈpɪθi/; [a]精练的,简洁有力的,多髓的; [^]sat;
pittance: [-]/ˈpɪtns/; [n]微薄的收入,小额津贴,少量; [^]sat;
pivotal: [-]/ˈpɪvətl/; [a]关键的,枢轴的; [^]sat;
placate: [-]/ˈpleɪkeɪt/; [vt]安抚,抚慰; [^]sat;
placebo: [-]/pləˈsiːboʊ/; [n]安慰剂;为死者所诵的晚祷词; [^]sat;
placid: [-]/ˈplæsɪd/; [a]安静的,平和的; [^]sat;
plagiarism: [-]/ˈpleɪdʒərɪzəm/; [n]剽窃,抄袭; [^]sat;
plagiarize: [-]/ˈpleɪdʒəraɪz/; [v]剽窃,抄袭(别人学说,著作); [^]sat;
plaintive: [-]/ˈpleɪntɪv/; [a]表示悲痛的,伤心的; [^]sat;
plasticity: [-]/plæˈstɪsəti/; [n]可塑性;适应性;柔软性; [^]sat;
platitude: [-]/ˈplætɪtuːd/; [n]陈词滥调,老生常谈;单调; [^]sat;
plausible: [-]/ˈplɔːzəbl/; [a]似乎有理的;巧嘴的; [^]sat;
plenitude: [-]/ˈplenɪtuːd/; [n]充分;丰富;大量; [^]sat;
plethora: [-]/ˈpleθərə/; [n]过多,过剩,多血症; [^]sat;
pliable: [-]/ˈplaɪəbl/; [a]易弯的;柔韧的;圆滑的; [^]sat;
pliant: [-]/ˈplaɪənt/; [a]易弯的,柔软的; [n]顺从; [^]sat;
plight: [-]/plaɪt/; [n]困境; [v]宣誓,保证; [^]sat;
plumage: [-]/ˈpluːmɪdʒ/; [n]全身羽毛; [^]sat;
plumb: [-]/plʌm/; [n]铅锤,测锤; [vi]垂直悬挂; [a]垂直的; [vt]用铅锤测量; [ad]垂直地; [^]sat;
plummet: [-]/ˈplʌmɪt/; [v]垂直或突然地堕下,骤然下降; [n]测锤(钓丝的)坠子;线锤;铅锤线;锤规; [^]sat;
plutocracy: [-]/pluːˈtɑːkrəsi/; [n]富豪,财阀统治; [^]sat;
polarize: [-]/ˈpoʊləraɪz/; [v](使)极化,(使)偏振,(使)两极分化; [^]sat;
politic: [-]/ˈpɑːlətɪk/; [a]策略性的,政治上的,国家的; [^]sat;
polygamist: [-]/pəˈlɪɡəmɪst/; [n]多配偶的人;多配偶论者; [^]sat;
polyglot: [-]/ˈpɑːliɡlɑːt/; [n]通晓数种语言的人;用通晓数种语言记载的书; [a]通数国语言,数国语言的; [^]sat;
pomposity: [-]/pɑːmˈpɑːsəti/; [n]自大,傲慢,摆架子; [^]sat;
ponderous: [-]/ˈpɑːndərəs/; [a]笨重的,笨拙的,沉闷的; [^]sat;
pontifical: [-]/pɑːnˈtɪfɪkl/; [a]罗马教宗的,主教的; [^]sat;
pore: [-]/pɔːr/; [n]毛孔,细孔; [v]深思熟虑,仔细阅读,审视; [^]sat;
porous: [-]/ˈpɔːrəs/; [a]可渗透的,多孔的,可穿越的; [^]sat;
portend: [-]/pɔːrˈtend/; [v]预兆,预示; [^]sat;
portent: [-]/ˈpɔːrtent/; [n]征兆,预兆;迹象; [^]sat;
portly: [-]/ˈpɔːrtli/; [n]肥胖的人;特大号服装; [a]肥胖的;魁伟的; [^]sat;
poseur: [-]/poʊˈzɜːr/; [n]装模作样的人; [^]sat;
posterity: [-]/pɑːˈsterəti/; [n]子孙,后裔,后代; [^]sat;
posthumous: [-]/ˈpɑːstʃəməs/; [a]遗腹的;著作者死后出版的;死后的; [^]sat;
postulate: [-]/ˈpɑːstʃəleɪt/; [v]假定.是真的; [n]假定; [^]sat;
potable: [-]/ˈpoʊtəbl/; [a]适于饮用的; [n]饮料; [^]sat;
potent: [-]/ˈpoʊtnt/; [a]强有力的;有权势的;有说服力的; [^]sat;
potentate: [-]/ˈpoʊtnteɪt/; [n]统治者,君主;有权势的人; [^]sat;
potential: [-]/pəˈtenʃl/; [n]潜力,潜能; [a]潜在的,可能的; [^]sat;
potion: [-]/ˈpoʊʃn/; [n]一剂,一服;毒药,魔药; [^]sat;
practicable: [-]/ˈpræktɪkəbl/; [a]能实行的,行得通的;适用的,能用的;可通行的; [^]sat;
practical: [-]/ˈpræktɪkl/; [a]实际的,实用的,实践的,切合实际的;〔人〕注重实际的,务实的;〔计划,方法等〕有效的,切实可行的;心灵手巧的; [n]实习课;实践课;实验考核; [^]sat;
practitioner: [-]/prækˈtɪʃənər/; [n](医生或律师等)开业者;实践者,从事者; [^]sat;
pragmatic: [-]/præɡˈmætɪk/; [a]国事的,团体事务的;实际的,注重实效的; [n]爱管闲事的人;专断的人;国事诏书;实际家; [^]sat;
prank: [-]/præŋk/; [n]恶作剧,玩笑; [^]sat;
prate: [-]/preɪt/; [v]大谈特谈,唠叨; [n]唠叨,多嘴,无聊话; [^]sat;
prattle: [-]/ˈprætl/; [v]闲聊;胡说;小孩般说话; [n]无聊话;咿咿呀呀声; [^]sat;
preamble: [-]/priˈæmbl/; [n]序文,电报报头,先兆; [v]作序言<绪论>; [^]sat;
precarious: [-]/prɪˈkeriəs/; [a]不稳定的;危险的;可疑的;说不定的; [^]sat;
precedent: [-]/ˈpresɪdənt/; [n]先例,范例;惯例; [a]在前的,前面的; [^]sat;
precept: [-]/ˈpriːsept/; [n]箴言,格言; [^]sat;
precinct: [-]/ˈpriːsɪŋkt/; [n]管理区,管辖区;选区;界限,范围; [^]sat;
precipice: [-]/ˈpresəpɪs/; [n]危险的处境,灾难的边缘,濒危点;悬崖; [^]sat;
precipitate: [-]/prɪˈsɪpɪteɪt/; [v]促成,使..沉淀,猛摔;<气象>凝结; [n]沉淀物,冷凝物; [a]突如其来的,仓促的,迅猛的;感情用事的; [^]sat;
precipitous: [-]/prɪˈsɪpɪtəs/; [a]险峻的;急躁的,鲁莽的; [^]sat;
precis: [-]/preɪˈsiː/; [n]摘要,大纲; [vt]〈法〉为.写摘要,概括.的大意; [^]sat;
precise: [-]/prɪˈsaɪs/; [a]精确的;恰好的; [^]sat;
preclude: [-]/prɪˈkluːd/; [v]阻止;排除; [^]sat;
precocious: [-]/prɪˈkoʊʃəs/; [a]早慧的;早熟的;过早发育的; [^]sat;
precursor: [-]/priːˈkɜːrsər/; [n]先兆,先驱,前体; [^]sat;
predator: [-]/ˈpredətər/; [n]掠夺者,食肉动物; [^]sat;
predecessor: [-]/ˈpredəsesər/; [n]前辈;(被取代的)原有事物; [^]sat;
predicament: [-]/prɪˈdɪkəmənt/; [n]困境,穷境,尴尬的处境; [^]sat;
predilection: [-]/ˌpredlˈekʃn/; [n]偏好; [^]sat;
preeminent: [-]/priˈemɪnənt/; [a]卓越的,超群的; [ad]卓越地,杰出地; [^]sat;
preempt: [-]/priː'empt/; [v]制止,以先买权取得,取代; [n]〔经〕优先占有; [^]sat;
preen: [-]/priːn/; [v]打扮;用嘴整理;赞扬; [^]sat;
prehensile: [-]/prɪˈhensl/; [a]适于抓握的;善于领会的; [^]sat;
prelate: [-]/ˈprelət/; [n]高级教士;高位神职者; [^]sat;
prelude: [-]/ˈpreljuːd/; [n]序幕,前奏; [^]sat;
premise: [-]/ˈpremɪs/; [n]前提;房屋地基; [v]假定; [^]sat;
premonition: [-]/ˌpriːməˈnɪʃn/; [n]预告,征兆,预感; [^]sat;
preposterous: [-]/prɪˈpɑːstərəs/; [a]荒谬的,可笑的; [^]sat;
prerogative: [-]/prɪˈrɑːɡətɪv/; [n]权利;特权; [^]sat;
presage: [-]/ˈpresɪdʒ/; [v]预示; [n]预感,不祥感,前兆,预言; [^]sat;
prescience: [-]/ˈpresiəns/; [n]先见;预知; [^]sat;
presentiment: [-]/prɪˈzentɪmənt/; [n]不祥的预感; [^]sat;
prestige: [-]/preˈstiːʒ/; [n]威望,声望; [^]sat;
presumptuous: [-]/prɪˈzʌmptʃuəs/; [a]专横的,自以为是的,冒昧的; [ad]自以为是地,专横地,冒失地; [n]自以为是,专横,冒失; [^]sat;
pretentious: [-]/prɪˈtenʃəs/; [a]做作的,自命不凡的,炫耀的; [^]sat;
preternatural: [-]/ˌpriːtərˈnætʃrəl/; [a]超自然的;不可思议的; [^]sat;
pretext: [-]/ˈpriːtekst/; [n]借口,托词; [^]sat;
prevail: [-]/prɪˈveɪl/; [v]流行,盛行;战胜,压倒; [^]sat;
prevalent: [-]/ˈprevələnt/; [a]普遍的,流行的; [^]sat;
prevaricate: [-]/prɪˈværɪkeɪt/; [v]支吾,搪塞,说谎; [^]sat;
prey: [-]/preɪ/; [n]被掠食者,猎物;牺牲者; [v]使..苦恼; [vi]捕食;受..控制; [^]sat;
prim: [-]/prɪm/; [a]拘谨的,呆板的;端庄的;整洁的; [ad]循规蹈矩地,整洁地; [v](使)一本正经;使整洁; [^]sat;
primordial: [-]/praɪˈmɔːrdiəl/; [a]原始的;根本的;原生的; [^]sat;
primp: [-]/prɪmp/; [v]精心打扮;装饰; [^]sat;
pristine: [-]/ˈprɪstiːn/; [a]原始的;古时的;纯朴的;崭新的; [^]sat;
privation: [-]/praɪˈveɪʃn/; [n]缺乏,贫困,丧失,被剥夺了某物的状态; [^]sat;
probe: [-]/proʊb/; [v]探测,探索; [n]探索,调查;探针,探测器; [^]sat;
problematic: [-]/ˌprɑːbləˈmætɪk/; [a]问题的;有疑问的;不确定的; [^]sat;
proclivity: [-]/prəˈklɪvəti/; [n]倾向,怪癖; [^]sat;
procrastinate: [-]/proʊˈkræstɪneɪt/; [v](因不愿意做或习惯性地)耽搁,拖延; [^]sat;
prod: [-]/prɑːd/; [n]刺针;刺棒;签子; [v]刺;戳;刺激; [^]sat;
prodigal: [-]/ˈprɑːdɪɡl/; [a]挥霍的,十分慷慨的; [n]浪子,挥霍者; [^]sat;
prodigious: [-]/prəˈdɪdʒəs/; [a]异常的,奇妙的;巨大的; [^]sat;
prodigy: [-]/ˈprɑːdədʒi/; [n]天才; [^]sat;
profane: [-]/prəˈfeɪn/; [a]亵渎神圣的,不敬的,粗俗的,污秽的; [v]亵渎,玷污(神圣),滥用; [n]未受秘传的人; [^]sat;
profligate: [-]/ˈprɑːflɪɡət/; [a]放荡的;不检点的;恣意挥霍的; [n]放荡的人,浪子,肆意挥霍者; [^]sat;
profound: [-]/prəˈfaʊnd/; [a]深刻的;知识渊博的;深奥的;极度的,完全的;深远的;渊博的; [n]深渊;深海; [^]sat;
profusion: [-]/prəˈfjuːʒn/; [n]丰富; [^]sat;
progeny: [-]/ˈprɑːdʒəni/; [n]子孙,后代,成果; [^]sat;
prognosis: [-]/prɑːɡˈnoʊsɪs/; [n]<医>预后;预知; [^]sat;
projectile: [-]/prəˈdʒektl/; [n]抛射物,发射体,火箭,导弹; [a]发射的; [^]sat;
proliferation: [-]/prəˌlɪfəˈreɪʃn/; [n]增殖;增加; [^]sat;
prolific: [-]/prəˈlɪfɪk/; [a]多育的,多产的;丰富的,富饶的; [^]sat;
prologue: [-]/ˈproʊlɔːɡ/; [n]开场白,序幕; [^]sat;
prolong: [-]/prəˈlɔːŋ/; [v]延长;拉长;拖延; [^]sat;
prominent: [-]/ˈprɑːmɪnənt/; [a]突起的,显眼的;突出的,杰出的; [^]sat;
promiscuous: [-]/prəˈmɪskjuəs/; [a]滥交的,杂乱的,混杂的; [^]sat;
promontory: [-]/ˈprɑːməntɔːri/; [n]岬,海角,隆突; [^]sat;
promote: [-]/prəˈmoʊt/; [v]提升;促进;发扬;促销; [^]sat;
prompt: [-]/prɑːmpt/; [v]提示;激起;促进,推动;敦促; [a]迅速的,及时的; [n]提示; [^]sat;
promulgate: [-]/ˈprɑːmlɡeɪt/; [v]公布;传播;发表; [^]sat;
prone: [-]/proʊn/; [a]易于.的;有.倾向的;俯卧的; [^]sat;
propagate: [-]/ˈprɑːpəɡeɪt/; [v]繁殖,增殖; [vt]传播,宣传; [^]sat;
propensity: [-]/prəˈpensəti/; [n]嗜好,习性;倾向; [^]sat;
prophetic: [-]/prəˈfetɪk/; [a]预言的,预示的; [^]sat;
propinquity: [-]/prəˈpɪŋkwəti/; [n]接近,邻近,近亲关系; [^]sat;
propitiate: [-]/prəˈpɪʃieɪt/; [v]讨好,抚慰; [^]sat;
propitious: [-]/prəˈpɪʃəs/; [a]适合的;吉利的;顺利的; [^]sat;
proponent: [-]/prəˈpoʊnənt/; [n]支持者;提议者;主张者;提出认证遗嘱者; [a]建议的;支持的;辩护的; [^]sat;
propound: [-]/prəˈpaʊnd/; [v]提出(问题,计划)供考虑; [^]sat;
propriety: [-]/prəˈpraɪəti/; [n]正当(的行为);礼节;适当; [^]sat;
prosaic: [-]/prəˈzeɪɪk/; [a]平凡的,乏味的,散文体的; [^]sat;
proscribe: [-]/proʊˈskraɪb/; [v]剥夺..的公权,禁止; [^]sat;
proselytize: [-]/ˈprɑːsələtaɪz/; [v]使皈依; [^]sat;
prosperity: [-]/prɑːˈsperəti/; [n]繁荣,兴旺,发达; [^]sat;
prostrate: [-]/ˈprɑːstreɪt/; [a]降伏的,沮丧的,衰竭的,俯卧的; [v]弄倒,使屈服; [^]sat;
protean: [-]/ˈproʊtiən/; [a]变化多端的,能够变化的; [^]sat;
protege: [-]/ˈproʊtəʒeɪ/; [n]被保护人,门徒,门生; [^]sat;
protocol: [-]/ˈproʊtəkɔːl/; [n]外交礼节;草案;外交议定书; [vi]拟定议定书; [vt]把.写入议定书; [^]sat;
prototype: [-]/ˈproʊtətaɪp/; [n]原型,典型,样本; [^]sat;
protract: [-]/proʊ'trækt/; [v]绘制;延长;伸展; [^]sat;
protrude: [-]/proʊˈtruːd/; [v]伸出,突出,凸出; [^]sat;
provident: [-]/ˈprɑːvɪdənt/; [a]节俭的,深谋远虑的,顾及未来的; [^]sat;
provincial: [-]/prəˈvɪnʃl/; [a]省的;地方性的;偏狭的; [n]地方人民;乡下人;外地人; [^]sat;
provisional: [-]/prəˈvɪʒənl/; [n]临时邮票; [a]临时的,暂时的,暂定的; [^]sat;
provocative: [-]/prəˈvɑːkətɪv/; [a]挑衅的,煽动的,刺激的;挑逗的; [^]sat;
provoke: [-]/prəˈvoʊk/; [v]激怒;对.挑衅;引起; [^]sat;
prowess: [-]/ˈpraʊəs/; [n]勇敢,不凡的能力;超凡技术; [^]sat;
proximity: [-]/prɑːkˈsɪməti/; [n]接近;邻近; [^]sat;
proxy: [-]/ˈprɑːksi/; [n]代理权,代表权,代理人; [a]代理的; [^]sat;
prude: [-]/pruːd/; [n]过分守礼的人,故作正经的人; [^]sat;
prudent: [-]/ˈpruːdnt/; [a]谨慎的,精明的; [^]sat;
prune: [-]/pruːn/; [n]梅干; [v]修剪;削减; [^]sat;
prurient: [-]/ˈprʊriənt/; [a]好色的;淫乱的;渴望的; [^]sat;
pseudonym: [-]/ˈsuːdənɪm/; [n]笔名,假名; [^]sat;
psyche: [-]/ˈsaɪki/; [n]灵魂;心智; [^]sat;
puerile: [-]/ˈpjʊrəl/; [a]幼稚的,孩子气的; [^]sat;
pugnacity: [-]/pʌɡˈnæsəti/; [n]好斗,好战; [^]sat;
pulchritude: [-]/ˈpʌlkrɪtjuːd/; [n]漂亮,标致; [^]sat;
pulverize: [-]/ˈpʌlvəraɪz/; [v]粉碎;使成粉末;彻底击败;彻底毁坏; [^]sat;
pummel: [-]/ˈpʌml/; [v]击;打;用拳头连续揍; [^]sat;
punctilious: [-]/pʌŋkˈtɪliəs/; [a]一丝不苟的,精密细心的,拘泥形式的; [^]sat;
pundit: [-]/ˈpʌndɪt/; [n]博学者,评论家; [^]sat;
pungent: [-]/ˈpʌndʒənt/; [a]刺激性的;刺鼻的;尖锐的; [^]sat;
punitive: [-]/ˈpjuːnətɪv/; [a]给予惩罚,刑罚的; [^]sat;
puny: [-]/ˈpjuːni/; [a]弱小的,微不足道的; [^]sat;
purchase: [-]/ˈpɜːrtʃəs/; [v]购买; [n]购买;所购之物; [^]sat;
purge: [-]/pɜːrdʒ/; [v]通便,净化,使(身,心)清净; [n]驱赶,泻药,净化; [^]sat;
purveyor: [-]/pərˈveɪər/; [n]承办者;供应粮食者; [^]sat;
pusillanimous: [-]/ˌpjuːsɪˈlænɪməs/; [a]懦弱的,胆小的;优柔寡断的; [^]sat;
putrid: [-]/ˈpjuːtrɪd/; [a]腐臭的;讨人厌的; [^]sat;
quack: [-]/kwæk/; [n]庸医;鸭叫声; [v]嘎嘎叫;吹嘘;大声闲聊; [a]骗人的,江湖医生的; [^]sat;
quaff: [-]/kwæf/; [v]痛饮; [^]sat;
quagmire: [-]/ˈkwæɡmaɪər/; [n]沼泽地,困境; [^]sat;
quail: [-]/kweɪl/; [n]鹌鹑; [v]畏缩;感到恐惧; [^]sat;
quaint: [-]/kweɪnt/; [a]精巧的;古雅的; [^]sat;
qualified: [-]/ˈkwɑːlɪfaɪd/; [a]有资格的;保留的,有限度的; [vt]描述,形容;使合适;授权予;有权,达标; [vi]合格,成为合格;取得.的资格; [^]sat;
quandary: [-]/ˈkwɑːndəri/; [n]困惑;窘境;为难; [^]sat;
quarantine: [-]/ˈkwɔːrəntiːn/; [v]检疫;隔离;使隔离; [n]检疫;隔离;检疫期;封锁; [^]sat;
quarry: [-]/ˈkwɔːri/; [n]采石场;猎物;来源; [v]挖出;努力挖掘; [^]sat;
quay: [-]/kiː/; [n]码头; [^]sat;
queasy: [-]/ˈkwiːzi/; [a]呕吐的;不稳定的; [^]sat;
quell: [-]/kwel/; [v]镇压,消除,减轻(激动,恐惧等); [n]镇压,平息,减轻; [^]sat;
quench: [-]/kwentʃ/; [v]扑灭(火);止渴; [^]sat;
querulous: [-]/ˈkwerələs/; [a]抱怨的,挑剔的; [^]sat;
query: [-]/ˈkwɪri/; [n]质问,询问,怀疑; [v]询问,表示怀疑; [^]sat;
quibble: [-]/ˈkwɪbl/; [n]谬论;双关语;遁辞; [v]诡辩;挑剔;说模棱两可的话; [^]sat;
quiescent: [-]/kwaɪˈesnt/; [a]静止的,沉寂的,不活动的; [^]sat;
quip: [-]/kwɪp/; [n]妙语,嘲弄,讽刺语; [v]嘲弄,讥讽; [^]sat;
quiver: [-]/ˈkwɪvər/; [n]颤抖;箭袋; [vi]颤抖; [^]sat;
quixotic: [-]/kwɪkˈsɑːtɪk/; [a]空想的,堂吉诃德式的; [n]同"quixotism"; [^]sat;
quizzical: [-]/ˈkwɪzɪkl/; [a]困惑的,引人发笑的,嘲弄的,探询的; [ad]疑问地,戏弄地; [^]sat;
quorum: [-]/ˈkwɔːrəm/; [n]法定人数; [^]sat;
rabid: [-]/ˈræbɪd/; [a]激烈的;狂暴的;偏激的;患狂犬病的; [^]sat;
raconteur: [-]/ˌrækɑːnˈtɜːr/; [n]健谈者;善谈者;擅长讲故事的人; [^]sat;
rail: [-]/reɪl/; [n]铁轨;扶手,栏杆; [v]咒骂; [^]sat;
raiment: [-]/ˈreɪmənt/; [n]衣服; [^]sat;
rally: [-]/ˈræli/; [n]集会;公路汽车赛; [v]集合;恢复(健康等),重新振作; [^]sat;
ramble: [-]/ˈræmbl/; [vi]瞎扯;溜达;漫步于; [n]漫步; [^]sat;
ramification: [-]/ˌræmɪfɪˈkeɪʃn/; [n]分枝;分枝(或分叉)的结果; [^]sat;
ramp: [-]/ræmp/; [n]斜坡,坡道;倾斜装置; [v]蔓延; [^]sat;
rampant: [-]/ˈræmpənt/; [a]猖獗的,蔓生的; [^]sat;
ramshackle: [-]/ˈræmʃækl/; [a]摇摇欲坠的; [^]sat;
rancid: [-]/ˈrænsɪd/; [a]腐臭的;令人作呕的,讨厌的; [^]sat;
rancor: [-]/ˈræŋkər/; [n]深仇,怨恨; [^]sat;
random: [-]/ˈrændəm/; [a]随机的;任意的;胡乱的; [^]sat;
rankle: [-]/ˈræŋkl/; [v]怨恨,使痛苦,化脓; [^]sat;
rant: [-]/rænt/; [n]咆哮,痛骂; [v]咆哮,痛骂,大声责骂; [^]sat;
rapacious: [-]/rəˈpeɪʃəs/; [a]贪婪的;掠夺的; [^]sat;
rapport: [-]/ræˈpɔːr/; [n]密切关系,交往;和谐一致;意见一致; [^]sat;
rapt: [-]/ræpt/; [a]全神贯注的,着迷的;狂喜的; [^]sat;
raspy: [-]/ˈræspi/; [a]声音沙哑的,容易生气的; [^]sat;
ratify: [-]/ˈrætɪfaɪ/; [vt]批准,认可,签署生效; [^]sat;
ratiocination: [-]/ˌreɪʃioʊsɪˈneɪʃn/; [n]推理,推论; [^]sat;
rationale: [-]/ˌræʃəˈnæl/; [n]基本原理;原理的阐述; [^]sat;
raucous: [-]/ˈrɔːkəs/; [a](声音)沙哑的,刺耳的,吵闹的; [^]sat;
rave: [-]/reɪv/; [n]热切赞扬,喧闹的宴会;胡言乱语; [v]咆哮;胡言乱语;语无伦次地说; [a]赞扬的; [^]sat;
ravenous: [-]/ˈrævənəs/; [a]贪婪的;渴望的,极饿的;狼吞虎咽的; [^]sat;
raze: [-]/reɪz/; [v]夷为平地,破坏,消除;拆毁; [^]sat;
reactionary: [-]/riˈækʃəneri/; [a]保守的,反动的; [n]反动分子; [^]sat;
realm: [-]/relm/; [n]王国;领域;国土; [^]sat;
reaper: [-]/ˈriːpər/; [n]收割者;收割机; [^]sat;
rebuff: [-]/rɪˈbʌf/; [n]断然拒绝,回绝,漠不关心; [v]断然拒绝; [^]sat;
rebuke: [-]/rɪˈbjuːk/; [v]指责; [n]谴责; [^]sat;
recalcitrant: [-]/rɪˈkælsɪtrənt/; [a]顽抗的,不顺从的; [^]sat;
recant: [-]/rɪˈkænt/; [v]宣布放弃,公开认错; [^]sat;
recapitulate: [-]/ˌriːkəˈpɪtʃuleɪt/; [v]扼要重述; [^]sat;
recast: [-]/ˌriːˈkæst/; [v]重建; [^]sat;
receptive: [-]/rɪˈseptɪv/; [a]善于接受的;能容纳的; [^]sat;
recession: [-]/rɪˈseʃn/; [n](经济)衰退,不景气;后退,撤回;凹处; [^]sat;
recidivism: [-]/rɪˈsɪdɪvɪzəm/; [n]再犯,累犯; [^]sat;
recipient: [-]/rɪˈsɪpiənt/; [n]接受者;容器;间接宾语; [a]接受的;善于接受的;接受能力强的; [^]sat;
reciprocal: [-]/rɪˈsɪprəkl/; [a]相互的,互惠的; [n]倒数;互相关联的事物; [^]sat;
reciprocate: [-]/rɪˈsɪprəkeɪt/; [v]互给;酬答;互换;报答; [^]sat;
recluse: [-]/ˈrekluːs/; [n]隐士; [a]隐士的,隐遁的; [^]sat;
reconcile: [-]/ˈrekənsaɪl/; [v]和解;调解;调和; [^]sat;
reconnaissance: [-]/rɪˈkɑːnɪsns/; [n]侦察,勘测,搜索,事先考查; [^]sat;
recount: [-]/rɪˈkaʊnt/; [v]叙述; [n]重新计算; [^]sat;
recourse: [-]/ˈriːkɔːrs/; [n]求援(对象),求助(对象,<商><律>追索权; [^]sat;
recrimination: [-]/rɪˌkrɪmɪˈneɪʃn/; [n]反责,反控,揭丑; [^]sat;
rectify: [-]/ˈrektɪfaɪ/; [v]纠正;修复; [^]sat;
rectitude: [-]/ˈrektɪtuːd/; [n]正直,公正,正确; [^]sat;
recumbent: [-]/rɪˈkʌmbənt/; [a]斜倚的;休息的; [n]〈口〉座位斜靠式自行车; [^]sat;
recuperate: [-]/rɪˈkuːpəreɪt/; [v]恢复(健康),重新得到,复兴; [^]sat;
recurrent: [-]/rɪˈkɜːrənt/; [a]复发的;周期性的,经常发生的; [^]sat;
redolent: [-]/ˈredələnt/; [a]气味强烈的,芬芳的,令人想起..的; [^]sat;
redoubtable: [-]/rɪˈdaʊtəbl/; [a]可敬畏的,可怕的; [^]sat;
redress: [-]/rɪˈdres/; [n]纠正,革除,救济; [v]修正,救济,革除; [^]sat;
redundant: [-]/rɪˈdʌndənt/; [a]多余的,过剩的;被下岗的; [^]sat;
reek: [-]/riːk/; [v]散发;冒烟;放出臭气; [n]恶臭;水蒸汽;雾;烟; [^]sat;
refraction: [-]/rɪˈfrækʃn/; [n]折射;折光; [^]sat;
refractory: [-]/rɪˈfræktəri/; [a]难治的,难熔的,不听话的; [^]sat;
refrain: [-]/rɪˈfreɪn/; [v]抑制,避免; [n]歌曲的反复句,叠句; [^]sat;
refurbish: [-]/ˌriːˈfɜːrbɪʃ/; [v]刷新,再磨光; [^]sat;
regal: [-]/ˈriːɡl/; [a]帝王的,豪华的,帝王般的; [^]sat;
regale: [-]/rɪˈɡeɪl/; [v]盛情款待,享用,享受; [n]盛宴,佳肴,款待; [^]sat;
regime: [-]/reɪˈʒiːm/; [n]政权;政治制度;养生法,生活规则; [^]sat;
regimen: [-]/ˈredʒɪmən/; [n]养生法,生活规则; [^]sat;
rehabilitate: [-]/ˌriːəˈbɪlɪteɪt/; [v]使康复,使恢复名誉,使恢复原状; [^]sat;
reimburse: [-]/ˌriːɪmˈbɜːrs/; [v]偿还;赔偿;退还(钱),付还; [^]sat;
reiterate: [-]/riˈɪtəreɪt/; [vt]反复讲,重申,反复做; [^]sat;
rejoinder: [-]/rɪˈdʒɔɪndər/; [n]回答,反驳,第二次答辩; [^]sat;
rejuvenate: [-]/rɪˈdʒuːvəneɪt/; [v]使..年轻;使..恢复精神;变年轻; [vi]返老还童,恢复活力,复原; [^]sat;
relent: [-]/rɪˈlent/; [v]变温和,变宽厚;减弱;缓和;终于答应;不再拒绝; [^]sat;
relevant: [-]/ˈreləvənt/; [a]有关的;恰当的;贴切的; [^]sat;
relic: [-]/ˈrelɪk/; [n]遗迹;神圣的遗物;纪念物; [^]sat;
relinquish: [-]/rɪˈlɪŋkwɪʃ/; [v]放弃,让出(权利,财产等),撤回; [^]sat;
relish: [-]/ˈrelɪʃ/; [v]享受;享受.的味道;品味; [n]乐趣;调味品; [^]sat;
remediable: [-]/rɪˈmiːdiəbl/; [a]可治疗的,可矫正的,可补救的; [^]sat;
remedial: [-]/rɪˈmiːdiəl/; [a]治疗的;补救的;矫正的; [^]sat;
reminiscence: [-]/ˌremɪˈnɪsns/; [n]回忆,怀旧,引起联想的相似事物; [^]sat;
remiss: [-]/rɪˈmɪs/; [a]疏忽的,怠慢的; [^]sat;
remission: [-]/rɪˈmɪʃn/; [n]缓解;宽恕;豁免; [^]sat;
remnant: [-]/ˈremnənt/; [n]遗迹;边角剩料; [^]sat;
remonstrance: [-]/rɪˈmɑːnstrəns/; [n]抗议,抱怨,谏书; [^]sat;
remorse: [-]/rɪˈmɔːrs/; [n]懊悔,自责,同情,怜悯; [^]sat;
remunerative: [-]/rɪˈmjuːnərətɪv/; [a]有报酬的,有利可图的; [^]sat;
rend: [-]/rend/; [v]撕碎;分裂;强夺; [^]sat;
render: [-]/ˈrendər/; [v]使成为,致使,使处于(某种状态);提供,给予,以.回报;(以某种方式)表达,表现;翻译;粉刷,往(墙上)抹灰;将(脂肪)熬成油,使熔化; [n]粉刷,打底,交纳; [^]sat;
rendition: [-]/renˈdɪʃn/; [n]表演,演奏;译文;给予,提供; [^]sat;
renegade: [-]/ˈrenɪɡeɪd/; [n]叛教者,脱党者,叛徒; [v]背叛,背教,变节; [a]叛教的,背叛的,变节的; [^]sat;
renege: [-]/rɪˈniːɡ/; [v]食言,否认; [^]sat;
renounce: [-]/rɪˈnaʊns/; [vt]宣布放弃,与...断绝关系;抛弃; [vi]垫牌; [n]垫牌; [^]sat;
renovate: [-]/ˈrenəveɪt/; [v]更新,修复; [a]恢复的,革新的,翻新的; [^]sat;
renown: [-]/rɪˈnaʊn/; [n]声誉;名望; [vt]使有声望; [^]sat;
rent: [-]/rent/; [n]租金; [v]租用,出租; [^]sat;
reparable: [-]/'repərəbəl/; [a]可修缮的;可挽回的; [^]sat;
repast: [-]/rɪˈpæst/; [n]宴;就餐; [vi]就餐,设宴; [^]sat;
repeal: [-]/rɪˈpiːl/; [n]撤销; [v]废除;废止; [^]sat;
repel: [-]/rɪˈpel/; [v]击退,驱逐;排斥,抵制;使厌恶,使反感;使恐惧; [^]sat;
repellent: [-]/rɪˈpelənt/; [a]令人厌恶的; [n]消肿药,驱虫剂; [^]sat;
repercussion: [-]/ˌriːpərˈkʌʃn/; [n]反响;弹回;反射; [^]sat;
repertoire: [-]/ˈrepərtwɑːr/; [n](剧团,演员等的)全部节目;全部才能; [^]sat;
replenish: [-]/rɪˈplenɪʃ/; [v]补充,再装满;把.装满;给.添加燃料; [^]sat;
replete: [-]/rɪˈpliːt/; [a]充满的,装满的; [n]<昆>贮蜜蚁; [^]sat;
replica: [-]/ˈreplɪkə/; [n]复制品; [^]sat;
replicate: [-]/ˈreplɪkeɪt/; [v]复制;重复,反复; [^]sat;
repository: [-]/rɪˈpɑːzətɔːri/; [n]储藏室;仓库;智囊人物;知识库; [^]sat;
reprehensible: [-]/ˌreprɪˈhensəbl/; [a]应受谴责的; [^]sat;
repress: [-]/rɪˈpres/; [vt]抑制;镇压;约束; [^]sat;
reprieve: [-]/rɪˈpriːv/; [v]暂缓处罚,免罪,维持运行; [n]<法>死缓,缓刑,暂缓; [^]sat;
reprimand: [-]/ˈreprɪmænd/; [n](特指当权者进行的)严责,谴责,申斥; [v]申斥,谴责,惩戒; [^]sat;
reprisal: [-]/rɪˈpraɪzl/; [n]报复;报复性劫掠; [^]sat;
reproach: [-]/rɪˈproʊtʃ/; [v]责备,指责; [n]指责; [^]sat;
reprobate: [-]/ˈreprəbeɪt/; [n]混蛋,恶棍; [a]邪恶的;堕落的; [v]谴责,指责; [^]sat;
reprove: [-]/rɪˈpruːv/; [v]责骂,申斥; [^]sat;
repudiate: [-]/rɪˈpjuːdieɪt/; [v]拒绝,否定,驳斥; [^]sat;
repugnant: [-]/rɪˈpʌɡnənt/; [a]令人厌恶的; [^]sat;
repulsion: [-]/rɪˈpʌlʃn/; [n]排斥;厌恶;反驳; [^]sat;
reputable: [-]/ˈrepjətəbl/; [a]声誉好的;受尊敬的;卓越的; [^]sat;
reputed: [-]/rɪˈpjuːtɪd/; [a]名誉好的;被普遍认为.的; [^]sat;
requiem: [-]/ˈrekwiəm/; [n]安魂曲;追思弥撒; [^]sat;
requisite: [-]/ˈrekwɪzɪt/; [n]必需品; [a]需要的,必不可少的,必备的; [^]sat;
requite: [-]/rɪˈkwaɪt/; [v]报答,酬谢,回报,补偿;报复; [^]sat;
rescind: [-]/rɪˈsɪnd/; [v]废除;取消;撤回; [^]sat;
resentment: [-]/rɪˈzentmənt/; [n]憎恨; [^]sat;
reserve: [-]/rɪˈzɜːrv/; [n]储备;保留;保护区; [v]保留;预定;储备; [^]sat;
residue: [-]/ˈrezɪduː/; [n]剩余物;残渣;渣;残数; [^]sat;
resigned: [-]/rɪˈzaɪnd/; [a]逆来顺受的;已辞职的;已放弃的; [^]sat;
resilient: [-]/rɪˈzɪliənt/; [a]能复原的,弹回的,有弹性的; [^]sat;
resolution: [-]/ˌrezəˈluːʃn/; [n]决心,决定,解决,决议,分辨率; [^]sat;
resolve: [-]/rɪˈzɑːlv/; [n]决心; [v]解决,决定,表决; [^]sat;
resonant: [-]/ˈrezənənt/; [a]洪亮的,共振的,共鸣的; [^]sat;
respiration: [-]/ˌrespəˈreɪʃn/; [n]呼吸; [^]sat;
respite: [-]/ˈrespɪt/; [n]缓解;暂缓;暂时的休息;缓期执行; [v]使缓解;使暂缓;使延期;缓期执行; [^]sat;
resplendent: [-]/rɪˈsplendənt/; [a]华丽的,辉煌的; [^]sat;
restitution: [-]/ˌrestɪˈtuːʃn/; [n]归还,赔偿; [^]sat;
restive: [-]/ˈrestɪv/; [a]不耐烦的,焦躁不安的,倔强的; [^]sat;
retain: [-]/rɪˈteɪn/; [v]保持,保留,保存;聘请; [^]sat;
retaliation: [-]/rɪˌtæliˈeɪʃn/; [n]反击;回敬;报复; [^]sat;
retentive: [-]/rɪˈtentɪv/; [a]保持的;吸(水)的; [ad]有记性地,记性强地; [n]保持力;〈物〉顽磁性; [^]sat;
retinue: [-]/ˈretənuː/; [n]侍从,随员; [^]sat;
retiring: [-]/rɪˈtaɪərɪŋ/; [a]退休的,不善社交的,过隐居生活的; [v]退休; [^]sat;
retort: [-]/rɪˈtɔːrt/; [v]反驳; [n]反驳,反击,回嘴; [^]sat;
retract: [-]/rɪˈtrækt/; [v]缩回;收回;取消; [n]收缩核; [^]sat;
retrench: [-]/rɪˈtrentʃ/; [v]节省,削减;紧缩; [^]sat;
retribution: [-]/ˌretrɪˈbjuːʃn/; [n]报应,惩罚,报答,报偿; [^]sat;
retrieve: [-]/rɪˈtriːv/; [v]取回,重新得到,挽回,检索; [^]sat;
retroactive: [-]/ˌretroʊˈæktɪv/; [a]追溯的;有追溯效力的;反动的; [^]sat;
retrograde: [-]/ˈretrəɡreɪd/; [vi]倒退,退步; [a]后退的,退步的,退化的; [vt]使倒退; [^]sat;
retrospective: [-]/ˌretrəˈspektɪv/; [a]回顾的;怀旧的;可追溯的; [n]作品回顾展出; [^]sat;
revelry: [-]/ˈrevlri/; [n]狂欢;欢宴; [^]sat;
reverent: [-]/ˈrevərənt/; [a]虔诚的,恭敬的; [^]sat;
reverie: [-]/ˈrevəri/; [n]幻想,沉思,幻想曲; [^]sat;
revile: [-]/rɪˈvaɪl/; [v]辱骂,诽谤,批判; [^]sat;
revoke: [-]/rɪˈvoʊk/; [v]撤回,取消;废除; [n]有牌不跟; [^]sat;
revulsion: [-]/rɪˈvʌlʃn/; [n]剧变,厌恶,强烈反感; [^]sat;
rhetoric: [-]/ˈretərɪk/; [n]修辞学,浮夸的言语;雄辩术; [^]sat;
rhetorical: [-]/rɪˈtɔːrɪkl/; [a]语言上的,文字上的,言辞华丽(却往往无内涵的); [^]sat;
riddle: [-]/ˈrɪdl/; [n]谜,谜语; [v]解谜,出谜题,满是弹孔; [^]sat;
rider: [-]/ˈraɪdər/; [n]骑士;附件,附文;扶手; [^]sat;
rife: [-]/raɪf/; [a]普遍的;流行的; [^]sat;
rift: [-]/rɪft/; [n]裂缝,裂口; [^]sat;
rig: [-]/rɪɡ/; [n]钻井架;装备;帆具;成套器械; [v]操纵;装配;欺骗; [^]sat;
rigid: [-]/ˈrɪdʒɪd/; [a]坚硬的;僵硬的;死板的; [^]sat;
rigor: [-]/'rɪgə/; [n]严厉;精确;困难境地; [^]sat;
rigorous: [-]/ˈrɪɡərəs/; [a]严厉的,严格的; [^]sat;
rile: [-]/raɪl/; [v]刺激,惹怒; [^]sat;
riveting: [-]/ˈrɪvɪtɪŋ/; [a]非常精彩的; [n]铆接(法; [^]sat;
rivulet: [-]/ˈrɪvjələt/; [n]小溪,小河; [^]sat;
robust: [-]/roʊˈbʌst/; [a]健壮的,强壮的;精力充沛的;坚固的;粗鲁的; [^]sat;
roil: [-]/rɔɪl/; [v]搅浑,惹怒,动荡,喧闹; [n]小股汹涌的急流; [^]sat;
roster: [-]/ˈrɑːstər/; [n]值勤表,花名册; [v]将(姓名)列入值勤名单; [^]sat;
rostrum: [-]/ˈrɑːstrəm/; [n]讲坛,讲台; [^]sat;
rote: [-]/roʊt/; [n]死记硬背,机械的做法,生搬硬套; [^]sat;
rout: [-]/raʊt/; [v]击溃;搜寻; [n]溃败;暴动; [^]sat;
rubble: [-]/ˈrʌbl/; [n]碎石,瓦砾; [^]sat;
ruddy: [-]/ˈrʌdi/; [a]红的,红润的; [ad]极度,非常; [vt]使变红; [^]sat;
rudimentary: [-]/ˌruːdɪˈmentri/; [a]基本的,初期的;发育不完全的;退化的; [^]sat;
rue: [-]/ruː/; [v]后悔,遗憾; [^]sat;
ruffian: [-]/ˈrʌfiən/; [n]流氓,无赖,恶棍; [a]凶狠的,残暴的,无法无天的; [^]sat;
ruminate: [-]/ˈruːmɪneɪt/; [v]反刍,再嚼,深思; [^]sat;
rummage: [-]/ˈrʌmɪdʒ/; [n]杂物,翻寻; [v]彻底搜查,翻箱倒柜; [^]sat;
ruse: [-]/ruːz/; [n]诡计; [^]sat;
rustic: [-]/ˈrʌstɪk/; [n]乡巴佬,庄稼汉,粗人; [a]乡村的;质朴的;不精致的; [^]sat;
ruthless: [-]/ˈruːθləs/; [a]无情的;残忍的; [^]sat;
saccharine: [-]/ˈsækəriːn/; [a]像糖一样的,有甜味的,做作的,矫情的; [^]sat;
sacrilegious: [-]/ˌsækrəˈlɪdʒəs/; [a]该受天谴的,亵渎神明的; [^]sat;
sacrosanct: [-]/ˈsækroʊsæŋkt/; [a](因十分重要,神圣)不可改变,批判的; [^]sat;
sadistic: [-]/səˈdɪstɪk/; [a]虐待狂的;残忍成性的; [^]sat;
saga: [-]/ˈsɑːɡə/; [n]传奇故事;冒险故事;一连串的事件(或经历); [^]sat;
sagacious: [-]/səˈɡeɪʃəs/; [a]有洞察力的,有远见的,精明的,敏锐的; [^]sat;
sage: [-]/seɪdʒ/; [a]贤明的,审慎的; [n]圣人,年高望重的人; [^]sat;
salient: [-]/ˈseɪliənt/; [a]显著的;突出的;跳跃的; [n]凸角;突出部分; [^]sat;
salubrious: [-]/səˈluːbriəs/; [a]清爽的;气候有益健康的; [^]sat;
salutary: [-]/ˈsæljəteri/; [a]有益的,有益健康的; [^]sat;
salvage: [-]/ˈsælvɪdʒ/; [n]抢救;从灾难中抢救出的物资; [vt]拯救;打捞; [^]sat;
salvo: [-]/ˈsælvoʊ/; [n]齐射,齐鸣,齐声欢呼喝彩,保留条款,遁辞; [v]齐鸣; [^]sat;
sanctimonious: [-]/ˌsæŋktɪˈmoʊniəs/; [a]伪装虔诚的;道貌岸然的; [^]sat;
sanction: [-]/ˈsæŋkʃn/; [n]批准;制裁,处罚; [v]批准,支持,对..实施制裁; [^]sat;
sanctuary: [-]/ˈsæŋktʃueri/; [n]圣堂,避难所; [^]sat;
sanguine: [-]/ˈsæŋɡwɪn/; [a]乐观的,(脸色等)有血色的,多血质的; [n]血红色,乐观; [^]sat;
sap: [-]/sæp/; [n]树液,汁液;易上当的人; [v]削弱;逐渐耗竭; [vt]使伤元气; [vi]挖坑道进攻; [^]sat;
sarcasm: [-]/ˈsɑːrkæzəm/; [n]讽刺,挖苦,嘲笑; [^]sat;
sardonic: [-]/sɑːrˈdɑːnɪk/; [a]讽刺的,嘲笑的; [^]sat;
sartorial: [-]/sɑːrˈtɔːriəl/; [a]裁缝匠的,裁缝的;缝纫的; [^]sat;
sate: [-]/seɪt/; [v]使心满意足,使厌足; [^]sat;
satellite: [-]/ˈsætəlaɪt/; [n]卫星;人造卫星;随体; [a]卫视的; [^]sat;
satiate: [-]/ˈseɪʃieɪt/; [v]使饱足,生腻; [a]饱足的;厌腻的; [^]sat;
satire: [-]/ˈsætaɪər/; [n]讽刺(作品); [^]sat;
satirical: [-]/səˈtɪrɪkl/; [a]讽刺性的,讥讽的,爱挖苦人的; [^]sat;
saturate: [-]/ˈsætʃəreɪt/; [v]使充满,使饱和,使湿透; [^]sat;
saturnine: [-]/ˈsætərnaɪn/; [a]忧郁的,阴沉的,讥讽的; [^]sat;
saunter: [-]/ˈsɔːntər/; [n]漫步,闲逛; [v]闲逛,漫步; [^]sat;
savant: [-]/sæˈvɑːnt/; [n]博学之士,大学士; [^]sat;
savor: [-]/ˈseɪvər/; [n]味道,气味,特点,趣味; [v]调味,品尝,欣赏,玩味; [^]sat;
savory: [-]/ˈseɪvəri/; [a]口感好的,味道好的,令人愉悦的; [^]sat;
scabbard: [-]/ˈskæbərd/; [n](刀,剑)鞘,枪套; [v]把.插入鞘中; [^]sat;
scaffold: [-]/ˈskæfoʊld/; [n]支架;断头台;脚手架;脚手架材料; [vt]给.搭脚手架; [^]sat;
scale: [-]/skeɪl/; [n]天平,磅秤;刻度,尺度,标度;等级,级别, 等级体系;鳞片,鳞状物;规模;水垢,牙垢; [v]攀登;按比例决定;称重;刮鳞,剥落; [^]sat;
scanty: [-]/ˈskænti/; [a]少的,小的,缺乏的; [^]sat;
scapegoat: [-]/ˈskeɪpɡoʊt/; [n]替罪羊; [^]sat;
scavenge: [-]/ˈskævɪndʒ/; [v](在废物中)寻觅;(动物)食腐肉;打扫;排除废气; [^]sat;
scenario: [-]/səˈnærioʊ/; [n]剧情梗概;情况,情节;设想; [^]sat;
schematic: [-]/skiːˈmætɪk/; [a]图示的,扼要的; [n]简图; [^]sat;
schism: [-]/ˈsɪzəm/; [n]分裂,(教派或政党的)分裂; [^]sat;
scintillate: [-]/'sɪntlˌeɪt/; [v]闪烁,(淡吐)流露机智; [^]sat;
scoff: [-]/skɔːf/; [vi]讥笑; [v]嘲笑; [n]愚弄; [^]sat;
scourge: [-]/skɜːrdʒ/; [n]鞭笞,磨难,带来灾难的事物或人(祸害); [v]鞭笞,折磨,使苦恼; [^]sat;
scruple: [-]/ˈskruːpl/; [n]顾虑,不安; [vi]有顾虑,良心上感到不安; [^]sat;
scrupulous: [-]/ˈskruːpjələs/; [a]小心谨慎的;严谨的;细心的; [^]sat;
scrutinize: [-]/ˈskruːtənaɪz/; [v]仔细检查,细看; [^]sat;
scuffle: [-]/ˈskʌfl/; [v]混战,扭打,拖着脚步快速行走; [n]混战,扭打; [^]sat;
scurry: [-]/ˈskɜːri/; [v]快速疾走,急跑,急躁不安地来回走动; [n]快步急跑;疾走;仓皇奔跑声;骤雨; [^]sat;
scurvy: [-]/ˈskɜːrvi/; [n]坏血病; [a]卑鄙的,下流的; [^]sat;
seamy: [-]/ˈsiːmi/; [a]丑恶的,露出线缝的; [^]sat;
secession: [-]/sɪˈseʃn/; [n]脱离,退出; [^]sat;
seclusion: [-]/sɪˈkluːʒn/; [n]隐遁,隐蔽的地方; [^]sat;
secrete: [-]/sɪˈkriːt/; [v]藏匿;私下侵吞;分泌; [^]sat;
sedate: [-]/sɪˈdeɪt/; [a]沉着的,镇定的,平和的; [v]使服镇静剂而安静下来; [^]sat;
sedentary: [-]/ˈsednteri/; [a]久坐不动的;静止的;坐惯的,定栖的; [^]sat;
sedulous: [-]/ˈsedʒələs/; [a]聚精会神的,勤勉的; [^]sat;
seedy: [-]/ˈsiːdi/; [a]多种子的,结籽的,破旧的,褴褛的; [^]sat;
seemly: [-]/ˈsiːmli/; [a]适当的,有礼的,好看的; [ad]适当地; [^]sat;
seep: [-]/siːp/; [v](液体等)渗漏,(观念等)渗入,(疾病恐惧等)扩散; [n]小泉,水陆两用的吉普车; [^]sat;
seethe: [-]/siːð/; [v]沸腾;汹涌;激动; [^]sat;
seismic: [-]/ˈsaɪzmɪk/; [a]地震的;地震引起的;剧烈的; [^]sat;
seminary: [-]/ˈsemɪneri/; [n]神学院,学校,发源地,高级中学; [^]sat;
sensual: [-]/ˈsenʃuəl/; [a]感官的;色情的,肉欲的; [^]sat;
sententious: [-]/senˈtenʃəs/; [a]好说教的,简要的,警句的; [^]sat;
sentinel: [-]/ˈsentɪnl/; [n]哨兵,看守; [v]守卫,放哨; [^]sat;
sequester: [-]/sɪˈkwestər/; [v]使隔离,隔绝,使隐退,没收,扣押; [^]sat;
serendipity: [-]/ˌserənˈdɪpəti/; [n]机缘巧合; [^]sat;
serenity: [-]/səˈrenəti/; [n]平静; [^]sat;
serrated: [-]/səˈreɪtɪd/; [a]呈锯齿状的; [^]sat;
servile: [-]/ˈsɜːrvl/; [a]奴颜婢膝的,卑屈的,隶属的; [n]奴隶; [^]sat;
servitude: [-]/ˈsɜːrvətuːd/; [n]劳役,奴役; [^]sat;
sever: [-]/ˈsevər/; [vt]割断,断绝;分开;使分离; [vi]断;裂开;分离; [^]sat;
severity: [-]/sɪˈverəti/; [n]严格,严肃; [^]sat;
shackle: [-]/ˈʃækl/; [n]枷锁,羁绊(物); [v]给..上手铐(脚镣),用钩链连结,束缚; [^]sat;
sham: [-]/ʃæm/; [n]假货;虚假;欺诈; [v]假装; [a]虚假的,假装的; [^]sat;
shambles: [-]/ˈʃæmblz/; [n]混乱,废墟,屠宰场; [v]蹒跚而行,拖着脚走,踉跄地走; [^]sat;
shard: [-]/ʃɑːrd/; [n](陶器等)碎片,破片; [^]sat;
sheaf: [-]/ʃiːf/; [n]一捆,一束; [v]捆,束; [^]sat;
shear: [-]/ʃɪr/; [vt]剪羊毛;剪头发; [n](复数)大剪刀; [^]sat;
sheer: [-]/ʃɪr/; [a]陡峭的;纯粹的; [v](off)急转向,偏离; [n]透明薄纱,透明布料的衣服; [ad]完全地,全然;垂直地,陡峭地; [^]sat;
shimmer: [-]/ˈʃɪmər/; [v]闪烁,微微发亮; [n]微光,闪光; [^]sat;
shirk: [-]/ʃɜːrk/; [v]逃避;规避(义务,责任等); [n]偷懒者; [^]sat;
shoddy: [-]/ˈʃɑːdi/; [a]劣等的;假的;冒充的;虚有其表的; [n]赝品,不值钱的东西; [^]sat;
shrewd: [-]/ʃruːd/; [a]精明的;机灵的; [n]精明;精明者; [^]sat;
shroud: [-]/ʃraʊd/; [n]寿衣,覆盖物; [v]覆盖,包以尸衣; [^]sat;
shun: [-]/ʃʌn/; [v](有意或习惯性地)避开,躲开; [^]sat;
shyster: [-]/ˈʃaɪstər/; [n]奸诈的人(尤指政客),讼棍; [^]sat;
sibling: [-]/ˈsɪblɪŋ/; [n]兄弟姊妹;同胞;(生物)同科,同属; [^]sat;
simian: [-]/ˈsɪmiən/; [n]类人猴,猴子; [a]猿的,猴的; [^]sat;
simile: [-]/ˈsɪməli/; [n]直喻,明喻; [^]sat;
simulate: [-]/ˈsɪmjuleɪt/; [v]假装;模仿;模拟; [^]sat;
sinecure: [-]/ˈsaɪnɪkjʊr/; [n]闲职,挂名职务; [^]sat;
sinewy: [-]/ˈsɪnjuːi/; [a]多腱的,强壮有力的; [^]sat;
singular: [-]/ˈsɪŋɡjələr/; [a]单独的,单个的;奇怪的;非凡的,卓越的,显著的; [n]单数;单数形式; [^]sat;
sinister: [-]/ˈsɪnɪstər/; [a]不吉祥的,险恶的; [^]sat;
sinuous: [-]/ˈsɪnjuəs/; [a]弯曲的,蜿蜒的; [^]sat;
skeptic: [-]/ˈskeptɪk/; [n]怀疑论者;怀疑者;无神论者; [^]sat;
skiff: [-]/skɪf/; [n]小艇;小型帆船;轻舟; [^]sat;
skimp: [-]/skɪmp/; [vt]少给,克扣,不足量地供给;对.草率从事; [vi]克俭,节省; [a]少的,不足的; [^]sat;
skinflint: [-]/ˈskɪnflɪnt/; [n]吝啬鬼; [^]sat;
skirmish: [-]/ˈskɜːrmɪʃ/; [n]小战役,小争吵; [v]卷入战役(争论),搜索; [^]sat;
slacken: [-]/ˈslækən/; [v](使)慢下来,放松,松懈; [^]sat;
slag: [-]/slæɡ/; [n]炉渣,矿渣; [^]sat;
slake: [-]/sleɪk/; [v]解渴,消渴; [^]sat;
slander: [-]/ˈslændər/; [n]诽谤,诋毁; [v]讲坏话,污蔑,诽谤; [^]sat;
sleeper: [-]/ˈsliːpər/; [n]睡眠者;卧车,卧铺;枕木; [^]sat;
sleight: [-]/slaɪt/; [n]巧妙手法,巧计,灵巧; [^]sat;
slight: [-]/slaɪt/; [a]轻微的,微小的;纤细的,瘦弱的;少量的; [n]轻视,蔑视; [vt]轻视,忽略; [^]sat;
slither: [-]/ˈslɪðər/; [v](蛇)滑动,滑行; [n]滑动;滑行; [^]sat;
slothful: [-]/ˈsloʊθfl/; [a]偷懒的,懒惰的; [^]sat;
slough: [-]/slʌf/; [n](蛇等)蜕皮,要脱落或抛弃的东西,绝境; [v](蛇等)蜕皮,陷入泥沼,顽强地前进; [^]sat;
slovenly: [-]/ˈslʌvnli/; [a]不整洁的,马虎的; [^]sat;
sluggard: [-]/ˈslʌɡərd/; [n]懒鬼;游手好闲的人; [^]sat;
sluggish: [-]/ˈslʌɡɪʃ/; [a]行动迟缓的,迟钝的;偷懒的; [^]sat;
slur: [-]/slɜːr/; [n]含糊的发音,藐视,污点,连线符; [vi]含糊地说; [vt]对.忽略,含糊不清地说出,贬低; [^]sat;
smelt: [-]/smelt/; [v]熔解,熔炼; [n]香鱼;胡瓜鱼; [^]sat;
smirk: [-]/smɜːrk/; [n]傻笑;假笑;得意的笑; [vi]傻笑;假笑; [vt]以假笑表示;以傻笑表示; [^]sat;
smolder: [-]/ˈsmoʊldər/; [v]无火焰地闷烧,(仇恨,嫉妒,愤怒等)在心里郁积; [n]焖烧,文火,冒烟; [^]sat;
snicker: [-]/ˈsnɪkər/; [vi]偷笑,窃笑; [vt]窃笑着说; [n]窃笑; [^]sat;
snivel: [-]/ˈsnɪvl/; [v]流鼻涕;啜泣; [^]sat;
sodden: [-]/ˈsɑːdn/; [a]浑身湿透的;浸透的;浸过酒的; [^]sat;
sojourn: [-]/ˈsoʊdʒɜːrn/; [n]逗留,旅居; [vi]逗留,旅居; [^]sat;
solace: [-]/ˈsɑːləs/; [n]慰藉,给予安慰的人或事物; [v]安慰,缓和,使开心; [^]sat;
solder: [-]/ˈsɑːdər/; [v]焊接;使联接在一起; [n]焊接;接合物; [^]sat;
solemnity: [-]/səˈlemnəti/; [n]庄严,肃穆,庄严的仪式; [^]sat;
solicit: [-]/səˈlɪsɪt/; [v]乞求,恳求给予(帮助,金钱); [^]sat;
solicitous: [-]/səˈlɪsɪtəs/; [a]热切期望的;热心的;挂念的; [^]sat;
soliloquy: [-]/səˈlɪləkwi/; [n]自言自语,独白; [^]sat;
solitude: [-]/ˈsɑːlətuːd/; [n]孤独; [^]sat;
soluble: [-]/ˈsɑːljəbl/; [a]可溶解的;可解决的; [^]sat;
solvent: [-]/ˈsɑːlvənt/; [a]有偿付能力的;有溶解力的; [n]溶剂;解决方法; [^]sat;
somber: [-]/'sɒmbə/; [a]忧郁的;昏暗的,阴天的; [^]sat;
somnambulist: [-]/sɑːmˈnæmbjəlɪst/; [n]梦游症患者; [^]sat;
somnolent: [-]/ˈsɑːmnələnt/; [a]思睡的,催眠的; [ad]瞌睡地;昏昏欲睡地;使人瞌睡地;催眠地; [^]sat;
sonorous: [-]/ˈsɑːnərəs/; [a]响亮的,作响的,能发出响亮声音的; [ad]圆润低沉地;感人地,堂皇地; [n]感人,堂皇; [^]sat;
sophisticated: [-]/səˈfɪstɪkeɪtɪd/; [a](仪器)精密的,复杂的;老于世故的,老练的,富有经验的;高雅的,精致的; [^]sat;
soporific: [-]/ˌsɑːpəˈrɪfɪk/; [a]催眠的; [n]安眠药; [^]sat;
sordid: [-]/ˈsɔːrdɪd/; [a]卑鄙的,肮脏的,色彩死气沉沉暗淡的; [^]sat;
sovereign: [-]/ˈsɑːvrən/; [a]至高无上的,具有独立主权的,有最高统治权的; [n]最高统治者,君主,元首; [^]sat;
spangle: [-]/ˈspæŋɡl/; [n](缝在衣服上的)金属亮片;闪光装饰; [v]是闪烁发光;用闪光饰物装饰; [^]sat;
sparse: [-]/spɑːrs/; [a]稀少的;稀疏的; [^]sat;
spat: [-]/spæt/; [n]口角,小争论; [v]轻轻拍打;发生小争吵; [^]sat;
spate: [-]/speɪt/; [n]洪水;一阵;大雨;突然迸发; [^]sat;
spatial: [-]/ˈspeɪʃl/; [a]空间的,关于空间的; [^]sat;
spatula: [-]/ˈspætʃələ/; [n](调和,涂抹用)抹刀,小铲;<医>压舌板; [^]sat;
spawn: [-]/spɔːn/; [n]卵;菌丝;产物; [v]产卵;酿成,造成;大量生产; [^]sat;
specious: [-]/ˈspiːʃəs/; [a]外表美观,华而不实的,徒有其表的; [^]sat;
spectrum: [-]/ˈspektrəm/; [n]光谱,范围,系列; [^]sat;
spendthrift: [-]/ˈspendθrɪft/; [a]挥霍无度的;浪费的; [n]挥霍无度的人;浪费的人; [^]sat;
splice: [-]/splaɪs/; [n]接合,衔接处; [v]接头,捻接(线头等); [^]sat;
spontaneity: [-]/ˌspɑːntəˈneɪəti/; [n]自发性,自然行为;自然发生; [^]sat;
sporadic: [-]/spəˈrædɪk/; [a]不定时发生的;零星的;分散的; [^]sat;
sportive: [-]/'spɔːtɪv/; [a]运动的;嬉戏的;适合运动穿戴的; [^]sat;
spurious: [-]/ˈspjʊriəs/; [a]假的,伪造的,欺骗的; [^]sat;
spurn: [-]/spɜːrn/; [v]轻蔑地拒绝,摒弃,唾弃,一脚踢开; [^]sat;
squabble: [-]/ˈskwɑːbl/; [v]发生口角,大声争吵; [n]争吵,口角; [^]sat;
squalor: [-]/ˈskwɑːlər/; [n]肮脏,邋遢,(道德品质等的)卑劣; [^]sat;
squander: [-]/ˈskwɑːndər/; [n]浪费,挥霍; [v]浪费,挥霍; [^]sat;
squat: [-]/skwɑːt/; [a]蹲着的; [v]蹲坐,蹲伏; [n]蹲坐; [^]sat;
staccato: [-]/stəˈkɑːtoʊ/; [a](音乐)断音的,不连贯的; [n]断奏;断续的一段音乐;不连贯的东西(如说话,发动机的声音等); [ad]断音地;不连接地; [^]sat;
stagnant: [-]/ˈstæɡnənt/; [a]不流动的;停滞的;萧条的; [^]sat;
stalemate: [-]/ˈsteɪlmeɪt/; [n]和棋局面,僵局; [v]使陷入僵局; [^]sat;
stalwart: [-]/ˈstɔːlwərt/; [n]坚定的成员;健壮的人; [a]强壮的,坚定的,忠诚的; [^]sat;
stamina: [-]/ˈstæmɪnə/; [n]耐力,持久力; [^]sat;
stanch: [-]/stɔːntʃ/; [v]制止(血液),止住; [a]坚固的;坚定的;可靠的;不漏水的; [^]sat;
stanza: [-]/ˈstænzə/; [n]诗节; [^]sat;
static: [-]/ˈstætɪk/; [a]静电的,静态的,静止的; [n]静电,静电干扰; [^]sat;
statute: [-]/ˈstætʃuːt/; [n]法令,法规,条例; [^]sat;
steadfast: [-]/ˈstedfæst/; [a]坚定的;不变的; [^]sat;
stealth: [-]/stelθ/; [n]隐秘,秘密; [^]sat;
steep: [-]/stiːp/; [v]沉浸于..; [a]陡峭的;急剧的;过高的; [n]陡坡; [^]sat;
stellar: [-]/ˈstelər/; [a]星的,星球的,主要的; [^]sat;
stem: [-]/stem/; [n]茎,(树)干; [v]阻止;起源于;遏制,抑制; [^]sat;
stereotype: [-]/ˈsteriətaɪp/; [n]老套的模式,陈规,成见; [v]对..产生成见; [^]sat;
stifle: [-]/ˈstaɪfl/; [v]抑制,压制,使窒息; [^]sat;
stigma: [-]/ˈstɪɡmə/; [n]<植>柱头,耻辱,污名,烙印,特征; [^]sat;
stigmatize: [-]/ˈstɪɡmətaɪz/; [v]诬蔑,玷污; [^]sat;
stint: [-]/stɪnt/; [n]节约;从事某工作的时间;固定; [v]节省;限制; [^]sat;
stipend: [-]/ˈstaɪpend/; [n]奖学金;固定薪金;定期津贴;养老金; [^]sat;
stipulate: [-]/ˈstɪpjuleɪt/; [v]规定;保证;保证;要求以.为条件; [^]sat;
stodgy: [-]/ˈstɑːdʒi/; [a]平凡的;塞满的;庸俗的; [^]sat;
stoic: [-]/ˈstoʊɪkl/; [n]斯多葛学派哲学家;禁欲主义者;坚守克己之人; [a]斯多葛派的;禁欲主义的; [^]sat;
stoke: [-]/stoʊk/; [v]添加燃料,把(火)拨旺,狼吞虎咽吃; [n]斯托克;<物>沲; [^]sat;
stolid: [-]/ˈstɑːlɪd/; [a]无动于衷的,感情麻木的; [^]sat;
stratagem: [-]/ˈstrætədʒəm/; [n]谋略,策略; [^]sat;
stratify: [-]/ˈstrætɪfaɪ/; [v]分层,成层,阶层化; [^]sat;
stratum: [-]/ˈstreɪtəm/; [n]层次;薄层;地层;阶层; [^]sat;
strew: [-]/struː/; [vt]撒;把.撒在.上;散播,点缀; [^]sat;
stricture: [-]/ˈstrɪktʃər/; [n]谴责;严厉;束缚; [^]sat;
strident: [-]/ˈstraɪdnt/; [a]尖声的,刺耳的; [^]sat;
stringent: [-]/ˈstrɪndʒənt/; [a]严厉的;迫切的;银根紧的; [^]sat;
strut: [-]/strʌt/; [n]高视阔步,抗压装置; [v]昂首阔步地走,趾高气昂地走; [^]sat;
stultify: [-]/ˈstʌltɪfaɪ/; [v]使显得愚蠢,愚弄,使无效,使无价值; [^]sat;
stupefy: [-]/ˈstuːpɪfaɪ/; [v](使)茫然,吓呆; [^]sat;
stupor: [-]/ˈstuːpər/; [n]恍惚,昏迷,不醒人事; [^]sat;
stymie: [-]/ˈstaɪmi/; [v]从中作梗,阻挠;妨碍; [n]妨碍球; [^]sat;
subdued: [-]/səbˈduːd/; [a]减弱的;被制服的;被抑制的; [^]sat;
subjective: [-]/səbˈdʒektɪv/; [a]主观(上)的,个人的; [^]sat;
subjugate: [-]/ˈsʌbdʒuɡeɪt/; [v]征服,使服从; [^]sat;
sublime: [-]/səˈblaɪm/; [a]雄伟的,崇高的,极端的,超群的;(行为,态度)极端的,漠不关心的; [n]顶峰,崇高; [v]使.纯化,使.升华,变高尚; [^]sat;
subliminal: [-]/ˌsʌbˈlɪmɪnl/; [a]潜意识的,下意识的; [^]sat;
submissive: [-]/səbˈmɪsɪv/; [a]顺从的,惟命是从的,谦恭的; [^]sat;
subordinate: [-]/səˈbɔːrdɪnət/; [n]部下;下属; [a]次要的;从属的;下级的; [v]使从属于;使处于次要地位; [^]sat;
subpoena: [-]/səˈpiːnə/; [n](法律)传票; [v]传讯;传审; [^]sat;
subsequent: [-]/ˈsʌbsɪkwənt/; [a]随后的; [^]sat;
subservient: [-]/səbˈsɜːrviənt/; [a]屈从的;奉承的;有用的,有帮助的; [^]sat;
subside: [-]/səbˈsaɪd/; [vi]平息,减弱;减弱;(建筑)下陷;(尤指洪水的水位) 回落; [^]sat;
subsidiary: [-]/səbˈsɪdieri/; [a]辅助的,次要的,附属的; [n]子公司,附属机构; [^]sat;
subsidy: [-]/ˈsʌbsədi/; [n]补助金,津贴; [^]sat;
subsistence: [-]/səbˈsɪstəns/; [n]存在,生存;生活; [a]收成仅够自身口粮的; [^]sat;
substantiate: [-]/səbˈstænʃieɪt/; [v]证实;使实体化; [^]sat;
substantive: [-]/səbˈstæntɪv/; [a]有实质的;大量的;真实的;独立存在的; [n]实词,名词,名词性词组; [^]sat;
subterfuge: [-]/ˈsʌbtərfjuːdʒ/; [n]托词,借口,诡计; [^]sat;
subversive: [-]/səbˈvɜːrsɪv/; [n]颠覆分子,破坏分子; [a]颠覆性的,破坏性的; [^]sat;
succinct: [-]/səkˈsɪŋkt/; [a]简明的,简洁的,没有废话的; [^]sat;
succor: [-]/ˈsʌkər/; [n]救援,援助者,救援人员; [v]援助,救援; [^]sat;
succulent: [-]/ˈsʌkjələnt/; [n]肉质植物; [a]多汁鲜美的;丰富多彩的; [^]sat;
succumb: [-]/səˈkʌm/; [v]屈从,屈服,因.死亡(to); [^]sat;
sully: [-]/ˈsʌli/; [v]玷污,污染; [^]sat;
sultry: [-]/ˈsʌltri/; [a]闷热的,狂暴的,淫荡的; [^]sat;
summit: [-]/ˈsʌmɪt/; [n]山顶,顶点;(政府间的)峰会; [^]sat;
sumptuous: [-]/ˈsʌmptʃuəs/; [a]奢侈的;华丽的; [^]sat;
sunder: [-]/ˈsʌndər/; [v]切开;分裂,分离; [^]sat;
supercilious: [-]/ˌsuːpərˈsɪliəs/; [a]目中无人的,高傲的; [^]sat;
superficial: [-]/ˌsuːpərˈfɪʃl/; [a]肤浅的;表面的;微不足道的; [n]表面文章; [^]sat;
superfluous: [-]/suːˈpɜːrfluəs/; [a]多余的,过剩的;不必要的; [^]sat;
superimpose: [-]/ˌsuːpərɪmˈpoʊz/; [v]添加;重叠;附加;安装; [^]sat;
supersede: [-]/ˌsuːpərˈsiːd/; [v]代替;紧接着而到来; [^]sat;
supplant: [-]/səˈplænt/; [v]代替;排挤掉; [^]sat;
supple: [-]/ˈsʌpl/; [a]柔软的;柔顺的; [^]sat;
supplicate: [-]/'sʌplɪˌkeɪt/; [v]恳求,乞求; [^]sat;
suppress: [-]/səˈpres/; [v]镇压;禁止发表;抑制(感情等);阻止.的生长; [^]sat;
surfeit: [-]/ˈsɜːrfɪt/; [n]饮食过度,过量; [^]sat;
surly: [-]/ˈsɜːrli/; [a]乖戾的;无礼的;阴沉的; [^]sat;
surmise: [-]/sərˈmaɪz/; [v]猜测,推测,认为; [n]推测,猜度; [^]sat;
surmount: [-]/sərˈmaʊnt/; [v]克服,战胜,越过; [^]sat;
surpass: [-]/sərˈpæs/; [v]胜过;超出; [^]sat;
surreptitious: [-]/ˌsɜːrəpˈtɪʃəs/; [a]鬼鬼祟祟的,暗中的,秘密的; [^]sat;
surrogate: [-]/ˈsɜːrəɡət/; [n]代替品,代理人,代孕妈妈; [a]代理的,替代的; [v]代替,代理;指定为自己的代理人,接替; [^]sat;
surveillance: [-]/sɜːrˈveɪləns/; [n]监视;检查; [^]sat;
susceptible: [-]/səˈseptəbl/; [a]易受感染的;易受影响的;多情的; [^]sat;
sustain: [-]/səˈsteɪn/; [v]维持;支撑,承受;供养;忍受;遭受,蒙受; [^]sat;
sustenance: [-]/ˈsʌstənəns/; [n]生计;食物,粮食; [^]sat;
suture: [-]/ˈsuːtʃər/; [n]缝合; [v]缝合; [^]sat;
swagger: [-]/ˈswæɡər/; [n]傲慢的态度,大摇大摆; [v]大摇大摆地走,吹牛,傲慢; [a]豪华时髦的; [^]sat;
swarm: [-]/swɔːrm/; [n]蜂群;一群,一批人; [v]蜂拥;密集; [vt]蜂拥;挤满; [^]sat;
swarthy: [-]/ˈswɔːrði/; [a](皮肤等)黝黑的; [^]sat;
swathe: [-]/sweɪð/; [n]带子,绷带;包装品; [vt]包围;紧绑;裹; [^]sat;
swerve: [-]/swɜːrv/; [v]转弯,突然改变方向; [n]转向;滑出;逸出;背离; [^]sat;
swill: [-]/swɪl/; [n]泔水;冲洗;痛饮; [v]冲洗,痛饮; [^]sat;
swindler: [-]/ˈswɪndlər/; [n]骗子; [^]sat;
sybarite: [-]/'sɪbəˌraɪt/; [n]沉于奢侈逸乐者,酒色之徒; [^]sat;
sycophant: [-]/ˈsɪkəfænt/; [n]马屁精; [^]sat;
symbiosis: [-]/ˌsɪmbɪˈoʊsɪs/; [n]共生,共栖; [^]sat;
symmetry: [-]/ˈsɪmətri/; [n]对称;均衡; [^]sat;
synoptic: [-]/sɪˈnɑːptɪk/; [a]天气的,概要的,一览无余的; [^]sat;
synthesis: [-]/ˈsɪnθəsɪs/; [n]合成; [^]sat;
tacit: [-]/ˈtæsɪt/; [a]心照不宣的,静默的; [^]sat;
taciturn: [-]/ˈtæsɪtɜːrn/; [a]沉默寡言的; [^]sat;
tactile: [-]/ˈtæktl/; [a]有触觉的;能触知的; [^]sat;
taint: [-]/teɪnt/; [n]污点;感染;异味; [vi]腐败,腐烂; [vt]污染;玷污,使受不良影响; [^]sat;
talisman: [-]/ˈtælɪzmən/; [n]护身符,避邪物; [^]sat;
talon: [-]/ˈtælən/; [n]猛禽的锐爪; [^]sat;
tanner: [-]/ˈtænər/; [n]制革工人,六便士; [^]sat;
tantalize: [-]/ˈtæntəlaɪz/; [v]逗弄,挑逗,使(看到拿不到而)焦急; [^]sat;
tantamount: [-]/ˈtæntəmaʊnt/; [a]与.相等的; [^]sat;
tantrum: [-]/ˈtæntrəm/; [n](孩子气的)脾气发作; [^]sat;
tarry: [-]/ˈtæri/; [n]逗留,短期滞在; [v]耽搁,踌躇(等待),拖延; [a]柏油的,涂柏油的; [^]sat;
taut: [-]/tɔːt/; [a]拉紧的;紧张的;整洁的; [^]sat;
tawdry: [-]/ˈtɔːdri/; [a]非常华丽的,廉价而俗丽的; [n]俗丽的东西,廉价而俗丽之物; [ad]俗丽地,华而不实地; [^]sat;
tedious: [-]/ˈtiːdiəs/; [a]沉闷的,冗长乏味的; [^]sat;
temerity: [-]/təˈmerəti/; [n]鲁莽,大胆,蛮勇; [^]sat;
temper: [-]/ˈtempər/; [n]脾气,性情;调和剂; [v]锻炼,缓和; [^]sat;
temperament: [-]/ˈtemprəmənt/; [n]气质,性格,喜怒无常; [^]sat;
temperate: [-]/ˈtempərət/; [a]温和的;适度的,有节制的; [^]sat;
tempestuous: [-]/temˈpestʃuəs/; [a]有暴风雨的,暴乱的,剧烈的; [^]sat;
tempo: [-]/ˈtempoʊ/; [n]<音>节奏,拍子;行进速度; [^]sat;
temporal: [-]/ˈtempərəl/; [a]现世的,世俗的;当时的,暂时的;<解>颞的;时间的; [n]世间万物;教会财产; [^]sat;
temporize: [-]/ˈtempəraɪz/; [v]拖延,妥协,顺应时势,迎合潮流; [^]sat;
tenacious: [-]/təˈneɪʃəs/; [a]坚忍不拔的,固执的,顽强的; [^]sat;
tenacity: [-]/təˈnæsəti/; [n]坚韧不拔,顽强精神; [^]sat;
tendentious: [-]/tenˈdenʃəs/; [a]有偏见的,有倾向的;宣传性的; [ad]宣传性地,不公平地,有倾向性地; [n]倾向性小说; [^]sat;
tender: [-]/ˈtendər/; [a]温柔的;嫩的;柔弱的,脆弱的;痛的; [n]煤水车,附属船;投标; [v]提出(希望对方接受的意见等); [^]sat;
tenet: [-]/ˈtenɪt/; [n]信念,原则,教条; [^]sat;
tensile: [-]/ˈtensl/; [a]可拉长的,可伸长的,<物>张力的,拉力的; [^]sat;
tenuous: [-]/ˈtenjuəs/; [a]纤细的;稀薄的;贫乏的;脆弱的; [^]sat;
tenure: [-]/ˈtenjər/; [n]任期;终身职位; [^]sat;
tepid: [-]/ˈtepɪd/; [a]微温的,不热烈的; [^]sat;
termination: [-]/ˌtɜːrmɪˈneɪʃn/; [n]终端;结果;结束,终止; [^]sat;
terminology: [-]/ˌtɜːrməˈnɑːlədʒi/; [n]术语,术语学; [^]sat;
terrestrial: [-]/təˈrestriəl/; [a]地球的,陆地的; [n]陆地生物;地球上的人; [^]sat;
terse: [-]/tɜːrs/; [a]简洁的,简明的; [^]sat;
testy: [-]/ˈtesti/; [a]性急的,暴躁的; [^]sat;
tether: [-]/ˈteðər/; [n]范围,系链,拴绳; [v]用绳或链拴住; [^]sat;
theocracy: [-]/θiˈɑːkrəsi/; [n]神权政治; [^]sat;
theoretical: [-]/ˌθiːəˈretɪkl/; [a]理论(上)的; [^]sat;
therapeutic: [-]/ˌθerəˈpjuːtɪk/; [a]治疗的;治疗学的;有益于健康的; [n]治疗剂;治疗学家; [^]sat;
thermal: [-]/ˈθɜːrml/; [a]保暖的;温泉的;热的; [n]保暖内衣裤; [^]sat;
thespian: [-]/ˈθespiən/; [a]悲剧的;戏剧的; [n]演员;悲剧演员; [^]sat;
threadbare: [-]/ˈθredber/; [a]磨破的,衣衫褴褛的,乏味的,俗套的; [^]sat;
thrifty: [-]/ˈθrɪfti/; [a]节省的,节俭的; [^]sat;
thrive: [-]/θraɪv/; [v]茁壮成长;繁荣,兴旺; [^]sat;
throng: [-]/θrɔːŋ/; [v]群集,蜂拥; [n]一大群人; [vt]挤向; [^]sat;
thwart: [-]/θwɔːrt/; [n]<船>横坐板; [v]阻挠,阻碍,横过; [a]横放的; [ad]横过; prep. 〈古〉横跨,横过; [^]sat;
timidity: [-]/tɪˈmɪdəti/; [n]胆怯; [^]sat;
timorous: [-]/ˈtɪmərəs/; [a]胆小的,胆怯的,羞怯的; [^]sat;
tirade: [-]/ˈtaɪreɪd/; [n]长篇的攻击性演说; [^]sat;
title: [-]/ˈtaɪtl/; [n]标题;头衔;权利; [vt]加标题于;授予.称号; [a]标题的,题目的;称呼的; [^]sat;
toady: [-]/ˈtoʊdi/; [n]谄媚者,拍马屁的人; [v]谄媚,拍马屁; [^]sat;
tome: [-]/toʊm/; [n]册,卷,本,大本书; [^]sat;
tonic: [-]/ˈtɑːnɪk/; [n]补药;主调音或基音; [a]滋补的;声调的;使精神振作的; [^]sat;
topography: [-]/təˈpɑːɡrəfi/; [n]地形学;地形,地貌;局部解剖学;地形图,地势图; [^]sat;
torpor: [-]/ˈtɔːrpər/; [n]麻木;无感觉;不活泼; [^]sat;
torrent: [-]/ˈtɔːrənt/; [n]湍流,洪流,奔流;迸发,连发,爆发;倾盆大雨; [^]sat;
torrid: [-]/ˈtɔːrɪd/; [a]酷热的,热烈; [^]sat;
torso: [-]/ˈtɔːrsoʊ/; [n](人体的)躯干,躯干像; [^]sat;
tortuous: [-]/ˈtɔːrtʃuəs/; [a]弯弯曲曲的,蜿蜒的; [^]sat;
totter: [-]/ˈtɑːtər/; [n]蹒跚,踉跄; [vi]蹒跚,踉跄,动摇,摇摇欲坠; [^]sat;
touchy: [-]/ˈtʌtʃi/; [a](人或话题)敏感的,易发脾气的; [ad]易动气地,过分敏感地,小心眼地; [n]易动气,过分敏感; [^]sat;
tout: [-]/taʊt/; [v]招徕顾客,极力赞扬; [^]sat;
toxic: [-]/ˈtɑːksɪk/; [n]毒物; [a]有毒的;中毒的; [^]sat;
tract: [-]/trækt/; [n]器官系统;一大片地;短文,小册子; [^]sat;
tractable: [-]/ˈtræktəbl/; [a]易于管教的,易驾驭的,易处理的,驯良的; [^]sat;
trajectory: [-]/trəˈdʒektəri/; [n]弹道,航线;轨线; [^]sat;
transcribe: [-]/trænˈskraɪb/; [v]抄写,转录; [^]sat;
transient: [-]/ˈtrænʃnt/; [a]短暂的,路过的;转瞬即逝的; [n]过客; [^]sat;
transition: [-]/trænˈzɪʃn/; [n]转变,过渡时期; [v](从某一状态或活动)转变,过渡(到另一状态或活动); [^]sat;
transitory: [-]/ˈtrænsətɔːri/; [a]短暂的,暂时的,瞬息的; [^]sat;
translucent: [-]/trænsˈluːsnt/; [a]半透明的;透亮的,有光泽的;易懂的;真实的; [^]sat;
transmute: [-]/trænzˈmjuːt/; [v]使改变,使变形; [^]sat;
transparent: [-]/trænsˈpærənt/; [a]透明的,清澈的,明净的;易识破的,显而易见的; [^]sat;
transport: [-]/ˈtrænspɔːrt/; [v]运输;使狂喜;流放; [n]运输;运输工具;流放犯; [^]sat;
trappings: [-]/ˈtræpɪŋz/; [n]服饰,礼服,外部标志,马饰; [^]sat;
traumatic: [-]/traʊˈmætɪk/; [a](精神)受创伤的,外伤的; [^]sat;
travail: [-]/trəˈveɪl/; [n]分娩的痛苦,艰苦劳动; [v]辛勤努力,经受分娩的阵痛; [^]sat;
traverse: [-]/trəˈvɜːrs/; [v]横越;穿过; [n]横越; [^]sat;
travesty: [-]/ˈtrævəsti/; [n]滑稽模仿;拙劣的模仿作品;歪曲; [vt]滑稽地模仿;歪曲; [^]sat;
treatise: [-]/ˈtriːtɪs/; [n]论述;论文;专著; [^]sat;
trek: [-]/trek/; [n]艰苦跋涉; [v]拉(货车),搬运; [^]sat;
tremor: [-]/ˈtremər/; [n](小)地震;<医>震颤,战栗,发抖; [^]sat;
tremulous: [-]/ˈtremjələs/; [a]胆小的,颤动的,不安的; [^]sat;
trenchant: [-]/ˈtrentʃənt/; [a]犀利的,锐利的,有力的,清晰的,一针见血的; [^]sat;
trepidation: [-]/ˌtrepɪˈdeɪʃn/; [n]恐惧,惶恐; [^]sat;
trespass: [-]/ˈtrespæs/; [v]侵入;犯罪; [n]罪过;非法侵入; [^]sat;
tribute: [-]/ˈtrɪbjuːt/; [n]致敬;悼念;贡品;称赞; [^]sat;
trifling: [-]/ˈtraɪflɪŋ/; [a]细微的,不重要的; [^]sat;
trigger: [-]/ˈtrɪɡər/; [n](枪等的)扳机,诱因; [v]触发,引起,激发,扣扳机; [^]sat;
trinket: [-]/ˈtrɪŋkɪt/; [n]小装饰品,不值钱的珠宝; [^]sat;
trite: [-]/traɪt/; [a]陈腐的;平庸的;老一套的; [^]sat;
trough: [-]/trɔːf/; [n]水槽,水槽;低谷期;饲料槽;低气压; [^]sat;
truism: [-]/ˈtruːɪzəm/; [n]自明之理,真理,不言而喻的道理; [^]sat;
truncate: [-]/ˈtrʌŋkeɪt/; [a]截短的;被删节的; [v]把(某物)截短,去尾; [^]sat;
tumult: [-]/ˈtuːmʌlt/; [n]骚动;骚乱;吵闹;激动; [^]sat;
tundra: [-]/ˈtʌndrə/; [n]冻土地带; [^]sat;
turbid: [-]/ˈtɜːrbɪd/; [a]混浊的,紊乱的; [^]sat;
turbulence: [-]/ˈtɜːrbjələns/; [n]骚乱,动荡;狂暴;(空气或水的)乱流; [^]sat;
turgid: [-]/ˈtɜːrdʒɪd/; [a]肿胀的;浮夸的;浮肿的; [^]sat;
turmoil: [-]/ˈtɜːrmɔɪl/; [n]骚动,骚乱; [^]sat;
turncoat: [-]/ˈtɜːrnkoʊt/; [n]叛徒; [^]sat;
turpitude: [-]/ˈtɜːrpətuːd/; [n]邪恶,卑鄙(行为); [^]sat;
tutelage: [-]/ˈtuːtəlɪdʒ/; [n]监护,指导; [^]sat;
tycoon: [-]/taɪˈkuːn/; [n]有钱有势的企业家,大亨; [^]sat;
typhoon: [-]/taɪˈfuːn/; [n]台风,强热带风暴; [^]sat;
tyranny: [-]/ˈtɪrəni/; [n]暴政,苛政,虐待; [^]sat;
tyro: [-]/ˈtaɪroʊ/; [n]新手; [^]sat;
ubiquitous: [-]/juːˈbɪkwɪtəs/; [a]普遍存在的;无所不在的; [^]sat;
ultimate: [-]/ˈʌltɪmət/; [a]根本的;最后的,最终的; [^]sat;
unanimity: [-]/ˌjuːnəˈnɪməti/; [n]一致同意; [^]sat;
unassailable: [-]/ˌʌnəˈseɪləbl/; [a]无可争辩的,无懈可击的,不可亵渎的; [^]sat;
unassuming: [-]/ˌʌnəˈsuːmɪŋ/; [a]谦逊的,不装腔作势的; [^]sat;
unbridled: [-]/ʌnˈbraɪdld/; [a]无拘束的;激烈的;放纵的;放纵的,无约束的; [^]sat;
uncanny: [-]/ʌnˈkæni/; [a]神秘的,不可思议的; [^]sat;
uncouth: [-]/ʌnˈkuːθ/; [a]笨拙的;粗野的;不舒适的;陌生的; [^]sat;
unctuous: [-]/ˈʌŋktʃuəs/; [a]油腔滑调的,虚情假意的; [^]sat;
underlying: [-]/ˌʌndərˈlaɪɪŋ/; [a]基本的;潜在的;在下面的; [^]sat;
undermine: [-]/ˌʌndərˈmaɪn/; [v]暗中破坏;逐渐削弱;侵蚀.的基础;在...下挖坑道,从根基处损害; [^]sat;
underscore: [-]/ˌʌndərˈskɔːr/; [v]强调,加强,划线于.下; [n]底线; [^]sat;
unearth: [-]/ʌnˈɜːrθ/; [vt]发掘,掘出,揭露,发现;揭发; [^]sat;
unequivocal: [-]/ˌʌnɪˈkwɪvəkl/; [a]明确的,不含糊的; [^]sat;
ungainly: [-]/ʌnˈɡeɪnli/; [a]笨拙的,不雅的; [ad]笨拙地;不雅地; [^]sat;
uniformity: [-]/ˌjuːnɪˈfɔːrməti/; [n]均匀性;一致,一致性;同样; [^]sat;
unimpeachable: [-]/ˌʌnɪmˈpiːtʃəbl/; [a]可信的,无可挑剔的; [^]sat;
unique: [-]/juˈniːk/; [a]独特的,独一无二的;(唯一的)特有的;不同寻常的; [^]sat;
universal: [-]/ˌjuːnɪˈvɜːrsl/; [a]普遍存在的;全体的;通用的;宇宙的; [n]普遍原则; [^]sat;
unkempt: [-]/ˌʌnˈkempt/; [a](衣服,头发)不整洁的;蓬乱的; [^]sat;
unobtrusive: [-]/ˌʌnəbˈtruːsɪv/; [a]不唐突的,谦虚的,不引人注目的; [^]sat;
unpalatable: [-]/ʌnˈpælətəbl/; [a]不可口的,不好吃的;令人不愉快的; 使人难以接受的; [^]sat;
unprecedented: [-]/ʌnˈpresɪdentɪd/; [a]前所未有的,空前的,无前例的; [^]sat;
unravel: [-]/ʌnˈrævl/; [v]解开;拆开;阐明;解释; [^]sat;
unrequited: [-]/ˌʌnrɪˈkwaɪtɪd/; [a]无回报的;无报酬的; [^]sat;
unruly: [-]/ʌnˈruːli/; [a]不守规矩的;任性的;难驾驭的; [^]sat;
unscathed: [-]/ʌnˈskeɪðd/; [a]未受损伤的;未遭伤害的; [^]sat;
unseemly: [-]/ʌnˈsiːmli/; [a]不适宜的;不得体的; [ad]不适当地; [^]sat;
unsightly: [-]/ʌnˈsaɪtli/; [a]难看的; [^]sat;
untenable: [-]/ʌnˈtenəbl/; [a]防守不住的,站不住脚的; [^]sat;
unwarranted: [-]/ʌnˈwɔːrəntɪd/; [a]未经保证的,无根据的,不合适的; [^]sat;
unwieldy: [-]/ʌnˈwiːldi/; [a]使用不便的,不灵巧的,难处理的;笨重的; [^]sat;
unwitting: [-]/ʌnˈwɪtɪŋ/; [a]不知情的;无意的; [^]sat;
upbraid: [-]/ʌpˈbreɪd/; [v]斥责,责骂; [^]sat;
upshot: [-]/'ʌpʃɑːt/; [n]结果,结局;要点; [^]sat;
urbane: [-]/ɜːrˈbeɪn/; [a]温文尔雅的,懂礼的;都<城>市气派的; [^]sat;
usurp: [-]/juːˈzɜːrp/; [vi]篡夺,篡位; [vt]篡夺,强夺; [^]sat;
vacuous: [-]/ˈvækjuəs/; [a]空的,空虚的,空洞的,无意义的; [^]sat;
vagabond: [-]/ˈvæɡəbɑːnd/; [n]流浪者; [v]漂泊,流浪; [a]流浪的,流浪者的,漂泊的; [^]sat;
vagrant: [-]/ˈveɪɡrənt/; [n]游民; [a]漂泊的; [^]sat;
valedictory: [-]/ˌvælɪˈdɪktəri/; [n]告别辞; [a]告别的; [^]sat;
valid: [-]/ˈvælɪd/; [a]有效的,正式认可的;合理的,有根据的; [^]sat;
validate: [-]/ˈvælɪdeɪt/; [v]使.生效,使合法化;证明正确; [^]sat;
valor: [-]/'vælə/; [n]勇猛,英勇; [^]sat;
vampire: [-]/ˈvæmpaɪər/; [n]吸血鬼; [^]sat;
vanguard: [-]/ˈvænɡɑːrd/; [n]先锋,前锋;先驱;领导者; [^]sat;
vantage: [-]/'vɑːntɪdʒ/; [n]优势;有利情况; [^]sat;
vapid: [-]/ˈvæpɪd/; [a]索然无味的;无生气的; [ad]乏味地;无滋味地;无趣味地;无生气地; [^]sat;
vaporize: [-]/ˈveɪpəraɪz/; [v](使)蒸发;使.蒸发; [^]sat;
variegated: [-]/ˈverɪɡeɪtɪd/; [n]使富有变化,使成为杂色; [a]斑驳的,多色的,富于变化的; [^]sat;
veer: [-]/vɪr/; [n]方向的转变; [v]转向,改变(话题等),放松(绳,缆等); [^]sat;
vehement: [-]/ˈviːəmənt/; [a]猛烈的,强烈的; [^]sat;
velocity: [-]/vəˈlɑːsəti/; [n]速度;迅速,快速; [^]sat;
venal: [-]/ˈviːnl/; [a]唯利是图的;贪赃枉法; [^]sat;
vendor: [-]/ˈvendər/; [n]小贩,卖主,供应商; [^]sat;
veneer: [-]/vəˈnɪr/; [n](镶于劣质东西上的)镶面板;掩饰; [v]虚饰;给.镶以饰片; [^]sat;
venerable: [-]/ˈvenərəbl/; [a]令人尊敬的;(因历史悠久而) 神圣庄严的; [^]sat;
venerate: [-]/ˈvenəreɪt/; [v]崇敬,敬仰; [^]sat;
venial: [-]/ˈviːniəl/; [a]可原谅的,(罪过)轻微的,可宽恕的; [^]sat;
venom: [-]/ˈvenəm/; [n]毒液;恶意;怨恨; [vt]使有毒;放毒; [^]sat;
vent: [-]/vent/; [n]发泄;通风口,排气口;(上衣背部或两侧的)开衩;(小型动物的)排泄口; [v]发泄(情绪),开孔,泄露; [^]sat;
ventriloquist: [-]/venˈtrɪləkwɪst/; [n]口技表演者; [^]sat;
venturesome: [-]/ˈventʃərsəm/; [a]好冒险的,大胆的;危险的; [^]sat;
verbalize: [-]/ˈvɜːrbəlaɪz/; [v]唠叨;以言语表述;使.变成动词; [^]sat;
verbatim: [-]/vɜːrˈbeɪtɪm/; [a]逐字的; [ad]逐字地; [^]sat;
verbiage: [-]/ˈvɜːrbiɪdʒ/; [n]罗嗦,冗长,措辞方式; [^]sat;
verbose: [-]/vɜːrˈboʊs/; [a]冗长的,啰嗦的; [^]sat;
verdant: [-]/ˈvɜːrdnt/; [a]青葱的,翠绿的; [^]sat;
verge: [-]/vɜːrdʒ/; [n]边缘;边界; [v]接近;濒临; [^]sat;
verisimilitude: [-]/ˌverɪsɪˈmɪlɪtuːd/; [n]逼真,真实性; [^]sat;
vernacular: [-]/vərˈnækjələr/; [a]本国的,地方的,用本地语写成的; [n]方言;土语;(建筑的)民间风格; [^]sat;
versatile: [-]/ˈvɜːrsətl/; [a]万能的,综合的,多才多艺的; [^]sat;
vertigo: [-]/ˈvɜːrtɪɡoʊ/; [n]晕头转向;眩晕; [^]sat;
verve: [-]/vɜːrv/; [n]热情,神韵,活力,气魄; [^]sat;
vestige: [-]/ˈvestɪdʒ/; [n]遗迹,(生)退化的器官,残余,微量(一般用于否定句); [^]sat;
vex: [-]/veks/; [v]使烦恼,使苦恼,使恼怒; [^]sat;
viable: [-]/ˈvaɪəbl/; [a]可行的;能养活的;能生育的; [^]sat;
vicarious: [-]/vaɪˈkeriəs/; [a]代替别人做的;代理的,代替的;发同感的; [^]sat;
vicissitude: [-]/vɪˈsɪsɪtuːd/; [n]变迁,沧桑,兴衰; [^]sat;
vie: [-]/vaɪ/; [v]竞争;使针锋相对;以..作较量; [^]sat;
vigilance: [-]/ˈvɪdʒɪləns/; [n]警戒;警惕;警戒; [^]sat;
vignette: [-]/vɪnˈjet/; [n]装饰图案;小插图; [v]把..印放为虚光照,晕映; [^]sat;
vigor: [-]/ˈvɪɡər/; [n]生命力,活力; [^]sat;
vilify: [-]/ˈvɪlɪfaɪ/; [v]辱骂,诽谤; [^]sat;
vindicate: [-]/ˈvɪndɪkeɪt/; [vt]证明.无辜;维护,辩护; [^]sat;
vindictive: [-]/vɪnˈdɪktɪv/; [a]报复性的,怀恨的,惩罚的; [^]sat;
virile: [-]/ˈvɪrəl/; [a]成年男子的,有男子气概的,强壮的; [^]sat;
virtual: [-]/ˈvɜːrtʃuəl/; [a](计算机)虚拟的;十分接近的;实质上的; [^]sat;
virtue: [-]/ˈvɜːrtʃuː/; [n]正直,善良;美德,德行;好处,优点; [^]sat;
virtuoso: [-]/ˌvɜːrtʃuˈoʊsoʊ/; [n]艺术品鉴赏家,古董收藏家,艺术大师; [a]行家里手的,艺术爱好者的; [^]sat;
virulent: [-]/ˈvɪrələnt/; [a]剧毒的;恶性的;有恶意的; [^]sat;
virus: [-]/ˈvaɪrəs/; [n]病毒;(计算机) 病毒;病毒性疾病; [^]sat;
viscid: [-]/ˈvɪsɪd/; [a]黏的,黏质的; [^]sat;
viscous: [-]/ˈvɪskəs/; [a]黏的;黏稠的;黏滞的;有黏性的; [^]sat;
visionary: [-]/ˈvɪʒəneri/; [n]有远见的人;幻想家; [a]有远见的;爱幻想的; [^]sat;
vital: [-]/ˈvaɪtl/; [a]生命所必需的;必不可少的;至关重要的;有活力的;生命攸关的; [n]要害;重要部分; [^]sat;
vitriolic: [-]/ˌvɪtriˈɑːlɪk/; [a]刻薄的,强烈的,硫酸(盐)的,由硫酸制成的; [^]sat;
vituperative: [-]/vaɪˈtuːpəreɪtɪv/; [a]责骂的,辱骂的; [^]sat;
vivacious: [-]/vɪˈveɪʃəs/; [a]活泼的,快活的(多指女性); [^]sat;
vociferous: [-]/voʊˈsɪfərəs/; [a](表达意见或感情等)大声的,有力的; [^]sat;
vogue: [-]/voʊɡ/; [n]时髦,时尚; [a]流行的; [^]sat;
volatile: [-]/ˈvɑːlətl/; [a]易气化的;爆炸性的;反复无常的;短暂的;不稳定的; [^]sat;
volition: [-]/voʊˈlɪʃn/; [n]决定;自主;意志力;下决心;意志力; [^]sat;
voluble: [-]/ˈvɑːljəbl/; [a]健谈的,缠绕的,易旋转的; [^]sat;
voluminous: [-]/vəˈluːmɪnəs/; [a]大量的;长篇的,多产的;庞大的; [ad]宽松地;容量大地;篇幅长地; [n]宽松;容量大,篇幅长; [^]sat;
voluptuous: [-]/vəˈlʌptʃuəs/; [a]撩人的,沉溺酒色的,骄奢淫逸的; [^]sat;
voracious: [-]/vəˈreɪʃəs/; [a]狼吞虎咽的,贪婪的; [ad]贪婪地; [n]贪婪,贪吃; [^]sat;
vortex: [-]/ˈvɔːrteks/; [n]旋涡,气旋;涡流; [^]sat;
voyeur: [-]/vwaɪˈɜːr/; [n]窥淫狂者,窥隐私者; [^]sat;
vulnerable: [-]/ˈvʌlnərəbl/; [a]易受伤的;脆弱的;易受攻击的; [^]sat;
waffle: [-]/ˈwɑːfl/; [n]华夫饼干;动听而无意义的话;无聊话; [v]胡扯,含糊其辞; [^]sat;
waft: [-]/wɑːft/; [v]使飘荡;吹送; [n]飘荡;吹拂; [^]sat;
waggish: [-]/ˈwæɡɪʃ/; [a]诙谐的,滑稽的; [^]sat;
waive: [-]/weɪv/; [v]放弃;不坚持;推迟;搁置; [vt]抑制;搁置; [^]sat;
wake: [-]/weɪk/; [v]醒来,使觉醒;激发,引起; [n]守灵,守夜;(船航过时的)尾波;年度假期; [^]sat;
wallow: [-]/ˈwɑːloʊ/; [v]打滚;沉迷,沉溺;颠簸; [n]打滚;堕落;泥坑; [^]sat;
wan: [-]/wɑːn/; [a]虚弱的,病态的; [^]sat;
wane: [-]/weɪn/; [n]衰退(期);月亏(期);减少; [v](月)缺损;(光,势力,治理等)衰落;减少; [^]sat;
wanton: [-]/ˈwɑːntən/; [n]水性杨花的人,任性的孩子,无节制的人; [v]放肆,胡作非为,挥霍; [a]胡作非为的,淫荡的,无节制的; [^]sat;
warble: [-]/ˈwɔːrbl/; [n]鸟啭鸣,颤声; [v]鸟鸣,用柔和的颤声唱; [^]sat;
warrant: [-]/ˈwɔːrənt/; [n]逮捕证;正当理由;凭证; [v]使正当; [^]sat;
warranty: [-]/ˈwɔːrənti/; [n]授权;根据;保证书;担保书,保单; [^]sat;
wary: [-]/ˈweri/; [a]谨慎的,小心的,提防的;考虑周到的; [^]sat;
wastrel: [-]/ˈweɪstrəl/; [n]败家子,挥霍无度的人; [^]sat;
watershed: [-]/ˈwɔːtərʃed/; [n](美)流域;分水岭;集水区;转折点;重要关头; [a]标志转折点的; [^]sat;
wax: [-]/wæks/; [n]蜡;蜡状物; [v]给.上蜡;给.打蜡,给.上蜡;渐渐变大;变为;(月亮)渐圆,渐盈; [a]蜡制的; [^]sat;
waylay: [-]/weɪˈleɪ/; [v]埋伏,伏击; [^]sat;
wean: [-]/wiːn/; [v]断奶,戒掉(off/from),(从早年开始)使用; [n]〈英〉婴儿;小儿; [^]sat;
welter: [-]/ˈweltər/; [n]混乱;滚浪;翻滚;起伏; [v]翻滚;沉溺;起伏; [a]负重赛马的; [^]sat;
wheedle: [-]/ˈwiːdl/; [v]以甜言蜜语诱惑,用甜言蜜语欺骗; [^]sat;
whet: [-]/wet/; [v]刺激;磨快;促进; [n]磨;开胃物;刺激物; [^]sat;
whiff: [-]/wɪf/; [n]一吹,一吸,一阵香气,一点点,香烟的一口; [v]轻轻地吹,喷气,<棒>三击出局; [^]sat;
whimsical: [-]/ˈwɪmzɪkl/; [a]古怪的,异想天开的; [^]sat;
whittle: [-]/ˈwɪtl/; [v]削(木头);削减; [n]大刀,屠刀; [^]sat;
willful: [-]/ˈwɪlfl/; [a]有意的,任性的,故意的; [^]sat;
wily: [-]/ˈwaɪli/; [a]狡猾的; [^]sat;
wince: [-]/wɪns/; [v]避开,畏缩; [n]畏缩;脸部肌肉的抽搐; [^]sat;
windfall: [-]/ˈwɪndfɔːl/; [n]风吹落果;意外的收获,意外幸运; [^]sat;
winnow: [-]/ˈwɪnoʊ/; [v]把(谷物)的杂质吹掉;簸;精选;扬谷; [^]sat;
winsome: [-]/ˈwɪnsəm/; [a]迷人的;可爱的;漂亮的; [^]sat;
wispy: [-]/ˈwɪspi/; [a]象小束状的,纤细的;脆弱的; [^]sat;
wistful: [-]/ˈwɪstfl/; [a]渴望的,向往的;深思的;留恋的; [^]sat;
withdrawn: [-]/wɪðˈdrɔːn/; [a]孤独的,孤僻的,内向的,离群的,沉默寡言的; [^]sat;
wither: [-]/ˈwɪðər/; [v]枯萎;凋谢; [vt]使枯萎,使凋谢,萎缩;使人感觉羞惭或迷惑; [^]sat;
withhold: [-]/wɪðˈhoʊld/; [v]抑制,拒绝给某事物; [^]sat;
withstand: [-]/wɪðˈstænd/; [v]忍受;抵挡; [^]sat;
woe: [-]/woʊ/; [n]悲哀;痛苦; [int]唉(表示痛苦,悲伤或悔恨);咳; [^]sat;
worldly: [-]/ˈwɜːrldli/; [a]世间的,尘世的;世俗的; [ad]世故地; [^]sat;
wrath: [-]/ræθ/; [n]愤怒; [^]sat;
wrench: [-]/rentʃ/; [n]扳手;痛苦,难受;猛扭,猛拉; [v]猛拧;挣脱;使扭伤; [^]sat;
writhe: [-]/raɪð/; [v]扭动(身体);扭曲变形;缠绕打结; [n]扭动;翻腾;苦恼; [^]sat;
wry: [-]/raɪ/; [a]歪斜的,扭歪的,歪曲的; [v]歪曲,扭曲;扭转; [^]sat;
xenophobia: [-]/ˌzenəˈfoʊbiə/; [n]仇外,对外国人的恐惧或憎恨; [^]sat;
yield: [-]/jiːld/; [v]出产;屈服;弯曲;让行; [n]收益; [^]sat;
yoke: [-]/joʊk/; [n]牛轭;枷锁;纽带; [v]结合;连结; [^]sat;
zeal: [-]/ziːl/; [n]热情,热心; [^]sat;
zealot: [-]/ˈzelət/; [n]狂热份子,犹太教狂热信徒; [^]sat;
zenith: [-]/ˈziːnɪθ/; [n]顶点,顶峰;全盛; [^]sat;
zephyr: [-]/ˈzefər/; [n]和风,西风; [^]sat;
