Baroque: [-]/bəˈroʊk/; [a]巴洛克式的,结构复杂的,形式怪样的; [n]巴洛克风格,巴洛克艺术; [^]gre3k;
Canon: [-]/ˈkænən/; [n]标准,教规,正典圣经,教士; [^]gre3k;
Catholic: [-]/ˈkæθlɪk/; [a](兴趣等)广泛的,(C大写)天主教的; [n](C大写)天主教徒; [^]gre3k;
Spartan: [-]/ˈspɑːrtn/; [a]斯巴达式的,简朴的,刻苦的; [n]斯巴达人;勇士; [^]gre3k;
abandon: [-]/əˈbændən/; [v]抛弃;放弃;放纵; [^]gre3k;
abase: [-]/əˈbeɪs/; [v]贬抑;使卑下;降低.的地位; [n]贬低;屈辱;贬低别人的人; [^]gre3k;
abash: [-]/ə'bæʃ/; [v]使局促不安;使羞愧; [a]窘迫的,尴尬的; [ad]窘迫地,尴尬地; [n]窘迫,尴尬; [^]gre3k;
abbreviate: [-]/əˈbriːvieɪt/; [v]缩写,使省略,使用缩写词; [n]使用缩写词的人;缩短,缩写(词,短语,名字,名称); [^]gre3k;
abdicate: [-]/ˈæbdɪkeɪt/; [a]放弃权力的;退位的; [n]放弃权力者;退位者; [vi]退位,辞职; [vt]辞;放弃; [^]gre3k;
aberrant: [-]/æˈberənt/; [n]离开正路的人,反常的人; [a]偏离正轨的;异常的,畸变的; [^]gre3k;
abet: [-]/əˈbet/; [vt]唆使,怂恿;支持; [^]gre3k;
abeyance: [-]/əˈbeɪəns/; [n]中止,搁置; [^]gre3k;
abhor: [-]/əbˈhɔːr/; [v]痛恨;憎恶; [^]gre3k;
abiding: [-]/əˈbaɪdɪŋ/; [a]持久的;永久的,不变的; [^]gre3k;
abject: [-]/ˈæbdʒekt/; [a]糟糕透顶的;可怜的,不幸的; [^]gre3k;
abjure: [-]/əbˈdʒʊr/; [v]发誓放弃,公开放弃,避免; [^]gre3k;
abnegate: [-]/'æbnɪɡeɪt/; [v]放弃,舍弃,禁忌; [^]gre3k;
abominate: [-]/əˈbɑːmɪneɪt/; [v]痛恨,痛恶; [n]憎恶者,厌恶者; [^]gre3k;
abrade: [-]/əˈbreɪd/; [v]磨损,擦伤; [^]gre3k;
abreast: [-]/əˈbrest/; [ad]并肩地,并列; [a]并排的;并肩的; [^]gre3k;
abridge: [-]/əˈbrɪdʒ/; [v]删节;削减; [^]gre3k;
abrogate: [-]/ˈæbrəɡeɪt/; [v]废止,废除; [n]取消,废除; [^]gre3k;
abscond: [-]/əbˈskɑːnd/; [v]逃匿,潜逃;避债; [^]gre3k;
absent: [-]/ˈæbsənt/; [a]缺席的,不在的;心不在焉的,出神的; [v]缺席;使缺席; prep. 缺乏; [^]gre3k;
absolute: [-]/ˈæbsəluːt/; [a]完全的;绝对的;纯粹的; [^]gre3k;
absolve: [-]/əbˈzɑːlv/; [v]赦免,宽恕;免除,解除; [^]gre3k;
abstain: [-]/əbˈsteɪn/; [v]戒掉(烟\酒等);避开;弃权; [^]gre3k;
abstemious: [-]/əbˈstiːmiəs/; [a](吃喝等)有节制的,节俭的; [^]gre3k;
abstract: [-]/ˈæbstrækt/; [a]抽象的; [n]摘要,抽象; [v]提取; [^]gre3k;
abstruse: [-]/əbˈstruːs/; [a]难懂的,深奥的; [^]gre3k;
absurd: [-]/əbˈsɜːrd/; [a]荒唐的;可笑的;不合理的; [n]荒唐; [^]gre3k;
abundant: [-]/əˈbʌndənt/; [a]丰富的;大量的; [^]gre3k;
abuse: [-]/əˈbjuːs/; [v]虐待;辱骂;(对麻醉毒品,兴奋剂等的)非法服用;滥用; [n]滥用;虐待;辱骂; [^]gre3k;
abut: [-]/əˈbʌt/; [v]紧靠; [^]gre3k;
abysmal: [-]/əˈbɪzməl/; [a]极低的或极可怜的,(程度)很深的,极端的; [^]gre3k;
accede: [-]/əkˈsiːd/; [v]同意,就任,加入; [^]gre3k;
accelerate: [-]/əkˈseləreɪt/; [v]加速,增长;使增速,促进; [^]gre3k;
accessible: [-]/əkˈsesəbl/; [a]可使用的;可到达的;可进入的;易懂的; [^]gre3k;
accessory: [-]/əkˈsesəri/; [n](妇女的)装饰品;附件;附属物;同谋; [a]附属的;辅助的;同谋的; [^]gre3k;
accidental: [-]/ˌæksɪˈdentl/; [a]偶然的,意外的;非本质的; [^]gre3k;
acclaim: [-]/əˈkleɪm/; [n]欢呼,赞扬,称赞; [v]欢呼,喝彩,鼓掌欢迎; [vt]鼓掌欢迎,向.欢呼,为.喝彩;推选; [^]gre3k;
acclimate: [-]/ˈækləmeɪt/; [v]服水土,适应新环境; [^]gre3k;
accolade: [-]/ˈækəleɪd/; [n]同意,赞赏; [v]赞扬; [^]gre3k;
accommodate: [-]/əˈkɑːmədeɪt/; [v]向.提供住处(或膳宿);给.提供方便;容纳;使适应,顺应; [^]gre3k;
accomplish: [-]/əˈkɑːmplɪʃ/; [v]完成,做到;实现; [^]gre3k;
accord: [-]/əˈkɔːrd/; [n]协议; [v]授予; [^]gre3k;
accost: [-]/əˈkɔːst/; [v]搭讪;引诱;面对;勾引; [^]gre3k;
accrete: [-]/ə'kriːt/; [v]逐渐增长,依附,合生,连接; [a]合生的,增积的; [^]gre3k;
accumulate: [-]/əˈkjuːmjəleɪt/; [vi]聚积,堆积; [vt]积攒,积累; [^]gre3k;
acerbic: [-]/əˈsɜːrbɪk/; [a]尖刻的;酸涩的心情,心境或者语调,酸涩的; [^]gre3k;
acknowledge: [-]/əkˈnɑːlɪdʒ/; [v]告知收到;对(人)打招呼,招呼(某人)以示相识,致意;就..表示谢忱,鸣谢,感谢,感激,答谢,对..表示感谢;承认(属实),承认(权威,地位); [^]gre3k;
acme: [-]/ˈækmi/; [n]顶点,极点; [^]gre3k;
acquiesce: [-]/ˌækwiˈes/; [v]默许;勉强同意; [a]默认的; [^]gre3k;
acquire: [-]/əˈkwaɪər/; [v](尤指靠自己的努力或行动或经过一个过程)获得;学到;取得; [^]gre3k;
acquisitive: [-]/əˈkwɪzətɪv/; [a]贪得的,物欲重的;可学到的; [^]gre3k;
acrid: [-]/ˈækrɪd/; [a]辛辣的,(言语或语调)刻薄的; [^]gre3k;
acrimonious: [-]/ˌækrɪˈmoʊniəs/; [a]严厉的;辛辣的;刻薄的; [^]gre3k;
acumen: [-]/ˈækjəmən/; [n]聪明,敏锐; [^]gre3k;
acute: [-]/əˈkjut/; [a](疼痛,妒忌等)剧烈的,严重的;敏锐的;急性的;尖声的; [^]gre3k;
adamant: [-]/ˈædəmənt/; [a]强硬的,固执的; [n]坚硬的东西;坚石; [^]gre3k;
adapt: [-]/əˈdæpt/; [vi]适应不同情况; [vt]使适合;改编; [^]gre3k;
addict: [-]/ˈædɪkt/; [n]上瘾的人;入迷的人; [v]使沉迷,使上瘾; [^]gre3k;
adhere: [-]/ədˈhɪr/; [v]遵守;坚持;粘附;附着,粘在..上; [^]gre3k;
adjourn: [-]/əˈdʒɜːrn/; [v]延期,休会,推迟对.采取行动; [vi]休会; [^]gre3k;
adjudicate: [-]/əˈdʒuːdɪkeɪt/; [v]充当裁判,判决; [n]判决,宣判;裁判员; [^]gre3k;
adjunct: [-]/ˈædʒʌŋkt/; [n]附属物,配件,添加剂;助手,部下; [a]附加的,辅助的,下级的; [^]gre3k;
admonish: [-]/ədˈmɑːnɪʃ/; [v]训诫,警告; [^]gre3k;
adore: [-]/əˈdɔːr/; [v]很喜欢,极喜爱;崇拜;爱慕; [^]gre3k;
adulate: [-]/'ædʒəˌleɪt/; [v]谄媚,奉承; [^]gre3k;
adulterate: [-]/əˈdʌltəreɪt/; [v]掺假; [a]通奸的;搀杂的; [n]掺假; [^]gre3k;
adventitious: [-]/ˌædvenˈtɪʃəs/; [a]外来的,偶然的; [^]gre3k;
adversary: [-]/ˈædvərseri/; [n]对手,敌手; [^]gre3k;
adversity: [-]/ədˈvɜːrsəti/; [n]逆境,不幸,灾难; [^]gre3k;
advert: [-]/ˈædvɜːrt/; [n]广告; [v]注意,留意; [^]gre3k;
advocate: [-]/ˈædvəkeɪt/; [v]提倡;主张;为.辩护; [n]辩护者;提倡者;律师; [^]gre3k;
affable: [-]/ˈæfəbl/; [a]易于交谈的,和蔼的; [^]gre3k;
affectation: [-]/ˌæfekˈteɪʃn/; [n]假装,做作;假装;装模作样; [^]gre3k;
affinity: [-]/əˈfɪnəti/; [n]姻亲关系;密切关系;近似,类似关系;亲近; [^]gre3k;
affirm: [-]/əˈfɜːrm/; [v]肯定;断定;坚持声称; [^]gre3k;
affix: [-]/əˈfɪks/; [v]粘上;署名;将罪责加之于; [n]词缀;附加物; [^]gre3k;
affliction: [-]/əˈflɪkʃn/; [n]苦恼,折磨;痛苦; [^]gre3k;
affluent: [-]/ˈæfluənt/; [a]富裕的,丰富的; [^]gre3k;
agape: [-]/əˈɡeɪp/; [a]张口结舌,目瞪口呆;张大着; [^]gre3k;
aggrandize: [-]/ə'grænˌdaɪz/; [v]增大;夸大;吹捧; [^]gre3k;
aggravate: [-]/ˈæɡrəveɪt/; [v]使恶化,加重;使气恼,激怒; [^]gre3k;
aggregate: [-]/ˈæɡrɪɡət/; [n]合计;总数;混凝料;总计; [v]集合;聚集;合计; [a]总的,总数的;集合的; [^]gre3k;
aggressive: [-]/əˈɡresɪv/; [a]好斗的,挑衅性的;有闯劲的,积极进取的; [^]gre3k;
aggrieve: [-]/ə'griːv/; [v]使悲痛;冒犯;侵害.的合法权利; [^]gre3k;
agility: [-]/əˈdʒɪləti/; [n]敏捷;灵活; [^]gre3k;
agitate: [-]/ˈædʒɪteɪt/; [v](尤指为法律,社会状况的改变而)激烈争论,鼓动,煽动;搅动(液体);激怒; [^]gre3k;
agog: [-]/əˈɡɑːɡ/; [a]兴奋的,有强烈兴趣的; [ad]渴望;极度兴奋; [^]gre3k;
agonize: [-]/ˈæɡənaɪz/; [v]感到极度痛苦,挣扎,折磨; [^]gre3k;
agreeable: [-]/əˈɡriːəbl/; [a](欣然)同意的;愉快的;可以接受的; [^]gre3k;
airtight: [-]/ˈertaɪt/; [a]不透气的,密封的; [^]gre3k;
alacrity: [-]/əˈlækrəti/; [n]反应迅速,乐意; [^]gre3k;
alienate: [-]/ˈeɪliəneɪt/; [v]疏远;挑拨; [^]gre3k;
align: [-]/əˈlaɪn/; [vi]排队,排成一行; [vt]使成一直线; [^]gre3k;
allay: [-]/əˈleɪ/; [v]减轻;使缓和;使平静; [^]gre3k;
allegiance: [-]/əˈliːdʒəns/; [n]忠诚,拥护; [^]gre3k;
alleviate: [-]/əˈliːvieɪt/; [v]减轻;缓解;缓和; [^]gre3k;
alloy: [-]/ˈælɔɪ/; [n]合金; [v]使成合金; [^]gre3k;
allude: [-]/əˈluːd/; [v]间接提到,暗指,暗示; [^]gre3k;
allure: [-]/əˈlʊr/; [v]吸引;诱使; [n]诱惑力; [^]gre3k;
ally: [-]/ˈælaɪ/; [n]盟友;同盟国;(二战时的) 同盟国; [v]结盟; [^]gre3k;
aloft: [-]/əˈlɔːft/; [ad]在空中,在高处,在上面; prep. 在 ... 上; [^]gre3k;
aloof: [-]/əˈluːf/; [a]远离的;冷漠的,冷淡的; [ad]远离,避开; [^]gre3k;
altruism: [-]/ˈæltruɪzəm/; [n]利他主义,不自私; [^]gre3k;
amalgamate: [-]/əˈmælɡəmeɪt/; [v]合并,混合; [^]gre3k;
ambiguous: [-]/æmˈbɪɡjuəs/; [a]含糊不清的,引起歧义的,模棱两可的; [^]gre3k;
ambivalent: [-]/æmˈbɪvələnt/; [a]矛盾的;摇摆不定的;好恶相克的; [n]两性人; [^]gre3k;
amble: [-]/ˈæmbl/; [v]漫步,缓行; [n]缓行,漫步; [^]gre3k;
ambrosial: [-]/æm'broʊʒɪəl/; [a](食物或者气味)特别美味的; [^]gre3k;
ameliorate: [-]/əˈmiːliəreɪt/; [v]改善,减轻(痛苦等),改良; [^]gre3k;
amenable: [-]/əˈmiːnəbl/; [a]愿意的,顺从的,服从的;经得起检验的; [^]gre3k;
amenity: [-]/əˈmenəti/; [n]适意;舒适;便利设施;舒适,愉快;礼仪; [^]gre3k;
amiable: [-]/ˈeɪmiəbl/; [a]和蔼的,亲切的;温和的; [^]gre3k;
amicable: [-]/ˈæmɪkəbl/; [a]友善的,温和的,平心静气的; [^]gre3k;
amity: [-]/ˈæməti/; [n]友好,亲善关系,友好关系; [^]gre3k;
amorphous: [-]/əˈmɔːrfəs/; [a]无定形的;无组织的;<物>非晶形的; [^]gre3k;
anachronistic: [-]/əˌnækrəˈnɪstɪk/; [a]时代错误的; [^]gre3k;
analgesic: [-]/ˌænəlˈdʒiːzɪk/; [n]镇痛药; [a]止痛的; [^]gre3k;
analogous: [-]/əˈnæləɡəs/; [a]类似的,可比拟的;<昆>同功的; [^]gre3k;
anarchist: [-]/ˈænərkɪst/; [n]无政府主义者; [^]gre3k;
anathema: [-]/əˈnæθəmə/; [n](基督教的)咒诅,被诅咒者,令人厌恶的人; [^]gre3k;
ancillary: [-]/ˈænsəleri/; [a]辅助的,副的; [n]助手;辅助设备; [^]gre3k;
anecdote: [-]/ˈænɪkdoʊt/; [n]轶事,趣闻; [^]gre3k;
anemic: [-]/ə'niːmɪk/; [a]贫血的,缺乏力量,活力,精神的; [^]gre3k;
anesthetic: [-]/ˌænəs'θetɪk/; [n]麻醉剂,麻药; [a]麻醉的,感觉缺失的; [^]gre3k;
animate: [-]/ˈænɪmeɪt/; [v]使有生气,使活泼;鼓舞,推动; [a]有生命的; [^]gre3k;
animus: [-]/ˈænɪməs/; [n]憎恨,敌意; [^]gre3k;
annex: [-]/əˈneks/; [n]附加物;附属的建筑物; [vt]附加;并吞,强行占取;获得; [^]gre3k;
annotate: [-]/ˈænəteɪt/; [v]注释,评注; [n]注释者; [^]gre3k;
annoy: [-]/əˈnɔɪ/; [v]使烦恼,使生气; [n]烦恼(等于annoyance); [^]gre3k;
annul: [-]/əˈnʌl/; [v]取消,废除,宣告无效; [^]gre3k;
anomalous: [-]/əˈnɑːmələs/; [a]反常的,不规则的,不恰当的; [^]gre3k;
anonymous: [-]/əˈnɑːnɪməs/; [a]匿名的;无名的;不具名的;无特色的;无个性特征; [^]gre3k;
antagonize: [-]/ænˈtæɡənaɪz/; [v]使.敌对,使.对抗,引起反抗; [^]gre3k;
antedate: [-]/ˌæntiˈdeɪt/; [n]比实际提前的日期; [vt]在.上写上早于实际的日期;发生于.以前;使提前发生;使回到过去; [^]gre3k;
antediluvian: [-]/ˌæntidɪˈluːviən/; [a]史前的,陈旧的; [n]大洪水以前的人;年迈的人;不合时宜的人; [^]gre3k;
anterior: [-]/ænˈtɪriər/; [a]前面的,先前的; [^]gre3k;
antic: [-]/'æntɪk/; [a]古怪的;滑稽可笑的; [n]滑稽动作;丑角; [v]扮小旦;做滑稽动作; [^]gre3k;
antipathy: [-]/ænˈtɪpəθi/; [n]反感,厌恶,憎恶; [^]gre3k;
antiquated: [-]/ˈæntɪkweɪtɪd/; [a]陈旧的,过时的; [v]使古旧,废弃; [^]gre3k;
antithetical: [-]/ˌæntɪˈθetɪkl/; [a]完全对立的,相反的; [^]gre3k;
apathy: [-]/ˈæpəθi/; [n]冷漠,无兴趣;漠不关心,无感情; [^]gre3k;
aphorism: [-]/ˈæfərɪzəm/; [n]格言,警句; [^]gre3k;
apocalyptic: [-]/əˌpɑːkəˈlɪptɪk/; [a]预示灾祸的,启示的; [^]gre3k;
apocryphal: [-]/əˈpɑːkrɪfl/; [a]伪的;可疑; [^]gre3k;
apoplectic: [-]/ˌæpəˈplektɪk/; [a]中风的,易怒的; [n]中风患者; [^]gre3k;
apostasy: [-]/əˈpɑːstəsi/; [n]放弃宗教信仰,变节,背叛; [^]gre3k;
apparition: [-]/ˌæpəˈrɪʃn/; [n]幽灵,神奇的现象; [^]gre3k;
appeal: [-]/əˈpiːl/; [vi]呼吁,请求;申诉;有吸引力; [n]呼吁;恳求;(为慈善或好的事业所做的) 筹款努力;(人或物的)吸引力; [^]gre3k;
appealing: [-]/əˈpiːlɪŋ/; [a]吸引人的,打动人心的; [^]gre3k;
applause: [-]/əˈplɔːz/; [n]鼓掌,掌声; [^]gre3k;
appreciable: [-]/əˈpriːʃəbl/; [a]很可观的;可感知的;可察觉的;可评估的; [^]gre3k;
apprehension: [-]/ˌæprɪˈhenʃn/; [n]忧虑,担心,疑惧;逮捕;理解; [^]gre3k;
apprehensive: [-]/ˌæprɪˈhensɪv/; [a]忧虑的,不安的,敏悟的,知晓的; [^]gre3k;
apprise: [-]/əˈpraɪz/; [v]通知,报告; [^]gre3k;
approbation: [-]/ˌæprəˈbeɪʃn/; [n]称赞,认可;批准; [^]gre3k;
appropriate: [-]/əˈproʊpriət/; [a]合适的;适当的; [v]挪用;拨款;私占; [^]gre3k;
apt: [-]/æpt/; [a]恰当的;有(做某事的)倾向; [^]gre3k;
arable: [-]/ˈærəbl/; [a]可耕的,适合种植的; [n]耕地; [^]gre3k;
arbitrary: [-]/ˈɑːrbətreri/; [a]随意的,任性的,随心所欲的;霸道的,专制的,专横的;主观的,武断的; [^]gre3k;
arcane: [-]/ɑːrˈkeɪn/; [a]神秘的;秘传的;晦涩难解的; [^]gre3k;
archaic: [-]/ɑːrˈkeɪɪk/; [a]古代的;陈旧的,过时的,老式的;已不通用的; [^]gre3k;
archetype: [-]/ˈɑːrkitaɪp/; [n]原型,典型; [^]gre3k;
ardor: [-]/'ɑːdə/; [n]热情,狂热; [^]gre3k;
arduous: [-]/ˈɑːrdʒuəs/; [a]艰巨的;努力的;陡峭的; [^]gre3k;
argument: [-]/ˈɑːrɡjumənt/; [n]争吵,争论,辩论;论据,论点; [^]gre3k;
arid: [-]/ˈærɪd/; [a](土地或气候)干燥的,干旱的,贫瘠的,荒芜的;无创见的,无新意的; [^]gre3k;
array: [-]/əˈreɪ/; [n]一系列;陈列;编队; [v]排列;部署; [^]gre3k;
arrest: [-]/əˈrest/; [v]逮捕,拘留;吸引; [n]逮捕,拘留; [^]gre3k;
arresting: [-]/əˈrestɪŋ/; [a]引人注目的,醒目的,有趣的; [^]gre3k;
arrhythmic: [-]/əˈrɪθmɪk/; [a]无节奏的;心律不齐的; [^]gre3k;
arrogance: [-]/ˈærəɡəns/; [n]自大;傲慢态度; [^]gre3k;
articulate: [-]/ɑːrˈtɪkjuleɪt/; [a]善于表达的;发音清晰的; [v]清晰地发音;清楚地讲话;连接,接合;与.合成整体 ,使相互连贯; [^]gre3k;
ascendant: [-]/əˈsendənt/; [n]优势,支配地位; [a]上升的,优越的; [^]gre3k;
ascetic: [-]/əˈsetɪk/; [a]禁欲的;苦行的; [n]禁欲者;苦行者; [^]gre3k;
aseptic: [-]/ˌeɪˈseptɪk/; [a]无菌的,洁净的; [^]gre3k;
askew: [-]/əˈskjuː/; [a]歪斜的; [ad]歪斜地,斜地; [^]gre3k;
aspect: [-]/ˈæspekt/; [n]外表,面貌;(问题等的)方面; [^]gre3k;
asperity: [-]/æˈsperəti/; [n](表面的)粗糙;(气候等的)严酷;艰苦的条件;(性格)粗暴; [^]gre3k;
aspersion: [-]/ə'spɜːʒən/; [n]诽谤,中伤; [^]gre3k;
aspirant: [-]/əˈspaɪərənt/; [n]有抱负的人,野心家; [a]上进的,有野心的; [^]gre3k;
assail: [-]/əˈseɪl/; [v]攻击;质问;着手解决; [^]gre3k;
assent: [-]/əˈsent/; [v]同意,赞成; [n]同意;赞成; [^]gre3k;
assert: [-]/əˈsɜːrt/; [v]断言;肯定地说;坚持;维护; [^]gre3k;
assertive: [-]/əˈsɜːrtɪv/; [a]肯定的;决断的;坚定而自信的;独断的; [^]gre3k;
assess: [-]/əˈses/; [v]评估;估值; [^]gre3k;
assiduous: [-]/əˈsɪdʒuəs/; [a]勤勉的,刻苦的; [^]gre3k;
assuage: [-]/əˈsweɪdʒ/; [v]缓和,减轻; [n]缓和,减轻;减轻.的人; [^]gre3k;
astounding: [-]/əˈstaʊndɪŋ/; [a]使人惊骇的; [^]gre3k;
astute: [-]/əˈstuːt/; [a]机敏的,精明的,狡猾的; [^]gre3k;
asunder: [-]/əˈsʌndər/; [ad]分离;化为碎片; [^]gre3k;
asylum: [-]/əˈsaɪləm/; [n]精神病院,疯人院;避难所; [^]gre3k;
asymmetrical: [-]/ˌeɪsɪˈmetrɪk(ə)l/; [a]<数>非对称的; [^]gre3k;
asymmetry: [-]/ˌeɪˈsɪmətri/; [n]不对称,不均匀; [a]不对称的,不对等的; [^]gre3k;
atone: [-]/əˈtoʊn/; [v]赎罪,补偿; [^]gre3k;
atrocious: [-]/əˈtroʊʃəs/; [a]糟透的,残暴的,骇人听闻的; [^]gre3k;
atrophy: [-]/ˈætrəfi/; [v]萎缩;衰退;虚脱; [n]萎缩;衰退;萎缩症; [^]gre3k;
attenuate: [-]/əˈtenjueɪt/; [v]变薄,变弱,变纤细; [a]稀薄的;细小的;减弱的;减少的; [^]gre3k;
attest: [-]/əˈtest/; [vt]证明;证实;为.作证; [vi]证明;作证; [^]gre3k;
attune: [-]/ə'tjuːn/; [v]使协调,为.调音; [^]gre3k;
audacious: [-]/ɔːˈdeɪʃəs/; [a]大胆的,鲁莽的,大胆创新的; [^]gre3k;
augur: [-]/ˈɔːɡər/; [n]预言者; [v]预言,占卜; [^]gre3k;
auspicious: [-]/ɔːˈspɪʃəs/; [a]吉兆的,幸运的; [^]gre3k;
austere: [-]/ɔːˈstɪr/; [a]严峻的;简朴的;苦行的;无装饰的; [^]gre3k;
authentic: [-]/ɔːˈθentɪk/; [a]真实的;真正的;可靠的; [^]gre3k;
authority: [-]/əˈθɔːrəti/; [n]权威;威信;当局,官方;权力,职权; [^]gre3k;
autocracy: [-]/ɔːˈtɑːkrəsi/; [n]独裁政治;专制政治;独裁政府;独裁统治的国家; [^]gre3k;
automatic: [-]/ˌɔːtəˈmætɪk/; [a]无意识的;自动的;自发的; [n]自动手枪;自动工具; [^]gre3k;
autonomy: [-]/ɔːˈtɑːnəmi/; [n]人身自由;自治;自治权; [^]gre3k;
avarice: [-]/ˈævərɪs/; [n]贪财,贪婪; [^]gre3k;
aver: [-]/əˈvɜːr/; [v]极力声明,断言; [^]gre3k;
aversion: [-]/əˈvɜːrʒn/; [n]厌恶;讨厌的人,(或东西); [^]gre3k;
avid: [-]/ˈævɪd/; [a]渴望的,贪婪的;热心的; [^]gre3k;
avowal: [-]/əˈvaʊəl/; [n]公开承认,声明; [^]gre3k;
awe: [-]/ɔː/; [n]敬畏;畏怯;(壮观等引起的)惊叹,惊奇; [vt]使敬畏,令人敬畏,使充满畏惧; [^]gre3k;
awkward: [-]/ˈɔːkwərd/; [a]尴尬的;笨拙的;棘手的;不雅观的;不方便的;困难的,危险的; [^]gre3k;
awning: [-]/ˈɔːnɪŋ/; [n]雨篷,遮阳篷; [^]gre3k;
awry: [-]/əˈraɪ/; [a]扭曲的,走样的; [ad]歪曲地;歪斜地;错误地; [^]gre3k;
axiomatic: [-]/ˌæksiəˈmætɪk/; [a]公理的,自明的; [^]gre3k;
babble: [-]/ˈbæbl/; [v]呀呀学语,喋喋不休,作潺潺声;泄露(秘密); [n]儿语,胡言乱语,潺潺声; [^]gre3k;
backfire: [-]/ˌbækˈfaɪər/; [v]放出逆火,产生出乎意料及事与愿违的结果; [n]逆火;后爆的巨大响声; [^]gre3k;
backslide: [-]/'bækslaɪd/; [v](情况等)倒退,故态复萌; [n]倒退; [^]gre3k;
badger: [-]/ˈbædʒər/; [n]獾;獾皮毛; [v]纠缠;烦扰(反复提提出问题或要求); [^]gre3k;
badinage: [-]/ˌbædənˈɑːʒ/; [n]开玩笑,嘲弄,揶揄; [^]gre3k;
baffle: [-]/ˈbæfl/; [v]使困惑;难住;阻碍; [n]挡板; [^]gre3k;
baffling: [-]/ˈbæflɪŋ/; [a]令人困惑的; [v]使困难,使为难; [^]gre3k;
bait: [-]/beɪt/; [n]饵,诱惑物; [v]装饵;辱骂,欺侮; [^]gre3k;
bale: [-]/beɪl/; [n]大包裹,灾祸,不幸; [vt]将某物打成包或包装成捆; [^]gre3k;
baleful: [-]/ˈbeɪlfl/; [a]邪恶的,恶意的; [ad]凶恶地,有害地; [^]gre3k;
balk: [-]/bɔːk/; [v]畏缩;阻止;停止; [n]障碍;错误; [^]gre3k;
balky: [-]/ˈbɔːlki/; [a]停蹄不前的;倔强的;不愿干的; [^]gre3k;
ballad: [-]/ˈbæləd/; [n]歌谣;小曲; [^]gre3k;
balm: [-]/bɑːm/; [n]香油,止痛膏,安慰物,香气; [^]gre3k;
banal: [-]/bəˈnɑːl/; [a]陈腐的;平庸的;老一套的; [^]gre3k;
bane: [-]/beɪn/; [n]祸根; [^]gre3k;
banish: [-]/ˈbænɪʃ/; [v]放逐;摒弃; [^]gre3k;
banter: [-]/ˈbæntər/; [n]善意地取笑,逗弄; [v]善意的与人开玩笑; [^]gre3k;
barb: [-]/bɑːrb/; [n]箭头鱼钩等的倒钩;伤人的话; [v]装倒钩于; [a]具倒刺的;(话)带刺的; [^]gre3k;
barbarous: [-]/ˈbɑːrbərəs/; [a]野蛮的,残暴的; [^]gre3k;
bargain: [-]/ˈbɑːrɡən/; [n]交易,特价商品;便宜货;契约; [vi]讨价还价,讲价;成交; [vt]经讨价还价成交;用.交换; [a](价格),低廉的; [^]gre3k;
barrage: [-]/bəˈrɑːʒ/; [n]大量;阻塞;齐射式攻击;<水利>拦河坝; [v]以密集火力阻击; [^]gre3k;
barren: [-]/ˈbærən/; [a]贫瘠的,不孕的; [n]荒原,不毛之地; [^]gre3k;
barricade: [-]/ˌbærɪˈkeɪd/; [n]路障;障碍物;栅栏; [v]设路障;挡住; [^]gre3k;
barter: [-]/ˈbɑːrtər/; [v]物物交换;以货易货; [n]物物交换;实物交易; [^]gre3k;
bash: [-]/bæʃ/; [v]猛击,痛击;怒殴; [n]猛烈的一击,痛击; [^]gre3k;
bask: [-]/bæsk/; [vi]晒太阳(享受温暖),感到温暖,愉快或舒适; [n]晒太阳,取暖;沉浸于; [^]gre3k;
batch: [-]/bætʃ/; [n]一批(人或物);一批生产量; [^]gre3k;
bathetic: [-]/bə'θetɪk/; [a]平凡的,陈腐的,假装感伤的; [^]gre3k;
bawdy: [-]/ˈbɔːdi/; [a]说黄色笑话的;淫猥的,下流的; [^]gre3k;
bedeck: [-]/bɪˈdek/; [v]装饰,点缀; [^]gre3k;
beholden: [-]/bɪˈhoʊldən/; [a]蒙恩的,受惠的,感激的,负有义务的,依靠的; [^]gre3k;
behoove: [-]/bɪ'huːv/; [v]理应,对.有此必要; [n]适宜; [^]gre3k;
beige: [-]/beɪʒ/; [n]米黄色; [a]浅褐色的,米黄色的; [^]gre3k;
belabor: [-]/bɪˈleɪbər/; [v]抨击;反复讨论,啰啰嗦嗦地说明; [^]gre3k;
beleaguer: [-]/bɪ'liːgə/; [v]围攻; [^]gre3k;
belie: [-]/bɪˈlaɪ/; [vt]与.不符;矛盾,误解; [^]gre3k;
belligerence: [-]/bəˈlɪdʒərəns/; [n]好战,交战; [^]gre3k;
belligerent: [-]/bəˈlɪdʒərənt/; [a](国家等)交战的,挑斗的; [n]交战国,交战者;参加斗殴的人或集团; [^]gre3k;
beneficent: [-]/bɪˈnefɪsnt/; [a]慈善的;善行的; [^]gre3k;
benign: [-]/bɪˈnaɪn/; [a]仁慈的;慈祥的;(病)良性的; [^]gre3k;
berate: [-]/bɪˈreɪt/; [v]猛烈责骂; [^]gre3k;
beseech: [-]/bɪˈsiːtʃ/; [v]恳求,哀求; [a]恳求的;哀求的;乞求的; [^]gre3k;
beset: [-]/bɪˈset/; [v]困扰;镶嵌;围绕; [^]gre3k;
besmirch: [-]/bɪˈsmɜːrtʃ/; [v]诽谤,玷污; [^]gre3k;
bewitching: [-]/bɪˈwɪtʃɪŋ/; [a]迷人的,令人着迷的; [^]gre3k;
bifurcate: [-]/ˈbaɪfərkeɪt/; [v]分为二支,分叉; [a]分叉的; [^]gre3k;
bigot: [-]/ˈbɪɡət/; [n](宗教,种族,政治等的)偏执者,盲信者; [^]gre3k;
blackmail: [-]/ˈblækmeɪl/; [n]敲诈,勒索;保护费; [vt]向.敲诈; [^]gre3k;
bland: [-]/blænd/; [vi]变得平淡无奇,变得枯燥无味; [a]温和的;(食物等)清淡的;漠不关心的; [vt]使变得淡而无味,使变得枯燥无味;除掉.的特性; [^]gre3k;
blandishment: [-]/ˈblændɪʃmənt/; [n]甜言蜜语,奉承;谄媚;哄诱; [^]gre3k;
blase: [-]/blɑːˈzeɪ/; [a]玩厌了的,厌烦于享乐的; [^]gre3k;
blast: [-]/blæst/; [n]一阵(疾风等);爆炸;冲击波; [v](用炸药)炸,摧毁; [^]gre3k;
blatant: [-]/ˈbleɪtnt/; [a]喧哗的;露骨的;公然的;明目张胆的; [^]gre3k;
blazon: [-]/ˈbleɪzn/; [v]宣布,装饰; [n]纹章,描绘; [^]gre3k;
blemish: [-]/ˈblemɪʃ/; [v]损害,玷污; [n]瑕疵,缺点; [^]gre3k;
blight: [-]/blaɪt/; [n]植物枯萎病; [v]使.枯萎; [^]gre3k;
bliss: [-]/blɪs/; [n]福佑,天赐的福; [vt]使欣喜若狂,使狂喜; [vi]欣喜若狂,狂喜; [^]gre3k;
blithe: [-]/blaɪð/; [a]愉快的;快乐无忧的; [^]gre3k;
blueprint: [-]/ˈbluːprɪnt/; [n]蓝图,设计图,计划; [vt]制成蓝图,计划; [^]gre3k;
bluff: [-]/blʌf/; [a]直率的; [v]虚张声势,吓唬; [n]虚张声势;吓唬;断崖,绝壁; [^]gre3k;
blunder: [-]/ˈblʌndər/; [n]愚蠢之举;大错; [vi]犯大错; [v]失策;绊倒; [^]gre3k;
blunt: [-]/blʌnt/; [a]钝的;直率的; [v]使情感,感觉,需求减弱;变钝; [^]gre3k;
blur: [-]/blɜːr/; [n]污点,模糊; [v]使.模糊;弄脏;变模糊; [^]gre3k;
blurt: [-]/blɜːrt/; [v]突然说出,冲动地说; [^]gre3k;
bluster: [-]/ˈblʌstər/; [v]咆哮;狂吹;夸口;威吓;气势汹汹地说; [n]怒号;吓唬; [^]gre3k;
boggle: [-]/ˈbɑːɡl/; [v]畏缩不前;惊恐;使..困惑; [^]gre3k;
bogus: [-]/ˈboʊɡəs/; [a]假的,假装的; [n]伪币;冒牌货; [^]gre3k;
boisterous: [-]/ˈbɔɪstərəs/; [a]喧闹的,欢闹的; [^]gre3k;
bolster: [-]/ˈboʊlstər/; [n]枕垫; [v]支持,鼓励,增强; [^]gre3k;
bombast: [-]/ˈbɑːmbæst/; [n]高调,夸大之辞; [^]gre3k;
bonhomie: [-]/ˌbɑːnəˈmiː/; [n]欢乐友好的氛围; [^]gre3k;
boo: [-]/buː/; [n]嘘声; [v]嘘(以表示不满或嘲笑); [^]gre3k;
boon: [-]/buːn/; [n]恩惠,福利,利益; [a]愉快的; [^]gre3k;
boor: [-]/bʊr/; [n]举止粗野的人,乡下人; [^]gre3k;
bootless: [-]/'buːtlɪs/; [a]无用的,无益的,无利可图的,没穿鞋的; [^]gre3k;
bound: [-]/baʊnd/; [a]受约束的;有义务的;一定的; [v]束缚;跳跃着前行; [n]跳跃;范围;界限; [^]gre3k;
boycott: [-]/ˈbɔɪkɑːt/; [vt]抵制; [n]抵制; [^]gre3k;
bracing: [-]/ˈbreɪsɪŋ/; [a]振奋精神的; [^]gre3k;
brake: [-]/breɪk/; [v]刹车; [n]刹车,制动器,闸; [^]gre3k;
brandish: [-]/ˈbrændɪʃ/; [v]挥舞;炫耀的挥舞(武器); [n]挥舞; [^]gre3k;
brash: [-]/bræʃ/; [a]无礼的,傲慢的;仓促的,性急的; [n]骤雨;碎片;<医>胃灼热; [^]gre3k;
brassy: [-]/ˈbræsi/; [a]似黄铜的,刺耳的,厚脸皮的; [n]铜头高尔夫球棍; [^]gre3k;
bravado: [-]/brəˈvɑːdoʊ/; [n]故作勇敢,逞能; [^]gre3k;
brazen: [-]/ˈbreɪzn/; [a]厚脸皮的,厚颜无耻的;黄铜(制)的; [v]厚着脸皮干,使变得无耻; [^]gre3k;
breach: [-]/briːtʃ/; [n]破裂;裂痕;冲击;违反; [v]使有裂口;破坏; [^]gre3k;
brevity: [-]/ˈbrevəti/; [n]简短,短小,精炼; [^]gre3k;
bribe: [-]/braɪb/; [v]向.行贿;买通; [n]贿赂;行贿物; [^]gre3k;
bridle: [-]/ˈbraɪdl/; [n]马笼头,缰绳; [v]上笼头;昂首(表傲慢,愤怒等);抑制,控制; [^]gre3k;
brim: [-]/brɪm/; [n]边;边缘; [v]充满,注满; [vt]注满; [^]gre3k;
brisk: [-]/brɪsk/; [a]轻快的;活跃的;寒冷而清新的; [^]gre3k;
brittle: [-]/ˈbrɪtl/; [a]易碎的;脆弱的;靠不住的; [n]薄片脆糖; [^]gre3k;
broach: [-]/broʊtʃ/; [v]提出;钻孔;开始讨论;给.开口; [^]gre3k;
bromide: [-]/ˈbroʊmaɪd/; [n]<无化>溴化物,庸俗的人,陈词滥调; [^]gre3k;
brook: [-]/brʊk/; [v](常用于否定句或疑问句)容忍;忍受;容忍; [n]小溪;小河; [^]gre3k;
browbeat: [-]/ˈbraʊbiːt/; [v]恫吓,吓唬;欺侮; [^]gre3k;
bruit: [-]/bruːt/; [v](未经证实地)散播消息; [n]谣传; [^]gre3k;
buck: [-]/bʌk/; [n]雄鹿;年轻男士;美元; [v]反对;马弓背踢后腿挑起; [^]gre3k;
budge: [-]/bʌdʒ/; [v]移动一点;妥协; [^]gre3k;
bulge: [-]/bʌldʒ/; [n]凸出部分; [v]凸出,膨胀; [^]gre3k;
bully: [-]/ˈbʊli/; [n]恃强欺弱者; [v]欺负; [^]gre3k;
bumble: [-]/ˈbʌmbl/; [v]嗡嗡叫,营营响;说话含糊,结结巴巴地讲话;笨拙地行动,踉跄前行;弄糟; [n]〈英〉骄横的小官吏; [^]gre3k;
bumptious: [-]/ˈbʌmpʃəs/; [a]专横傲慢的,自以为是的; [^]gre3k;
bungle: [-]/ˈbʌŋɡl/; [v]办糟,失败; [n]粗劣,失败,笨拙; [^]gre3k;
buoy: [-]/ˈbuːi/; [n]浮标;浮筒;救生圈;航标; [v]使浮起;支撑;鼓励; [^]gre3k;
buoyant: [-]/ˈbɔɪənt/; [a]有浮力的;愉快的;(股市)保持高价的; [^]gre3k;
burgeon: [-]/ˈbɜːrdʒən/; [v]发芽,迅速成长; [n]嫩枝; [^]gre3k;
burlesque: [-]/bɜːrˈlesk/; [a]滑稽的,可笑的; [v]讥笑; [n]脱衣舞,打油诗,滑稽戏,笑剧,杂耍,漫画; [^]gre3k;
burnish: [-]/ˈbɜːrnɪʃ/; [v]擦亮,磨光; [^]gre3k;
bustle: [-]/ˈbʌsl/; [n]喧闹,熙攘;腰垫;奔走,奔忙; [v]喧闹;忙乱,奔忙; [^]gre3k;
buttress: [-]/ˈbʌtrəs/; [n]扶墙,拱壁; [v]支持; [^]gre3k;
cache: [-]/kæʃ/; [n]隐藏处所,隐藏的粮食或物资,贮藏物; [vt]贮藏; [vi]躲藏; [^]gre3k;
cachet: [-]/kæˈʃeɪ/; [n](证明品质的)优良标志,公务印章,私人印戳,威望,纪念邮戳; [^]gre3k;
cacophony: [-]/kəˈkɑːfəni/; [n]刺耳的音调;不和谐音; [^]gre3k;
cadge: [-]/kædʒ/; [v]行乞,乞求,贩卖; [^]gre3k;
cajole: [-]/kəˈdʒoʊl/; [v]以甜言蜜语哄骗,勾引; [^]gre3k;
calamity: [-]/kəˈlæməti/; [n]大灾祸,不幸之事; [^]gre3k;
calibrate: [-]/ˈkælɪbreɪt/; [vt]测定(或测量).的口径;校准(或校正);调整; [^]gre3k;
calligraphy: [-]/kəˈlɪɡrəfi/; [n]笔迹,墨宝,书法; [^]gre3k;
callous: [-]/ˈkæləs/; [a]无情的,铁石心肠的,硬结的; [vt](使)变硬,(使)起茧;(使)冷酷无情; [^]gre3k;
callow: [-]/ˈkæloʊ/; [a](鸟)未生羽毛的;年轻而无经验的; [^]gre3k;
calumniate: [-]/kə'lʌmnɪˌeɪt/; [v]诽谤,中伤,诬蔑; [^]gre3k;
camaraderie: [-]/ˌkɑːməˈrɑːdəri/; [n]友情; [^]gre3k;
cameo: [-]/ˈkæmioʊ/; [n]石雕,贝雕;浮雕玉石;文学小品; [^]gre3k;
camouflage: [-]/ˈkæməflɑːʒ/; [n]伪装;掩饰; [v]使改头换面,伪装,掩饰;欺瞒; [^]gre3k;
canard: [-]/kəˈnɑːrd/; [n]误传,谬传;谣言; [^]gre3k;
candor: [-]/'kændə/; [n]坦白,直率,诚挚; [^]gre3k;
canny: [-]/ˈkæni/; [a]精明的,谨慎的,节约的; [ad]<苏格兰>仔细地; [^]gre3k;
canonize: [-]/ˈkænənaɪz/; [v]使加入圣徒之列,推崇,褒扬,将.封为圣徒; [^]gre3k;
canvass: [-]/ˈkænvəs/; [v]仔细检查或详尽地讨论;审查,游说; [n]讨论;细查;劝诱; [^]gre3k;
capitulate: [-]/kəˈpɪtʃuleɪt/; [vi]有条件投降,认输,屈服,让步,停止抵抗; [^]gre3k;
caprice: [-]/kəˈpriːs/; [n]任性,反复无常,随想曲; [^]gre3k;
captious: [-]/'kæpʃəs/; [a]挑剔的,吹毛求疵的; [^]gre3k;
captivate: [-]/ˈkæptɪveɪt/; [v]吸引,迷惑; [^]gre3k;
cardinal: [-]/ˈkɑːrdɪnl/; [a]主要的;基本的; [n]<天主教>枢机主教,红衣主教;基数; [^]gre3k;
careen: [-]/kəˈriːn/; [n](船的)倾侧; [v](船)倾斜,使倾斜; [^]gre3k;
carefree: [-]/ˈkerfriː/; [a]无忧无虑的,轻松愉快的;不负责的; [^]gre3k;
careworn: [-]/ˈkerwɔːrn/; [a]伤心焦虑的;饱经忧患的;疲倦的; [^]gre3k;
caricature: [-]/ˈkærɪkətʃər/; [n]讽刺画,滑稽模仿;扭曲,夸张的描述; [^]gre3k;
carnal: [-]/ˈkɑːrnl/; [a]肉体的,肉欲的,性欲的,色欲的,淫荡的; [^]gre3k;
carouse: [-]/kəˈraʊz/; [v]畅饮,欢宴; [^]gre3k;
carp: [-]/kɑːrp/; [n]鲤鱼; [v]吹毛求疵; [^]gre3k;
carve: [-]/kɑːrv/; [v]雕刻;(把肉等)切成片;开创,开拓; [^]gre3k;
cascade: [-]/kæˈskeɪd/; [n]层叠;小瀑布;喷流; [v]像瀑布般冲下或倾泻; [^]gre3k;
cast: [-]/kæst/; [v]投;抛下,投射(光线和阴影);瞥,飞快看(一眼),扫视;掷;放钓;投票;选定演员; [n]投掷物;铸件;演员表,演员阵容; [^]gre3k;
castigate: [-]/ˈkæstɪɡeɪt/; [v]严惩;苛评;矫正;修订; [^]gre3k;
catalyze: [-]/'kætəˌlaɪz/; [v]催化;刺激,促进; [^]gre3k;
catastrophe: [-]/kəˈtæstrəfi/; [n]大灾难; [^]gre3k;
categorical: [-]/ˌkætəˈɡɔːrɪkl/; [a]绝对的;直接了当的;无条件的;属于某一范畴的; [^]gre3k;
caustic: [-]/ˈkɔːstɪk/; [a]腐蚀性的;苛性的;刻薄的;焦散的; [n]腐蚀剂;苛性钠;焦散曲线; [^]gre3k;
caveat: [-]/ˈkæviæt/; [n]警告;防止误解的说明; [^]gre3k;
cavil: [-]/ˈkævl/; [v]吹毛求疵,挑剔,无端指摘;挑毛病,无端抱怨; [n]吹毛求疵,苛责,无端的指责; [^]gre3k;
cavort: [-]/kəˈvɔːrt/; [v]欢快地蹦跳或行走,雀跃; [^]gre3k;
cede: [-]/siːd/; [v]放弃;割让(领土); [^]gre3k;
cellular: [-]/ˈseljələr/; [a]细胞的,无线的;蜂窝式的; [^]gre3k;
cement: [-]/sɪˈment/; [n]水泥,混凝土;胶合剂; [vt]巩固,加强;用水泥涂;接合; [vi]粘牢; [^]gre3k;
censor: [-]/ˈsensər/; [n]检查员; [vt]审查,检查;修改; [^]gre3k;
censorious: [-]/senˈsɔːriəs/; [a]爱挑剔的,吹毛求疵的,严厉批评的; [^]gre3k;
censure: [-]/ˈsenʃər/; [v]责难,责备; [n]责难,责备; [^]gre3k;
census: [-]/ˈsensəs/; [n]人口普查,人口调查;统计; [v]调查(某地区等的)人口数字;统计.的数字; [^]gre3k;
ceremonious: [-]/ˌserəˈmoʊniəs/; [a]隆重的;讲究仪式的;正式的; [^]gre3k;
certitude: [-]/ˈsɜːrtɪtuːd/; [n]确实;确信;必然性; [^]gre3k;
cessation: [-]/seˈseɪʃn/; [n]停止,中止,中断; [^]gre3k;
chaff: [-]/tʃæf/; [n]谷物的皮壳,米糠;草料,干草;小玩笑; [v]开玩笑; [^]gre3k;
chagrin: [-]/ʃəˈɡrɪn/; [n]懊恼;委屈;气愤; [v]使.懊恼; [^]gre3k;
chameleon: [-]/kəˈmiːliən/; [n]蜥蜴;变色龙;善变的人; [^]gre3k;
champion: [-]/ˈtʃæmpiən/; [n]冠军;拥护者,战士; [v]拥护;保卫;为..而斗争; [a]夺得第一名的;优胜的; [^]gre3k;
channel: [-]/ˈtʃænl/; [n]频道;渠道,方法;海峡; [v]引导;经沟槽输送; [^]gre3k;
chaos: [-]/ˈkeɪɑːs/; [n]混沌;混乱,纷乱; [^]gre3k;
charade: [-]/ʃəˈreɪd/; [n]看手势猜字谜游戏; [^]gre3k;
charisma: [-]/kəˈrɪzmə/; [n]魅力; [^]gre3k;
charlatan: [-]/ˈʃɑːrlətən/; [n]骗子;假内行; [^]gre3k;
chary: [-]/ˈtʃeri/; [a]小心的,谨慎的; [^]gre3k;
chase: [-]/tʃeɪs/; [v]追赶;驱逐;追求; [n]追逐;追求; [^]gre3k;
chasm: [-]/ˈkæzəm/; [n](地壳,冰上的)隐窟,深坑,峡谷;显著差距,巨大分歧; [^]gre3k;
chauvinistic: [-]/ˌʃoʊvɪˈnɪstɪk/; [a]盲目爱国的;大男子主义的; [^]gre3k;
check: [-]/tʃek/; [v]检查;阻止; [n]支票;阻止;检查;阻止物; [^]gre3k;
cherished: [-]/ˈtʃerɪʃt/; [a]受喜爱的,珍爱的; [^]gre3k;
cherubic: [-]/tʃəˈruːbɪk/; [a]可爱的;天使的;无邪的; [^]gre3k;
chicanery: [-]/ʃɪˈkeɪnəri/; [n]诡计,诈骗,欺骗; [^]gre3k;
chide: [-]/tʃaɪd/; [v]叱责,指责; [^]gre3k;
chivalrous: [-]/ˈʃɪvəlrəs/; [a]像骑士的,侠义的,大侠的; [^]gre3k;
choleric: [-]/ˈkɑːlərɪk/; [a]易怒的,暴躁的,胆汁质的; [^]gre3k;
chord: [-]/kɔːrd/; [n]和弦;和音;心弦;(数学)弦; [^]gre3k;
chromatic: [-]/krəˈmætɪk/; [a]彩色的,五彩的; [^]gre3k;
chronic: [-]/ˈkrɑːnɪk/; [a](疾病)慢性的;长期的;(人)久病的;积习难改的;严重的; [^]gre3k;
churl: [-]/tʃɜːrl/; [n]吝啬鬼,乡下人,粗暴的人; [^]gre3k;
cipher: [-]/ˈsaɪfər/; [n]密码,暗号,不重要的人; [^]gre3k;
circuitous: [-]/sərˈkjuːɪtəs/; [a]迂回的,绕圈子的; [^]gre3k;
circumlocution: [-]/ˌsɜːrkəmləˈkjuːʃn/; [n]婉转曲折的说法,累赘的陈述,遁辞; [^]gre3k;
circumscribe: [-]/ˈsɜːrkəmskraɪb/; [v]限制;在.周围画线;<数>使外接,使外切; [^]gre3k;
circumspect: [-]/ˈsɜːrkəmspekt/; [a]慎重的,仔细的; [^]gre3k;
circumvent: [-]/ˌsɜːrkəmˈvent/; [v]用计避免,规避; [^]gre3k;
civility: [-]/səˈvɪləti/; [n]谦恭;礼貌;端庄; [^]gre3k;
claim: [-]/kleɪm/; [v]声称;要求;断言;主张;认领;索赔; [n]索赔;主张;声称;断言;要求; [^]gre3k;
clamor: [-]/ˈklæmər/; [n]喧闹;强烈的要求; [v]喧嚷;强烈的要求; [^]gre3k;
clan: [-]/klæn/; [n]家族;氏族;部落;宗派;亲族; [^]gre3k;
clandestine: [-]/klænˈdestɪn/; [a]秘密的,私下的,暗中的; [^]gre3k;
clarion: [-]/'klærɪən/; [n]号角; [a]清澈响亮的; [^]gre3k;
clarity: [-]/ˈklærəti/; [n]清楚;清澈; [^]gre3k;
clasp: [-]/klæsp/; [v]握紧;扣紧;扣住;抱紧; [n]扣子;钩子;紧抱;紧握; [^]gre3k;
cleave: [-]/kliːv/; [v]劈开,分裂; [^]gre3k;
clement: [-]/ˈklemənt/; [a](天气)温和的;仁慈的; [^]gre3k;
cliche: [-]/klɪˈʃeɪ/; [n]陈腐思想,陈词滥调; [a]陈腐的; [^]gre3k;
cling: [-]/klɪŋ/; [v]紧紧抓住;黏着,挨近;依恋,依附;坚持,墨守,忠实于; [^]gre3k;
clog: [-]/klɑːɡ/; [v]阻塞,阻碍; [n]障碍;木底鞋; [^]gre3k;
clot: [-]/klɑːt/; [v]使凝成块; [n]凝块; [^]gre3k;
cloudburst: [-]/ˈklaʊdbɜːrst/; [n]大暴雨,豪雨; [^]gre3k;
cloying: [-]/ˈklɔɪɪŋ/; [a]甜得发腻的;厌烦的;倒胃口的; [^]gre3k;
clumsy: [-]/ˈklʌmzi/; [a]笨拙的,不灵活的;拙劣的,不得体的; [^]gre3k;
coagulate: [-]/koʊˈæɡjuleɪt/; [v]凝结,使凝结; [^]gre3k;
coalesce: [-]/ˌkoʊəˈles/; [v]联合,合并,结合; [^]gre3k;
coarse: [-]/kɔːrs/; [a]粗糙的;粗俗的;粗鲁的; [^]gre3k;
coax: [-]/koʊks/; [v]哄,哄诱; [^]gre3k;
coda: [-]/ˈkoʊdə/; [n]［音］结尾,符尾; [^]gre3k;
coerce: [-]/koʊˈɜːrs/; [v]强迫,压制; [^]gre3k;
coeval: [-]/koʊˈiːvl/; [a]同时代的; [n]同时代的人; [^]gre3k;
cogent: [-]/ˈkoʊdʒənt/; [a]有说服力的; [^]gre3k;
cognizant: [-]/ˈkɑːɡnɪzənt/; [a]审理的,已认知的; [^]gre3k;
cohesive: [-]/koʊˈhiːsɪv/; [a]团结的;紧密结合的;有黏着力的; [^]gre3k;
collaborate: [-]/kəˈlæbəreɪt/; [v]合作; [^]gre3k;
collapse: [-]/kəˈlæps/; [v](使)倒塌,(使)崩溃,(使)瓦解; [n]倒塌,崩溃,暴跌; [^]gre3k;
collude: [-]/kəˈluːd/; [v]串通,共谋; [^]gre3k;
colossal: [-]/kəˈlɑːsl/; [a]巨像(似)的;巨大的,庞大的; [^]gre3k;
coltish: [-]/ˈkoʊltɪʃ/; [a]放浪不拘的,似小马的; [^]gre3k;
coma: [-]/ˈkoʊmə/; [n]昏迷状态; [^]gre3k;
combustible: [-]/kəmˈbʌstəbl/; [a]易燃的;易激动的; [n]可燃物;易燃物; [^]gre3k;
comely: [-]/ˈkʌmli/; [a]动人的,美丽的; [^]gre3k;
comity: [-]/'kɒmətɪ/; [n]友好,社会和谐;礼让; [^]gre3k;
commencement: [-]/kəˈmensmənt/; [n]开始,发端;毕业典礼; [^]gre3k;
commend: [-]/kəˈmend/; [v]称赞;推荐;委托保管; [^]gre3k;
commensurate: [-]/kəˈmenʃərət/; [a]相称的,相应的;同量的;同样大小的; [^]gre3k;
commingle: [-]/kəˈmɪŋɡl/; [vi]混合; [vt]使混合;掺和; [^]gre3k;
commiserate: [-]/kəˈmɪzəreɪt/; [v]同情,怜悯; [^]gre3k;
commitment: [-]/kəˈmɪtmənt/; [n]承诺;许诺;委任;承担的义务;献身;赞助;委托;犯罪;罪行;信奉; [^]gre3k;
committed: [-]/kəˈmɪtɪd/; [a]效忠的;忠于.的;坚信的; [^]gre3k;
commodious: [-]/kəˈmoʊdiəs/; [a]宽敞的; [^]gre3k;
commotion: [-]/kəˈmoʊʃn/; [n]骚动,动乱; [^]gre3k;
compatible: [-]/kəmˈpætəbl/; [a]可和谐共存的;兼容的; [^]gre3k;
compelling: [-]/kəmˈpelɪŋ/; [a]引人注目的;紧迫的;令人信服的; [^]gre3k;
compendium: [-]/kəmˈpendiəm/; [n]纲要,概略; [^]gre3k;
complacency: [-]/kəmˈpleɪsnsi/; [n]自满,自鸣得意;满足; [^]gre3k;
complacent: [-]/kəmˈpleɪsnt/; [a]自满的,得意的; [^]gre3k;
complaisance: [-]/kəmˈpleɪzəns/; [n]迁就,奉承,彬彬有礼; [^]gre3k;
complementary: [-]/ˌkɑːmplɪˈmentri/; [a]补足的,补充的,互补的; [^]gre3k;
compliant: [-]/kəmˈplaɪənt/; [a]顺从的,服从的,应允的; [^]gre3k;
complicate: [-]/ˈkɑːmplɪkeɪt/; [v](使)变复杂; [^]gre3k;
compliment: [-]/ˈkɑːmplɪmənt/; [n]恭维,问候; [v]赞美,祝贺; [^]gre3k;
comply: [-]/kəmˈplaɪ/; [vi]依从,服从,遵守; [^]gre3k;
compose: [-]/kəmˈpoʊz/; [v]创作,作曲,形成,构成; [^]gre3k;
compound: [-]/ˈkɑːmpaʊnd/; [n]复合物;<化学>化合物; [a]合成的;复合的;多功能的; [vi]妥协;和解; [vt]混合;调和;调停;使恶化; [^]gre3k;
comprehend: [-]/ˌkɑːmprɪˈhend/; [v]由.组成;了解;领会;包含; [^]gre3k;
compress: [-]/kəmˈpres/; [v]压紧,压缩,压榨; [^]gre3k;
compromise: [-]/ˈkɑːmprəmaɪz/; [n]妥协;折中; [v]妥协;使遭受危害; [^]gre3k;
compunction: [-]/kəmˈpʌŋkʃn/; [n]懊悔,良心不安; [^]gre3k;
concatenate: [-]/kɑnˈkæt(ə)ˌneɪt/; [v]连结,连锁; [a]连结的;连锁的; [^]gre3k;
concave: [-]/kɑːnˈkeɪv/; [a]凹面的; [n]凹面; [vt]使成凹形; [^]gre3k;
conceal: [-]/kənˈsiːl/; [v]隐藏,隐瞒,掩盖; [^]gre3k;
concede: [-]/kənˈsiːd/; [v]承认;承认失败;让给,让与;让步; [^]gre3k;
concentrate: [-]/ˈkɑːnsntreɪt/; [v]全神贯注于,集中于;浓缩; [n]浓缩物; [^]gre3k;
concerted: [-]/kənˈsɜːrtɪd/; [a]一致的,商定的; [^]gre3k;
conciliate: [-]/kənˈsɪlieɪt/; [v]调和,安抚; [^]gre3k;
concise: [-]/kənˈsaɪs/; [a]简明的,简要的;简洁的,简要的; [^]gre3k;
concord: [-]/ˈkɑːŋkɔːrd/; [n]和睦,公约; [^]gre3k;
concrete: [-]/ˈkɑːŋkriːt/; [n]混凝土; [a]具体的,实质性的; [v]给 (道路等) 浇混凝土; [^]gre3k;
concur: [-]/kənˈkɜːr/; [v]同意;一致; [^]gre3k;
condemn: [-]/kənˈdem/; [v]谴责,责备;判(某人某罪); [^]gre3k;
condescending: [-]/ˌkɑːndɪˈsendɪŋ/; [a]贬低的;有优越感的; [^]gre3k;
conditional: [-]/kənˈdɪʃənl/; [a]有条件的,假定的; [n]条件句,条件语; [^]gre3k;
condole: [-]/kən'doʊl/; [v]慰问,哀悼; [^]gre3k;
condone: [-]/kənˈdoʊn/; [v]宽恕;赦免; [^]gre3k;
conducive: [-]/kənˈduːsɪv/; [a]有益的,有助于.的; [^]gre3k;
confident: [-]/ˈkɑːnfɪdənt/; [a]自信的;确信的,深信的; [^]gre3k;
confine: [-]/kənˈfaɪn/; [v]限制;监禁; [n]范围,界限,约束,限制; [^]gre3k;
conflagration: [-]/ˌkɑːnfləˈɡreɪʃn/; [n]建筑物或森林大火; [^]gre3k;
conflate: [-]/kənˈfleɪt/; [v]合并; [^]gre3k;
confluence: [-]/ˈkɑːnfluəns/; [n](河流的)汇合,汇流点;(人或物的)聚集; [^]gre3k;
conform: [-]/kənˈfɔːrm/; [vi]一致;遵照,顺从;符合; [vt]使一致;使遵照; [a]一致的; [^]gre3k;
confound: [-]/kənˈfaʊnd/; [v]使混淆,使混乱;挫败;讨厌; [^]gre3k;
confront: [-]/kənˈfrʌnt/; [v]与某人对峙;与..对抗;正视; [^]gre3k;
congeal: [-]/kənˈdʒiːl/; [v]凝结;凝固; [^]gre3k;
congenial: [-]/kənˈdʒiːniəl/; [a]意气相投的,令人愉快的,意气相投的,协调的; [^]gre3k;
congruent: [-]/ˈkɑːŋɡruənt/; [a]和谐一致的,全等的; [^]gre3k;
conjecture: [-]/kənˈdʒektʃər/; [n]推测;猜想; [v]推测;揣摩; [^]gre3k;
conjure: [-]/ˈkʌndʒər/; [v]变魔术;使...变戏法般地出现(或消失);使想起;使...呈现于脑际;(a name to conjure with)大名鼎鼎的人;影响巨大的事物;恳求; [^]gre3k;
connive: [-]/kəˈnaɪv/; [v]默许,共谋; [^]gre3k;
connoisseur: [-]/ˌkɑːnəˈsɜːr/; [n](艺术品等的)鉴赏家,鉴定家,行家; [^]gre3k;
conscientious: [-]/ˌkɑːnʃiˈenʃəs/; [a]勤勤恳恳的;认真的; [^]gre3k;
consensus: [-]/kənˈsensəs/; [n]一致同意,合意; [^]gre3k;
consent: [-]/kənˈsent/; [n]同意,准许;赞成; [v]同意; [^]gre3k;
consequence: [-]/ˈkɑːnsɪkwens/; [n]结果,后果;重要性; [^]gre3k;
conservative: [-]/kənˈsɜːrvətɪv/; [a]保守的;保守估计的;保守党的; [n]保守主义者;保守党党员; [^]gre3k;
conservatory: [-]/kənˈsɜːrvətɔːri/; [n]温室;音乐学校; [a]有保存力的;保存性的; [^]gre3k;
conserve: [-]/kənˈsɜːrv/; [v]保藏,保存;节约; [n]蜜饯,果酱; [^]gre3k;
considerable: [-]/kənˈsɪdərəbl/; [a]相当大的;重要的;可观的; [^]gre3k;
consign: [-]/kənˈsaɪn/; [v]托运,托卖,寄存; [^]gre3k;
console: [-]/kənˈsoʊl/; [v]安慰,慰问; [n]控制台,仪表板;落地柜; [^]gre3k;
consolidate: [-]/kənˈsɑːlɪdeɪt/; [v]巩固,加强;把.合为一体; [^]gre3k;
consonant: [-]/ˈkɑːnsənənt/; [a]辅音的;一致的,和谐的; [n]辅音;辅音字母; [^]gre3k;
conspicuous: [-]/kənˈspɪkjuəs/; [a]显眼的;显著的;显而易见的; [^]gre3k;
conspire: [-]/kənˈspaɪər/; [v]密谋策划;共谋,串通一气; [^]gre3k;
consternation: [-]/ˌkɑːnstərˈneɪʃn/; [n]惊愕,恐怖,惊惶失措; [^]gre3k;
constitute: [-]/ˈkɑːnstətuːt/; [v]构成,组成;任命; [^]gre3k;
constrain: [-]/kənˈstreɪn/; [v]约束;限制;强迫; [^]gre3k;
constrict: [-]/kənˈstrɪkt/; [v]约束,收缩,妨碍; [^]gre3k;
construct: [-]/kənˈstrʌkt/; [v]建造;作(图);构筑; [n]概念;构筑物;结构体;建造物; [^]gre3k;
consummate: [-]/ˈkɑːnsəmət/; [a]至上的,完美的; [v]完成,使达到极点; [^]gre3k;
contagious: [-]/kənˈteɪdʒəs/; [a](病)有传染性的;(人)患传染病的;有感染力的; [^]gre3k;
contaminate: [-]/kənˈtæmɪneɪt/; [v]弄脏,污染; [^]gre3k;
contemplate: [-]/ˈkɑːntəmpleɪt/; [v]沉思;对..周密考虑;注视; [^]gre3k;
contempt: [-]/kənˈtempt/; [n]轻视,鄙视; [^]gre3k;
contend: [-]/kənˈtend/; [v]争辩;坚决主张;搏斗; [^]gre3k;
content: [-]/ˈkɑːntent/; [n]内容,目录;满足; [a]满足的; [v]使满意; [^]gre3k;
contentious: [-]/kənˈtenʃəs/; [a]好辩的,爱争论的; [^]gre3k;
contiguous: [-]/kənˈtɪɡjuəs/; [a]相接的;邻近的,附近的; [^]gre3k;
contort: [-]/kənˈtɔːrt/; [v]扭曲,歪曲; [^]gre3k;
contract: [-]/ˈkɑːntrækt/; [n]合同,契约; [v]感染(疾病);招致;订合同;订立(婚约);缩减; [^]gre3k;
contradict: [-]/ˌkɑːntrəˈdɪkt/; [v]与..发生矛盾,与..抵触,与..对立; [^]gre3k;
contravene: [-]/ˌkɑːntrəˈviːn/; [v]抵触,违反,反驳,否认; [^]gre3k;
contrite: [-]/kənˈtraɪt/; [a]悔罪的;痛悔的; [^]gre3k;
contrived: [-]/kənˈtraɪvd/; [a]人为的;做作的;不自然的; [^]gre3k;
contumacious: [-]/ˌkɑːntuˈmeɪʃəs/; [a]违抗的,顽固的,反抗法院命令的; [^]gre3k;
conundrum: [-]/kəˈnʌndrəm/; [n](答案有双关意义的)谜语;机智问答;难题; [^]gre3k;
convalesce: [-]/ˌkɑːnvəˈles/; [v]渐愈,渐渐康复; [^]gre3k;
convene: [-]/kənˈviːn/; [v]集合,召集,召唤; [^]gre3k;
convenience: [-]/kənˈviːniəns/; [n]方便;便利设施; [^]gre3k;
convention: [-]/kənˈvenʃn/; [n]会议;习俗;惯例; [^]gre3k;
converge: [-]/kənˈvɜːrdʒ/; [v](向某一点)相交,会合;汇集,聚集,集中; [^]gre3k;
conversant: [-]/kənˈvɜːrsnt/; [a]熟悉的;精通的;亲近的; [^]gre3k;
convert: [-]/kənˈvɜːrt/; [v]可转变为,可变换成;改变,转变,转化;使改变信仰; [n]皈依者;改变宗教信仰者; [^]gre3k;
convex: [-]/ˈkɑːnveks/; [a]中凸的;凸圆的;凸面的; [n]凸面体;凸状; [^]gre3k;
convey: [-]/kənˈveɪ/; [v]传送,运送;表达,传达; [^]gre3k;
conviction: [-]/kənˈvɪkʃn/; [n]定罪;信服;坚强信念; [^]gre3k;
convoke: [-]/kənˈvoʊk/; [v]召集会议; [^]gre3k;
convoluted: [-]/ˈkɑːnvəluːtɪd/; [a]旋绕的,费解的; [^]gre3k;
convulsion: [-]/kənˈvʌlʃn/; [n]惊厥,动乱,震撼,震动; [^]gre3k;
coop: [-]/kuːp/; [v]把.关进笼子里;限制;拘禁; [n]鸡笼;小屋;捕鱼篓; [^]gre3k;
copious: [-]/ˈkoʊpiəs/; [a]丰富的,多产的; [^]gre3k;
coquette: [-]/koʊˈket/; [n]调情的女子; [v]不认真对待; [^]gre3k;
cordon: [-]/ˈkɔːrdn/; [n]哨兵线,警戒线;饰带; [v]布设警戒线;封锁交通; [^]gre3k;
cornucopia: [-]/ˌkɔːrnjuˈkoʊpiə/; [n]象征丰收的羊角;装满花果及谷穗表丰饶的羊角状物;丰饶的象征; [^]gre3k;
coronation: [-]/ˌkɔːrəˈneɪʃn/; [n]加冕,加冕礼; [^]gre3k;
corporeal: [-]/kɔːrˈpɔːriəl/; [a]物质的,有形的,肉体的; [^]gre3k;
correlate: [-]/ˈkɔːrələt/; [v](使)相关联; [n]相关物; [^]gre3k;
corroborate: [-]/kəˈrɑːbəreɪt/; [v]支持或证实,强化; [n]确证者,证物; [^]gre3k;
corrosive: [-]/kəˈroʊsɪv/; [a]腐蚀的;腐蚀性的;蚀坏的; [n]腐蚀剂; [^]gre3k;
corrugated: [-]/ˈkɔːrəɡeɪtɪd/; [a]褶皱的; [^]gre3k;
cosmopolitan: [-]/ˌkɑːzməˈpɑːlɪtən/; [n]游历四方的人; [a]见多识广的;多元的;广泛分布的; [^]gre3k;
cosset: [-]/ˈkɑːsɪt/; [v]宠爱,娇养; [n]宠儿,爱畜;宠物; [^]gre3k;
countenance: [-]/ˈkaʊntənəns/; [n]面容,表情,气色; [v]支持,赞成; [^]gre3k;
counterfeit: [-]/ˈkaʊntərfɪt/; [n]仿制品,伪造物; [a]仿造的.假冒的; [v]伪造,仿造; [^]gre3k;
countermand: [-]/ˈkaʊntərmænd/; [vt]撤回,取消; [^]gre3k;
counterpart: [-]/ˈkaʊntərpɑːrt/; [n]对应的人(物);副本;对手; [^]gre3k;
counterproductive: [-]/ˌkaʊntərprəˈdʌktɪv/; [a]反效果的,阻碍预期目标的; [^]gre3k;
court: [-]/kɔːrt/; [n]法院,法庭;庭院;球场;宫廷; [v]讨好,取悦;招致危险;追求; [^]gre3k;
courteous: [-]/ˈkɜːrtiəs/; [a]有礼貌的,谦恭有礼的; [^]gre3k;
covert: [-]/ˈkoʊvɜːrt/; [a]隐蔽的,偷偷摸摸的,<律>在丈夫保护下的; [n]掩蔽处,隐藏处; [^]gre3k;
covetous: [-]/ˈkʌvətəs/; [a]贪婪的,贪心的; [^]gre3k;
cow: [-]/kaʊ/; [n]母牛,奶牛;母兽; [v]恐吓,吓倒; [^]gre3k;
cowardice: [-]/ˈkaʊərdɪs/; [n]胆小,懦弱; [^]gre3k;
cower: [-]/ˈkaʊər/; [v]畏缩,退缩,蜷缩; [^]gre3k;
coy: [-]/kɔɪ/; [a]腼腆的,怕羞的;卖弄风情的; [^]gre3k;
cramped: [-]/kræmpt/; [a]狭窄的,挤在一起的; [^]gre3k;
crass: [-]/kræs/; [a]粗鲁的,粗俗的,愚钝的; [^]gre3k;
crave: [-]/kreɪv/; [v]渴望;恳求; [^]gre3k;
craven: [-]/ˈkreɪvn/; [a]懦弱的,畏缩的; [^]gre3k;
crease: [-]/kriːs/; [n]折缝,皱痕; [v]起折痕; [^]gre3k;
credence: [-]/ˈkriːdns/; [n]信任,相信; [^]gre3k;
credible: [-]/ˈkredəbl/; [a]可信任的,可靠的,出色的; [^]gre3k;
credit: [-]/ˈkredɪt/; [n]信用;荣誉;学分;信贷;称赞;债权; [v]信赖;归因于;记学分; [^]gre3k;
credulous: [-]/ˈkredʒələs/; [a]轻信的,因轻信而产生的; [^]gre3k;
creek: [-]/kriːk/; [n]小溪;小湾; [^]gre3k;
creep: [-]/kriːp/; [vi]爬行;潜入;蔓延;变形;毛发直竖; [n]卑鄙小人;爬行;变形;毛骨悚然的感觉; [^]gre3k;
crescendo: [-]/krəˈʃendoʊ/; [n](音乐)渐强;高潮; [^]gre3k;
crest: [-]/krest/; [n]鸟冠,盔上的装饰(如羽毛),顶部,顶峰; [v]到达绝顶,加以顶饰; [^]gre3k;
crestfallen: [-]/ˈkrestfɔːlən/; [a]垂头丧气的,气馁的; [^]gre3k;
cronyism: [-]/ˈkroʊniɪzəm/; [n]任人唯亲;任用亲信; [^]gre3k;
crook: [-]/krʊk/; [n]骗子;弯曲处;钩;河弯;诡计; [v]使弯曲; [a]不正当的;骗人的; [^]gre3k;
croon: [-]/kruːn/; [v]低声歌唱或说话; [^]gre3k;
crouch: [-]/kraʊtʃ/; [v]蹲;弯腰; [^]gre3k;
crow: [-]/kroʊ/; [n]乌鸦;欢呼声; [v]啼;报晓;(儿童)欢笑; [^]gre3k;
crucial: [-]/ˈkruːʃl/; [a]关键的;决定性的; [^]gre3k;
crumple: [-]/ˈkrʌmpl/; [v]把.揉作一团,弄皱;压碎; [^]gre3k;
crutch: [-]/krʌtʃ/; [n]拐杖,支柱; [v]支撑; [^]gre3k;
crux: [-]/krʌks/; [n]关键,难题,十字架形,坩埚; [^]gre3k;
cryptic: [-]/ˈkrɪptɪk/; [a]秘密的,含义模糊的,神秘的,隐藏的; [^]gre3k;
culpable: [-]/ˈkʌlpəbl/; [a]有罪的;该责备的;不周到的;应受处罚的; [^]gre3k;
cultivate: [-]/ˈkʌltɪveɪt/; [v]耕作,养植,栽培;培养,陶冶,发展; [^]gre3k;
cumbersome: [-]/ˈkʌmbərsəm/; [a]笨重的;麻烦的; [^]gre3k;
cunning: [-]/ˈkʌnɪŋ/; [n]狡猾,精巧; [a]狡猾的,精巧的; [^]gre3k;
curmudgeon: [-]/kɜːrˈmʌdʒən/; [n]脾气暴躁之人; [^]gre3k;
cursory: [-]/ˈkɜːrsəri/; [a]匆忙的,不注意细节的;草率地;粗略地; [^]gre3k;
curt: [-]/kɜːrt/; [a]简略的; [^]gre3k;
curtail: [-]/kɜːrˈteɪl/; [vt]截短;削减;剥夺.特权; [^]gre3k;
cynic: [-]/ˈsɪnɪk/; [n]愤世嫉俗者;犬儒学派的人; [a]犬儒学派的; [^]gre3k;
dabble: [-]/ˈdæbl/; [v]涉足;浅赏,溅湿;浸入水中; [^]gre3k;
daft: [-]/dæft/; [a]愚蠢的; [^]gre3k;
dais: [-]/ˈdeɪɪs/; [n]主席台,嘉宾席; [^]gre3k;
dally: [-]/ˈdæli/; [v]闲荡,嬉戏;浪费(时间); [^]gre3k;
damn: [-]/dæm/; [int]该死,讨厌; [v]诅咒; [n]诅咒; [a]该死的;完全的; [ad](表示厌烦)该死;非常; [^]gre3k;
dampen: [-]/ˈdæmpən/; [v]变潮湿; [vi]沮丧; [vt]使潮湿;抑制,使扫兴; [^]gre3k;
dandy: [-]/ˈdændi/; [n]花花公子; [a]服装华丽的,极好的,上等的; [^]gre3k;
dank: [-]/dæŋk/; [a]潮湿的,阴湿的;透水的; [^]gre3k;
dapper: [-]/ˈdæpər/; [a]干净利落的,衣冠楚楚的; [^]gre3k;
dappled: [-]/ˈdæpld/; [a]有斑点的,斑驳的; [^]gre3k;
daredevil: [-]/ˈderdevl/; [n]铤而走险的人,蛮勇的人; [a]蛮勇的,不怕死的; [^]gre3k;
dart: [-]/dɑːrt/; [n]飞镖;猛冲;标枪; [v]快速投掷;突然移动; [^]gre3k;
dashing: [-]/ˈdæʃɪŋ/; [a]时髦的,华丽的;雄纠纠的;劲头十足的; [^]gre3k;
dated: [-]/ˈdeɪtɪd/; [a]注有(或注明)日期的;过时的,旧式的; [^]gre3k;
daunt: [-]/dɔːnt/; [v]使气馁,使畏缩,威吓; [^]gre3k;
dawdle: [-]/ˈdɔːdl/; [v]闲荡,浪费时间; [^]gre3k;
deadlock: [-]/ˈdedlɑːk/; [vt](使)相持不下; [vi]僵持; [n]僵局;不分胜负; [^]gre3k;
deadpan: [-]/ˈdedpæn/; [a]面无表情的; [ad]面无表情地; [^]gre3k;
dearth: [-]/dɜːrθ/; [n]缺乏,供应不足; [^]gre3k;
debacle: [-]/dɪˈbɑːkl/; [n]解冻,崩溃;灾害; [^]gre3k;
debark: [-]/dɪ'bɑːk/; [v]下船,登陆; [^]gre3k;
debase: [-]/dɪˈbeɪs/; [v]贬值,降低; [^]gre3k;
debilitate: [-]/dɪˈbɪlɪteɪt/; [v]使衰弱; [^]gre3k;
debonair: [-]/ˌdebəˈner/; [a]温文尔雅的; [^]gre3k;
debris: [-]/dəˈbriː/; [n]废墟,残骸; [^]gre3k;
debunk: [-]/ˌdiːˈbʌŋk/; [v]揭穿真面目,证明为假; [^]gre3k;
debut: [-]/deɪˈbjuː/; [n]初次登台,在社交场合的初次露脸; [v]初次露面,初次表演;首次推出; [a]首张的,首场的,首次的; [^]gre3k;
decadence: [-]/ˈdekədəns/; [n]堕落,颓废;衰落; [^]gre3k;
decadent: [-]/ˈdekədənt/; [a]颓废的;衰退的; [^]gre3k;
decant: [-]/dɪˈkænt/; [vt]轻轻倒出; [^]gre3k;
decipher: [-]/dɪˈsaɪfər/; [n]密电译文; [vt]解释;破译; [^]gre3k;
decode: [-]/ˌdiːˈkoʊd/; [v]译解;解码; [^]gre3k;
decorum: [-]/dɪˈkɔːrəm/; [n]礼节,礼貌,端庄,正派; [^]gre3k;
decrepit: [-]/dɪˈkrepɪt/; [a]衰老的,破旧的; [^]gre3k;
decry: [-]/dɪˈkraɪ/; [v]谴责,责难,诽谤; [^]gre3k;
default: [-]/dɪˈfɔːlt/; [n]违约;缺席;缺乏;默认; [vi]不履行义务;拖欠; [vt]不履行;不参加; [^]gre3k;
defer: [-]/dɪˈfɜːr/; [v]使推迟,使延期;听从,顺从; [vi]延期; [^]gre3k;
deference: [-]/ˈdefərəns/; [n]尊敬,尊重;顺从; [^]gre3k;
deficiency: [-]/dɪˈfɪʃnsi/; [n]缺乏,不足;缺陷; [^]gre3k;
defile: [-]/dɪˈfaɪl/; [v]污损,弄脏;以纵队前进; [n]狭谷;隘路; [^]gre3k;
deflect: [-]/dɪˈflekt/; [v](使)偏斜,(使)偏转; [^]gre3k;
defray: [-]/dɪˈfreɪ/; [v]支出;支付; [^]gre3k;
deft: [-]/deft/; [a]灵巧的,敏捷的,熟练的; [^]gre3k;
defuse: [-]/ˌdiːˈfjuːz/; [vi]平息,变弱; [vt]拆除;使消除危险性,平息; [^]gre3k;
defy: [-]/dɪˈfaɪ/; [v]违抗,藐视;使不可能 (理解或解释);违背;赌.也不能; [n]挑战;对抗; [^]gre3k;
dehydrate: [-]/diːˈhaɪdreɪt/; [v]除去水份,脱水; [^]gre3k;
deify: [-]/ˈdeɪɪfaɪ/; [v]奉为神;崇拜; [^]gre3k;
deign: [-]/deɪn/; [v]屈尊,惠允(做某事); [^]gre3k;
deject: [-]/dɪ'dʒekt/; [v]使.灰心; [a]沮丧的,气馁的; [^]gre3k;
delegate: [-]/ˈdelɪɡət/; [n]代表; [v]委派..为代表,授权; [^]gre3k;
deleterious: [-]/ˌdeləˈtɪriəs/; [a]有害的;有毒的; [^]gre3k;
deliberate: [-]/dɪˈlɪbərət/; [a]故意的;深思熟虑的;从容不迫的; [v]仔细考虑;研讨; [^]gre3k;
delicacy: [-]/ˈdelɪkəsi/; [n]精致;柔弱;佳肴;优雅;谨慎; [^]gre3k;
delineate: [-]/dɪˈlɪnieɪt/; [v]描画;画出..轮廓; [^]gre3k;
delirium: [-]/dɪˈlɪriəm/; [n]神志不清,极度兴奋; [^]gre3k;
deluge: [-]/ˈdeljuːdʒ/; [n]洪水;暴雨;泛滥; [v]使泛滥;压倒; [^]gre3k;
delusion: [-]/dɪˈluːʒn/; [n]错觉; [^]gre3k;
delve: [-]/delv/; [v]钻研;探究;挖; [n]穴;洞; [^]gre3k;
demagogue: [-]/ˈdeməɡɑːɡ/; [n]煽动者; [^]gre3k;
demanding: [-]/dɪˈmændɪŋ/; [a]苛求的,难取悦的;费力的; [^]gre3k;
demolition: [-]/ˌdeməˈlɪʃn/; [n]拆除(等于demolishment);破坏,毁坏; [^]gre3k;
demonstrate: [-]/ˈdemənstreɪt/; [vt](用实例,实验)论证;演示,展示;示范; [vi]示威; [^]gre3k;
demoralize: [-]/dɪˈmɔːrəlaɪz/; [v]使低落,使沮丧;使道德败坏;使士气低落; [^]gre3k;
demote: [-]/ˌdiːˈmoʊt/; [v]降级,降职; [^]gre3k;
demotic: [-]/dɪˈmɑːtɪk/; [a]通俗的,民众的; [^]gre3k;
demotion: [-]/ˌdiːˈmoʊʃn/; [n]降级,降职; [^]gre3k;
demur: [-]/dɪˈmɜːr/; [n]异议; [v]异议,反对,拒绝; [^]gre3k;
denigrate: [-]/ˈdenɪɡreɪt/; [v]抹黑,贬低; [^]gre3k;
denouement: [-]/ˌdeɪnuːˈmɑ̃ː/; [n]结局,终场; [^]gre3k;
denounce: [-]/dɪˈnaʊns/; [v]谴责,斥责; [^]gre3k;
dent: [-]/dent/; [n]缺口,凹痕; [v]使凹下,凹进,削弱; [^]gre3k;
denude: [-]/dɪˈnuːd/; [v]脱去,剥蚀,剥夺; [^]gre3k;
dependable: [-]/dɪˈpendəbl/; [a]可靠的;可信赖的; [^]gre3k;
deplete: [-]/dɪˈpliːt/; [v]使大大减少;耗尽,用尽; [^]gre3k;
deplorable: [-]/dɪˈplɔːrəbl/; [a]可叹的;凄惨的; [^]gre3k;
deplore: [-]/dɪˈplɔːr/; [v]谴责;对...深感遗憾;悲悼;痛惜; [^]gre3k;
deploy: [-]/dɪˈplɔɪ/; [v]部署,设置;展开,散开; [^]gre3k;
deportation: [-]/ˌdiːpɔːrˈteɪʃn/; [n]驱逐出境,放逐; [^]gre3k;
depose: [-]/dɪˈpoʊz/; [v]免职,废黜,作证; [^]gre3k;
deposit: [-]/dɪˈpɑːzɪt/; [v]存款,存放;沉淀; [n]存款,定金;沉积物,矿床; [^]gre3k;
depravity: [-]/dɪˈprævəti/; [n][n]恶劣行为;堕落,腐败,邪恶;腐败;邪恶;恶劣行为,腐化堕落的行为; [^]gre3k;
deprecate: [-]/ˈdeprəkeɪt/; [v]反对;轻视; [^]gre3k;
depreciate: [-]/dɪˈpriːʃieɪt/; [v]贬低,轻视;贬值;折旧; [^]gre3k;
depressed: [-]/dɪˈprest/; [a]沮丧的;萧条的;低迷的; [^]gre3k;
deprivation: [-]/ˌdeprɪˈveɪʃn/; [n]剥夺;免职;匮乏;丧失;损失;免职; [^]gre3k;
deracinate: [-]/ˌdiːˈræsɪneɪt/; [v]根除,使孤立; [^]gre3k;
derelict: [-]/ˈderəlɪkt/; [a]渎职的,荒废的,被弃置的; [n]失业贫穷的无家可归者; [^]gre3k;
deride: [-]/dɪˈraɪd/; [v]嘲弄,愚弄; [^]gre3k;
derivative: [-]/dɪˈrɪvətɪv/; [n]派生物;<化学>衍生物; [a]被引申出的,被诱导的;衍生的;第二手的; [^]gre3k;
descend: [-]/dɪˈsend/; [vi]走下;降临; [v]下降,下来;突然访问;下移,下降; [^]gre3k;
descendant: [-]/dɪˈsendənt/; [n]后代,后裔;派生物; [^]gre3k;
desecrate: [-]/ˈdesɪkreɪt/; [v]亵渎,玷污; [^]gre3k;
desiccate: [-]/'desɪˌkeɪt/; [v](使)完全干涸,脱水; [^]gre3k;
designate: [-]/ˈdezɪɡneɪt/; [a]已受委派而尚未上任的; [v]标出,说出;委任,任命,提名;指定; [^]gre3k;
desperate: [-]/ˈdespərət/; [a]绝望的;孤注一掷的;极需要的,渴望的;(情况) 极严重的;极危险的;很危急的; [^]gre3k;
despicable: [-]/dɪˈspɪkəbl/; [a]可鄙的,卑劣的; [^]gre3k;
despise: [-]/dɪˈspaɪz/; [vt]轻视,蔑视,看不起; [^]gre3k;
despotic: [-]/dɪˈspɑːtɪk/; [a]专政的,专横的,暴虐的; [^]gre3k;
desultory: [-]/ˈdesəltɔːri/; [a]散漫的,无目的的,断断续续的; [^]gre3k;
detach: [-]/dɪˈtætʃ/; [v]使分开,拆卸;派遣; [^]gre3k;
detain: [-]/dɪˈteɪn/; [v]拘留,使延迟; [^]gre3k;
deter: [-]/dɪˈtɜːr/; [v]防止,阻止,使踌躇; [^]gre3k;
deterioration: [-]/dɪˌtɪriəˈreɪʃn/; [n]变坏,退化,恶化;堕落; [^]gre3k;
detour: [-]/ˈdiːtʊr/; [n]弯路,绕行之路; [v]绕道,迂回; [^]gre3k;
detritus: [-]/dɪˈtraɪtəs/; [n]岩屑,碎石; [^]gre3k;
devoted: [-]/dɪˈvoʊtɪd/; [a]虔诚的,投入的; [^]gre3k;
devout: [-]/dɪˈvaʊt/; [a]虔诚的,真挚的,诚恳的; [n]虔诚;真挚,诚恳; [^]gre3k;
dexterous: [-]/ˈdekstrəs/; [a]灵巧的,熟练的; [^]gre3k;
diabolic: [-]/ˌdaɪə'bɑːlɪk/; [a]恶魔的;恶魔似的;残忍的; [^]gre3k;
diaphanous: [-]/daɪˈæfənəs/; [a]透明的;精致的;模糊的; [^]gre3k;
diatribe: [-]/ˈdaɪətraɪb/; [n]诽谤,恶骂; [^]gre3k;
dichotomy: [-]/daɪˈkɑːtəmi/; [n]二分,本质对立; [^]gre3k;
dictate: [-]/ˈdɪkteɪt/; [v]规定;命令;口授;听写; [n]命令;指令; [^]gre3k;
didactic: [-]/daɪˈdæktɪk/; [a]说教的;教诲的; [^]gre3k;
diehard: [-]/ˈdaɪhɑːrd/; [n]顽固分子,保守分子; [a]顽固的,执拗的; [^]gre3k;
diffident: [-]/ˈdɪfɪdənt/; [a]羞怯的,缺乏自信的,谦虚谨慎的; [^]gre3k;
diffuse: [-]/dɪˈfjuːz/; [v]传播;扩散,弥漫;漫射; [a]四散的,散开的;不清楚的; [^]gre3k;
digress: [-]/daɪˈɡres/; [v]离题;走向岔道; [^]gre3k;
dike: [-]/daɪk/; [n]堤防,堤坝;障碍物;(英)壕沟; [v]筑堤防护;开沟排水; [^]gre3k;
dilapidate: [-]/də'læpəˌdeɪt/; [v]毁坏,荒废,浪费; [^]gre3k;
dilate: [-]/daɪˈleɪt/; [v]使膨胀,扩张,膨胀;详述; [^]gre3k;
dilatory: [-]/ˈdɪlətɔːri/; [a]拖拉的,缓慢的,不慌不忙的; [^]gre3k;
dilettante: [-]/ˌdɪləˈtænti/; [n]半吊子; [^]gre3k;
diligent: [-]/ˈdɪlɪdʒənt/; [a]勤奋的;用功的; [^]gre3k;
dilute: [-]/daɪˈluːt/; [v]使变淡,稀释;使病弱; [^]gre3k;
diminish: [-]/dɪˈmɪnɪʃ/; [v]减少;失势,削弱.的权势, 减弱.的权势; [^]gre3k;
din: [-]/dɪn/; [n]喧闹声,嘈杂声; [v]喧闹,喋喋不休地说; [^]gre3k;
dingy: [-]/ˈdɪndʒi/; [a]昏暗的,肮脏的;褴褛的; [n]同"dingey"; [^]gre3k;
diocesan: [-]/daɪˈɑːsɪsn/; [a]主教管区的; [n]教区主教; [^]gre3k;
diplomatic: [-]/ˌdɪpləˈmætɪk/; [a]外交的,从事外交的;老练的,圆滑的; [^]gre3k;
dire: [-]/ˈdaɪər/; [a]可怕的;悲惨的;极端的; [^]gre3k;
dirge: [-]/dɜːrdʒ/; [n]挽歌;哀悼歌; [^]gre3k;
disabuse: [-]/ˌdɪsəˈbjuːz/; [v]使省悟,解迷惑,释疑,矫正; [^]gre3k;
disaffected: [-]/ˌdɪsəˈfektɪd/; [a]不满的,有叛意的,愤愤不平的; [^]gre3k;
disarm: [-]/dɪsˈɑːrm/; [vt]放下武器;使人消除敌意; [vi]解除武装; [^]gre3k;
disarray: [-]/ˌdɪsəˈreɪ/; [n]混乱,漫无秩序; [^]gre3k;
disavow: [-]/ˌdɪsəˈvaʊ/; [v]不承认,抵赖,拒绝对..承担责任; [^]gre3k;
discern: [-]/dɪˈsɜːrn/; [v]辨别;识别;看出; [^]gre3k;
discharge: [-]/dɪsˈtʃɑːrdʒ/; [n]发射;释放;解雇;放电; [v]卸掉负担;发射;放电;卸(货);使爆炸;履行;解雇;允许.离开;排出,放出;清偿(债务); [^]gre3k;
disciple: [-]/dɪˈsaɪpl/; [n]信徒,门徒;耶稣的信徒(或门徒,使徒); [^]gre3k;
discombobulate: [-]/ˌdɪskəmˈbɑːbjuleɪt/; [vt]使混乱,使困惑,挫败; [^]gre3k;
discomfit: [-]/dɪsˈkʌmfɪt/; [v]挫败,扰乱,破坏,使.为难; [^]gre3k;
discommode: [-]/ˌdɪskə'moʊd/; [v]使不方便,使为难,使不自由; [^]gre3k;
discompose: [-]/ˌdɪskəmˈpoʊz/; [v]使失态,使烦恼,慌张; [^]gre3k;
disconcert: [-]/ˌdɪskənˈsɜːrt/; [v]使仓皇失措;使困惑;破坏; [^]gre3k;
discord: [-]/ˈdɪskɔːrd/; [n]不和,争吵;(声音)不和谐; [^]gre3k;
discredit: [-]/dɪsˈkredɪt/; [v]使不相信,使怀疑;败坏.的名声; [n]丧失信誉,丧失名誉;败坏名声的人或事,耻辱; [^]gre3k;
discreet: [-]/dɪˈskriːt/; [a]谨慎的;思虑周全的,小心的; [^]gre3k;
discrepancy: [-]/dɪsˈkrepənsi/; [n]不一致,差异,不符; [^]gre3k;
discrete: [-]/dɪˈskriːt/; [a]分开的;不连续的; [^]gre3k;
discretion: [-]/dɪˈskreʃn/; [n]自由裁量权;谨慎;判断力;判定;考虑周到; [^]gre3k;
discretionary: [-]/dɪˈskreʃəneri/; [a]分立的,自理自由的;任意的; [^]gre3k;
discriminate: [-]/dɪˈskrɪmɪneɪt/; [v]区别,辨别;歧视; [^]gre3k;
discursive: [-]/dɪsˈkɜːrsɪv/; [a](谈话内容)杂乱的,东拉西扯的,无层次的; [^]gre3k;
disdain: [-]/dɪsˈdeɪn/; [n]蔑视,鄙视; [vt]鄙视;不屑; [^]gre3k;
disenchant: [-]/ˌdɪsɪn'tʃænt/; [v]使觉悟,使摆脱幻想; [^]gre3k;
disengage: [-]/ˌdɪsɪnˈɡeɪdʒ/; [v]分开; [^]gre3k;
disgorge: [-]/dɪsˈɡɔːrdʒ/; [v]涌出,流出;吐出; [^]gre3k;
disguise: [-]/dɪsˈɡaɪz/; [v]伪装;掩饰; [n]伪装物;伪装; [^]gre3k;
dishearten: [-]/dɪsˈhɑːrtn/; [v]使灰心,使沮丧; [^]gre3k;
disinclination: [-]/ˌdɪsˌɪnklɪˈneɪʃn/; [n]不感兴趣,厌恶; [^]gre3k;
disinfect: [-]/ˌdɪsɪnˈfekt/; [v]消毒; [^]gre3k;
disinter: [-]/ˌdɪsɪnˈtɜːr/; [v]掘出;发掘;显露; [^]gre3k;
disinterested: [-]/dɪsˈɪntrəstɪd/; [a]公正的;不感兴趣的;无私的;廉洁的; [^]gre3k;
disjointed: [-]/dɪsˈdʒɔɪntɪd/; [a]杂乱的,无逻辑的,脱节的; [^]gre3k;
dismantle: [-]/dɪsˈmæntl/; [v]拆开;拆除; [^]gre3k;
dismay: [-]/dɪsˈmeɪ/; [n]失望;沮丧;惊愕; [v]使惊恐; [^]gre3k;
disparage: [-]/dɪˈspærɪdʒ/; [v]蔑视;贬损; [^]gre3k;
disparate: [-]/ˈdɪspərət/; [a]迥然不同的; [^]gre3k;
dispassionate: [-]/dɪsˈpæʃənət/; [a]平心静气的,不带感情的; [^]gre3k;
dispatch: [-]/dɪˈspætʃ/; [v]派遣,调遣;发送(信件,电报等);结束,摆脱掉;匆匆办完; [vt]处决; [n]派遣,调遣;发送;快信,急件;迅速,敏捷; [^]gre3k;
dispose: [-]/dɪˈspoʊz/; [v]处理,处置,除去;使愿意; [^]gre3k;
disprove: [-]/ˌdɪsˈpruːv/; [v]反驳,证明.是虚假的; [^]gre3k;
disregard: [-]/ˌdɪsrɪˈɡɑːrd/; [v]不理会;漠视; [n]忽视,漠视; [^]gre3k;
dissect: [-]/dɪˈsekt/; [v]解剖(动植物等);仔细研究;切开; [^]gre3k;
dissemble: [-]/dɪˈsembl/; [v]掩饰;假装;隐藏,掩饰; [^]gre3k;
disseminate: [-]/dɪˈsemɪneɪt/; [v]宣传,传播;散布; [^]gre3k;
dissension: [-]/dɪˈsenʃn/; [n]意见分歧;纷争;倾轧; [^]gre3k;
dissent: [-]/dɪˈsent/; [v]不同意;不信奉国教; [n]异议;(大写)不信奉国教; [^]gre3k;
dissipate: [-]/ˈdɪsɪpeɪt/; [v]消散,消失;浪费; [^]gre3k;
dissolute: [-]/ˈdɪsəluːt/; [a]无节制的;放荡的; [^]gre3k;
dissolve: [-]/dɪˈzɑːlv/; [v]使溶解;废除,使解散; [^]gre3k;
dissonance: [-]/ˈdɪsənəns/; [n]不一致;不调和;不和谐音; [^]gre3k;
dissuade: [-]/dɪˈsweɪd/; [v]劝阻,阻止; [^]gre3k;
distal: [-]/ˈdɪstl/; [a]<解剖>末梢的,末端的; [^]gre3k;
distend: [-]/dɪˈstend/; [v]膨胀;胀大;扩张; [^]gre3k;
distill: [-]/dɪˈstɪl/; [v]抽出..的精华;蒸馏; [^]gre3k;
distinctive: [-]/dɪˈstɪŋktɪv/; [a]有特色的,与众不同的; [^]gre3k;
distort: [-]/dɪˈstɔːrt/; [v]扭曲,使变形;歪曲,曲解; [^]gre3k;
distortion: [-]/dɪˈstɔːrʃn/; [n]扭曲,变形;曲解;失真; [^]gre3k;
distract: [-]/dɪˈstrækt/; [v]使分心,转移(注意力),分散(思想); [^]gre3k;
distraught: [-]/dɪˈstrɔːt/; [a]发狂的;心烦意乱的; [^]gre3k;
diurnal: [-]/daɪˈɜːrnl/; [a]白天的;每日的;日间活动的; [^]gre3k;
diverge: [-]/daɪˈvɜːrdʒ/; [v]分歧,分开; [^]gre3k;
diversity: [-]/daɪˈvɜːrsəti/; [n]多样性,差异,分集; [^]gre3k;
divert: [-]/daɪˈvɜːrt/; [v]使转向,使改道(或绕道);转移,转移.的注意力;使娱乐,使消遣; [^]gre3k;
divestiture: [-]/də'vestətʃə/; [n]剥夺,脱衣,拆分; [^]gre3k;
divulge: [-]/daɪˈvʌldʒ/; [v]泄露,透露; [^]gre3k;
doctrinaire: [-]/ˌdɑːktrəˈner/; [a]教条主义的,空谈理论的; [n]空论家,纯理论家; [^]gre3k;
dodder: [-]/ˈdɑdər/; [v]蹒跚,颤巍巍地行进; [n]<植>菟丝子; [^]gre3k;
dodge: [-]/dɑːdʒ/; [n]托词;躲闪,躲避; [v]回避,规避;躲避,避开; [^]gre3k;
doff: [-]/dɑːf/; [v]脱掉(外衣,帽子); [^]gre3k;
dogged: [-]/ˈdɔːɡɪd/; [a]顽强的;顽固的; [vt]跟踪;尾随; [^]gre3k;
dogma: [-]/ˈdɔːɡmə/; [n]教条;武断的意见; [a]教义的,教条的,信条的; [^]gre3k;
doldrums: [-]/ˈdoʊldrəmz/; [n](海洋上的)无风带,情绪低沉; [^]gre3k;
dolorous: [-]/ˈdoʊlərəs/; [a]忧伤的,悲痛的; [^]gre3k;
dolt: [-]/doʊlt/; [n]笨蛋,傻瓜; [^]gre3k;
domicile: [-]/ˈdɑːmɪsaɪl/; [n]住宅;永久居住地;期票支付场所; [v]居住;使在指定的场所支付(期票等; [a]定居;在固定住所生活; [^]gre3k;
dominant: [-]/ˈdɑːmɪnənt/; [a]主要的,占优势的,支配的,统治的;显性基因的; [^]gre3k;
don: [-]/dɑːn/; [n]指导教师,大学教师;先生,阁下; [vt]穿上; [^]gre3k;
donor: [-]/ˈdoʊnər/; [n]捐献者; [^]gre3k;
doodle: [-]/ˈduːdl/; [v](无目的地)乱画,漫无目的地打发时光; [n]涂鸦; [^]gre3k;
dormant: [-]/ˈdɔːrmənt/; [a]睡眠的,休眠的;静止的,隐伏的; [^]gre3k;
dour: [-]/dʊr/; [a]严厉的,顽强的,阴沉的,不爱讲话的; [^]gre3k;
douse: [-]/daʊs/; [v]把.浸入水中,用水泼; [^]gre3k;
downpour: [-]/ˈdaʊnpɔːr/; [n]倾盆大雨; [^]gre3k;
doze: [-]/doʊz/; [vi]瞌睡,假寐; [n]瞌睡; [^]gre3k;
drab: [-]/dræb/; [a]枯黄色的,无聊的,单调的; [n]单调;淡褐色;[印,纺]淡褐色厚呢;邋遢女人; [^]gre3k;
draconian: [-]/drəˈkoʊniən/; [a]严峻的,苛刻的; [^]gre3k;
dramatic: [-]/drəˈmætɪk/; [a]戏剧的,戏剧性的;引人注目的;逼真的,刺激的; [^]gre3k;
dread: [-]/dred/; [v]惧怕,害怕; [n]畏惧,恐惧; [a]恐怖的,使人敬畏的; [^]gre3k;
dreary: [-]/ˈdrɪri/; [a]沉闷的;乏味的;凄凉的; [^]gre3k;
drench: [-]/drentʃ/; [v]使淋透;使湿透; [n]淋透;雨淋;浸渍液;(制革时浸泡熟皮的)脱灰水; [^]gre3k;
drivel: [-]/ˈdrɪvl/; [n]胡言乱语; [v]胡言乱语,说傻话; [^]gre3k;
drizzle: [-]/ˈdrɪzl/; [v]下毛毛雨; [n]细雨,毛毛雨; [^]gre3k;
droll: [-]/droʊl/; [a]滑稽的;好笑的;逗趣的; [n]逗人发笑的人;滑稽演员;小丑; [v]开玩笑; [ad]古里古怪地,滑稽地; [^]gre3k;
drone: [-]/droʊn/; [n]无人机,无人驾驶飞机;雄蜂;单调的低音; [v]嗡嗡地响; [vi]混日子; [^]gre3k;
drudgery: [-]/ˈdrʌdʒəri/; [n]苦工;苦差事;单调乏味的工作; [^]gre3k;
dubious: [-]/ˈduːbiəs/; [a]可疑的;怀疑的;无把握的; [^]gre3k;
ductile: [-]/ˈdʌktaɪl/; [a](某些金属)有延展性的;可塑的;易受影响的; [^]gre3k;
dulcet: [-]/ˈdʌlsɪt/; [a]美妙的;悦耳的;怡人的; [^]gre3k;
dupe: [-]/duːp/; [n]受骗的人,上当者; [v]欺骗,愚弄; [^]gre3k;
duplicate: [-]/ˈduːplɪkeɪt/; [n]复制品; [v]复制;重复; [a]完全一样的; [^]gre3k;
duplicity: [-]/duːˈplɪsəti/; [n]口是心非;表里不一;不诚实; [^]gre3k;
dwindle: [-]/ˈdwɪndl/; [v]日渐减少,变小,缩小; [^]gre3k;
dynamic: [-]/daɪˈnæmɪk/; [a]有活力的,有生气的;不断变化的;动态的; [n]活力,动力; [^]gre3k;
dyspeptic: [-]/dɪsˈpeptɪk/; [n]消化不良者; [a]消化不良的;患胃病的; [^]gre3k;
earnest: [-]/ˈɜːrnɪst/; [a]真诚的,诚挚的,认真的; [n]认真,严肃; [^]gre3k;
earshot: [-]/ˈɪrʃɑːt/; [n]听力所及的范围; [^]gre3k;
earsplitting: [-]/'ɪəˌsplɪtɪŋ/; [a]震耳欲聋的; [^]gre3k;
eavesdrop: [-]/ˈiːvzdrɑːp/; [v]偷听,窃听; [n]屋檐水; [^]gre3k;
ebullient: [-]/ɪˈbʌliənt/; [a]热情洋溢的,沸腾的; [^]gre3k;
eclat: [-]/eɪ'klaː/; [n]辉煌成就,喝采; [^]gre3k;
eclectic: [-]/ɪˈklektɪk/; [a]折衷主义的;选择的; [n]折衷主义者,折衷派的人; [^]gre3k;
eclipse: [-]/ɪˈklɪps/; [n](日,月)食;黯然失色; [v]掩盖..的重要性;使暗淡; [^]gre3k;
ecstasy: [-]/ˈekstəsi/; [n]狂喜,心醉神怡; [^]gre3k;
edible: [-]/ˈedəbl/; [a]可食的; [^]gre3k;
edifice: [-]/ˈedɪfɪs/; [n]宏伟的建筑物;大厦;(知识的)体系,结构; [^]gre3k;
efface: [-]/ɪˈfeɪs/; [v]擦掉,抹去;消去; [^]gre3k;
effervesce: [-]/ˌefə'ves/; [v]冒泡,热情洋溢; [^]gre3k;
effete: [-]/ɪˈfiːt/; [a]软弱的;娘娘腔的;颓废的; [^]gre3k;
effluvium: [-]/e'fluːvɪəm/; [n]难闻的气味,没用的副产品,废品; [^]gre3k;
effrontery: [-]/ɪˈfrʌntəri/; [n]厚颜无耻; [^]gre3k;
effulgent: [-]/ɪˈfʌldʒənt/; [a]光辉的,灿烂的; [^]gre3k;
effusive: [-]/ɪˈfjuːsɪv/; [a]流出的;感情奔放的; [^]gre3k;
egoistic: [-]/ˌeɡoʊˈɪstɪk/; [a]自私自利的,自我中心的; [n]自我主义者; [^]gre3k;
elaborate: [-]/ɪˈlæbəreɪt/; [a]精心设计的,精巧的;复杂的; [v]详细说明,详尽阐述; [vt]变得复杂; [^]gre3k;
elastic: [-]/ɪˈlæstɪk/; [a]有弹性的;可伸缩的,(系统或计划)灵活的;弹力材料制成的; [n]松紧带,橡皮圈; [^]gre3k;
eleemosynary: [-]/ˌelə'mɒsənˌerɪ/; [a]施舍的,慈善的,接受接济的; [^]gre3k;
elegy: [-]/ˈelədʒi/; [n]挽歌,哀歌; [^]gre3k;
elephantine: [-]/ˌelɪˈfæntiːn/; [a]笨拙的;巨大的; [^]gre3k;
elevate: [-]/ˈelɪveɪt/; [v]上升;提高;举起;提拔; [^]gre3k;
elicit: [-]/iˈlɪsɪt/; [v]引出;诱出;探出; [^]gre3k;
elliptical: [-]/ɪˈlɪptɪkl/; [a]椭圆的;省略的; [^]gre3k;
elucidate: [-]/iˈluːsɪdeɪt/; [v]阐明,说明; [^]gre3k;
elude: [-]/iˈluːd/; [v]逃避,躲避;使.错过,使.找不到;使.不记得;把.难住; [^]gre3k;
emaciate: [-]/ɪ'meɪʃɪˌeɪt/; [v]使消瘦,使衰弱,使贫瘠; [^]gre3k;
emancipate: [-]/ɪˈmænsɪpeɪt/; [v]解放;释放; [^]gre3k;
embargo: [-]/ɪmˈbɑːrɡoʊ/; [v]禁止出入港口;禁止或限制贸易;征用或扣押; [n]禁令;禁止;封港令; [^]gre3k;
embark: [-]/ɪmˈbɑːrk/; [v]上船或飞机;开始,着手,从事; [^]gre3k;
embarrass: [-]/ɪmˈbærəs/; [vt]使窘迫,使尴尬(尤指在社交场合);困窘,困扰; [^]gre3k;
embed: [-]/ɪmˈbed/; [v]把.嵌入;使嵌入; [^]gre3k;
embezzle: [-]/ɪmˈbezl/; [v]盗用,挪用,贪污; [^]gre3k;
embolden: [-]/ɪmˈboʊldən/; [vt]鼓励,使勇敢,使有胆量; [^]gre3k;
emboss: [-]/ɪmˈbɔːs/; [v]加浮雕花纹于;使凸出;装饰; [^]gre3k;
embrace: [-]/ɪmˈbreɪs/; [v]拥抱;包含;欣然接受,乐意采纳; [n]拥抱;接受;领会; [^]gre3k;
embroider: [-]/ɪmˈbrɔɪdər/; [v]刺绣,绣花;润色,渲染; [^]gre3k;
emigrate: [-]/ˈemɪɡreɪt/; [v]移居国外(或外地); [^]gre3k;
eminent: [-]/ˈemɪnənt/; [a]显赫的;杰出的;有名的;(品质)优良的; [^]gre3k;
emollient: [-]/iˈmɑːliənt/; [n]润肤剂; [^]gre3k;
emulate: [-]/ˈemjuleɪt/; [v]努力赶上(超过),仿效; [n]仿真; [^]gre3k;
enact: [-]/ɪˈnækt/; [v]颁布;制定法律;扮演; [^]gre3k;
enamel: [-]/ɪˈnæml/; [n]搪瓷;珐琅;瓷釉;指甲油; [v]彩饰;涂以瓷釉; [^]gre3k;
enamored: [-]/ɪˈnæmə(r)d/; [a]迷恋的;倾心的; [^]gre3k;
encomium: [-]/enˈkoʊmiəm/; [n]赞美; [^]gre3k;
encompass: [-]/ɪnˈkʌmpəs/; [vt]环绕,包围;包含;完成; [^]gre3k;
encumber: [-]/ɪnˈkʌmbər/; [v]阻塞,妨害,拖累; [^]gre3k;
endeavor: [-]/ɪnˈdevər/; [n]尝试,努力,尽力; [v]努力,尽力; [^]gre3k;
endemic: [-]/enˈdemɪk/; [a]地方性的; [n]地方病; [^]gre3k;
endorse: [-]/ɪnˈdɔːrs/; [v]赞同,认可;签注(文件); [^]gre3k;
enervate: [-]/ˈenərveɪt/; [v]使虚弱;使无力; [^]gre3k;
enfranchise: [-]/ɪnˈfræntʃaɪz/; [v]给予选举权,释放(奴隶); [^]gre3k;
engender: [-]/ɪnˈdʒendər/; [v]产生; [^]gre3k;
engross: [-]/ɪnˈɡroʊs/; [v]独占;正式誊写;使全神贯注于;用大字体书写; [^]gre3k;
enigma: [-]/ɪˈnɪɡmə/; [n]谜,哑谜;闷葫芦; [^]gre3k;
enlighten: [-]/ɪnˈlaɪtn/; [v]启发,开导; [^]gre3k;
enmity: [-]/ˈenməti/; [n]敌意,憎恨; [^]gre3k;
entangle: [-]/ɪnˈtæŋɡl/; [v]使纠缠,卷入; [^]gre3k;
enthrall: [-]/ɪnˈθrɔl/; [v]迷惑,迷住; [^]gre3k;
enthusiasm: [-]/ɪnˈθuːziæzəm/; [n]热情,热心,热忱;热衷的活动,热爱的事物; [^]gre3k;
entice: [-]/ɪnˈtaɪs/; [v]怂恿,引诱; [^]gre3k;
entrance: [-]/ˈentrəns/; [n]入口,通道,大门口;出场,登场;进入权; [v]使出神,使入迷; [^]gre3k;
entrap: [-]/ɪnˈtræp/; [v]诱骗; [^]gre3k;
entreat: [-]/ɪnˈtriːt/; [v]恳求,请求; [^]gre3k;
enunciate: [-]/əˈnʌnsieɪt/; [v]发音,阐明,宣布; [^]gre3k;
ephemeral: [-]/ɪˈfemərəl/; [a]短暂的,短命的; [n]生存极短时间的事物; [^]gre3k;
epic: [-]/ˈepɪk/; [a]史诗的,叙事诗的;壮丽的,宏大的; [n]史诗;叙事诗;史诗般的作品; [^]gre3k;
epicure: [-]/ˈepɪkjʊr/; [n]美食家;享乐主义者; [^]gre3k;
epigram: [-]/ˈepɪɡræm/; [n]机智的言语; [^]gre3k;
epilogue: [-]/ˈepɪlɔːɡ/; [n]收场白;尾声; [^]gre3k;
epithet: [-]/ˈepɪθet/; [n]外号,绰号; [^]gre3k;
epitomize: [-]/ɪˈpɪtəmaɪz/; [v]摘要;化身;成为.的缩影; [^]gre3k;
equable: [-]/ˈekwəbl/; [a]温和,平均,稳定的,不变的,(脾气)温和的; [^]gre3k;
equilibrium: [-]/ˌiːkwɪˈlɪbriəm/; [n](心态情感等)平静;平衡; [^]gre3k;
equity: [-]/ˈekwəti/; [n]公平,公正;衡平法;普通股;抵押资产的净值; [^]gre3k;
equivalent: [-]/ɪˈkwɪvələnt/; [a]相等的;等值的; [n]同义词;等价物; [^]gre3k;
equivocate: [-]/ɪˈkwɪvəkeɪt/; [v]模棱两可地说,支吾其词; [^]gre3k;
erode: [-]/ɪˈroʊd/; [v]腐蚀;遭侵蚀,腐蚀,侵蚀;削弱; [vt]损害; [^]gre3k;
errant: [-]/ˈerənt/; [a]错误的,脱离正途的,迷路的;周游的,漂泊的;无定的; [n]游侠; [^]gre3k;
erratic: [-]/ɪˈrætɪk/; [a]古怪的;反复无常的,不稳定的; [^]gre3k;
erroneous: [-]/ɪˈroʊniəs/; [a]错误的; [^]gre3k;
erudite: [-]/ˈerudaɪt/; [a]博学的,有学问的; [n]饱学之士,有学问的人; [^]gre3k;
escalate: [-]/ˈeskəleɪt/; [v]逐步升高,逐步增强,加剧恶化; [^]gre3k;
eschew: [-]/ɪsˈtʃuː/; [v]避开;戒绝; [^]gre3k;
escort: [-]/ˈeskɔːrt/; [n]护送者; [v]护送; [^]gre3k;
esoteric: [-]/ˌesəˈterɪk/; [a]秘传的,神秘的,限于少数人的; [n]受秘传的人; [^]gre3k;
espouse: [-]/ɪˈspaʊz/; [v]支持,拥护; [^]gre3k;
esteem: [-]/ɪˈstiːm/; [n]尊敬;尊重; [vt]尊敬;认为;考虑;估计; [^]gre3k;
estimable: [-]/ˈestɪməbl/; [a]可估计的;可尊敬的;有价值的; [^]gre3k;
estrange: [-]/ɪ'streɪndʒ/; [v]使疏远,离间; [^]gre3k;
etch: [-]/etʃ/; [n]蚀刻; [vi]蚀刻; [vt]蚀镂,蚀刻,描述,铭记; [^]gre3k;
eternal: [-]/ɪˈtɜːrnl/; [a]永恒的,永不改变的; [^]gre3k;
ethereal: [-]/iˈθɪriəl/; [a]太空的,轻巧的,像空气的; [^]gre3k;
ethics: [-]/'eθɪks/; [n]行为准则;道德规范; [^]gre3k;
ethos: [-]/ˈiːθɑːs/; [n]民族精神,气质,社会思潮; [^]gre3k;
euphemism: [-]/ˈjuːfəmɪzəm/; [n]婉言,委婉的说法; [^]gre3k;
euphonious: [-]/juːˈfoʊniəs/; [a]悦耳的;好听的;声音和谐的; [^]gre3k;
euphoria: [-]/juːˈfɔːriə/; [n]幸福愉快感; [^]gre3k;
evacuate: [-]/ɪˈvækjueɪt/; [v]撤离,疏散,排清; [^]gre3k;
evanescent: [-]/ˌevəˈnesnt/; [a]短暂的,容易消散的,(印象等)逐渐消失的,会凋零的; [^]gre3k;
evasive: [-]/ɪˈveɪsɪv/; [a]逃避的;托辞的,推托的; [^]gre3k;
everlasting: [-]/ˌevərˈlæstɪŋ/; [a]永恒的,持久的;无止境的;耐用的; [^]gre3k;
evict: [-]/ɪˈvɪkt/; [v]驱逐,逐出; [^]gre3k;
evince: [-]/ɪˈvɪns/; [v]表明,表示,引起; [^]gre3k;
evoke: [-]/ɪˈvoʊk/; [v]唤起;引起;使人想起; [^]gre3k;
exacerbate: [-]/ɪɡˈzæsərbeɪt/; [v]加重;恶化;激怒; [^]gre3k;
exacting: [-]/ɪɡˈzæktɪŋ/; [a]苛求的,要求严格的,强索的; [^]gre3k;
exalt: [-]/ɪɡˈzɔːlt/; [v]提升,提拔,赞扬,使得意; [^]gre3k;
exasperate: [-]/ɪɡˈzæspəreɪt/; [vt]激怒;加剧; [^]gre3k;
excavate: [-]/ˈekskəveɪt/; [v]挖掘,挖出;挖(空),挖(洞); [^]gre3k;
exceptional: [-]/ɪkˈsepʃənl/; [a]优越的,杰出的;异常的; [^]gre3k;
excoriate: [-]/ˌeksˈkɔːrieɪt/; [v]严厉批评,擦伤(皮肤等); [^]gre3k;
excrete: [-]/ɪkˈskriːt/; [v]排泄,分泌; [^]gre3k;
exculpate: [-]/ˈekskʌlpeɪt/; [v]声明无罪,开脱,使无罪; [^]gre3k;
execrate: [-]/'eksɪˌkreɪt/; [v]谴责,痛恨; [^]gre3k;
exemplary: [-]/ɪɡˈzempləri/; [a]模范的,可仿效的; [^]gre3k;
exhaust: [-]/ɪɡˈzɔːst/; [v]使筋疲力尽;耗尽;详尽论述; [n]排气装置;废气; [^]gre3k;
exhilarate: [-]/ɪɡˈzɪləreɪt/; [v]使高兴;使兴奋; [a]使人高兴的,令人兴奋的; [^]gre3k;
exhort: [-]/ɪɡˈzɔːrt/; [vt]敦促,劝告; [vi]规劝,劝告; [^]gre3k;
exigent: [-]/'eksədʒənt/; [a]迫切的;紧急的;苛求的; [^]gre3k;
exodus: [-]/ˈeksədəs/; [n]大批离去,成群外出; [^]gre3k;
exonerate: [-]/ɪɡˈzɑːnəreɪt/; [v]使免罪; [^]gre3k;
exorbitant: [-]/ɪɡˈzɔːrbɪtənt/; [a]要价过高的,过分的; [^]gre3k;
exorcise: [-]/ˈeksɔːrsaɪz/; [v]驱邪;除怪; [^]gre3k;
exotic: [-]/ɪɡˈzɑːtɪk/; [a]奇异的,珍奇的,来自异国的; [^]gre3k;
expansive: [-]/ɪkˈspænsɪv/; [a]广阔的,扩张的,豪爽的; [^]gre3k;
expedite: [-]/ˈekspədaɪt/; [v]加快;促进;发出; [a]畅通的;迅速的;方便的; [^]gre3k;
expedition: [-]/ˌekspəˈdɪʃn/; [n]远征队;探险;短途旅行;迅速; [^]gre3k;
expiate: [-]/ˈekspieɪt/; [v]赎罪,补偿; [^]gre3k;
expire: [-]/ɪkˈspaɪər/; [v]期满,(期限)终止;断气,死亡; [^]gre3k;
explicate: [-]/ˈeksplɪkeɪt/; [v]详细解说; [^]gre3k;
explicit: [-]/ɪkˈsplɪsɪt/; [a]充分表达清楚的,明确的;直率的,直截了当的;〔描绘性或暴力的语言或画面〕清晰露骨的; [^]gre3k;
exploit: [-]/ɪkˈsplɔɪt/; [v]剥削,利用;开发,开拓; [n]辉煌功绩; [^]gre3k;
exponent: [-]/ɪkˈspoʊnənt/; [n]<数>指数;典型;说明者,说明物; [a]说明的; [^]gre3k;
expurgate: [-]/ˈekspərɡeɪt/; [v]净化,删去; [^]gre3k;
exquisite: [-]/ɪkˈskwɪzɪt/; [a]精致的,精选的;细腻的;强烈的; [n]过分讲究穿戴的人; [^]gre3k;
extant: [-]/ekˈstænt/; [a]现存的;显著的; [^]gre3k;
extemporize: [-]/ɪkˈstempəraɪz/; [v]即席演说; [^]gre3k;
extenuate: [-]/ɪk'stenjʊˌeɪt/; [v]减轻,低估,为.找借口,使人原谅; [^]gre3k;
exterminate: [-]/ɪkˈstɜːrmɪneɪt/; [v]消灭,灭绝;根除; [^]gre3k;
extinct: [-]/ɪkˈstɪŋkt/; [a]灭绝的;破灭了的,消亡了的; [^]gre3k;
extinguish: [-]/ɪkˈstɪŋɡwɪʃ/; [v]熄灭,扑灭;根除,消灭; [^]gre3k;
extol: [-]/ɪkˈstoʊl/; [v]赞美,称赞,颂扬; [^]gre3k;
extort: [-]/ɪkˈstɔːrt/; [vt]敲诈,勒索; [^]gre3k;
extract: [-]/ɪkˈstrækt/; [v]取出;提取;摘录;设法得到;索取; [n]摘录;提出物; [^]gre3k;
extraction: [-]/ɪkˈstrækʃn/; [n]抽出,取出;家世,出身;抽出物; [^]gre3k;
extrapolate: [-]/ɪkˈstræpəleɪt/; [v]进行推断; [^]gre3k;
extravagant: [-]/ɪkˈstrævəɡənt/; [a]奢侈的,无节制的; [^]gre3k;
extricate: [-]/ˈekstrɪkeɪt/; [v]拯救,救出; [n]解脱;解脱者; [^]gre3k;
exuberant: [-]/ɪɡˈzuːbərənt/; [a](植物)茂盛的,(人)充满活力的; [^]gre3k;
exude: [-]/ɪɡˈzuːd/; [v]慢慢流出,四溢,渗出,散发; [^]gre3k;
exult: [-]/ɪɡˈzʌlt/; [v]狂喜,欢欣鼓舞; [^]gre3k;
fable: [-]/ˈfeɪbl/; [n]寓言,童话;无稽之谈; [v]虚构,杜撰;煞有介事地讲; [^]gre3k;
fabricate: [-]/ˈfæbrɪkeɪt/; [v]建造,制造,伪造(文件等),捏造,编造(谎言,借口等); [^]gre3k;
fabulous: [-]/ˈfæbjələs/; [a]极好的;极妙的;极为巨大的;寓言中的;传说中的; [^]gre3k;
facetious: [-]/fəˈsiːʃəs/; [a]滑稽的,诙谐的,开玩笑的; [^]gre3k;
facilitate: [-]/fəˈsɪlɪteɪt/; [v]为他人提供方便;使便利; [vt]促进; [^]gre3k;
faction: [-]/ˈfækʃn/; [n]派别,小集团,小派系;派系斗争,内讧; [^]gre3k;
fad: [-]/fæd/; [n]风尚,风行一时的东西; [a]极好的; [^]gre3k;
fail-safe: [-]/ˈfeɪl seɪf/; [n]保险措施; [a]万无一失的; [^]gre3k;
fallacious: [-]/fəˈleɪʃəs/; [a]谬误的,易误解的,虚妄的; [^]gre3k;
fallible: [-]/ˈfæləbl/; [a]会犯错的,易犯错的; [^]gre3k;
fallow: [-]/ˈfæloʊ/; [a]休耕的;不活跃的;休闲地,休闲的; [n]休耕地;休耕; [v]使(翻耕后的土地)休闲; [^]gre3k;
falsehood: [-]/ˈfɔːlshʊd/; [n]谬误,不真实,谎言,虚假; [^]gre3k;
falter: [-]/ˈfɔːltər/; [v]蹒跚,摇摆;踌躇;畏缩; [n]踌躇;支吾;颤抖; [^]gre3k;
fanatic: [-]/fəˈnætɪk/; [n]狂热者,盲信者; [a]狂热的,入迷的,盲信的; [^]gre3k;
fanciful: [-]/ˈfænsɪfl/; [a]异想天开的;别出心裁的; [^]gre3k;
fantasy: [-]/ˈfæntəsi/; [n]幻想,想象;幻想作品; [vi]奏幻想曲; [vt]想像;幻想; [a]虚幻的; [^]gre3k;
farce: [-]/fɑːrs/; [n]闹剧;胡闹;笑剧; [^]gre3k;
fascinate: [-]/ˈfæsɪneɪt/; [v]使着迷;使神魂颠倒;吸引注意; [^]gre3k;
fastidious: [-]/fæˈstɪdiəs/; [a]难讨好的,爱挑剔的; [^]gre3k;
fateful: [-]/ˈfeɪtfl/; [a]重大的;决定性的;宿命的; [^]gre3k;
fathom: [-]/ˈfæðəm/; [n]英寻(=6英尺); [vi]测量深度; [vt]彻底了解,测深; [^]gre3k;
fatigue: [-]/fəˈtiːɡ/; [n]疲乏,劳累; [^]gre3k;
fatuous: [-]/ˈfætʃuəs/; [a]愚昧而不自知的; [^]gre3k;
faultfinder: [-]/fɔːlt'faɪndə/; [n]吹毛求疵的人; [^]gre3k;
favorable: [-]/ˈfeɪvərəbl/; [a]赞同的,称赞的;有利的,顺利的; [^]gre3k;
favoritism: [-]/'feɪvərɪtˌɪzəm/; [n]偏爱,偏袒; [^]gre3k;
fawn: [-]/fɔːn/; [v]奉承;生(小鹿或小动物); [n]小鹿;浅黄褐色; [^]gre3k;
faze: [-]/feɪz/; [v]打扰,折磨,使狼狈,使担忧; [^]gre3k;
featureless: [-]/ˈfiːtʃərləs/; [a]缺乏特征的,没有标记的; [^]gre3k;
feckless: [-]/ˈfekləs/; [a]不负责任的,无目标无计划的,无效的; [ad]没有价值地;没有长远目标地;不负责任地; [n]没有价值,没有长远目标,不负责任; [^]gre3k;
fecund: [-]/ˈfiːkənd/; [a]肥沃的;多产的;丰饶的;生殖力旺盛的; [^]gre3k;
feeble: [-]/ˈfiːbl/; [a]虚弱的; [^]gre3k;
feign: [-]/feɪn/; [v]假装,装作; [^]gre3k;
feisty: [-]/ˈfaɪsti/; [a]好斗的,好争论的;活跃的,充满生气的;烦躁不安的,坐立不安的; [^]gre3k;
felony: [-]/ˈfeləni/; [n]重罪; [^]gre3k;
fender: [-]/ˈfendər/; [n]火炉围栏;挡泥板,防护板;(汽车的)保险杠; [^]gre3k;
feral: [-]/ˈferəl/; [a]未驯服的,野生的;凶猛的; [^]gre3k;
ferocious: [-]/fəˈroʊʃəs/; [a]凶猛的;强烈的,严重的; [^]gre3k;
fertilize: [-]/ˈfɜːrtəlaɪz/; [v]施肥,使肥沃,使多产;使受精; [^]gre3k;
fervent: [-]/ˈfɜːrvənt/; [a]热烈的,满怀热情的;狂热的; [^]gre3k;
fervid: [-]/ˈfɜːrvɪd/; [a]热的;热心的; [^]gre3k;
fervor: [-]/ˈfɜrvər/; [n]强烈感情,激情,热情; [^]gre3k;
fester: [-]/ˈfestər/; [v]溃烂;化脓;使..痛苦;使..恶化; [n]溃烂;脓疮,脓疱; [^]gre3k;
fetid: [-]/ˈfetɪd/; [a]有恶臭的; [^]gre3k;
fetter: [-]/ˈfetər/; [n]脚镣;束缚; [vt]给.上脚镣;束缚; [^]gre3k;
fiasco: [-]/fiˈæskoʊ/; [n]大失败,惨败; [^]gre3k;
fickle: [-]/ˈfɪkl/; [a](在感情等方面)反复无常的,轻浮的,善变的; [^]gre3k;
fictitious: [-]/fɪkˈtɪʃəs/; [a]虚构的; [^]gre3k;
fidelity: [-]/fɪˈdeləti/; [n]忠诚;逼真度,保真度; [^]gre3k;
figment: [-]/ˈfɪɡmənt/; [n]空想;虚构的理论,故事等; [^]gre3k;
figurative: [-]/ˈfɪɡərətɪv/; [a]比喻的,修饰丰富的,形容多的; [^]gre3k;
figurine: [-]/ˌfɪɡjəˈriːn/; [n]小塑像,小雕像; [^]gre3k;
filibuster: [-]/ˈfɪlɪbʌstər/; [n]冗长演说; [v]拖延议事; [^]gre3k;
filter: [-]/ˈfɪltər/; [n]过滤器,滤纸; [v]过滤,渗透; [^]gre3k;
finesse: [-]/fɪˈnes/; [n]技巧,计谋,策略; [v]以技巧取胜; [^]gre3k;
finicky: [-]/ˈfɪnɪki/; [a]苛求的,过份讲究的; [^]gre3k;
fitful: [-]/ˈfɪtfl/; [a]发作的,间歇的,不定的; [^]gre3k;
flaccid: [-]/ˈflæsɪd/; [a]软弱的,无活力的,没气力的,松弛的; [^]gre3k;
flamboyant: [-]/flæmˈbɔɪənt/; [a]辉耀的;华丽的,艳丽的;火焰似的; [^]gre3k;
flatter: [-]/ˈflætər/; [v]阿谀,使高兴;(肖像等)胜过(真人真物);自鸣得意,自以为是; [^]gre3k;
flaw: [-]/flɔː/; [n]瑕疵;缺点; [v]使有缺陷;使不完美;有瑕疵; [^]gre3k;
fledgling: [-]/ˈfledʒlɪŋ/; [n]刚学飞的幼鸟,无经验的人; [a]刚开始的;无经验的; [^]gre3k;
fleet: [-]/fliːt/; [n]舰队,船队;车队; [a]迅速的; [^]gre3k;
fleeting: [-]/ˈfliːtɪŋ/; [a]短暂的,飞逝的; [^]gre3k;
flexible: [-]/ˈfleksəbl/; [a]易曲的,柔软的,灵活的; [^]gre3k;
flinch: [-]/flɪntʃ/; [v]畏缩,退缩; [n]退缩,畏惧; [^]gre3k;
flippancy: [-]/ˈflɪpənsi/; [n]轻率;无礼; [^]gre3k;
flirt: [-]/flɜːrt/; [n]急扔;调情者; [vi]卖弄风情,调情;戏弄,不认真地对待;摆动; [vt]急速摆动,挥动; [^]gre3k;
flit: [-]/flɪt/; [n]轻快的飞行;迁移; [vi]掠过;轻快地飞过;偷偷溜走;去世; [^]gre3k;
flock: [-]/flɑːk/; [n](鸟兽)群;一群人;(对牧师而言的)教徒; [v]聚集,成群而行; [^]gre3k;
florid: [-]/ˈflɔːrɪd/; [a]涨红的,华丽的,红润的; [^]gre3k;
flounder: [-]/ˈflaʊndər/; [n]比目鱼;踉跄前进; [v]踉跄前行;(在水或泥浆中)挣扎,陷入困境; [^]gre3k;
flourish: [-]/ˈflɜːrɪʃ/; [vi]繁荣,茂盛,兴旺; [vt]挥舞;夸耀; [n]兴旺;茂盛;炫耀;挥舞; [^]gre3k;
flout: [-]/flaʊt/; [n]表示轻蔑的言行;嘲弄;嘲笑; [vi]藐视;嘲弄;嘲笑; [vt]嘲弄;嘲笑;藐视; [^]gre3k;
fluctuate: [-]/ˈflʌktʃueɪt/; [v]波动;起伏;涨落; [^]gre3k;
fluent: [-]/ˈfluːənt/; [a]流畅的,(说话)流利的;顺畅的,流畅熟练的; [^]gre3k;
fluky: [-]/ˈfluːki/; [a]侥幸的,偶然的; [^]gre3k;
flush: [-]/flʌʃ/; [v]脸红;清除;赶出;冲掉; [n]发红;冲掉;脸红; [a]挥霍的,浪费的;富有的;完全齐平的; [^]gre3k;
fluster: [-]/ˈflʌstər/; [n]慌乱,狼狈,混乱; [v]使困惑,慌乱; [^]gre3k;
foible: [-]/ˈfɔɪbl/; [n]弱点,小缺点,癖好; [^]gre3k;
foil: [-]/fɔɪl/; [n]箔;锡箔纸;衬托; [v]挫败;使受挫折; [^]gre3k;
foment: [-]/foʊˈment/; [v]煽动,助长(坏事); [^]gre3k;
foolproof: [-]/ˈfuːlpruːf/; [a]万无一失的,简单的,肯定成功的; [^]gre3k;
footloose: [-]/ˈfʊtluːs/; [a]自由自在的,无拘束的,到处走动的; [^]gre3k;
forage: [-]/ˈfɔːrɪdʒ/; [v]搜寻,翻寻,觅食; [n](牛马的)饲料,粮草; [^]gre3k;
forbearance: [-]/fɔːrˈberəns/; [n]自制,忍耐;宽容; [^]gre3k;
forebear: [-]/ˈfɔːrber/; [n]祖先,祖宗; [v]忍住; [^]gre3k;
forebode: [-]/foʊr'boʊd/; [v]预示,预兆,预言; [^]gre3k;
foreground: [-]/ˈfɔːrɡraʊnd/; [n]前景,最显著的位置; [v]强调; [^]gre3k;
forestall: [-]/fɔːrˈstɔːl/; [v]领先;占先一步;先发制人,阻止,妨碍;垄断;占先一步; [^]gre3k;
foreword: [-]/ˈfɔːrwɜːrd/; [n]序,前言; [^]gre3k;
forge: [-]/fɔːrdʒ/; [n]熔炉;锻工车间;铁匠店; [v]锻造;经锻炼而形成;伪造;推进,加强; [^]gre3k;
formidable: [-]/ˈfɔːrmɪdəbl/; [a]令人畏惧的;可怕的;难以克服的;难应付的; [^]gre3k;
forsake: [-]/fərˈseɪk/; [v]放弃;抛弃,离开; [^]gre3k;
forthright: [-]/ˈfɔːrθraɪt/; [a]直接的,直率的,坦白的,豪爽的; [ad]马上,立即; [n]直路; [^]gre3k;
fortify: [-]/ˈfɔːrtɪfaɪ/; [v]设防于;增强; [^]gre3k;
foster: [-]/ˈfɔːstər/; [a]收养的; [vt]养育;培养,促进; [^]gre3k;
founder: [-]/ˈfaʊndər/; [n]奠基者;创始人; [v](船)沉没,浸水而沉没;(计划等)失败,受挫折; [^]gre3k;
fracas: [-]/ˈfreɪkəs/; [n]喧嚷,吵闹,争论,论战; [^]gre3k;
fracture: [-]/ˈfræktʃər/; [n]骨折;折断;裂口; [v]使折断;使骨折; [^]gre3k;
fragile: [-]/ˈfrædʒl/; [a]易碎的;易损坏的;虚弱的;脆弱的; [^]gre3k;
frail: [-]/freɪl/; [a]脆弱的,不坚实的; [n]少妇;灯心草篓;灯心草篓的容量; [^]gre3k;
fraudulent: [-]/ˈfrɔːdʒələnt/; [a]欺诈的,欺骗性的,骗得的; [^]gre3k;
fraught: [-]/frɔːt/; [a]担心的,忧虑的;充满.的; [n]货物,装载物; [vt]装货于; [^]gre3k;
frenzy: [-]/ˈfrenzi/; [n]狂暴;狂怒,暴怒;疯狂,迷乱; [v]使发狂,使狂怒; [^]gre3k;
frequent: [-]/ˈfriːkwənt/; [a]时常的,频繁的; [v]常去,常到; [^]gre3k;
fretful: [-]/ˈfretfl/; [a]烦躁的,焦躁的,(水面)起波纹的; [^]gre3k;
friable: [-]/ˈfraɪəbl/; [a]易碎的;脆的; [^]gre3k;
friction: [-]/ˈfrɪkʃn/; [n]摩擦,摩擦力;争执,冲突; [^]gre3k;
frigid: [-]/ˈfrɪdʒɪd/; [a]寒冷的,冷淡的,死板的,呆板的,性冷淡的; [^]gre3k;
fringe: [-]/frɪndʒ/; [n]刘海;一排;边缘;穗,流苏; [v]形成.的边缘; [^]gre3k;
frivolous: [-]/ˈfrɪvələs/; [a]轻佻的,不重要的,缺乏基础的; [^]gre3k;
frosty: [-]/ˈfrɔːsti/; [a]结霜的,严寒的;冷淡的;灰白的; [^]gre3k;
frothy: [-]/ˈfrɔːθi/; [a]起泡的,多泡的,空洞的; [^]gre3k;
frugal: [-]/ˈfruːɡl/; [a]节俭的,俭朴的;不昂贵的,廉价的,花钱少的,不充足的; [^]gre3k;
frustrate: [-]/ˈfrʌstreɪt/; [v]使灰心;挫败;阻挠; [^]gre3k;
full-bodied: [-]/ˌfʊl ˈbɑːdid/; [a]浓郁的,意味深长的;魁梧的,躯体大的; [^]gre3k;
fulminate: [-]/ˈfʊlmɪneɪt/; [v]猛烈抨击,严厉谴责;怒骂; [n]雷酸盐;烈性炸药; [^]gre3k;
fumble: [-]/ˈfʌmbl/; [v]摸索,笨拙地做,漏球; [n]摸索,笨拙的处理,漏球; [a]笨拙的;迟疑的; [^]gre3k;
furor: [-]/ˈfjʊˌrɔr/; [n]狂热;激怒;喧闹;感动; [^]gre3k;
furtive: [-]/ˈfɜːrtɪv/; [a]偷偷的,秘密的,鬼鬼祟祟的,; [^]gre3k;
fury: [-]/ˈfjʊri/; [n]狂怒,暴怒; [^]gre3k;
fussy: [-]/ˈfʌsi/; [a]爱挑剔的,难取悦的,易烦恼的; [^]gre3k;
fusty: [-]/ˈfʌsti/; [a]过时的,腐臭的;发霉的; [^]gre3k;
futile: [-]/ˈfjuːtl/; [a]无益的,无用的; [^]gre3k;
gadfly: [-]/ˈɡædflaɪ/; [n]牛虻,令人生厌的人; [^]gre3k;
gaffe: [-]/ɡæf/; [n](社交上令人不快的)失言,失态,失礼; [^]gre3k;
gainsay: [-]/ˌɡeɪnˈseɪ/; [v]否认,否定,反驳; [n]否认,反驳; [^]gre3k;
gall: [-]/ɡɔːl/; [n]粗鲁,无礼; [v]使恼怒; [^]gre3k;
gallant: [-]/ˈɡælənt/; [a]勇敢的;(男子对女子)殷勤的; [v]向(女子)献殷勤;护卫;求爱; [n](尤指对女子殷勤的)时髦男子; [^]gre3k;
galvanize: [-]/ˈɡælvənaɪz/; [v]镀锌,通电,刺激; [^]gre3k;
gamble: [-]/ˈɡæmbl/; [v]赌博;投机;打赌; [n]赌博;冒险; [vt]赌输; [^]gre3k;
gambol: [-]/ˈɡæmbl/; [n]雀跃,嬉戏; [v]欢跃,嬉戏; [^]gre3k;
gangly: [-]/ˈɡæŋɡli/; [a]身材痩长的; [^]gre3k;
garble: [-]/'gɑːbəl/; [v]使错乱,混淆;歪曲,断章取义; [^]gre3k;
gargantuan: [-]/ɡɑːrˈɡæntʃuən/; [a]巨大的,庞大的; [^]gre3k;
garish: [-]/ˈɡerɪʃ/; [a]炫耀的;过分装饰的;过分鲜艳的; [^]gre3k;
garment: [-]/ˈɡɑːrmənt/; [n]服装; [vt]给 ... 披上衣服;覆上...; [^]gre3k;
garrulous: [-]/ˈɡærələs/; [a]唠叨的,喋喋不休的;聒噪的; [^]gre3k;
gash: [-]/ɡæʃ/; [n]深长的伤口,切痕;裂缝;裂痕; [v]在..上划口;砍; [a]衣冠楚楚的;聪明伶俐的; [^]gre3k;
gauche: [-]/ɡoʊʃ/; [a]笨拙的,不会社交的,偏转的; [^]gre3k;
gaudy: [-]/ˈɡɔːdi/; [n]华丽而俗气的廉价饰物; [a](服饰,装饰,文风等)华丽而俗气的;浮华的;过分显眼的; [^]gre3k;
gauge: [-]/ɡeɪdʒ/; [n]测量仪;尺度,标准; [v]估计,判断;计量; [^]gre3k;
gawky: [-]/ˈɡɔːki/; [a](举止)笨拙的; [n]笨拙的人; [^]gre3k;
gear: [-]/ɡɪr/; [n]档位;齿轮;装备;衣物; [v]使适合; [^]gre3k;
genial: [-]/ˈdʒiːniəl/; [a]愉快的,脾气好的,友好的; [^]gre3k;
genteel: [-]/dʒenˈtiːl/; [a]有教养的,文雅的;高雅的;假斯文的,装作体面的; [^]gre3k;
germane: [-]/dʒɜːrˈmeɪn/; [a]有密切关系的;贴切的;恰当的; [^]gre3k;
germinate: [-]/ˈdʒɜːrmɪneɪt/; [v]发芽,发展,生长; [^]gre3k;
gibe: [-]/dʒaɪb/; [n]嘲弄,讥笑; [v]嘲笑; [^]gre3k;
giddy: [-]/ˈɡɪdi/; [a]眼花缭乱的,头晕的,轻率的; [v](使)眼花,(使)眩晕; [^]gre3k;
gild: [-]/ɡɪld/; [v]镀金; [n]协会,行会(同guild);同业公会;<植>依赖植物集团; [^]gre3k;
gist: [-]/dʒɪst/; [n]主旨,要点;依据; [^]gre3k;
glacial: [-]/ˈɡleɪʃl/; [a]冰的;冰冷的;冰河时代的; [^]gre3k;
gladiator: [-]/ˈɡlædieɪtər/; [n]职业格斗者;角斗士,斗剑者; [^]gre3k;
glaze: [-]/ɡleɪz/; [n](浇在糕点上的)糖浆,蛋浆,釉;<气>雨淞; [v](眼睛)变呆滞;浇浆汁于 (食物) 表面;给.安装玻璃; [^]gre3k;
glib: [-]/ɡlɪb/; [a]口齿伶俐的;油嘴滑舌的; [^]gre3k;
glide: [-]/ɡlaɪd/; [v]滑翔;滑动; [n]滑音,延音;滑行; [^]gre3k;
glisten: [-]/ˈɡlɪsn/; [v]闪烁,闪耀; [^]gre3k;
glitch: [-]/ɡlɪtʃ/; [n]小故障; [^]gre3k;
gloat: [-]/ɡloʊt/; [v]幸灾乐祸地看,窃喜; [^]gre3k;
gloomy: [-]/ˈɡluːmi/; [a]愁容满面的,阴暗的,没有希望的; [^]gre3k;
gloss: [-]/ɡlɑːs/; [n]光泽;假象;唇膏; [vt]使有光彩;掩盖; [^]gre3k;
glossy: [-]/ˈɡlɑːsi/; [a]光泽的,光滑的; [^]gre3k;
glower: [-]/ˈɡlaʊər/; [v]怒目而视; [^]gre3k;
glut: [-]/ɡlʌt/; [n]供过于求,过多; [vt]使吃饱;使充斥; [vi]过量地吃; [^]gre3k;
glutinous: [-]/ˈɡluːtənəs/; [a]粘的,胶状的; [^]gre3k;
glutton: [-]/ˈɡlʌtn/; [n]贪吃者,对..贪婪的人; [^]gre3k;
goad: [-]/ɡoʊd/; [vt]驱赶;刺激;鼓励; [n](赶牛用的)刺棒; [^]gre3k;
gobble: [-]/ˈɡɑːbl/; [v]狼吞虎咽;急急抓住,任意花完;如饥似渴地阅读;发出雄火鸡般的咯咯叫声; [n](火鸡的)咯咯声; [^]gre3k;
goggle: [-]/ˈɡɑːɡl/; [n]眼睛睁视,风镜,护目镜; [a]睁眼的,瞪眼的; [v]眼珠转动,瞪眼看,使瞪眼; [^]gre3k;
goldbrick: [-]/ˈɡoʊldbrɪk/; [n]懒汉,假金砖,赝品; [v]称病,欺诈,偷懒; [^]gre3k;
gorge: [-]/ɡɔːrdʒ/; [n]峡谷;胃;暴食;咽喉;障碍物; [v]拼命吃;吞下,狼吞虎咽;塞满,填满; [^]gre3k;
gossamer: [-]/ˈɡɑːsəmər/; [n]蛛丝,小蜘蛛网;薄纱,纤细的东西; [a]轻而薄的; [^]gre3k;
gourmand: [-]/ˈɡʊrmɑːnd/; [n]贪食者; [a]贪食的; [^]gre3k;
gourmet: [-]/ˈɡʊrmeɪ/; [n]美食家,讲究吃喝的人; [a]菜肴精美的; [^]gre3k;
graft: [-]/ɡræft/; [n]嫁接;嫁接株;移植; [vi]接枝; [vt]将.嫁接;移植(器官); [^]gre3k;
grandeur: [-]/ˈɡrændʒər/; [n]壮观,宏伟,庄严; [^]gre3k;
grandiloquent: [-]/ɡrænˈdɪləkwənt/; [a](语言等)夸张的,夸大的; [^]gre3k;
grandiose: [-]/ˈɡrændioʊs/; [a]浮夸的,夸大的,宏伟的; [^]gre3k;
grandstand: [-]/ˈɡrænstænd/; [n]正面看台;看台席上的观众;哗众取宠的表演; [a]哗众取宠的;看台上的; [v]哗众取宠;卖弄技巧; [^]gre3k;
grate: [-]/ɡreɪt/; [n]壁炉;格栅; [v]磨碎,使人烦燥; [^]gre3k;
gratify: [-]/ˈɡrætɪfaɪ/; [v]使高兴,使满足; [^]gre3k;
gratuitous: [-]/ɡrəˈtuːɪtəs/; [a]无根据的,无理由的,无报酬的,免费的,多余的; [^]gre3k;
green: [-]/ɡriːn/; [a]绿色的,青的,草绿色的;缺乏经验的;嫉妒的,眼红的;(赞成)环境保护的;生的,未熟的; [n]绿色;草地,草坪,公共绿地;绿色蔬菜,绿叶蔬菜; [v]使成为绿色,成为绿色,变绿;使..恢复活力; [^]gre3k;
gregarious: [-]/ɡrɪˈɡeriəs/; [a]群居的,爱社交的; [^]gre3k;
grieve: [-]/ɡriːv/; [v]伤心,悲痛; [vi]使悲伤,使伤心; [^]gre3k;
grimace: [-]/ˈɡrɪməs/; [v]做鬼脸,面部歪扭; [n]愁眉苦脸,怪相,鬼脸; [^]gre3k;
grin: [-]/ɡrɪn/; [v]露齿而笑,咧嘴一笑; [n]龇牙笑; [^]gre3k;
gripe: [-]/ɡraɪp/; [n]控制,发牢骚,肠绞痛; [v]抱怨,发牢骚; [^]gre3k;
grisly: [-]/ˈɡrɪzli/; [a]恐怖的;令人震惊的;厉害的; [^]gre3k;
grit: [-]/ɡrɪt/; [n]沙粒;决心,勇气; [v]研磨;在.上铺砂砾;下定决心,咬紧牙关; [^]gre3k;
groggy: [-]/ˈɡrɑːɡi/; [a]体弱的;摇摇晃晃的,踉踉跄跄的;头昏眼花的; [^]gre3k;
groove: [-]/ɡruːv/; [n]<建>凹槽;最佳状态;槽;惯例; [v]开槽于;形成沟槽; [^]gre3k;
grotesque: [-]/ɡroʊˈtesk/; [a]奇形怪状的,奇异的; [n]奇形怪状的人(或物,图案等);奇异风格; [^]gre3k;
grovel: [-]/ˈɡrɑːvl/; [v]摇尾乞怜;奴颜婢膝;匍匐; [^]gre3k;
grudge: [-]/ɡrʌdʒ/; [n]怨恨;妒嫉;恶意;忿忿不平; [v]怨恨;嫉妒;不情愿做; [^]gre3k;
grueling: [-]/'gruːəlɪŋ/; [n]惩罚,劳累; [a]累垮人的,折磨人的; [^]gre3k;
grumble: [-]/ˈɡrʌmbl/; [v]埋怨;发牢骚;咕哝; [n]隆隆响声;抱怨,怨言; [^]gre3k;
guile: [-]/ɡaɪl/; [n]狡猾,诡计,欺诈; [^]gre3k;
guilt: [-]/ɡɪlt/; [n]内疚;罪行;罪恶感; [^]gre3k;
gull: [-]/ɡʌl/; [n]鸥;笨人;易受骗之人; [v]骗;欺诈; [^]gre3k;
gullible: [-]/ˈɡʌləbl/; [a]易受骗的;轻信的; [^]gre3k;
gush: [-]/ɡʌʃ/; [v]涌出;滔滔不绝地说,洋洋洒洒地写; [n]迸发; [^]gre3k;
gust: [-]/ɡʌst/; [n]阵风,(感情的)迸发,汹涌; [v]猛吹; [^]gre3k;
guzzle: [-]/ˈɡʌzl/; [v]狂饮暴食,大吃大喝; [^]gre3k;
hack: [-]/hæk/; [n]砍,劈;出租马车;出租车; [vt]砍,乱劈;胡乱删改;<计算机>(熟练地编辑或修改)程序;非法侵入(他人计算机系统); [a]出租的;用旧了的;(文人等)被雇佣的;雇佣文人做的; [^]gre3k;
hackneyed: [-]/ˈhæknid/; [a]陈腐的,平常的; [^]gre3k;
halcyon: [-]/ˈhælsiən/; [a]平静的,愉快的,幸福的; [n]翡翠鸟;传说中的太平鸟; [^]gre3k;
hale: [-]/heɪl/; [a]矍铄的(尤指老人);强壮的; [ad]完全地; [v]迫使;猛拉;不断流出; [^]gre3k;
half-baked: [-]/ˌhæf ˈbeɪkt/; [a]不完整的;未完成的;半熟的; [^]gre3k;
halfhearted: [-]/'hɑːf'hɑːtɪd/; [a]不感兴趣的,不热情的; [^]gre3k;
hallmark: [-]/ˈhɔːlmɑːrk/; [n]特点;品质证明; [v]给.盖上品质证明印记;使具有.标志; [^]gre3k;
hallow: [-]/'hæloʊ/; [v]把.视为神圣,尊敬; [^]gre3k;
hallucination: [-]/həˌluːsɪˈneɪʃn/; [n]幻觉,幻想; [^]gre3k;
hammer: [-]/ˈhæmər/; [n]锤; [v]锤击; [^]gre3k;
hamper: [-]/ˈhæmpər/; [v]阻碍,妨碍,牵制; [n](有盖的)大篮子; [^]gre3k;
hamstring: [-]/ˈhæmstrɪŋ/; [n]腿筋; [v]切断腿筋使成跛腿;使无效; [^]gre3k;
hangdog: [-]/ˈhæŋdɔːɡ/; [a]伤心的,沮丧的;鬼鬼祟祟的; [n]卑鄙的人;卑微的人; [^]gre3k;
hanker: [-]/ˈhæŋkər/; [vi]渴望,追求; [^]gre3k;
haphazard: [-]/hæpˈhæzərd/; [a]偶然的;随意的;凑合的;胡乱的; [^]gre3k;
harangue: [-]/həˈræŋ/; [n]长篇大论; [v]高谈阔论;大声训斥; [^]gre3k;
harass: [-]/həˈræs/; [v]使困扰,使烦恼,反复袭击; [^]gre3k;
harbinger: [-]/ˈhɑːrbɪndʒər/; [n]先驱,先兆; [vt]预告;充做.的前驱; [^]gre3k;
harbor: [-]/'hɑːbə/; [n]海港;港口;避风港; [v]庇护;藏匿;心怀(怨恨等); [^]gre3k;
hard-bitten: [-]/ˌhɑːrd ˈbɪtn/; [a]顽强的;不屈服的; [^]gre3k;
hardy: [-]/ˈhɑːrdi/; [a](植物)耐寒的;能吃苦耐劳的;勇敢的; [n]强壮的人; [^]gre3k;
harmonious: [-]/hɑːrˈmoʊniəs/; [a]和谐的,协调的;和睦的;悦耳的; [^]gre3k;
harness: [-]/ˈhɑːrnɪs/; [n]挽具,马具,降落伞背带; [v]上挽具;治理(河流等);利用; [^]gre3k;
harrow: [-]/ˈhæroʊ/; [n]耙; [v]耙地,使苦恼,被耙松; [^]gre3k;
harry: [-]/ˈhæri/; [v]折磨,掠夺,骚扰; [n]恶魔,恶鬼;胡闹的青年人;伦敦佬;(人名)哈里; [^]gre3k;
harsh: [-]/hɑːrʃ/; [a]严厉的;刺耳的;条件艰苦的; [^]gre3k;
hasten: [-]/ˈheɪsn/; [v]赶快,急忙;加速;催促; [^]gre3k;
hasty: [-]/ˈheɪsti/; [a]匆忙的;仓促完成的;草率的; [^]gre3k;
haunt: [-]/hɔːnt/; [v]常去,萦绕于..;(鬼,魂)常出没于;(思想)萦绕; [n]常去的地方; [^]gre3k;
hauteur: [-]/hɔːˈtɜːr/; [n]傲慢; [^]gre3k;
haven: [-]/ˈheɪvn/; [n]港湾;避难所; [vt]为.提供庇护所; [^]gre3k;
havoc: [-]/ˈhævək/; [n](天灾,战争等造成的)大破坏,大毁灭; [vi]损毁; [vt]严重破坏; [^]gre3k;
hearten: [-]/ˈhɑːrtn/; [v]激励,鼓励,(使)振作; [^]gre3k;
heckle: [-]/ˈhekl/; [v]诘问,困扰; [n]麻梳;梳理;<印>针排; [^]gre3k;
hedonism: [-]/ˈhiːdənɪzəm/; [n]享乐主义; [^]gre3k;
hegemony: [-]/hɪˈdʒemoʊni/; [n]霸权,领导权; [^]gre3k;
heinous: [-]/ˈheɪnəs/; [a]可憎的;极凶恶的; [^]gre3k;
herald: [-]/ˈherəld/; [n]使者;预兆; [v]预告;为.欢呼; [^]gre3k;
heresy: [-]/ˈherəsi/; [n]异端邪说;异教; [^]gre3k;
heretical: [-]/həˈretɪkl/; [a]异端的,异教的; [^]gre3k;
hermetic: [-]/hɜːrˈmetɪk/; [a]密封的;与外界隔绝的;不透气的;炼金术的; [^]gre3k;
hesitance: [-]/'hezətəns/; [n]犹豫,不情愿; [^]gre3k;
hew: [-]/hjuː/; [v]砍伐;劈;遵守,坚持; [^]gre3k;
hidebound: [-]/ˈhaɪdbaʊnd/; [a]死板的,顽固的,墨守成规的; [^]gre3k;
hideous: [-]/ˈhɪdiəs/; [a]讨厌的,丑恶的; [^]gre3k;
hie: [-]/haɪ/; [v]催促,使赶紧; [^]gre3k;
hierarchical: [-]/ˌhaɪəˈrɑːrkɪkl/; [a]分等级的; [^]gre3k;
hike: [-]/haɪk/; [n]远足,徒步旅行;(数量,价格等)增加,上升; [v]作长途徒步旅行;使高涨,提高(价格); [^]gre3k;
hilarious: [-]/hɪˈleriəs/; [a]有趣的;令人捧腹的;滑稽的;欢闹的; [^]gre3k;
histrionic: [-]/ˌhɪstriˈɑːnɪk/; [a]戏剧的,装腔作势的,作戏的; [n]演员;戏剧表演;舞台艺术;戏剧似的言行; [^]gre3k;
hive: [-]/haɪv/; [n]蜂房,忙碌之地; [v]分开,隔开; [^]gre3k;
hoard: [-]/hɔːrd/; [v]贮藏,秘藏; [n]贮藏物; [^]gre3k;
hoary: [-]/ˈhɔːri/; [a]年纪高迈的;(头发等)灰白的;古老的; [^]gre3k;
hoax: [-]/hoʊks/; [n]骗局;恶作剧; [vt]愚弄;欺骗; [^]gre3k;
hobble: [-]/ˈhɑːbl/; [v]蹒跚,跛行; [n]跛行;韵律不全的诗;马的脚绊;〈口,方〉困境; [^]gre3k;
hodgepodge: [-]/ˈhɑːdʒpɑːdʒ/; [n]大杂烩,混煮,一团糟; [^]gre3k;
homage: [-]/ˈhɑːmɪdʒ/; [n]敬意;尊敬;效忠; [^]gre3k;
homely: [-]/ˈhoʊmli/; [a]不好看的,相貌平平的;朴素的;(如在家一般)舒适自在,家庭的;(女士)热情友好的,和蔼的; [^]gre3k;
homogenize: [-]/həˈmɑdʒəˌnaɪz/; [vi]变均匀; [vt]使均匀,使类同; [^]gre3k;
hone: [-]/hoʊn/; [n]细磨刀石; [v]磨刀; [^]gre3k;
hoodwink: [-]/ˈhʊdwɪŋk/; [v]欺骗,遮眼,蒙蔽; [^]gre3k;
hortative: [-]/'hɔːtətɪv/; [a]激励的; [^]gre3k;
hovel: [-]/ˈhʌvl/; [n]茅舍,肮脏的小屋; [^]gre3k;
hubris: [-]/ˈhjuːbrɪs/; [n]傲慢;狂妄自大; [^]gre3k;
humble: [-]/ˈhʌmbl/; [a]卑微的;(级别或地位)低下的,简陋的;谦逊的; [v]使⋯谦逊,使⋯卑下;轻松打败(尤指强大的对手); [^]gre3k;
humdrum: [-]/ˈhʌmdrʌm/; [a]单调的;乏味的; [n]平凡;单调; [vi]单调乏味地进行; [^]gre3k;
humiliate: [-]/hjuːˈmɪlieɪt/; [vt]使蒙耻;使丢脸;羞辱; [^]gre3k;
humility: [-]/hjuːˈmɪləti/; [n]谦逊,谦恭; [^]gre3k;
humor: [-]/ˈhjuːmər/; [n]幽默,诙谐; [^]gre3k;
hurricane: [-]/ˈhɜːrəkeɪn/; [n]飓风; [^]gre3k;
husk: [-]/hʌsk/; [n]外壳,皮;无价值之物; [v]削皮;以粗哑的嗓音说; [^]gre3k;
hybrid: [-]/ˈhaɪbrɪd/; [n]杂种,混血儿,混合物; [a]混合的;杂种的; [^]gre3k;
hymn: [-]/hɪm/; [n]赞美诗,圣歌;歌颂某事物的电影; [^]gre3k;
hyperbole: [-]/haɪˈpɜːrbəli/; [n]夸张的语句;夸张法; [^]gre3k;
hypnotic: [-]/hɪpˈnɑːtɪk/; [n]安眠药; [a]催眠的,令人着迷的; [^]gre3k;
hypocritical: [-]/ˌhɪpəˈkrɪtɪkl/; [a]虚伪的;伪善的; [^]gre3k;
hypothetical: [-]/ˌhaɪpəˈθetɪkl/; [a]假设的,假定的; [^]gre3k;
iconoclast: [-]/aɪˈkɑːnəklæst/; [n]攻击传统观念或风俗的人; [^]gre3k;
idiosyncrasy: [-]/ˌɪdiəˈsɪŋkrəsi/; [n]特殊癖性或行为; [^]gre3k;
idle: [-]/ˈaɪdl/; [a]空闲的;懒散的; [v]无所事事;虚度;空转;使空转; [vt]虚度; [^]gre3k;
idyll: [-]/ˈaɪdl/; [n]田园诗,牧歌; [^]gre3k;
ignite: [-]/ɪɡˈnaɪt/; [v]点燃,发光,燃烧; [^]gre3k;
ignominy: [-]/ˈɪɡnəmɪni/; [n]耻辱,不体面,丑行; [^]gre3k;
ill-bred: [-]/ˌɪl ˈbred/; [a]没有教养的,没有礼貌的; [^]gre3k;
illiteracy: [-]/ɪˈlɪtərəsi/; [n]文盲,无知; [^]gre3k;
illuminate: [-]/ɪˈluːmɪneɪt/; [vt]照亮;阐释;说明; [^]gre3k;
illusory: [-]/ɪˈluːsəri/; [a]错觉的,幻影的,虚假的,产生幻觉的; [^]gre3k;
illustrious: [-]/ɪˈlʌstriəs/; [a]著名的,杰出的;辉煌的; [^]gre3k;
imbibe: [-]/ɪmˈbaɪb/; [v]喝,饮;吸收,接受; [^]gre3k;
imbroglio: [-]/ɪmˈbroʊlioʊ/; [n]纠纷,纠葛; [^]gre3k;
imitation: [-]/ˌɪmɪˈteɪʃn/; [n]模仿;仿制品;赝品; [a]伪造的;仿制的; [^]gre3k;
immaculate: [-]/ɪˈmækjələt/; [a]完美的,无瑕疵的;洁净的; [^]gre3k;
immanent: [-]/ˈɪmənənt/; [a]内在的,固有的; [n]天生,固有; [^]gre3k;
immaterial: [-]/ˌɪməˈtɪriəl/; [a]非实体的,无关紧要的; [^]gre3k;
immature: [-]/ˌɪməˈtʃʊr/; [a]幼年的;未成熟的; [^]gre3k;
immemorial: [-]/ˌɪməˈmɔːriəl/; [a]太古的,极古的; [^]gre3k;
immune: [-]/ɪˈmjuːn/; [a]免疫的,有免疫力的;不受影响的;免除的; [^]gre3k;
immure: [-]/ɪˈmjʊr/; [v]监禁; [^]gre3k;
immutable: [-]/ɪˈmjuːtəbl/; [a]永远不变的,永恒的; [^]gre3k;
impassive: [-]/ɪmˈpæsɪv/; [a]无动于衷的,冷漠的; [^]gre3k;
impeccable: [-]/ɪmˈpekəbl/; [a]无瑕疵的,没有缺点的; [^]gre3k;
impecunious: [-]/ˌɪmpɪˈkjuːniəs/; [a]贫困的,一文不名的; [^]gre3k;
impede: [-]/ɪmˈpiːd/; [v]妨碍,阻碍; [^]gre3k;
impending: [-]/ɪmˈpendɪŋ/; [a]即将到来的;迫在眉睫的,紧急的; [^]gre3k;
impenetrable: [-]/ɪmˈpenɪtrəbl/; [a]难以渗透的,坚不可摧的; [^]gre3k;
impenitent: [-]/ɪmˈpenɪtənt/; [a]不悔悟的; [^]gre3k;
imperative: [-]/ɪmˈperətɪv/; [a]必要的;祈使的;急需的; [n]命令;必要的事;义务;驱使; [^]gre3k;
imperial: [-]/ɪmˈpɪriəl/; [a]帝王的,壮丽的,至尊的; [n]帝国,皇家; [^]gre3k;
imperious: [-]/ɪmˈpɪriəs/; [a]傲慢的,专横的; [^]gre3k;
imperishable: [-]/ɪmˈperɪʃəbl/; [a]不能被摧毁的,不朽的,永恒的; [^]gre3k;
impertinent: [-]/ɪmˈpɜːrtnənt/; [a]不恰当的,粗鲁的; [^]gre3k;
imperturbable: [-]/ˌɪmpərˈtɜːrbəbl/; [a]冷静的,沉着的; [^]gre3k;
impervious: [-]/ɪmˈpɜːrviəs/; [a]不能渗透的,不为所动的; [^]gre3k;
impetuous: [-]/ɪmˈpetʃuəs/; [a]冲动的,鲁莽的; [^]gre3k;
impious: [-]/ɪmˈpaɪəs/; [a]不敬神的,不虔诚的,不孝的; [^]gre3k;
implacable: [-]/ɪmˈplækəbl/; [a]难以满足的,难平息的; [^]gre3k;
implement: [-]/ˈɪmplɪment/; [n]工具;器具; [v]实施,执行;执行; [^]gre3k;
implicit: [-]/ɪmˈplɪsɪt/; [a]隐含的;盲目的;完全的,绝对的;成为一部分的; [^]gre3k;
implode: [-]/ɪmˈploʊd/; [vi]内向爆炸,内向崩溃; [vt]使爆裂; [^]gre3k;
importune: [-]/ˌɪmpɔːrˈtuːn/; [v]强求,胡搅蛮缠; [a]同"importunate"; [^]gre3k;
imposing: [-]/ɪmˈpoʊzɪŋ/; [a]壮观的,壮丽的; [^]gre3k;
impostor: [-]/ɪmˈpɑːstər/; [n]骗子;冒充者; [^]gre3k;
impotent: [-]/ˈɪmpətənt/; [a]无力的,无能的,阳痿的; [n]虚弱者;阳痿者; [^]gre3k;
imprecise: [-]/ˌɪmprɪˈsaɪs/; [a]不精确的,不严密的; [^]gre3k;
impromptu: [-]/ɪmˈprɑːmptuː/; [a]一触即发的;即席的,即兴的; [ad]即席地,即兴地; [n]即兴之作; [^]gre3k;
improvise: [-]/ˈɪmprəvaɪz/; [v]即席创作,临时凑成; [^]gre3k;
imprudent: [-]/ɪmˈpruːdnt/; [a]轻率的,鲁莽的; [^]gre3k;
impudent: [-]/ˈɪmpjədənt/; [a]鲁莽的,冒失的,无礼的; [^]gre3k;
impugn: [-]/ɪmˈpjuːn/; [v]指责,对.表示怀疑; [^]gre3k;
impunity: [-]/ɪmˈpjuːnəti/; [n]不受惩罚;无患; [^]gre3k;
inadvertent: [-]/ˌɪnədˈvɜːrtənt/; [a]疏忽的,漫不经心的,无意中的; [^]gre3k;
inalienable: [-]/ɪnˈeɪliənəbl/; [a]不可分割的; [^]gre3k;
inane: [-]/ɪˈneɪn/; [a]无意义的,空洞的;愚蠢的; [^]gre3k;
inanimate: [-]/ɪnˈænɪmət/; [a]无生命的;无生气的; [^]gre3k;
inaugurate: [-]/ɪˈnɔːɡjəreɪt/; [v]为..揭幕;为.举行就职典礼;开展; [^]gre3k;
incandescent: [-]/ˌɪnkænˈdesnt/; [a]白热的,热烈的; [^]gre3k;
incantation: [-]/ˌɪnkænˈteɪʃn/; [n]咒语; [^]gre3k;
incarnate: [-]/ɪnˈkɑːrnət/; [a]化身的,人体化的,肉色的; [v]体现,使.具体化,使实体化; [^]gre3k;
incendiary: [-]/ɪnˈsendieri/; [n]放火者,纵火者,燃烧弹,煽动者; [a]放火的,纵火的,能燃烧的,煽动性的; [^]gre3k;
incense: [-]/ˈɪnsens/; [n]焚香时的烟,香味; [v]激怒; [^]gre3k;
incentive: [-]/ɪnˈsentɪv/; [n]刺激,激励;鼓励; [^]gre3k;
inception: [-]/ɪnˈsepʃn/; [n]起初;获得学位; [^]gre3k;
incessant: [-]/ɪnˈsesnt/; [a]无间断的,连续的; [^]gre3k;
inchoate: [-]/ɪnˈkoʊət/; [a]早期的;刚开始的;未充分发展的; [^]gre3k;
incinerate: [-]/ɪnˈsɪnəreɪt/; [v]焚化,毁弃; [^]gre3k;
incipient: [-]/ɪnˈsɪpiənt/; [a]初期的;刚出现的; [^]gre3k;
incite: [-]/ɪnˈsaɪt/; [v]刺激;煽动; [^]gre3k;
inclement: [-]/ɪnˈklemənt/; [a]险恶的;气候严酷的;狂风暴雨的; [^]gre3k;
inconsequential: [-]/ɪnˌkɑːnsɪˈkwenʃl/; [a]不重要的,不合理的,不合逻辑的; [^]gre3k;
incontrovertible: [-]/ˌɪnkɑːntrəˈvɜːrtəbl/; [a]无可争议的; [^]gre3k;
incorrigible: [-]/ɪnˈkɔːrɪdʒəbl/; [a]积习难改的,不可救药的; [^]gre3k;
incriminate: [-]/ɪnˈkrɪmɪneɪt/; [v]控告,暗示..有罪; [^]gre3k;
incubate: [-]/ˈɪŋkjubeɪt/; [v]孵卵; [^]gre3k;
inculpate: [-]/'ɪnkʌlˌpeɪt/; [v]连累;使负罪;控告; [^]gre3k;
incumbent: [-]/ɪnˈkʌmbənt/; [n]在职者,现任者; [a]现任的;依靠的;负有职责的; [^]gre3k;
incursion: [-]/ɪnˈkɜːrʒn/; [n]入侵,侵犯; [^]gre3k;
indecorous: [-]/ɪnˈdekərəs/; [a]不合乎礼节的,不得体的; [^]gre3k;
indelible: [-]/ɪnˈdeləbl/; [a](印记等)无法擦除的,无法忘怀的; [^]gre3k;
indemnity: [-]/ɪnˈdemnəti/; [n]赔偿物;补偿,赔偿;保障; [^]gre3k;
indict: [-]/ɪnˈdaɪt/; [v]控诉,起诉; [^]gre3k;
indifferent: [-]/ɪnˈdɪfrənt/; [a]不感兴趣的,不关心的;平庸的;冷漠的; [^]gre3k;
indigenous: [-]/ɪnˈdɪdʒənəs/; [a]土生土长的,本土的; [^]gre3k;
indigent: [-]/ˈɪndɪdʒənt/; [a]贫困的,贫穷的; [^]gre3k;
indispensable: [-]/ˌɪndɪˈspensəbl/; [a]必不可少的;必需的; [^]gre3k;
indoctrinate: [-]/ɪnˈdɑːktrɪneɪt/; [v]灌输思想; [^]gre3k;
indolent: [-]/ˈɪndələnt/; [a]懒惰的,懒洋洋的; [^]gre3k;
inducement: [-]/ɪnˈduːsmənt/; [n]诱因;刺激物;犯罪动因; [^]gre3k;
indulgent: [-]/ɪnˈdʌldʒənt/; [a]放纵的;宽容的;任性的; [^]gre3k;
indurate: [-]/'ɪndjʊˌreɪt/; [v]变坚固,使冷酷; [a]冷酷的,硬化的; [^]gre3k;
industrious: [-]/ɪnˈdʌstriəs/; [a]勤劳的,勤奋的; [^]gre3k;
ineffable: [-]/ɪnˈefəbl/; [a]不可言喻的,不应说出的,难以形容的; [^]gre3k;
ineluctable: [-]/ˌɪnɪˈlʌktəbl/; [a]不可改变的,无法逃避的; [^]gre3k;
inept: [-]/ɪˈnept/; [a]无能的;不称职的;笨拙的; [^]gre3k;
inert: [-]/ɪˈnɜːrt/; [a]不动的,惰性的;行动迟钝的;无生气的; [^]gre3k;
inevitable: [-]/ɪnˈevɪtəbl/; [a]不可避免的,必然的; [n]必然发生的事; [^]gre3k;
inexorable: [-]/ɪnˈeksərəbl/; [a]不为所动的,坚决不变的; [n]坚定不移的人; [^]gre3k;
infamous: [-]/ˈɪnfəməs/; [a]声名狼藉的,无耻的; [^]gre3k;
infatuate: [-]/ɪn'fætʃʊˌeɪt/; [v]使迷恋;使糊涂,使冲昏头脑; [a]着迷的; [^]gre3k;
infelicitous: [-]/ˌɪnfə'lɪsətəs/; [a]不妥当的,不得体的,不吉利的; [^]gre3k;
inferno: [-]/ɪnˈfɜːrnoʊ/; [n]火海,地狱般的场所; [^]gre3k;
infiltrate: [-]/ˈɪnfɪltreɪt/; [v]渗入,潜入 (某地方或组织);(气,液)渗透; [n]渗透物; [^]gre3k;
infinite: [-]/ˈɪnfɪnət/; [a]无限的,无穷的;无数的; [n]无穷,无限大; [^]gre3k;
infirm: [-]/ɪnˈfɜːrm/; [a]衰弱的;意志薄弱的;不坚固的; [^]gre3k;
inflame: [-]/ɪnˈfleɪm/; [v]使燃烧,激怒(某人); [^]gre3k;
influx: [-]/ˈɪnflʌks/; [n]流入,涌入;河口; [^]gre3k;
infraction: [-]/ɪnˈfrækʃn/; [n]违法; [^]gre3k;
infuriate: [-]/ɪnˈfjʊrieɪt/; [v]使(人)极为愤怒; [^]gre3k;
infuse: [-]/ɪnˈfjuːz/; [v]沏(茶),泡(草药);灌输;使充满; [^]gre3k;
ingenious: [-]/ɪnˈdʒiːniəs/; [a]聪明的;有发明天才的;有独创性的,别出心裁的; [^]gre3k;
ingenuity: [-]/ˌɪndʒəˈnuːəti/; [n]机灵,心灵手巧,富于创造天赋; [^]gre3k;
ingest: [-]/ɪnˈdʒest/; [v]咽下;摄取;吸收;接待; [^]gre3k;
ingratiating: [-]/ɪnˈɡreɪʃieɪtɪŋ/; [a]讨好的,谄媚的; [^]gre3k;
inherent: [-]/ɪnˈhɪrənt/; [a]内在的,固有的;生来就有的; [^]gre3k;
inimical: [-]/ɪˈnɪmɪkl/; [a]敌意的,有害的; [^]gre3k;
inimitable: [-]/ɪˈnɪmɪtəbl/; [a]独特的,无比的,无法仿效的; [^]gre3k;
iniquity: [-]/ɪˈnɪkwəti/; [n]邪恶,不公正; [^]gre3k;
initiate: [-]/ɪˈnɪʃieɪt/; [v]开始,发动; [n]新加入组织的人; [^]gre3k;
inkling: [-]/ˈɪŋklɪŋ/; [n]轻微暗示,小提示,略知; [^]gre3k;
innocuous: [-]/ɪˈnɑːkjuəs/; [a]无伤大雅的;无害的; [^]gre3k;
innovative: [-]/ˈɪnəveɪtɪv/; [a]创新的,革新的; [^]gre3k;
inquisitive: [-]/ɪnˈkwɪzətɪv/; [a]好奇的,好打听的; [^]gre3k;
insensible: [-]/ɪnˈsensəbl/; [a]昏迷的,无知觉的,麻木不仁的; [^]gre3k;
insensitive: [-]/ɪnˈsensətɪv/; [a]感觉迟钝的,对.没有感觉的; [^]gre3k;
insight: [-]/ˈɪnsaɪt/; [n]深刻的理解,洞察力,见识; [^]gre3k;
insipid: [-]/ɪnˈsɪpɪd/; [a]淡而无味的;枯燥乏味的; [^]gre3k;
insolent: [-]/ˈɪnsələnt/; [a]傲慢的,粗鲁的,无礼的; [^]gre3k;
instigate: [-]/ˈɪnstɪɡeɪt/; [v]发起,煽动; [^]gre3k;
institute: [-]/ˈɪnstɪtuːt/; [n]学会;学院,专科学院,研究院; [vt]建立,设立,制定; [^]gre3k;
insubordinate: [-]/ˌɪnsəˈbɔːrdɪnət/; [a]不服从的,反抗的; [^]gre3k;
insular: [-]/ˈɪnsələr/; [a]岛屿的,与世隔绝的; [^]gre3k;
insulate: [-]/ˈɪnsəleɪt/; [v]隔离,使隔绝(以免受到影响);使隔热; [^]gre3k;
insurgent: [-]/ɪnˈsɜːrdʒənt/; [n]叛乱分子; [a]叛乱的,起事的; [^]gre3k;
intangible: [-]/ɪnˈtændʒəbl/; [a]不可捉摸的,无形的; [n]无形的东西; [^]gre3k;
integral: [-]/ˈɪntɪɡrəl/; [a](用于构成整体)必需的,不可缺少的,必不可少的;基本的,作为组成部分的,内置的;整体的,完整的; [^]gre3k;
integrity: [-]/ɪnˈteɡrəti/; [n]正直,真诚;完整; [^]gre3k;
intelligible: [-]/ɪnˈtelɪdʒəbl/; [a]可理解的,明白易懂的; [^]gre3k;
intemperate: [-]/ɪnˈtempərət/; [a]放纵的;酗酒的;酷烈的; [^]gre3k;
intensify: [-]/ɪnˈtensɪfaɪ/; [v]增强;加剧; [^]gre3k;
inter: [-]/ɪnˈtɜːr/; [v]埋葬; prep. 在内; [^]gre3k;
interdict: [-]/ˈɪntərdɪkt/; [n]禁令;禁止,制止; [v]禁止,制止;闭锁,阻断(敌人通路);<宗教>停止教权; [^]gre3k;
interim: [-]/ˈɪntərɪm/; [n]中间时期,过渡时期; [a]暂时的; [^]gre3k;
interlock: [-]/ˌɪntərˈlɑːk/; [v]连锁,连串; [n]〔电信〕结合;联锁装置;相关;联动; [^]gre3k;
interminable: [-]/ɪnˈtɜːrmɪnəbl/; [a]没完没了的,无穷无尽的,冗长的; [^]gre3k;
intermittent: [-]/ˌɪntərˈmɪtənt/; [a]断断续续的,间歇的; [^]gre3k;
interrogate: [-]/ɪnˈterəɡeɪt/; [v]审问,审讯; [^]gre3k;
intimate: [-]/ˈɪntɪmət/; [a]亲密的,密切的;详细的; [v]暗示;宣布,通知; [n]密友,知己; [^]gre3k;
intimidate: [-]/ɪnˈtɪmɪdeɪt/; [v]恫吓,威胁; [^]gre3k;
intoxicant: [-]/ɪnˈtɑːksɪkənt/; [a]醉人的,麻醉的,沉醉的; [n]酒精饮料,麻醉品; [^]gre3k;
intransigent: [-]/ɪnˈtrænzɪdʒənt/; [a]固执的,不妥协的,不让步的; [n]不妥协,不妥协的人; [^]gre3k;
intrepid: [-]/ɪnˈtrepɪd/; [a]无畏的;刚毅的,勇敢的; [^]gre3k;
intrigue: [-]/ɪnˈtriːɡ/; [n]阴谋;诡计; [v]密谋;欺骗;引起极大兴趣; [^]gre3k;
intrinsic: [-]/ɪnˈtrɪnsɪk/; [a]固有的; [^]gre3k;
intuitive: [-]/ɪnˈtuːɪtɪv/; [a]直觉的,凭直觉获知的; [^]gre3k;
inundate: [-]/ˈɪnʌndeɪt/; [v]淹没,泛滥; [^]gre3k;
inure: [-]/ɪˈnjʊr/; [v]使.习惯,使.适应,起作用,有助于; [^]gre3k;
invective: [-]/ɪnˈvektɪv/; [n]猛烈抨击,恶言漫骂; [a]谩骂的;恶言的;诽谤的; [^]gre3k;
inveigh: [-]/ɪnˈveɪ/; [v]激烈抗议,表示强烈不满;痛骂; [^]gre3k;
inveigle: [-]/ɪnˈveɪɡl/; [v]诱骗,诱使,诱惑; [^]gre3k;
inventory: [-]/ˈɪnvəntɔːri/; [n]详细目录;存货清单; [^]gre3k;
inveterate: [-]/ɪnˈvetərət/; [a]积习已深的,根深蒂固的,长期形成的; [^]gre3k;
invidious: [-]/ɪnˈvɪdiəs/; [a]惹人反感的,招人嫉妒的,令人厌恶的,诽谤的,不公平的; [^]gre3k;
invigorate: [-]/ɪnˈvɪɡəreɪt/; [v]鼓舞;提神,使精力充沛; [a]生气勃勃的,精力充沛的,健壮的; [n]滋补;鼓舞; [^]gre3k;
invincible: [-]/ɪnˈvɪnsəbl/; [a]无敌的;不能征服的; [^]gre3k;
invoke: [-]/ɪnˈvoʊk/; [v]调用,祈求,恳求,引起; [^]gre3k;
irascible: [-]/ɪˈræsəbl/; [a]易怒的,性情暴躁的; [^]gre3k;
irate: [-]/aɪˈreɪt/; [a]发怒的,愤怒的; [^]gre3k;
iridescent: [-]/ˌɪrɪˈdesnt/; [a]彩虹色的;闪光的,闪色的; [^]gre3k;
irk: [-]/ɜːrk/; [v]使苦恼,使厌烦; [n]厌烦,厌倦; [^]gre3k;
ironclad: [-]/ˈaɪərnklæd/; [a]坚固的,装铁甲的;无可推诿的; [n]装甲舰; [^]gre3k;
irrigate: [-]/ˈɪrɪɡeɪt/; [v]灌溉,冲洗; [^]gre3k;
irritate: [-]/ˈɪrɪteɪt/; [v]使烦躁;激怒;使难受; [^]gre3k;
issue: [-]/ˈɪʃuː/; [n]问题;议题;发行物;子女; [v]发行;发布;分配,分发,给; [^]gre3k;
jabber: [-]/ˈdʒæbər/; [v]急急忙忙地说,急促不清地说; [n]急促不清地话,无意义的话; [^]gre3k;
jaded: [-]/ˈdʒeɪdɪd/; [a]疲倦的,精疲力竭的;厌倦的; [^]gre3k;
jape: [-]/dʒeɪp/; [n]嘲弄;玩笑; [vi]开玩笑; [vt]嘲弄; [^]gre3k;
jargon: [-]/ˈdʒɑːrɡən/; [n]行话,术语;黄锆石; [^]gre3k;
jarring: [-]/ˈdʒɑːrɪŋ/; [a]剌耳的,震惊的; [n]辗轧声,冲突,震动; [v]受震动而疼痛; [^]gre3k;
jaunty: [-]/ˈdʒɔːnti/; [a]愉快的,满足的;斯文的;时髦的; [ad]心满意足地,洋洋得意地; [n]心满意足;洋洋得意; [^]gre3k;
jejune: [-]/dʒɪˈdʒuːn/; [a]空洞的,枯燥无味的;不成熟的;缺乏营养的; [^]gre3k;
jeopardy: [-]/ˈdʒepərdi/; [n]危险;(被告处于被判罪或受处罚的)危险境地; [^]gre3k;
jest: [-]/dʒest/; [n]笑话,俏皮话;玩笑; [v]开玩笑;嘲笑; [^]gre3k;
jettison: [-]/ˈdʒetɪsn/; [v]向外抛弃,投弃(船舶遇难时投弃货物以为减轻负载); [n]抛弃的货物; [^]gre3k;
jibe: [-]/dʒaɪb/; [v]与.一致,嘲笑,调转方向,改变航道; [n]嘲笑,嘲弄; [^]gre3k;
jingoist: [-]/dʒɪŋɡə'ʊɪst/; [n]沙文主义者,侵略主义者; [^]gre3k;
jitters: [-]/ˈdʒɪtərz/; [n]紧张,激动; [v]紧张不安;使激动;抖动(jitter的三单形式);神经过敏地说; [^]gre3k;
jocular: [-]/ˈdʒɑːkjələr/; [a]搞笑的,欢乐的; [^]gre3k;
jocund: [-]/ˈdʒɑːkənd/; [a]快活的;高兴的; [^]gre3k;
jog: [-]/dʒɑːɡ/; [v]慢跑;轻碰; [n]轻推,慢跑,漫步; [^]gre3k;
jolt: [-]/dʒoʊlt/; [n]猛的一击,摇晃,震惊; [v](使)颠簸,摇晃;使震惊; [^]gre3k;
jot: [-]/dʒɑːt/; [n]最少量,微不足道的量; [vt]草草记下;匆匆记下; [^]gre3k;
jovial: [-]/ˈdʒoʊviəl/; [a]天性快活的,主神朱庇特的; [n]左威尔牌手表; [^]gre3k;
jubilant: [-]/ˈdʒuːbɪlənt/; [a]喜悦的,欢呼的; [^]gre3k;
judicious: [-]/dʒuˈdɪʃəs/; [a]有判断力的;明智的; [^]gre3k;
juggernaut: [-]/ˈdʒʌɡərnɔːt/; [n]摧毁一切的强大力量,不可抗拒的力量;大型重卡车; [^]gre3k;
kidnap: [-]/ˈkɪdnæp/; [v]诱拐;绑架; [^]gre3k;
kindle: [-]/ˈkɪndl/; [v]点燃,激起;着火;照亮;煽动; [^]gre3k;
kindred: [-]/ˈkɪndrəd/; [n]亲戚,家族,亲属关系,相似; [a]有血缘关系的,同宗的,同源的,类似的; [^]gre3k;
knack: [-]/næk/; [n]诀窍;本领;熟练技术;巧妙手法; [^]gre3k;
knead: [-]/niːd/; [v]揉捏,塑造; [^]gre3k;
knit: [-]/nɪt/; [v]编结,针织; [n]编织的衣服;针织衫; [^]gre3k;
knotty: [-]/ˈnɑːti/; [a]有节疤的,有结的;棘手的; [^]gre3k;
kudos: [-]/ˈkuːdəʊs/; [n]荣誉;名望;称赞; [^]gre3k;
labile: [-]/'leɪbəl/; [a]易变化的,不稳定的,不安定; [n]心境不定; [^]gre3k;
laborious: [-]/ləˈbɔːriəs/; [a]费时费力的,辛苦的;艰苦的; [^]gre3k;
lacerate: [-]/ˈlæsəreɪt/; [v]划破,撕裂;伤害;使..痛心; [a]撕碎的;精神深受创伤的;受折磨的; [^]gre3k;
lachrymose: [-]/ˈlækrɪmoʊs/; [a]落泪的,好哭的;催泪的;悲哀的; [^]gre3k;
lackluster: [-]/ˈlækˌlʌstər/; [n]无光泽;暗淡; [a]无光泽的;平凡的; [^]gre3k;
laconic: [-]/ləˈkɑːnɪk/; [a](用词)简洁的;简明的; [ad]简短地,简洁地; [^]gre3k;
lag: [-]/læɡ/; [n]落后,延迟; [v]落后;缓慢进行,减退; [^]gre3k;
lambaste: [-]/læmˈbæst/; [v]痛打;痛骂;严责; [^]gre3k;
lament: [-]/ləˈment/; [v]哀悼;惋惜;悲叹; [n]悲叹;悼词; [^]gre3k;
lamentable: [-]/ˈlæməntəbl/; [a]可悲的,可怜的,哀伤的; [^]gre3k;
lampoon: [-]/læmˈpuːn/; [n]讽刺文章; [v]讽刺,写文章讽刺; [^]gre3k;
lance: [-]/læns/; [n]长矛; [v]以长矛攻击; [^]gre3k;
languid: [-]/ˈlæŋɡwɪd/; [a]没精打采的,倦怠的; [^]gre3k;
languish: [-]/ˈlæŋɡwɪʃ/; [v]凋萎,衰弱,变得消瘦; [^]gre3k;
languor: [-]/ˈlæŋɡər/; [n]身心疲惫;柔情;呆滞; [^]gre3k;
lank: [-]/læŋk/; [a]瘦削的;稀疏的;平直的;细长的; [^]gre3k;
lapse: [-]/læps/; [n]失误,过失;行为失检;(时间)流逝; [v]退步,倒退,衰退;失效;背弃,放弃(宗教信仰); [^]gre3k;
largesse: [-]/lɑːrˈdʒes/; [n]慷慨援助,施舍; [^]gre3k;
lash: [-]/læʃ/; [v]鞭打;猛烈抨击;捆绑;摆动;猛击; [n]鞭梢;鞭打; [^]gre3k;
lassitude: [-]/ˈlæsɪtuːd/; [n]困乏,厌倦,无精打采; [^]gre3k;
latent: [-]/ˈleɪtnt/; [a]潜在的,隐伏的,不易察觉的; [^]gre3k;
latitude: [-]/ˈlætɪtuːd/; [n]纬度;地区;(言论,行动的)自由; [^]gre3k;
laudatory: [-]/ˈlɔːdətɔːri/; [a]表扬的,赞扬的; [^]gre3k;
lavish: [-]/ˈlævɪʃ/; [a]奢华的;铺张浪费的; [v]浪费;慷慨给予; [^]gre3k;
lax: [-]/læks/; [a]松懈的;松弛的;<语>松弛元音的; [n]松元音;泻肚; [^]gre3k;
leaven: [-]/ˈlevn/; [n]发酵剂,影响力; [v]发酵,影响,渐变; [^]gre3k;
leer: [-]/lɪr/; [v]斜眼看,睨视;抛媚眼; [n]媚眼;恶意的瞥视; [^]gre3k;
leery: [-]/ˈlɪri/; [a]机警的,狡猾的; [^]gre3k;
legacy: [-]/ˈleɡəsi/; [n]遗赠(物);遗产; [^]gre3k;
legend: [-]/ˈledʒənd/; [n]传说,传奇人物;(奖章纪念牌等的)铭文;地图的图例,插图的说明; [^]gre3k;
legion: [-]/ˈliːdʒən/; [n](古罗马)军团,众多,军队; [a]众多的,大量的; [^]gre3k;
lenient: [-]/ˈliːniənt/; [a]宽大的,宽容的,仁慈的; [^]gre3k;
lethal: [-]/ˈliːθl/; [a]致命的,致死的;杀伤性的; [n]致死因子; [^]gre3k;
lethargic: [-]/ləˈθɑːrdʒɪk/; [a]困倦的,无力的,无兴趣的; [^]gre3k;
levelheaded: [-]/'levəl'hedɪd/; [a]稳健的,头脑冷静的,明智的; [^]gre3k;
levity: [-]/ˈlevəti/; [n]轻率,轻浮,多变,不稳定; [^]gre3k;
liability: [-]/ˌlaɪəˈbɪləti/; [n]责任;债务;倾向;可能性;不利因素;惹麻烦的人(或事); [^]gre3k;
liberal: [-]/ˈlɪbərəl/; [n]开明的人,自由主义者; [a]慷慨的;心胸宽阔的;自由主义的; [^]gre3k;
libertine: [-]/ˈlɪbərtiːn/; [n]性行为放纵者,浪荡子;自由思想家; [a]放荡的; [^]gre3k;
license: [-]/ˈlaɪsns/; [n]许可;执照; [v]许可,准许;发许可证; [^]gre3k;
licentious: [-]/laɪˈsenʃəs/; [a]纵欲的,放肆的; [^]gre3k;
liken: [-]/ˈlaɪkən/; [v]把..比作,比拟; [^]gre3k;
limber: [-]/ˈlɪmbər/; [a]松软的,柔软的;可塑的; [n](炮车的)拖车; [^]gre3k;
limp: [-]/lɪmp/; [n]跛行; [vi]一瘸一拐地走,跛行;慢腾腾地进行; [a]无力的,无生气的;柔软的,软弱的; [^]gre3k;
limpid: [-]/ˈlɪmpɪd/; [a]清澈的,透明的,平静的; [^]gre3k;
linger: [-]/ˈlɪŋɡər/; [v]逗留,留恋; [^]gre3k;
lionize: [-]/ˈlaɪənaɪz/; [v]崇拜,把..奉为名人; [^]gre3k;
lissome: [-]/'lɪsəm/; [a]柔软的,敏捷的,轻盈的; [^]gre3k;
lithe: [-]/laɪð/; [a]轻盈的(等于lithesome);柔软的;易弯曲的; [^]gre3k;
loath: [-]/loʊθ/; [a]不愿意的; [^]gre3k;
loathe: [-]/loʊð/; [v]憎恨,厌恶; [^]gre3k;
lofty: [-]/ˈlɔːfti/; [a]极高的,巍峨的;崇高的;高傲的; [^]gre3k;
loll: [-]/lɑːl/; [vi]懒洋洋地倚靠;闲荡; [vt]懒洋洋地倚靠着;使悬垂; [^]gre3k;
lopsided: [-]/ˌlɑːpˈsaɪdɪd/; [a]不平衡的,倾向一方的; [^]gre3k;
loquacious: [-]/ləˈkweɪʃəs/; [a]多话的;饶舌的;冗长的;(水)潺潺不息的; [^]gre3k;
loutish: [-]/ˈlaʊtɪʃ/; [a]粗野的,笨拙的,无礼的; [^]gre3k;
lubricate: [-]/ˈluːbrɪkeɪt/; [v]使.润滑;给.加润滑油; [^]gre3k;
lucid: [-]/ˈluːsɪd/; [a]明晰的;透明的;易懂的;头脑清楚的; [^]gre3k;
ludicrous: [-]/ˈluːdɪkrəs/; [a]荒谬的,可笑的,滑稽的; [^]gre3k;
lug: [-]/lʌɡ/; [n]耳状物;把手;笨家伙; [v]拖拉; [^]gre3k;
lugubrious: [-]/ləˈɡuːbriəs/; [a]闷闷不乐的;郁郁寡欢的,悲哀的; [^]gre3k;
lull: [-]/lʌl/; [v]使平静,使安静,哄骗; [n]间歇,暂停,暂时平静; [^]gre3k;
lullaby: [-]/ˈlʌləbaɪ/; [n]催眠曲,摇篮曲,轻柔的声音; [v]唱催眠曲使入睡; [^]gre3k;
lumber: [-]/ˈlʌmbər/; [v]缓慢地移动;拖累,迫使担负;伐木;杂乱地堆积;隆隆地行进; [n]木材;废旧家具,不用的大件物品;无用的杂物;隆隆声; [^]gre3k;
luminary: [-]/ˈluːmɪneri/; [n]杰出人物,发光体; [^]gre3k;
luminous: [-]/ˈluːmɪnəs/; [a]发光的;鲜艳的;明亮的;夜光的; [^]gre3k;
lurch: [-]/lɜːrtʃ/; [n]突然倾斜,挫折,举步蹒跚,徘徊,困境; [v]惨败,倾斜,徘徊,击败; [^]gre3k;
lurid: [-]/ˈlʊrɪd/; [a](暴力,性爱等)耸人听闻的; [^]gre3k;
lurk: [-]/lɜːrk/; [n]潜伏,潜行; [vi]潜伏;潜藏;鬼鬼祟祟地走; [^]gre3k;
lush: [-]/lʌʃ/; [a]草木茂盛的,多的,丰富豪华的; [n]酒;醉汉; [^]gre3k;
lustrous: [-]/ˈlʌstrəs/; [a]有光泽的;光辉的; [^]gre3k;
luxurious: [-]/lʌɡˈʒʊriəs/; [a]奢侈的,豪华的; [^]gre3k;
lyric: [-]/ˈlɪrɪk/; [n]抒情诗;歌词; [a](供)吟唱的;抒情的; [^]gre3k;
macabre: [-]/məˈkɑːbrə/; [a]骇人的,可怖的; [^]gre3k;
macerate: [-]/ˈmæsəreɪt/; [v]浸软,消瘦; [^]gre3k;
machination: [-]/ˌmækəˈneɪʃn/; [n]阴谋; [^]gre3k;
madcap: [-]/ˈmædkæp/; [n]热爱冒险的人; [a]大胆的,鲁莽的; [^]gre3k;
maelstrom: [-]/ˈmeɪlstrɑːm/; [n]大漩涡;灾祸;不可抗的破坏力; [^]gre3k;
magnificent: [-]/mæɡˈnɪfɪsnt/; [a]华丽的,宏伟的,壮丽的; [^]gre3k;
magnitude: [-]/ˈmæɡnɪtuːd/; [n]巨大;震级;重要性;<数>量值; [^]gre3k;
maladroit: [-]/ˌmæləˈdrɔɪt/; [a]笨拙的; [^]gre3k;
malaise: [-]/məˈleɪz/; [n]不舒服;心神不安; [^]gre3k;
malcontent: [-]/ˌmælkənˈtent/; [n]不满分子,反抗者; [a]不满的,不服的; [^]gre3k;
malevolent: [-]/məˈlevələnt/; [a]有恶意的,恶毒的; [^]gre3k;
malicious: [-]/məˈlɪʃəs/; [a]怀恶意的,恶毒的; [^]gre3k;
malign: [-]/məˈlaɪn/; [v]诽谤,中伤; [a]邪恶的;有害的; [^]gre3k;
malignant: [-]/məˈlɪɡnənt/; [a]恶性的,恶毒的,充满恨意的; [n]怀有恶意的人;保王党员; [^]gre3k;
malinger: [-]/məˈlɪŋɡər/; [v]装病以逃避工作; [^]gre3k;
malleable: [-]/ˈmæliəbl/; [a](金属)可锻的;有延展性的;(性格)可训练的;易适应的; [^]gre3k;
malodorous: [-]/ˌmælˈoʊdərəs/; [a]有恶臭的;令人极为反感的;不合法的; [^]gre3k;
mandatory: [-]/ˈmændətɔːri/; [a]命令的,强制性的; [^]gre3k;
maneuver: [-]/məˈnʊvər/; [v]操纵; [n]操纵;花招;调遣;策略; [^]gre3k;
mangle: [-]/ˈmæŋɡl/; [v]损毁,使伤残,弄砸; [n]轧布机; [^]gre3k;
mangy: [-]/ˈmeɪndʒi/; [a]污秽的;疥癣的;肮脏的; [^]gre3k;
mania: [-]/ˈmeɪniə/; [n]癫狂,狂热; [^]gre3k;
manifest: [-]/ˈmænɪfest/; [a]显然的,明白无误的,明了的; [v]使显现,使显露,表明; [n]货单,旅客名单; [^]gre3k;
manipulate: [-]/məˈnɪpjuleɪt/; [v]操纵,影响;正骨; [^]gre3k;
mannered: [-]/ˈmænərd/; [a]装模作样的,矫揉造作的,墨守成规的,中规中矩的; [^]gre3k;
manumit: [-]/ˌmænjə'mɪt/; [v]解放(奴隶); [^]gre3k;
manuscript: [-]/ˈmænjuskrɪpt/; [n]手稿;底稿;手抄本; [^]gre3k;
mar: [-]/mɑːr/; [v]毁坏,弄糟,玷污; [^]gre3k;
marginal: [-]/ˈmɑːrdʒɪnl/; [a]微小的,不重要的;仅以微弱多数票获胜的; [n](议会或地方委员会的)边缘席位; [^]gre3k;
marsh: [-]/mɑːrʃ/; [n]湿地;沼泽; [^]gre3k;
martinet: [-]/ˌmɑːrtnˈet/; [n]纪律严明之人; [^]gre3k;
marvel: [-]/ˈmɑːrvl/; [n]奇迹,奇景;奇才; [v]惊叹,吃惊,诧异; [^]gre3k;
mash: [-]/mæʃ/; [v]捣碎; [n]糊状物; [^]gre3k;
masquerade: [-]/ˌmæskəˈreɪd/; [n]化装舞会;伪装,假扮; [vi]假扮; [^]gre3k;
mastery: [-]/ˈmæstəri/; [n]权力;优势;精通,掌握; [^]gre3k;
matriculate: [-]/məˈtrɪkjuleɪt/; [n]被录取者; [v]准许.入学; [^]gre3k;
maudlin: [-]/ˈmɔːdlɪn/; [a]感情脆弱的;容易流泪的;酒后伤感的; [^]gre3k;
maverick: [-]/ˈmævərɪk/; [n]独行者,想法与众不同的人; [a]行为不合常规的; [v]用不正当手段获取;迷路; [^]gre3k;
mawkish: [-]/ˈmɔːkɪʃ/; [a]令人厌恶的,伤感的; [^]gre3k;
meager: [-]/ˈmiːɡər/; [a]瘦的;贫乏的;粗劣的;少量的; [^]gre3k;
meander: [-]/miˈændər/; [n]蜿蜒曲折,迂回曲折的旅程;漫步; [v]迂回曲折;漫步;漫谈; [^]gre3k;
meddle: [-]/ˈmedl/; [vi]干预,多管闲事; [^]gre3k;
mediate: [-]/ˈmiːdieɪt/; [v]调解,调停,斡旋; [^]gre3k;
mediocre: [-]/ˌmiːdiˈoʊkər/; [a]普通的;平凡的;中等的; [^]gre3k;
meditate: [-]/ˈmedɪteɪt/; [v]考虑,沉思,冥想; [^]gre3k;
medley: [-]/ˈmedli/; [a]大杂烩,混合物; [n]混合;混杂;混合物; [^]gre3k;
meek: [-]/miːk/; [a]温顺的,逆来顺受的;谦恭的; [n]温顺的人;谦恭的人; [^]gre3k;
mellifluous: [-]/meˈlɪfluəs/; [a](曲调)优美的;流畅的;如蜜般的; [^]gre3k;
melodramatic: [-]/ˌmelədrəˈmætɪk/; [a]夸张的,情节剧的,戏剧似的; [^]gre3k;
menace: [-]/ˈmenəs/; [v]威胁,威吓; [n]威胁;具有危险性的人(或物); [^]gre3k;
mendacious: [-]/menˈdeɪʃəs/; [a]撒谎的,虚假的; [^]gre3k;
menial: [-]/ˈmiːniəl/; [a]仆人的,乏味的; [n]家仆; [^]gre3k;
mentor: [-]/ˈmentɔːr/; [n]导师,指导; [vt]做.的良师;指导; [^]gre3k;
mercenary: [-]/ˈmɜːrsəneri/; [n]外国雇佣兵;唯利是图者; [a]唯利是图的;雇佣的; [^]gre3k;
mercurial: [-]/mɜːrˈkjʊriəl/; [a](情绪)善变的; [^]gre3k;
merited: [-]/ˈmerɪtɪd/; [a]应得的,理所当然的; [^]gre3k;
mesh: [-]/meʃ/; [n]网,筛孔; [v]相啮合; [^]gre3k;
metamorphose: [-]/ˌmetəˈmɔːrfoʊz/; [v]使变形,使变质; [^]gre3k;
metaphysical: [-]/ˌmetəˈfɪzɪkl/; [a]形而上学的;超自然的;玄学派诗歌的; [^]gre3k;
meteoric: [-]/ˌmiːtiˈɔːrɪk/; [a]流星的,转瞬即逝的,突然的; [^]gre3k;
methodical: [-]/məˈθɑːdɪkl/; [a]有系统的,有方法的; [^]gre3k;
meticulous: [-]/məˈtɪkjələs/; [a]谨小慎微的;一丝不苟的; [^]gre3k;
mettle: [-]/ˈmetl/; [n]勇气,毅力,耐力; [^]gre3k;
miff: [-]/mɪf/; [n]微怒,小争执; [v]使..恼怒; [a]有点恼火;有点不高兴; [^]gre3k;
migratory: [-]/ˈmaɪɡrətɔːri/; [a]迁移的;流浪的; [^]gre3k;
milieu: [-]/mɪlˈjuː/; [n]周围环境;背景;周围;出身背景; [^]gre3k;
military: [-]/ˈmɪləteri/; [n]军队; [a]军事的; [^]gre3k;
mime: [-]/maɪm/; [n]哑剧演员,小丑,笑剧,丑角; [v]作摹拟表演; [^]gre3k;
mimic: [-]/ˈmɪmɪk/; [v]模仿,戏弄; [n]模仿者; [a]模拟的;假的,伪装的; [^]gre3k;
minatory: [-]/ˈmɪnətɔːri/; [a]带来威胁的,有凶兆的; [^]gre3k;
mince: [-]/mɪns/; [v]切碎,小步走路; [n]切碎物; [^]gre3k;
mingle: [-]/ˈmɪŋɡl/; [v]使混合,使相混; [vi]相交往,相往来; [^]gre3k;
minimize: [-]/ˈmɪnɪmaɪz/; [v]使缩到最小;达到最低值; [^]gre3k;
miniscule: [-]/'mɪnəˌskjuːl/; [a]极小的;草写小字的; [n](中世纪古抄本的)小书写体; [^]gre3k;
mint: [-]/mɪnt/; [n]薄荷,薄荷糖,造币厂; [v]铸造(硬币); [^]gre3k;
minutia: [-]/mɪ'njuːʃɪə/; [n]次要的细节,小事; [^]gre3k;
mirage: [-]/məˈrɑːʒ/; [n]幻影,海市蜃楼; [^]gre3k;
mire: [-]/ˈmaɪər/; [n]泥沼,困境; [^]gre3k;
mirth: [-]/mɜːrθ/; [n]欢乐,欢笑; [^]gre3k;
misanthropic: [-]/ˌmɪsənˈθrɑːpɪk/; [a]厌恶人类的,不愿与人来往的; [^]gre3k;
misapprehension: [-]/ˌmɪsæprɪˈhenʃn/; [n]错误的理解,错误的判断; [^]gre3k;
misbehaving: [-]/ˌmɪsbɪˈheɪvɪŋ/; [a]调皮的,行为不端的; [^]gre3k;
mischievous: [-]/ˈmɪstʃɪvəs/; [a]狡猾的;调皮的;有害的; [^]gre3k;
misconstrue: [-]/ˌmɪskənˈstruː/; [v]误解,曲解; [^]gre3k;
miscreant: [-]/ˈmɪskriənt/; [n]恶棍,歹徒; [^]gre3k;
misdemeanor: [-]/ˌmɪsdɪ'miːnə/; [n]轻罪,品行不端; [^]gre3k;
miserly: [-]/ˈmaɪzərli/; [a]贪财的,吝啬的; [^]gre3k;
misfortune: [-]/ˌmɪsˈfɔːrtʃuːn/; [n]不幸,灾祸; [^]gre3k;
misgiving: [-]/ˌmɪsˈɡɪvɪŋ/; [n]疑虑; [vt]担忧;使.疑虑;害怕(misgive的变形); [^]gre3k;
mishap: [-]/ˈmɪshæp/; [n]不幸的事,灾祸;晦气; [^]gre3k;
misrepresent: [-]/ˌmɪsˌreprɪˈzent/; [vi]作虚假陈述; [vt]歪曲;误传; [^]gre3k;
mite: [-]/maɪt/; [n]极小量,小虫; [^]gre3k;
mitigate: [-]/ˈmɪtɪɡeɪt/; [v]减轻,缓和; [^]gre3k;
mobile: [-]/ˈmoʊbl/; [n]风铃,悬挂饰物;手机,移动电话; [a]可移动的;行动方便的; [^]gre3k;
mockery: [-]/ˈmɑːkəri/; [n]嘲弄;笑柄;徒劳无功;拙劣可笑的模仿或歪曲; [^]gre3k;
moderate: [-]/ˈmɑːdərət/; [a]适度的,适中的,温和的,稳健的,中等的; [v]使减轻,使缓和; [n]温和主义者;稳健的人; [^]gre3k;
mollify: [-]/ˈmɑːlɪfaɪ/; [v]安慰,安抚; [^]gre3k;
mollycoddle: [-]/ˈmɑːlikɑːdl/; [v]溺爱,娇惯; [n]娇生惯养的人; [^]gre3k;
molt: [-]/moʊlt/; [v]脱毛,换毛; [n]换羽期,脱毛期; [^]gre3k;
momentum: [-]/moʊˈmentəm/; [n](物理)动量;势头;动力; [^]gre3k;
monarch: [-]/ˈmɑːnərk/; [n]君主;帝王;统治者; [^]gre3k;
mongrel: [-]/ˈmʌŋɡrəl/; [n]杂种动物,混血儿; [a]杂种的;杂交的;混血的; [^]gre3k;
monochromatic: [-]/ˌmɑːnəkroʊˈmætɪk/; [a]<物>单色的; [^]gre3k;
monologue: [-]/ˈmɑːnəlɔːɡ/; [n]独白,个人长篇演说; [^]gre3k;
monopolize: [-]/məˈnɑːpəlaɪz/; [vt]垄断;独占,全部占有; [^]gre3k;
monotonous: [-]/məˈnɑːtənəs/; [a]单调的,无聊的; [^]gre3k;
montage: [-]/ˌmɑːnˈtɑːʒ/; [n]蒙太奇(电影的基本结构手段和叙事方式),混合画,拼集的照片; [^]gre3k;
moratorium: [-]/ˌmɔːrəˈtɔːriəm/; [n]暂停,中止;<金融>延期偿付; [^]gre3k;
morbid: [-]/ˈmɔːrbɪd/; [a]疾病的;(精神等)病态的;恐怖的; [^]gre3k;
moribund: [-]/ˈmɔːrɪbʌnd/; [a]濒临失败的,垂死的; [n]垂死的人; [^]gre3k;
morose: [-]/məˈroʊs/; [a]脾气坏的,乖戾的,不高兴的; [^]gre3k;
mosaic: [-]/moʊˈzeɪɪk/; [n]镶嵌细工,马赛克; [a]摩西的;拼花的; [vt]镶嵌;用马赛克装饰; [^]gre3k;
mosque: [-]/mɑːsk/; [n]伊斯兰教寺院;清真寺; [^]gre3k;
motile: [-]/'moʊtɪl/; [a]<生理>能动的,显示活力的; [n]运动型; [^]gre3k;
motivate: [-]/ˈmoʊtɪveɪt/; [vt]激励;使有动机;促进;促动;激发..的积极性; [^]gre3k;
motley: [-]/ˈmɑːtli/; [a]混杂的,杂色的; [n]混杂;杂色衣服;小丑; [^]gre3k;
mottle: [-]/'mɒtəl/; [n]斑点,杂色,斑驳; [v]使呈杂色,使显得斑驳陆离; [^]gre3k;
motto: [-]/ˈmɑːtoʊ/; [n]座右铭;格言;箴言;口号; [^]gre3k;
mournful: [-]/ˈmɔːrnfl/; [a]悲哀的; [^]gre3k;
movement: [-]/ˈmuːvmənt/; [n]动作,移动;运动;(交响乐)乐章; [^]gre3k;
muddy: [-]/ˈmʌdi/; [a]泥泞的;暗淡的;浑浊的; [v]使粘上烂泥;显得扑朔迷离; [^]gre3k;
muffle: [-]/ˈmʌfl/; [v]蒙住,裹住,抑制,发低沉的声音; [n]低沉的声音,消声器,包裹物(如头巾,围巾等),唇鼻部; [^]gre3k;
mumble: [-]/ˈmʌmbl/; [v]含糊地说;抿着嘴嚼; [n]含糊的话;咕噜; [^]gre3k;
mundane: [-]/mʌnˈdeɪn/; [a]普通的,平凡的;单调的;现世的,世俗的; [^]gre3k;
munificent: [-]/mjuːˈnɪfɪsnt/; [a]慷慨的,大方的; [^]gre3k;
murky: [-]/ˈmɜːrki/; [a]黑暗的,朦胧的; [ad]阴暗地,混浊地,可疑地; [n]阴暗;昏暗;混浊;可疑; [^]gre3k;
murmur: [-]/ˈmɜːrmər/; [v]低声说,低语;低声抱怨; [n]低语;喃喃说话声; [^]gre3k;
mutate: [-]/ˈmjuːteɪt/; [v]变异; [^]gre3k;
mute: [-]/mjuːt/; [n]弱音器; [a]缄默的;哑的; [vt]减弱.的声音; [^]gre3k;
mutter: [-]/ˈmʌtər/; [n]低语;小声抱怨; [v]低声说;小声抱怨; [vt]低声说;抱怨地说; [^]gre3k;
myopic: [-]/maɪˈɑːpɪk/; [n]近视; [a]近视的;目光短浅的; [^]gre3k;
myriad: [-]/ˈmɪriəd/; [n]无数;极大数量; [a]无数的; [^]gre3k;
nadir: [-]/ˈneɪdɪr/; [n]最低点,无底; [^]gre3k;
naive: [-]/naɪˈiːv/; [a]天真的; [n]天真的人; [^]gre3k;
narcissism: [-]/ˈnɑːrsɪsɪzəm/; [n]自恋,自爱; [^]gre3k;
nascent: [-]/ˈnæsnt/; [a]初生的,萌芽的;发生中的; [^]gre3k;
natty: [-]/ˈnæti/; [a]整洁的,干净的,潇洒的; [^]gre3k;
nauseate: [-]/ˈnɔːzieɪt/; [v]使作呕,产生恶感; [^]gre3k;
nautical: [-]/ˈnɔːtɪkl/; [a]航海的;海上的;海员的; [^]gre3k;
nebulous: [-]/ˈnebjələs/; [a]朦胧的,星云的,星云状的; [^]gre3k;
needy: [-]/ˈniːdi/; [a]贫困的;贫穷的;生活艰苦的; [^]gre3k;
nefarious: [-]/nɪˈferiəs/; [a]违法的,邪恶的; [^]gre3k;
negation: [-]/nɪˈɡeɪʃn/; [n]否定,拒绝;反面; 对立面; [^]gre3k;
negligent: [-]/ˈneɡlɪdʒənt/; [a]疏忽的,粗心大意的;随意的; [^]gre3k;
negotiate: [-]/nɪˈɡoʊʃieɪt/; [v]谈判,交涉,商议;成功越过,渡过; [^]gre3k;
neophyte: [-]/ˈniːəfaɪt/; [n]新信徒;新入教者;初学者; [^]gre3k;
nerve: [-]/nɜːrv/; [n]神经;胆量,勇气; [v]给.以力量,使振作; [^]gre3k;
nettle: [-]/ˈnetl/; [v]刺激;惹恼;用荨麻刺; [n]荨麻; [^]gre3k;
neutralize: [-]/ˈnuːtrəlaɪz/; [v]宣布中立,使中立化;使无效;中和; [^]gre3k;
nexus: [-]/ˈneksəs/; [n]关系;连结; [^]gre3k;
nibble: [-]/ˈnɪbl/; [v]一点点地咬,慢慢啃,吹毛求疵; [n]细咬,轻咬,啃; [^]gre3k;
nicety: [-]/ˈnaɪsəti/; [n]细节,讲究; [^]gre3k;
nil: [-]/nɪl/; [n]零;无; [^]gre3k;
nip: [-]/nɪp/; [v]咬;捏;剪断;冻伤;阻止; [n]夹;捏;刺骨;小饮; [^]gre3k;
nirvana: [-]/nɪrˈvɑːnə/; [n]涅槃,心灵的平静,极乐; [^]gre3k;
nitpick: [-]/'nɪtpɪk/; [v]挑剔,吹毛求疵; [^]gre3k;
nocturnal: [-]/nɑːkˈtɜːrnl/; [a]夜晚的,夜间发生的; [^]gre3k;
noisome: [-]/ˈnɔɪsəm/; [a]恶臭的;令人不快的; [^]gre3k;
nomad: [-]/ˈnoʊmæd/; [n]流浪者,游牧民; [a]游牧的;流浪的; [^]gre3k;
nominal: [-]/ˈnɑːmɪnl/; [a]名义上的;象征性的,很少的;名词性的; [^]gre3k;
nonchalant: [-]/ˌnɑːnʃəˈlɑːnt/; [a]若无其事的;满不在乎的;冷静的;冷漠的; [^]gre3k;
nondescript: [-]/ˈnɑːndɪskrɪpt/; [a]没有特征的,难以形容的,难以归类的; [n]难以名状,不属任何型类的人; [^]gre3k;
nonentity: [-]/nɑːˈnentəti/; [n]不存在,虚无;无能力之人,无足轻重的人; [^]gre3k;
nonplus: [-]/ˌnɒn'plʌs/; [v]使窘困;使迷惑;狼狈不堪; [n]迷惑,困惑; [^]gre3k;
nonsense: [-]/ˈnɑːnsens/; [n]胡说,废话; [^]gre3k;
nostalgia: [-]/nəˈstældʒə/; [n]怀旧之情,思乡病; [^]gre3k;
notch: [-]/nɑːtʃ/; [n]刻痕,凹口;等级;峡谷; [v]赢得;用刻痕计算;在.上刻凹痕; [^]gre3k;
nourish: [-]/ˈnɜːrɪʃ/; [v]养育;培育(希望);增强(希望); [^]gre3k;
novel: [-]/ˈnɑːvl/; [n]小说,长篇故事; [a]新奇的,新颖的,不同的; [^]gre3k;
novice: [-]/ˈnɑːvɪs/; [n]生手,新手; [^]gre3k;
noxious: [-]/ˈnɑːkʃəs/; [a]有害的,有毒的; [^]gre3k;
nuance: [-]/ˈnuːɑːns/; [n]细微差别; [^]gre3k;
nudge: [-]/nʌdʒ/; [v](用臂肘)轻推(促其注意),鼓动,接近; [n]推动,用肘轻推; [^]gre3k;
nugatory: [-]/ˈnuːɡətɔːri/; [a]无价值的,琐碎的,无效的,无法律效力的; [^]gre3k;
nullification: [-]/ˌnʌləfə'keɪʃən/; [n]废弃,取消,(美)州对联邦法令的拒绝执行或承认; [^]gre3k;
numb: [-]/nʌm/; [a]麻木的,失去知觉的; [vt]使麻木,使失去知觉; [^]gre3k;
nurture: [-]/ˈnɜːrtʃər/; [v]养育,培育;培植; [n]养育,培养;教养;营养物; [^]gre3k;
oaf: [-]/oʊf/; [n]愚蠢的人; [^]gre3k;
oath: [-]/oʊθ/; [n]誓言;誓约;咒骂;咒语; [^]gre3k;
obdurate: [-]/ˈɑːbdərət/; [a]固执的,冷酷无情的; [^]gre3k;
obedient: [-]/oʊˈbiːdiənt/; [a]服从的,顺从的;孝顺的; [^]gre3k;
obeisance: [-]/oʊˈbiːsns/; [n]鞠躬,敬礼;尊敬; [^]gre3k;
obfuscate: [-]/ˈɑːbfʌskeɪt/; [v]使复杂;使迷乱,使模糊;弄暗; [^]gre3k;
obligatory: [-]/əˈblɪɡətɔːri/; [a]强制性的;义务的;必须的; [^]gre3k;
obliging: [-]/əˈblaɪdʒɪŋ/; [a]乐于助人的;有礼貌的;体贴的;亲切的; [^]gre3k;
oblique: [-]/əˈbliːk/; [a]斜的,非直角的,隐射的; [v]倾斜; [n]<解>斜肌(尤指腹部的肌肉);倾斜物;<军>倾斜航空照片; [ad]<军>以45度角; [^]gre3k;
obliterate: [-]/əˈblɪtəreɪt/; [v]消灭;涂去;冲刷;忘掉; [^]gre3k;
oblivious: [-]/əˈblɪviəs/; [a]不在意的;忘却的,健忘的; [^]gre3k;
obloquy: [-]/ˈɑːbləkwi/; [n]毁谤;耻辱;漫骂; [^]gre3k;
obscure: [-]/əbˈskjʊr/; [v]隐藏,使.模糊;使变暗;遮掩; [a]不清楚的;难以理解的; [n]某种模糊的或不清楚的东西; [^]gre3k;
obsequious: [-]/əbˈsiːkwiəs/; [a]逢迎的,谄媚的; [^]gre3k;
observant: [-]/əbˈzɜːrvənt/; [a]机警的;严格遵守的;善于观察的; [^]gre3k;
obsess: [-]/əbˈses/; [vt]迷住,使着迷,使烦扰; [^]gre3k;
obsolete: [-]/ˌɑːbsəˈliːt/; [a]已过时的;已废弃的; [v]使过时;使作废; [n]废词;被废弃的事物; [^]gre3k;
obstinate: [-]/ˈɑːbstɪnət/; [a]顽固的;较难治愈的; [^]gre3k;
obstreperous: [-]/əbˈstrepərəs/; [a]吵闹的,喧嚣的;难驾驭的; [^]gre3k;
obstruct: [-]/əbˈstrʌkt/; [v]阻碍,妨碍,阻塞,堵塞; [^]gre3k;
obtuse: [-]/əbˈtuːs/; [a]迟钝的;圆头的;不锋利的; [^]gre3k;
obviate: [-]/ˈɑːbvieɪt/; [v]排除,避免,消除; [^]gre3k;
occult: [-]/əˈkʌlt/; [a]秘密的,神秘的,玄妙的; [n]神秘学; [vt]隐蔽;<天>(使)掩(星); [vi]定时隐蔽; [^]gre3k;
odium: [-]/ˈoʊdiəm/; [n]憎恶,反感; [^]gre3k;
off-key: [-]/ˌɔːf ˈkiː/; [a]不和谐的;走音的;不恰当的; [^]gre3k;
offbeat: [-]/ˌɔːfˈbiːt/; [a]离奇的;标新立异的;<乐>弱拍的;离奇的;标新立异的; [^]gre3k;
officious: [-]/əˈfɪʃəs/; [a]多管闲事的,非官方的; [ad]过分殷勤地; [n]过分殷勤,爱管闲事; [^]gre3k;
offish: [-]/'ɔːfɪʃ/; [a]冷淡的,疏远的; [^]gre3k;
ominous: [-]/ˈɑːmɪnəs/; [a]不祥的,不吉利的; [^]gre3k;
omniscient: [-]/ɑːmˈnɪsiənt/; [a]无所不知的,博识的; [n]无所不知者,上帝; [^]gre3k;
onerous: [-]/ˈɑːnərəs/; [a]繁重的,麻烦的;负有义务的;负有法律责任的; [^]gre3k;
onset: [-]/ˈɑːnset/; [n]开始;攻击,袭击; [^]gre3k;
opaque: [-]/oʊˈpeɪk/; [a]不透明的;难懂的; [^]gre3k;
opine: [-]/oʊˈpaɪn/; [v]以为;想; [^]gre3k;
opportune: [-]/ˌɑːpərˈtuːn/; [a]适当的,恰好的,合时宜的; [^]gre3k;
opprobrious: [-]/əˈproʊbriəs/; [a]辱骂的;无礼的;可耻的; [^]gre3k;
oration: [-]/ɔːˈreɪʃn/; [n]演说;致辞;叙述法; [^]gre3k;
ordeal: [-]/ɔːrˈdiːl/; [n]严峻考验,苦难的经历,折磨; [^]gre3k;
orient: [-]/ˈɔːrient/; [n][the Orient]东方; [v]定..的方位; [a]东方的;(太阳等)上升的,新生的;闪闪发光的; [^]gre3k;
original: [-]/əˈrɪdʒənl/; [a]有独创性的,原始的,最初的,新颖的; [n]原件;怪人; [^]gre3k;
orthodox: [-]/ˈɔːrθədɑːks/; [a]正统的;传统的;(Orthodox)东正教的; [^]gre3k;
oscillate: [-]/ˈɑːsɪleɪt/; [v]摆动,犹豫; [^]gre3k;
ossify: [-]/ˈɑːsɪfaɪ/; [v]硬化,骨化; [^]gre3k;
ostensible: [-]/ɑːˈstensəbl/; [a]表面上的,伪装的; [^]gre3k;
ostentatious: [-]/ˌɑːstenˈteɪʃəs/; [a]浮华的,虚饰的,外观美丽的; [^]gre3k;
ostracize: [-]/ˈɑːstrəsaɪz/; [v]放逐,排斥,(古希腊)按贝壳流放法放逐; [^]gre3k;
oust: [-]/aʊst/; [v]罢免,驱逐,剥夺,取代; [^]gre3k;
outgoing: [-]/ˈaʊtɡoʊɪŋ/; [a]外向的;外出的;乐于助人的;即将离职的,卸任的; [n]流出;开支; [^]gre3k;
outgrowth: [-]/ˈaʊtɡroʊθ/; [n]结果;副产物;自然的发展;分枝; [^]gre3k;
outlandish: [-]/aʊtˈlændɪʃ/; [a]稀奇古怪的,奇特的;异国风情的; [^]gre3k;
outmaneuver: [-]/ˌaʊtməˈnuvər/; [v]以计谋胜过;运用策略击败; [^]gre3k;
outmoded: [-]/ˌaʊtˈmoʊdɪd/; [a]不再流行的,过时的; [^]gre3k;
outset: [-]/ˈaʊtset/; [n]开始,开端; [^]gre3k;
outwit: [-]/ˌaʊtˈwɪt/; [v]以机智胜过; [^]gre3k;
overbearing: [-]/ˌoʊvərˈberɪŋ/; [a]专横的,独断的,傲慢的; [^]gre3k;
overlap: [-]/ˌoʊvərˈlæp/; [n]重叠,重复; [v](部分地)重叠; [^]gre3k;
overshadow: [-]/ˌoʊvərˈʃædoʊ/; [v]遮蔽,使显得不重要; [^]gre3k;
overt: [-]/oʊˈvɜːrt/; [a]明显的;公开的;公然的; [^]gre3k;
overture: [-]/ˈoʊvərtʃər/; [n]主动表示,姿态;前奏曲;序言,事件的开端;提出问题; [vt]作为一种主动姿态提出;向.提出建议; [^]gre3k;
overwhelm: [-]/ˌoʊvərˈwelm/; [v]压垮;不知所措;淹没;打败,压倒; [^]gre3k;
overwrought: [-]/ˌoʊvərˈrɔːt/; [a]过分紧张的,过度兴奋的; [^]gre3k;
pacify: [-]/ˈpæsɪfaɪ/; [v]使平静,安慰,抚慰; [^]gre3k;
padding: [-]/ˈpædɪŋ/; [n]衬垫,填料;夸张;废话; [v]给.装衬垫,加垫子; [^]gre3k;
paean: [-]/ˈpiːən/; [n]欢乐颂,赞美歌; [^]gre3k;
painstaking: [-]/ˈpeɪnzteɪkɪŋ/; [a](不辞)劳苦的,辛勤的; [n]辛劳,煞费苦心; [^]gre3k;
palatable: [-]/ˈpælətəbl/; [a]美味的,合口味的,合心意的; [^]gre3k;
palatial: [-]/pəˈleɪʃl/; [a]宫殿般的;宏伟的; [^]gre3k;
palaver: [-]/pəˈlɑːvər/; [n]废话;奉承;诱骗;谈判; [v]闲谈;哄骗,笼络; [^]gre3k;
pall: [-]/pɔːl/; [n]幕;棺罩;遮盖物; [v]覆盖;使乏味;走味; [^]gre3k;
palliate: [-]/ˈpælieɪt/; [v]减轻,掩饰,辩解; [^]gre3k;
pallid: [-]/ˈpælɪd/; [a]苍白的,病态的,无生气的; [^]gre3k;
palpable: [-]/ˈpælpəbl/; [a]明显的,易觉察的,可触知的; [^]gre3k;
palpitation: [-]/ˌpælpə'teɪʃən/; [n]<内科>心悸;跳动;颤动; [^]gre3k;
palter: [-]/'pɔːltə/; [v]含糊其词;玩弄;讨价还价,争论不休; [^]gre3k;
paltry: [-]/ˈpɔːltri/; [a]不足取的,无价值的,琐碎的,卑鄙的; [^]gre3k;
pan: [-]/pæn/; [n]平底锅; [v]严厉批评;淘金; [^]gre3k;
panacea: [-]/ˌpænəˈsiːə/; [n]灵丹妙药,万能药; [^]gre3k;
panache: [-]/pəˈnæʃ/; [n]羽饰,神气十足; [^]gre3k;
pandemic: [-]/pænˈdemɪk/; [a]全国流行的;普遍的; [^]gre3k;
pandemonium: [-]/ˌpændəˈmoʊniəm/; [n]地狱,混乱; [^]gre3k;
panegyric: [-]/ˌpænəˈdʒɪrɪk/; [n]颂词,赞词; [^]gre3k;
panoramic: [-]/ˌpænəˈræmɪk/; [a]全景的; [^]gre3k;
parable: [-]/ˈpærəbl/; [n]寓言,比喻; [^]gre3k;
paradigm: [-]/ˈpærədaɪm/; [n]范例,示范; [^]gre3k;
paradise: [-]/ˈpærədaɪs/; [n]天国;天堂;极乐世界; [^]gre3k;
paradox: [-]/ˈpærədɑːks/; [n]矛盾;似矛盾而正确的说法; [^]gre3k;
paragon: [-]/ˈpærəɡɑːn/; [n]模范;完美之物;优秀之人; [a]完美的; [^]gre3k;
paramount: [-]/ˈpærəmaʊnt/; [n]元首;最高; [a]最高的,至上的,首要的; [^]gre3k;
paranoid: [-]/ˈpærənɔɪd/; [a]偏执狂的,过分怀疑的; [^]gre3k;
paraphrase: [-]/ˈpærəfreɪz/; [v]解释,释义; [n]转述,释义; [^]gre3k;
parch: [-]/pɑːrtʃ/; [v]焦干,烤干,使干透; [^]gre3k;
parenthesis: [-]/pəˈrenθəsɪs/; [n]圆括号;插入语,插入成分;间歇,插曲; [^]gre3k;
pariah: [-]/pəˈraɪə/; [n]被排斥或鄙视的人; [^]gre3k;
parity: [-]/ˈpærəti/; [n]相等;同等;平价; [^]gre3k;
parody: [-]/ˈpærədi/; [n]嘲弄文章,拙劣的模仿; [v]拙劣模仿; [^]gre3k;
paroxysm: [-]/ˈpærəksɪzəm/; [n]突发,阵发; [a]发作性的,爆发性的; [^]gre3k;
parrot: [-]/ˈpærət/; [n]鹦鹉,盲目重复或模仿他人行为的人; [vt]学舌,盲目重复或模仿; [^]gre3k;
parry: [-]/ˈpæri/; [v]挡开,避开(武器,问题等); [^]gre3k;
parsimonious: [-]/ˌpɑːrsəˈmoʊniəs/; [a]太节省的,小气的; [^]gre3k;
partial: [-]/ˈpɑːrʃl/; [a]偏爱的,特别喜欢的;偏袒的,不公平的,有偏见的;部分的;不完全的; [n]<数学>偏微商; [^]gre3k;
particularize: [-]/pərˈtɪkjələraɪz/; [v]列举,详细说明; [^]gre3k;
partisan: [-]/ˈpɑːrtəzn/; [a]党派的;效忠的;偏袒的;盲目推崇的; [n]党羽;虔诚信徒;游击队; [^]gre3k;
partition: [-]/pɑːrˈtɪʃn/; [n]划分;隔开物,隔墙,隔板; [v]隔开; [vt]瓜分;分割; [^]gre3k;
patent: [-]/ˈpætnt/; [n]专利; [a]显然的,明显的;专利的;独创的; [v]取得.的专利权; [^]gre3k;
pathological: [-]/ˌpæθəˈlɑːdʒɪkl/; [a]病理学的;病态的;由疾病引起的(等于pathologic); [^]gre3k;
patina: [-]/pəˈtiːnə/; [n]绿锈,光亮的外表,神态,圣餐盘; [^]gre3k;
patrician: [-]/pəˈtrɪʃn/; [n]贵族; [a]贵族的;显贵的;(相貌等)贵族似的; [^]gre3k;
patriot: [-]/ˈpeɪtriət/; [n]爱国者; [^]gre3k;
patronize: [-]/ˈpeɪtrənaɪz/; [v]惠顾;赞助,资助; [^]gre3k;
paucity: [-]/ˈpɔːsəti/; [n]小量,缺乏; [^]gre3k;
paunchy: [-]/ˈpɔːntʃi/; [a]大腹便便,大肚子的; [^]gre3k;
peck: [-]/pek/; [n]啄;轻吻;喙; [v]啄; [vt]轻吻; [^]gre3k;
peculiarity: [-]/pɪˌkjuːliˈærəti/; [n]怪癖;独特性; [^]gre3k;
pedagogical: [-]/ˌpedəˈɡɑdʒɪk(ə)l/; [a]教育的;教学法的; [^]gre3k;
pedagogue: [-]/ˈpedəɡɑːɡ/; [n]教师,卖弄学问者; [^]gre3k;
pedant: [-]/ˈpednt/; [n]学究式人物,书呆子,卖弄学问的人; [^]gre3k;
pedestrian: [-]/pəˈdestriən/; [n]步行者,行人; [a]步行的;平庸无奇的,无聊的; [^]gre3k;
peel: [-]/piːl/; [v]剥皮,削皮,去壳; [n]果皮,外皮; [^]gre3k;
peep: [-]/piːp/; [n]窥看,隐约看见; [v]窥视,偷看; [^]gre3k;
peer: [-]/pɪr/; [n]同龄人,同等地位的人;贵族; [v]仔细看,费力地看; [^]gre3k;
peeve: [-]/piːv/; [v]打扰,惹恼; [n]怨恨;麻烦的事物;触怒; [^]gre3k;
pejorative: [-]/pɪˈdʒɔːrətɪv/; [n]轻蔑语; [a]带有轻蔑意义的,贬低的; [^]gre3k;
pellucid: [-]/pəˈluːsɪd/; [a]透明的,清晰的,明了的; [^]gre3k;
pen: [-]/pen/; [n]笔,钢笔;围栏,畜栏; [v]书写;关押,监禁; [^]gre3k;
penalty: [-]/ˈpenəlti/; [n]惩罚,处罚,不利,罚球; [a]处罚的; [^]gre3k;
penchant: [-]/ˈpentʃənt/; [n]倾向,爱好; [^]gre3k;
penitent: [-]/ˈpenɪtənt/; [a]后悔的,忏悔的; [n]改过迁善的人;忏悔的人;悔罪者; [^]gre3k;
pensive: [-]/ˈpensɪv/; [a]沉思的,心事重重的,忧郁的; [^]gre3k;
penury: [-]/ˈpenjəri/; [n]贫穷; [^]gre3k;
perambulate: [-]/pəˈræmbjuleɪt/; [v]巡行,巡视,漫步; [^]gre3k;
perceptible: [-]/pərˈseptəbl/; [a]可察觉的,可注意到的; [^]gre3k;
perceptive: [-]/pərˈseptɪv/; [a]感知的,知觉的;有知觉力的; [^]gre3k;
peremptory: [-]/pəˈremptəri/; [a]专横的,不容反抗的; [^]gre3k;
perfidy: [-]/ˈpɜːrfədi/; [n]不忠,背叛; [^]gre3k;
perforate: [-]/ˈpɜːrfəreɪt/; [vt]穿孔于,打孔穿透;在.上打齿孔; [vi]穿过,贯穿;穿孔; [^]gre3k;
perfunctory: [-]/pərˈfʌŋktəri/; [a]草率的,敷衍搪塞的; [^]gre3k;
perilous: [-]/ˈperələs/; [a]危险的; [^]gre3k;
perimeter: [-]/pəˈrɪmɪtər/; [n]周长;周界; [^]gre3k;
periodical: [-]/ˌpɪriˈɑːdɪkl/; [n]期刊;杂志; [^]gre3k;
peripatetic: [-]/ˌperipəˈtetɪk/; [a]漫游的,逍遥学派的; [n]走来走去的人,逍遥学派的人; [^]gre3k;
peripheral: [-]/pəˈrɪfərəl/; [a]外围的; [n]外围设备; [^]gre3k;
perish: [-]/ˈperɪʃ/; [vi]死去;毁灭,灭亡; [v]脆裂,老化,腐烂; [^]gre3k;
permanent: [-]/ˈpɜːrmənənt/; [a]永久的,持久的; [n]电烫发; [^]gre3k;
permeable: [-]/ˈpɜːrmiəbl/; [a]可渗透的;可穿透的; [^]gre3k;
pernicious: [-]/pərˈnɪʃəs/; [a]有害的,恶性的,致命的; [^]gre3k;
peroration: [-]/ˌperəˈreɪʃn/; [n]结尾,结论,长篇大论; [^]gre3k;
perpetual: [-]/pərˈpetʃuəl/; [a]永远的,永恒的;不断的; [^]gre3k;
perquisite: [-]/ˈpɜːrkwɪzɪt/; [n]固定津贴,福利; [^]gre3k;
persecute: [-]/ˈpɜːrsɪkjuːt/; [v](尤指因宗教或政治信仰不同)迫害;烦扰,纠缠; [^]gre3k;
persevere: [-]/ˌpɜːrsəˈvɪr/; [v]坚持,不屈不挠; [^]gre3k;
persiflage: [-]/ˈpɜːrsɪflɑːʒ/; [n]挖苦;嘲弄;戏谑; [^]gre3k;
persistence: [-]/pərˈsɪstəns/; [n]坚持不懈,持续; [^]gre3k;
personable: [-]/ˈpɜːrsənəbl/; [a]英俊的,风度好的; [^]gre3k;
perspicacious: [-]/ˌpɜːrspɪˈkeɪʃəs/; [a]独具慧眼的,聪颖的; [^]gre3k;
pertain: [-]/pərˈteɪn/; [vi]属于;适合;有关; [^]gre3k;
pertinacious: [-]/ˌpɜːrtnˈeɪʃəs/; [a]顽固的,执拗的; [^]gre3k;
pertinent: [-]/ˈpɜːrtnənt/; [a]有关的;适当的;中肯的; [n]附属物;参考; [^]gre3k;
perturb: [-]/pərˈtɜːrb/; [vt]使不安;烦扰;使紊乱; [^]gre3k;
peruse: [-]/pəˈruːz/; [v]详细考察;精读; [^]gre3k;
pervade: [-]/pərˈveɪd/; [vt]普及;渗透;弥漫; [vi]弥漫;渗透; [^]gre3k;
pessimistic: [-]/ˌpesɪˈmɪstɪk/; [a]悲观(主义)的; [^]gre3k;
petition: [-]/pəˈtɪʃn/; [n]请愿;请愿书;祈求; [v]请愿; [^]gre3k;
petrify: [-]/ˈpetrɪfaɪ/; [v]石化,使僵化,使惊呆; [^]gre3k;
petty: [-]/ˈpeti/; [a]价值不大的;小的;器量小的;琐碎的; [^]gre3k;
petulant: [-]/ˈpetʃələnt/; [a]性急的,易怒的,爱闹气的; [^]gre3k;
phenomenal: [-]/fəˈnɑːmɪnl/; [a]非凡的;现象的;显著的; [^]gre3k;
philanthropic: [-]/ˌfɪlənˈθrɑːpɪk/; [a]博爱的,为他人着想的; [^]gre3k;
phlegmatic: [-]/fleɡˈmætɪk/; [a]冷淡的;迟钝的; [^]gre3k;
piddling: [-]/ˈpɪdlɪŋ/; [a]琐屑的,无用的,不重要的; [^]gre3k;
piebald: [-]/ˈpaɪbɔːld/; [a]花斑的;杂色的; [^]gre3k;
pigment: [-]/ˈpɪɡmənt/; [n]天然色素,颜料; [^]gre3k;
pilfer: [-]/ˈpɪlfər/; [v]偷窃(公司财产),小偷小摸; [^]gre3k;
pillar: [-]/ˈpɪlər/; [n]柱,台柱,栋梁; [^]gre3k;
pillory: [-]/ˈpɪləri/; [v]给.上颈手枷;使.惹人嘲笑; [n]示众;颈手枷;使惹人嘲笑; [^]gre3k;
pilot: [-]/ˈpaɪlət/; [n]领航员;飞行员; [a]试验性的; [v]给..领航,驾驶;试验; [^]gre3k;
pine: [-]/paɪn/; [n]松树; [v](因死亡,离别等)难过,悲伤; [^]gre3k;
pinnacle: [-]/ˈpɪnəkl/; [n](哥德式建筑的)小尖塔,顶峰; [v]置于尖顶上,置于高处; [^]gre3k;
pinpoint: [-]/ˈpɪnpɔɪnt/; [v]准确地解释或说明; [a]精确的; [n]针尖,极小之物,极不重要的事物; [^]gre3k;
pioneer: [-]/ˌpaɪəˈnɪr/; [n]先驱,先锋,开拓者; [v]开辟,首倡; [^]gre3k;
pious: [-]/ˈpaɪəs/; [a]虔诚的;难以实现的;尽责的; [^]gre3k;
piquant: [-]/ˈpiːkənt/; [a]辛辣的,开胃的;活泼有趣的; [^]gre3k;
pique: [-]/piːk/; [v]引起(好奇心,兴趣等),不悦,愤怒; [n]不悦,生气; [^]gre3k;
pirate: [-]/ˈpaɪrət/; [n]海盗;剽窃者; [v]剽窃; [^]gre3k;
pitfall: [-]/ˈpɪtfɔːl/; [n]陷阱,未料到的危险或困难; [^]gre3k;
pithy: [-]/ˈpɪθi/; [a]精练的,简洁有力的,多髓的; [^]gre3k;
pitiless: [-]/ˈpɪtiləs/; [a]冷酷的,无情的,无同情心的; [^]gre3k;
pittance: [-]/ˈpɪtns/; [n]微薄的收入,小额津贴,少量; [^]gre3k;
pivotal: [-]/ˈpɪvətl/; [a]关键的,枢轴的; [^]gre3k;
placate: [-]/ˈpleɪkeɪt/; [vt]安抚,抚慰; [^]gre3k;
placebo: [-]/pləˈsiːboʊ/; [n]安慰剂;为死者所诵的晚祷词; [^]gre3k;
placid: [-]/ˈplæsɪd/; [a]安静的,平和的; [^]gre3k;
plagiarize: [-]/ˈpleɪdʒəraɪz/; [v]剽窃,抄袭(别人学说,著作); [^]gre3k;
plangent: [-]/ˈplændʒənt/; [a]轰鸣的,凄切的; [^]gre3k;
plateau: [-]/plæˈtoʊ/; [n]高原; [vi]到达平稳阶段; [^]gre3k;
platitude: [-]/ˈplætɪtuːd/; [n]陈词滥调,老生常谈;单调; [^]gre3k;
plausible: [-]/ˈplɔːzəbl/; [a]似乎有理的;巧嘴的; [^]gre3k;
playful: [-]/ˈpleɪfl/; [a]好玩的,嬉戏的,十分有趣的; [^]gre3k;
pleat: [-]/pliːt/; [n]褶,褶状物; [^]gre3k;
plebeian: [-]/pləˈbiːən/; [a]平民的,普通的,粗俗的; [n]平民,百姓,粗俗的人; [^]gre3k;
plenitude: [-]/ˈplenɪtuːd/; [n]充分;丰富;大量; [^]gre3k;
plethora: [-]/ˈpleθərə/; [n]过多,过剩,多血症; [^]gre3k;
pliable: [-]/ˈplaɪəbl/; [a]易弯的;柔韧的;圆滑的; [^]gre3k;
pliant: [-]/ˈplaɪənt/; [a]易弯的,柔软的; [n]顺从; [^]gre3k;
plight: [-]/plaɪt/; [n]困境; [v]宣誓,保证; [^]gre3k;
plod: [-]/plɑːd/; [v]沉重地走,吃力干,拖沓冗长; [n]辛勤工作,沉重的步伐; [^]gre3k;
pluck: [-]/plʌk/; [v]拔去(毛发等);拽开;选; [n]勇气; [^]gre3k;
plumb: [-]/plʌm/; [n]铅锤,测锤; [vi]垂直悬挂; [a]垂直的; [vt]用铅锤测量; [ad]垂直地; [^]gre3k;
plummet: [-]/ˈplʌmɪt/; [v]垂直或突然地堕下,骤然下降; [n]测锤(钓丝的)坠子;线锤;铅锤线;锤规; [^]gre3k;
plump: [-]/plʌmp/; [a]颇胖的,丰满的; [v]拍打使鼓起,突然坐下,倒下,; [^]gre3k;
plunge: [-]/plʌndʒ/; [v]跳进,(使)投入;使陷入;暴跌; [n]卷入,参与;暴跌,骤减; [^]gre3k;
plush: [-]/plʌʃ/; [n]长毛绒; [a]豪华的,长毛绒做的,舒服的; [^]gre3k;
poach: [-]/poʊtʃ/; [v]水煮;小火煮;偷猎;窃取; [^]gre3k;
pointer: [-]/ˈpɔɪntər/; [n]一种短毛猎犬,暗示,指示,指针,指示器; [^]gre3k;
polarize: [-]/ˈpoʊləraɪz/; [v](使)极化,(使)偏振,(使)两极分化; [^]gre3k;
polemic: [-]/pəˈlemɪk/; [n]争论,论战,驳斥; [a]论战的;喜欢争论的; [^]gre3k;
polished: [-]/ˈpɑːlɪʃt/; [a]擦亮的;磨光的;优美的;处世圆滑的; [^]gre3k;
politic: [-]/ˈpɑːlətɪk/; [a]策略性的,政治上的,国家的; [^]gre3k;
pompous: [-]/ˈpɑːmpəs/; [a]傲慢的,浮华的; [^]gre3k;
ponderous: [-]/ˈpɑːndərəs/; [a]笨重的,笨拙的,沉闷的; [^]gre3k;
pore: [-]/pɔːr/; [n]毛孔,细孔; [v]深思熟虑,仔细阅读,审视; [^]gre3k;
porous: [-]/ˈpɔːrəs/; [a]可渗透的,多孔的,可穿越的; [^]gre3k;
portentous: [-]/pɔːrˈtentəs/; [a]不祥的;预兆的;令人惊讶的; [^]gre3k;
poseur: [-]/poʊˈzɜːr/; [n]装模作样的人; [^]gre3k;
posit: [-]/ˈpɑːzɪt/; [v]假定; [n]安置;论断; [^]gre3k;
postulate: [-]/ˈpɑːstʃəleɪt/; [v]假定.是真的; [n]假定; [^]gre3k;
posture: [-]/ˈpɑːstʃər/; [n]姿势;看法;态度; [v]装模作样; [^]gre3k;
potable: [-]/ˈpoʊtəbl/; [a]适于饮用的; [n]饮料; [^]gre3k;
potentate: [-]/ˈpoʊtnteɪt/; [n]统治者,君主;有权势的人; [^]gre3k;
pout: [-]/paʊt/; [n]撅嘴,板脸,生气; [v]撅嘴,绷脸; [^]gre3k;
practitioner: [-]/prækˈtɪʃənər/; [n](医生或律师等)开业者;实践者,从事者; [^]gre3k;
pragmatic: [-]/præɡˈmætɪk/; [a]国事的,团体事务的;实际的,注重实效的; [n]爱管闲事的人;专断的人;国事诏书;实际家; [^]gre3k;
prairie: [-]/ˈpreri/; [n]大草原,(尤指)北美大草原;草原地带; [^]gre3k;
prate: [-]/preɪt/; [v]大谈特谈,唠叨; [n]唠叨,多嘴,无聊话; [^]gre3k;
preach: [-]/priːtʃ/; [v]传教,布道;说教;宣扬; [^]gre3k;
precarious: [-]/prɪˈkeriəs/; [a]不稳定的;危险的;可疑的;说不定的; [^]gre3k;
precedent: [-]/ˈpresɪdənt/; [n]先例,范例;惯例; [a]在前的,前面的; [^]gre3k;
precipice: [-]/ˈpresəpɪs/; [n]危险的处境,灾难的边缘,濒危点;悬崖; [^]gre3k;
precipitate: [-]/prɪˈsɪpɪteɪt/; [v]促成,使..沉淀,猛摔;<气象>凝结; [n]沉淀物,冷凝物; [a]突如其来的,仓促的,迅猛的;感情用事的; [^]gre3k;
precipitation: [-]/prɪˌsɪpɪˈteɪʃn/; [n]猛然摔下;促使;急促;沉淀;降水; [^]gre3k;
precipitous: [-]/prɪˈsɪpɪtəs/; [a]险峻的;急躁的,鲁莽的; [^]gre3k;
preclude: [-]/prɪˈkluːd/; [v]阻止;排除; [^]gre3k;
precursor: [-]/priːˈkɜːrsər/; [n]先兆,先驱,前体; [^]gre3k;
predecessor: [-]/ˈpredəsesər/; [n]前辈;(被取代的)原有事物; [^]gre3k;
predestine: [-]/priː'destɪn/; [v]注定; [^]gre3k;
predilection: [-]/ˌpredlˈekʃn/; [n]偏好; [^]gre3k;
preeminent: [-]/priˈemɪnənt/; [a]卓越的,超群的; [ad]卓越地,杰出地; [^]gre3k;
preempt: [-]/priː'empt/; [v]制止,以先买权取得,取代; [n]〔经〕优先占有; [^]gre3k;
preen: [-]/priːn/; [v]打扮;用嘴整理;赞扬; [^]gre3k;
preface: [-]/ˈprefəs/; [n]序言,前言,开端; [^]gre3k;
pregnant: [-]/ˈpreɡnənt/; [a]怀孕的;充满的,意味深长的; [^]gre3k;
preoccupation: [-]/priˌɑːkjuˈpeɪʃn/; [n]抢先占据;全神贯注;首先要做的事,急务; [^]gre3k;
preponderant: [-]/prɪˈpɑːndərənt/; [a]占优势的,压倒性的; [^]gre3k;
prepossessing: [-]/ˌpriːpəˈzesɪŋ/; [a]给人好感的;有魅力的;引人注意的; [^]gre3k;
preposterous: [-]/prɪˈpɑːstərəs/; [a]荒谬的,可笑的; [^]gre3k;
prerequisite: [-]/ˌpriːˈrekwəzɪt/; [n]先决条件,必要条件; [a]必须先具备的,必要的; [^]gre3k;
prerogative: [-]/prɪˈrɑːɡətɪv/; [n]权利;特权; [^]gre3k;
presage: [-]/ˈpresɪdʒ/; [v]预示; [n]预感,不祥感,前兆,预言; [^]gre3k;
prescience: [-]/ˈpresiəns/; [n]先见;预知; [^]gre3k;
prescription: [-]/prɪˈskrɪpʃn/; [n]处方,药方;(医生开)的药;开处方,开药方; [^]gre3k;
preservative: [-]/prɪˈzɜːrvətɪv/; [n]防腐剂;预防法;防护层; [a]有保存力的;防腐的;有保存力的;有保护性的; [^]gre3k;
prestige: [-]/preˈstiːʒ/; [n]威望,声望; [^]gre3k;
presumptuous: [-]/prɪˈzʌmptʃuəs/; [a]专横的,自以为是的,冒昧的; [ad]自以为是地,专横地,冒失地; [n]自以为是,专横,冒失; [^]gre3k;
pretense: [-]/ˈpriːtens/; [n]虚假;伪装;自吹;炫耀;借口;做作; [^]gre3k;
preternatural: [-]/ˌpriːtərˈnætʃrəl/; [a]超自然的;不可思议的; [^]gre3k;
prevail: [-]/prɪˈveɪl/; [v]流行,盛行;战胜,压倒; [^]gre3k;
prevalent: [-]/ˈprevələnt/; [a]普遍的,流行的; [^]gre3k;
prevaricate: [-]/prɪˈværɪkeɪt/; [v]支吾,搪塞,说谎; [^]gre3k;
primordial: [-]/praɪˈmɔːrdiəl/; [a]原始的;根本的;原生的; [^]gre3k;
primp: [-]/prɪmp/; [v]精心打扮;装饰; [^]gre3k;
principal: [-]/ˈprɪnsəpl/; [n]校长,负责人;本金,资本; [a]主要的,首要的; [^]gre3k;
pristine: [-]/ˈprɪstiːn/; [a]原始的;古时的;纯朴的;崭新的; [^]gre3k;
privation: [-]/praɪˈveɪʃn/; [n]缺乏,贫困,丧失,被剥夺了某物的状态; [^]gre3k;
probe: [-]/proʊb/; [v]探测,探索; [n]探索,调查;探针,探测器; [^]gre3k;
probity: [-]/ˈproʊbəti/; [n]正直,诚实; [^]gre3k;
proclaim: [-]/prəˈkleɪm/; [v]声明,声称;宣告;表明; [^]gre3k;
proclivity: [-]/prəˈklɪvəti/; [n]倾向,怪癖; [^]gre3k;
procrastinate: [-]/proʊˈkræstɪneɪt/; [v](因不愿意做或习惯性地)耽搁,拖延; [^]gre3k;
procure: [-]/prəˈkjʊr/; [vt](努力)取得;获得;导致;完成; [vi]介绍娼妓;拉皮条; [^]gre3k;
prod: [-]/prɑːd/; [n]刺针;刺棒;签子; [v]刺;戳;刺激; [^]gre3k;
prodigal: [-]/ˈprɑːdɪɡl/; [a]挥霍的,十分慷慨的; [n]浪子,挥霍者; [^]gre3k;
prodigious: [-]/prəˈdɪdʒəs/; [a]异常的,奇妙的;巨大的; [^]gre3k;
profane: [-]/prəˈfeɪn/; [a]亵渎神圣的,不敬的,粗俗的,污秽的; [v]亵渎,玷污(神圣),滥用; [n]未受秘传的人; [^]gre3k;
proffer: [-]/ˈprɑːfər/; [v]提出(建议),提供,赠送; [n]提议,建议,赠送; [^]gre3k;
proficient: [-]/prəˈfɪʃnt/; [a]精通的,熟练的; [^]gre3k;
profligate: [-]/ˈprɑːflɪɡət/; [a]放荡的;不检点的;恣意挥霍的; [n]放荡的人,浪子,肆意挥霍者; [^]gre3k;
profundity: [-]/prəˈfʌndəti/; [n]深奥,深厚,深刻; [^]gre3k;
profusion: [-]/prəˈfjuːʒn/; [n]丰富; [^]gre3k;
prohibitive: [-]/prəˈhɪbətɪv/; [a]禁止性的,阻止的;(费用,价格等)过高的;类同禁止的; [^]gre3k;
project: [-]/ˈprɑːdʒekt/; [n]项目,工程;专题研究;课题方案; [v]映射,放映;计划,设计,打算,拟订方案;投掷,发射,喷射;表明..的特性,使呈现特性;阐述;突出,伸出;估计,预估; [^]gre3k;
proliferate: [-]/prəˈlɪfəreɪt/; [v]激增,繁殖,增殖; [^]gre3k;
prolix: [-]/ˈproʊlɪks/; [a]冗长的,说话啰嗦的; [^]gre3k;
prologue: [-]/ˈproʊlɔːɡ/; [n]开场白,序幕; [^]gre3k;
prolong: [-]/prəˈlɔːŋ/; [v]延长;拉长;拖延; [^]gre3k;
promulgate: [-]/ˈprɑːmlɡeɪt/; [v]公布;传播;发表; [^]gre3k;
proofread: [-]/ˈpruːfriːd/; [v]校正,校对; [^]gre3k;
propagate: [-]/ˈprɑːpəɡeɪt/; [v]繁殖,增殖; [vt]传播,宣传; [^]gre3k;
propensity: [-]/prəˈpensəti/; [n]嗜好,习性;倾向; [^]gre3k;
prophetic: [-]/prəˈfetɪk/; [a]预言的,预示的; [^]gre3k;
propitiate: [-]/prəˈpɪʃieɪt/; [v]讨好,抚慰; [^]gre3k;
propitious: [-]/prəˈpɪʃəs/; [a]适合的;吉利的;顺利的; [^]gre3k;
proponent: [-]/prəˈpoʊnənt/; [n]支持者;提议者;主张者;提出认证遗嘱者; [a]建议的;支持的;辩护的; [^]gre3k;
proprietary: [-]/prəˈpraɪəteri/; [a]所有的;专利的;私人拥有的; [n]所有权;所有物;所有人; [^]gre3k;
propriety: [-]/prəˈpraɪəti/; [n]正当(的行为);礼节;适当; [^]gre3k;
prosaic: [-]/prəˈzeɪɪk/; [a]平凡的,乏味的,散文体的; [^]gre3k;
proscribe: [-]/proʊˈskraɪb/; [v]剥夺..的公权,禁止; [^]gre3k;
prosecution: [-]/ˌprɑːsɪˈkjuːʃn/; [n](+the)起诉方,原告;起诉;经营; [^]gre3k;
proselytize: [-]/ˈprɑːsələtaɪz/; [v]使皈依; [^]gre3k;
prospect: [-]/ˈprɑːspekt/; [n]前景,展望;视野;景象; [v]勘察;有前途;勘探;对..进行仔细调查; [^]gre3k;
prosperous: [-]/ˈprɑːspərəs/; [a]富裕的;繁荣的;茂盛的;茁壮生长的; [^]gre3k;
prostrate: [-]/ˈprɑːstreɪt/; [a]降伏的,沮丧的,衰竭的,俯卧的; [v]弄倒,使屈服; [^]gre3k;
protean: [-]/ˈproʊtiən/; [a]变化多端的,能够变化的; [^]gre3k;
protocol: [-]/ˈproʊtəkɔːl/; [n]外交礼节;草案;外交议定书; [vi]拟定议定书; [vt]把.写入议定书; [^]gre3k;
prototype: [-]/ˈproʊtətaɪp/; [n]原型,典型,样本; [^]gre3k;
protract: [-]/proʊ'trækt/; [v]绘制;延长;伸展; [^]gre3k;
protrude: [-]/proʊˈtruːd/; [v]伸出,突出,凸出; [^]gre3k;
protuberant: [-]/proʊˈtuːbərənt/; [a]突出的,隆起的; [^]gre3k;
provident: [-]/ˈprɑːvɪdənt/; [a]节俭的,深谋远虑的,顾及未来的; [^]gre3k;
providential: [-]/ˌprɑːvɪˈdenʃl/; [a]天佑的;神意的; [^]gre3k;
provincial: [-]/prəˈvɪnʃl/; [a]省的;地方性的;偏狭的; [n]地方人民;乡下人;外地人; [^]gre3k;
provisional: [-]/prəˈvɪʒənl/; [n]临时邮票; [a]临时的,暂时的,暂定的; [^]gre3k;
provisory: [-]/prə'vaɪzərɪ/; [a]有附带条件的,临时的; [^]gre3k;
provoke: [-]/prəˈvoʊk/; [v]激怒;对.挑衅;引起; [^]gre3k;
prowess: [-]/ˈpraʊəs/; [n]勇敢,不凡的能力;超凡技术; [^]gre3k;
prowl: [-]/praʊl/; [n](鬼鬼祟祟)徘徊,觅食,游荡; [vi]徘徊,潜行; [vt]在.搜寻;潜行于; [^]gre3k;
prude: [-]/pruːd/; [n]过分守礼的人,故作正经的人; [^]gre3k;
prudent: [-]/ˈpruːdnt/; [a]谨慎的,精明的; [^]gre3k;
prudish: [-]/ˈpruːdɪʃ/; [a]装正经的,故作拘谨的; [^]gre3k;
prune: [-]/pruːn/; [n]梅干; [v]修剪;削减; [^]gre3k;
pry: [-]/praɪ/; [v]刺探,打听,撬开; [n]窥探;杠杆;爱打探的人; [^]gre3k;
pseudonym: [-]/ˈsuːdənɪm/; [n]笔名,假名; [^]gre3k;
psychology: [-]/saɪˈkɑːlədʒi/; [n]心理学;心理状态;心理; [^]gre3k;
pucker: [-]/ˈpʌkər/; [v]折叠;缩拢;皱起; [^]gre3k;
puerile: [-]/ˈpjʊrəl/; [a]幼稚的,孩子气的; [^]gre3k;
puissance: [-]/ˈpwɪsəns/; [n]权力,权势,影响; [^]gre3k;
pulchritude: [-]/ˈpʌlkrɪtjuːd/; [n]漂亮,标致; [^]gre3k;
pulverize: [-]/ˈpʌlvəraɪz/; [v]粉碎;使成粉末;彻底击败;彻底毁坏; [^]gre3k;
pun: [-]/pʌn/; [n]双关语; [v]说双关语,用双关语; [^]gre3k;
punctilious: [-]/pʌŋkˈtɪliəs/; [a]一丝不苟的,精密细心的,拘泥形式的; [^]gre3k;
pundit: [-]/ˈpʌndɪt/; [n]博学者,评论家; [^]gre3k;
pungent: [-]/ˈpʌndʒənt/; [a]刺激性的;刺鼻的;尖锐的; [^]gre3k;
puny: [-]/ˈpjuːni/; [a]弱小的,微不足道的; [^]gre3k;
purity: [-]/ˈpjʊrəti/; [n]纯洁;纯净;纯正;纯粹; [^]gre3k;
purloin: [-]/pɜːrˈlɔɪn/; [v]偷窃; [^]gre3k;
purvey: [-]/pərˈveɪ/; [v](大量)供给,供应; [^]gre3k;
pusillanimous: [-]/ˌpjuːsɪˈlænɪməs/; [a]懦弱的,胆小的;优柔寡断的; [^]gre3k;
quack: [-]/kwæk/; [n]庸医;鸭叫声; [v]嘎嘎叫;吹嘘;大声闲聊; [a]骗人的,江湖医生的; [^]gre3k;
quaff: [-]/kwæf/; [v]痛饮; [^]gre3k;
quail: [-]/kweɪl/; [n]鹌鹑; [v]畏缩;感到恐惧; [^]gre3k;
qualify: [-]/ˈkwɑːlɪfaɪ/; [v]胜任,使具有资格;描述,形容; [^]gre3k;
quandary: [-]/ˈkwɑːndəri/; [n]困惑;窘境;为难; [^]gre3k;
quarantine: [-]/ˈkwɔːrəntiːn/; [v]检疫;隔离;使隔离; [n]检疫;隔离;检疫期;封锁; [^]gre3k;
quarry: [-]/ˈkwɔːri/; [n]采石场;猎物;来源; [v]挖出;努力挖掘; [^]gre3k;
quash: [-]/kwɔːʃ/; [v]镇压,平息,废除,使无效; [^]gre3k;
quaver: [-]/ˈkweɪvər/; [v]颤抖,发颤音; [n]八分音符,颤音; [^]gre3k;
quell: [-]/kwel/; [v]镇压,消除,减轻(激动,恐惧等); [n]镇压,平息,减轻; [^]gre3k;
quench: [-]/kwentʃ/; [v]扑灭(火);止渴; [^]gre3k;
querulous: [-]/ˈkwerələs/; [a]抱怨的,挑剔的; [^]gre3k;
quibble: [-]/ˈkwɪbl/; [n]谬论;双关语;遁辞; [v]诡辩;挑剔;说模棱两可的话; [^]gre3k;
quiescent: [-]/kwaɪˈesnt/; [a]静止的,沉寂的,不活动的; [^]gre3k;
quixotic: [-]/kwɪkˈsɑːtɪk/; [a]空想的,堂吉诃德式的; [n]同"quixotism"; [^]gre3k;
quota: [-]/ˈkwoʊtə/; [n]配额;限额;定额; [^]gre3k;
quotidian: [-]/kwoʊˈtɪdiən/; [a]每天的,司空见惯的; [^]gre3k;
rabble: [-]/ˈræbl/; [n]下层社会;乌合之众;暴民; [^]gre3k;
rabid: [-]/ˈræbɪd/; [a]激烈的;狂暴的;偏激的;患狂犬病的; [^]gre3k;
racy: [-]/ˈreɪsi/; [a]令人激动的;猥亵的; [^]gre3k;
raffish: [-]/ˈræfɪʃ/; [a]轻浮的,艳丽而俗气的; [^]gre3k;
raffle: [-]/ˈræfl/; [n]废物;抽彩票; [v]抽彩票; [^]gre3k;
rage: [-]/reɪdʒ/; [n]极怒;盛怒; [v]迅速蔓延,快速扩散;(战争等)激烈地进行; [^]gre3k;
ragged: [-]/ˈræɡɪd/; [a]破旧的;参差不齐的;未梳理的;粗糙的;精疲力竭的; [^]gre3k;
rail: [-]/reɪl/; [n]铁轨;扶手,栏杆; [v]咒骂; [^]gre3k;
ramble: [-]/ˈræmbl/; [vi]瞎扯;溜达;漫步于; [n]漫步; [^]gre3k;
rambunctious: [-]/ræmˈbʌŋkʃəs/; [a]喧闹的;难控制的;粗暴的;骚乱的; [^]gre3k;
rampant: [-]/ˈræmpənt/; [a]猖獗的,蔓生的; [^]gre3k;
ramshackle: [-]/ˈræmʃækl/; [a]摇摇欲坠的; [^]gre3k;
rancor: [-]/ˈræŋkər/; [n]深仇,怨恨; [^]gre3k;
random: [-]/ˈrændəm/; [a]随机的;任意的;胡乱的; [^]gre3k;
rankle: [-]/ˈræŋkl/; [v]怨恨,使痛苦,化脓; [^]gre3k;
rant: [-]/rænt/; [n]咆哮,痛骂; [v]咆哮,痛骂,大声责骂; [^]gre3k;
rapacious: [-]/rəˈpeɪʃəs/; [a]贪婪的;掠夺的; [^]gre3k;
rapport: [-]/ræˈpɔːr/; [n]密切关系,交往;和谐一致;意见一致; [^]gre3k;
rapprochement: [-]/ˌræproʊʃˈmɑːn/; [n]和好,恢复邦交; [^]gre3k;
rapscallion: [-]/ræp'skæljən/; [n]流氓,恶棍; [^]gre3k;
rapt: [-]/ræpt/; [a]全神贯注的,着迷的;狂喜的; [^]gre3k;
rarefy: [-]/'rerəˌfaɪ/; [v]变稀薄;使(人格,精神等)纯洁;精炼; [^]gre3k;
rash: [-]/ræʃ/; [a]轻率的,鲁莽的; [n]疹,皮疹;(短时期内)爆发的一连串; [^]gre3k;
raspy: [-]/ˈræspi/; [a]声音沙哑的,容易生气的; [^]gre3k;
ratify: [-]/ˈrætɪfaɪ/; [vt]批准,认可,签署生效; [^]gre3k;
ratiocination: [-]/ˌreɪʃioʊsɪˈneɪʃn/; [n]推理,推论; [^]gre3k;
ration: [-]/ˈræʃn/; [n]定量配给; [v]配给;定量供应; [^]gre3k;
rational: [-]/ˈræʃnəl/; [a]理性的;理智的;合理的; [^]gre3k;
rave: [-]/reɪv/; [n]热切赞扬,喧闹的宴会;胡言乱语; [v]咆哮;胡言乱语;语无伦次地说; [a]赞扬的; [^]gre3k;
ravenous: [-]/ˈrævənəs/; [a]贪婪的;渴望的,极饿的;狼吞虎咽的; [^]gre3k;
ravish: [-]/ˈrævɪʃ/; [v]强夺,强奸,使着迷; [^]gre3k;
raze: [-]/reɪz/; [v]夷为平地,破坏,消除;拆毁; [^]gre3k;
react: [-]/riˈækt/; [v]起反应,有影响,对..做出反应;有不良反应;起化学反应; [^]gre3k;
reactionary: [-]/riˈækʃəneri/; [a]保守的,反动的; [n]反动分子; [^]gre3k;
ream: [-]/riːm/; [v]榨取(果汁等);扩展;挖; [n]令(纸张的计数单位);大量; [^]gre3k;
reap: [-]/riːp/; [v]收割;获得;收获; [^]gre3k;
reassure: [-]/ˌriːəˈʃʊr/; [v]使放心,使消除疑虑; [^]gre3k;
rebuff: [-]/rɪˈbʌf/; [n]断然拒绝,回绝,漠不关心; [v]断然拒绝; [^]gre3k;
recalcitrant: [-]/rɪˈkælsɪtrənt/; [a]顽抗的,不顺从的; [^]gre3k;
recant: [-]/rɪˈkænt/; [v]宣布放弃,公开认错; [^]gre3k;
recessive: [-]/rɪˈsesɪv/; [a]隐性的,逆行的,后退的; [^]gre3k;
recidivate: [-]/rɪ'sɪdəˌveɪt/; [v]回到原先的习惯,尤指重新犯罪; [^]gre3k;
reciprocate: [-]/rɪˈsɪprəkeɪt/; [v]互给;酬答;互换;报答; [^]gre3k;
reckless: [-]/ˈrekləs/; [a]不顾虑的;鲁莽的,不顾后果的; [^]gre3k;
recluse: [-]/ˈrekluːs/; [n]隐士; [a]隐士的,隐遁的; [^]gre3k;
recoil: [-]/rɪˈkɔɪl/; [v]畏缩;弹回;报应; [n]畏缩;弹回;反作用; [^]gre3k;
reconcile: [-]/ˈrekənsaɪl/; [v]和解;调解;调和; [^]gre3k;
recondite: [-]/ˈrekəndaɪt/; [a]深奥的,隐藏的,不为人知的; [^]gre3k;
reconnoiter: [-]/ˌrikəˈnɔɪtər/; [v]侦察,勘查; [^]gre3k;
reconstitute: [-]/ˌriːˈkɑːnstətuːt/; [v]重新设立,重新组成; [^]gre3k;
reconvene: [-]/ˌriːkənˈviːn/; [v]重新集合,重新召集; [^]gre3k;
rectitude: [-]/ˈrektɪtuːd/; [n]正直,公正,正确; [^]gre3k;
recumbent: [-]/rɪˈkʌmbənt/; [a]斜倚的;休息的; [n]〈口〉座位斜靠式自行车; [^]gre3k;
recuperate: [-]/rɪˈkuːpəreɪt/; [v]恢复(健康),重新得到,复兴; [^]gre3k;
redeem: [-]/rɪˈdiːm/; [vt]赎回;挽回;恢复;偿还;弥补;履行;兑换; [^]gre3k;
redolent: [-]/ˈredələnt/; [a]气味强烈的,芬芳的,令人想起..的; [^]gre3k;
redoubtable: [-]/rɪˈdaʊtəbl/; [a]可敬畏的,可怕的; [^]gre3k;
redundant: [-]/rɪˈdʌndənt/; [a]多余的,过剩的;被下岗的; [^]gre3k;
reel: [-]/riːl/; [n]卷盘; [v]旋转;感到震惊;眩晕; [^]gre3k;
referee: [-]/ˌrefəˈriː/; [n]裁判员,仲裁者; [v]裁判,仲裁; [^]gre3k;
refine: [-]/rɪˈfaɪn/; [v]精炼,改进; [^]gre3k;
reflect: [-]/rɪˈflekt/; [v]倒映;反映,反射;仔细思考;反省; [^]gre3k;
refractory: [-]/rɪˈfræktəri/; [a]难治的,难熔的,不听话的; [^]gre3k;
refreshing: [-]/rɪˈfreʃɪŋ/; [a]使精神振作的,使人清爽的;清新悦目的; [^]gre3k;
refulgent: [-]/rɪˈfʌldʒənt/; [a]辉煌的,灿烂的; [^]gre3k;
regenerate: [-]/rɪˈdʒenəreɪt/; [v]新生,再生,使革新; [a]改过自新的,新生的; [n]重生者;再生器官; [^]gre3k;
regimen: [-]/ˈredʒɪmən/; [n]养生法,生活规则; [^]gre3k;
regress: [-]/rɪˈɡres/; [v]后退,退化,恶化; [n]回归;退回; [^]gre3k;
rehabilitate: [-]/ˌriːəˈbɪlɪteɪt/; [v]使康复,使恢复名誉,使恢复原状; [^]gre3k;
rehearsal: [-]/rɪˈhɜːrsl/; [n]排演;叙述;详述;排练; [^]gre3k;
reign: [-]/reɪn/; [v]占主导地位,统治,当政; [n](君主)统治时期; [^]gre3k;
rein: [-]/reɪn/; [n]缰绳; [v]控制; [^]gre3k;
reiterate: [-]/riˈɪtəreɪt/; [vt]反复讲,重申,反复做; [^]gre3k;
rejoice: [-]/rɪˈdʒɔɪs/; [v]欣喜,高兴; [^]gre3k;
relapse: [-]/rɪˈlæps/; [n](旧病的)复发,重陷,回复; [vi]重新陷入,回复; [^]gre3k;
release: [-]/rɪˈliːs/; [v]释放;解放;发行; [n]解除;免除;发表; [^]gre3k;
relentless: [-]/rɪˈlentləs/; [a]顽强的;持续的;坚定地;冷酷的; [^]gre3k;
relevant: [-]/ˈreləvənt/; [a]有关的;恰当的;贴切的; [^]gre3k;
religion: [-]/rɪˈlɪdʒən/; [n]宗教;宗教信仰;宗教生活;虔诚的追求; [^]gre3k;
relinquish: [-]/rɪˈlɪŋkwɪʃ/; [v]放弃,让出(权利,财产等),撤回; [^]gre3k;
relish: [-]/ˈrelɪʃ/; [v]享受;享受.的味道;品味; [n]乐趣;调味品; [^]gre3k;
reluctant: [-]/rɪˈlʌktənt/; [a]不情愿的;勉强的; [^]gre3k;
remiss: [-]/rɪˈmɪs/; [a]疏忽的,怠慢的; [^]gre3k;
remnant: [-]/ˈremnənt/; [n]遗迹;边角剩料; [^]gre3k;
remodel: [-]/ˌriːˈmɑːdl/; [vt]重塑;改造,重建; [^]gre3k;
remonstrance: [-]/rɪˈmɑːnstrəns/; [n]抗议,抱怨,谏书; [^]gre3k;
remorse: [-]/rɪˈmɔːrs/; [n]懊悔,自责,同情,怜悯; [^]gre3k;
remunerate: [-]/rɪˈmjuːnəreɪt/; [v]酬劳;给与报酬;赔偿; [^]gre3k;
rend: [-]/rend/; [v]撕碎;分裂;强夺; [^]gre3k;
renegade: [-]/ˈrenɪɡeɪd/; [n]叛教者,脱党者,叛徒; [v]背叛,背教,变节; [a]叛教的,背叛的,变节的; [^]gre3k;
renege: [-]/rɪˈniːɡ/; [v]食言,否认; [^]gre3k;
renounce: [-]/rɪˈnaʊns/; [vt]宣布放弃,与...断绝关系;抛弃; [vi]垫牌; [n]垫牌; [^]gre3k;
renovate: [-]/ˈrenəveɪt/; [v]更新,修复; [a]恢复的,革新的,翻新的; [^]gre3k;
repartee: [-]/ˌrepɑːrˈtiː/; [n]机敏的应答,妙语,巧辩; [^]gre3k;
repatriate: [-]/ˌriːˈpeɪtrieɪt/; [v]遣返; [n]被遣返回国者; [^]gre3k;
repeal: [-]/rɪˈpiːl/; [n]撤销; [v]废除;废止; [^]gre3k;
repel: [-]/rɪˈpel/; [v]击退,驱逐;排斥,抵制;使厌恶,使反感;使恐惧; [^]gre3k;
repertoire: [-]/ˈrepərtwɑːr/; [n](剧团,演员等的)全部节目;全部才能; [^]gre3k;
repine: [-]/rɪ'paɪn/; [v]不满,心中抱怨; [^]gre3k;
replenish: [-]/rɪˈplenɪʃ/; [v]补充,再装满;把.装满;给.添加燃料; [^]gre3k;
replete: [-]/rɪˈpliːt/; [a]充满的,装满的; [n]<昆>贮蜜蚁; [^]gre3k;
replicate: [-]/ˈreplɪkeɪt/; [v]复制;重复,反复; [^]gre3k;
repose: [-]/rɪˈpoʊz/; [n]休息,睡眠;静止; [vi]建立于.之上; [vt]使休息,使依靠; [^]gre3k;
reprehend: [-]/ˌreprɪ'hend/; [vt]申斥,指责,批评; [^]gre3k;
repress: [-]/rɪˈpres/; [vt]抑制;镇压;约束; [^]gre3k;
reprieve: [-]/rɪˈpriːv/; [v]暂缓处罚,免罪,维持运行; [n]<法>死缓,缓刑,暂缓; [^]gre3k;
reproach: [-]/rɪˈproʊtʃ/; [v]责备,指责; [n]指责; [^]gre3k;
reprobate: [-]/ˈreprəbeɪt/; [n]混蛋,恶棍; [a]邪恶的;堕落的; [v]谴责,指责; [^]gre3k;
reproof: [-]/rɪˈpruːf/; [n]斥责,责备; [v]重新上防水胶;<印>重新打样; [^]gre3k;
reprove: [-]/rɪˈpruːv/; [v]责骂,申斥; [^]gre3k;
repudiate: [-]/rɪˈpjuːdieɪt/; [v]拒绝,否定,驳斥; [^]gre3k;
repugnant: [-]/rɪˈpʌɡnənt/; [a]令人厌恶的; [^]gre3k;
repulse: [-]/rɪˈpʌls/; [n]击退;断然拒绝; [vt]击退;断然拒绝;憎恶; [v]使排斥,使厌恶; [^]gre3k;
repute: [-]/rɪˈpjuːt/; [n]名声,荣誉; [vt]被认为,被称为; [^]gre3k;
requisite: [-]/ˈrekwɪzɪt/; [n]必需品; [a]需要的,必不可少的,必备的; [^]gre3k;
requite: [-]/rɪˈkwaɪt/; [v]报答,酬谢,回报,补偿;报复; [^]gre3k;
rescind: [-]/rɪˈsɪnd/; [v]废除;取消;撤回; [^]gre3k;
reserved: [-]/rɪˈzɜːrvd/; [a]保留的,留作专用的;矜持的,缄默的,有节制的; [^]gre3k;
residual: [-]/rɪˈzɪdʒuəl/; [a]残余的,剩余的; [^]gre3k;
residue: [-]/ˈrezɪduː/; [n]剩余物;残渣;渣;残数; [^]gre3k;
resign: [-]/rɪˈzaɪn/; [v]辞职; [^]gre3k;
resilience: [-]/rɪˈzɪliəns/; [n]恢复力;弹力;顺应力; [^]gre3k;
resolute: [-]/ˈrezəluːt/; [a]坚决的;果断的; [^]gre3k;
resonant: [-]/ˈrezənənt/; [a]洪亮的,共振的,共鸣的; [^]gre3k;
resourceful: [-]/rɪˈsɔːrsfl/; [a]足智多谋的;资源丰富的;机智的; [^]gre3k;
respire: [-]/rɪˈspaɪər/; [v]呼吸; [^]gre3k;
respite: [-]/ˈrespɪt/; [n]缓解;暂缓;暂时的休息;缓期执行; [v]使缓解;使暂缓;使延期;缓期执行; [^]gre3k;
resplendent: [-]/rɪˈsplendənt/; [a]华丽的,辉煌的; [^]gre3k;
responsive: [-]/rɪˈspɑːnsɪv/; [a]反应积极的,反应敏捷的;反应热烈的;响应的; [^]gre3k;
restitution: [-]/ˌrestɪˈtuːʃn/; [n]归还,赔偿; [^]gre3k;
restive: [-]/ˈrestɪv/; [a]不耐烦的,焦躁不安的,倔强的; [^]gre3k;
restless: [-]/ˈrestləs/; [a]烦躁不安的,焦虑的;得不到休息的;不安宁的; [^]gre3k;
restrain: [-]/rɪˈstreɪn/; [v]制止(做);抑制(愤怒等),控制;监禁; [^]gre3k;
resurgence: [-]/rɪˈsɜːrdʒəns/; [n]复活;再现;再起; [^]gre3k;
resurrect: [-]/ˌrezəˈrekt/; [v]复苏,复兴;使复活; [^]gre3k;
resuscitate: [-]/rɪˈsʌsɪteɪt/; [v]使复活,使苏醒,使复兴; [^]gre3k;
retainer: [-]/rɪˈteɪnər/; [n]保持器;家臣;保持者;<机>护圈;预付费用; [^]gre3k;
retaliate: [-]/rɪˈtælieɪt/; [v]报复,反击; [^]gre3k;
retard: [-]/rɪˈtɑːrd/; [v]延迟,使减速; [n]妨碍,阻碍; [^]gre3k;
retentive: [-]/rɪˈtentɪv/; [a]保持的;吸(水)的; [ad]有记性地,记性强地; [n]保持力;〈物〉顽磁性; [^]gre3k;
reticent: [-]/ˈretɪsnt/; [a]沉默不语的;有保留的;含蓄的; [^]gre3k;
retinue: [-]/ˈretənuː/; [n]侍从,随员; [^]gre3k;
retort: [-]/rɪˈtɔːrt/; [v]反驳; [n]反驳,反击,回嘴; [^]gre3k;
retouch: [-]/ˌriːˈtʌtʃ/; [n]润饰;修整部分; [vt]润饰;修整; [vi]润饰;修整; [^]gre3k;
retract: [-]/rɪˈtrækt/; [v]缩回;收回;取消; [n]收缩核; [^]gre3k;
retrench: [-]/rɪˈtrentʃ/; [v]节省,削减;紧缩; [^]gre3k;
retribution: [-]/ˌretrɪˈbjuːʃn/; [n]报应,惩罚,报答,报偿; [^]gre3k;
retrieve: [-]/rɪˈtriːv/; [v]取回,重新得到,挽回,检索; [^]gre3k;
retrograde: [-]/ˈretrəɡreɪd/; [vi]倒退,退步; [a]后退的,退步的,退化的; [vt]使倒退; [^]gre3k;
retrospective: [-]/ˌretrəˈspektɪv/; [a]回顾的;怀旧的;可追溯的; [n]作品回顾展出; [^]gre3k;
revelry: [-]/ˈrevlri/; [n]狂欢;欢宴; [^]gre3k;
revenge: [-]/rɪˈvendʒ/; [n]报仇;报复; [v]为.报仇,报.之仇; [^]gre3k;
reverberate: [-]/rɪˈvɜːrbəreɪt/; [v]弹回,起回声,使回荡在; [^]gre3k;
revere: [-]/rɪˈvɪr/; [v]敬畏;尊敬;崇敬; [^]gre3k;
revise: [-]/rɪˈvaɪz/; [v]修订;修改;温习(功课); [^]gre3k;
revive: [-]/rɪˈvaɪv/; [v](使)苏醒;(使)复苏;再兴起;重做; [^]gre3k;
revoke: [-]/rɪˈvoʊk/; [v]撤回,取消;废除; [n]有牌不跟; [^]gre3k;
revolt: [-]/rɪˈvoʊlt/; [v]反抗,叛乱,厌恶;造反;反抗;厌恶; [n]背叛;厌恶;反叛; [^]gre3k;
rhetorical: [-]/rɪˈtɔːrɪkl/; [a]语言上的,文字上的,言辞华丽(却往往无内涵的); [^]gre3k;
rickety: [-]/ˈrɪkəti/; [a]佝偻病的;摇晃的;蹒跚的;不结实的; [^]gre3k;
rider: [-]/ˈraɪdər/; [n]骑士;附件,附文;扶手; [^]gre3k;
ridicule: [-]/ˈrɪdɪkjuːl/; [v]嘲笑,愚弄; [n]嘲笑,愚弄; [^]gre3k;
rife: [-]/raɪf/; [a]普遍的;流行的; [^]gre3k;
rift: [-]/rɪft/; [n]裂缝,裂口; [^]gre3k;
rigmarole: [-]/ˈrɪɡməroʊl/; [n]冗长无聊的废话; [^]gre3k;
rile: [-]/raɪl/; [v]刺激,惹怒; [^]gre3k;
riot: [-]/ˈraɪət/; [v]闹事; [n]骚乱;暴乱;骚动;放纵; [^]gre3k;
ripen: [-]/ˈraɪpən/; [vi]成熟; [vt]使.成熟;使成熟可以食用; [^]gre3k;
rite: [-]/raɪt/; [n]仪式;惯例;习俗; [^]gre3k;
riveting: [-]/ˈrɪvɪtɪŋ/; [a]非常精彩的; [n]铆接(法; [^]gre3k;
rivulet: [-]/ˈrɪvjələt/; [n]小溪,小河; [^]gre3k;
robust: [-]/roʊˈbʌst/; [a]健壮的,强壮的;精力充沛的;坚固的;粗鲁的; [^]gre3k;
roil: [-]/rɔɪl/; [v]搅浑,惹怒,动荡,喧闹; [n]小股汹涌的急流; [^]gre3k;
roisterer: [-]/'rɔɪstərər/; [n]摆架子的人,喝酒喧哗者; [^]gre3k;
rookie: [-]/ˈrʊki/; [n]新手,新兵,新球员; [^]gre3k;
roster: [-]/ˈrɑːstər/; [n]值勤表,花名册; [v]将(姓名)列入值勤名单; [^]gre3k;
rostrum: [-]/ˈrɑːstrəm/; [n]讲坛,讲台; [^]gre3k;
rouse: [-]/raʊz/; [vt]唤醒,唤起;激起; [^]gre3k;
royalty: [-]/ˈrɔɪəlti/; [n]皇家,王族,皇族;版税;专利费; [^]gre3k;
rubicund: [-]/ˈruːbɪkənd/; [a]红润的;透红的; [^]gre3k;
rudimentary: [-]/ˌruːdɪˈmentri/; [a]基本的,初期的;发育不完全的;退化的; [^]gre3k;
rue: [-]/ruː/; [v]后悔,遗憾; [^]gre3k;
ruffle: [-]/ˈrʌfl/; [vt]弄皱;使生气,扰乱;连续地轻敲;使起波浪; [n]皱纹;生气;混乱; [vi]起皱;愤怒; [^]gre3k;
ruminate: [-]/ˈruːmɪneɪt/; [v]反刍,再嚼,深思; [^]gre3k;
rumple: [-]/ˈrʌmpl/; [v]弄皱;弄得乱七八糟; [n]皱褶;皱纹; [^]gre3k;
runic: [-]/ˈruːnɪk/; [a]神秘的;古代北欧文字的; [n]古代北欧文字; [^]gre3k;
rupture: [-]/ˈrʌptʃər/; [n]破裂;割裂; [v]使破裂;断绝(关系); [^]gre3k;
ruse: [-]/ruːz/; [n]诡计; [^]gre3k;
rustic: [-]/ˈrʌstɪk/; [n]乡巴佬,庄稼汉,粗人; [a]乡村的;质朴的;不精致的; [^]gre3k;
rustle: [-]/ˈrʌsl/; [v]发出沙沙声,使沙沙作响,偷窃; [n]沙沙声; [^]gre3k;
ruthless: [-]/ˈruːθləs/; [a]无情的;残忍的; [^]gre3k;
sabotage: [-]/ˈsæbətɑːʒ/; [n]怠工,蓄意破坏,妨碍; [v]怠工,从事破坏活动,故意阻挠; [^]gre3k;
saccharine: [-]/ˈsækəriːn/; [a]像糖一样的,有甜味的,做作的,矫情的; [^]gre3k;
sacrilege: [-]/ˈsækrəlɪdʒ/; [n]亵渎圣物,悖理逆天的行为; [^]gre3k;
sacrosanct: [-]/ˈsækroʊsæŋkt/; [a](因十分重要,神圣)不可改变,批判的; [^]gre3k;
saddle: [-]/ˈsædl/; [n]鞍;鞍部; [v]给马装鞍具;装鞍具;使负重担; [^]gre3k;
safeguard: [-]/ˈseɪfɡɑːrd/; [v]保护,维护; [n]防卫措施,防范措施; [^]gre3k;
sage: [-]/seɪdʒ/; [a]贤明的,审慎的; [n]圣人,年高望重的人; [^]gre3k;
salient: [-]/ˈseɪliənt/; [a]显著的;突出的;跳跃的; [n]凸角;突出部分; [^]gre3k;
salubrious: [-]/səˈluːbriəs/; [a]清爽的;气候有益健康的; [^]gre3k;
salutary: [-]/ˈsæljəteri/; [a]有益的,有益健康的; [^]gre3k;
salutation: [-]/ˌsæljuˈteɪʃn/; [n]称呼;招呼;寒喧; [^]gre3k;
salvage: [-]/ˈsælvɪdʒ/; [n]抢救;从灾难中抢救出的物资; [vt]拯救;打捞; [^]gre3k;
salve: [-]/sælv/; [n]药膏,安慰; [v]涂药膏;缓和; [^]gre3k;
sanctify: [-]/ˈsæŋktɪfaɪ/; [vt]使神圣化,使合法化; [^]gre3k;
sanctimonious: [-]/ˌsæŋktɪˈmoʊniəs/; [a]伪装虔诚的;道貌岸然的; [^]gre3k;
sanction: [-]/ˈsæŋkʃn/; [n]批准;制裁,处罚; [v]批准,支持,对..实施制裁; [^]gre3k;
sanctuary: [-]/ˈsæŋktʃueri/; [n]圣堂,避难所; [^]gre3k;
sanguine: [-]/ˈsæŋɡwɪn/; [a]乐观的,(脸色等)有血色的,多血质的; [n]血红色,乐观; [^]gre3k;
sanitary: [-]/ˈsænəteri/; [a]卫生的;清洁的; [^]gre3k;
sap: [-]/sæp/; [n]树液,汁液;易上当的人; [v]削弱;逐渐耗竭; [vt]使伤元气; [vi]挖坑道进攻; [^]gre3k;
sapient: [-]/ˈseɪpiənt/; [a]聪明的,伶俐的,装聪明样的,有见识的; [n](史前的)智人; [^]gre3k;
sarcasm: [-]/ˈsɑːrkæzəm/; [n]讽刺,挖苦,嘲笑; [^]gre3k;
sartorial: [-]/sɑːrˈtɔːriəl/; [a]裁缝匠的,裁缝的;缝纫的; [^]gre3k;
sate: [-]/seɪt/; [v]使心满意足,使厌足; [^]gre3k;
satiate: [-]/ˈseɪʃieɪt/; [v]使饱足,生腻; [a]饱足的;厌腻的; [^]gre3k;
satire: [-]/ˈsætaɪər/; [n]讽刺(作品); [^]gre3k;
saturate: [-]/ˈsætʃəreɪt/; [v]使充满,使饱和,使湿透; [^]gre3k;
saturnine: [-]/ˈsætərnaɪn/; [a]忧郁的,阴沉的,讥讽的; [^]gre3k;
saunter: [-]/ˈsɔːntər/; [n]漫步,闲逛; [v]闲逛,漫步; [^]gre3k;
savant: [-]/sæˈvɑːnt/; [n]博学之士,大学士; [^]gre3k;
savory: [-]/ˈseɪvəri/; [a]口感好的,味道好的,令人愉悦的; [^]gre3k;
savvy: [-]/ˈsævi/; [n]老练,机智; [v]明确了解; [a]有见识,精明能干的; [^]gre3k;
scads: [-]/skædz/; [n]大量,巨额; [^]gre3k;
scant: [-]/skænt/; [a]不足的,缺乏的;勉强够的; [v]减少;节省;限制; [^]gre3k;
scathing: [-]/ˈskeɪðɪŋ/; [a]严厉的;损伤的; [v]损伤;伤害; [^]gre3k;
schism: [-]/ˈsɪzəm/; [n]分裂,(教派或政党的)分裂; [^]gre3k;
scintillate: [-]/'sɪntlˌeɪt/; [v]闪烁,(淡吐)流露机智; [^]gre3k;
scion: [-]/ˈsaɪən/; [n]<农学>接穗;子孙; [^]gre3k;
scoff: [-]/skɔːf/; [vi]讥笑; [v]嘲笑; [n]愚弄; [^]gre3k;
scorch: [-]/skɔːrtʃ/; [v]烧焦;枯萎; [vi]高速行驶,疾驰,飞驰; [^]gre3k;
scorn: [-]/skɔːrn/; [n]鄙视; [v]轻蔑;对.不屑一顾; [^]gre3k;
scotch: [-]/skɑːtʃ/; [n](产自苏格兰的一种)威士忌;刻痕,划痕; [v]阻止;平息;挫败; [^]gre3k;
scour: [-]/ˈskaʊər/; [v]搜查;洗涤,洗刷,擦洗;冲刷成,冲刷出; [^]gre3k;
scourge: [-]/skɜːrdʒ/; [n]鞭笞,磨难,带来灾难的事物或人; [v]鞭笞,折磨,使苦恼; [^]gre3k;
scowl: [-]/skaʊl/; [n]愁容,怒容,暴风雨前的阴沉晦暗; [v]皱眉头,怒目而视; [^]gre3k;
scrap: [-]/skræp/; [n]碎片;口角,吵架;小块,小片;废金属;残羹冷炙; [v]报废;舍弃;打架; [^]gre3k;
scrappy: [-]/ˈskræpi/; [a]好斗的,不连贯的; [^]gre3k;
scrawl: [-]/skrɔːl/; [n]潦草的笔迹; [v]乱涂,乱写,潦草地写; [^]gre3k;
screen: [-]/skriːn/; [n]屏幕,荧光屏;纱窗; [v]遮蔽;放映;检查; [^]gre3k;
scribble: [-]/ˈskrɪbl/; [v]潦草地写,乱写,滥写; [n]潦草的写法,潦草写成的东西,杂文; [^]gre3k;
scrimp: [-]/skrɪmp/; [a]不足的,吝啬的; [vt]过度缩减,克扣; [vi]节省或精打细算; [^]gre3k;
scruple: [-]/ˈskruːpl/; [n]顾虑,不安; [vi]有顾虑,良心上感到不安; [^]gre3k;
scrupulous: [-]/ˈskruːpjələs/; [a]小心谨慎的;严谨的;细心的; [^]gre3k;
scrutable: [-]/'skruːtəbəl/; [a]可理解的; [^]gre3k;
scrutinize: [-]/ˈskruːtənaɪz/; [v]仔细检查,细看; [^]gre3k;
scuff: [-]/skʌf/; [vt]使磨损;践踏;拖着脚走; [vi]磨损;拖着脚走; [n]拖着脚走,磨损,践踏; [^]gre3k;
scurrilous: [-]/ˈskɜːrələs/; [a]下流的,恶言毁谤的; [^]gre3k;
scurvy: [-]/ˈskɜːrvi/; [n]坏血病; [a]卑鄙的,下流的; [^]gre3k;
seamy: [-]/ˈsiːmi/; [a]丑恶的,露出线缝的; [^]gre3k;
secluded: [-]/sɪˈkluːdɪd/; [a]隐遁的,隔绝的; [^]gre3k;
secrete: [-]/sɪˈkriːt/; [v]藏匿;私下侵吞;分泌; [^]gre3k;
sedate: [-]/sɪˈdeɪt/; [a]沉着的,镇定的,平和的; [v]使服镇静剂而安静下来; [^]gre3k;
sedentary: [-]/ˈsednteri/; [a]久坐不动的;静止的;坐惯的,定栖的; [^]gre3k;
seduce: [-]/sɪˈduːs/; [v]引诱,诱使,诱惑,勾引;着迷; [^]gre3k;
sedulous: [-]/ˈsedʒələs/; [a]聚精会神的,勤勉的; [^]gre3k;
seemly: [-]/ˈsiːmli/; [a]适当的,有礼的,好看的; [ad]适当地; [^]gre3k;
segment: [-]/ˈseɡmənt/; [n]部分;片段;(橘子等的)瓣; [v]分割; [^]gre3k;
self-abasement: [-]/ˌselfə'beɪsmənt/; [n]自卑,自谦; [^]gre3k;
self-absorbed: [-]/ˌself əbˈzɔːrbd/; [a]自恋的,自私的; [^]gre3k;
seminal: [-]/ˈsemɪnl/; [a]重要的,精液的,种子的; [^]gre3k;
sensation: [-]/senˈseɪʃn/; [n]感觉;知觉;轰动; [^]gre3k;
sensitive: [-]/ˈsensətɪv/; [a]敏感的,过敏的;灵敏的;善解人意的,体恤的; [^]gre3k;
sentinel: [-]/ˈsentɪnl/; [n]哨兵,看守; [v]守卫,放哨; [^]gre3k;
septic: [-]/ˈseptɪk/; [a]受感染的,败血症的,腐败的; [n]引起腐败的东西;腐败物; [^]gre3k;
sepulchral: [-]/səˈpʌlkrəl/; [a]坟墓的,阴深的; [^]gre3k;
sequel: [-]/ˈsiːkwəl/; [n]续集;结局;继续;后果; [^]gre3k;
sequela: [-]/sɪ'kwiːlə/; [n]<医>后遗症,结果,后继者; [^]gre3k;
sequester: [-]/sɪˈkwestər/; [v]使隔离,隔绝,使隐退,没收,扣押; [^]gre3k;
sere: [-]/sɪr/; [a]干枯的,凋萎的; [^]gre3k;
serendipity: [-]/ˌserənˈdɪpəti/; [n]机缘巧合; [^]gre3k;
serene: [-]/səˈriːn/; [a]宁静的,静谧的; [v]宁静;〈诗〉使(海,脸色等)平静;使(天空)明朗; [n]平静(的海);〈诗,古〉晴朗(天空); [^]gre3k;
sermon: [-]/ˈsɜːrmən/; [n]布道;训诫; [^]gre3k;
serpentine: [-]/ˈsɜːrpəntiːn/; [a]似蛇般绕曲的,蜿蜒的; [^]gre3k;
serried: [-]/ˈserid/; [a]密集的;林立的; [^]gre3k;
servile: [-]/ˈsɜːrvl/; [a]奴颜婢膝的,卑屈的,隶属的; [n]奴隶; [^]gre3k;
severe: [-]/sɪˈvɪr/; [a]严重的;严厉的;严酷的;剧烈的; [^]gre3k;
shackle: [-]/ˈʃækl/; [n]枷锁,羁绊(物); [v]给..上手铐(脚镣),用钩链连结,束缚; [^]gre3k;
shadow: [-]/ˈʃædoʊ/; [n]阴影;影子; [v]把影子投在..;盯梢; [^]gre3k;
shallow: [-]/ˈʃæloʊ/; [a]浅的;肤浅的; [v]变浅;使变浅; [n]浅滩;浅处; [^]gre3k;
sham: [-]/ʃæm/; [n]假货;虚假;欺诈; [v]假装; [a]虚假的,假装的; [^]gre3k;
shift: [-]/ʃɪft/; [n]转移;替换;轮值; [v]移动;售卖(难卖的物品);换挡;改换,替换; [^]gre3k;
shiftless: [-]/ˈʃɪftləs/; [a]没有决断力的;无计谋的;偷懒的; [^]gre3k;
shifty: [-]/ˈʃɪfti/; [a]变化的,诡诈的,机智的; [^]gre3k;
shipshape: [-]/ˈʃɪpʃeɪp/; [a]井然有序的;整整齐齐的;整洁干净的; [^]gre3k;
shirk: [-]/ʃɜːrk/; [v]逃避;规避(义务,责任等); [n]偷懒者; [^]gre3k;
shoal: [-]/ʃoʊl/; [n]浅滩,沙洲,一群(鱼); [a](水)浅的; [v]变成浅滩;驶入浅水的地方;(鱼)成群集聚; [^]gre3k;
shopworn: [-]/ˈʃɑːpwɔːrn/; [a]陈旧的; [^]gre3k;
shred: [-]/ʃred/; [n]碎片,少量,毁灭; [v]切成细条,撕成碎片; [^]gre3k;
shrewd: [-]/ʃruːd/; [a]精明的;机灵的; [n]精明;精明者; [^]gre3k;
shrink: [-]/ʃrɪŋk/; [v]收缩;缩小;退缩; [n](非正式用法)心理医生,精神病医生; [^]gre3k;
shroud: [-]/ʃraʊd/; [n]寿衣,覆盖物; [v]覆盖,包以尸衣; [^]gre3k;
shrug: [-]/ʃrʌɡ/; [n]耸肩; [v](为表示厌恶,轻漠,冷淡,怀疑等)耸肩;以耸肩表示(厌恶,轻蔑,冷淡,怀疑等); [^]gre3k;
shun: [-]/ʃʌn/; [v](有意或习惯性地)避开,躲开; [^]gre3k;
sidestep: [-]/ˈsaɪdstep/; [n](侧面)台阶;拳击等横跨一步躲避打击;［喻］回避(困难); [v]回避;横跨一步躲避; [^]gre3k;
signal: [-]/ˈsɪɡnəl/; [n]信号;预兆; [v]发信号;标志; [a]显著的,优越的;暗号的,作信号用的; [^]gre3k;
simile: [-]/ˈsɪməli/; [n]直喻,明喻; [^]gre3k;
simpleton: [-]/ˈsɪmpltən/; [n]傻子;笨蛋; [^]gre3k;
simulate: [-]/ˈsɪmjuleɪt/; [v]假装;模仿;模拟; [^]gre3k;
sin: [-]/sɪn/; [n]罪;罪孽;错误; [v]违犯戒律;犯过失; [^]gre3k;
sincere: [-]/sɪnˈsɪr/; [a]真诚的,诚恳的; [^]gre3k;
sinecure: [-]/ˈsaɪnɪkjʊr/; [n]闲职,挂名职务; [^]gre3k;
sinew: [-]/ˈsɪnjuː/; [n]腱,筋,中坚力量; [v]用腱连结,(好像使用肌筋似的)给..以力量,支持; [^]gre3k;
singe: [-]/sɪndʒ/; [n](轻微的)烧焦; [v](轻微地)烧焦,烫焦; [^]gre3k;
sinuous: [-]/ˈsɪnjuəs/; [a]弯曲的,蜿蜒的; [^]gre3k;
sip: [-]/sɪp/; [v]啜饮; [n]一小口; [^]gre3k;
skeleton: [-]/ˈskelɪtn/; [n]骨骼,梗概;骨瘦如柴的人或动物; [^]gre3k;
skeptic: [-]/ˈskeptɪk/; [n]怀疑论者;怀疑者;无神论者; [^]gre3k;
skimp: [-]/skɪmp/; [vt]少给,克扣,不足量地供给;对.草率从事; [vi]克俭,节省; [a]少的,不足的; [^]gre3k;
skirmish: [-]/ˈskɜːrmɪʃ/; [n]小战役,小争吵; [v]卷入战役(争论),搜索; [^]gre3k;
skittish: [-]/ˈskɪtɪʃ/; [a]轻佻的;活泼的;胆小的; [^]gre3k;
slack: [-]/slæk/; [a]松弛的;懈怠的;萧条的; [n]松弛的部分,松散; [v]变松弛,逃避工作; [^]gre3k;
slake: [-]/sleɪk/; [v]解渴,消渴; [^]gre3k;
slant: [-]/slænt/; [n]倾斜,倾向性,偏见; [v](使)倾斜,使带有某种色彩,歪曲; [a]倾斜的;有偏见的; [^]gre3k;
slate: [-]/sleɪt/; [n]黑板,石板,候选人名单; [v]提名; [^]gre3k;
slew: [-]/sluː/; [n]大量,大批; [v]回转,旋转; [^]gre3k;
slight: [-]/slaɪt/; [a]轻微的,微小的;纤细的,瘦弱的;少量的; [n]轻视,蔑视; [vt]轻视,忽略; [^]gre3k;
sling: [-]/slɪŋ/; [n]<机>吊索,投石器,弹弓,抛掷; [v]用投石器投掷,吊起; [^]gre3k;
slippery: [-]/ˈslɪpəri/; [a]滑的;易滑脱的;不老实的;不稳定的; [^]gre3k;
sloppy: [-]/ˈslɑːpi/; [a]泥泞的,(工作)草率的,粗心的; [^]gre3k;
sloth: [-]/slɑːθ/; [n]懒惰;树懒; [^]gre3k;
slouch: [-]/slaʊtʃ/; [v]耷拉,低垂,使低垂; [n](帽边等的)下垂,耷拉,萎靡不振的人; [^]gre3k;
slovenly: [-]/ˈslʌvnli/; [a]不整洁的,马虎的; [^]gre3k;
sluggard: [-]/ˈslʌɡərd/; [n]懒鬼;游手好闲的人; [^]gre3k;
sluggish: [-]/ˈslʌɡɪʃ/; [a]行动迟缓的,迟钝的;偷懒的; [^]gre3k;
slumber: [-]/ˈslʌmbər/; [n]睡眠;睡觉; [v]浅睡;打盹儿; [^]gre3k;
slur: [-]/slɜːr/; [n]含糊的发音,藐视,污点,连线符; [vi]含糊地说; [vt]对.忽略,含糊不清地说出,贬低; [^]gre3k;
sly: [-]/slaɪ/; [a]狡猾的,奸诈的;会心的;淘气的;诡异的; [^]gre3k;
smarmy: [-]/ˈsmɑːrmi/; [a]迎奉的,讨好的; [^]gre3k;
smart: [-]/smɑːrt/; [a]时髦的,衣着讲究的;聪明的;干净的,整洁的; [v]剧痛,刺疼; [^]gre3k;
smattering: [-]/ˈsmætərɪŋ/; [n]浅薄的知识,少量; [a]肤浅的;些许的;点滴的; [^]gre3k;
smirk: [-]/smɜːrk/; [n]傻笑;假笑;得意的笑; [vi]傻笑;假笑; [vt]以假笑表示;以傻笑表示; [^]gre3k;
smother: [-]/ˈsmʌðər/; [v]窒息; [^]gre3k;
smug: [-]/smʌɡ/; [a]自鸣得意的; [^]gre3k;
smuggling: [-]/ˈsmʌɡlɪŋ/; [n]走私; [v]走私; [^]gre3k;
snare: [-]/sner/; [n]罗网;陷阱;圈套; [^]gre3k;
snarl: [-]/snɑːrl/; [v]缠结,混乱,吠,咆哮,怒骂; [n]咆哮,吼叫,怒骂,缠结,混乱; [^]gre3k;
sneer: [-]/snɪr/; [v]冷笑;嘲笑; [n]嘲笑; [^]gre3k;
snobbish: [-]/ˈsnɑːbɪʃ/; [a]自命不凡的,势利的; [^]gre3k;
snub: [-]/snʌb/; [n]冷落,怠慢; [vt]冷落;断然拒绝;掐灭; [a]故意冷落的,断然拒绝的,斥责的; [^]gre3k;
soak: [-]/soʊk/; [v]浸泡,渗透,吸入; [n]浸泡; [^]gre3k;
sober: [-]/ˈsoʊbər/; [vi]变得冷静; [a]未饮醉的,清醒的;有节制的;严肃的; [v]使清醒;使冷静; [^]gre3k;
sodden: [-]/ˈsɑːdn/; [a]浑身湿透的;浸透的;浸过酒的; [^]gre3k;
solace: [-]/ˈsɑːləs/; [n]慰藉,给予安慰的人或事物; [v]安慰,缓和,使开心; [^]gre3k;
solder: [-]/ˈsɑːdər/; [v]焊接;使联接在一起; [n]焊接;接合物; [^]gre3k;
solemnity: [-]/səˈlemnəti/; [n]庄严,肃穆,庄严的仪式; [^]gre3k;
solicitous: [-]/səˈlɪsɪtəs/; [a]热切期望的;热心的;挂念的; [^]gre3k;
solid: [-]/ˈsɑːlɪd/; [a]结实的;坚固的;固体的; [n]固体; [^]gre3k;
soliloquy: [-]/səˈlɪləkwi/; [n]自言自语,独白; [^]gre3k;
solitude: [-]/ˈsɑːlətuːd/; [n]孤独; [^]gre3k;
solvent: [-]/ˈsɑːlvənt/; [a]有偿付能力的;有溶解力的; [n]溶剂;解决方法; [^]gre3k;
somatic: [-]/soʊ'mætɪk/; [a]肉体的; [^]gre3k;
somber: [-]/'sɒmbə/; [a]忧郁的;昏暗的,阴天的; [^]gre3k;
somnolence: [-]/ˈsɑːmnələns/; [n]困倦;想睡;嗜眠症; [^]gre3k;
sonnet: [-]/ˈsɑːnɪt/; [n]十四行诗; [^]gre3k;
soothe: [-]/suːð/; [v]使(某人,情绪)平静,安慰,使(痛苦,疼痛)缓和或减轻; [^]gre3k;
sop: [-]/sɑːp/; [n]安慰物,贿赂,回扣; [v]浸湿,湿透; [^]gre3k;
sophisticated: [-]/səˈfɪstɪkeɪtɪd/; [a](仪器)精密的,复杂的;老于世故的,老练的,富有经验的;高雅的,精致的; [^]gre3k;
soporific: [-]/ˌsɑːpəˈrɪfɪk/; [a]催眠的; [n]安眠药; [^]gre3k;
sordid: [-]/ˈsɔːrdɪd/; [a]卑鄙的,肮脏的,色彩死气沉沉暗淡的; [^]gre3k;
sparing: [-]/ˈsperɪŋ/; [a]节省的,节制的,少量使用的,保守的; [^]gre3k;
sparse: [-]/spɑːrs/; [a]稀少的;稀疏的; [^]gre3k;
spat: [-]/spæt/; [n]口角,小争论; [v]轻轻拍打;发生小争吵; [^]gre3k;
spate: [-]/speɪt/; [n]洪水;一阵;大雨;突然迸发; [^]gre3k;
specific: [-]/spəˈsɪfɪk/; [a]具体的,明确的;特定的;特殊的;针对..的; [n]详情;特性; [^]gre3k;
specious: [-]/ˈspiːʃəs/; [a]外表美观,华而不实的,徒有其表的; [^]gre3k;
speck: [-]/spek/; [n]斑点,灰尘,污点,小颗粒; [^]gre3k;
spectator: [-]/ˈspekteɪtər/; [n]旁观者;观众;目击者; [^]gre3k;
spectrum: [-]/ˈspektrəm/; [n]光谱,范围,系列; [^]gre3k;
speculate: [-]/ˈspekjuleɪt/; [vi]推测,猜测;投机,做投机买卖; [vt]推测; [^]gre3k;
spendthrift: [-]/ˈspendθrɪft/; [a]挥霍无度的;浪费的; [n]挥霍无度的人;浪费的人; [^]gre3k;
spent: [-]/spent/; [a]精疲力竭的; [^]gre3k;
spindly: [-]/ˈspɪndli/; [a]细长的;纺锤形的; [^]gre3k;
spiny: [-]/ˈspaɪni/; [a]多刺的;长刺的;刺状的;棘手的; [n]多刺的东西; [^]gre3k;
spleen: [-]/spliːn/; [n]脾,脾气,怒气; [^]gre3k;
splice: [-]/splaɪs/; [n]接合,衔接处; [v]接头,捻接(线头等); [^]gre3k;
splinter: [-]/ˈsplɪntər/; [n]碎片;微小的东西;极瘦的人; [v]分裂;裂成碎片; [^]gre3k;
splutter: [-]/ˈsplʌtər/; [n]劈啪声,急忙说出的话,杂乱的声音; [v]喷溅,气急败坏地说; [^]gre3k;
spontaneous: [-]/spɑːnˈteɪniəs/; [a]自发的,无意识的;自然的,天真率直的; [^]gre3k;
spoof: [-]/spuːf/; [n]滑稽模仿(对电影,电视节目等); [v]揶揄,嘲讽;哄骗,欺骗; [^]gre3k;
sporadic: [-]/spəˈrædɪk/; [a]不定时发生的;零星的;分散的; [^]gre3k;
sprawl: [-]/sprɔːl/; [n]四肢伸开的躺卧姿势;蔓生; [v]四肢伸开地坐(或卧);爬行;蔓生; [^]gre3k;
sprightly: [-]/ˈspraɪtli/; [a]活泼的;生气勃勃的;轻快的; [ad]活泼;生气勃勃;轻松地; [^]gre3k;
spur: [-]/spɜːr/; [v]策马,用踢马刺驱马前进;激励,鞭策;推动; [n]踢马刺,靴刺;刺激,鞭策,鼓励;尖坡; [^]gre3k;
spurious: [-]/ˈspjʊriəs/; [a]假的,伪造的,欺骗的; [^]gre3k;
spurn: [-]/spɜːrn/; [v]轻蔑地拒绝,摒弃,唾弃,一脚踢开; [^]gre3k;
squabble: [-]/ˈskwɑːbl/; [v]发生口角,大声争吵; [n]争吵,口角; [^]gre3k;
squalid: [-]/ˈskwɑːlɪd/; [a]污秽的,肮脏的,卑劣的; [^]gre3k;
squall: [-]/skwɔːl/; [n](通常伴随着雨或雪的)风暴,暴风雪; [v]尖叫; [^]gre3k;
squander: [-]/ˈskwɑːndər/; [n]浪费,挥霍; [v]浪费,挥霍; [^]gre3k;
squat: [-]/skwɑːt/; [a]蹲着的; [v]蹲坐,蹲伏; [n]蹲坐; [^]gre3k;
squeamish: [-]/ˈskwiːmɪʃ/; [a]害怕的,易受惊的,想呕吐的; [n]易心烦意乱的人;神经脆弱的人; [^]gre3k;
squelch: [-]/skweltʃ/; [n]吧唧声;压制,镇压; [v]吧唧作响;消除,镇压,不让说; [^]gre3k;
squint: [-]/skwɪnt/; [v]斜视,眯眼睛看; [a]斜着眼的;斜视的;细眯着眼看的;倾斜的;偏移的; [n]斜视眼;斜视斜眼;趋势; [^]gre3k;
stabilize: [-]/ˈsteɪbəlaɪz/; [v]使稳定; [^]gre3k;
stalwart: [-]/ˈstɔːlwərt/; [n]坚定的成员;健壮的人; [a]强壮的,坚定的,忠诚的; [^]gre3k;
stamina: [-]/ˈstæmɪnə/; [n]耐力,持久力; [^]gre3k;
stammer: [-]/ˈstæmər/; [v]口吃,结巴着说出; [n]口吃; [^]gre3k;
startle: [-]/ˈstɑːrtl/; [v]吃惊;惊吓; [^]gre3k;
stasis: [-]/ˈsteɪsɪs/; [n]平衡,停滞; [^]gre3k;
static: [-]/ˈstætɪk/; [a]静电的,静态的,静止的; [n]静电,静电干扰; [^]gre3k;
stature: [-]/ˈstætʃər/; [n]身高,身材;(精神,道德等的)高度; [^]gre3k;
staunch: [-]/stɔːntʃ/; [a]坚定的,可靠的; [vt]止住;止血; [^]gre3k;
steadfast: [-]/ˈstedfæst/; [a]坚定的;不变的; [^]gre3k;
stealth: [-]/stelθ/; [n]隐秘,秘密; [^]gre3k;
steep: [-]/stiːp/; [v]沉浸于..; [a]陡峭的;急剧的;过高的; [n]陡坡; [^]gre3k;
stench: [-]/stentʃ/; [n]臭气,恶臭; [vi](使)发恶臭; [vt]发恶臭; [^]gre3k;
stentorian: [-]/stenˈtɔːriən/; [a](指声音)极响亮的; [^]gre3k;
stereotype: [-]/ˈsteriətaɪp/; [n]老套的模式,陈规,成见; [v]对..产生成见; [^]gre3k;
sterile: [-]/ˈsterəl/; [a]不孕的,无细菌的,贫瘠的; [^]gre3k;
stickler: [-]/ˈstɪklər/; [n]坚持细节的人,顽固的人,费解的事物; [^]gre3k;
stiff: [-]/stɪf/; [a]僵直的,酸痛的;硬的;困难的; [^]gre3k;
stifle: [-]/ˈstaɪfl/; [v]抑制,压制,使窒息; [^]gre3k;
stigma: [-]/ˈstɪɡmə/; [n]<植>柱头,耻辱,污名,烙印,特征; [^]gre3k;
stigmatize: [-]/ˈstɪɡmətaɪz/; [v]诬蔑,玷污; [^]gre3k;
stingy: [-]/ˈstɪndʒi/; [a]吝啬的,小气的,少量的; [^]gre3k;
stint: [-]/stɪnt/; [n]节约;从事某工作的时间;固定; [v]节省;限制; [^]gre3k;
stipple: [-]/ˈstɪpl/; [v]点画,点描; [^]gre3k;
stipulate: [-]/ˈstɪpjuleɪt/; [v]规定;保证;保证;要求以.为条件; [^]gre3k;
stitch: [-]/stɪtʃ/; [v]缝,绣; [n]一针,线迹;缝法,编结法;(肋部的)突然剧痛;缝合(伤口); [^]gre3k;
stock: [-]/stɑːk/; [n]股票;股份;存货;储备;家畜; [v]给..装满;储存; [a]储备的; [^]gre3k;
stockade: [-]/stɑːˈkeɪd/; [n]栅栏,围栏; [^]gre3k;
stodgy: [-]/ˈstɑːdʒi/; [a]平凡的;塞满的;庸俗的; [^]gre3k;
stoic: [-]/ˈstoʊɪkl/; [n]斯多葛学派哲学家;禁欲主义者;坚守克己之人; [a]斯多葛派的;禁欲主义的; [^]gre3k;
stoke: [-]/stoʊk/; [v]添加燃料,把(火)拨旺,狼吞虎咽吃; [n]斯托克;<物>沲; [^]gre3k;
stolid: [-]/ˈstɑːlɪd/; [a]无动于衷的,感情麻木的; [^]gre3k;
stonewall: [-]/ˈstoʊnwɔːl/; [v]阻碍议事,妨碍; [^]gre3k;
stouthearted: [-]/ˌstaʊtˈhɑrtəd/; [a]勇敢的; [^]gre3k;
strait: [-]/streɪt/; [n]海峡;窘迫; [^]gre3k;
strand: [-]/strænd/; [n](线等的)股,缕;一个组成部分;海滨,河岸,海滩,湖滨; [v]使陷入困境;使滞留,使搁浅; [^]gre3k;
stratagem: [-]/ˈstrætədʒəm/; [n]谋略,策略; [^]gre3k;
stratify: [-]/ˈstrætɪfaɪ/; [v]分层,成层,阶层化; [^]gre3k;
stray: [-]/streɪ/; [a]走失的,迷路的;离了群的; [v]走失;分心,走神;有外遇,在别处拈花惹草; [n]流浪者;走失,迷路; [^]gre3k;
strength: [-]/streŋθ/; [n]体力,力气,力量;意志力;长处;兵力;实力;人手;浓度,效力;力度,速度; [^]gre3k;
striate: [-]/'straɪˌeɪt/; [a]有条纹的; [v]加条纹,加条; [^]gre3k;
stricture: [-]/ˈstrɪktʃər/; [n]谴责;严厉;束缚; [^]gre3k;
stride: [-]/straɪd/; [v]大步走;越过;跨越; [vt]大步走过;跨骑在.上; [n]大步;阔步行走的姿势;一大步;跨越;正常的进展; [^]gre3k;
strident: [-]/ˈstraɪdnt/; [a]尖声的,刺耳的; [^]gre3k;
strike: [-]/straɪk/; [v]击打;袭击;罢工; [n]罢工;打击;袭击; [^]gre3k;
stringent: [-]/ˈstrɪndʒənt/; [a]严厉的;迫切的;银根紧的; [^]gre3k;
strip: [-]/strɪp/; [v]剥;夺去;脱衣服; [n]长条;长条形土地; [a]脱衣舞的;被剥去外皮的; [^]gre3k;
strut: [-]/strʌt/; [n]高视阔步,抗压装置; [v]昂首阔步地走,趾高气昂地走; [^]gre3k;
studio: [-]/ˈstuːdioʊ/; [n]摄影棚;工作室;录音室;单间公寓(studio flat);制片公司; [^]gre3k;
stultify: [-]/ˈstʌltɪfaɪ/; [v]使显得愚蠢,愚弄,使无效,使无价值; [^]gre3k;
stunt: [-]/stʌnt/; [n]惊人表演,特技;矮小的人(或物); [v]阻碍..发育;作惊人表演;使绝招; [^]gre3k;
stupor: [-]/ˈstuːpər/; [n]恍惚,昏迷,不醒人事; [^]gre3k;
sturdy: [-]/ˈstɜːrdi/; [a]结实的;坚固的;强壮的;健壮的; [n](羊的)晕倒病; [^]gre3k;
stymie: [-]/ˈstaɪmi/; [v]从中作梗,阻挠;妨碍; [n]妨碍球; [^]gre3k;
subdue: [-]/səbˈduː/; [v]征服,压制,减轻; [^]gre3k;
subject: [-]/ˈsʌbdʒɪkt/; [n]科目;主题;受试者;国民; [a]易患的,服从的; [vt]使服从,使隶属,使遭遇; [^]gre3k;
subjugate: [-]/ˈsʌbdʒuɡeɪt/; [v]征服,使服从; [^]gre3k;
sublime: [-]/səˈblaɪm/; [a]雄伟的,崇高的,极端的,超群的;(行为,态度)极端的,漠不关心的; [n]顶峰,崇高; [v]使.纯化,使.升华,变高尚; [^]gre3k;
subliminal: [-]/ˌsʌbˈlɪmɪnl/; [a]潜意识的,下意识的; [^]gre3k;
submerge: [-]/səbˈmɜːrdʒ/; [v]沉没,淹没;遮掩; [^]gre3k;
submissive: [-]/səbˈmɪsɪv/; [a]顺从的,惟命是从的,谦恭的; [^]gre3k;
subordinate: [-]/səˈbɔːrdɪnət/; [n]部下;下属; [a]次要的;从属的;下级的; [v]使从属于;使处于次要地位; [^]gre3k;
subservient: [-]/səbˈsɜːrviənt/; [a]屈从的;奉承的;有用的,有帮助的; [^]gre3k;
subside: [-]/səbˈsaɪd/; [vi]平息,减弱;减弱;(建筑)下陷;(尤指洪水的水位) 回落; [^]gre3k;
subsidiary: [-]/səbˈsɪdieri/; [a]辅助的,次要的,附属的; [n]子公司,附属机构; [^]gre3k;
subsidy: [-]/ˈsʌbsədi/; [n]补助金,津贴; [^]gre3k;
substantiate: [-]/səbˈstænʃieɪt/; [v]证实;使实体化; [^]gre3k;
substantive: [-]/səbˈstæntɪv/; [a]有实质的;大量的;真实的;独立存在的; [n]实词,名词,名词性词组; [^]gre3k;
substitute: [-]/ˈsʌbstɪtuːt/; [v]代替; [n]代替者,代用品,替补队员; [^]gre3k;
subterfuge: [-]/ˈsʌbtərfjuːdʒ/; [n]托词,借口,诡计; [^]gre3k;
subtle: [-]/ˈsʌtl/; [a]微妙的;敏锐的;不明显的;精细的;狡猾的; [^]gre3k;
succinct: [-]/səkˈsɪŋkt/; [a]简明的,简洁的,没有废话的; [^]gre3k;
succor: [-]/ˈsʌkər/; [n]救援,援助者,救援人员; [v]援助,救援; [^]gre3k;
succumb: [-]/səˈkʌm/; [v]屈从,屈服,因.死亡(to); [^]gre3k;
suffocate: [-]/ˈsʌfəkeɪt/; [v]使窒息,被闷死,受阻; [^]gre3k;
suffuse: [-]/səˈfjuːz/; [v](色彩等)弥漫,染遍; [^]gre3k;
sulk: [-]/sʌlk/; [n]生气,愠怒,愠怒的人; [v]生气,愠怒; [^]gre3k;
sullen: [-]/ˈsʌlən/; [a]沮丧的,闷闷不乐的;阴沉的; [^]gre3k;
summary: [-]/ˈsʌməri/; [n]摘要,总结; [a]简略的,概要的,即决的; [^]gre3k;
summit: [-]/ˈsʌmɪt/; [n]山顶,顶点;(政府间的)峰会; [^]gre3k;
summon: [-]/ˈsʌmən/; [v]召唤;召集;聚集; [^]gre3k;
sumptuous: [-]/ˈsʌmptʃuəs/; [a]奢侈的;华丽的; [^]gre3k;
sunder: [-]/ˈsʌndər/; [v]切开;分裂,分离; [^]gre3k;
supercilious: [-]/ˌsuːpərˈsɪliəs/; [a]目中无人的,高傲的; [^]gre3k;
superficial: [-]/ˌsuːpərˈfɪʃl/; [a]肤浅的;表面的;微不足道的; [n]表面文章; [^]gre3k;
superfluous: [-]/suːˈpɜːrfluəs/; [a]多余的,过剩的;不必要的; [^]gre3k;
superimpose: [-]/ˌsuːpərɪmˈpoʊz/; [v]添加;重叠;附加;安装; [^]gre3k;
supersede: [-]/ˌsuːpərˈsiːd/; [v]代替;紧接着而到来; [^]gre3k;
supine: [-]/ˈsuːpaɪn/; [a]仰卧的;懒散的;向后靠的; [^]gre3k;
supplant: [-]/səˈplænt/; [v]代替;排挤掉; [^]gre3k;
supple: [-]/ˈsʌpl/; [a]柔软的;柔顺的; [^]gre3k;
supplement: [-]/ˈsʌplɪmənt/; [n]增补,补充物,保健品;附录; [v]补充; [^]gre3k;
supplicate: [-]/'sʌplɪˌkeɪt/; [v]恳求,乞求; [^]gre3k;
suppress: [-]/səˈpres/; [v]镇压;禁止发表;抑制(感情等);阻止.的生长; [^]gre3k;
surcharge: [-]/ˈsɜːrtʃɑːrdʒ/; [n]额外费用,过高的要价; [v]追加罚款;使.装载过多;使.负担过重; [^]gre3k;
surfeit: [-]/ˈsɜːrfɪt/; [n]饮食过度,过量; [^]gre3k;
surly: [-]/ˈsɜːrli/; [a]乖戾的;无礼的;阴沉的; [^]gre3k;
surmise: [-]/sərˈmaɪz/; [v]猜测,推测,认为; [n]推测,猜度; [^]gre3k;
surmount: [-]/sərˈmaʊnt/; [v]克服,战胜,越过; [^]gre3k;
surpass: [-]/sərˈpæs/; [v]胜过;超出; [^]gre3k;
surrender: [-]/səˈrendər/; [v]投降;屈服;放弃;交出;自首; [n]投降;放弃;屈服;(保险的)解约; [^]gre3k;
surreptitious: [-]/ˌsɜːrəpˈtɪʃəs/; [a]鬼鬼祟祟的,暗中的,秘密的; [^]gre3k;
surrogate: [-]/ˈsɜːrəɡət/; [n]代替品,代理人,代孕妈妈; [a]代理的,替代的; [v]代替,代理;指定为自己的代理人,接替; [^]gre3k;
surveillance: [-]/sɜːrˈveɪləns/; [n]监视;检查; [^]gre3k;
susceptibility: [-]/səˌseptəˈbɪləti/; [n]易感性的,敏感性,感情; [^]gre3k;
suspend: [-]/səˈspend/; [v]悬挂,吊;中止;推迟; [^]gre3k;
suture: [-]/ˈsuːtʃər/; [n]缝合; [v]缝合; [^]gre3k;
svelte: [-]/svelt/; [a]体态苗条的;线条清晰的; [^]gre3k;
swagger: [-]/ˈswæɡər/; [n]傲慢的态度,大摇大摆; [v]大摇大摆地走,吹牛,傲慢; [a]豪华时髦的; [^]gre3k;
swear: [-]/swer/; [v]发誓,郑重地说;咒骂; [^]gre3k;
sweltering: [-]/ˈsweltərɪŋ/; [a]酷热的; [^]gre3k;
swerve: [-]/swɜːrv/; [v]转弯,突然改变方向; [n]转向;滑出;逸出;背离; [^]gre3k;
swill: [-]/swɪl/; [n]泔水;冲洗;痛饮; [v]冲洗,痛饮; [^]gre3k;
swindle: [-]/ˈswɪndl/; [n]诈骗;欺诈行为;骗局; [vi]欺骗,行骗; [vt]诈骗;骗取; [^]gre3k;
sybarite: [-]/'sɪbəˌraɪt/; [n]沉于奢侈逸乐者,酒色之徒; [^]gre3k;
sycophant: [-]/ˈsɪkəfænt/; [n]马屁精; [^]gre3k;
syllabus: [-]/ˈsɪləbəs/; [n]教学大纲,摘要,课程表; [^]gre3k;
symbiosis: [-]/ˌsɪmbɪˈoʊsɪs/; [n]共生,共栖; [^]gre3k;
symmetry: [-]/ˈsɪmətri/; [n]对称;均衡; [^]gre3k;
synchronous: [-]/ˈsɪŋkrənəs/; [a]同时的,<物>同步的; [^]gre3k;
synonymous: [-]/sɪˈnɑːnɪməs/; [a]同义的;同义词的;同义突变的; [^]gre3k;
synopsis: [-]/sɪˈnɑːpsɪs/; [n]摘要,概要; [^]gre3k;
synthesis: [-]/ˈsɪnθəsɪs/; [n]合成; [^]gre3k;
tacit: [-]/ˈtæsɪt/; [a]心照不宣的,静默的; [^]gre3k;
taciturn: [-]/ˈtæsɪtɜːrn/; [a]沉默寡言的; [^]gre3k;
tackle: [-]/ˈtækl/; [v]对付,处理;(足球等比赛中)阻截; [n]阻截;钓具;滑轮(组); [^]gre3k;
tact: [-]/tækt/; [n]机智,得体,老练,圆滑; [^]gre3k;
tactile: [-]/ˈtæktl/; [a]有触觉的;能触知的; [^]gre3k;
tactless: [-]/ˈtæktləs/; [a]不机智的,笨拙的; [ad]粗鲁地,笨拙地,不老练地; [n]粗鲁,笨拙; [^]gre3k;
taint: [-]/teɪnt/; [n]污点;感染;异味; [vi]腐败,腐烂; [vt]污染;玷污,使受不良影响; [^]gre3k;
talisman: [-]/ˈtælɪzmən/; [n]护身符,避邪物; [^]gre3k;
tame: [-]/teɪm/; [a]驯服的,温顺的;顺从的;枯燥的; [v]驯服; [^]gre3k;
tamper: [-]/ˈtæmpər/; [v]篡改;玩弄;贿赂; [n]填塞者;捣棒; [^]gre3k;
tangent: [-]/ˈtændʒənt/; [n]切线; [a]无关的; [^]gre3k;
tangle: [-]/ˈtæŋɡl/; [v](使)缠结;(使)乱作一团; [n]纠缠;纠结;复杂的问题;困惑; [^]gre3k;
tangy: [-]/ˈtæŋi/; [a]扑鼻的,有刺激性的,强烈的; [^]gre3k;
tantalize: [-]/ˈtæntəlaɪz/; [v]逗弄,挑逗,使(看到拿不到而)焦急; [^]gre3k;
tantamount: [-]/ˈtæntəmaʊnt/; [a]与.相等的; [^]gre3k;
tantrum: [-]/ˈtæntrəm/; [n](孩子气的)脾气发作; [^]gre3k;
taper: [-]/ˈteɪpər/; [v]逐渐变细; [n]锥形;渐弱;蜡芯,小蜡烛; [vi]变尖;逐渐减弱; [vt]变尖;逐渐减弱; [a]渐细的;斜的;依次递减的; [^]gre3k;
tardy: [-]/ˈtɑːrdi/; [n]迟到,迟到记录; [a]缓慢的,迟到的,磨蹭的; [^]gre3k;
tarnish: [-]/ˈtɑːrnɪʃ/; [n]弄脏;失去光泽,生锈; [v]变灰暗,失去光泽,破坏(形象等); [^]gre3k;
tasty: [-]/ˈteɪsti/; [a]好吃的;(尤指女子)迷人的,性感的; [^]gre3k;
tatty: [-]/ˈtæti/; [a]不整洁的;不值钱的;简陋的; [^]gre3k;
taunt: [-]/tɔːnt/; [n]辱骂,嘲弄; [vt]嘲弄,奚落; [a]<海>(桅杆)很高的; [ad]扯满风帆; [^]gre3k;
taut: [-]/tɔːt/; [a]拉紧的;紧张的;整洁的; [^]gre3k;
tawdry: [-]/ˈtɔːdri/; [a]非常华丽的,廉价而俗丽的; [n]俗丽的东西,廉价而俗丽之物; [ad]俗丽地,华而不实地; [^]gre3k;
taxing: [-]/ˈtæksɪŋ/; [a]繁重的,费力的; [^]gre3k;
tedious: [-]/ˈtiːdiəs/; [a]沉闷的,冗长乏味的; [^]gre3k;
teeming: [-]/ˈtiːmɪŋ/; [a]多产的,丰富的;热闹的; [^]gre3k;
teeter: [-]/ˈtiːtər/; [v]使..摇摆;使..上下晃动;蹒跚; [n]跷跷板;摇摆; [^]gre3k;
teetotalism: [-]/ˌtiːˈtoʊtəlɪzəm/; [n]禁酒; [^]gre3k;
telling: [-]/ˈtelɪŋ/; [a]明显的;生动的; [n]叙述; [^]gre3k;
temerity: [-]/təˈmerəti/; [n]鲁莽,大胆,蛮勇; [^]gre3k;
temperate: [-]/ˈtempərət/; [a]温和的;适度的,有节制的; [^]gre3k;
tempestuous: [-]/temˈpestʃuəs/; [a]有暴风雨的,暴乱的,剧烈的; [^]gre3k;
temporal: [-]/ˈtempərəl/; [a]现世的,世俗的;当时的,暂时的;<解>颞的;时间的; [n]世间万物;教会财产; [^]gre3k;
temporize: [-]/ˈtempəraɪz/; [v]拖延,妥协,顺应时势,迎合潮流; [^]gre3k;
tenable: [-]/ˈtenəbl/; [a]站得住脚的;无懈可击的;合理的; [^]gre3k;
tenacious: [-]/təˈneɪʃəs/; [a]坚忍不拔的,固执的,顽强的; [^]gre3k;
tendentious: [-]/tenˈdenʃəs/; [a]有偏见的,有倾向的;宣传性的; [ad]宣传性地,不公平地,有倾向性地; [n]倾向性小说; [^]gre3k;
tender: [-]/ˈtendər/; [a]温柔的;嫩的;柔弱的,脆弱的;痛的; [n]煤水车,附属船;投标; [v]提出(希望对方接受的意见等); [^]gre3k;
tentative: [-]/ˈtentətɪv/; [a]试探性的;不确定的;暂时的;犹豫不决的; [^]gre3k;
tenuous: [-]/ˈtenjuəs/; [a]纤细的;稀薄的;贫乏的;脆弱的; [^]gre3k;
tepid: [-]/ˈtepɪd/; [a]微温的,不热烈的; [^]gre3k;
terminology: [-]/ˌtɜːrməˈnɑːlədʒi/; [n]术语,术语学; [^]gre3k;
terminus: [-]/ˈtɜːrmɪnəs/; [n](火车,汽车)终点站;界标; [^]gre3k;
terror: [-]/ˈterər/; [n]恐怖,惊骇; [^]gre3k;
terse: [-]/tɜːrs/; [a]简洁的,简明的; [^]gre3k;
testimony: [-]/ˈtestɪmoʊni/; [n]证据,证词;表明,说明;见证,证明; [^]gre3k;
testy: [-]/ˈtesti/; [a]性急的,暴躁的; [^]gre3k;
tether: [-]/ˈteðər/; [n]范围,系链,拴绳; [v]用绳或链拴住; [^]gre3k;
theatrical: [-]/θiˈætrɪkl/; [a]戏剧的,矫揉造作的; [n]戏剧表演;戏剧演员;戏剧表演艺术;做戏似的动作; [^]gre3k;
therapeutic: [-]/ˌθerəˈpjuːtɪk/; [a]治疗的;治疗学的;有益于健康的; [n]治疗剂;治疗学家; [^]gre3k;
thorny: [-]/ˈθɔːrni/; [a]多刺的;痛苦的;令人苦恼的; [^]gre3k;
threadbare: [-]/ˈθredber/; [a]磨破的,衣衫褴褛的,乏味的,俗套的; [^]gre3k;
thrill: [-]/θrɪl/; [n]兴奋,激动,引起激动的事物; [v](使)非常兴奋,(使)非常激动; [^]gre3k;
throng: [-]/θrɔːŋ/; [v]群集,蜂拥; [n]一大群人; [vt]挤向; [^]gre3k;
thwart: [-]/θwɔːrt/; [n]<船>横坐板; [v]阻挠,阻碍,横过; [a]横放的; [ad]横过; prep. 〈古〉横跨,横过; [^]gre3k;
ticklish: [-]/ˈtɪklɪʃ/; [a]不稳定的;难对付的;易倒的;易痒的;忌讳的; [ad]怕痒地; [n]怕痒,小心处理; [^]gre3k;
tiff: [-]/tɪf/; [n]淡酒;一口;口角;生气; [^]gre3k;
tightfisted: [-]/'taɪt'fɪstɪd/; [a]吝啬的; [^]gre3k;
timely: [-]/ˈtaɪmli/; [a]适时的,及时的; [ad]及时地; [^]gre3k;
timeworn: [-]/ˈtaɪmˌwɔrn/; [a]陈腐的; [^]gre3k;
timid: [-]/ˈtɪmɪd/; [a]胆怯的;腼腆的; [^]gre3k;
timorous: [-]/ˈtɪmərəs/; [a]胆小的,胆怯的,羞怯的; [^]gre3k;
tinge: [-]/tɪndʒ/; [n]淡淡的(颜色,神色),轻微,少量; [v]给.染色,轻微地影响; [^]gre3k;
tinker: [-]/ˈtɪŋkər/; [n](流动的)补锅工人; [v]做拙劣修补; [^]gre3k;
tint: [-]/tɪnt/; [n]色彩;染发剂;染色; [v]染色,着色于.; [^]gre3k;
tirade: [-]/ˈtaɪreɪd/; [n]长篇的攻击性演说; [^]gre3k;
toady: [-]/ˈtoʊdi/; [n]谄媚者,拍马屁的人; [v]谄媚,拍马屁; [^]gre3k;
tonic: [-]/ˈtɑːnɪk/; [n]补药;主调音或基音; [a]滋补的;声调的;使精神振作的; [^]gre3k;
topsy-turvy: [-]/ˌtɑːpsi ˈtɜːrvi/; [a]混乱的,不整洁的; [n]颠倒,乱七八糟; [^]gre3k;
torpid: [-]/ˈtɔːrpɪd/; [a]懒散的,死气沉沉的,不活泼的; [^]gre3k;
torpor: [-]/ˈtɔːrpər/; [n]麻木;无感觉;不活泼; [^]gre3k;
torrential: [-]/təˈrenʃl/; [a]汹涌的;奔流的; [ad]似急流地; [^]gre3k;
torrid: [-]/ˈtɔːrɪd/; [a]酷热的,热烈; [^]gre3k;
tortuous: [-]/ˈtɔːrtʃuəs/; [a]弯弯曲曲的,蜿蜒的; [^]gre3k;
tout: [-]/taʊt/; [v]招徕顾客,极力赞扬; [^]gre3k;
toy: [-]/tɔɪ/; [n]玩具; [v]不认真考虑,玩弄; [a]作为玩具的; [^]gre3k;
tractable: [-]/ˈtræktəbl/; [a]易于管教的,易驾驭的,易处理的,驯良的; [^]gre3k;
tranquility: [-]/træŋ'kwɪlətɪ/; [n]安静,平静; [^]gre3k;
transcend: [-]/trænˈsend/; [v]超越(经验,理性,信念等)的范围,超过; [^]gre3k;
transfigure: [-]/trænsˈfɪɡjər/; [v]美观,改观; [^]gre3k;
transgress: [-]/trænzˈɡres/; [v]冒犯,违背;侵犯;越界; [^]gre3k;
transient: [-]/ˈtrænʃnt/; [a]短暂的,路过的;转瞬即逝的; [n]过客; [^]gre3k;
transitory: [-]/ˈtrænsətɔːri/; [a]短暂的,暂时的,瞬息的; [^]gre3k;
translucent: [-]/trænsˈluːsnt/; [a]半透明的;透亮的,有光泽的;易懂的;真实的; [^]gre3k;
transparent: [-]/trænsˈpærənt/; [a]透明的,清澈的,明净的;易识破的,显而易见的; [^]gre3k;
travail: [-]/trəˈveɪl/; [n]分娩的痛苦,艰苦劳动; [v]辛勤努力,经受分娩的阵痛; [^]gre3k;
traverse: [-]/trəˈvɜːrs/; [v]横越;穿过; [n]横越; [^]gre3k;
travesty: [-]/ˈtrævəsti/; [n]滑稽模仿;拙劣的模仿作品;歪曲; [vt]滑稽地模仿;歪曲; [^]gre3k;
treacherous: [-]/ˈtretʃərəs/; [a]不牢靠的,危险的;奸诈的,叛逆的,背叛的; [ad]背信弃义地; [n]背信弃义,背叛; [^]gre3k;
trenchant: [-]/ˈtrentʃənt/; [a]犀利的,锐利的,有力的,清晰的,一针见血的; [^]gre3k;
trepidation: [-]/ˌtrepɪˈdeɪʃn/; [n]恐惧,惶恐; [^]gre3k;
trespass: [-]/ˈtrespæs/; [v]侵入;犯罪; [n]罪过;非法侵入; [^]gre3k;
tribute: [-]/ˈtrɪbjuːt/; [n]致敬;悼念;贡品;称赞; [^]gre3k;
trickle: [-]/ˈtrɪkl/; [v]一滴滴地流;徐徐地流; [n]细流;徐徐地流;稀稀疏疏缓慢来往的东西; [^]gre3k;
trifle: [-]/ˈtraɪfl/; [n]蛋糕;琐事,小事,无价值的东西; [v]嘲笑,轻视; [^]gre3k;
trifling: [-]/ˈtraɪflɪŋ/; [a]细微的,不重要的; [^]gre3k;
trite: [-]/traɪt/; [a]陈腐的;平庸的;老一套的; [^]gre3k;
truant: [-]/ˈtruːənt/; [n]旷课者,懒惰的人; [a]旷课的,偷懒的; [v]逃学,偷懒,逃避责任; [^]gre3k;
truce: [-]/truːs/; [n]停战;休战;休战协定; [^]gre3k;
truculent: [-]/ˈtrʌkjələnt/; [a]好斗的;野蛮的;言词刻毒的; [^]gre3k;
trudge: [-]/trʌdʒ/; [n]长途跋涉,沉重的步伐; [v]跋涉,吃力地走; [^]gre3k;
trumpet: [-]/ˈtrʌmpɪt/; [n]喇叭,小号;小号声;小号手;传声筒; [v]吹喇叭;发出喇叭般的声音;用喇叭吹出;发喇叭似的声音;大声宣布;宣扬; [^]gre3k;
truncate: [-]/ˈtrʌŋkeɪt/; [a]截短的;被删节的; [v]把(某物)截短,去尾; [^]gre3k;
truss: [-]/trʌs/; [n]束;构架;捆; [v]捆绑;用构架支撑; [^]gre3k;
tumult: [-]/ˈtuːmʌlt/; [n]骚动;骚乱;吵闹;激动; [^]gre3k;
turbid: [-]/ˈtɜːrbɪd/; [a]混浊的,紊乱的; [^]gre3k;
turbulent: [-]/ˈtɜːrbjələnt/; [a]湍急的;混乱的,动荡的;骚动的; [^]gre3k;
turgid: [-]/ˈtɜːrdʒɪd/; [a]肿胀的;浮夸的;浮肿的; [^]gre3k;
turmoil: [-]/ˈtɜːrmɔɪl/; [n]骚动,骚乱; [^]gre3k;
turncoat: [-]/ˈtɜːrnkoʊt/; [n]叛徒; [^]gre3k;
turpitude: [-]/ˈtɜːrpətuːd/; [n]邪恶,卑鄙(行为); [^]gre3k;
twig: [-]/twɪɡ/; [n]细枝,嫩枝;末梢;桠枝; [^]gre3k;
tycoon: [-]/taɪˈkuːn/; [n]有钱有势的企业家,大亨; [^]gre3k;
typo: [-]/ˈtaɪpoʊ/; [n]排印错误;排字工;印刷工; [^]gre3k;
tyrant: [-]/ˈtaɪrənt/; [n]暴君; [^]gre3k;
tyro: [-]/ˈtaɪroʊ/; [n]新手; [^]gre3k;
ubiquitous: [-]/juːˈbɪkwɪtəs/; [a]普遍存在的;无所不在的; [^]gre3k;
umbrage: [-]/ˈʌmbrɪdʒ/; [n]不快,愤怒; [^]gre3k;
unanimous: [-]/juˈnænɪməs/; [a]全体一致的;一致同意的; [^]gre3k;
unassailable: [-]/ˌʌnəˈseɪləbl/; [a]无可争辩的,无懈可击的,不可亵渎的; [^]gre3k;
unavailing: [-]/ˌʌnəˈveɪlɪŋ/; [a]无效的,徒劳的; [^]gre3k;
uncanny: [-]/ʌnˈkæni/; [a]神秘的,不可思议的; [^]gre3k;
uncouth: [-]/ʌnˈkuːθ/; [a]笨拙的;粗野的;不舒适的;陌生的; [^]gre3k;
unctuous: [-]/ˈʌŋktʃuəs/; [a]油腔滑调的,虚情假意的; [^]gre3k;
underdog: [-]/ˈʌndərdɔːɡ/; [n]弱势的一方,受害者,输家; [^]gre3k;
undergird: [-]/ˌʌndə'gɜːd/; [v]加强,巩固..的底部; [^]gre3k;
undermine: [-]/ˌʌndərˈmaɪn/; [v]暗中破坏;逐渐削弱;侵蚀.的基础;在...下挖坑道,从根基处损害; [^]gre3k;
underscore: [-]/ˌʌndərˈskɔːr/; [v]强调,加强,划线于.下; [n]底线; [^]gre3k;
unexceptionable: [-]/ˌʌnɪkˈsepʃənəbl/; [a]无懈可击的,完美无缺的,极好的; [^]gre3k;
unflappable: [-]/ˌʌnˈflæpəbl/; [a]镇定自若的;从容不迫的; [^]gre3k;
ungainly: [-]/ʌnˈɡeɪnli/; [a]笨拙的,不雅的; [ad]笨拙地;不雅地; [^]gre3k;
unimpeachable: [-]/ˌʌnɪmˈpiːtʃəbl/; [a]可信的,无可挑剔的; [^]gre3k;
unkempt: [-]/ˌʌnˈkempt/; [a](衣服,头发)不整洁的;蓬乱的; [^]gre3k;
unlettered: [-]/ˌʌnˈletərd/; [a]未受教育的,文盲的; [^]gre3k;
unproductive: [-]/ˌʌnprəˈdʌktɪv/; [a]徒然的,无效的; [^]gre3k;
unrequited: [-]/ˌʌnrɪˈkwaɪtɪd/; [a]无回报的;无报酬的; [^]gre3k;
unruly: [-]/ʌnˈruːli/; [a]不守规矩的;任性的;难驾驭的; [^]gre3k;
untenable: [-]/ʌnˈtenəbl/; [a]防守不住的,站不住脚的; [^]gre3k;
untold: [-]/ˌʌnˈtoʊld/; [a]无数的,数不清的; [^]gre3k;
untoward: [-]/ʌnˈtɔːrd/; [a](困难)出乎意料的; [^]gre3k;
unwitting: [-]/ʌnˈwɪtɪŋ/; [a]不知情的;无意的; [^]gre3k;
upbraid: [-]/ʌpˈbreɪd/; [v]斥责,责骂; [^]gre3k;
uphold: [-]/ʌpˈhoʊld/; [v]维护,支持,举起; [^]gre3k;
urbane: [-]/ɜːrˈbeɪn/; [a]温文尔雅的,懂礼的;都<城>市气派的; [^]gre3k;
usurp: [-]/juːˈzɜːrp/; [vi]篡夺,篡位; [vt]篡夺,强夺; [^]gre3k;
utter: [-]/ˈʌtər/; [v]说,发出;发射; [a]完全的;彻底的;无条件的; [^]gre3k;
vaccinate: [-]/ˈvæksɪneɪt/; [v]进行预防接种; [n]被接种牛痘者; [^]gre3k;
vacillate: [-]/ˈvæsəleɪt/; [v]犹豫;踌躇;摇摆; [^]gre3k;
vacuous: [-]/ˈvækjuəs/; [a]空的,空虚的,空洞的,无意义的; [^]gre3k;
vagary: [-]/'veɪgərɪ/; [n]奇想;奇特行为; [^]gre3k;
vague: [-]/veɪɡ/; [a]含糊的,模糊的,不明确的,茫然的; [n]模糊不定状态; [^]gre3k;
valediction: [-]/ˌvælɪˈdɪkʃn/; [n]告别演说;告别词; [^]gre3k;
valiant: [-]/ˈvæliənt/; [n]勇士,勇敢的人; [a]勇敢的,英勇的; [^]gre3k;
valid: [-]/ˈvælɪd/; [a]有效的,正式认可的;合理的,有根据的; [^]gre3k;
vanquish: [-]/ˈvæŋkwɪʃ/; [v]征服,击败; [^]gre3k;
vapid: [-]/ˈvæpɪd/; [a]索然无味的;无生气的; [ad]乏味地;无滋味地;无趣味地;无生气地; [^]gre3k;
vaporize: [-]/ˈveɪpəraɪz/; [v](使)蒸发;使.蒸发; [^]gre3k;
variance: [-]/ˈveriəns/; [n]变化;<数> 方差;不一致;分歧;变异; [^]gre3k;
variegated: [-]/ˈverɪɡeɪtɪd/; [n]使富有变化,使成为杂色; [a]斑驳的,多色的,富于变化的; [^]gre3k;
varnish: [-]/ˈvɑːrnɪʃ/; [n]清漆;虚饰;光泽面; [v]涂上清漆;使.有光泽; [^]gre3k;
vault: [-]/vɔːlt/; [n]保险库,金库,拱顶,墓室; [v]越过,跳过; [^]gre3k;
vaunt: [-]/vɔːnt/; [v]吹嘘,炫耀; [^]gre3k;
veer: [-]/vɪr/; [n]方向的转变; [v]转向,改变(话题等),放松(绳,缆等); [^]gre3k;
vehement: [-]/ˈviːəmənt/; [a]猛烈的,强烈的; [^]gre3k;
venal: [-]/ˈviːnl/; [a]唯利是图的;贪赃枉法; [^]gre3k;
vendor: [-]/ˈvendər/; [n]小贩,卖主,供应商; [^]gre3k;
veneer: [-]/vəˈnɪr/; [n](镶于劣质东西上的)镶面板;掩饰; [v]虚饰;给.镶以饰片; [^]gre3k;
venerate: [-]/ˈvenəreɪt/; [v]崇敬,敬仰; [^]gre3k;
venial: [-]/ˈviːniəl/; [a]可原谅的,(罪过)轻微的,可宽恕的; [^]gre3k;
venom: [-]/ˈvenəm/; [n]毒液;恶意;怨恨; [vt]使有毒;放毒; [^]gre3k;
veracious: [-]/və'reɪʃəs/; [a]诚实的,说真话的; [^]gre3k;
verbatim: [-]/vɜːrˈbeɪtɪm/; [a]逐字的; [ad]逐字地; [^]gre3k;
verbose: [-]/vɜːrˈboʊs/; [a]冗长的,啰嗦的; [^]gre3k;
verdant: [-]/ˈvɜːrdnt/; [a]青葱的,翠绿的; [^]gre3k;
verify: [-]/ˈverɪfaɪ/; [v]查证,证明,证实; [^]gre3k;
verisimilar: [-]/ˌverə'sɪmələ/; [a]逼真的; [^]gre3k;
vernacular: [-]/vərˈnækjələr/; [a]本国的,地方的,用本地语写成的; [n]方言;土语;(建筑的)民间风格; [^]gre3k;
versatile: [-]/ˈvɜːrsətl/; [a]万能的,综合的,多才多艺的; [^]gre3k;
verse: [-]/vɜːrs/; [n]诗句,诗节,诗; [^]gre3k;
versed: [-]/vɜːrst/; [a]熟练的,精通的; [^]gre3k;
vertigo: [-]/ˈvɜːrtɪɡoʊ/; [n]晕头转向;眩晕; [^]gre3k;
verve: [-]/vɜːrv/; [n]热情,神韵,活力,气魄; [^]gre3k;
vessel: [-]/ˈvesl/; [n]船,容器,血管; [^]gre3k;
vestige: [-]/ˈvestɪdʒ/; [n]遗迹,(生)退化的器官,残余,微量(一般用于否定句); [^]gre3k;
veteran: [-]/ˈvetərən/; [n]老兵;退役军人; [a]经验丰富的;老练的; [^]gre3k;
veto: [-]/ˈviːtoʊ/; [v]否决;投反对票; [n]否决;否决权;禁止; [^]gre3k;
vex: [-]/veks/; [v]使烦恼,使苦恼,使恼怒; [^]gre3k;
viable: [-]/ˈvaɪəbl/; [a]可行的;能养活的;能生育的; [^]gre3k;
vicarious: [-]/vaɪˈkeriəs/; [a]代替别人做的;代理的,代替的;发同感的; [^]gre3k;
vicious: [-]/ˈvɪʃəs/; [a]罪恶的;恶意的;凶猛的,残忍的; [^]gre3k;
vicissitude: [-]/vɪˈsɪsɪtuːd/; [n]变迁,沧桑,兴衰; [^]gre3k;
victimize: [-]/ˈvɪktɪmaɪz/; [v]使受害,使牺牲,欺骗; [^]gre3k;
vigilant: [-]/ˈvɪdʒɪlənt/; [a]警戒的,警惕的; [^]gre3k;
vignette: [-]/vɪnˈjet/; [n]装饰图案;小插图; [v]把..印放为虚光照,晕映; [^]gre3k;
vigorous: [-]/ˈvɪɡərəs/; [a]精力充沛的;强有力的,有活力的;强健的; [^]gre3k;
vile: [-]/vaɪl/; [a]令人讨厌的,恶心的;可恨的;可耻的;简陋的; [^]gre3k;
vilify: [-]/ˈvɪlɪfaɪ/; [v]辱骂,诽谤; [^]gre3k;
vim: [-]/vɪm/; [n]精力,活力; [^]gre3k;
vindicate: [-]/ˈvɪndɪkeɪt/; [vt]证明.无辜;维护,辩护; [^]gre3k;
vindictive: [-]/vɪnˈdɪktɪv/; [a]报复性的,怀恨的,惩罚的; [^]gre3k;
virtuoso: [-]/ˌvɜːrtʃuˈoʊsoʊ/; [n]艺术品鉴赏家,古董收藏家,艺术大师; [a]行家里手的,艺术爱好者的; [^]gre3k;
virtuous: [-]/ˈvɜːrtʃuəs/; [a]善良的,有德行的,贞洁的; [^]gre3k;
virulent: [-]/ˈvɪrələnt/; [a]剧毒的;恶性的;有恶意的; [^]gre3k;
viscid: [-]/ˈvɪsɪd/; [a]黏的,黏质的; [^]gre3k;
viscous: [-]/ˈvɪskəs/; [a]黏的;黏稠的;黏滞的;有黏性的; [^]gre3k;
visionary: [-]/ˈvɪʒəneri/; [n]有远见的人;幻想家; [a]有远见的;爱幻想的; [^]gre3k;
vitality: [-]/vaɪˈtæləti/; [n]活力;生气;生命力; [^]gre3k;
vitiate: [-]/ˈvɪʃieɪt/; [vt]污损,污染,使堕落,使(契约等)无效; [^]gre3k;
vitriolic: [-]/ˌvɪtriˈɑːlɪk/; [a]刻薄的,强烈的,硫酸(盐)的,由硫酸制成的; [^]gre3k;
vituperate: [-]/vaɪ'tjuːpəˌreɪt/; [v]痛斥,辱骂; [^]gre3k;
vivacious: [-]/vɪˈveɪʃəs/; [a]活泼的,快活的(多指女性); [^]gre3k;
vocation: [-]/voʊˈkeɪʃn/; [n]职业;行业;天职;使命; [^]gre3k;
vociferous: [-]/voʊˈsɪfərəs/; [a](表达意见或感情等)大声的,有力的; [^]gre3k;
volatile: [-]/ˈvɑːlətl/; [a]易气化的;爆炸性的;反复无常的;短暂的;不稳定的; [^]gre3k;
volition: [-]/voʊˈlɪʃn/; [n]决定;自主;意志力;下决心;意志力; [^]gre3k;
voluble: [-]/ˈvɑːljəbl/; [a]健谈的,缠绕的,易旋转的; [^]gre3k;
voluminous: [-]/vəˈluːmɪnəs/; [a]大量的;长篇的,多产的;庞大的; [ad]宽松地;容量大地;篇幅长地; [n]宽松;容量大,篇幅长; [^]gre3k;
voluptuous: [-]/vəˈlʌptʃuəs/; [a]撩人的,沉溺酒色的,骄奢淫逸的; [^]gre3k;
voracious: [-]/vəˈreɪʃəs/; [a]狼吞虎咽的,贪婪的; [ad]贪婪地; [n]贪婪,贪吃; [^]gre3k;
votary: [-]/ˈvoʊtəri/; [n]崇拜者,热心支持者; [^]gre3k;
vouch: [-]/vaʊtʃ/; [v]担保;证明;保证; [n]被担保者; [^]gre3k;
voyeur: [-]/vwaɪˈɜːr/; [n]窥淫狂者,窥隐私者; [^]gre3k;
vulgar: [-]/ˈvʌlɡər/; [a]粗俗的;下流的;平民的;通俗的; [n]平民;方言; [^]gre3k;
vulnerable: [-]/ˈvʌlnərəbl/; [a]易受伤的;脆弱的;易受攻击的; [^]gre3k;
waddle: [-]/ˈwɑːdl/; [v](鸭,矮胖子等)摇摇摆摆地走,蹒跚而行; [n]摇摆的步子; [^]gre3k;
waffle: [-]/ˈwɑːfl/; [n]华夫饼干;动听而无意义的话;无聊话; [v]胡扯,含糊其辞; [^]gre3k;
waft: [-]/wɑːft/; [v]使飘荡;吹送; [n]飘荡;吹拂; [^]gre3k;
wag: [-]/wæɡ/; [n]摇摆;爱说笑的人; [v]摇动; [^]gre3k;
wan: [-]/wɑːn/; [a]虚弱的,病态的; [^]gre3k;
wanderlust: [-]/ˈwɑːndərlʌst/; [n]漫游癖;憧憬流浪; [^]gre3k;
wane: [-]/weɪn/; [n]衰退(期);月亏(期);减少; [v](月)缺损;(光,势力,治理等)衰落;减少; [^]gre3k;
wanting: [-]/ˈwɑːntɪŋ/; [a]欠缺的,不足的,不够格的; prep. 缺; [^]gre3k;
warmonger: [-]/ˈwɔːrmʌŋɡər/; [n]战争贩子,好战者; [^]gre3k;
warp: [-]/wɔːrp/; [n]弯曲,歪曲,偏见; [v]使变形,使有偏见,曲解; [^]gre3k;
warrant: [-]/ˈwɔːrənt/; [n]逮捕证;正当理由;凭证; [v]使正当; [^]gre3k;
wary: [-]/ˈweri/; [a]谨慎的,小心的,提防的;考虑周到的; [^]gre3k;
wastrel: [-]/ˈweɪstrəl/; [n]败家子,挥霍无度的人; [^]gre3k;
watershed: [-]/ˈwɔːtərʃed/; [n](美)流域;分水岭;集水区;转折点;重要关头; [a]标志转折点的; [^]gre3k;
wax: [-]/wæks/; [n]蜡;蜡状物; [v]给.上蜡;给.打蜡,给.上蜡;渐渐变大;变为;(月亮)渐圆,渐盈; [a]蜡制的; [^]gre3k;
waylay: [-]/weɪˈleɪ/; [v]埋伏,伏击; [^]gre3k;
wayward: [-]/ˈweɪwərd/; [a]任性的,不规则的,刚愎的; [^]gre3k;
welter: [-]/ˈweltər/; [n]混乱;滚浪;翻滚;起伏; [v]翻滚;沉溺;起伏; [a]负重赛马的; [^]gre3k;
wheedle: [-]/ˈwiːdl/; [v]以甜言蜜语诱惑,用甜言蜜语欺骗; [^]gre3k;
whet: [-]/wet/; [v]刺激;磨快;促进; [n]磨;开胃物;刺激物; [^]gre3k;
whiff: [-]/wɪf/; [n]一吹,一吸,一阵香气,一点点,香烟的一口; [v]轻轻地吹,喷气,<棒>三击出局; [^]gre3k;
whimsical: [-]/ˈwɪmzɪkl/; [a]古怪的,异想天开的; [^]gre3k;
wholesome: [-]/ˈhoʊlsəm/; [a]有益于健康的;有益的; [^]gre3k;
wicked: [-]/ˈwɪkɪd/; [a]邪恶的,恶毒的;淘气的,恶作剧的; [n]恶人;邪恶的人; [ad]用作加强语气用; [^]gre3k;
willful: [-]/ˈwɪlfl/; [a]有意的,任性的,故意的; [^]gre3k;
willy-nilly: [-]/ˌwɪli ˈnɪli/; [a]犹豫不决的,不容分辨的,随意的; [ad]乱七八糟地,不管愿不愿意地; [^]gre3k;
wilt: [-]/wɪlt/; [v]使.凋谢,枯萎; [n]枯萎;憔悴; [^]gre3k;
wily: [-]/ˈwaɪli/; [a]狡猾的; [^]gre3k;
wince: [-]/wɪns/; [v]避开,畏缩; [n]畏缩;脸部肌肉的抽搐; [^]gre3k;
windbag: [-]/ˈwɪndbæɡ/; [n]风囊,饶舌之人; [^]gre3k;
winsome: [-]/ˈwɪnsəm/; [a]迷人的;可爱的;漂亮的; [^]gre3k;
wiretap: [-]/ˈwaɪərtæp/; [n]窃听装置;窃听; [v]偷听,窃听; [^]gre3k;
wistful: [-]/ˈwɪstfl/; [a]渴望的,向往的;深思的;留恋的; [^]gre3k;
wit: [-]/wɪt/; [n]富有机智的人;智力,才智;机智;风趣,措辞巧妙的能力; [^]gre3k;
withdraw: [-]/wɪðˈdrɔː/; [v]取款;撤退,收回,撤离; [^]gre3k;
wither: [-]/ˈwɪðər/; [v]枯萎;凋谢; [vt]使枯萎,使凋谢,萎缩;使人感觉羞惭或迷惑; [^]gre3k;
withhold: [-]/wɪðˈhoʊld/; [v]抑制,拒绝给某事物; [^]gre3k;
wizen: [-]/'wɪzən/; [v](使)凋谢,(使)枯萎; [a]凋谢的,枯萎的; [^]gre3k;
wobble: [-]/ˈwɑːbl/; [v]摇晃;摇摆;游移不定; [n]摆动;摇晃;不稳定; [^]gre3k;
worldly: [-]/ˈwɜːrldli/; [a]世间的,尘世的;世俗的; [ad]世故地; [^]gre3k;
worship: [-]/ˈwɜːrʃɪp/; [v]崇拜,爱戴;做礼拜,拜神; [n]礼拜,礼拜仪式;崇拜,敬仰; [^]gre3k;
wrangle: [-]/ˈræŋɡl/; [n]争论,争吵; [vi]争论,争吵,口角; [vt]辩驳,放牧; [^]gre3k;
wrest: [-]/rest/; [n]扭,拧; [vt]用力拧;强夺;歪曲; [^]gre3k;
wretched: [-]/ˈretʃɪd/; [a]可怜的;恶劣的;身心疲惫的; [^]gre3k;
wrongheaded: [-]/'rɒŋhedɪd/; [a]固执己见的,坚持(错误观点)的; [^]gre3k;
wry: [-]/raɪ/; [a]歪斜的,扭歪的,歪曲的; [v]歪曲,扭曲;扭转; [^]gre3k;
xenophobe: [-]/'zenəˌfoʊb/; [n]仇视(或畏惧)外国人(或外国事物)者; [^]gre3k;
yoke: [-]/joʊk/; [n]牛轭;枷锁;纽带; [v]结合;连结; [^]gre3k;
yokel: [-]/ˈjoʊkl/; [n]乡巴佬;庄稼汉; [^]gre3k;
zeal: [-]/ziːl/; [n]热情,热心; [^]gre3k;
zealot: [-]/ˈzelət/; [n]狂热份子,犹太教狂热信徒; [^]gre3k;
zenith: [-]/ˈziːnɪθ/; [n]顶点,顶峰;全盛; [^]gre3k;
zesty: [-]/ˈzesti/; [a]刺激的,开胃的; [^]gre3k;
