leave sth/sb out: [a]/liːv ˈsʌmθɪŋ ˈsʌmbədi aʊt/; [phr]遗漏,不考虑;
in stock: [a]/ɪn stɒk/; [phr]有存货;
stick to sb/sth: [a]/stɪk tu ˈsʌmbədi (ˈsʌmθɪŋ)/; [phr]忠于;
come along: [a]/kʌm ə'lɔːŋ/; [phr]一起;进步;出现;
look for: [a]/lʊk fɔr/; [phr]寻找;期待;
keep away (from): [a]/kiːp əˈweɪ frʌm/; [phr]远离,回避;
be all set: [a]/bi ɔl set/; [phr]准备就绪;
take sth back: [a]/teɪk ˈsʌmθɪŋ bæk/; [phr]收回;取回;
find fault with: [a]/faɪnd fɔlt wɪθ/; [phr]埋怨,挑剔;
look down on: [a]/lʊk daʊn ɑːn/; [phr]轻视;
bear with (sb): [a]/ber wɪθ ˈsʌmbədi/; [phr]耐心等待;宽容;
stand out: [a]/stænd aut/; [phr]突出;继续抵抗;
live up to: [a]/lɪv ʌp tu/; [phr]不辜负;做到;
make for sb(sth.): [a]/meɪk fɔːr ˈsʌmbədi ˈsʌmθɪŋ/; [phr]有助于;促进;走向;
stand by sth: [a]/stænd baɪ ˈsʌmθɪŋ/; [phr]信守;支持;
on behalf of: [a]/ɔn bɪˈhæf ɑv/; [phr]代表.,为了.;
on the air: [a]/ɔn ðə er/; [phr]直播中;
pay for: [a]/peɪ fɔr/; [phr]付出代价,出钱;因.受处罚,为.而付钱;
permeate through (among): [a]/ˈpɜːrmieɪt θruː əˈmʌŋ/; [phr]渗透,透入;
pull through: [a]/pʊl θru/; [phr]渡过难关;恢复健康;
settle down: [a]/ˈset(ə)l daʊn/; [phr]定居,安定下来;
hold back: [a]/hoʊld bæk/; [phr]阻挡,抑制,控制; [v]隐瞒;
come upon: [a]/kʌm əˈpɑn/; [phr]遇到;对⋯⋯有感觉;突然⋯⋯想做;
bring about: [a]/brɪŋ əˈbaʊt/; [phr]导致,引起;
for the most part: [a]/fɔr ðə moʊst pɑrt/; [phr]多半;通常;在极大程度上;
merge into: [a]/mɜrdʒ ˈɪntu/; [phr]合并;结合;
carry out: [a]/ˈkærɪ aʊt/; [phr]执行,实行;实现;完成;
consist of: [a]/kənˈsɪst ɑv/; [phr]由..组成;
go off: [a]/ɡoʊ ɑf/; [phr]爆炸;进行;变质;
get off: [a]/ɡet ɑf/; [phr]动身;免于受罚;从..下来;把手拿开;
get on: [a]/ɡet ɔːn/; [phr]上车(飞机,船),进展,使前进;
look back (on sth): [a]/lʊk bæk ɒn ˈsʌmθɪŋ/; [phr]回顾;
the present day: [a]/ˌpreznt ˈdeɪ/; [phr]现代;
come apart: [a]/kʌm əˈpɑrt/; [phr]破碎;瓦解;崩塌;
get away: [a]/ɡet, əˈweɪ/; [phr]离开,逃脱;
get down to business: [a]/ɡet daʊn tu ˈbɪznəs/; [phr]着手干正事;
get into: [a]/ɡet ˈɪntu/; [phr]穿上;陷入,染上(习惯);对.有兴趣;
get nowhere: [a]/ɡet ˈnoʊˌhwer/; [phr](使)无进展;行不通;
go by: [a]/ɡoʊ baɪ/; [phr]走过,过去;(时间)流逝;
hard and fast: [a]/hɑrd ənd fæst/; [phr](规则等)严格的,不容改变的;
keep in with sb: [a]/kiːp ɪn wɪθ ˈsʌmbədi/; [phr]与(某人)友好相处;
let alone: [a]/let əˈloʊn/; [phr]听任;不打扰;更别说;
make off: [a]/meɪk ɑf/; [phr]逃走;离开;匆忙离开;
on account of: [a]/ɑːn ə'kaʊnt əv/; [phr]因为;
pass sb/sth by: [a]/pæs ˈsʌmbədi ˈsʌmθɪŋ baɪ/; [phr]经过,走过;打..旁边走过;忽视;
pay sb back for sth: [a]/peɪ ˈsʌmbədi bæk fɔːr ˈsʌmθɪŋ/; [phr]向.报复,报答;
reckon on: [a]/ˈrekən ɔn/; [phr]依赖;估计;计划;指望;
say to oneself: [a]/seɪ tu wʌnˈself/; [phr]心中暗想;自言自语;
look forward to: [a]/lʊk ˈfɔːrwərd tu/; [phr]盼望;
go down: [a]/ɡoʊ daʊn/; [phr]下降;平静下来;被接受;
live through: [a]/lɪv θru/; [phr]度过;
come to nothing: [a]/kʌm tu ˈnʌθɪŋ/; [phr]失败,落空;
take to sth(sb): [a]/teɪk tu ˈsʌmθɪŋ ˈsʌmbədi/; [phr]喜欢;养成.习惯;
lay sth aside: [a]/leɪ ˈsʌmθɪŋ əˈsaɪd/; [phr]储蓄;放一边;
go into: [a]/ɡoʊ ˈɪntu/; [phr]进入;加入;变得;探究;
take sth apart: [a]/teɪk ˈsʌmθɪŋ əˈpɑːrt/; [phr]拆开;
out of line (with): [a]/aʊt ʌv laɪn wɪθ/; [phr]跟.(不)一致;
cut sth/sb down: [a]/kʌt ˈsʌmθɪŋ ˈsʌmbədi daʊn/; [phr]砍倒;削减;说服某人降价;
in the air: [a]/ɪn ðə er/; [phr]在空中;悬而未决;在流传中;
stand off: [a]/stænd ɑf/; [phr]远离;疏远;
live with: [a]/lɪv wɪθ/; [phr]接受,忍受;同居;
bring up: [a]/brɪŋ ʌp/; [phr]养育;呕出;提出;
hold on: [a]/həʊld ɒn/; [phr]坚持;不挂断;稍等;紧紧抓住;
learn/know sth by heart: [a]/lɜːrn noʊ ˈsʌmθɪŋ baɪ hɑːrt/; [phr]记住,背下;
call/sth off: [a]/kɔːl ˈsʌmθɪŋ ɑːf/; [phr]停止;
all out: [a]/ˌɔːl ˈaʊt/; [phr]全力以赴;
do away with: [a]/doʊ əˈweɪ wɪθ/; [phr]废除;消灭;去掉;
hang on: [a]/hæŋ ɔn/; [phr]坚持下去;不挂断;稍等;握住不放;
keep off: [a]/kip ɑf/; [phr]让开;不接近;
look after: [a]/lʊk ˈæftər/; [phr]照顾,照看;
back sb up: [a]/bæk ˈsʌmbədi ʌp/; [phr]支持某人;
back down (from): [a]/bæk daʊn frəm/; [phr]投降,认输;
hold the line: [a]/hoʊld ðə laɪn/; [phr]坚持下去;不挂断电话;
leave sb/sth alone: [a]/liːv ˈsʌmbədi ˈsʌmθɪŋ əˈloʊn/; [phr]不干涉某人(某事);
leave sb/sth behind: [a]/liːv ˈsʌmbədi ˈsʌmθɪŋ bɪˈhaɪnd/; [phr]忘带,留下;
check out: [a]/tʃek aʊt/; [phr]结账后离开,检验,通过考核,合格;
break down: [a]/brek daʊn/; [phr]发生故障;失败;(精神)垮下来;
feel for: [a]/fil fɔr/; [phr]同情;
lose face: [a]/luz feɪs/; [phr]丢面子;
curriculum vitae: [a]/kəˌrɪkjələm ˈviːtaɪ/; [phr]简短的履历书;
lay bare: [a]/leɪ ber/; [phr]揭发;暴露;公开;
lay/sth bare: [a]/leɪ ˈsʌmθɪŋ ber/; [phr]显示;揭露;
look round: [a]/lʊk raʊnd/; [phr]四处看;寻找;
be better off: [a]/bi ˈbetər ɑf/; [phr]较富裕;更好;
get out: [a]/ɡet aʊt/; [phr]出去;逃脱;泄露;
bring back: [a]/briŋbæk/; [phr]拿回来;使.回忆起来;
go after sb/sth: [a]/ɡoʊ ˈæftər ˈsʌmbədi ˈsʌmθɪŋ/; [phr]追求,追逐;
keep an eye on: [a]/kiːp æn aɪɑːn/; [phr]密切注视;
take off: [a]/teɪk, ɒf/; [phr](飞机)起飞;拿掉;取消;脱衣;(事业)突然成功,突然蹿红;
fall back on: [a]/fɔl bæk ɔn/; [phr]求助于;
look over: [a]/lʊk ˈoʊvər/; [phr]检查;
take-away: [a]/teɪk əˈweɪ/; [phr]外带,外卖;
call on: [a]/kɔːl ɑːn/; [phr]拜访,呼吁,请求;
take sth to heart: [a]/teɪk ˈsʌmθɪŋ tu hɑːrt/; [phr]牢记;为某事耿耿于怀;
look sth up: [a]/lʊk ˈsʌmθɪŋ ʌp/; [phr]查字典;
all the same to: [a]/ɔl ðə seɪm tu/; [phr]对.说来都一样;无所谓;
at its best: [a]/ət ɪts best/; [phr]处在最好状态;
hang up: [a]/hæŋ ʌp/; [phr]挂断电话;
go back: [a]/ɡoʊ bæk/; [phr]回去;追溯;
be on good terms (with sb): [a]/biː ɔːn ɡʊd tɜːrmz wɪθ ˈsʌmbədi/; [phr]关系好;
hold one's ground: [a]/hold wʌnz ɡraʊnd/; [phr]坚持立场;
clear out: [a]/klɪr aʊt/; [phr]匆忙离开;逃离;清空;腾空;
look at: [a]/lʊk ət/; [phr]看,浏览,检查;
come about: [a]/kʌm ə'baʊt/; [phr]发生;
come off: [a]/kʌm ɑf/; [phr]从..掉下,发生,举行,(计划)实现;
live on: [a]/liːv ɑːn/; [phr]以.为主食;靠.生活;
come on: [a]/kʌm ɔn/; [phr]来吧;发展;开始;
go over: [a]/ɡoʊ ˈoʊvər/; [v]仔细检查; [phr]复习,重温;
get the better of: [a]/ɡet ðə ˈbetər ɑv/; [phr]打败;
take sth off: [a]/teɪk ˈsʌmθɪŋ ɑːf/; [phr]除去;取消;脱掉;
the pick of: [a]/ðə pɪk ɑv/; [phr]精华,最好部分;
learn sth the hard way: [a]/lɜːrn ˈsʌmθɪŋ ðə hɑːrd weɪ/; [phr]经过艰难困苦而学到;
come round(around): [a]/kʌm raʊnd əˈraʊnd/; [phr]绕道而来;过访;重又来到;改变主意;苏醒;
take sth upon oneself: [a]/teɪk ˈsʌmθɪŋ əˈpɔːn wʌnˈself/; [phr]承担;担任;
have one's hands full: [a]/hæv wʌnz hændz fʊl/; [phr]忙得不可开交;手头事情应接不暇;离不开手;
at fault: [a]/ət fɔlt/; [phr]⋯⋯过错,⋯⋯责任;
do sth with a bad grace: [a]/duː ˈsʌmθɪŋ wɪð ə bæd ɡreɪs/; [phr]勉强做某事;
make one's day: [a]/meɪk wʌnz deɪ/; [phr]使某人快活;
go (very) far: [a]/ɡoʊ ˈveri fɑːr/; [phr]成功;扬名;大有前途;
at the outset: [a]/ət ðə ˈaʊtˌset/; [phr]在开头时;
lose one's bearings: [a]/luːz wʌnz ˈberɪŋs/; [phr]迷失方向;不知所措;
go up: [a]/ɡoʊ ʌp/; [phr]上升;被建立;被炸毁;
stick up: [a]/stɪk ʌp/; [phr]竖起;
go with sb/sth: [a]/ɡoʊ wɪθ ˈsʌmbədi ˈsʌmθɪŋ/; [phr]陪伴.去;与.相配;
keep to the beaten track: [a]/kip tu ðə ˈbit(ə)n træk/; [phr]循规蹈矩;
get round to doing sth: [a]/ɡet raʊnd tu ˈduːɪŋ ˈsʌmθɪŋ/; [phr]抽出时间做;
to one's face: [a]/tu wʌnz feɪs/; [phr]坦白地;当面;
have one's say: [a]/hæv wʌnz seɪ/; [phr]利用机会发表意见;
catch on: [a]/kætʃ ɔn/; [phr]变得流行;理解;
cash crop: [a]/ˈkæʃ krɑːp/; [phr]经济作物;
end up: [a]/end ʌp/; [phr]以.告终;
come down: [a]/kʌm daʊn/; [phr]倒塌;下降,下来;
be hard to say: [a]/bi hɑrd tu seɪ/; [phr]难以开口;
come to terms (with sb): [a]/kʌm tu tɜːrmz wɪθ ˈsʌmbədi/; [phr]与..达成协议;
for one thing: [a]/fɔr wʌn θɪŋ/; [phr]首先;一则;
on and on: [a]/ɔn ənd ɔn/; [phr]继续不停地;
pass on: [a]/pæs ɔn/; [phr]传给;去世;
pull sth down: [a]/pʊl ˈsʌmθɪŋ daʊn/; [phr]摧毁;破坏;拆除;
set off: [a]/set ɑf/; [phr]出发;
settle (sb) in: [a]/ˈsetl ˈsʌmbədi ɪn/; [phr]迁入(新居),(使)习惯;
sort sth out: [a]/sɔːrt ˈsʌmθɪŋ aʊt/; [phr]分类,拣选,整理;解决;消除误会;
speak one's mind: [a]/spik wʌnz maɪnd/; [phr]直言不讳,吐露心声;
take sb off: [a]/teɪk ˈsʌmbədi ɑːf/; [phr]带走;
give way to: [a]/ɡɪv weɪ tu/; [phr]让位于..;让路;
as opposed to: [a]/æz ə'poʊʊzd tu/; [phr]与.形成对照;
be on to: [a]/bi ɔn tu/; [phr]意识到,识透;找..岔子;
give oneself up: [a]/ɡɪv wʌnˈself ʌp/; [phr]自首;投降;
hand sth out: [a]/hænd ˈsʌmθɪŋ aʊt/; [phr]分发;
hand sth over to sb: [a]/hænd ˈsʌmθɪŋ ˈoʊvər tu ˈsʌmbədi/; [phr]移交;
open one's eyes to: [a]/ˈoʊpən wʌnz aɪz tu/; [phr]使某人看清;
pull sth off: [a]/pʊl ˈsʌmθɪŋ ɑːf/; [phr]努力实现;
take sb out: [a]/teɪk ˈsʌmbədi aʊt/; [phr]带.出去;淘汰出局;
hold out (against): [a]/hoʊld aʊt əˈɡeɪnst/; [phr]坚持(反抗),顶住;
in sb's favour: [a]/ɪn ˈsʌmbədiz ˈfeɪvər/; [phr]对某人有利;偏爱;
get down to: [a]/ɡet daʊn tu/; [phr]开始认真对待;着手处理;
null and void: [a]/nʌl ənd vɔɪd/; [phr]无效的;
back and forth: [a]/bæk ənd fɔrθ/; [phr]来回地;
regardless of: [a]/rɪˈɡɑːrdləs əv/; [phr]不论,不管;
all but: [a]/ɔl bət/; [phr]几乎;差不多;除.以外所有的;
apart from: [a]/əˈpɑːrt frəm/; [phr]除..之外;
waste disposal: [a]/weɪst dɪˈspoʊz(ə)l/; [phr]废物处理;
living quarters: [a]/ˈlɪvɪŋ ˈkwɔːrtərs/; [phr]住处;
account for: [a]/əˈkaʊnt fɔr/; [phr]解释,说明;(在数量方面)占;对.负责;导致,引起;
equilateral triangle: [a]/ˌiːkwɪˌlætərəl ˈtraɪæŋɡl/; [phr]等边三角形;
wipe out: [a]/waɪp aʊt/; [phr]消灭;
deal with: [a]/dil wɪθ/; [phr]处理;研究;
follow suit: [a]/‘fɔləusuːt/; [phr]学样,照着做;
testify to: [a]/ˈtestɪˌfaɪ tu/; [phr]证实;
light bulb: [a]/ˈlaɪt bʌlb/; [phr]灯泡;
critical point: [a]/ˈkrɪtɪk(ə)l pɔɪnt/; [phr]临界点;
feed on: [a]/fid ɔn/; [phr]以..为食;
snack bar: [a]/ˈsnæk bɑːr/; [phr]快餐馆;小吃店;
ward off: [a]/wɔrd ɑf/; [phr]避开;挡住;
a great deal: [a]/ə ɡreɪt dil/; [phr]丰富;大量;
a pivotal figure: [a]/eɪ ˈpɪvətl ˈfɪɡjər/; [phr]关键人物;
an army of: [a]/ən ˈɑrmi ɑv/; [phr]大群的,大量的;
be characterized by: [a]/biː ˈkærəktəraɪzd baɪ/; [phr]以.为特征,典型代表;
be informed about: [a]/bi ɪnˈfɔrmd əˈbaʊt/; [phr]熟悉,知晓;
behave oneself: [a]/biˈheɪv wʌnˈself/; [phr]举止得体,端庄;
believe in: [a]/bɪˈliv ɪn/; [phr]相信;
belong to: [a]/bɪˈlɔŋ tu/; [phr]属于;
big deal: [a]/bɪɡ dil/; [phr]重大的事,重要的人;
biological diversity: [a]/ˌbaɪəˌlɑːdʒɪkl daɪˈvɜːrsəti/; [phr]生物多样性;
boiling point: [a]/ˈbɔɪlɪŋ pɔɪnt/; [phr]沸点;
break apart: [a]/breɪk əˈpɑrt/; [phr]分开,分裂;
break out: [a]/breikaut/; [phr]爆发;发生;越狱;摆脱,逃脱;
break up: [a]/breikʌp/; [phr]关系破裂,离异,结束,散会,解散,驱散,衰弱;
cast away: [a]/kæst əˈweɪ/; [phr]使漂流;抛弃;
comply with: [a]/kəmˈplaɪ wɪθ/; [phr]遵从,符合;
confined to bed: [a]/kənˈfaɪnd tu bed/; [phr]卧病不起的;
coral reef: [a]/ˈkɔrəl rif/; [phr]珊瑚礁;
coupled with: [a]/'kʌpld wɪθ/; [phr]加之;结合;
dash off: [a]/dæʃ ɑf/; [phr]匆忙地把.写好;
depend on: [a]/dɪˈpend ɔn/; [phr]依靠;取决于;
dispense with: [a]/dɪˈspens wɪθ/; [phr]免除;省却;
dispose of: [a]/dɪˈspoʊz ɑv/; [phr]解决;处理,安排;
dividing line: [a]/dɪˈvaɪdɪŋ laɪn/; [phr]分界线;
draw out: [a]/drɔ aʊt/; [phr]拉;抽;使离开;延长;鼓励说出;
draw up: [a]/drɔ ʌp/; [phr]起草;停靠在;
drop in: [a]/drɑp ɪn/; [phr]顺便拜访;
engage in: [a]/ɪnˈɡeɪdʒ ɪn/; [phr]从事于;参加;
exempt from: [a]/ɪɡˈzempt frɒm/; [phr]豁免;免除;
lunar eclipse: [a]/ˈlunər ɪˈklɪps/; [phr]月蚀,月食;
mistrustful of: [a]/ˌmɪs'trʌstfl ɑv/; [phr]不相信,怀疑;
most distinctive: [a]/moʊst dɪˈstɪŋktɪv/; [phr]最杰出的;
native to: [a]/ˈneɪtɪv tu/; [phr]土生土长的;
natural gas: [a]/ˌnætʃrəl ˈɡæs/; [phr]天然气;
object to: [a]/əbˈdʒekt tu/; [phr]反对;
pack animal: [a]/ˈpæk ænɪml/; [phr]畜(如马;骆驼等);
pack down: [a]/pæk daʊn/; [phr]填塞,夯实;
postal service: [a]/ˈpoʊstl sɜːrvɪs/; [phr]邮政服务;
preside over: [a]/ˌpriˈzaɪd ˈoʊvər/; [phr]主持,掌管;
presidential election: [a]/ˌprezɪˈdenʃ(ə)l ɪˈlekʃ(ə)n/; [phr]总统选举;
prime number: [a]/ˌpraɪm ˈnʌmbər/; [phr]质数;
pry open: [a]/praɪ ˈoʊpən/; [phr]撬开;
sea cucumber: [a]/ˌsiː ˈkjuːkʌmbər/; [phr]海参;
set aside for: [a]/set əˈsaɪd fɔr/; [phr]专门留..给;
shuffle the deck: [a]/ˈʃʌf(ə)l ðə dek/; [phr]洗牌;
slip one's mind: [a]/slɪp wʌnz maɪnd/; [phr]忘记;
smoke detector: [a]/smoʊk dɪˈtektər/; [phr]烟雾探测器;
solar cell: [a]/ˌsoʊlər ˈsel/; [phr]太阳能电池;
solar eclipse: [a]/ˈsoʊlər ɪˈklɪps/; [phr]日食;
spring up: [a]/sprɪŋ ʌp/; [phr]出现,产生;
stand in the way of: [a]/stænd ɪn ðə weɪ ɑv/; [phr]挡住.的道路,阻止;
take into account: [a]/teɪk ˈɪntu əˈkaʊnt/; [phr]重视,考虑;
teem with: [a]/tim wɪθ/; [phr]富有;拥有大量,充满;
to and fro: [a]/tu ənd froʊ/; [phr]往复,来来回回;
usher in: [a]/ˈʌʃər ɪn/; [phr]迎接;传报;引发;产生,开创;引领;
wear away: [a]/wer əˈweɪ/; [phr]磨去;
well organized: [a]/wel ˈɔrɡəˌnaɪzd/; [phr]有组织的;
artificial leg: [a]/ˌɑrtɪˈfɪʃ(ə)l leɡ/; [phr]假腿;
wear out: [a]/wer aʊt/; [phr]用坏,磨损; [v]使...筋疲力尽;
express train: [a]/ɪkˈspres treɪn/; [phr]特快列车;
fend for oneself: [a]/fend fɔr wʌnˈself/; [phr]自己谋生;
field research: [a]/fild ˈriˌsɜrtʃ/; [phr]野外实地考察;
flock to: [a]/flɑk tu/; [phr]成群结队地去;
get in the way of: [a]/ɡet ɪn ðə weɪ ɑv/; [phr]阻挡;
go broke: [a]/ɡoʊ broʊk/; [phr]破产;
gravitational field: [a]/ˌɡrævɪˈteɪʃən(ə)l fild/; [phr]重力场;
gravitational pull: [a]/ˌɡrævɪˈteɪʃən(ə)l pʊl/; [phr]地心引力;
grazing land: [a]/'ɡreɪzɪŋ lænd/; [phr]牧场,草场;
horror film/movie: [a]/ˈhɔrər fɪlm ˈmuvi/; [phr]恐怖片;
ice cream cone: [a]/aɪs krim koʊn/; [phr]冰淇淋蛋卷;
immune system: [a]/ɪˈmjuːn sɪstəm/; [phr]免疫系统;
in accord with: [a]/ɪn əˈkɔrd wɪθ/; [phr]与.一致;
in common: [a]/ɪn ˈkɑmən/; [phr]相同的,共有,有共同之处;
in terms of: [a]/ɪn tɜːrmz əv/; [phr]就.而论;用..字眼;依据;
inorganic chemical: [a]/ˌɪnɔrˈɡænɪk ˈkemɪk(ə)l/; [n]无机化合物; [phr]无机化学;
learn by rote: [a]/lɜrn baɪ roʊt/; [phr]死记硬背学习;
log cabin: [a]/ˌlɔːɡ ˈkæbɪn/; [phr]小木屋;
all in all: [a]/ɔːl ɪn ɔːl/; [phr]总而言之;总的来说;
as for: [a]/əz fɔr/; [phr]至于,就.方面说;
get over: [a]/ɡet ˈoʊvər/; [phr]克服;恢复;熬过;原谅;
in one: [a]/ɪn wʌn/; [phr]成为一体;只试一次;
not to say: [a]/nɑːt tə seɪ/; [phr]并不是说;
set in: [a]/set ɪn/; [phr]开始;到来;生效;流行;设置(戏剧,小说等的)背景;上涨;插入;
give way (to sth): [a]/ɡɪv weɪ tuː ˈsʌmθɪŋ/; [phr]给.让路;为.所代替;
make sth up: [a]/meɪk ˈsʌmθɪŋ ʌp/; [phr]补足;弥补;编造;虚构;组成;准备;
pass sth off: [a]/pæs ˈsʌmθɪŋ ɔːf/; [phr]冒充,假装;蒙混过去,敷衍过去,搪塞过去;
scale up (down): [a]/skeɪl ʌp daʊn/; [phr]按比例增加(或降低);
check in: [a]/tʃek ɪn/; [phr]报到,记录;登记入住;
on purpose: [a]/ɒn, ‘pə:pəs/; [phr]故意;
according to: [a]/əˈkɔːrdɪŋ tu/; [phr]根据,据..所说;
shut off: [a]/ʃʌt ɑf/; [phr]关掉(煤气等),切断,使隔绝,脱离;
die out: [a]/daɪ aʊt/; [phr]灭绝,绝种;
prior to: [a]/ˈpraɪr tu/; [phr]在..之前;
list price: [a]/ˈlɪst praɪs/; [phr]目录价格,标价;
pull away: [a]/pʊl əˈweɪ/; [phr]脱身,离开,脱出;
odd number: [a]/ɑd ˈnʌmbər/; [phr]奇数;
break through: [a]/breɪk, θruː/; [phr]突破;突围;
couch potato: [a]/ˈkaʊtʃ pəteɪtoʊ/; [phr]终日懒散在家的人,电视迷,成天看电视的人;
cover up: [a]/ˈkʌvə(r), ʌp/; [phr]掩盖;掩饰;盖住;裹住;
dress up: [a]/dres, ʌp/; [phr]盛装,打扮,装饰;
drop out: [a]/drɔp aut/; [phr]退学;拒绝传统社会;放弃;退出;辍学;不参与;离去;
emergency exit: [a]/i'mə:dʒənsi 'eksit, 'eɡ zit/; [phr]紧急出口,太平门;
eye contact: [a]/ai  'kɔntækt/; [phr]目光接触,眼神交会;
fall over: [a]/fɔl ˈovɚ/; [phr]跌倒,从..掉下来,落在.上,叛变,颠覆;
food chain: [a]/ˈfuːd tʃeɪn/; [phr]食物链;
give in: [a]/ɡɪv ɪn/; [phr]屈服,让步;投降;
grow up: [a]/ɡrəʊ ʌp/; [phr]长大成人,成长;
hot pot: [a]/'hɔt pɔt/; [phr]火锅;
look out: [a]/lʊk aʊt/; [phr]当心,留神;
lost and found: [a]/ˌlɔːst ən ˈfaʊnd/; [phr]失物招领处;
make faces: [a]/meɪk feɪs/; [phr]做鬼脸;
make up: [a]/meɪk, ʌp/; [phr]组成;补足;化妆;编造;
mix up: [a]/mɪks ʌp/; [phr]混和,混淆;
pass by: [a]/pɑːs  baɪ/; [phr]经过;
point of view: [a]/ˌpɔɪnt əv ˈvjuː/; [phr]观点,见地,立场;
put out: [a]/pʊt aʊt/; [phr]扑灭,熄灯;
throw/sth away: [a]/θrəʊ, əˈweɪ/; [phr]扔掉;
virtual reality: [a]/ˌvɜːrtʃuəl riˈæləti/; [phr]虚拟现实;
zebra crossing: [a]/ˌzebrə ˈkrɔːsɪŋ/; [phr]人行横道线(斑马线);
simple interest: [a]/ˌsɪmpl ˈɪntrəst/; [phr]单利;
every now and then: [a]/ˈevriː naʊ ənd ðen/; [phr]不时;
range from...to...: [a]/reɪndʒ frəm tu/; [phr]从.到.的范围;在.中变化;
side effect: [a]/ˈsaɪd ɪfekt/; [phr]副作用;
do with: [a]/duː wɪθ/; [phr]需要;
take sb in: [a]/teɪk ˈsʌmbədi ɪn/; [phr]收留;欺骗;带到警察局;
be on edge: [a]/bi ɑn ɛdʒ/; [phr]紧张不安;
prone to: [a]/proʊn tu/; [phr]易于..的;
gold rush: [a]/ˈɡoʊld rʌʃ/; [phr]淘金热;
susceptible to: [a]/səˈseptəb(ə)l tu/; [phr]易受..影响的;
per capita: [a]/pər ˈkæpɪtə/; [phr]人均;
take pains to do: [a]/teɪk peɪnz tu doʊ/; [phr]尽力去做;费劲苦心做某事;
natural number: [a]/ˌnætʃrəl ˈnʌmbər/; [phr]自然数;
speak out: [a]/spik aʊt/; [phr]大胆地说,清楚和响亮地说;
take precedence over: [a]/teɪk ˈpresɪdəns ˈoʊvər/; [phr]优先于..,地位在..之上;
daylight saving time: [a]/ˌdeɪlaɪt ˈseɪvɪŋ taɪm/; [phr]夏时制;
put away: [a]/pʊt əˈweɪ/; [phr]放好;把.收起来;储存;
right angle: [a]/ˈraɪt æŋɡl/; [phr]直角;
antitrust law: [a]/ˌæntiˈtrʌst lɔ/; [phr]反托拉斯法;
in full bloom: [a]/ɪn fʊl blum/; [phr]全盛时期;
whole number: [a]/ˌhoʊl ˈnʌmbər/; [phr]整数;
at stake: [a]/ət steɪk/; [phr]存亡攸关,处于危险中;
interest rate: [a]/ˈɪntrəst reɪt/; [phr]利率;
give rise to: [a]/ɡɪv raɪz tu/; [phr]引起,发生;
fill in: [a]/fɪl ɪn/; [phr]填充;
swimming pool: [a]/ˈswɪmɪŋ puːl/; [phr]游泳池;
take over: [a]/teɪk ˈoʊvər/; [phr]接收,接管,接任,夺取;
pick up: [a]/pɪk ʌp/; [phr]捡起,接人;搭载,拿回;清理;学会;
come across: [a]/kʌm əˈkrɔs/; [phr]遇到;
add up to: [a]/æd ʌp tu/; [phr]总计;
turn down: [a]/tɜrn daʊn/; [phr]拒绝;调低;关小;
care for: [a]/ker fɔr/; [phr]照料(看),喜欢;
put up: [a]/pʊt ʌp/; [phr]建造;
show off: [a]/ʃəʊ ɒf/; [phr]炫耀,卖弄;
run out of: [a]/rʌn aʊt ɒv/; [phr]用完;
work out: [a]/wɜrk aʊt/; [phr]计算出;锻炼;计划;解决;
soft drink: [a]/ˌsɔːft ˈdrɪŋk/; [phr](不含酒精的)清凉饮料;
driver's license: [a]/ˈdraɪvərz ˈlaɪsns/; [phr]驾驶执照;
gold medal: [a]/ˌɡoʊld ˈmedl/; [phr]金牌;
from mouth to mouth: [a]/frɒm maʊθ tu maʊθ/; [phr]口口相传地;人传人地;
night club: [a]/naɪt klʌb/; [phr]夜总会;
wake up: [a]/weɪk ʌp/; [phr]醒来;
put on: [a]/pʊt ɔn/; [phr]穿,戴上,上演;
turn off: [a]/tɜrn ɑf/; [phr]关掉(水,电,电视,收音机等);
turn on: [a]/tɜrn ɔn/; [phr]打开(水,电视,收音机,灯,煤气等);  quant. 取决于;攻击;激发性欲;
get up: [a]/ɡet ʌp/; [phr]起床;
look up: [a]/lʊk ʌp/; [phr]查找;抬头,仰望;敬仰,尊敬;
side by side: [a]/saɪd baɪ saɪd/; [phr]肩并肩,一起;
fall asleep: [a]/fɔl əˈslip/; [phr]入睡;
make a face: [a]/meɪk ə feɪs/; [phr]做鬼脸,做苦脸;
turn over: [a]/tɜrn ˈoʊvər/;  quant. 翻动,犁翻(土地),翻转; [phr]交;移交;
give up: [a]/ɡɪv ʌp/; [phr]放弃;
run away: [a]/rʌn əˈweɪ/; [phr]逃跑,出走,私奔;避开,失控;
break off: [a]/breɪk ɔːf/; [phr]折断,掰掉;突然停止,暂停,中断;终止 (关系);
rather than: [a]/ˈræðər ðən/; [phr]而不是;
point out: [a]/pɔɪnt aʊt/; [phr]指出;
break in: [a]/breɪk ɪn/; [phr]闯入,强行进入,插嘴,打断;
think about: [a]/θɪŋk əˈbaʊt/; [phr]考虑;
face to face: [a]/feɪs tu feɪs/; [phr]面对面;
hurry up: [a]/ˈhɜːri ʌp/; [phr]赶快,快点;
think of: [a]/θɪŋk ɑv/; [phr]想起,考虑;认为,看法;
as a result: [a]/əz ə rɪˈzʌlt/; [phr]因此,由于;
get together: [a]/ɡet təˈɡeðər/; [phr]聚集;汇集;开会;
ring road: [a]/ˈrɪŋ roʊd/; [phr]环形公路;
a bit: [a]/ə bɪt/; [phr]有一点;一会儿;
a good many: [a]/ə ɡʊd ˈmeni/; [phr]大量;许多;
a little: [a]/ə ˈlɪtl/; [phr]一点,少许;
a lot of: [a]/ə lɑːt əv/; [phr]许多,大量;
a pair of: [a]/e pɛr ʌv/; [phr]一双,一副;
a piece of: [a]/e pis ʌv/; [phr]一块,一张,一根,一片;
above all: [a]/əˈbʌv ɔːl/; [phr]首先,首要;
after class: [a]/ˈæftɚ klæs/; [phr]课后;
agree to do sth: [a]/əˈɡriː tuː duː ˈsʌmθɪŋ/; [phr]同意做某事;
agree with sb: [a]/əˈɡriː wɪð ˈsʌmbədi/; [phr]同意某人的看法,与某人看法一致;
all kinds of: [a]/ɔːl kaɪnds əv/; [phr]各种各样的;
all over: [a]/ɔːl ˈoʊvər/; [phr]到处,遍及;
all right: [a]/ˌɔːl ˈraɪt/; [phr]好;顺利的;正确的;
as though: [a]/æz ðoʊ/; [phr]好像,仿佛;
as usual: [a]/æz ˈjuːʒuəl/; [phr]通常,平常地;
be proud of: [a]/bi praʊd ʌv/; [phr]因.骄傲,自豪;
be strict with: [a]/bi strɪkt wɪð/; [phr]对..严格要求;
break away from: [a]/brek əˈwe frʌm/; [phr]脱离..;
by air: [a]/baɪ er/; [phr]乘飞机;
by and by: [a]/baɪ ənd baɪ/; [phr]逐渐地,不久以后;
by day: [a]/baɪ deɪ/; [phr]日间,在白天;
call in: [a]/ˈkɔːlˌɪn/; [phr]叫来;顺便拜访;召回;
call up: [a]/ˈkɔːlˌʌp/; [phr]打电话,号召;  quant. 使想起;
carry off: [a]/ˈkæri ɔːf/; [phr]夺走;获得(奖项,奖杯);成功应对;
catch up with: [a]/kætʃ ʌp wɪð/; [phr]赶上;
change into: [a]/tʃeɪndʒ ˈɪntʊ/; [phr]变成;把..变成;转换成;
come back: [a]/kʌm bæk/; [phr]回来,想起来;
come from: [a]/kʌm frʌm/; [phr]来自,出生(于);
come in: [a]/kʌm ɪn/; [phr]进入,进来;
come true: [a]/kʌm truː/; [phr]变为现实;
compare to: [a]/kəmˈper tu/; [phr]与..相比;
compare with: [a]/kəmˈper wɪð/; [phr]与..相比;
congratulate...on: [a]/kənˈɡrætʃuleɪt ɔːn/; [phr]祝贺..;
connect to: [a]/kəˈnekt tuː/; [phr]连接,相连;
connect with: [a]/kəˈnɛkt wɪð/; [phr]与..相连;
cut off: [a]/kʌt ɔːf/; [phr]切断;
cut up: [a]/kʌt ʌp/; [phr]切碎;
day and night: [a]/deɪ ənd naɪt/; [phr]日夜不停地,不断地;
different from: [a]/ˈdɪfərənt frʌm/; [phr]与..不同;
divide up: [a]/dɪˈvaɪd ʌp/; [phr]分配;
do some cleaning: [a]/duː səm ˈkliːnɪŋ/; [phr]做扫除;
do some shopping: [a]/du sʌm ˈʃɑpɪŋ/; [phr]买东西;
dozens of: [a]/ˈdʌznz əv/; [phr]几十;
each other: [a]/ˌiːtʃ ˈʌðər/; [phr]相互;
fall ill: [a]/fɔːl ɪl/; [phr]患病,病倒;
far away: [a]/fɑːr əˈweɪ/; [phr]遥远的;
figure out: [a]/ˈfɪɡjər aʊt/; [phr]想明白,理解;
find out: [a]/faɪnd aʊt/; [phr]查明,发现,了解;
for ever: [a]/fər ˈevər/; [phr]永远;
have to: [a]/ˈhæv tə/; [phr]必须;不得不;
in surprise: [a]/ɪn sɚˈpraɪz/; [phr]吃惊,惊讶;
keep back: [a]/kiːp bæk/; [phr]保留,阻止,阻挡,隐瞒;
knock at: [a]/nɑk æt/; [phr]敲;
let sb in: [a]/let ˈsʌmbədi ɪn/; [phr]让..进来,放进;
let out: [a]/ˈletˌaʊt/; [phr]放出;泄露;发出;
look through: [a]/lʊk θrʊ/; [phr]浏览,看穿;
make up of: [a]/mek ʌp ʌv/; [phr]由..组成,构成;
millions of: [a]/ˈmɪljənz əv/; [phr]成百万上千万,数以百万计;
on duty: [a]/ɑːn ˈdʊti/; [phr]值日,值班;
on foot: [a]/ɑːn fʊt/; [phr]走路,步行;
on show: [a]/ɑːn ʃoʊ/; [phr]展出,在上演(放映);
out of work: [a]/aʊt əv wɜːrk/; [phr]失业;
take up: [a]/teɪk ʌp/; [phr]占据,占用,拿起,开始做,继续;
tape recorder: [a]/ˈteɪp rɪkɔːrdər/; [phr]磁带录音机;
a kind of: [a]/ə kaɪnd əv/; [phr]一种,一类;
again and again: [a]/əˈɡen ənd əˈɡen/; [phr]再三地;反复地;
all the best: [a]/ɔːl ðə best/; [phr]一切顺利;一路平安;
answer for: [a]/ˈænsər fɔːr/; [phr]对..负责;
as a matter of fact: [a]/æz ə ˈmætər əv fækt/; [phr]事实上,其实;
as...as: [a]/æz æz/; [phr]像,如同;
as long as: [a]/æz lɔːŋ æz/; [phr]只要;
both...and: [a]/boʊθ ænd/; [phr]两个都,既..又..;
either...or: [a]/ˈiːðər ɔːr/; [phr].或者.;不是.就是.;
enjoy oneself: [a]/enˈdʒɔːɪ wʌnˈself/; [phr]过得愉快;
even if: [a]/ˈiːvən ɪf/; [phr]即使,尽管;
even though: [a]/ˈiːvən ðoʊ/; [phr]尽管,即使;
ever since: [a]/ˈevər sɪns/; [phr]自那时起直到现在;
fill with: [a]/fɪl wɪð/; [phr]用..填充;
from now on: [a]/frʌm naʊ ɑːn/; [phr]从今以后,今后;
get along with: [a]/ɡet əˈlɔːŋ wɪð/; [phr]与..相处;
give away: [a]/ɡɪv ə'weɪ/; [phr]分发;出卖;泄露;赠送;
go ahead: [a]/ˈɡoʊəˌhed/; [phr]走在前面,领先,干吧,干下去;
go away: [a]/ɡoʊ əˈweɪ/; [phr]走开,出去;
go fishing: [a]/ɡo ˈfɪʃɪŋ/; [phr](去)钓鱼;
go for a walk: [a]/ɡoʊ fɔːr ə wɔːk/; [phr]散步;
go on doing: [a]/ɡoʊ ɔːn ˈduːɪŋ/; [phr]继续干某事,不停地干某事;
go through: [a]/ɡoʊ θruː/; [phr]浏览,查阅;通过,完成;经历,经受;
have a cold: [a]/hæv e kold/; [phr]患感冒;
have a gift for: [a]/hæv e ɡɪft fɔr/; [phr]对..有天赋;
have a good time: [a]/hæv ə ɡʊd taɪm/; [phr]玩得高兴,过得愉快;
have classes: [a]/hæv klɑ:sɪz/; [phr]上课;
have fun with: [a]/hæv fʌn wɪð/; [phr]玩得高兴;
hear from: [a]/hɪr frʌm/; [phr]收到..的来信;
help oneself to: [a]/help wʌnˈself tu/; [phr]请随便吃点;
help sb with sth: [a]/help ˈsʌmbədi wɪð ˈsʌmθɪŋ/; [phr]帮助某人做某事;
hundreds of: [a]/hʌndrədz əv/; [phr]几百;成百上千;
in a hurry: [a]/ɪn ə ˈhɜːri/; [phr]匆忙,很快地;
in all: [a]/ɪn ɔːl/;  quant. 总共;共计; [phr]总共;共计;
in debt: [a]/ɪn det/; [phr]欠债;
in danger: [a]/ɪn ˈdeɪndʒər/; [phr]处在危险状态;
in front of: [a]/ɪn frʌnt ʌv/; [phr]在⋯⋯前面;
in need of: [a]/ɪn niːd əv/; [phr]需要;
in order: [a]/ɪn ˈɔːrdər/; [phr]按顺序;
in peace: [a]/ɪn pis/; [phr]安静,宁静;和平地;
in public: [a]/ɪn ˈpʌblɪk/; [phr]当众;公开地;
in the end: [a]/ɪn ðə end/; [phr]最后,终于;
instead of: [a]/ɪnˈsted əv/; [phr]代替,顶替,反而;代替,而不是;
keep on: [a]/kiːp ɑːn/; [phr]持续(进行);
lead to: [a]/liːd tu/; [phr]导致,导向;
look ahead: [a]/lʊk əˈhed/; [phr]向前看,展望未来;
look down upon: [a]/lʊk daʊn əˈpɑːn/; [phr]看不起,轻视;
make friends with: [a]/meɪk frends wɪð/; [phr]与..交朋友;
more or less: [a]/mɔːr ɔːr les/; [phr]或多或少;
not any more: [a]/nɒt ˈeni mɔr/; [phr]不再;
of course: [a]/əv kɔːrs/; [phr]当然;
once again: [a]/wʌns əˈɡen/; [phr]再一次;
ought to: [a]/ˈɔːt tə/; [phr]应该;
out of breath: [a]/aʊt əv breθ/; [phr]上气不接下气;
out of order: [a]/aʊt əv ˈɔːrdər/; [phr]出毛病,运转不正常;
pay attention to: [a]/peɪ əˈtenʃən tu/; [phr]注意;
pay back: [a]/peɪ bæk/; [phr]偿还(借款等);
pick out: [a]/pɪk aʊt/; [phr]选出,找出,挑选;
prevent...from: [a]/prɪˈvent frəm/; [phr]防止,妨碍,预防;
put on a performance: [a]/pʊt ɑːn ə pərˈfɔːrməns/; [phr]演出;
put on weight: [a]/pʊt ɑn wet/; [phr]发福,增加体重;
put up with: [a]/pʊt ʌp wɪð/; [phr]忍受,容忍;
ring sb back: [a]/rɪŋ ˈsʌmbədi bæk/; [phr]回电话;
ring up: [a]/rɪŋ ʌp/; [phr]打电话给;
right away: [a]/raɪt əˈweɪ/; [phr]立即,马上;
scores of: [a]/skɔrz ʌv/; [phr]许多,大量;
send out: [a]/send aʊt/; [phr]发出,派遣;
spend...on: [a]/spend ɑːn/; [phr]消耗,消磨(时间);在..花钱;
stand for: [a]/stænd fɔːr/; [phr]代表,象征;容忍;
stop doing sth: [a]/stɑːp ˈduːɪŋ ˈsʌmθɪŋ/; [phr]停止做某事;
struggle against: [a]/'strʌɡl ə'ɡɛnst/; [phr]同..作斗争;
talk about: [a]/tɔːk əˈbaʊt/; [phr]谈论,议论;
talk of: [a]/tɔːk əv/; [phr]谈论,议论;
the day after tomorrow: [a]/ðə deɪ ˈæftər təˈmɔːroʊ/; [phr]后天;
the day before yesterday: [a]/ðə deɪ bɪˈfɔːr ˈjestərˌdeɪ/; [phr]前天;
try sth on: [a]/traɪ ˈsʌmθɪŋ ɑːn/; [phr]试穿,试试看;
up and down: [a]/ʌp ænd daʊn/; [phr]来回,来来回回;上上下下;
be used to sth: [a]/biː ju:st tuː ˈsʌmθɪŋ/; [phr]习惯于;  quant. 习惯于;
wait for: [a]/weɪt fɔːr/; [phr]等候,等待;
worry about: [a]/'wɜːri ə'baʊt/; [phr]担心,烦恼;
write down: [a]/ˈraɪtˌdaʊn/; [phr]写下,记下;
write to: [a]/raɪt tu/; [phr]写信给..;
arrive at a place: [a]/əˈraɪv æt eɪ pleɪs/; [phr]到达某地;
do one's best: [a]/duː wʌnz best/; [phr]尽最大的努力;
divide...into...: [a]/dɪˈvaɪd ˈɪntu/; [phr]把..分成..;
earn one's living: [a]/ɜː(r)n wʌnz ˈlɪvɪŋ/; [phr]谋生;
had better (do): [a]/hæd ˈbetər doʊ/; [phr]最好(做);
help...out: [a]/help aʊt/; [phr]帮助某人解决困难;
hold one's breath: [a]/hoʊld wʌnz breθ/; [phr]不出气,屏住呼吸;
keep doing sth: [a]/kiːp ˈduːɪŋ ˈsʌmθɪŋ/; [phr]不停做某事;继续做某事;
make up one's mind: [a]/meɪk ʌp wʌnz maɪnd/; [phr]下决心,决定;
on average: [a]/ɔn ˈæv(ə)rɪdʒ/; [phr]平均,通常;
save one's life: [a]/seɪv wʌnz laɪf/; [phr]挽救某人生命;
take one's time: [a]/tek wʌnz taɪm/; [phr]从容;慢慢行动;不急;
the more...the more...: [a]/ðə mɔːr ðə mɔːr/; [phr]越..就越..;
too...to: [a]/tu tu/; [phr]太..以至于不..;
turn up: [a]/tɜrn ʌp/; [phr]调高,来到,出现,到场;卷起;
speed up: [a]/spid ʌp/; [phr]加快速度;
refer to: [a]/rɪˈfɜr tu/; [phr]参考;涉及;指的是;适用于;谈到;
far from: [a]/fɑːr frɒm/; [phr]远离,绝不,远非;
in order that: [a]/ɪn ˈɔːrdər ðæt/; [phr]为了;
the other day: [a]/ðə ˈʌðər deɪ/; [phr]前几天,某日;
by the way: [a]/baɪ ðə weɪ/; [phr]顺便说一下;
keep one's word: [a]/kip wʌnz wɚd/; [phr]守信用,履行诺言;
by accident: [a]/baɪ ˈæksɪdənt/; [phr]意外地;偶然;
wrap up: [a]/ræp ʌp/; [phr]包起来;完成某事;
point to: [a]/pɔːɪnt tu/; [phr]表明,显示;
cut down: [a]/kʌt daʊn/; [phr]砍倒;减少,削减;
roller skating: [a]/ˈroʊlər skeɪtɪŋ/; [phr]滑旱冰;
take out: [a]/teɪk aʊt/; [phr]取出;除去;拔掉;把.带出去;
keep up: [a]/kiːp ʌp/; [phr]保持;继续;不落后于;赶上;
get in: [a]/ɡet ɪn/; [phr]进入;收获,收割;当选;参加;到达;
the United Kingdom(UK): [a]/ðə juˈnaɪtəd ˈkɪŋdəm ˌjuː'keɪ/; [phr]英国;
give back: [a]/ɡɪv bæk/; [phr]归还;送回;
put down: [a]/pʊt daʊn/; [phr]放下,记下,镇压;
build up: [a]/bɪld ʌp/; [phr]逐步增加(增强),逐渐增进;建立;聚集;
in other words: [a]/ɪn ˈʌðər wɜːdz/; [phr]换句话说;
a number of: [a]/ə ˈnʌmbər əv/; [phr]一些,许多;
ahead of: [a]/əˈhed əv/; [phr]在..之前;
as soon as: [a]/æz suːn æz/; [phr]一..就..;
feel like doing: [a]/fil laɪk ˈduɪŋ/; [phr]想要..,感觉要..;
for example: [a]/fɔːr ɪɡˈzæmpəl/; [phr]例如,举个例子;
for good: [a]/fɔːr ɡʊd/; [phr]永远;
get on with sb: [a]/ɡet ɑːn wɪð ˈsʌmbədi/; [phr]与..相处;
go on with: [a]/ɡoʊ ɑːn wɪð/; [phr]继续;进行;暂时使用;
hold out: [a]/hoʊld aʊt/; [phr]伸出;坚持,维持;
in a word: [a]/ɪn ə wɜːrd/; [phr]总之,简言之;
in fact: [a]/ɪn fækt/; [phr]事实上,实际上;
in order to: [a]/ɪn ˈɔːrdər tu/; [phr]为了,目的是;
join in: [a]/dʒɔːɪn ɪn/; [phr]加入,参加;
join up: [a]/dʒɔːɪn ʌp/; [phr]参军,入伍;与..联手;
lots of: [a]/lɒts əv/; [phr]许多,大量;
no doubt: [a]/noʊ daʊt/; [phr]无疑地;
no longer: [a]/noʊ ˈlɔːŋɡər/; [phr]不再;
not at all: [a]/nɑːt æt ɔːl/; [phr]一点也不,绝非;不必客气;
once upon a time: [a]/wʌns əˈpɑːn ə taɪm/; [phr]很久以前,从前;
one after another: [a]/wʌn ˈæftər əˈnʌðər/; [phr]一个接一个;
or else: [a]/ɔːr els/; [phr]否则;要不然;
put off: [a]/pʊt ɔːf/; [phr]推迟;
ring off: [a]/rɪŋ ɔːf/; [phr]挂断电话,停止讲话;
right now: [a]/raɪt naʊ/; [phr]马上,立即;
separate...from...: [a]/ˈseprət frɑːm/; [phr]分开;
so as to: [a]/soʊʊ æz tu/; [phr]为的是,以便;
so far: [a]/soʊʊ fɑːr/; [phr]到目前为止;
so long as: [a]/soʊʊ lɔːŋ æz/; [phr]只要;
so...that: [a]/soʊ ðæt/; [phr]太..以至于..;
such as: [a]/sʌtʃ æz/; [phr]例如;
take it easy: [a]/teɪk ɪt ˈiːzi/; [phr]别着急,别紧张;
take place: [a]/tek ples/; [phr]发生;举行;来;
thousands of: [a]/ˈθaʊznds əv/; [phr]成千上万,几千;
try sth out: [a]/traɪ ˈsʌmθɪŋ aʊt/; [phr]试验;
used to do sth: [a]/ju:st tuː duː ˈsʌmθɪŋ/; [phr]过去常常做某事;
depend on (upon): [a]/dɪˈpend ɔn əˈpɑn/; [phr]依靠,相信,信赖;
get close (to): [a]/ɡet kloʊs tu/; [phr]接近;
not till: [a]/nɑːt tɪl/; [phr]直到..才;
over the radio: [a]/ˈoʊvər ðə ˈreɪdioʊ/; [phr]通过收音机;
regard... as: [a]/rɪˈɡɑrd æz/; [phr]把..看作;
see...off: [a]/si ɑf/; [phr]为某人送行;
sentence...to death: [a]/ˈsentəns tuː deθ/; [phr]判处死刑;
come to: [a]/kʌm tu/; [phr]谈到;提及;总计;开始(认识,理解);苏醒;到达;
hand out: [a]/hænd aʊt/; [phr]分发;施舍;把.拿出来;
family name: [a]/ˈfæməli neɪm/; [phr]姓氏;
not only...but also: [a]/nɑːt ˈoʊnli bət ˈɔːlsoʊ/; [phr]不仅..而且..;
not until: [a]/nɑt ʌnˈtɪl/; [phr]直到⋯⋯才;
send up: [a]/ˈsendˌʌp/; [phr]发射,射出;
take the place of: [a]/teɪk ðə pleɪs əv/; [phr]取代,代替;
from...to: [a]/frɒm tu/; [phr]从..到..;
after all: [a]/ˈæftər ɔːl/; [phr]毕竟,终究;
as far as: [a]/æz fɑːr æz/; [phr](表示程度,范围)就..;尽..;
as if: [a]/æz ɪf/; [phr]好像,仿佛;
first of all: [a]/fɜːrst əv ɔːl/; [phr]首先;
hear of: [a]/hɪr əv/; [phr]听说,听到;知道; [v]同意,允许;
not as...as: [a]/nɑːt æz æz/; [phr]不像;不如;
now that: [a]/naʊ ðæt/; [phr]既然;
take sb in one's arms: [a]/teɪk ˈsʌmbədi ɪn wʌnz ɑːrmz/; [phr]搂抱;
sell out: [a]/sel aʊt/; [phr]卖完,卖出;
hand in: [a]/hænd ɪn/; [phr]上交,递交;
send for: [a]/send fɔːr/; [phr]派人去请(拿),召唤;
give birth to: [a]/ɡɪv bɜːrθ tu/; [phr]产生,形成;
break into: [a]/breɪk ˈɪntʊ/; [phr]闯入,碰到,发现;
come into being: [a]/kʌm ˈɪntʊ ˈbiːɪŋ/; [phr]形成,产生;
before long: [a]/bɪˈfɔːr lɔːŋ/; [phr]不久以后;
blow up: [a]/bloʊ ʌp/; [phr]炸毁;
turn to: [a]/tɚn tu/; [phr]求助于;变成,转向;
be connected with: [a]/bi kəˈnɛktɪd wɪð/; [phr]与..有关;
in general: [a]/ɪn ˈdʒenərəl/; [phr]总的说来;
series of: [a]/ˈsɪriz ʌv/; [phr]一系列;
be at war with: [a]/bi æt wɔr wɪð/; [phr]与..交战;
solar system: [a]/ˈsoʊlər sɪstəm/; [phr]太阳系;
cling to: [a]/klɪŋ tu/; [phr]依靠,粘在..上;
as a result of: [a]/æz ə rɪˈzʌlt əv/; [phr]作为..的结果;
set up: [a]/set ʌp/; [phr]设立,创立;提议,提倡;预备;(军事)训练;
calm down: [a]/kɑm daʊn/; [phr](使)平静下来,(使)镇定下来;
not...any longer: [a]/nɑːt ˈeni ˈlɔːŋɡər/; [phr]不再..;
add up: [a]/æd ʌp/; [phr]合计;
walk the dog: [a]/wɔk ðə dɔɡ/; [phr]遛狗;
at dusk: [a]/ət dʌsk/; [phr]在黄昏时刻;
suffer from: [a]/'sʌfər frʌm/; [phr]遭受,患病;
pack/sth up: [a]/pæk ˈsʌmθɪŋ ʌp/; [phr]将(东西)装箱打包;
fall in love: [a]/fɔːl ɪn lʌv/; [phr]相爱,爱上;
because of: [a]/bɪˈkɔːz əv/; [phr]因为;由于;
at present: [a]/æt 'preznt/; [phr]现在;目前;
play a part (in): [a]/pleɪ ə pɑːrt ɪn/; [phr]扮演一个角色,参与;
at midnight: [a]/ət ˈmɪdˌnaɪt/; [phr]在午夜;
at an end: [a]/æt ən ɛnd/; [phr]结束,终结;
in ruins: [a]/ɪn 'ruːɪnz/; [phr]严重受损,破败不堪;
dig out: [a]/dɪɡ aʊt/; [phr]掘出,发现;
a (great) number of: [a]/ə ɡreɪt ˈnʌmbər əv/; [phr]许多,大量的;
in trouble: [a]/ɪn 'trʌbəl/; [phr]在危险,受罚,痛苦,忧虑等的处境中;
come to power: [a]/kʌm tu ˈpaʊər/; [phr]掌权;
be sentenced to: [a]/biː ˈsentənst tuː/; [phr]被判处..(徒刑);
get/be tired of: [a]/ɡet biː ˈtaɪərd əv/; [phr]对..厌烦;
dream of: [a]/driːm əv/; [phr]梦见,梦想,设想;
less than: [a]/les ðən/; [phr]少于;
watch over: [a]/wɑːtʃ 'oʊvər/; [phr]看守,监视;
take apart: [a]/teɪk ə'pɑːrt/; [phr]拆开;
in search of: [a]/ɪn sɜːrtʃ əv/; [phr]寻找;
in return: [a]/ɪn rɪ'tɜːrn/; [phr]作为报答,回报;
at war: [a]/æt wɔːr/; [phr]处于交战状态;
take part in: [a]/tek pɑrt ɪn/; [phr]参加;
in charge: [a]/ɪn tʃɑːrdʒ/; [phr]主管,看管;
human race: [a]/ˈhjumən reɪs/; [phr]人类;
with the help of: [a]/wɪθ ðə help ɑv/; [phr]在..的帮助下;
in danger (of): [a]/ɪn 'deɪndʒər əv/; [phr]在危险中,垂危;
burst into laughter: [a]/bɜːrst 'ɪntʊ 'læftər/; [phr]突然笑起来,放声大笑;
colobus monkey: [a]/'kɑːləbəs ˈmʌŋki/; [phr](非洲产)疣猴,髯猴;
to be honest: [a]/tu bi ˈɑnəst/; [phr]说实在地,实话说;
attach...to: [a]/əˈtætʃ tuː/; [phr]认为有(重要性,意义),附上,连接;
in cash: [a]/ɪn kæʃ/; [phr]用现金,有现钱;
play jokes on: [a]/pleɪ dʒoʊks ɑːn/; [phr]戏弄;
rely on: [a]/rɪ'laɪ ɑːn/; [phr]依靠;
be/get familiar with: [a]/biː ɡet fəˈmɪliər wɪð/; [phr]熟悉,与..熟悉起来;
lose weight: [a]/luz wet/; [phr]体重减轻,减肥;
play a trick on: [a]/pleɪ ə trɪk ɑːn/; [phr]搞恶作剧,诈骗,开玩笑;
carbon dioxide: [a]/ˌkɑːrbən daɪˈɑːksaɪd/; [phr]二氧化碳;
in memory of: [a]/ɪn 'meməri əv/; [phr]纪念,追念;
remind...of...: [a]/rɪˈmaɪnd əv/; [phr]使..想起..;
balanced diet: [a]/ˈbælənst ˈdaɪət/; [phr]平衡膳食;
get away with: [a]/ɡet əˈweɪ wɪθ/; [phr]被放过,(做坏事)不受惩罚;
tell a lie: [a]/tel ə lai/; [phr]说谎;
win back: [a]/wɪn bæk/; [phr]赢回,重新获得;
spy on: [a]/spaɪ ɔn/; [phr]暗中监视,侦查;
make a bet: [a]/meɪk ə bet/; [phr]打赌;
stare at: [a]/ster ət/; [phr]盯着看,凝视;
on the contrary: [a]/ɑːn ðə 'kɑːnˌtreri/; [phr]与此相反,正相反;
take a chance: [a]/teɪk ə tʃæns/; [phr]冒险;
in rags: [a]/ɪn ræɡz/; [phr]衣衫褴褛;
lay eggs: [a]/leɪ ˌeɡz/; [phr]下蛋;
prevent from: [a]/prɪˈvent frɒm/; [phr]阻止,制止;
block out: [a]/blɑk aʊt/; [phr]挡住(光线);
cheer up: [a]/tʃɪr ʌp/; [phr]感到高兴,感到振奋;
get the hang of: [a]/ɡet ðə hæŋ ɑv/; [phr]熟悉,掌握,理解;
watch out for: [a]/wɑːtʃ aʊt fɔːr/; [phr]密切注视,当心,提防;
manage to do: [a]/ˈmænɪdʒ tu doʊ/; [phr]设法做;
catch sight of: [a]/kætʃ saɪt əv/; [phr]看见,瞥见;
in the distance: [a]/ɪn ðə 'dɪstəns/; [phr]在远处;
would rather: [a]/wʊd ˈræðər/; [phr]宁愿,宁可;
fairy tale: [a]/ˈferi teɪl/; [phr]神话故事;童话故事;
thanks to: [a]/θæŋks tu/; [phr]幸亏,由于,因为;
lead a...life: [a]/liːd ə laɪf/; [phr]过着..的生活;
crowd in: [a]/kraʊd ɪn/; [phr](想法,问题等)涌上心头,涌入脑海,挤入;
rid of: [a]/rɪd ɑv/; [phr]摆脱,除去;
be satisfied with: [a]/bi ˈsætɪsˌfaɪd wɪθ/; [phr]对..感到满意;
up to now: [a]/ʌp tu naʊ/; [phr]到目前为止;
badly off: [a]/ˌbædli ˈɔːf/; [phr]穷的,缺少的;
star in: [a]/stɑr ɪn/; [phr]担任主角,主演;
defend against: [a]/dɪˈfend əˈɡenst/; [phr]保卫..以免受;
be likely to: [a]/bi ˈlaɪkli tu/; [phr]很可能..,有希望..;
at ease: [a]/æt iːz/; [phr]舒适,快活,自由自在;
be famous for: [a]/bi ˈfeɪməs fɔr/; [phr]以..而闻名;
be modelled after: [a]/bi'mɑːdl ˈæftər/; [phr]根据..模仿,仿造;
get close to: [a]/ɡet kloʊs tu/; [phr]接近;
come to life: [a]/kʌm tə laɪf/; [phr]活跃起来;
look down upon/on: [a]/lʊk daʊn əˈpɑːn ɑːn/; [phr]蔑视,瞧不起;
keep...free from/of: [a]/kiːp friː frɑːm əv/; [phr]使..免受(影响,伤害等),使..不含(有害物);
feel/be content with: [a]/fiːl biː ˈkɑːntent wɪð/; [phr]对..满足;
safety belt: [a]/ˈseɪfti belt/; [phr]安全带;
leave...out: [a]/liːv aʊt/; [phr]省去;遗漏;不考虑;
put forward: [a]/pʊt 'fɔːrwəd/; [phr]提出;
draw a conclusion: [a]/drɔ ə kənˈkluʒ(ə)n/; [phr]得出结论;
expose...to: [a]/ɪkˈspoʊz tuː/; [phr]使显露,暴露;
make sense: [a]/meɪk sens/; [phr]讲得通;有意义;
divide...into: [a]/dɪˈvaɪd ˈɪntuː/; [phr]把..分成;
to one's credit: [a]/tuː wʌnz ˈkredɪt/; [phr]为..带来荣誉,值得赞扬,在..名下;
be back on one's feet: [a]/biː bæk ɔːn wʌnz fiːt/; [phr](困境后)恢复,完全复原;
lose sight of...: [a]/luːz saɪt əv/; [phr]看不见..;
sweep up: [a]/swiːp ʌp/; [phr]打扫,横扫;
slide into: [a]/slaɪd ˈɪntu/; [phr](快捷而悄声地)移动,溜进..;
concentrate on: [a]/'kɑːnsənˌtreɪt ɑːn/; [phr]聚精会神,集中思想;
accuse...of: [a]/əˈkjuːz əv/; [phr]因..指责或控告..;
first aid: [a]/ˌfɜːrst ˈeɪd/; [phr](对伤患者的)急救;
electric shock: [a]/ɪˌlektrɪk ˈʃɑːk/; [phr]触电,电休克;
squeeze out: [a]/skwiz aʊt/; [phr]榨出,挤出;
in place: [a]/ɪn pleɪs/; [phr]在适当的位置;适当;
put one's hands on: [a]/pʊt wʌnz hændz ɑːn/; [phr]找到;
make a difference: [a]/meɪk ə 'dɪfərəns/; [phr]有影响,使不相同;
out of date: [a]/ˌaʊt əv ˈdeɪt/; [phr]过时;
at the start of: [a]/ət ðə stɑrt ɑv/; [phr]在..开始的时候;
at the end of: [a]/ət ðə end ɑv/; [phr]在..结束的时候;
go to college: [a]/ɡoʊ tu ˈkɑlɪdʒ/; [phr]上大学;
be divided into: [a]/bi dɪˈvaɪdɪd ˈɪntu/; [phr]被(划)分成..;
make sure: [a]/meɪk ʃʊr/; [phr]确定;确信;查明;弄清楚;
tell jokes: [a]/tel dʒoʊks/; [phr]讲笑话,开玩笑;
get out of: [a]/ɡet aʊt ɑv/; [phr]摆脱;逃避;下(车);
be short for: [a]/bi ʃɔrt fɔr/; [phr]是..的缩写/简称;
till now: [a]/tɪl naʊ/; [phr]到目前为止;
used to: [a]/ˈjuːst tu/; [phr]过去(常常)..;
add...to...: [a]/æd tu/; [phr]往..加入..;
in the area of: [a]/ɪn ðə ˈeriə ɑv/; [phr]在..领域;
consists of: [a]/kənˈsɪsts əv/; [phr]由..组成;
take turns: [a]/teɪk ˈtɜːnz/; [phr]轮流;
put into: [a]/pʊt ˈɪntu/; [phr]将..投入..;
be crazy about: [a]/bi ˈkreɪzi əˈbaʊt/; [phr]迷恋;
have a temperature: [a]/həv ə ˈtemp(ə)rəˌtʃʊr/; [phr]发烧;
lie down: [a]/laɪ daʊn/; [phr]躺下;
begin with: [a]/bɪˈɡɪn wɪθ/; [phr]以..开始;
become ill: [a]/bɪˈkʌm ɪl/; [phr]生病;
related to: [a]/rɪˈleɪtəd tu/; [phr]有关系的,有关联的;
be impressed with: [a]/biː ɪmˈprest wɪð/; [phr]留下深刻印象;
split up: [a]/splɪt ʌp/; [phr]分裂,分割;
make a note of: [a]/meɪk ə noʊt ɑv/; [phr]记录;
be/get tired of: [a]/bi ɡet 'taɪərd ɑv/; [phr]对..厌烦;
tell by: [a]/tel baɪ/; [phr]从..可以看出;
in total: [a]/ɪn 'toʊtl/; [phr]总共,合计;
be similar to: [a]/bi ˈsɪmɪlər tu/; [phr]和..相似;
fall in love with: [a]/fɔːl ɪn lʌv wɪð/; [phr]爱上,喜欢(表动作);
be in love with: [a]/bi ɪn lʌv wɪθ/; [phr]爱上,喜欢(表状态);
play a part: [a]/pleɪ ə pɑrt/; [phr]扮演角色;
become addicted to: [a]/bɪˈkʌm əˈdɪktəd tu/; [phr]对..上瘾,沉迷于;
take one's advice: [a]/teɪk wʌnz ədˈvaɪs/; [phr]听某人的意见;
to one's surprise: [a]/tuː wʌnz sərˈpraɪz/; [phr]令某人吃惊的是;
date from: [a]/deɪt frʌm/; [phr]起源于;
take in: [a]/teɪk ɪn/; [phr]吸收;欺骗;
be known as: [a]/bi noʊn əz/; [phr]作为..而出名/闻名;
on the other hand: [a]/ɔn ðə ˈʌðər hænd/; [phr]另一方面,反过来说;
little by little: [a]/'lɪtl baɪ 'lɪtl/; [phr]一点点地,逐渐地;
at the top of: [a]/ət ðə tɑp ɑv/; [phr]在..顶端;
at the bottom of: [a]/ət ðə ˈbɑtəm ɑv/; [phr]在..底部;
make effort: [a]/meɪk ˈefərt/; [phr]努力;
be close to: [a]/bi kloʊs tu/; [phr]接近,靠近;
set fire to: [a]/set faɪr tu/; [phr]放火(焚烧)..;
catch fire: [a]/kætʃ ˈfaɪər/; [phr]着火,失火;
become interested in: [a]/bɪˈkʌm ˈɪntrəstəd ɪn/; [phr]对..感兴趣;
in conclusion: [a]/ɪn kən'klʊʒən/; [phr]总之;
for the first time: [a]/fɔr ðə fɜrst taɪm/; [phr]第一次;
switch on: [a]/swɪtʃ ɑːn/; [phr]打开(灯,无线电等);
on guard: [a]/ɑːn ɡɑːrd/; [phr](保持)警惕;
use up: [a]/juːz ʌp/; [phr]用完;
get around: [a]/ɡet ə'raʊnd/; [phr]四处走动(旅行);
place order: [a]/pleɪs ˈɔrdər/; [phr]订购;
free of charge: [a]/friː əv tʃɑːrdʒ/; [phr]不收费,免费的,无偿的;
for a start: [a]/fɔr ə stɑrt/; [phr]首先;
be connected to: [a]/bi kəˈnektəd tu/; [phr]与.相连;
be/get stuck in: [a]/bi ɡet stʌk ɪn/; [phr]被困在..;
switch off: [a]/swɪtʃ ɔːf/; [phr]关上(点灯,电视等);断掉(电源);
at the edge of: [a]/ət ðə edʒ ɑv/; [phr]在..的边缘;
get a kick out of: [a]/ɡet ə kɪk aʊt ɑv/; [phr](俚语)从..中得到乐趣;
throw light on: [a]/θroʊ laɪt ɔn/; [phr]帮助弄清楚,阐明某事;
come straight to the point: [a]/kʌm streɪt tu ðə pɔɪnt/; [phr]谈正题,开门见山;
have difficulty (in) doing sth: [a]/hæv ˈdɪfɪkəlti ɪn ˈduːɪŋ ˈsʌmθɪŋ/; [phr]做某事有困难;
in particular: [a]/ɪn pər'tɪkjələr/; [phr]尤其,特别;
in practice: [a]/ɪn 'præktɪs/; [phr]实际上,在实践中;
have an effect on: [a]/hæv ən ɪˈfɛkt ɑn/; [phr]对..产生影响;
take notice of: [a]/teɪk ˈnoʊtɪs ɑv/; [phr]注意,留心;注意到;
in response to: [a]/ɪn rɪ'spɑːns tu/; [phr]作为..的回应;
have connection with: [a]/həv kəˈnekʃ(ə)n wɪθ/; [phr]与..有联系/有关联;
play a trick on sb: [a]/pleɪ ə trɪk ɑːn ˈsʌmbədi/; [phr]捉弄某人,对某人恶作剧;
be in the mood for sth: [a]/biː ɪn ðə muːd fɔːr ˈsʌmθɪŋ/; [phr]有意(做某事),有(做某事的)心情;
come to an end: [a]/kʌm tu: æn end/; [phr]完结;
on the increase: [a]/ɑːn ðə ɪn'kriːs/; [phr]正在增加;
have in common: [a]/həv ɪn ˈkɑmən/; [phr]有相同的特点;
refer to...as: [a]/rɪˈfɜr tu æz/; [phr]称.为.;
take...for granted: [a]/teɪk fɔr ˈɡræntəd/; [phr]以为..理所当然;
make one's fortune: [a]/meɪk wʌnz ˈfɔːrtʃən/; [phr]发财;
rise to one's feet: [a]/raɪz tuː wʌnz fiːt/; [phr]站起身;
hot dog: [a]/ˈhɑːt dɔːɡ/; [phr]热狗;红肠面包;
stay up: [a]/steɪ ʌp/; [phr]熬夜;
look back (on): [a]/lʊk bæk ɔn/; [phr]回顾,回忆起;
in charge of: [a]/ɪn tʃɑrdʒ ʌv/; [phr]负责;主管;
insist on: [a]/ɪn'sɪst ɑːn/; [phr]坚持,强调,坚决要求,督促;
get into shape: [a]/ɡet ˈɪntu ʃeɪp/; [phr]强身健体,使有条理,恰当安排;
in the long term: [a]/ɪn ðə lɔŋ tɜrm/; [phr]长期来说;
can't wait to: [a]/kænt weɪt tuː duː ˈsʌmθɪŋ/; [phr]迫不及待地做某事;
in sight: [a]/ɪn saɪt/; [phr]看得见;被看到;在即;在望;
wish for: [a]/wɪʃ fɔr/; [phr]希望得到,想要;
reach out: [a]/ritʃ aʊt/; [phr]伸出,伸展;
be made up of: [a]/bi meɪd ʌp əv/; [phr]由.构成,由.组成;
differ from: [a]/ˈdɪfər frɑːm/; [phr]不同于,与..有区别;
as a whole: [a]/æz ə hoʊl/; [phr]整个来说,总体上;
come down with: [a]/kʌm daʊn wɪθ/; [phr]得(传染性的病),感染;
make way for: [a]/meɪk weɪ fɔːr/; [phr]为..腾出地方,让路;
play trick on: [a]/pleɪ trɪk ɔn/; [phr]开..的玩笑,捉弄,欺诈;
in honour of: [a]/ɪn 'ɑːnər əv/; [phr]为纪念,为庆祝,向.表示敬意;
lead the way: [a]/lid ðə weɪ/; [phr]引路,带路;
last but not least: [a]/læst bət nɒt list/; [phr]最后但同样重要的;放在最后但并非最不重要的一点;
even if/though: [a]/ˈiv(ə)n ɪf ðoʊ/; [phr]虽然,即使;
get something across: [a]/ɡet ˈsʌmθɪŋ əˈkrɔs/; [phr]把..表达清楚;
pass sth on: [a]/pæs ˈsʌmθɪŋ ɔn/; [phr](to somebody)转交,传给,递给;
keep pace with: [a]/kiːp peɪs wɪð/; [phr]跟上,与..齐步前进,跟上.的最新发展;
be based on: [a]/biː beɪst ɑːn/; [phr]根据,以..为基准;
cut back on: [a]/kʌt bæk ɔn/; [phr]减少;
run out (of): [a]/rʌn aʊt əv/; [phr]用完,耗尽,从..跑出;
queue up: [a]/kju ʌp/; [phr]排队;
under way: [a]/'ʌndər weɪ/; [phr]在进行中;
push ahead with: [a]/pʊʃ ə'hed wɪð/; [phr]促进,推动;
for sale: [a]/fɔːr seɪl/; [phr]出售,待售;
on the one hand...on the other hand...: [a]/ɔn ðə wʌn hænd ɔn ðə ˈʌðər hænd/; [phr]一方面..另一方面..;
be/get burnt out: [a]/bi ɡet bɜrnt aʊt/; [phr]耗尽体力,累垮;
burn down: [a]/bɜːrn daʊn/; [phr]烧成平地,烧毁,烧光;
TV series: [a]/ˌti ˈvi ˈsɪriz/; [phr]电视系列片,电视剧;
talk show: [a]/ˈtɔːk ʃoʊ/; [phr]脱口秀,谈话节目;
switch over: [a]/swɪtʃ ˈoʊvər/; [phr]切换,转变;
distance learning: [a]/ˈdɪstəns lɜːrnɪŋ/; [phr]远程教育;
at the moment: [a]/ət ðə 'moʊmənt/; [phr]此时,此刻,现在,目前;
over the years: [a]/ˈoʊvər ði jɪrz/; [phr]多年来;
kong fu: [a]/ˌkʌŋ ˈfuː/; [phr](中国)功夫;
manned spaceship: [a]/mænd ˈspeɪsˌʃɪp/; [phr]载人宇宙飞船;
commit suicide: [a]/kəˈmɪt ˈsuɪˌsaɪd/; [phr]自杀;
apply for: [a]/ə'plaɪ fɔːr/; [phr]申请;
auto shop: [a]/ˈɔtoʊ ʃɑp/; [phr]自动售货店;
get in touch: [a]/ɡet ɪn tʌtʃ/; [phr]联络,联系;
in the flesh: [a]/ɪn ðə fleʃ/; [phr]本人;
be/get used to: [a]/biː juːzd tu/; [phr]习惯于;被用来;
date back (to): [a]/deɪt bæk tu/; [phr]可追溯到,始于(某时期);
upside down: [a]/ˌʌpsaɪd ˈdaʊn/; [phr]颠倒,混乱,倒转,翻转;
watch out: [a]/wɑːtʃ aʊt/; [phr]小心,提防;
water skiing: [a]/ˈwɔtər ˈskiɪŋ/; [phr]滑水;
get into trouble: [a]/ɡet 'ɪntʊ 'trʌbəl/; [phr]陷入困境,惹上麻烦;
make it to: [a]/meɪk ɪt tu/; [phr]到达某地;
make a living: [a]/meɪk ə ˈlɪvɪŋ/; [phr]谋生;
all at once: [a]/ɔːl æt wʌns/; [phr]同时;一起;突然;忽然;
back out: [a]/bæk aʊt/; [phr]退出,放弃,食言;
on one's way: [a]/ɔːn wʌnz weɪ/; [phr]即将来,即将上菜;
fed up: [a]/ˌfed ˈʌp/; [phr]厌倦;
air hostess: [a]/ˈer hoʊstəs/; [phr]空中小姐;
put into prison: [a]/pʊt ˈɪntu ˈprɪz(ə)n/; [phr]关进监狱;
credit card: [a]/ˈkredɪt kɑːrd/; [phr]信用卡;
go ahead with: [a]/ɡoʊ əˈhed wɪθ/; [phr]继续;
get used to: [a]/ɡet juːzd tu/; [phr]习惯于;
give...a lift: [a]/ɡɪv ə lɪft/; [phr]让---搭车;
sit up: [a]/'sɪtˌʌp/; [phr]坐直,坐起来,迟睡,熬夜;
speak up: [a]/spik ʌp/; [phr]大声讲,毫无顾虑地说出;
can't help doing sth: [a]/kænt help ˈduːɪŋ ˈsʌmθɪŋ/; [phr]禁不住做某事;
fellow students: [a]/ˈfeloʊ ˈstuːdnts/; [phr]同学;
dairy product: [a]/ˈdɛri ˈprɑdəkt/; [phr]乳制品;
lack of: [a]/læk ɑv/; [phr]缺乏;
in authority: [a]/ɪn ɔˈθɔrəti/; [phr]有权;
be shocked at: [a]/bi ʃɑkt ət/; [phr]对..很震惊;
burst in: [a]/bɜː(r)st ɪn/; [phr]打断,破门而入,突然出现;
bring back to life: [a]/brɪŋ bæk tu laɪf/; [phr]使恢复生命使.苏醒,使.复活,使.生动活泼;
banyan tree: [a]/'bænjən tri/; [phr]悦榕庄(酒店名),榕树;
school uniform: [a]/skul ˈjunəˌfɔrm/; [phr]校服;
close down: [a]/kloʊz daʊn/; [phr]关闭,停业;关闭;
get straight A's: [a]/ɡet streɪteɪ/; [phr]得全优;
in many ways: [a]/ɪn ˈmɛni wez/; [phr]在不同方面;
make money: [a]/meɪk 'mʌni/; [phr]赚钱;
be willing to do: [a]/bi ˈwɪlɪŋ tu doʊ/; [phr]愿意做某事,不反对做某事;
at one's own pace: [a]/æt wʌnz oʊn peɪs/; [phr]以轻松自在的速度;
make comments: [a]/meɪk ˈkɑːments/; [phr]发表议论,提出意见;
sense of achievement: [a]/sens ɑv əˈtʃivmənt/; [phr]成就感;
sense of satisfaction: [a]/sens ɑv ˌsætɪsˈfækʃ(ə)n/; [phr]满意感;
bring along: [a]/brɪŋ əˈlɔŋ/; [phr]带来;
search for: [a]/sɜːrtʃ fɔːr/; [phr]搜寻,寻找;
go out of style: [a]/ɡoʊ aʊt ɑv staɪl/; [phr]不再时兴,过时;
go against: [a]/ɡoʊ ə'ɡenst/; [phr]违反,对..不利;
be linked to: [a]/bi lɪŋkt tu/; [phr]连接,联系;
of some kind: [a]/ɑv səm kaɪnd/; [phr]某种;
pop into: [a]/pɑp ˈɪntu/; [phr]急急走进.;
meet one's needs: [a]/miːt wʌnz niːdz/; [phr]符合某人的需要;
a wide range of: [a]/ə waɪd reɪndʒ ɑv/; [phr]各式各样的;
step into: [a]/step ˈɪntu/; [phr]进入,着手做;
the greenhouse effect: [a]/ðə ˈɡriːnhaʊs ɪfekt/; [phr]温室效应;
go up to: [a]/ɡoʊ ʌp tu/; [phr]走上前去;
be equal in: [a]/bi ˈikwəl ɪn/; [phr]在..方面相同的;
command of: [a]/kəˈmænd ɑv/; [phr]掌握;
be forced to do: [a]/bi fɔrst tu doʊ/; [phr]被迫做某事;
be convenient for: [a]/bi kənˈviniənt fɔr/; [phr]方便的;
adapt...to: [a]/əˈdæpt tu/; [phr]使..适应;
a piece of clothing: [a]/ə pis ɑv ˈkloʊðɪŋ/; [phr]一件衣服;
be likely to do: [a]/bi ˈlaɪkli tu doʊ/; [phr]很有可能做某事;
distinguish...from: [a]/dɪˈstɪŋɡwɪʃ frɒm/; [phr]区别;
stick to: [a]/stɪk tu/; [phr]坚持,遵守,粘附在.上,紧跟,紧随;
keep fit: [a]/kiːp fɪt/; [phr]保持健康;
cosmetic surgery: [a]/kɑzˈmetɪk ˈsɜrdʒəri/; [phr]整容外科(手术);
ear lobe: [a]/ɪr loʊb/; [phr]耳垂;
aim at: [a]/eɪm æt/; [phr]瞄准,目的在于;
roar with laughter: [a]/rɔr wɪθ ˈlæftər/; [phr]哄堂大笑;
on top of: [a]/ɑːn tɑːp əv/; [phr]在..之上,停留在.之上,加之,控制住,对.了如指掌;
be equivalent to: [a]/bi ɪˈkwɪvələnt tu/; [phr]等于,相当于;
rowing machine: [a]/ˈroʊwɪŋ məʃiːn/; [phr]划式练力机;
take one's own life: [a]/teɪk wʌnz oʊn laɪf/; [phr]自杀;
take a peek at: [a]/teɪk ə pik ət/; [phr]偷看;
face cream: [a]/ˈfeɪs kriːm/; [phr]面霜;
define...as: [a]/dɪˈfaɪn əz/; [phr]给..下定义;
serve as: [a]/sɜrv əz ˈsʌmθɪŋ/; [phr]可用作,可当..使;
by coincidence: [a]/baɪ koˈɪnsɪdəns/; [phr]巧合地;
appeal to: [a]/əˈpiːl tu/; [phr](对某人)有吸引力,(使某人)感兴趣;
star rating: [a]/stɑːr ˈreɪtɪŋ/; [phr]星级评定;
price range: [a]/praɪs rendʒ/; [phr]价格区间;
special request: [a]/ˈspeʃl rɪˈkwest/; [phr]特殊要求;
whipped cream: [a]/wɪpt kriːm/; [phr]奶油;
salad dressing: [a]/ˈsæləd dresɪŋ/; [phr](供拌色拉或其他菜用的)沙拉酱,调味汁;
wine list: [a]/ˈwaɪn lɪst/; [phr]酒水单; [n](餐馆供应的)酒单;
on the rocks: [a]/ɑːn ðə rɑːks/; [phr]加冰的;
mixed drink: [a]/mɪkst drɪŋk/; [phr]鸡尾酒;
hard drink: [a]/hɑː(r)d drɪŋk/; [phr]带酒精的饮料;
main course: [a]/men kɔː(r)s/; [phr]主菜;
medium rare: [a]/ˈmidiəm rɛr/; [phr]3分熟;
medium well: [a]/ˈmidiəm wɛl/; [phr]7分熟;
well done: [a]/ˌwel ˈdʌn/; [phr]全熟的;
side dish: [a]/ˈsaɪd dɪʃ/; [phr]配菜;
by the window: [a]/baɪ ðə ˈwɪndoʊ/; [phr]靠窗;
out of: [a]/aʊt əv/; [phr]缺少,没有,售罄;
pepper mill: [a]/ˈpɛpɚ mɪl/; [phr]胡椒磨;
by card: [a]/baɪ kɑːrd/; [phr]用卡;
quiet table: [a]/ˈkwaɪət ˈteɪbl/; [phr]安静的位置;
romaine lettuce: [a]/roˈmen ˈlɛtəs/; [phr]长叶莴苣;
red cabbage: [a]/rɛd ˈkæbɪdʒ/; [phr]紫甘蓝;
bell pepper: [a]/ˈbel pepər/; [phr]甜椒;
red onion: [a]/red ˈʌnjən/; [phr]红皮洋葱;
green onion: [a]/ˌɡriːn ˈʌnjən/; [phr]青葱;
green bean: [a]/ˌɡriːn ˈbiːn/; [phr]四季豆;
black bean: [a]/blæk bin/; [phr]黑豆;
green pea: [a]/ɡriːn piː/; [phr]豌豆;
black olive: [a]/blæk ˈɑlɪv/; [phr]黑橄榄;
ground beef: [a]/ˌɡraʊnd ˈbiːf/; [phr]绞碎的牛肉;
grilled chicken: [a]/ɡrɪld ˈtʃɪkɪn/; [phr]烤鸡肉;
hard-boiled egg: [a]/ˌhɑːrd ˈbɔɪld eɡ/; [phr]水煮蛋;
pine nut: [a]/ˈpaɪn nʌt/; [phr]松子;
black pepper: [a]/ˌblæk ˈpepər/; [phr]黑胡椒;
lemon juice: [a]/ˈlemən dʒʊs/; [phr]柠檬汁;
olive oil: [a]/ˌɑːlɪv ˈɔɪl/; [phr]橄榄油;
vegetable oil: [a]/ˈvedʒtəbl ɔɪl/; [phr]植物油;
serving bowl: [a]/ˈsɜːrvɪŋ boʊl/; [phr]盛菜碗;
salad bowl: [a]/ˈsæləd bol/; [phr]沙拉碗;
salad spoon: [a]/ˈsæləd spuːn/; [phr]沙拉勺;
cutting board: [a]/ˈkʌtɪŋ bɔːrd/; [phr]砧板;
chef's knife: [a]/ˌʃefs naɪf/; [phr]主厨刀;
bread knife: [a]/brɛd naɪf/; [phr]面包刀;
cheese knife: [a]/tʃiz naɪf/; [phr]奶酪刀;
measuring cup: [a]/ˈmeʒərɪŋ kʌp/; [phr]量杯;
mortar and pestle: [a]/ˈmɔːrtər ənd ˈpesl/; [phr]研钵和研杵;
Ranch dressing: [a]/ræntʃ ˈdresɪŋ/; [phr]田园沙拉酱;
Caesar dressing: [a]/ˌsiːzər ˈdresɪŋ/; [phr]凯撒沙拉酱;
Italian dressing: [a]/ɪˈtæliən ˈdresɪŋ/; [phr]意式沙拉调味酱;
Blue Cheese dressing: [a]/bluː tʃiːz ˈdresɪŋ/; [phr]蓝纹奶酪酱;
Thousand Island dressing: [a]/ˌθaʊznd ˌaɪlənd ˈdresɪŋ/; [phr]千岛酱;
Honey mustard dressing: [a]/ˈhʌni ˈmʌstərd ˈdresɪŋ/; [phr]蜂蜜芥末沙拉酱;
French dressing: [a]/ˌfrentʃ ˈdresɪŋ/; [phr]法式沙拉酱;
burn to the ground: [a]/bɜːrn tu ði ɡraʊnd/; [phr]焚烧殆尽;
make one's way: [a]/meɪk wʌnz weɪ/; [phr]去往,前进;
glance through: [a]/ɡlæns θruː/; [phr]快速扫一眼,匆匆一瞥;
vary from...to...: [a]/ˈværi frʌm tu/; [phr]从..到..不等;
addicted to: [a]/ə'dɪktɪd tu/; [phr]对..上瘾;
accustomed to: [a]/əˈkʌstəmd tu/; [phr]习惯于;
decide on: [a]/dɪˈsaɪd ɑn/; [phr]决定,选定;
in spite of: [a]/ɪn spaɪt ʌv/; [phr]尽管,不管;
take risks: [a]/teɪk rɪsks/; [phr]冒险(做某事);
at risk: [a]/æt rɪsk/; [phr]有危险,冒风险;
quantities of: [a]/ˈkwɑ:ntəties ʌv/; [phr]大量,众多;
result in: [a]/rɪˈzʌlt ɪn/; [phr]导致,致使;
be opposed to: [a]/bi əˈpoʊzd tu/; [phr]强烈反对;
and so on: [a]/ənd soʊ ɑn/; [phr]等等,诸如此类;
make fun of: [a]/meɪk fʌn əv/; [phr]嘲笑,取笑;
test out: [a]/test aʊt/; [phr]彻底检查,仔细检查;
leave...alone: [a]/liːv əˈloʊn/; [phr]不烦扰,不打扰;
set aside: [a]/set əˈsaɪd/; [phr]省出(时间,金钱),放置一边;
in the meantime: [a]/ɪn ði ˈmiːntaɪm/; [phr]在..期间;
help out: [a]/help aʊt/; [phr]帮助..脱离困境;
be aware of: [a]/biː əˈwer əv/; [phr]发觉,意识到;
(be) scared to death: [a]/skerd tuː deθ/; [phr]吓得要死;
stick out: [a]/stɪk aʊt/; [phr]伸出;
dry out: [a]/draɪ aʊt/; [phr]使干透;
dry up: [a]/draɪ ʌp/; [phr]干涸;
in need: [a]/ɪn niːd/; [phr]在贫困中,在困难中;
sewing machine: [a]/ˈsoʊɪŋ məʃiːn/; [phr]缝纫机;
trunk library: [a]/trʌŋk ˈlaɪbrəri/; [phr]箱子图书馆;
adjust to: [a]/əˈdʒʌst tu:/; [phr]适应;
as far as one is concerned: [a]/æz fɑ: æz wʌn ɪz kənˈsɜ:nd/; [phr]就我而言;
feel at home: [a]/fi:l æt həum/; [phr]感到很舒服;
settle in: [a]/ˈsetl in/; [phr]迁入新居并安顿好;
make a life: [a]/meɪk ə laɪf/; [phr]谋生;
occur to...: [a]/əˈkɜː(r) tuː/; [phr]想起;
cast down: [a]/kɑːst daʊn/; [phr]沮丧;
in favor of: [a]/ɪn ˈfeɪvə əv/; [phr]支持;
set about: [a]/set əˈbaʊt/; [phr]着手进行;
in case: [a]/ɪn keɪs/; [phr]以防万一;
beaten track: [a]/ˈbiːtn træk/; [phr]常规;
dive into: [a]/daɪv ˈɪntuː/; [phr]手伸进去掏,跳进;
in truth: [a]/ɪn truːθ/; [phr]实际上;
in disguise: [a]/ɪn dɪsˈɡaɪz/; [phr]装扮,伪装;
make one's acquaintance: [a]/meɪk wʌnz əˈkweɪntəns/; [phr]与..相识;
in amazement: [a]/əˈmeɪzmənt/; [phr]惊愕,惊诧;
show...in: [a]/ʃəu in/; [phr]领进;
fade out: [a]/feid aut/; [phr](声音,画面)慢慢淡出;
small talk: [a]/ˈsmɔːl tɔːk/; [phr]闲谈,聊天;
make friends: [a]/meɪk frends/; [phr]交朋友;
(be)nervous about: [a]/ˈnɜːrvəs əˈbaʊt/; [phr]对..神经紧张/害怕/胆怯/焦虑不安;
body language: [a]/ˈbɑːdi læŋɡwɪdʒ/; [phr]身体语言,肢体语言;
look away from: [a]/lʊk əˈweɪ frəm/; [phr]把目光从.移开;
in addition: [a]/ɪn əˈdɪʃn/; [phr]除此之外,另外;
cheer sb up: [a]/tʃɪr sb ʌp/; [phr]使某人高兴/振作起来;
(be)aware of: [a]/əˈwer əv/; [phr]知道;
take the lead: [a]/teɪk ðə liːd/; [phr]领先;
play an important part in: [a]/pleɪ ən ɪmˈpɔːrtnt  pɑːrt ɪn/; [phr]在.中起重要作用,对.有重要影响;
come up to: [a]/kʌm ʌp tu/; [phr]朝.走过来;
turn away: [a]/təːrn əˈweɪ/; [phr]走开;转变方向;
sweep over: [a]/swip ˈoʊvər/; [phr]扫过;拓展;
keep one's eyes on: [a]/kiːp wʌnz aɪ ɑːn/; [phr]注视,盯着看,主意;
fix on: [a]/fɪks  ɔːn/; [phr]注视,凝视;
cast about: [a]/kæst əˈbaʊt/; [phr]寻找,搜索,想办法;
(be)laden with: [a]/biː ˈleɪdn wɪð/; [phr](空气中)充溢着(某种味道)的;
look around for: [a]/lʊk əˈraʊnd fər/; [phr]四处寻找;
put a spell on: [a]/pʊt  ə  spel ɔːn/; [phr]用符咒镇住;
(be) associated with: [a]/əˈsoʊʃieɪtɪd wɪð/; [phr]与.有关系,与.联系在一起;
appeal to sb: [a]/əˈpiːl tu sb/; [phr]对某人有吸引力,引起某人的兴趣;
(be)restricted to: [a]/rɪˈstrɪktɪd tu/; [phr]限于;
look back over one's shoulder: [a]/lʊk bæk ˈoʊvər wʌnz ˈʃoʊldər/; [phr]回头看;
catch a glimpse of: [a]/kætʃ ə ɡlɪmps əv/; [phr]瞥一眼,瞥见了;
burst out: [a]/bɜːrst aʊt/; [phr]突然发生,突然..起来;
knock...over: [a]/nɑːk ˈoʊvər/; [phr](开车)撞死,撞伤;
lose interest in: [a]/luːz ˈɪntrəst ɪn/; [phr]对.失去兴趣;
turn round: [a]/təːrn raʊnd/; [phr]转过身来;
raise money: [a]/reɪz ˈmʌni/; [phr]筹钱;
on the phone: [a]/ɑːn ðə foʊn/; [phr]在通话中;
keep in touch: [a]/kiːp in tʌtʃ/; [phr]与.保持联系;
lose touch with: [a]/luːz tʌtʃ  wɪð/; [phr]与..失去联系;
(be)ashamed of: [a]/əˈʃeɪmd əv/; [phr]对..感到羞愧,惭愧;
(be)allergic to: [a]/əˈlɜːrdʒɪk tu/; [phr]对.过敏;
(be)on good terms with: [a]/bi: ɔːn ɡʊd tɜːrm wɪð/; [phr]与某人关系很好;
(be)nostalgic for: [a]/biː nəˈstældʒɪk fɔːr/; [phr]对.很怀念;
bring...to mind: [a]/brɪŋ tu  maɪnd/; [phr]使.想起;
give concerts: [a]/ɡɪv ˈkɑːnsərts/; [phr]举办音乐会;
folk song: [a]/ˈfoʊk sɔːŋ/; [phr]民歌;
give life to: [a]/ɡɪv laɪf tu/; [phr]赋予.生命(生命力,活力);
(be)the same with: [a]/ðə seɪm wɪð/; [phr]与.情况相同;
share feelings and idea with: [a]/ʃer ˈfiːlɪŋz ənd aɪˈdiːə wɪð/; [phr]与.分享感受与想法;
make contact with: [a]/meɪk kɑːntækt wɪð/; [phr]与.进行往来;
master musician: [a]/ˈmæstər  mjuˈzɪʃn/; [phr]音乐大师;
compose music: [a]/kəmˈpoʊz  ˈmjuːzɪk/; [phr]创造乐曲;
barrel organ: [a]/ˈbærəl ɔːrɡən/; [phr]手摇风琴;
dance to the music: [a]/dæns tə ðə ˈmjuːzɪk/; [phr]伴着音乐跳舞;
draw upon: [a]/drɔ əˈpɔn/; [phr]凭借,利用;
burn out: [a]/bɜːrn aʊt/; [phr](火)燃尽,烧完自灭;
contrast with: [a]/kənˈtræst  wɪð/; [phr]与.形成对照;
throw oneself on: [a]/θrəu wʌnˋsɛlf ɔn/; [phr]扑倒在..上;
make a sound: [a]/meɪk ə saʊnd/; [phr]发出声音;
stem cell: [a]/ˈstem sel/; [phr]干细胞;
(be)identical to: [a]/aɪˈdentɪkl tə/; [phr]和.一样,与.一致;
knock out: [a]/nɑːk aʊt/; [phr]摧毁;
get out of control: [a]/ɡet aʊt kənˈtroʊl əv/; [phr]摆脱.控制;
bring...back to life: [a]/brɪŋ bæk tu laɪf/; [phr]使.复活;
declare war on: [a]/dɪˈkler wɔːr  ɔːn/; [phr]向.宣战;
make a breakthrough: [a]/meɪk ə ˈbreɪkθruː/; [phr]取得重大突破(进展);
war memorial: [a]/ wɔːr məˋmɔrɪəl/; [phr]战争纪念碑;
to one's astonishment: [a]/tə wʌns ə`stɑnɪʃmənt/; [phr]令某人惊讶的是;
adapt to: [a]/əˈdæpt tu/; [phr](使)适应;
set foot on: [a]/set fut ɔn/; [phr]进入,到达;
in case of: [a]/ɪn keɪs əv/; [phr]假使;
leave sth behind: [a]/liːv ˋsʌmθɪŋ bɪˋhaɪnd/; [phr]把.抛在后面;
get tired of doing sth: [a]/get taɪəd əv/; [phr]厌倦做某事;
at liberty: [a]/æt `lɪbərti /; [phr]获得自由的;
up to: [a]/ʌp tuː/; [phr]到(某个数量);
have...in common: [a]/hæv ɪn ˈkɔmən/; [phr]与.有共同点;
tell...apart: [a]/tɛl əˋpɑrt/; [phr]区分开;
a huge number of: [a]/ə  hjuːdʒ ˈnʌmbə(r)  əv/; [phr]大量的;
get down to sth: [a]/get daun tu/; [phr]开始做某事;
at the very beginning of: [a]/æt ðə ˋvɛrɪ bɪˈgɪnɪŋ əv/; [phr]在.一开始的时候;
accuse sb of doing sth: [a]/əˈkjuːz ˈsʌmbədɪ əv ˈduːɪŋ ˈsʌmθɪŋ/; [phr]指责某人某事;
pray for: [a]/preɪ fɔr/; [phr]祈望;
take hold of: [a]/teɪk hold əv/; [phr]抓住;
approve of sth: [a]/əˈpruːv  əv/; [phr]赞成某事;
a chorus of: [a]/ə ˋkɔrəs əv/; [phr]异口同声的;
cater for: [a]/keɪtər fɔr/; [phr]满足.的要求;
correspond with: [a]/,kɔrə`spɑnd wɪθ/; [phr]与.通信;
with an average of: [a]/wɪð æn ˈævrɪdʒ əv/; [phr]平均为;
be rude to: [a]/bi ruːd tu/; [phr]对.粗鲁;
draw sb's attention to: [a]/drɔ ˈsʌmbədi s əˈtɛnʃn tu/; [phr]引起某人注意(某事物);
take possession of: [a]/teɪk pəˈzeʃn əv/; [phr]占有,占据,拥有;
look back at: [a]/lʊk bæk ət/; [phr]回顾,回忆;
have fun: [a]/həv fʌn/; [phr]玩得开心;
dinner jacket: [a]/ˈdɪnər dʒækɪt/; [phr]男子晚礼服上装,无尾礼服上装(正式场合穿着,黑色或白色,通常打蝶形领结);
as far as I'm concerned: [a]/æz fɑ: æz aɪ ɛm kənˈsɜ:nd/; [phr]就我而言;
be considered as: [a]/bi kənˈsɪdərd æz/; [phr]被看作,被认为是;
in astonishment: [a]/ɪn əˈstɑːnɪʃmənt/; [phr]惊讶地,吃惊地;
in a...voice: [a]/ɪn ə vɔɪs/; [phr]用.声音(说),.声地;
no sooner...than...: [a]/noʊ 'su:nə ðæn/; [phr]刚一...就;
a huge amount of: [a]/ə hjuːdʒ əˈmaʊnt əv/; [phr]大量的;
bring sth to the attention of sb: [a]/brɪŋ ˈsʌmθɪŋ tu ði əˈtɛnʃn ʌv ˈsʌmθɪŋ/; [phr]使某人关注某事;
hip hop: [a]/ˈhɪp hɑːp/; [phr]嬉蹦乐(节奏强烈,说唱形式的一种流行伴舞音乐);
be bored with: [a]/bi bɔːrd wɪð/; [phr]厌烦;
take advantage of: [a]/teɪk ədˈvæntɪdʒ əv/; [phr]利用;
be devoted to: [a]/bi dɪˈvoʊtɪd tu/; [phr]对.专一,专注;
beg for: [a]/beɡ fər/; [phr]乞求,请求;
make an impression on sb: [a]/meɪk ən ɪmˈpreʃn ɑːn ˈsʌmbədi/; [phr]给某人留下印象;
bright-coloured: [a]/braɪt ˈkʌlərd/; [phr]颜色鲜艳的;
in use: [a]/ɪn yuz/; [phr]在使用;
remind sb of sth: [a]/rɪˈmaɪnd ˈsʌmbədi əv ˈsʌmθɪŋ/; [phr]使某人想起.;
symbolic ambassador: [a]/sɪmˈbɑlɪk æmˈbæsədər/; [phr]形象大使;
at the mercy of...: [a]/æt ðə ˈmɜːrsi əv/; [phr]受...支配;
be honoured for: [a]/ bi ˈɑːnərd tu/; [phr]因.受人尊敬;
come into view: [a]/kʌm ɪntə vjuː/; [phr]出现;
volcanic eruption: [a]/vɑːlˈkænɪk  ɪˈrʌpʃn/; [phr]火山爆发;
in a way: [a]/in ə weɪ/; [phr]在某种程度上说;
on one's side: [a]/ ɔːn  wʌnz saɪd/; [phr]侧身;
on the way to: [a]/ɔːn ðə weɪ tu/; [phr]在去.的路上;
pay rise: [a]/peɪ raɪz/; [phr]涨工资;
name...after: [a]/neɪm ˈæftər/; [phr]以.命名;
count on: [a]/kaʊnt  ɔːn/; [phr]依靠;
musical instrument: [a]/ˌmjuːzɪkl ˈɪnstrəmənt/; [phr]乐器;
suspension bridge: [a]/səˈspenʃn brɪdʒ/; [phr]吊桥;
burst out laughing: [a]/bɜːrst aʊt læfɪŋ/; [phr]突然大笑起来;
cash a cheque: [a]/kæʃ  ə tʃek/; [phr]兑现支票;
wait in line: [a]/weɪt ɪn laɪn/; [phr]排队等候;
black eye: [a]/ˌblæk ˈaɪ/; [phr](打得)鼻青脸肿;
from time to time: [a]/frəm taɪm tu  taɪm/; [phr]不时地;
run into: [a]/rʌn ˈɪntə/; [phr]撞上;
turn sb off: [a]/tɜːrn sb ɔːf/; [phr]令人讨厌;
boarding school: [a]/ˈbɔːrdɪŋ skuːl/; [phr]寄宿学校;
play around: [a]/pleɪ əˈraʊnd/; [phr]四处玩耍;
pull faces: [a]/pʊl feɪsis/; [phr]做鬼脸;
hang on a second: [a]/hæŋ ɑːn ə ˈsekənd/; [phr]等一下;
bits and pieces: [a]/bɪts ənd piːsis/; [phr]各种各样的零碎东西;
greenhouse effect: [a]/ 'ɡrinhaʊs ɪ'fɛkt /; [phr]温室效应;
beyond one's control: [a]/ bɪ'jɑnd wʌns kənˈtrol /; [phr]处于某人控制范围之外;
pin (on): [a]/ pɪn ɑn /; [phr]把责任加在(某人)身上;
take action: [a]/ tek 'ækʃən /; [phr]采取行动;
call for an end to sth: [a]/kɔl fɔr ən ɛnd tu 'sʌmθɪŋ/; [phr]要求结束..;
on one's behalf: [a]/ɑn wʌns bɪ'hæf/; [phr]代表;
plug one's ears: [a]/ plʌɡ wʌns ɪrs /; [phr]塞住耳朵;
sum up: [a]/sʌm ʌp/; [phr]总结;
hand over: [a]/ hand ˈəʊvə /; [phr]把.交给; [v]转交; [n](权力,责任等的)移交;
bid...goodbye: [a]/bɪd gʊd'baɪ/; [phr]向.告别;
be exposed to: [a]/bi ɪk'spozd tu/; [phr]处于可能受伤害的境地;
in a flash: [a]/ɪn ə flæʃ/; [phr]瞬间,即刻;
stand up for: [a]/ stand ʌp fɔr /; [phr]维护;
from then on: [a]/frʌm ðɛn ɑn/; [phr]从那时起;
subscribe (to): [a]/səb'skraɪb tu/; [phr]订阅(杂志或报纸);
the more...the more: [a]/ðə mɔr ðə mɔr/; [phr]越.就越.;
pushing up daisies: [a]/ pʊʃɪŋ ʌp 'deziz /; [phr](俚)死;
rope off: [a]/ rop ɔf /; [phr]用绳围起(隔开);
bring sth on sb: [a]/ brɪŋ 'sʌmθɪŋ ɑn 'sʌmbədi /; [phr]给某人招来(不愉快的)事情;
sort out: [a]/sɔːrt aʊt/; [phr]整理分类;解决(问题或困难);让.意识到;
life expectancy: [a]/ˈlaɪf ɪkspektənsi/; [phr]预期寿命;
wind sb up: [a]/wɪnd ˈsʌmbədi ʌp/; [phr]故意惹恼某人(尤指开玩笑);
knock into sb: [a]/ nɑk 'ɪntə /; [phr]撞上某人;
turning point: [a]/ˈtɜːrnɪŋ pɔɪnt/; [phr]转折点;
on principle: [a]/ɑn 'prɪnsəpl/; [phr]根据原则;
mother tongue: [a]/ˌmʌðər ˈtʌŋ/; [phr]母语;
for ages: [a]/fɔːr eɪdʒiz/; [phr]很久,很长时间;
I bet: [a]/aɪ bet/; [phr]我敢打赌;
Academy of Arts: [a]/əˈkædəmi əv arts/; [phr]艺术学院;
track and field: [a]/ˌtræk ən ˈfiːld/; [phr]田径运动;
in vain: [a]/ɪn veɪn/; [phr]徒然,白费力气;
at random: [a]/æt ˈrændəm/; [phr]随便地,随意地;
at all costs: [a]/æt ɔːl kɔsts/; [phr]不管多大代价,无论如何;
straight away: [a]/streɪt əˈweɪ/; [phr]立即,马上;
stop sth in its tracks: [a]/stɑːp ˈsʌmθɪŋ ɪn ɪts træks/; [phr]终止,消灭;
at any rate: [a]/æt ˈeni reɪt/; [phr]无论如何,至少;
attend a workshop: [a]/əˈtend ə ˈwɜːrkʃɑːp/; [phr]参加研讨会;
annual meeting: [a]/ˈænjuəl ˈmitɪŋ/; [phr]年会;
be responsible for: [a]/bi rɪˈspɑnsəbəl fɔr/; [phr]对.负责,是.的原因;
award a prize: [a]/əˈwɔːrd ə praɪz/; [phr]授奖;
catering service: [a]/ˈkeɪtərɪŋ ˈsɜːrvɪs/; [phr]饮食服务;
be in charge of: [a]/bi ɪn tʃɑrdʒ ʌv/; [phr]负责;
make a contribution: [a]/meɪk ə ˌkɑːntrɪˈbjuːʃn/; [phr]做贡献;
IT consultant: [a]/aɪtiː kənˈsʌltənt/; [phr](Information Technology consultant)信息技术顾问;
head office: [a]/ˌhed ˈɔːfɪs/; [phr]总公司;
finance assistant: [a]/ˈfaɪnæns əˈsɪstənt/; [phr]财务助理;会计助理;
chronic fatigue syndrome: [a]/ˌkrɑːnɪk fəˈtiːɡ sɪndroʊm/; [phr]慢性疲劳综合征;
job title: [a]/dʒɑb ˈtaɪtl/; [phr]职称,职位;
PA: [a]/ˌpiː ˈeɪ/; [phr](Personal Assistance)私人秘书;(=Product Assurance)产品安全;
production flow: [a]/prəˈdʌkʃən flo/; [phr]生产流程;
production manager: [a]/prəˈdʌkʃən ˈmænɪdʒɚ/; [phr]生产经理;
marathon running: [a]/ˈmærəθɑːn ˈrʌnɪŋ/; [phr]马拉松赛跑;
job applicant: [a]/dʒɑb ˈæplɪkənt/; [phr]求职人员;
sales rep: [a]/ˈseɪlz rep/; [phr]推销员;
scuba diving: [a]/ˈskubə 'daɪvɪŋ/; [phr]戴水肺潜水;
work for: [a]/wɚk fɔr/; [phr]为.工作;
convention centre: [a]/kənˈvɛnʃən ˈsɛntɚ/; [phr]会议中心;
finance director: [a]/fəˈnæns dɪˈrɛktɚ/; [phr]财务经理;
for or against: [a]/fɔːr ɔːr əˈɡeɪnst/; [phr]支持或反对;
one-to-one session: [a]/ˌwʌn tə ˈwʌn ˈseʃn/; [phr]一对一谈话,一对一会议;
marketing manager: [a]/ˈmɑːrkɪtɪŋ ˈmænɪdʒər/; [phr]市场销售经理;
maternity leave: [a]/məˈtɜːrnəti liːv/; [phr]产假;
period of transition: [a]/ˈpɪriəd ʌv trænˈzɪʃən/; [phr]过渡时期;
overall grade: [a]/ˌoʊvərˈɔːl ɡreɪd/; [phr]整体成绩;
potential client: [a]/pəˈtenʃl ˈklaɪənt/; [phr]潜在客户;
production plant: [a]/prəˈdʌkʃən plænt/; [phr]生产工厂;
project manager: [a]/prəˈdʒɛkt ˈmænɪdʒɚ/; [phr]项目经理;
quality inspector: [a]/ˈkwɑlɪti ɪnˈspɛktɚ/; [phr]质量检验员;
return flight: [a]/rɪˈtɚn flaɪt/; [phr]往返航班;
shopping centre: [a]/ˈʃɑːpɪŋ sentər/; [phr]购物中心;
core business: [a]/kɔr ˈbɪznɪs/; [phr]核心业务;
go public: [a]/ɡo ˈpʌblɪk/; [phr]上市;
level off: [a]/ˈlevəl ɔːf/; [phr](升或跌之后)呈平稳状态;
tour guide: [a]/tʊr ɡaɪd/; [phr]导游;
budget airline: [a]/ˈbʌdʒɪt ˈɛrˌlaɪn/; [phr]廉价航空;
trade fair: [a]/treɪd fer/; [phr]商品交易会;
take shape: [a]/teɪk ʃeɪp/; [phr]形成;体现;
take on: [a]/teɪk ɑːn/; [phr]从事;呈现;承担;接受;较量;开始雇用;
business partner: [a]/ˈbɪznəs ˈpɑːrtnər/; [phr]合伙人;
limited company: [a]/ˌlɪmɪtɪd ˈkʌmpəni/; [phr]有限公司;
budget figures: [a]/ˈbʌdʒɪt ˈfɪɡjərz/; [phr]预算数据;
still water: [a]/stɪl ˈwɔtɚ/; [phr]无气饮用水;
business conference: [a]/ˈbɪznɪs ˈkɑnfərəns/; [phr]业务会议;
purchasing manager: [a]/ˈpɜːrtʃəsɪŋ ˈmænɪdʒər/; [phr]采购经理;
sparkling water: [a]/ˈspɑrklɪŋ ˈwɔtɚ/; [phr]苏打水;
press release: [a]/ˈpres rɪliːs/; [phr]新闻稿;
remain steady: [a]/rɪˈmeɪn ˈstedi/; [phr](物价)稳定;
extension number: [a]/ɪkˈstɛnʃən ˈnʌmbɚ/; [phr]分机号码;
freight forwarder: [a]/fret ˈfɔrwədɚ/; [phr]货运代理;运输经纪人;
import ban: [a]/ˈɪmpɔrt bæn/; [phr]进口禁令;
mute button: [a]/ˈmjuːt bʌtn/; [phr]静音键,静噪键;
dish of the day: [a]/dɪʃ əv ðə deɪ/; [phr]今日推荐菜品;
printer cartridge: [a]/ˈprɪntɚ ˈkɑrtrɪdʒ/; [phr]打印机墨盒;
sole trader: [a]/sol ˈtredɚ/; [phr]独资经营;个体经营;
retail trade: [a]/ˈriˌtel treid/; [phr]零售业;
tax form: [a]/tæks fɔrm/; [phr]纳税申报表格;
time difference: [a]/taɪm ˈdɪfərəns/; [phr]时间差;
bank loan: [a]/bæŋk loʊn/; [phr]银行贷款;
be off: [a]/bi ɔf/; [phr]腐烂,变味;掉下,落下;离开;被取消;
business card: [a]/ˈbɪznəs kɑːrd/; [phr]名片;
business park: [a]/ˈbɪznəs pɑːrk/; [phr]商业园;商业区;
loan application: [a]/lon ˌæplɪˈkeʃən/; [phr]贷款申请;
make a loss: [a]/mek e lɔs/; [phr]亏损;
make a profit: [a]/mek e ˈprɑfɪt/; [phr]获利;
meet up: [a]/miːt ʌp/; [phr]遇见;约见;会见;
office block: [a]/ˈɔːfɪs blɑːk/; [phr]办公大楼;
on a small scale: [a]/ɑn e smɔl skel/; [phr]小规模地;
progress report: [a]/ˈprɑɡˌrɛs rɪˈpɔrt/; [phr]进度报告;
rat race: [a]/ræt reɪs/; [phr]不停的劳碌奔波;商业上竞争;
removal company: [a]/rɪˈmuːvl ˈkʌmpəni/; [phr]搬家公司;
stress out: [a]/strɛs aʊt/; [phr]过度劳累;紧张;
air traffic controller: [a]/ˌer træfɪk kənˈtroʊlər/; [phr]空中交通管制员;
best regards: [a]/best rɪˈɡɑːrdz/; [phr]问候;致敬;
excess charge: [a]/ˈɛkˌsɛs tʃɑrdʒ/; [phr]逾重费;
first class: [a]/ˌfɜːrst ˈklæs/; [phr]头等舱;
flight attendant: [a]/ˈflaɪt ətendənt/; [phr]空中服务员;
fully booked: [a]/ˈfʊli bʊkt/; [phr]客满;
concierge service: [a]/kɔːnˈsjerʒ ˈsɜːrvɪs/; [phr]门房服务;
in-flight magazine: [a]/ˌɪn ˈflaɪt ˈmæɡəziːn/; [phr]机上杂志;
check-in clerk: [a]/ˈtʃek ɪn klɜːrk/; [phr]验票员;
secretarial services: [a]/ˌsekrəˈteriəl ˈsɜːrvɪsɪs/; [phr]秘书服务;
video projector: [a]/ˈvɪdioʊ prəˈdʒektər/; [phr]图像投影机;
agree on: [a]/əˈɡriː ɑːn/; [phr]对.意见一致;
be made of: [a]/bi meɪd əv/; [phr]由..构成;由..组成;
economy class: [a]/ɪˈkɑnəmi klæs/; [phr]经济舱;
business class: [a]/ˈbɪznəs klæs/; [phr]商务舱;
connecting flight: [a]/kəˈnɛktɪŋ flaɪt/; [phr]转接班机;
courier company: [a]/ˈkʊriər ˈkʌmpəni/; [phr]速递公司;
penalty charge: [a]/ˈpenəlti tʃɑːrdʒ/; [phr]罚款费用;
filing cabinet: [a]/ˈfaɪlɪŋ kæbɪnət/; [phr]档案橱柜;
per annum: [a]/pər ˈænəm/; [phr]每年;
fire brigade: [a]/ˈfaɪər brɪɡeɪd/; [phr]消防队;
pen drive: [a]/ˈpen draɪv/; [phr]闪存盘,U盘;
running costs: [a]/ˈrʌnɪŋ kɔːsts/; [phr]运行成本,日常管理费用,流水成本;
tuition fee: [a]/tuˈɪʃən fi/; [phr]学费;
light setting: [a]/laɪt ˈsetɪŋ/; [phr]照明装置;
value for money: [a]/ˈvælju fɔr ˈmʌni/; [phr]物超所值;
anti-virus program: [a]/ˈænti ˈvaɪrəs ˈproʊɡræm/; [phr]反病毒程序;
dial-up connection: [a]/ˈdaɪəl ʌp kəˈnekʃn/; [phr]拨号连接;
be on site: [a]/bi ɑːn saɪt/; [phr]在现场;
factory floor: [a]/ˌfæktri ˈflɔːr/; [phr]工厂车间;
financial return: [a]/faɪˈnænʃl rɪˈtɜːrn/; [phr]财政收益;
heat up: [a]/hit ʌp/; [phr]加热;加剧;
key feature: [a]/ki ˈfitʃɚ/; [phr]关键特征;
plug in: [a]/ˈplʌɡˌɪn/; [phr]插入;插上插头;
smoke alarm: [a]/ˈsmoʊk əlɑːrm/; [phr]烟气报警器;
loading bay: [a]/ˈlodɪŋ be/; [phr]装货间;进料台;
under licence: [a]/ˈʌndər ˈlaɪsns/; [phr]获得许可证,领有执照;
lean manufacturing: [a]/liːn ˌmænjuˈfæktʃərɪŋ/; [phr]精益生产,精实制造;
optical cell: [a]/ˈɑːptɪkl sel/; [phr]光学元件;
response time: [a]/rɪˈspɑːns taɪm/; [phr]响应时间;
shipping company: [a]/ˈʃɪpɪŋ ˈkʌmpəni/; [phr]航运公司;轮船公司;
local council: [a]/ˈloʊkl ˈkaʊnsl/; [phr]市政委员会;市议会;
departmental meeting: [a]/ˌdiːpɑːrtˈmentl ˈmiːtɪŋ/; [phr]部门会议;
after-school care: [a]/ˈæftər skuːl ker/; [phr]托儿中心;课后托管;
draw up a plan: [a]/drɔ ʌp e plæn/; [phr]制定计划;
bring down: [a]/brɪŋ daʊn/; [phr]使倒下;减少;
blow over: [a]/blo ˈovɚ/; [phr]平息;停止;被忘掉;
exhaust emission: [a]/ɪɡˈzɔst ɪˈmɪʃən/; [phr]汽车废气排放;
emergency team: [a]/iˈmɜːrdʒənsi tiːm/; [phr]抢救队;
lamb chops: [a]/læm tʃɑːps/; [phr]羊排;
run a meeting: [a]/rʌn eɪ ˈmiːtɪŋ/; [phr]开会;
solar panel: [a]/ˌsoʊlər ˈpænl/; [phr]太阳能电池板;
steak tartar: [a]/steɪk ˈtɑːrtər/; [phr]鞑靼牛排;
high-speed trains: [a]/ˌhaɪ ˈspiːd treɪns/; [phr]高速列车;
start up: [a]/ˈstɑːrtˌʌp/; [phr]创办;开动;开机;开办;新成立的;
exchange rate: [a]/ɪksˈtʃeɪndʒ reɪt/; [phr]汇率;兑换率;
sweep across: [a]/swiːp əˈkrɔːs/; [phr]席卷,横扫;冲过,迅速掠过;
take time off: [a]/teɪk taɪm ɔːf/; [phr]抽出时间;
waiting time: [a]/ˈwetɪŋ taɪm/; [phr]等待时间;待命时间;停工时间;
joint venture: [a]/ˌdʒɔɪnt ˈventʃər/; [phr]合资企业;
sales team: [a]/ˈseɪlz tiːm/; [phr]销售团队;
shopping list: [a]/ˈʃɑːpɪŋ lɪst/; [phr]购物单;
viable option: [a]/ˈvaɪəbl ˈɑːpʃn/; [phr]可行的替代方案;
chamber of commerce: [a]/ˈtʃembɚ ʌv ˈkɑməs/; [phr]商会;
dress code: [a]/ˈdres koʊd/; [phr]着装要求;
move on: [a]/mʊv ɑːn/; [phr]继续前进,更换工作(话题等),离开;
assembly point: [a]/əˈsɛmbli pɔɪnt/; [phr]集合地点;
baggage handler: [a]/ˈbæɡɪdʒ ˈhændlɚ/; [phr]行李员;
baby grand piano: [a]/ˈbebi ɡrænd piˈæno/; [phr]小型平台式钢琴;
be hospitalised: [a]/bi ˈhɑːspɪtəlaɪz/; [phr]住院;
big toe: [a]/ˌbɪɡ ˈtoʊ/; [phr]大趾;
clock in: [a]/klɑk ɪn/; [phr]打卡上班;记录上班时间;
facial bruising: [a]/ˈfeɪʃl ˈbruːzɪŋ/; [phr]面部擦伤;
fire drill: [a]/ˈfaɪər drɪl/; [phr]消防演习;
fire exit: [a]/faɪr ˈɛɡzɪt/; [phr]安全出口,紧急出口;
get the sack: [a]/ɡɛt ði sæk/; [phr]被解雇;被辞退;
heat exhaustion: [a]/hit ɪɡˈzɔstʃən/; [phr]中暑衰竭(指轻度中暑);
high voltage: [a]/haɪ ˈvoʊltɪdʒ/; [phr]高电压,高压;
listen for: [a]/ˈlɪsən fɔr/; [phr]注意倾听;
locker room: [a]/ˈlɑːkər ruːm/; [phr]更衣室,衣帽间;
lose one's balance: [a]/luːz wʌnz ˈbæləns/; [phr]失去平衡,心慌意乱;
movable barrier: [a]/ˈmuvəbəl ˈbæriɚ/; [phr]可移动障碍物,可移动阻片;
on offer: [a]/ɑn ˈɔfɚ/; [phr]降价出售;
pool table: [a]/pʊl ˈteɪbəl/; [phr]台球桌;
protective mask: [a]/prəˈtɛktɪv mæsk/; [phr]防毒面具;
reduce the risk: [a]/rɪˈduːs ðə rɪsk/; [phr]降低风险;
video beamer: [a]/ˈvɪdioʊ ˈbiːmə/; [phr]视频投影机;
covering letter: [a]/ˌkʌvərɪŋ ˈletər/; [phr](附于包裹或信件内用于说明或附言的)附信,求职信;
cruise ship: [a]/kruz ʃɪp/; [phr]游艇;
sound system: [a]/ˈsaʊnd sɪstəm/; [phr]音响设备;
export contract: [a]/ɪksˈpɔrt ˈkɑnˌtrækt/; [phr]出口合同;
financial services: [a]/faɪˈnænʃ(ə)l ˈsɜːvɪsis/; [phr]金融服务;
waste material: [a]/west məˈtɪriəl/; [phr]废料;
water consumption: [a]/ˈwɔtɚ kənˈsʌmpʃən/; [phr]水消耗,耗水量;
participate in: [a]/pɑrˈtɪsəˌpet ɪn/; [phr]参与,参加;
global marketplace: [a]/ˈɡloʊbl ˈmɑːrkɪtpleɪs/; [phr]全球市场;
health care: [a]/ˈhelθ ker/; [phr]卫生保健;
fight back: [a]/faɪt bæk/; [phr]反击,抵抗;
job-related skills: [a]/dʒɑːb rɪˈleɪtɪd skɪls/; [phr]职业相关技能;
solid waste: [a]/ˈsɑlɪd west/; [phr]固体废料;
sign in: [a]/saɪn ɪn/; [phr]签到,登记;
sign out: [a]/saɪn aʊt/; [phr]签名登记离开;
parent company: [a]/ˈperənt ˈkʌmpəni/; [phr]母公司,总公司;
accounts clerk: [a]/əˌkaʊnts klɜːrk/; [phr]财务文员,会计文员,账务员;
product launch: [a]/ˈprɑːdʌkt lɔːntʃ/; [phr]产品发布;
post office: [a]/ˈpoʊst ɔːfɪs/; [phr]邮局;
business plan: [a]/ˈbɪznɪs plæn/; [phr]商务计划,经营规划;
do sth different: [a]/duː ˈsʌmθɪŋ ˈdɪfrənt/; [phr]做些不同的事;
make progress: [a]/mek ˈprɑɡˌrɛs/; [phr]取得进步;
more than ever: [a]/mɔːr ðən ˈevər/; [phr]更加,越发,尤其;
spend on sth: [a]/spend ɑːn ˈsʌmθɪŋ/; [phr]在某物上花费多少钱;
take a holiday: [a]/tek e ˈhɑlɪˌde/; [phr]休假;
business centre: [a]/ˈbɪznɪs ˈsɛntɚ/; [phr]商业中心;
check-in desk: [a]/ˈtʃek ɪn desk/; [phr]办理登机手续处;
low cost: [a]/lo kɔst/; [phr]低成本;
email address: [a]/ˈiːmeɪl əˈdres/; [phr]电子邮件地址;
lose your job: [a]/luːz jʊr dʒɑːb/; [phr]失去你的工作;
Internet connection: [a]/ˈɪntərnet kəˈnekʃn/; [phr]网络连接;
personal details: [a]/ˈpɜːrsənl ˈdiːteɪlz/; [phr]个人信息;
IT technician: [a]/ɪt tekˈnɪʃn/; [phr](information technology technician)信息技术员,信息技术工程师;
factory worker: [a]/ˈfæktəri ˈwɚkɚ/; [phr]工厂工人;
kind regards: [a]/kaɪnd rɪˈɡɑːrdz/; [phr]谨致问候;
magazine editor: [a]/ˈmæɡəziːn ˈedɪtər/; [phr]期刊编辑;
electrical goods: [a]/ɪˈlektrɪkl ɡʊdz/; [phr]电气产品;
training course: [a]/ˈtrenɪŋ kɔː(r)s/; [phr]培训课程;
personnel manager: [a]/ˌpɚsəˈnɛl ˈmænɪdʒɚ/; [phr]人事主管人;
service user: [a]/ˈsɜːrvɪs ˈjuːzər/; [phr]服务使用者;
career field: [a]/kəˈrɪr fild/; [phr]事业领域;
run a business: [a]/rʌn eɪ ˈbɪznəs/; [phr]经营生意;
high-heel shoes: [a]/ˌhaɪ ˈhiːl ʃuːz/; [phr]高跟鞋;
university campus: [a]/ˌjuːnɪˈvɜːrsəti ˈkæmpəs/; [phr]大学校园;
fire alarm: [a]/ˈfaɪər əlɑːrm/; [phr]火警;
application form: [a]/ˌæplɪˈkeɪʃən fɔːrm/; [phr]申请表;
conference pack: [a]/ˈkɑːnfərəns pæk/; [phr]会议文件;
safety inspection: [a]/ˈsefti ɪnˈspɛkʃən/; [phr]安全检查;
health and safety: [a]/hɛlθ ənd ˈsefti/; [phr]健康与安全部门;
rail link: [a]/rel lɪŋk/; [phr]铁路联络线;
shift work: [a]/ʃɪft wɚk/; [phr]换班工作,倒班工作; [n]轮班;
involved in: [a]/ɪnˈvɑːlvd ɪn/; [phr]涉及,包含在..中;
branch out: [a]/bræntʃ aʊt/; [phr]拓展业务,扩展范围;
profit margin: [a]/ˈprɑːfɪt mɑːrdʒən/; [phr]利润率;
trade name: [a]/ˈtreɪd neɪm/; [phr]商品名称,商号,店名;
search engine: [a]/ˈsɜːrtʃ endʒɪn/; [phr]搜索引擎;
TV commercial: [a]/ˌtiː ˈviː kəˈmɜːrʃl/; [phr]电视中的商业广告;
give a presentation: [a]/ɡɪv eɪ ˌpriːzenˈteɪʃn/; [phr]做演示,做展示;
go along: [a]/ɡoʊ əˈlɔːŋ/; [phr]赞同,支持,进行,前进;
hold a meeting: [a]/hold e ˈmitɪŋ/; [phr]举行会议;
reach an agreement: [a]/ritʃ ən əˈɡrimənt/; [phr]达成一致;
see one's point: [a]/siː wʌnz pɔɪnt/; [phr]明白某人的意思;
set the agenda: [a]/sɛt ði əˈdʒɛndə/; [phr]制定议程;
take the minutes: [a]/teɪk ðə ˈmɪnɪts/; [phr]做会议记录;
click on: [a]/klɪk ɑn/; [phr]点击,打开,启动;
call center: [a]/kɔl ˈsɛntɚ/; [phr]呼叫中心;
walk out: [a]/wɔːk aʊt/; [phr]罢工;
cash bonus: [a]/kæʃ ˈboʊnəs/; [phr]现金分红;
distribution centre: [a]/ˌdɪstrəˈbjuʃən ˈsɛntɚ/; [phr]配送中心,分销中心;
word of mouth: [a]/wɚd ʌv maʊθ/; [phr]口头语,口碑;
newspaper advert: [a]/ˈnuːzpeɪpər ˈædvɜːrt/; [phr]报纸广告;
take with a pinch of salt: [a]/teɪk wɪð eɪ pɪntʃ əv sɔːlt/; [phr]部分相信(将信将疑);
internet advertising: [a]/ˈɪntərnet ˈædvərtaɪzɪŋ/; [phr]互联网广告;
parental leave: [a]/pəˌrentl ˈliːv/; [phr]育婴假,亲职假;
make redundant: [a]/meɪk rɪˈdʌndənt/; [phr]裁员;
shut down: [a]/ʃʌt daʊn/; [phr]关闭,(使)停工;
joint responsibility: [a]/dʒɔɪnt rɪˌspɑnsəˈbɪlɪti/; [phr]连带责任;
key factor: [a]/ki ˈfæktɚ/; [phr]关键因素;
formulate a response: [a]/ˈfɔːrmjuleɪt eɪ rɪˈspɑːns/; [phr]制定对策,回应;
meet objective: [a]/miːt əbˈdʒektɪv/; [phr]满足目标;
single user: [a]/ˈsɪŋɡl ˈjuːzər/; [phr]单用户模式,单一使用者;
team building: [a]/ˈtiːm bɪldɪŋ/; [phr]团队建设;
brand identity: [a]/brænd aɪˈdentəti/; [phr]品牌特色,品牌识别,品牌标识;
quality assurance: [a]/ˈkwɑːləti əʃʊrəns/; [phr]质量保证;
speech recognition technology: [a]/spiːtʃ ˌrekəɡˈnɪʃn tekˈnɑːlədʒi/; [phr]语音识别技术;
plan a strategy: [a]/plæn eɪ ˈstrætədʒi/; [phr]制定策略;
sales pitch: [a]/ˈseɪlz pɪtʃ/; [phr]兜揽生意的话,推销词;
set targets: [a]/set ˈtɑːrɡɪts/; [phr]制定目标;
succeed in: [a]/səkˈsid ɪn/; [phr]取得成功;
break even: [a]/ˈbreɪkˈiːvən/; [phr]不赔不赚,收支相抵;
avoid interruption: [a]/əˈvɔɪd ˌɪntəˈrʌpʃn/; [phr]避免中断;
cross-cultural awareness: [a]/ˌkrɔːs ˈkʌltʃərəl əˈwernəs/; [phr]跨文化意识;
face-to-face training: [a]/ˌfeɪs tə ˈfeɪs ˈtreɪnɪŋ/; [phr]面对面教学;
remain stable: [a]/rɪˈmeɪn ˈsteɪbl/; [phr]保持稳定;
ahead of schedule: [a]/əˈhed əv ˈskedʒuːl/; [phr]提前,超前;
behind schedule: [a]/bɪˈhaɪnd ˈskɛdʒul/; [phr]晚点,比预定计划(时间)晚;
develop an understanding: [a]/dɪˈveləp ən ˌʌndərˈstændɪŋ/; [phr]理解;
learn a great deal: [a]/lɜːrn eɪ ɡreɪt diːl/; [phr]学到很多;
miss opportunity: [a]/mɪs ˌɑːpərˈtuːnəti/; [phr]错失机会;
on schedule: [a]/ɑːn ˈskedʒʊl/; [phr]按预定时间;
out of time: [a]/aʊt ʌv taɪm/; [phr]不合拍,不合时宜;
take care: [a]/teɪk ker/; [phr]保重,当心,注意;
fire off: [a]/faɪr ɔf/; [phr]一连串提问(责难等),开炮,发射;
give notice: [a]/ɡɪv ˈnoʊtɪs/; [phr]离职通知;
take someone on: [a]/tek ˈsʌmˌwʌn ɑn/; [phr]聘用某人;
holding company: [a]/ˈhoʊldɪŋ kʌmpəni/; [phr]控股公司;
take seriously: [a]/tek ˈsɪriəsli/; [phr]认真对待.;
take voluntary redundancy: [a]/teɪk ˈvɑːlənteri rɪˈdʌndənsi/; [phr]自愿裁汰;
subject line: [a]/ˈsʌbdʒekt laɪn/; [phr]标题栏,主题栏;
close the sale: [a]/kloʊz ðə seɪl/; [phr]完成销售,成交;
a day off: [a]/e de ɔf/; [phr]放一天假,休息日,请一天假;
interpersonal skill: [a]/ˌɪntɚˈpɚsənəl skɪl/; [phr]社交技巧;
job seeker: [a]/ˈdʒɑːb siːkər/; [phr]求职者;
personal achievement: [a]/ˈpɜːrsənl əˈtʃiːvmənt/; [phr]个人成就;
listed company: [a]/ˌlɪstɪd ˈkʌmpəni/; [phr]上市公司;
clear lines of reporting: [a]/klɪr laɪnz əv rɪˈpɔːrtɪŋ/; [phr]明确划分权限和职责范围;
customer satisfaction: [a]/ˈkʌstəmɚ ˌsætɪsˈfækʃən/; [phr]客户满意度;
go out of business: [a]/ɡoʊ aʊt əv ˈbɪznɪs/; [phr]倒闭,歇业,破产;
high tempo: [a]/haɪ ˈtempoʊ/; [phr]高速度;
job security: [a]/dʒɑːb səˈkjʊrəti/; [phr]职业安全感,工作保障;
issue a press release: [a]/ˈɪʃuː eɪ pres rɪˈliːs/; [phr]发布新闻稿;
long-term planning: [a]/ˌlɔːŋ ˈtɜːrm ˈplænɪŋ/; [phr]长期规划;
non-financial reward: [a]/nɑːn faɪˈnænʃl rɪˈwɔːrd/; [phr]非财务奖励;
sales office: [a]/seɪlz ˈɔːfɪs/; [phr]销售办事处;
sell off: [a]/ˈselˌɔːfˌ-ˌɑːf/; [phr]廉价出售(存货);
communication channel: [a]/kəˌmjunɪˈkeʃən ˈtʃænəl/; [phr]信道,通信电路;
advertising campaign: [a]/ˈædvɚˌtaɪzɪŋ kæmˈpen/; [phr]广告活动;
what's more: [a]/wɑːts mɔːr/; [phr](常用作插入语)更重要的是,而且,另外,此外,甚者;
owing to: [a]/ˈoʊɪŋ tə/; [phr]由于,因为;
buying signal: [a]/baɪ-ɪŋ ˈsɪɡnəl/; [phr]购买信号;
added value: [a]/æd ˈvæljuː/; [phr]净增值,增值价值;
after-sales service: [a]/ˌæftər ˌseɪlz ˈsɜːrvɪs/; [phr]售后服务;
competitive advantage: [a]/kəmˈpɛtɪtɪv ædˈvæntɪdʒ/; [phr]竞争优势;
customer needs: [a]/ˈkʌstəmər niːdz/; [phr]顾客需求,消费者需求;
decision maker: [a]/dɪˈsɪʒən ˈmekɚ/; [phr]决策者;
direct mail: [a]/dəˌrekt ˈmeɪl/; [phr]直接邮寄广告;
perceived benefits: [a]/pərˈsiːvd ˈbenɪfɪts/; [phr]感知利得,感知利益;
favorable terms: [a]/ˈfeɪvərəbl tɜːrmz/; [phr]优惠条件;
mass marketing: [a]/mæs ˈmɑrkɪtɪŋ/; [phr]大众营销,大规模市场销售;
niche marketing: [a]/niːʃ ˈmɑːrkɪtɪŋ/; [phr]利基营销,对路适销;
point-of-sale promotion: [a]/ˌpɔɪnt əv ˈseɪl prəˈmoʊʃn/; [phr]销售终端促销;
price competition: [a]/praɪs ˌkɑmpɪˈtɪʃən/; [phr]价格竞争;
unique selling point: [a]/juˈniːk ˈselɪŋ pɔɪnt/; [phr]独特卖点;
viral marketing: [a]/ˌvaɪrəl ˈmɑːrkətɪŋ/; [phr]病毒式营销;
pension scheme: [a]/ˈpenʃn skiːm/; [phr]退休金计划;
accounts payable: [a]/əˌkaʊnts ˈpeɪəbl/; [phr]应付账款;
accounts receivable: [a]/əˌkaʊnts rɪˈsiːvəbl/; [phr]应收账款;
asset value: [a]/ˈæsˌɛt ˈvælju/; [phr]资产价值;
be short of money: [a]/bi ʃɔːrt əv ˈmʌni/; [phr]缺钱;
negative equity: [a]/ˌneɡətɪv ˈekwəti/; [phr]负资产净值,负资产抵押;
negotiate a discount: [a]/nɪˈɡoʊʃieɪt eɪ ˈdɪskaʊnt/; [phr]商讨折扣;
net income: [a]/net ˈɪnˌkʌm/; [phr]净收入;
profit and loss: [a]/ˈprɑːfɪt ənd lɔːs/; [phr]盈亏帐目,损益;
retained profit: [a]/rɪˈteɪnd ˈprɑːfɪt/; [phr]留存收益,留存盈利;
wage bill: [a]/weɪdʒ bɪl/; [phr]工资单;
seasonal discounts: [a]/ˈsiːzənl ˈdɪskaʊnts/; [phr]季节性折扣;
mint condition: [a]/mɪnt kənˈdɪʃn/; [phr]崭新的;
prompt payment: [a]/prɑmpt ˈpemənt/; [phr]立即付款;
overseas subsidiary: [a]/ˌoʊvərˈsiːz səbˈsɪdieri/; [phr]海外子公司;
control freak: [a]/kənˈtroʊl friːk/; [phr]控制狂;
people skills: [a]/ˈpiːpl skɪls/; [phr]社交技能,待人处世技能;
share the cost of: [a]/ʃer ðə kɔːst əv/; [phr]分担费用;
in addition to: [a]/ɪn əˈdɪʃən tu/; [phr]除..之外(还);
nuclear radiation leak: [a]/ˈnuːkliər ˌreɪdiˈeɪʃn liːk/; [phr]核辐射泄漏;
shortage of stock: [a]/ˈʃɔːrtɪdʒ əv stɑːk/; [phr]存货短缺;
oil spill: [a]/ɔːɪl spɪl/; [phr]漏油;
right to anonymity: [a]/raɪt tə ˌænəˈnɪməti/; [phr]匿名权;
social responsibility: [a]/ˈsoʃəl rɪˌspɑnsəˈbɪlɪti/; [phr]社会责任;
support local shops: [a]/səˈpɔːrt ˈloʊkl ʃɑːps/; [phr]扶持本地企业;
economic policy: [a]/ˌiːkəˈnɑːmɪk ˈpɑːlɪsi/; [phr]经济政策;
renew the contract: [a]/rɪˈnuː ðə ˈkɑːntrækt/; [phr]续签合同;
see sth through: [a]/siː ˈsʌmθɪŋ θruː/; [phr]把某事坚持到底,使(某事)顺利通过.;
stand up to sb: [a]/stænd ʌp tə ˈsʌmbədi/; [phr]与某人对抗;
do a deal: [a]/duː eɪ diːl/; [phr]达成一笔交易;
break the ice: [a]/breɪk ðə aɪs/; [phr]打破冷场,打破僵局;
consumer confidence: [a]/kənˌsuːmər ˈkɑːnfɪdəns/; [phr]消费者信心;
car share scheme: [a]/kɑːr ʃer skiːm/; [phr]汽车共享计划;
get lost: [a]/ɡet lɔːst/; [phr]迷路,滚开;
get married: [a]/ɡet ˈmæriːd/; [phr]结婚;
get sb involved: [a]/ɡet ˈsʌmbədi ɪnˈvɑːlvd/; [phr]使某人参与;
get ready: [a]/ɡɛt ˈrɛdi/; [phr]准备好;
get to know: [a]/ɡet tə noʊʊ/; [phr]了解,认识;
give sb a lift: [a]/ɡɪv ˈsʌmbədi eɪ lɪft/; [phr]让某人搭便车;
climate change: [a]/ˈklaɪmət tʃeɪndʒ/; [phr]气候变化;
environmentally friendly: [a]/ɪnˌvaɪrənmentəli ˈfrendli/; [phr]环境友好型的;
go according to plan: [a]/ɡoʊ əˈkɔːrdɪŋ tə plæn/; [phr]按计划进行;
go crazy: [a]/ɡo ˈkrezi/; [phr]发疯;
ethical code: [a]/ˈɛθɪkəl kod/; [phr]伦理规章;
go wrong: [a]/ɡoʊ rɔːŋ/; [phr]出错,发生故障;
rush hour: [a]/ˈrʌʃ aʊər/; [phr]上下班高峰时间,交通拥挤时间;
travel expenses: [a]/ˈtrævl ɪkˈspensɪs/; [phr]旅费;
affordable housing: [a]/əˈfɔrdəbəl ˈhaʊzɪŋ/; [phr]经济适用房;
ageing population: [a]/ˈedʒɪŋ ˌpɑpjəˈleʃən/; [phr]人口老龄化;
buying power: [a]/baɪ-ɪŋ ˈpaʊər/; [phr]购买力;
cost of living: [a]/kɔːst əv ˈlɪvɪŋ/; [phr]生活成本;
import duty: [a]/ˈɪmpɔːrt ˈdʊti/; [phr]进口税;
man-made disaster: [a]/ˌmæn ˈmeɪd dɪˈzæstər/; [phr]人为灾害;
in touch: [a]/ɪn tʌtʃ/; [phr]保持联系;在.能达到的地方;
cultural values: [a]/ˈkʌltʃərəl ˈvæljuːz/; [phr]文化价值观;
firsthand experience: [a]/ˌfɜːrstˈhænd ɪkˈspɪriəns/; [phr]亲身体验;
free trade: [a]/ˌfriː ˈtreɪd/; [phr]自由贸易;
welfare state: [a]/ˌwelfer ˈsteɪt/; [phr]福利国家;
get straight to the point: [a]/ɡet streɪt tə ðə pɔɪnt/; [phr]直奔主题;
multi-national corporation: [a]/ˈmʌlti ˈnæʃnəl ˌkɔːrpəˈreɪʃn/; [phr]跨国公司;
stock levels: [a]/stɑːk ˈlevls/; [phr]库存水平;
propose a toast: [a]/prəˈpoz e tost/; [phr]举杯,敬酒;
shake hands: [a]/ʃeɪk hændz/; [phr]握手;
social integration: [a]/ˈsoʃəl ˌɪntɪˈɡreʃən/; [phr]社会融合,社会平等,社会整体化;
trade deficit: [a]/ˈtreɪd defɪsɪt/; [phr]贸易逆差;
the global village: [a]/ðə ˈɡloʊbl ˈvɪlɪdʒ/; [phr]地球村;
swift delivery: [a]/swɪft dɪˈlɪvəri/; [phr]快速交付;
be pressed for: [a]/bi prɛst fɔr/; [phr]缺乏,缺少;
keep up with: [a]/kiːp ʌp wɪð/; [phr]跟上,紧跟;
tax incentive: [a]/tæks ɪnˈsɛntɪv/; [phr]税收激励;
retail at: [a]/ˈriˌtel æt/; [phr](使)以.(价格)零售;
run on: [a]/rʌn ɑn/; [phr]继续,不停地讲,滔滔不绝;
standard of living: [a]/ˌstændərd əv ˈlɪvɪŋ/; [phr]生活水平,生活标准;
income gap: [a]/ˈɪnkʌm ɡæp/; [phr]收入差距;
day-to-day operations: [a]/ˌdeɪ tə ˈdeɪ ɑːpəˈreɪʃnz/; [phr]日常经营;
press conference: [a]/ˈpres kɑːnfərəns/; [phr]记者招待会;
fixed cost: [a]/fɪkst kɔːst/; [phr]固定成本;
variable cost: [a]/ˈveriːəbəl kɔːst/; [phr]可变成本;
cash flow: [a]/ˈkæʃ floʊ/; [phr]资金流动,现金流动量;
tax burden: [a]/tæks ˈbɜːrdn/; [phr]税负;
renegotiate terms: [a]/reɪnɪˈɡoʊʃieɪt tɜːrmz/; [phr]重新谈判条款;
current debt: [a]/ˈkɚrənt dɛt/; [phr]短期债务;
long-term debt: [a]/ˈlɔŋˈtəm dɛt/; [phr]长期债务;
squeeze a supplier: [a]/skwiːz eɪ səˈplaɪər/; [phr]打压供应商;
bridging loan: [a]/ˈbrɪdʒɪŋ loʊn/; [phr]过渡性贷款;
measure success: [a]/ˈmeʒər səkˈses/; [phr]估量成就;
bearing circle: [a]/ˈbɛrɪŋ ˈsɚkəl/; [phr]方位圆;
set loose: [a]/sɛt lus/; [phr]释放,出发,开始;
in force: [a]/ɪn fɔːrs/; [phr]有效的,在实施中;
think ill of: [a]/θɪŋk ɪl ʌv/; [phr]对..评价不高;
do everything in one's power to: [a]/duː ˈevriθɪŋ ɪn wʌnz ˈpaʊər tə/; [phr]竭尽全力做某事;
against one's will: [a]/əˈɡenst wʌnz wɪl/; [phr]违心地;
at length: [a]/æt leŋkθ/; [phr]最后,详细地;
under the name of: [a]/ˈʌndɚ ði nem ʌv/; [phr]用..的名字,在..的名字下;
see through: [a]/ˈsiːˌθrʊ/; [phr]看穿,识破;
tend to: [a]/tend tu/; [phr]易于,往往会,倾向于,有助于;
associate with: [a]/əˈsoʊʊʃiːˌeɪt wɪð/; [phr]与..常在一起,和..联想在一起;
Great Barrier Reef: [a]/ɡreɪt ˈbæriər riːf/; [phr]大堡礁;
Rafflesia arnoldii: [a]/ræ'fliːʒɪə ɑː'nəʊldɪɪ/; [phr]大王花;
date back to: [a]/det bæk tu/; [phr]追溯到,远在..年代;
out of respect: [a]/aʊt əv rɪˈspekt/; [phr]出于尊敬;
talk sb into: [a]/tɔk ˈɪntu/; [phr]说服某人做某事;
red date: [a]/rɛd det/; [phr]红枣;
attach to: [a]/əˈtætʃ tu/; [phr]缚上,系上,附加;
turn into: [a]/tɜːrn ɪntu/; [phr](使)变成;
fit into: [a]/fɪt ˈɪntʊ/; [phr]适合;
have no use for: [a]/hæv noʊ juz fɔr/; [phr]不需要,厌恶,对..不耐烦;
not to mention: [a]/nɑːt tə ˈmenʃən/; [phr]不必提及,更不必说;
cater for sb/sth.: [a]/ˈkeɪtər fər ˈsʌmbədi ˈsʌmθɪŋ/; [phr]为某人提供,适合某人的需要;
subscribe to: [a]/səbˈskraɪb tu/; [phr]同意,赞成,订购;
on the whole: [a]/ɑːn ðə hoʊl/; [phr]大体上,基本上;
cut out: [a]/kʌt aʊt/; [phr]切去,省略,停止(做某事);
sit around: [a]/sit əˈraʊnd/; [phr]闲坐着,无所事事;
never mind: [a]/ˈnevər maɪnd/; [phr]不必担心,不要紧,没有关系;
give off: [a]/ɡɪv ɔːf/; [phr]发出(蒸汽,光等);
by law: [a]/baɪ lɔ/; [phr]根据法律;
keep it up: [a]/kip ɪt ʌp/; [phr]保持优秀成绩,继续干下去;
be occupied with: [a]/bi ˈɑːkjupaɪd wɪð/; [phr]忙着做..,忙于某事物;
out of the question: [a]/aʊt əv ðə ˈkwestʃən/; [phr]不可能;
by means of: [a]/baɪ miːnz əv/; [phr]用..办法,借助..;
team up with: [a]/tim ʌp wɪð/; [phr]与..合作或一起工作;
the media: [a]/ði ˈmidiə/; [phr]媒体;
fed up with: [a]/fɛd ʌp wɪð/; [phr]受够了,饱受,厌烦;
hula hooping: [a]/ˈhuːlə huːp-ɪŋ/; [phr]玩呼啦圈;
jumping jack: [a]/ˈdʒʌmpɪŋ dʒæk/; [phr]跳爆竹(一种跳跃运动,跳起时双腿展开,双手在头顶接触,然后恢复到双脚并拢,手臂垂放在身体两侧的姿势);
in detail: [a]/ɪn dɪˈteɪl/; [phr]详细地;
beyond question: [a]/biˈɑnd ˈkwɛstʃən/; [phr]无可争辩,毫无疑问;
meet with: [a]/miːt wɪð/; [phr]遇到,经历,会晤;
master's degree: [a]/ˈmæstərz dɪˈɡriː/; [phr]硕士学位;
back to back: [a]/bæk tə bæk/; [phr]背靠背;
pass off as: [a]/pæs ɔf æz/; [phr](把某人)改变或冒充成..;
generally speaking: [a]/ˈdʒenərəliː ˈspiːkɪŋ/; [phr]一般来说;
show in: [a]/ʃoʊ ɪn/; [phr]带或领..进来;
at most: [a]/æt moʊst/; [phr]至多,最多;
pack up: [a]/pæk ʌp/; [phr]把..打包,整理;
make a name: [a]/mek e nem/; [phr]出名;
make of sth/sb.: [a]/meɪk əv ˈsʌmθɪŋ ˈsʌmbədi/; [phr]了解,理解;
every so often: [a]/ˈevriː soʊʊ ˈɔːfən/; [phr]时常,偶尔;
cope with: [a]/koʊp wɪð/; [phr]应付,对付,克服;
let down: [a]/let daʊn/; [phr]使失望,辜负;
seize on: [a]/siːz ɑːn/; [phr]抓住,利用;
collision course: [a]/kəˈlɪʒən kɔː(r)s/; [phr]冲突(的进程或行动);
self-evident: [a]/ˌself ˈevɪdənt/; [phr]不证自明的,不言而喻的;
live out: [a]/liːv aʊt/; [phr]活过,实践;
glory in: [a]/ˈɡlɔri ɪn/; [phr]以..为荣;
for one's own sake: [a]/fər wʌnz oʊn seɪk/; [phr]为了..的缘故;
sleep rough: [a]/slip rʌf/; [phr]露宿;
count up: [a]/kaʊnt ʌp/; [phr]把..加起来;
at the crack of dawn: [a]/ət ðə kræk əv dɔːn/; [phr]黎明,大清早;
quick as a flash: [a]/kwɪk əz eɪ flæʃ/; [phr]立刻,马上,一刹那;
a wolf in sheep's clothing: [a]/eɪ wʊlf ɪn ʃiːps ˈkloʊðɪŋ/; [phr]披着羊皮的狼,伪装友好的敌人;
dead to the world: [a]/dɛd tu ði wɜrld/; [phr]熟睡的,完全失去知觉的;
wear off: [a]/wer ɔːf/; [phr]逐渐消失,磨灭,损耗;
zoom in on: [a]/zuːm ɪn ɑːn/; [phr]拉近,推进,拉开;
in disbelief: [a]/ɪn ˌdɪsbɪˈliːf/; [phr]不相信,怀疑;
drop into: [a]/drɑp ˈɪntu/; [phr]偶然进入(某地),顺便拜访;
now and again: [a]/naʊ ənd əˈɡɛn/; [phr]不时地,有时;
day off: [a]/ˌdeɪ ˈɔːf/; [phr]休假日,休息日;
mid: [a]/mɪd/; [adj]中间的;[语]央元音的; [prep]在...的中间; [phr]移动互联网设备(=Mobile Internet Device);
diss: [a]/dɪs/; [v]轻蔑表示对某人的不敬;在口头上耍弄或者取笑某人; [phr]论文(=dissertation); [n]似芦苇属草纤维;
forearmed: [a]/ˌfɔːrˈɑːrmd/; [phr]凡事预则立;有备无患;
at the rate of: [a]/æt ði reɪt ʌv/; [phr]以...速度或比率;
at the risk of: [a]/æt ði rɪsk ʌv/; [phr]冒着...的危险;
beyond doubt: [a]/biːˈɑːnd daʊt/; [phr]无疑地;
break away: [a]/breɪk əˈweɪ/; [phr]消散;拆毁;脱开;突然离开;逃脱;
burst into: [a]/bɜːrst ˈɪntʊ/; [phr]突然开始;闯入;
bury oneself in: [a]/ˈbɛri wʌnˈsɛlf ɪn/; [phr]埋头于某事,对.入迷;
call off: [a]/kɔːl ɔːf/; [phr]取消;把(注意力)转移开;
catch up: [a]/kætʃ ʌp/; [phr]赶上;很快拾起;缠住;了解近况,叙旧;
check off: [a]/tʃek ɔːf/; [phr]核对;查对;扣款;
close up: [a]/kloʊz ʌp/; [phr]靠近;愈合;关闭;
come in for: [a]/kʌm ɪn fɔːr/; [phr]得到;接受;遭到;受到;
come out with: [a]/kʌm aʊt wɪð/; [phr]出版;说出,泄露(秘密);提出,发表,讲出;
conform to: [a]/kənˈfɔrm tu/; [phr]遵从,遵守;符合;
contrary to: [a]/ˈkɑːnˌtreriː tu/; [phr]与.相反;
count for: [a]/kaʊnt fɔr/; [phr]有重要性,有价值;
curl up: [a]/kɜːrl ʌp/; [phr]卷起,蜷曲,撅起;
dedicate...to: [a]/ˈdedɪkeɪt tu/; [phr]把(时间,力量等)用在..;题献;
devote...to: [a]/dɪˈvot tu/; [phr]把...献于;
dip into: [a]/dɪp ˈɪntʊ/; [phr]浸入;浏览;动用(款项等);掏取;
discriminate against: [a]/dɪˈskrɪməˌnet əˈɡenst/; [phr]歧视,排斥; [vt]虐待;
doze off: [a]/doʊz ɑːf/; [phr]打瞌睡;打盹儿;
ease in: [a]/iːz ɪn/; [phr](小心翼翼地)把某物移入或放入某一位置,使逐步适应;逐步适应,放松自己;
eat up: [a]/iːt ʌp/; [phr]吃光;
fall out: [a]/fɔːl aʊt/; [phr]争吵;松掉;解散;掉队;结果;退出;
fossil fuel: [a]/ˈfɑːsl fjuːəl/; [phr]化石燃料;
get back at: [a]/ɡet bæk æt/; [phr]报复;
green with envy: [a]/ɡrin wɪð ˈɛnvi/; [phr]十分妒忌,非常嫉妒;
have a ball: [a]/hæv ə bɔːl/; [phr]狂欢,玩得开心,享受;
hit it off: [a]/hɪt ɪt ɔf/; [phr]一见如故,合得来;
in and out: [a]/ɪn ənd aʊt/; [adv]进进出出; [phr]进进出出;
in black and white: [a]/ɪn blæk ənd waɪt/; [phr]白纸黑字;
in compliance with: [a]/ɪn kəmˈplaɪəns wɪð/; [phr]遵守,遵从;按照;
in possession of: [a]/ɪn pəˈzeʃən əv/; [phr]控制;拥有,拥有某物;
in the same boat: [a]/ɪn ðə seɪm boʊt/; [phr]面临同样的危险;处境相同;
in the wrong: [a]/ɪn ðə rɔːŋ/; [phr]有错,错误的;负有责任;
keep to oneself: [a]/kip tu wʌnˈsɛlf/; [phr]保守秘密;不交际;
knock down: [a]/nɑːk daʊn/; [phr]击倒;拆除;
look out for: [a]/lʊk aʊt fɔːr/; [phr]密切注意;  quant. 提防;小心,留神;
lose track of: [a]/luːz træk ʌv/; [phr]失去线索,失去消息,失去联系;
major in: [a]/ˈmedʒɚ ɪn/; [phr]主修;专攻;专修(某课程);
make a fortune: [a]/meɪk eɪ ˈfɔːrtʃən/; [phr]发财;赚钱;
make oneself at home: [a]/mek wʌnˈsɛlf æt hom/; [phr]不要拘束,别客气;
make sense of: [a]/mek sɛns ʌv/; [phr]了解...的意义,理解;
make use of: [a]/meɪk juːz əv/; [phr]利用;
none the less: [a]/nʌn ðə les/; [phr]还是;尽管如此.仍然,依然;
on the verge of: [a]/ɑn ði vɚdʒ ʌv/; [phr]接近于,濒于;
out of condition: [a]/aʊt əv kənˈdɪʃən/; [phr]健康不佳;身体不好;情况不佳;
patch up: [a]/pætʃ ʌp/; [phr]修补;平息;拼凑;
plunge into: [a]/plʌndʒ ˈɪntu/; [phr]跳入;突然冲入,突然或仓促地开始某事;
pocket money: [a]/ˈpɑːkɪt mʌni/; [phr]零用钱;
pop out: [a]/pɑp aʊt/; [phr]弹出;突出出现;突然退出;
prop up: [a]/prɑp ʌp/; [phr]支撑;支持,支撑;给...撑腰;资助;
pull down: [a]/pʊl daʊn/; [phr]拉下;拆毁;<非正式>赚钱;
puzzle out: [a]/ˈpʌzəl aʊt/; [phr]苦苦思索而弄清楚或解决,解决难题;
puzzle over: [a]/ˈpʌzəl ˈovɚ/; [phr]苦苦思考;苦心思索;
refrain from: [a]/rɪˈfreɪn frʌm/; [phr]抑制;制止;戒(烟);
result from: [a]/rɪˈzʌlt frʌm/; [phr]起因于;
round about: [a]/raʊnd əˈbaʊt/; [phr]大约;围绕;向相反方向;迂回地;
run off: [a]/ˈrʌnˌɔːf/; [phr]逃跑;流掉;迅速离开;
sea gull: [a]/si ɡʌl/; [phr]海鸥;
second to none: [a]/ˈsekənd tə nʌn/; [phr]最好的,顶呱呱;
see about: [a]/siː əˈbaʊt/; [phr]考虑;负责处理;调查;
send off: [a]/send ɔːf/; [phr][体]罚下场,给.送行; [vt]寄出(逐出;欢送);
set forth: [a]/set fɔːrθ/; [vt]陈述;阐明; [phr]出发,启程;
sneer at: [a]/snɪr æt/; [phr]嘲笑; [v]讥笑;轻视;
specialize in: [a]/ˈspɛʃəˌlaɪz ɪn/; [phr]专攻;
step by step: [a]/step baɪ step/; [phr]一步步地,逐步地,逐渐地;
strip down: [a]/strɪp daʊn/; [phr]脱去;拆开;
strive for: [a]/straɪv fɔr/; [phr]奋斗;争取;
take account of: [a]/teɪk əˈkaʊnt ʌv/; [phr]考虑到;顾及;体谅;
take charge of: [a]/teɪk tʃɑːrdʒ əv/; [phr]负责;照管;监理;担任;
take delight in: [a]/teɪk dɪˈlaɪt ɪn/; [phr]以..为乐;
take exception to: [a]/teɪk ɪkˈsepʃən tu/; [phr]反对;表示异议;
take pity on: [a]/tek ˈpɪti ɑn/; [phr]怜悯;
tear off: [a]/ter ɔːf/; [phr]撕掉,扯下来,扯掉;匆匆离开;
tear up: [a]/tɛə ʌp/; [phr]撕毁,撕掉撕成碎片;
tell apart: [a]/tel əˈpɑːrt/; [phr]辨别;区分,区别;
think highly of: [a]/θɪŋk ˈhaɪli əv/; [phr]尊重;对.高度评价;
think over: [a]/θɪŋk ˈoʊvər/; [phr]仔细考虑;
think up: [a]/θɪŋk ʌp/; [phr]想出;设计出;发明;编造;
throw up: [a]/θroʊ ʌp/; [phr]呕吐;恶心;匆匆建造;产生;放弃;
to begin with: [a]/tu ˈbeɪɡɪn wɪð/; [phr]首先;
to the contrary: [a]/tu ðə ˈkɑːnˌtreri/; [phr]相反;
turn against: [a]/tɜːrn əˈɡenst/; [phr]背叛;
under consideration: [a]/ˈʌndɚ kənˌsɪdəˈreʃən/; [phr]在考虑之中;
under control: [a]/ˈʌndər kənˈtroʊl/; [phr]被控制住,在...控制下;
vantage point: [a]/ˈvæntɪdʒ pɔɪnt/; [phr](观察事物的)有利地点;有利地位;
vote in: [a]/vot ɪn/; [phr]选举(选出来);
waste away: [a]/weɪst əˈweɪ/; [phr]日渐消瘦;
water closet: [a]/ˈwɔːtər klɑːzət/; [phr]盥洗室;盥洗室,厕所;
with all one's heart: [a]/wɪð ɔːl wʌnz hɑːrt/; [phr]全心全意地;十分愿意地;
with reference to: [a]/wɪð ˈrefərəns tu/; [phr]关于,有关;根据;
make a deal: [a]/meɪk ə dil/; [phr]订个协议;达成协议,做成交易;
count down: [a]/kaʊnt daʊn/; [phr](发射火箭等时)倒读数;
look down: [a]/lʊk daʊn/; [phr]俯视;看不起;蔑视;低落;
date back: [a]/det bæk/; [phr]回溯至,追溯;
subject to: [a]/ˈsʌbdʒeɪkt tu/; [phr]处于.中;易受...影响的;屈服于...的;取决于;
in the light of: [a]/ɪn ðə laɪt əv/; [phr]根据,按照;
a variety of: [a]/ə vəˈraɪtiː əv/; [phr]多种多样,种种;
a wealth of: [a]/eɪ welθəv/; [phr]很多的;大量的,丰富的;
be limited to: [a]/bi ˈlɪmɪtɪd tu/; [phr]局限于;
be of prime importance: [a]/bi ʌv praɪm ɪmˈpɔrtns/; [phr]极其重要;
be paved with: [a]/biː peɪvd wɪð/; [phr]铺满,遍布;
be resistant to: [a]/bi rɪˈzɪstənt tu/; [phr]对...有抵御能力的,抗拒的,抵抗的;耐...的;
build confidence: [a]/bɪld ˈkɑnfɪdəns/; [phr]树立信心;
carve out of: [a]/kɑrv aʊt ʌv/; [phr]用...雕刻出(引伸为修建);
devoid of: [a]/dɪˈvɔɪd əv/; [phr]没有,缺乏的;
indulge in: [a]/ɪnˈdʌldʒ ɪn/; [phr]任凭自己沉溺于.,耽,耽于,醉;
run parallel to: [a]/rʌn ˈpærəˌlɛl tu/; [phr]与.平行;
satisfy one's needs: [a]/ˈsætɪsfaɪ wʌnz niːd/; [phr]满足某人的需要;
throw oneself into: [a]/θro wʌnˈsɛlf ˈɪntu/; [phr]热心投身于,开始努力干;
hang about: [a]/hæŋ əˈbaʊt/; [phr]闲逛;徘徊;逗留;
then and there: [a]/ðen ænd ðer/; [phr]当场,立即;
and so forth: [a]/ənd soʊ fɔːrθ/; [phr]等等,诸如此类;
come around: [a]/kʌm əˈraʊnd/; [phr]顺便来访;苏醒;复苏;
pull out of: [a]/pʊl aʊt ʌv/; [phr]离开,退出;取消;
be made from: [a]/biː meɪd frəm/; [phr]由..制造;
on the way out: [a]/ɑːn ðə weɪ aʊt/; [phr]即将灭亡;渐渐过时,正在离开;
take one's temperature: [a]/teɪk wʌnz ˈtemprətʃər/; [phr]量体温;
in contrast to: [a]/ɪn ˈkɑːntræst tu/; [phr]和...对比,相比之下;与...相反;
be keen on: [a]/bi kin ɑn/; [phr]渴望,喜爱,爱好,热衷于;
miss out on: [a]/mɪs aʊt ɑn/; [phr]失去...的好机会;
tidy up: [a]/ˈtaɪdi ʌp/; [phr]整理;收拾;
in the beginning: [a]/ɪn ði bɪˈɡɪnɪŋ/; [phr]起初;
come back to life: [a]/kʌm bæk tu laɪf/; [phr]苏醒过来;复活;
be ready to do: [a]/bi ˈrɛdi tu/; [phr]随时可,乐意,即将;
take one's place: [a]/teɪk wʌns pleɪs/; [phr]取代某人;
a case in point: [a]/ə keɪs ɪn pɔːɪnt/; [phr]恰当的例子;
a hard nut to crack: [a]/ə hɑːrd nʌt tə kræk/; [phr]棘手的问题;难对付的人;
at the instance of: [a]/æt ði ˈɪnstəns ʌv/; [phr]经.提议,应.之请;
be attached to: [a]/bi əˈtætʃt tu/; [phr]依恋;附属于;
be comparable to: [a]/biː ˈkɑːmpərəbl tuː/; [phr]和.相当,比得上,犹如;
be ignorant of: [a]/bi ˈɪɡnərənt ʌv/; [phr]不知道,不了解;
be jealous of: [a]/bi ˈdʒɛləs ʌv/; [phr]嫉妒;
be loyal to: [a]/bi ˈlɔɪəl tu/; [phr]对.忠诚,忠于;忠实于...;
be rid of: [a]/bi rɪd ʌv/; [phr]摆脱;
be subject to: [a]/biː ˈsʌbdʒeɪkt tu/; [phr]服从;以...为条件;容易遭受;
bear on: [a]/ber ɑːn/; [phr]压在.之上;与..有关;对..有影响;依靠;
combine with: [a]/kəmˈbaɪn wɪð/; [phr]与...结合(联合);
come into effect: [a]/kʌm ˈɪntʊ ɪˈfekt/; [phr]生效;实施;
feel up to: [a]/fiːl ʌp tu/; [phr]觉得能够胜任,觉得身体挺得住;
help oneself: [a]/help wʌnˈself/; [phr]自助,自取所需(食物);
in excess of: [a]/ɪn ˈekˌses əv/; [phr]超过;
no fewer than: [a]/noʊ ˈfjuːə ðæn/; [phr]不少于,至少;不下于;多至;
no other than: [a]/noʊ ˈʌðər ðæn/; [phr]除...外没有;恰恰是;
out of control: [a]/aʊt əv kənˈtroʊl/; [phr]失去控制;
pull in: [a]/pʊl ɪn/; [phr]停车; [v]赚得;逮捕;
track down: [a]/træk daʊn/; [phr]跟踪追捕;追查;
tune out: [a]/tuːn aʊt/; [phr]关掉;无视,不理会;
under the heel of: [a]/ˈʌndər ðə hiːl əv/; [phr]被.践踏(支配);
without fail: [a]/wɪðˈaʊt feɪl/; [phr]必定;一定;
appeal for: [a]/əˈpiːl fɔːr/; [phr]要求,呼吁;
brand new: [a]/ˌbrænd ˈnuː/; [phr]全新的,崭新的;
by the time: [a]/baɪ ðə taɪm/; [phr]到.时候;直到.时候;
chase up: [a]/tʃeɪs ʌp/; [phr]提醒某人快做某事;追上;设法(迅速)找到;
chew up: [a]/tʃuː ʌp/; [phr]损害;嚼碎;
commit a crime: [a]/kəˈmɪt ə kraɪm/; [phr]犯罪;
compensate for: [a]/ˈkɑmpənˌset fɔr/; [phr]弥补;赔偿;
conference room: [a]/ˈkɑːnfərəns ruːm/; [phr]会议厅,会议场所及教室会议室;
construction site: [a]/kənˈstrʌkʃn saɪt/; [phr]建筑工地;
fight for: [a]/faɪt fɔr/; [phr]为.而战斗;争斗,争取;
immerse oneself in: [a]/ɪˈmɜːrs wʌnˈself ɪn/; [phr]埋头于(专心于);陷入;
infringe on: [a]/ɪnˈfrɪndʒ ɔːn/; [phr]侵犯;违反,违背;
interference with: [a]/ˌɪntərˈfɪrəns wɪð/; [phr]干涉,干扰;
lash out: [a]/læʃ aʊt/; [phr]痛打;狠批;挥霍;
lavish...on: [a]/ˈlævɪʃ ɑn/; [phr]大肆花费;
lighten up: [a]/ˈlaɪtn ʌp/; [phr]放松;不要生气;
quite a number of: [a]/kwaɪt ə ˈnʌmbər ʌv/; [phr]相当多的(许多);
ramp up: [a]/ræmp ʌp/; [v]巩固; [phr]提高,斜升,提升;
root for: [a]/rut fɔr/; [phr]全力支持,为.加油喝彩,赞助;
speak highly of: [a]/spiːk ˈhaɪli əv/; [phr]赞扬,高度赞美;
without prejudice: [a]/wɪðˈaʊt ˈprɛdʒədɪs/; [phr]没偏见;不使受损害;
be afraid of: [a]/biː əˈfreɪd əv/; [phr]害怕;
collide with: [a]/kəˈlaɪd wɪð/; [phr]碰撞;抵触;
composite number: [a]/kəmˈpɑːzət ˈnʌmbər/; [phr]合成数,合数;
compound interest: [a]/ˌkɑːmpaʊnd ˈɪntrəst/; [phr]复利;
fade away: [a]/feɪd əˈweɪ/; [phr]逐渐消失;褪色;
at full speed: [a]/æt fʊl spiːd/; [phr]全速;
in private: [a]/ɪn ˈpraɪvɪt/; [phr]秘密地;私下地;
on the quiet: [a]/ɑːn ðə ˈkwaɪt/; [phr]秘密地;私下地;
interfere with: [a]/ˌɪntərˈfɪr wɪð/; [phr]打扰;妨碍;与...抵触;
lag behind: [a]/læɡ bɪˈhaɪnd/; [phr]滞后;落在后面;
mark up: [a]/mɑːrk ʌp/; [phr]标记;加价;提高分数;
out of style: [a]/aʊt əv staɪl/; [phr]不时髦的,过时的;
out of tune: [a]/aʊt əv tuːn/; [phr]走调;不一致;
concentric circle: [a]/kənˈsentrɪk ˈsɜːrkl/; [phr]同心圆;
gain weight: [a]/ɡeɪn weɪt/; [phr]增加体重,增肥,长胖了;
in cooperation with: [a]/ɪn koˌɑpəˈreʃən wɪð/; [phr]与..合作;
all year round: [a]/ɔl jɪr raʊnd/; [phr]一年到头,终年,四季;全年;
exert oneself: [a]/ɪɡˈzɜːrt wʌnˈself/; [phr]努力;尽力;
adopted child: [a]/əˈdɑːptɪd tʃaɪld/; [phr]养子(女),义子;
expand on: [a]/ɪkˈspænd ɑːn/; [phr]进一步阐述,详述;
be proficient in: [a]/bi prəˈfɪʃənt ɪn/; [phr]熟练;精通;
make a move: [a]/meɪk ə mʊv/; [phr]采取行动;动身;
keep abreast of: [a]/kip əˈbrɛst ʌv/; [phr]与.齐头并进;了解.的最新情况;
be ill at ease: [a]/bi ɪl æt iːz/; [phr]局促不安,心神不宁;困窘;
be worthy of: [a]/bi ˈwɚði ʌv/; [phr]值得,配得上,当之无愧;
come to light: [a]/kʌm tə laɪt/; [phr]显露;出现;为众人所知;
through thick and thin: [a]/θrʊ θɪk ənd θɪn/; [phr]不顾艰难险阻;在任何情况下;患难与共,风雨同舟;
catch a cold: [a]/kætʃ ə koʊld/; [phr]伤风;感冒;
put in order: [a]/pʊt ɪn ˈɔrdɚ/; [phr]整理,排列;检修;
take an interest in: [a]/tek ən ˈɪntrɪst ɪn/; [phr]对.产生兴趣,过问;
be suspicious of: [a]/bi səˈspɪʃəs ʌv/; [phr]怀疑;
be equipped with: [a]/bi ɪˈkwɪpt wɪð/; [phr]装备着;
be involved in: [a]/bi ɪnˈvɑlvd ɪn/; [phr]涉及到;与...有关联,参与;
be eager for: [a]/biː ˈiːɡər fɔːr/; [phr]想得到;渴望;
peep at: [a]/pip æt/; [phr]偷看...;
one after the other: [a]/wʌn ˈæftɚ ði ˈʌðər/; [phr]一个接着一个,陆续; [pron]相继);
show respect for: [a]/ʃo rɪˈspɛkt fɔr/; [phr]对...表示尊敬;
take a risk: [a]/tek e rɪsk/; [phr]冒险;
the former: [a]/ði ˈfɔrmɚ/; [phr]前者;
set foot in: [a]/set fʊt ɪn/; [vt]进入; [phr]踏进;
so much so that: [a]/soʊ mʌtʃ soʊ ðæt/; [phr]达到这样的程度以至.;
rise to fame: [a]/raɪz tu fem/; [phr]成名,出名;
be suitable for: [a]/biː ˈsuːtəbl fɔːr/; [phr]适合...的;
at any moment: [a]/ət ˈeni ˈmoʊmənt/; [phr]随时,在任何时候;
be sick of: [a]/bi sɪk ʌv/; [phr]对...感到厌烦的;
as poor as a church mouse: [a]/æz pʊr æz e tʃɚtʃ maʊs/; [phr]一贫如洗;
be dependent on: [a]/bi dɪˈpɛndənt ɑn/; [phr]取决于;依赖;
take the blame: [a]/tek ði blem/; [phr]承担责任;
cast light on: [a]/kæst laɪt ɑn/; [phr]使人们明白;阐明;
be conducive to: [a]/bi kənˈdusɪv tu/; [phr]有助于;
be infected with: [a]/biː ɪnˈfektɪd wɪð/; [phr]感染(疾病);
out of shape: [a]/aʊt əv ʃeɪp/; [phr]身体状况不佳;变形,走样;身材不好;
be incapable of: [a]/bi ɪnˈkepəbəl ʌv/; [phr]不会,不能;
be unaware of: [a]/bi ˌʌnəˈwɛr ʌv/; [phr]不知道,没有察觉到,没有意识到;
be prone to: [a]/bi pron tu/; [phr]易于.;
be convinced of: [a]/bi kənˈvɪnst ʌv/; [phr]确信,相信,深信;
be fit for: [a]/biː fɪt fɔːr/; [phr]适合于;胜任;
stand on one's feet: [a]/stænd ɑːn wʌnz fiːt/; [phr]依靠自己,自力更生,自食其力;站起来;
official language: [a]/əˈfɪʃəl ˈlæŋɡwɪdʒ/; [phr]官方语言;
take an active part in: [a]/tek ən ˈæktɪv pɑrt ɪn/; [phr]积极参加;
be indifferent to: [a]/biː ɪnˈdɪfrənt tuː/; [phr]对...漠不关心;把...置之度外;
in short supply: [a]/ɪn ʃɔrt səˈplaɪ/; [phr]缺乏;短缺;
the more the better: [a]/ðə mɔːr ðəˈbetər/; [phr]多多益善;
play on the swing: [a]/pleɪ ɑn ði swɪŋ/; [phr]荡秋千;
beyond expression: [a]/biˈɑnd ɪkˈsprɛʃən/; [phr]无法表达(形容不出);
drain away: [a]/dreɪn əˈweɪ/; [phr]渐渐枯竭;流尽;
figure in: [a]/ˈfɪɡjər ɪn/; [phr]算进去;
become acquainted with: [a]/bɪˈkʌm əˈkweɪntɪd wɪð/; [phr]开始认识,开始了解,同.结识,熟悉;
in the balance: [a]/ɪn ðə ˈbæləns/; [phr](生命等)在危急状态中;(命运等)未定;
turn a blind eye: [a]/tɚn e blaɪnd aɪ/; [phr]视而不见,熟视无睹;
in competition with: [a]/ɪnˌkɑːmpəˈtɪʃn wɪð/; [phr]在与.竞争之中;与..比赛;
make a complaint: [a]/mek e kəmˈplent/; [phr]抱怨;
in conflict with: [a]/ɪn ˈkɑːnˌflɪkt wɪð/; [phr]和...有争执;不一致;
computer crime: [a]/kəmˈpjuːtər kraɪm/; [phr]电脑犯罪;
be delighted with: [a]/bi dɪˈlaɪtɪd wɪð/; [phr]因...而十分高兴;
tourist destination: [a]/ˈtʊrɪst ˌdestɪˈneɪʃn/; [phr]目的地,旅游胜地,旅游目的地;
be distinct from: [a]/bi dɪˈstɪŋkt frəm/; [phr]与.有差别;
place emphasis on: [a]/pleɪsˈemfəsɪs ɑːn/; [phr]强调;着重于; [v]重视;
be engaged in: [a]/bi ɪnˈɡeɪdʒd ɪn/; [phr]从事于,忙于; [vt]致力于...;
face up: [a]/feɪs ʌp/; [phr]面对;正面朝上;
fade into: [a]/feɪd ɪntu/; [phr]逐渐消失而变成(无足轻重的东西),在.逐渐消失;渐渐融入于;
form the habit of: [a]/fɔːrm ðə ˈhæbɪt əv/; [phr]养成...的习惯;
infer from: [a]/ɪnˈfɚ frʌm/; [phr]从.中推测出.;
under investigation: [a]/ˈʌndər ɪnˌvestɪˈɡeɪʃn/; [phr]在调查研究中,正在调查中;在观察中;
preside at: [a]/prɪˈzaɪd æt/; [phr]主持;
in quest of: [a]/ɪn kwɛst ʌv/; [phr]探索;寻求,寻找,探求;设法找到;
show signs of: [a]/ʃoʊ saɪnz əv/; [phr]显示...迹象;
tee off: [a]/tiː ɔːf/; [phr]开球; [vi]发球;
be terrified at: [a]/biː ˈterɪfaɪd æt/; [phr]被..吓一大跳;
tick away: [a]/tɪk əˈwe/; [phr](时间一分一秒地)过去;
in commemoration of: [a]/ɪn kəˌmɛməˈreʃən ʌv/; [phr]为纪念(为庆祝);
out of curiosity: [a]/aʊt ʌv ˌkjʊriˈɑsɪti/; [phr]出于好奇心;
hold...in high esteem: [a]/hold ɪn haɪ ɪˈstim/; [phr]十分尊敬,推崇;
a multitude of: [a]/e ˈmʌltɪˌtud ʌv/; [phr]许多,众多;
under attack: [a]/ˈʌndɚ əˈtæk/; [phr]遭受攻击;
have an eye for: [a]/hæv æn aɪ fɔːr/; [phr]有眼光,对.有鉴赏力;
from that moment on: [a]/frəm ðæt ˈmoʊmənt ɔːn/; [phr]那时起,从那一刻起;
protect...from: [a]/prəˈtekt frəm/; [phr]保护.不受.;
would rather...than...: [a]/wʊd ˈræðər ðæn/; [phr]宁愿.而不愿.;
in the mood: [a]/ɪn ði mud/; [phr]兴致勃勃;
teach sb a lesson: [a]/titʃ ˈsʌmˌwʌn e ˈlɛsən/; [phr]给某人一个教训;
career development: [a]/kəˈrɪr dɪˈvɛləpmənt/; [phr]职业培训,职业发展;
confronted with: [a]/kənˈfrʌnt wɪð/; [phr]面临;对质;
full refund: [a]/fʊl ˈriːfʌnd/; [phr]全额退款,全额偿还;
get familiar with: [a]/ɡɛt fəˈmɪljɚ wɪð/; [phr]变得熟悉,与..熟悉起来;
struggle to do: [a]/ˈstrʌɡl tə duː/; [phr]奋斗,努力做某事;挣扎着做某事;
be enthusiastic about: [a]/bi ɛnˌθuziˈæstɪk əˈbaʊt/; [phr]对.热情;
in an effort to: [a]/ɪn ən ˈefərt tu/; [phr]企图, 努力想;为了,努力;
at the head of: [a]/æt ði hɛd ʌv/; [phr]在.的最前面;
be stressed out: [a]/bi strest aʊt/; [phr]紧张,有压力的;
be tolerant of: [a]/bi ˈtɑːlərənt əv/; [phr]对...容忍(或宽容);
take a day off: [a]/teɪk ə deɪ ɔːf/; [phr]放一天假;
be content with: [a]/bi ˈkɑnˌtɛnt wɪð/; [phr]满足于;以...为满足;
be annoyed with: [a]/bi əˈnɔɪd wɪð/; [phr]被...惹恼;对...生气;
get sick of: [a]/ɡet sɪk əv/; [phr]厌烦,对.感到厌恶;
be confident in: [a]/biˈkɑnfədənt ɪn/; [phr]确信;深信;对.有信心;对..充满信心;
an amount of: [a]/ən əˈmaʊnt ʌv/; [phr]相当数量的;
be tied up with: [a]/bi taɪd ʌp wɪð/; [phr]和..密切联系;和...协作;
fill up...with...: [a]/fɪl ʌp wɪð/; [phr]用.把.装满;被...填满;
be worn out: [a]/bi ˌwɔːrn ˈaʊt/; [phr]累坏了;
come in the form of: [a]/kʌm ɪn ðə fɔːrm əv/; [phr]以..的形式;
be of benefit to: [a]/bi əv ˈbenɪfɪt tu/; [phr]对.有益,有好处;
be laid off: [a]/biː leɪd ɔːf/; [phr]下岗,被解雇;
be piled with: [a]/bi paɪld wɪð/; [phr]堆积着.;
dissatisfy with: [a]/dɪsˈsætɪsfaɪ wɪð/; [phr]对..不满意;
be eager to do sth: [a]/bi ˈiːɡər tu duː ˈsʌmθɪŋ/; [phr]急欲,渴望做;
threaten to do sth: [a]/ˈθretn tu duː ˈsʌmθɪŋ/; [phr]扬言要.;
in contrast with: [a]/ɪn ˈkɑːntræst wɪθ/; [phr]和.成对比;和.大不相同;
put...into practice: [a]/pʊt ˈɪntu ˈpræktɪs/; [phr]实施,实行;
can't help but do sth: [a]/kænt help bət du ˈsʌmθɪŋ/; [phr]忍不住做某事;
have a good appetite: [a]/hæv eɪ ɡʊdˈæpɪtaɪt/; [phr]胃口好;饭量大;
credit to: [a]/ˈkredɪt tu/; [phr]赞赏,归功于,把.归于;
be obliged to sb: [a]/biː əˈblaɪdʒd tuː ˈsʌmbədi/; [phr]感激某人;
put a halt to: [a]/pʊt eɪ hɔːlt tu/; [phr](使)停止,制止;
narrow down to: [a]/ˈnæroʊ daʊn tu/; [phr]缩减,缩小,收紧;
exert pressure on: [a]/ɪɡˈzɜːrt ˈpreʃər ɑːn/; [phr]对.施加压力;
expand one's knowledge: [a]/ɪkˈspænd wʌnzˈnɑːlɪdʒ/; [phr]增长知识;
gain a reputation for: [a]/ɡeɪn ə ˌrepjuˈteɪʃn fɔːr/; [phr]以.而出名,赢得.的声誉;
be discontent with: [a]/bi ˌdɪskənˈtent wɪð/; [phr]不满足于;
take...into account: [a]/teɪk ˈɪntu əˈkaʊnt/; [phr]把.考虑在内;
take over one's business: [a]/teɪk ˈoʊvər wʌnz ˈbɪznəs/; [phr]接管某人的生意;
come in sight: [a]/kʌm ɪn saɪt/; [phr]看见,出现,表示看见;
be fit to: [a]/bi fɪt tu/; [phr]适合;
gain access to: [a]/ɡeɪn ˈækses tə/; [phr]接近,有接近.的权利;
take a photograph of: [a]/teɪk ə ˈfoʊtəɡræf əv/; [phr]拍照;
be dying to do sth: [a]/biˈdaɪɪŋ tuː duːˈsʌmθɪŋ/; [phr]渴望做某事;
the Gold Rush: [a]/ðə ɡoʊld rʌʃ/; [phr]淘金热;
in great shape: [a]/ɪn ɡreɪt ʃeɪp/; [phr]身体状态好,身材好;
make an effort to do: [a]/meɪk ən ˈefərt tə duː/; [phr]努力(做).;
take priority over: [a]/teɪk praɪˈɔːrəti ˈoʊvər/; [phr]优先;
draw one's attention to: [a]/drɔː wʌnz əˈtenʃn tu/; [phr]引起某人注意;
be determined to do sth: [a]/bi dɪˈtɜːrmɪnd tu du ˈsʌmθɪŋ/; [phr]下定决心要.;
be inappropriate for: [a]/bi ɪnəˈproʊpriət fɔːr/; [phr]不合适的,不适当的;
volunteer to do: [a]/ˌvɑːlənˈtɪr tu du/; [phr]自愿做;
a shortage of: [a]/ə ˈʃɔːrtɪdʒ ʌv/; [phr]短缺,缺乏;
to the delight of: [a]/tu ðə dɪˈlaɪt ʌv/; [phr]令.感到喜悦;
have taste in: [a]/hæv teɪst ɪn/; [phr]有品位,有鉴赏力;
raise one's spirits: [a]/reɪz wʌnz ˈspɪrɪt/; [phr]使人振奋,打起精神;
all day and all night: [a]/ɔːl deɪ ænd ɔːl naɪt/; [phr]整日整夜;
be strict about: [a]/biː strɪkt əˈbaʊt/; [phr]对某事很严格,对某事严格要求;
be diverse from: [a]/bi daɪˈvɜːrs frʌm/; [phr]和.不同;
career planning: [a]/kəˈrɪr ˈplænɪŋ/; [phr]职业生涯规划,职业规划;
within walking distance: [a]/wɪˈðɪn ˈwɔːkɪŋ ˈdɪstəns/; [phr]步行可及,很近;
warn sb about: [a]/wɔːrn əˈbaʊt/; [phr]警告,警醒;
make it difficult for sb: [a]/meɪk ɪt ˈdɪfɪkəlt fɔːr ˈsʌmbədi/; [phr]难以,使.觉得困难;
put...into prison: [a]/pʊt ˈɪntu ˈprɪzn/; [phr]关进监狱;把.投进监狱;使.坐牢;
get tired of sth: [a]/ɡet ˈtaɪərd əv ˈsʌmθɪŋ/; [phr]厌倦了某事;
play a joke: [a]/pleɪ eɪ dʒoʊk/; [phr]开玩笑;
have trouble in doing: [a]/hæv ˈtrʌbl ɪn ˈduːɪŋ/; [phr]做某事有困难;
shear off: [a]/ʃɪr ɔf/; [phr]剪断,切掉;
inspire sth: [a]/ɪnˈspaɪər ˈsʌmθɪŋ/; [phr]激励,鼓舞,启迪;
offer opportunity to: [a]/ˈɔːfər ˌɑːpərˈtuːnəti tuː/; [phr]给...提供机会;
throw up one's hands: [a]/θroʊ ʌp wʌnz hænds/; [phr]绝望;放弃;
have no time to: [a]/hæv noʊ taɪm tə/; [phr]没时间.;
by comparison to: [a]/baɪ kəmˈpærɪsn tuː/; [phr]比较下,相比;
compliance with: [a]/kəmˈplaɪəns wɪð/; [phr]遵守,遵从,顺从,符合;
cultural environment: [a]/ˈkʌltʃərəl ɪnˈvaɪrənmənt/; [phr]文化环境;
arouse one's curiosity: [a]/əˈraʊz wʌnz ˌkjʊriˈɑːsəti/; [phr]引起某人的好奇心;
support one's argument: [a]/səˈpɔːrt wʌnz ˈɑːrɡjumənt/; [phr]支持...的观点;
take...into consideration: [a]/teɪk ˈɪntuː kənˌsɪdəˈreɪʃn/; [phr]考虑到;
be reluctant to: [a]/biː rɪˈlʌktənt tuː/; [phr]不愿意;不情愿;不愿做.的;
not...but rather: [a]/nɑːt bət ˈræðər/; [phr]不是...而是;
get off with: [a]/ɡet ɔːf wɪð/; [phr]与.要好;罚款;
cooperate with sb: [a]/koʊˈɑːpəreɪt wɪð ˈsʌmbədi/; [phr]和.合作;
focus one's attention on: [a]/ˈfoʊkəs wʌnz əˈtenʃn ɔːn/; [phr]集中注意力在.上;
make face: [a]/meɪk feɪs/; [phr]做鬼脸;
engaged to sb: [a]/ɪnˈɡeɪdʒd tuː ˈsʌmbədi/; [phr]和.订婚;
insufficient for: [a]/ˌɪnsəˈfɪʃnt fɔːr/; [phr]不足的;
be wary of: [a]/bi ˈweri əv/; [phr]提防,小心翼翼;
balance between...and...: [a]/ˈbæləns bɪˈtwiːn ənd/; [phr]平衡.和.;
in the manner of: [a]/ɪn ðə ˈmænər əv/; [phr]照.的式样,做出.的样子;
have an insight into sth: [a]/hæv æn ˈɪnsaɪt ˈɪntu ˈsʌmθɪŋ/; [phr]洞察某事;
be furious with sb: [a]/bi ˈfjʊriəs wɪθ ˈsʌmbədi/; [phr]对..生气;
sign a contract with: [a]/saɪn ə ˈkɑːntrækt wɪð/; [phr]和..签合同;
build up one's confidence: [a]/bɪld ʌp wʌnz ˈkɑːnfɪdəns/; [phr]树立信心;
in the circumstance: [a]/ɪn ðə ˈsɜːrkəmstæns/; [phr]在这种情况下;
be dexterous in: [a]/bi ˈdɛkstərəs ɪn/; [phr]灵敏于..;
be inadequate for: [a]/bi ɪnˈædɪkwət fər/; [phr]不够,缺乏;
have the advantage over: [a]/hæv ðə ədˈvæntɪdʒ ˈoʊvər/; [phr]胜过,优于;
be replaced with: [a]/bi rɪˈpleɪst wɪð/; [phr]被..代替;
be urged to do: [a]/biː ɜːrdʒd tə duː/; [phr]不得不做;受到敦促去做;
be obliged to do sth: [a]/bi əˈblaɪdʒd tu du ˈsʌmθɪŋ/; [phr]有义务做,不得不;
spend time on: [a]/spend taɪm ɔːn/; [phr]花时间做某事;
be well-known for: [a]/bi ˌwel ˈnoʊn fər/; [phr]以.出名;因.而著名;
be skeptical of: [a]/bi ˈskeptɪkl əv/; [phr]怀疑;
be ready to: [a]/biː ˈredi tuː duː/; [phr]准备好..;
upper management: [a]/ˈʌpər ˈmænɪdʒmənt/; [phr]高层管理;
have a good relationship with: [a]/hæv ə ɡʊd rɪˈleɪʃnʃɪp wɪð/; [phr]和..关系好;
have a go: [a]/həv ə ɡoʊ/; [phr]企图,尝试;
occupy one's time: [a]/ˈɑːkjupaɪ wʌnz taɪm/; [phr]占用某人的时间;
in comparison to: [a]/in kəmˈpærɪsn tu/; [phr]与.相比;
call in on: [a]/kɔːl ɪn ɑːn/; [phr]拜访,访问;
debate over: [a]/dɪˈbeɪt ˈoʊvər/; [phr]辩论..;
wave down: [a]/weɪv daʊn/; [phr]挥手示意..停下;
much to one's surprise: [a]/mʌtʃ tu wʌnz sərˈpraɪz/; [phr]令.相当吃惊的是;
keep one's fingers crossed: [a]/kiːp wʌnz ˈfɪŋɡərs krɔːst/; [phr]为.祈祷;
at an alarming rate: [a]/ət ən əˈlɑːrmɪŋ reɪt/; [phr]以惊人的速度;
proposal for: [a]/prəˈpoʊzl fɔːr/; [phr]提案,提议;
be apparent to: [a]/bi əˈpærənt tə/; [phr]清楚,明显;
chase out: [a]/tʃeɪs aʊt/; [phr]赶走,驱散;
be mindful of: [a]/bi ˈmaɪndfl əv/; [phr]留意,注意;
be approximate to: [a]/bi əˈprɑːksɪmət tu/; [phr]近似;接近于.的;
dried food: [a]/draɪd fuːd/; [phr]干货,干制食品;
find it difficult to do: [a]/faɪnd ɪt ˈdɪfɪkəlt tə duː/; [phr]觉得做某事很困难;
go without saying: [a]/ɡoʊ wɪðˈaʊt ˈseɪɪŋ/; [v]不言而喻,理所当然;
above(beyond) reproach: [a]/əˈbʌv bɪˈjɑːnd rɪˈproʊtʃ/; [adv]无可指责,无可厚非;
behind time: [a]/bɪˈhaɪnd taɪm/; [adj]迟到;
do sb a favour: [a]/duːˈsʌmbədi ə ˈfeɪvər/; [v]为某人帮个忙;
break off/sth: [a]/breɪk ɑːf ˈsʌmθɪŋ/; [v]折断;突然结束;
look out for sb(sth.): [a]/lʊk aʊt fɔːrˈ sʌmbədi ˈsʌmθɪŋ/; [v]注意;
go round: [a]/ɡoʊ raʊnd/; [v]足够分配;绕道走,到处走动;
give in (to sb): [a]/ɡɪv ɪn tu ˈsʌmbədi/; [v]屈服,投降;
stand by sb: [a]/stænd baɪ ˈsʌmbədi/; [v]支持某人;
in hand: [a]/ɪn hænd/; [adv]可以动用的;在处理中;在控制中;
lay/sth out: [a]/leɪ ˈsʌmθɪŋ aʊt/; [v]展示,摆开;布置,设计;
keep sb down: [a]/kiːp ˈsʌmbədi daʊn/; [v]控制;为难;压制;
get by: [a]/ɡet baɪ/; [v]侥幸躲过,勉强生活;
make sb out to be: [a]/meɪk ˈsʌmbədi aʊt tu bi/; [v]把.说成;
once (and) for all: [a]/wʌns ənd fɔːr ɔːl/; [adv]只此一次,彻底地;
pass away: [a]/pæs əˈweɪ/; [v]死,逝世;
plead for sb: [a]/pliːd fɔːr ˈsʌmbədi/; [v]恳求;为.辩护;
put an end to: [a]/pʊt ən end tu/; [v]停止,消灭;
set sth off: [a]/set ˈsʌmθɪŋ ɑːf/; [v]使爆炸;平衡;
settle on (upon) sth: [a]/ˈsetl ɑːn əˈpɔːn ˈsʌmθɪŋ/; [v]决定;
snap at sb: [a]/snæp æt ˈsʌmbədi/; [v]对人厉声说;
go about: [a]/ɡoʊ əˈbaʊt/; [v]着手做;四处走动;传开;从事;
call for: [a]/kɔːl fɔr/; [v]需要;邀请;呼吁;
look into: [a]/lʊk ˈɪntu/; [v]研究;调查;
give out: [a]/ɡɪv aʊt/; [v]停止;耗尽;分发;产生;发出;
look up to: [a]/lʊk ʌp tu/; [v]尊敬;
pay off: [a]/peɪ ɔːf/; [v]付清;取得成功,使得益;贿赂;报复;
in favour of: [a]/ɪn ˈfeɪvər ɑv/; [prep]赞成;以.为收款人;
come out: [a]/kʌm aʊt/; [vi]出现,显露,出版,被算出,结果是,公开表态;
bring forward: [a]/brɪŋ ˈfɔrwərd/; [v]提出;提前;
take sth out: [a]/teɪk ˈsʌmθɪŋ aʊt/; [v]去掉;取得,取出;
come to nought: [a]/kʌm tu nɔt/; [v]失败;
call sb/sth up: [a]/kɔːl ˈsʌmbədi ˈsʌmθɪŋ ʌp/; [v]打电话;征召;
get at sb(sth.): [a]/ɡet æt ˈsʌmbədi ˈsʌmθɪŋ/; [v]到达,得到;接近;
give/sth off: [a]/ɡɪv ˈsʌmθɪŋ ɑːf/; [v]发出(烟,气);
hold onto: [a]/hoʊld ˈɑntə/; [v]抓住,不放;不卖掉;
in line for: [a]/ɪn laɪn fɔr/; [adv]即可得到;排队;
look in (on sb): [a]/lʊk ɪn ɔːn ˈsʌmbədi/; [v](顺便)看望;
look on (sb) as: [a]/lʊk ɔːn ˈsʌmbədi æz/; [v]当作..看待;
make up with sb: [a]/meɪk ʌp wɪθ ˈsʌmbədi/; [v]与.和解;
make the most of: [a]/meɪk ðə moʊst ɑv/; [v]充分利用;
mind one's own business: [a]/maɪnd wʌnz oʊn ˈbɪznəs/; [v]少管闲事;各人自扫门前雪;
on and off: [a]/ɔn ənd ɑf/;  quant. 断断续续地;
on hand: [a]/ɔn hænd/; [adv]手头现有;
once more: [a]/wʌns mɔr/; [adv]再一次;
one another: [a]/ˌwʌn əˈnʌðər/; [pron]彼此;
orientate oneself: [a]/ˈɔriənˌteɪt wʌnˈself/; [v]确认方位,地址;
out of stock: [a]/aʊt ɑv stɒk/; [v]无存货,已脱销;
pass over: [a]/pæs ˈoʊvər/; [v]忽略;不注意;
pass sth on to: [a]/pæs ˈsʌmθɪŋ ɔːn tu/; [v]把.交给.;
persevere with: [a]/ˌpɜːrsəˈvɪr wɪð/; [v]坚持,不屈不挠;
phase out: [a]/feɪz aʊt/; [v]逐渐淘汰;
pick sb/sth out: [a]/pɪk ˈsʌmbədi ˈsʌmθɪŋ aʊt/; [v]选出;认出,挑选;
pick sth up: [a]/pɪk ˈsʌmθɪŋ ʌp/; [v]买;得到;知道;捡起;
pull oneself together: [a]/pʊl wʌnˈself təˈɡeðər/; [v]振作起来;恢复镇定;
reckon with sb: [a]/ˈrekən wɪθ ˈsʌmbədi/; [v]清算;将.加以考虑,认真对待;
rise to the occasion: [a]/raɪz tu ði əˈkeʒən/; [v]应付自如;
see eye to eye (with): [a]/siː aɪ tu aɪ wɪθ/; [v]看法完全一致;
set about sth: [a]/siː əˈbaʊt ˈsʌmθɪŋ/; [v]着手;
bring in: [a]/brɪŋ ɪn/; [v]增加,赚取,产生,引进;
day in and day out: [a]/deɪ ɪn ənd deɪ aʊt/; [adv]天天,一天又一天;
the accused: [a]/ði əˈkjuːzd/; [n]被告;
find one's bearings: [a]/faɪnd wʌnz ˈberɪŋs/; [v]指明方向;信心十足;
clear the air: [a]/klɪr ðə er/; [v]消除误会;
for the sake of: [a]/fɔr ði sek ʌv/; [prep]为.起见;为了.的利益;
come up against: [a]/kʌm ʌp əˈɡenst/; [v]碰到(困难,反对);
take sth over: [a]/teɪk ˈsʌmθɪŋ ˈoʊvər/; [v]接管;
come (bring) sth to light: [a]/kʌm brɪŋ ˈsʌmθɪŋ tu laɪt/; [v]显露,揭露;
keep at: [a]/kip ət/; [v]不断地做;
keep sb/sth out (of): [a]/kiːp ˈsʌmbədi ˈsʌmθɪŋ aʊt ʌv/; [v]不让.入内;
try one's hand at: [a]/traɪ wʌnz hænd æt/; [v]尝试着做.;
from the outset: [a]/frɒm ðə ˈaʊtˌset/; [adv]从一开始;
get somewhere: [a]/ɡet ˈsʌmwer/; [v]有所成就;
in one's face: [a]/ɪn wʌnz feɪs/; [adv]公开地;当着某人的面;
come across sb(sth.): [a]/kʌm əˈkrɑːs ˈsʌmbədi ˈsʌmθɪŋ/; [v]偶然碰见;
keep sth (back) from: [a]/kiːp ˈsʌmθɪŋ bæk frʌm/; [v]不让某事.;离开;
look one's best: [a]/lʊk wʌnz bɛst/; [v]表现出最好的状态;
lose heart: [a]/luz hɑrt/; [v]丧失信心;
keep sb on: [a]/kiːp ˈsʌmbədi ɔːn/; [v]继续雇用某人;
go without/sth: [a]/ɡoʊ wɪˈðaʊt ˈsʌmθɪŋ/; [v]在缺少.的情况下勉强对付;
make up for: [a]/meɪk ʌp fɔr/; [v]补偿,弥补;
come up: [a]/kʌm ʌp/; [v]升起;出现;发生;发芽;
give sth up: [a]/ɡɪv ˈsʌmθɪŋ ʌp/; [v]放弃;戒烟;
apply oneself (to sth): [a]/əˈplaɪ wʌnˈself tu ˈsʌmθɪŋ/; [v]专心致志于;
keep to: [a]/kip tu/; [v]履行诺言;限制自己;坚持;
at the same time: [a]/ət ðə seɪm taɪm/; [adv]同时;然而;
be set on sth: [a]/biː set ɔːn ˈsʌmθɪŋ/; [adj]决心做某事;
have (get) the upper hand: [a]/hæv ɡet ði ˈʌpər hænd/; [v]取得优势,占上风;
at all times: [a]/ət ɔl taɪmz/; [adv]经常,一直;无论何时;
leave for: [a]/liv fɔr/; [v]动身去;
in no time: [a]/ɪn noʊ taɪm/; [adv]立刻;
take sth into account: [a]/teɪk ˈsʌmθɪŋ ˈɪntu əˈkaʊnt/; [v]考虑到某事;
all told: [a]/ɔːl toʊld/; [adv]总共;
take sth in: [a]/teɪk ˈsʌmθɪŋ ɪn/; [v]承接;领会;改小尺寸;
cast off: [a]/kæst ɑf/; [v]解缆放船;抛弃,丢弃;
take sth down: [a]/teɪk ˈsʌmθɪŋ daʊn/; [v]记录下来;拆除;
cut across: [a]/kʌt əˈkrɔs/; [v]抄近路通过;  quant. 与...相抵触;与...相反;
go on about sth: [a]/ɡoʊ ɔːn əˈbaʊt ˈsʌmθɪŋ/; [v]喋喋不休;
as well: [a]/əz wel/; [adv]同样地;也;
in time: [a]/ɪn taɪm/; [adv]及时;总有一天;
break away (from): [a]/breɪk əˈweɪ frʌm/; [v]突然走开;放弃;革除;
let oneself go: [a]/let wʌnˈself ɡoʊ/; [v]尽情,情不自禁;
call it a day: [a]/kɔl ɪt ə deɪ/; [v]收工;
hand sth down to sb: [a]/hænd ˈsʌmθɪŋ daʊn tu ˈsʌmbədi/; [v](作为传统)传下,传给;
break one's heart: [a]/brek wʌnz hɑrt/; [v]使人心碎;
for good (and all): [a]/fɔːr ɡʊd ənd ɔːl/; [adv]永久地,一劳永逸地;
be at odds (with sb)(over sth): [a]/biː æt ɑːdz wɪθ ˈsʌmbədi ˈoʊvər ˈsʌmθɪŋ/; [adj]与.有争执;
stand in line: [a]/stænd ɪn laɪn/; [v]排队;
make light of: [a]/meɪk laɪt ɑv/; [v]轻视;
fall behind: [a]/fɔl bɪˈhaɪnd/; [v]落后;
clear away: [a]/klɪr əˈweɪ/; [v]把.除掉;
let sb down: [a]/let ˈsʌmbədi daʊn/; [n]使失望;
at the mercy of: [a]/ət ðə ˈmɜrsi ɑv/; [prep]在.支配中,任凭.摆布;
keep sb up: [a]/kiːp ˈsʌmbədi ʌp/; [v]坚持,继续;
go out: [a]/ɡoʊ aʊt/; [v]外出,参加社交活动,熄灭,(衣服式样)过时,出去,交往;
be obsessed with: [a]/bi əbˈsest wɪð/; [v](指恐惧等)缠住;使烦扰;对.着迷;
think nothing of: [a]/θɪŋk ˈnʌθɪŋ ɑv/; [v]把.看作平常;
clear up: [a]/klɪr ʌp/; [v]放晴,清除,整理;
come to sb: [a]/kʌm tu ˈsʌmbədi/; [v]被想到;
hit on (upon): [a]/hɪt ɔːn əˈpɔːn/; [v]碰巧打到,偶然发现;
go for sb: [a]/ɡoʊ fɔːr ˈsʌmbədi/; [v]去请(人);袭击;
at a loose end: [a]/ət ə lus end/; [adv]不知做什么好;
stick sth out: [a]/stɪk ˈsʌmθɪŋ aʊt/; [v]伸出;
hit it off (with sb/together): [a]/hɪt ɪt ɑːf wɪθ ˈsʌmbədi təˈɡeðər/; [v]一见如故,合得来;
give oneself (put on) airs: [a]/ɡɪv wʌnˈself pʊt ɔːn erz/; [v]装腔作势;
make sb up: [a]/meɪk ˈsʌmbədi ʌp/; [v]化妆;
at a stroke: [a]/ət ə stroʊk/; [adv]一下子;
stick around: [a]/stɪk ə'raʊnd/; [v]逗留;
live it up: [a]/lɪv ɪt ʌp/; [v]过着逍遥的日子;狂欢一场;
at full tilt: [a]/ət fʊl tɪlt/; [adv]全速地;全力以赴地;
bring (call) sth to mind: [a]/brɪŋ kɔːl ˈsʌmθɪŋ tu maɪnd/; [v]想起某事;
cast sb/sth aside: [a]/kæst ˈsʌmbədi ˈsʌmθɪŋ əˈsaɪd/; [v]抛弃,废除;
behind the times: [a]/bɪˈhaɪnd ðə taɪmz/; [adv]过时的;
have the makings of: [a]/həv ðə ˈmeɪkɪŋz ɑv/; [v]具有成为.所需要的素质;
stand for sth: [a]/stænd fɔːr ˈsʌmθɪŋ/; [v]表示;代表;
carry on: [a]/'kæriː ɔn/; [v]继续开展;坚持;举止失常;
go through/sth: [a]/ɡoʊ θruː ˈsʌmθɪŋ/; [v]仔细讨论;搜查;经受;用光(钱);穿过;
come over sb: [a]/kʌm ˈoʊvər ˈsʌmbədi/; [v](被感觉等)支配,攥住,拜访;
come up with: [a]/kʌm ʌp wɪð/; [v]提出;想出;
first and foremost: [a]/fɜrst ənd ˈfɔrˌmoʊst/; [adv]首先;
in the hands of: [a]/ɪn ðə hændz ʌv/; [prep]在.掌握中;
bear sth in mind: [a]/ber ˈsʌmθɪŋ ɪn maɪnd/; [v]记住某事;
at full blast: [a]/æt fʊl blæst/; [adv]最大地;
leave off: [a]/liv ɑf/; [v](使)停止;
catch up with sb: [a]/kætʃ ʌp wɪθ ˈsʌmbədi/; [v]赶上;逮捕;
keep on (doing sth): [a]/kiːp ɔːn ˈduːɪŋ ˈsʌmθɪŋ/; [v]继续做某事;
be bent on: [a]/bi bent ɔn/; [v]专心致志于;决心要;
cash in on: [a]/kæʃ ɪn ɔn/; [v]以.获利,营利;
keep sth in mind: [a]/kiːp ˈsʌmθɪŋ ɪn maɪnd/; [v]记住;
take after sb: [a]/teɪk ˈæftər ˈsʌmbədi/; [v]像某人;
accountable for: [a]/əˈkaʊntəb(ə)l fɔr/; [adj]对.应负责任;
get sth down: [a]/ɡet ˈsʌmθɪŋ daʊn/; [v]吞下;写下;
be in two minds about sth: [a]/biː ɪn tuː maɪndz əˈbaʊt ˈsʌmθɪŋ/; [adj]犹豫不决;
take one's time (over sth): [a]/teɪk wʌnz taɪm ˈoʊvər ˈsʌmθɪŋ/; [v]慢慢做;
keep sth to oneself: [a]/kiːp ˈsʌmθɪŋ tu wʌnˈself/; [v]不让他人分享,独自享用;
get through/sth: [a]/ɡet θruː ˈsʌmθɪŋ/; [v]通过(考试等);
beat sb/sth off: [a]/biːt ˈsʌmbədi ˈsʌmθɪŋ ɑːf/; [v]击退;
be (go) on board: [a]/biː ɡoʊ ɔːn bɔːrd/; [adv]在船上,在飞机上;
the gist: [a]/ðə dʒɪst/; [n]要旨;
take stock of: [a]/teɪk stɒk ɑv/; [v]估量;观察;
carry through: [a]/ˈkeri θru/; [v]维持;使渡过难关,坚持下去;
bear sth(sb) out: [a]/ber ˈsʌmθɪŋ ˈsʌmbədi aʊt/; [v]证实;
become of: [a]/bɪˈkʌm ɑv/; [v](命运等)降临;使遭遇;发生.情况;
feel like: [a]/fil laɪk/; [v]想要;  quant. 像要.似的;觉得;摸起来像.似的;
get along: [a]/ɡet əˈlɔŋ/; [v]与.和睦相处;进展;
on end: [a]/ɔn end/; [adv]直立;
on no account: [a]/ɔn noʊ əˈkaʊnt/; [adv]决不;
on time: [a]/ɑːn taɪm/; [adv]准时;
pass the time of day with: [a]/pæs ðə taɪm ɑv deɪ wɪθ/; [v]交谈;共渡;
pay sb back: [a]/peɪ ˈsʌmbədi bæk/; [v]还债;受到惩罚;
pay up: [a]/peɪ ʌp/; [v]付清,结账;
plead guilty (not guilty): [a]/pliːd ˈɡɪlti nɑːt ˈɡɪlti/; [v]服罪(不服罪);
set on sb: [a]/set ɔːn ˈsʌmbədi/; [v]攻击;
set out: [a]/set aʊt/; [v]出发;
set sth back: [a]/set ˈsʌmθɪŋ bæk/; [v]把(钟,表)向回拨;
single out: [a]/ˈsɪŋɡ(ə)l aʊt/; [v]挑选,选出;
snap at sth: [a]/snæp æt ˈsʌmθɪŋ/; [v]咬住;
assembly line: [a]/əˈsembli laɪn/; [n]装配线(生产上一环接一环的),流水线;
real estate: [a]/ˈriːəl əsteɪt/; [n]不动产,房地产;
all the time: [a]/ɔl ðə taɪm/; [adv]始终;一直;
border on (upon): [a]/ˈbɔːrdər ɔːn əˈpɔːn/; [v]接近,近似;
give way (to sb): [a]/ɡɪv weɪ tu ˈsʌmbədi/; [v]让步,屈服;
nominate sb for: [a]/ˈnɑːmɪneɪt ˈsʌmbədi fɔːr/; [v]提名,推荐;
stand in (for sb): [a]/stænd ɪn fɔːr ˈsʌmbədi/; [v]代替;
have to do with: [a]/hæv tə dʊ wɪð/; [v]与.有关;
later on: [a]/'leɪtər ɔn/; [adv]后来;稍后;
get through: [a]/ɡet θru/; [v]完成;穿过;(成功)渡过(困难时期);打通(电话);
had better: [a]/hæd ˈbetər/; [v]最好还是;
boil down to: [a]/bɔɪl daʊn tu/; [v]归结起来是,问题是;
nothing to do with: [a]/ˈnʌθɪŋ tu doʊ wɪθ/; [v]与.无关;
pass off: [a]/pæs ɑf/; [v]冒充,误导使把.当做.;发生;
pull over: [a]/pʊl ˈoʊvər/; [v]开到路边;
chamber music: [a]/ˈtʃeɪmbər mjuːzɪk/; [n]室内乐;
superior to: [a]/sʊˈpɪriər tu/; [adj]高于..,优于..;
air conditioner: [a]/ˈer kəndɪʃənər/; [n]空调,空调设备;
get rid of: [a]/ɡet rɪd ɑv/; [v]摆脱;除去;
bald eagle: [a]/ˌbɔːld ˈiːɡl/; [n]秃头鹰(美国国鸟);
barbed wire: [a]/ˌbɑːrbd ˈwaɪər/; [n]带倒钩的铁丝(铁丝网);
blast furnace: [a]/ˈblæst fɜːrnəs/; [n]鼓风炉;
compound eyes: [a]/ˌkɑːmpaʊnd ˈaɪz/; [n]复眼;
contribute to: [a]/ˈkɑntrɪˌbjut tu/; [v]导致;是...的原因;有助于,捐赠;
crude oil: [a]/krud ɔɪl/; [n]原油;
draft animal: [a]/dræft ˈænɪm(ə)l/; [n]役用动物;
popular tune: [a]/ˈpɑpjələr tun/; [n]流行歌曲;
spinal cord: [a]/ˌspaɪnl ˈkɔːrd/; [n]脊髓;
treasure trove: [a]/ˈtreʒər troʊv/; [n]无主珍宝;宝藏,宝库;
gravitational force: [a]/ˌɡrævɪˈteɪʃən(ə)l fɔrs/; [n]地心引力;
ice sheet: [a]/ˈaɪs ʃiːt/; [n]冰层;
life span: [a]/laif spæn/; [n]寿命;生命的源泉;
make the best of a bad job: [a]/meɪk ðə best ɑv ə bæd dʒɑb/; [v]尽力把损失减少到最小;
pick sb up: [a]/pɪk ˈsʌmbədi ʌp/; [v]结识;中途搭乘;举起;
rule of thumb: [a]/rul ɑv θʌm/; [n]单凭经验的做法;经验法则;
beat about/around the bush: [a]/biːt əˈbaʊt əˈraʊnd ðə bʊʃ/; [v]转弯抹角;
per cent: [a]/pər ˈsent/; [n]百分数;
blind spot: [a]/ˈblaɪnd spɑːt/; [n]<物>盲点,<无>静区,(驾驶车辆等视力以外的)盲区;
better off: [a]/ˈbetər ɑf/; [adj]境况(尤指经济境况)较好;
Wall Street: [a]/ˈwɔːl striːt/; [n]华尔街(美金融业集中之地);
mark down: [a]/mɑrk daʊn/; [v]降价; [n]降价;
free market: [a]/ˌfriː ˈmɑːrkɪt/; [n]<经>自由竞争的市场;
roller coaster: [a]/ˈroʊlər koʊstər/; [n]过山车;
bad breath: [a]/ˌbæd ˈbreθ/; [n]口臭;
best man: [a]/ˌbest ˈmæn/; [n]伴郎;
boarding pass: [a]/ˈbɔːrdɪŋ pæs/; [n]登机牌;
bungee jumping: [a]/ˈbʌndʒi dʒʌmpɪŋ/; [n]蹦极跳,身上系着橡皮带从高处往下跳的游戏;
cheer on: [a]/tʃiə ɔn/; [v]鼓励,为某人打气;
fire extinguisher: [a]/ˈfaɪər ɪkstɪŋɡwɪʃər/; [n]灭火器;熄灭者;
hide and seek: [a]/haid ænd si:k/; [n]捉迷藏;
kung fu: [a]/ˌkʌŋ ˈfuː/; [n]中国功夫;
parking lot: [a]/ˈpɑːrkɪŋ lɑːt/; [n]停车场;
pass out: [a]/pæs aʊt/; [v]昏倒,死;
praying mantis: [a]/ˌpreɪɪŋ ˈmæntɪs/; [n]螳螂;
run out: [a]/rʌn, aʊt/; [v]跑出,离开,完成,被用完,伸向,流逝,逐出,放出去;
slam dunk: [a]/ˈslæm dʌŋk/; [n]扣篮;
sleeping bag: [a]/ˈsliːpɪŋ bæɡ/; [n](野外用的)睡袋;
Valentine's Day: [a]/ˈvælənˌtaɪnzdeɪ/; [n]情人节(二月十四日);
make (sth. )out: [a]/meɪk ˈsʌmθɪŋ aʊt/; [v]写;辨认出;理解;歪曲;
closed-circuit television: [a]/ˌkloʊzd ˌsɜːrkɪt ˈtelɪvɪʒn/; [n]闭路电视;
know better (than): [a]/noʊ ˈbetər ðən/; [v]很明白(而不至于);
sale price: [a]/seɪl praɪs/; [n]特价,廉价;
amino acid: [a]/əˌmiːnoʊ ˈæsɪd/; [n]<生>氨基酸;
take issue with: [a]/teɪk ˈɪʃu wɪθ/;  quant. 与...争论;对...提出异议;
due to: [a]/duː tu/; [prep]由于,取决于;
strep throat: [a]/ˌstrep ˈθroʊt/; [n]<医>脓毒性咽喉炎;
fool around: [a]/ful əˈraʊnd/; [v]闲荡,干蠢事(或无用,琐悄的事);
stumbling block: [a]/ˈstʌmblɪŋ blɑːk/; [n]障碍物,绊脚石;
bona fides: [a]/ˌboʊnə ˈfaɪdiːz/; [n]<拉>诚意,善意;
lay sb off: [a]/leɪ ˈsʌmbədi ɑf/; [v]解雇;关闭;停止活动; [n](临时)解雇期;
trade off: [a]/treɪd ɑf/; [v]交替换位,通过交换抛掉,权衡;
status quo: [a]/ˌsteɪtəs ˈkwoʊ/; [n]<拉>现状;
take issue: [a]/teɪk ˈɪʃu/; [v]就某事与某人争论;
live show: [a]/lɪv ʃoʊ/; [n]现场表演;
hold up: [a]/hoʊld ʌp/; [v]举起;支撑;耽搁;(在逆境中) 保持良好状况;
a great many: [a]/ə ɡreɪt ˈmeni/; [adj]许多;
information desk: [a]/ˌɪnfərˈmeɪʃ(ə)n desk/; [n]问讯处;
bank account: [a]/ˈbæŋk əkaʊnt/; [n]银行账户;
bean curd: [a]/ˈbiːn kɜːrd/; [n]豆腐;
boat race: [a]/boʊt reɪs/; [n]划船比赛;
body building: [a]/ˈbɑːdi ˈbɪldɪŋ/; [n]健美;
bus stop: [a]/ˈbʌs stɑːp/; [n]公共汽车站;
department store: [a]/dɪˈpɑːrtmənt stɔːr/; [n]百货商场;
fitting room: [a]/ˈfɪtɪŋ ruːm/; [n]试衣间;
table manners: [a]/ˈteɪbl mænərz/; [n]餐桌礼仪;
physical education: [a]/ˌfɪzɪkl edʒuˈkeɪʃn/; [n]体育课,体育教育;
record holder: [a]/ˈrekərd hoʊldər/; [n]记录保持者;
shop assistant: [a]/ˈʃɑːp əsɪstənt/; [n](英)售货员;
skipping rope: [a]/ˈskɪpɪŋ roʊp/; [n](跳绳用)绳;
table tennis: [a]/ˈteɪbl tenɪs/; [n]乒乓球;
traffic lights: [a]/ˈtræfɪk laɪts/; [n]交通指挥灯,红绿灯;
zip code: [a]/ˈzɪp koʊd/; [n]邮政编码;
hand truck: [a]/hænd trʌk/; [n]手推运货车;
washing machine: [a]/ˈwɑːʃɪŋ məʃiːn/; [n]洗衣机;
New York: [a]/nuː jɔːrk/; [n]纽约;
laugh at: [a]/læf æt/;  quant. 嘲笑;
human being: [a]/ˈhjumən ˈbiɪŋ/; [n]人;
fruit juice: [a]/frut dʒus/; [n]果汁;
moon cake: [a]/mun keɪk/; [n]月饼;
opera house: [a]/ˈɑːprə haʊs/; [n]歌剧院,艺术剧院;
service charge: [a]/ˈsɜːrvɪs tʃɑːrdʒ/; [n]服务费,小费;
short wave: [a]/ˌʃɔːrt ˈweɪv/; [n]短波;
side road: [a]/ˈsaɪd roʊd/; [n]岔道;
telephone box: [a]/ˈtelɪfoʊn bɑːks/; [n]电话亭;
the United Nations(UN): [a]/ði juˈnaɪtɪd ˈneɪʃnz/; [n]联合国; [(U.N./UN(缩)]
waiting room: [a]/ˈweɪtɪŋ ruːm/; [n]候车室,候诊室;
can opener: [a]/ˈkæn oʊpnər/; [n]开罐器;
next to: [a]/ˈnekst tu/; [prep]相邻,紧挨着;仅次于,在..之后;几乎;与..相比;
as well as: [a]/æz wel æz/; [conj]也,和;
Middle East: [a]/ˈmɪd(ə)l ist/; [n]中东;
tax free: [a]/ˌtæks ˈfriː/; [adj]免税的;
over and over again: [a]/ˈoʊvər ənd ˈoʊvər əˈɡen/; [adv]反复,多次重复;
set free: [a]/set friː/; [v]释放;使获得自由;
New Zealand: [a]/ˌnuːˈziːlənd/; [n]新西兰;
raw material: [a]/ˌrɑː məˈtɪriəl/; [n]原材料,原料;
chain store: [a]/ˈtʃeɪn stɔːr/; [n]连锁店;连锁商店;
trolley bus: [a]/ˈtrɑli bʌs/; [n]无轨电车;
dressing gown: [a]/ˈdresɪŋ ɡaʊn/; [n]晨衣,便袍;
driving licence: [a]/ˈdraɪvɪŋ laɪsns/; [n](英)驾驶执照;
sooner or later: [a]/ˈsʊnər ɔːr ˈleɪtər/; [adv]迟早;早晚有一天;
get round sth: [a]/ɡet raʊnd ˈsʌmθɪŋ/; [v]规避(法律),避开;
soya bean: [a]/ˈsɔɪbiːn/; [n]大豆;
pencil case: [a]/ˈpensl keɪs/; [n]文具盒;
Hong Kong: [a]/hɒŋ kɒŋ/; [n]香港;
San Francisco: [a]/sæn fræn'siskəu/; [n]旧金山(美国城市);
stand by: [a]/stænd baɪ/; [v]袖手旁观,准备行动;
in advance: [a]/ɪn ædˈvæns/;  quant. 提前,预先;
focus on: [a]/ˈfoʊkəs ɑːn/; [n]以..为焦点,集中于; [v]聚焦于;
care about: [a]/ker əˈbaʊt/; [v]对..感兴趣,关心,顾虑,在乎;
under construction: [a]/ˈʌndər kənˈstrʌkʃ(ə)n/; [prep]正在施工之中;
jet lag: [a]/ˈdʒet læɡ/; [n]飞行时差反应,时差感;
the Antarctic: [a]/ænˈtɑːrktɪk/; [n] [地理]南极地区;
the Arctic: [a]/ðə ˈɑrktɪk/; [n]北极区;
personal computer: [a]/ˌpɜːrsənl kəmˈpjuːtər/; [n](PC)个人电脑,; [计]个人计算机;
Taj Mahal: [a]/'tɑ:dʒ məˈhɑːl/; [n]泰姬陵;
Czech Republic: [a]/ˌtʃekrɪ'pʌblɪk/; [n]捷克共和国(东欧国家);
Milu deer: [a]/mɪ'luː dɪr/; [n]麋鹿;
rock 'n' roll: [a]/ˌrɑːk ən ˈroʊl/; [n](rock-and-roll)摇滚乐;
Prime Minister: [a]/ˌpraɪm ˈmɪnɪstər/; [n]总理,首相;
the Milky Way: [a]/ðə ˌmɪlki ˈweɪ/; [n]银河;
Big Bang: [a]/ˌbɪɡ ˈbæŋ/; [n]宇宙大爆炸,创世大爆炸;
the Vatican City State: [a]/ðə'vætɪkən ˈsɪti steɪt/; [n]梵蒂冈城国;
Northern Ireland: [a]/'nɔːrðərn 'aɪrlənd/; [n]北爱尔兰(英);
the Union Jack: [a]/ðə ˌjuːniən ˈdʒæk/; [n]英国国旗;
water color: [a]/ˈwɔtər ˈkʌlər/; [n]水彩画;
mind reader: [a]/ˈmaɪnd riːdər/; [n](自称或被认为)能看透别人心思的人;
on sale: [a]/ɑːn seɪl/; [adj]待售的,拍卖的;
go on a diet: [a]/ɡoʊ ɑːn ə ˈdaɪt/; [n]节食;
garbage can: [a]/ˈɡɑːrbɪdʒ kæn/; [n]垃圾桶,垃圾箱;
the North Pole: [a]/ðə ˌnɔːrθ ˈpoʊl/; [n]北极;
the Norman Conquest: [a]/ðə ˈnɔːrmən ˈkɑːŋkwest/; [n]诺曼征服;
the Renaissance: [a]/ðə'renəsɑːns/; [n]文艺复兴;
fall for: [a]/fɔːl fɔːr/; [v]信以为真,对..倾倒,受..的骗;
tae kwon do: [a]/ˌtaɪ ˌkwɑːn ˈdoʊ/; [n] [体]跆拳道;
power boating: [a]/ˈpaʊər ˈboʊtɪŋ/; [n](运动项目)汽艇,摩托艇;
amusement park: [a]/əˈmjuːzmənt pɑːrk/; [n]游乐场;
public relations: [a]/ˌpʌblɪk rɪˈleɪʃnz/; [n]公共关系;
follow in one's footsteps: [a]/ˈfɑːloʊ ɪn wʌnz ˈfʊtsteps/;  quant. 追踪别人的脚步;效法某人,以某人为榜样;效法某人,以某人为榜样;
genetically modified: [a]/dʒəˌnetɪkli ˈmɑːdɪfaɪd/; [adj]转基因的;
alarm clock: [a]/əˈlɑːrm klɑːk/; [n]闹钟;
remote control: [a]/rɪˌmoʊt kənˈtroʊl/; [n]遥控,遥控装置,遥控操作;
the United Nations: [a]/ðə juˌnaɪtɪd ˈneɪʃnz/; [n]联合国;
the Mid-Autumn Festival: [a]/ðə mɪd ˈɔːtəm ˈfestɪvl/; [n]中秋节;
the Lantern Festival: [a]/ðə ˈlæntə(r)n ˈfestɪv(ə)l/; [n]元宵节;
global warming: [a]/ˌɡloʊbl ˈwɔːrmɪŋ/; [n]全球变暖;
the Pentagon: [a]/ðə ˈpentəˌɡɑn/; [n]五角大楼;
tap dancing: [a]/tæp ˈdænsɪŋ/; [n]踢踏舞;
sort of: [a]/sɔːrt əv/; [adv]有几分地;
traffic jam: [a]/ˈtræfɪk dʒæm/; [n]塞车,交通拥塞;
pull out: [a]/pʊl aʊt/; [v]拔出,离开,度过难关,恢复健康;
get across: [a]/ɡet ə'krɔːs/; [vi]通过(渡过,被人了解);
carbon monoxide: [a]/ˌkɑːrbən mənˈɑːksaɪd/; [n] [化]一氧化碳;
mobile phone: [a]/ˌmoʊbl ˈfoʊn/; [n]手机;
heart attack: [a]/ˈhɑːrt ətæk/; [n]心脏病发作;
without hesitation: [a]/wɪðˈaʊt ˌhezɪˈteɪʃ(ə)n/; [adv]毫不犹豫地;
water lily: [a]/ˈwɔːtər lɪli/; [n] [植]睡莲;
Yulan magnolia: [a]/'juːlæn mæɡˈnoʊliə/; [n]玉兰;
South Korea: [a]/ˌsaʊθ kəˈriə/; [n]南朝鲜,韩国;
the Olympic Games: [a]/ði əˌlɪmpɪk ˈɡeɪmz/; [n]奥林匹克运动会;
track event: [a]/ˈtræk ɪvent/; [n]径赛项目;
field event: [a]/ˈfiːld ɪvent/; [n] [体]田赛;
correspondence course: [a]/kɔːrəˈspɑːndəns kɔːrs/; [n]函授课程;
car park: [a]/ˈkɑːr pɑːrk/; [n]停车场;
convenience store: [a]/kənˈviːniəns stɔːr/; [n](全天或长时间营业的)便利商店;
water vapour: [a]/ˈwɔtər 'veɪpər/; [n]水蒸汽;
practical joke: [a]/ˌpræktɪkl ˈdʒoʊk/; [n]恶作剧;
ozone layer: [a]/ˈoʊzoʊn ler/; [n]臭氧层;
peace and quiet: [a]/pis ənd ˈkwaɪət/; [n]宁静;
travel agent: [a]/ˈtrævl eɪdʒənt/; [n]旅行代理人;
the Netherlands: [a]/ði ˈnɛðələndz/; [n]荷兰;
base on: [a]/beɪs ɔn/; [v]基于,以..为依据;
the Stone Age: [a]/ðə ˈstoʊn eɪdʒ/; [n]石器时代;
MSG(mono-sodium glutamate): [a]/ˌem es ˈdʒiː (ˌmɑːnəˌsoʊdiəm ˈɡluːtəmeɪt)/; [n]味精;
nursery rhyme: [a]/ˈnɜːrsəri raɪm/; [n]童谣;
chewing gum: [a]/ˈtʃuːɪŋ ɡʌm/; [n]口香糖;
turn around: [a]/tɜːrn əˈraʊnd/;  quant. 掉头,转向;(生意或经济) 好转;
baleen whale: [a]/bəˈlin hwel/; [n]须鲸;
sea anemone: [a]/ˈsiː əneməni/; [n]海葵;
fit in: [a]/fit in/;  quant. 适合;适应,融入(群体);
cable car: [a]/ˈkeɪbl kɑːr/; [n](登山)缆车;
mark out: [a]/mɑːk aʊt/; [v]划界;
make out: [a]/meɪk aʊt/;  quant. 理解;辨认出;
DJ(=disk jockey): [a]/ˈdiː dʒeɪ/; [n](电台)音乐唱片节目主持人,(俱乐部)舞曲唱片播放员;
in turn: [a]/ ɪn tɝn /;  quant. 依次;反过来;转而;
the Statue of Liberty: [a]/ðə ˌstætʃuː əv ˈlɪbərti/; [n]自由女神像;
cater (to): [a]/ˈkeɪtər tu/; [vi]满足,迎合;
strategy meeting: [a]/ˈstrætədʒi ˈmiːtɪŋ/; [n]战略会议;
crisis meeting: [a]/ˈkraɪsɪs ˈmiːtɪŋ/; [n]危机会议;
vice versa: [a]/ˌvaɪs ˈvɜːrsə/; [adv]反过来也是一样地;
PR coordinator: [a]/ˌpiː ˈɑːr koʊˈɔːrdɪneɪtər/; [n]公关协调员(public relations coordinator);
quality control: [a]/ˈkwɑːləti kəntroʊl/; [n]质量管理,质量控制;
the Press: [a]/ðə pres/; [n]新闻界,报刊(总称);
specialise in: [a]/ˈspeʃəlaɪz ɪn/; [v]专门从事,专门研究;
cold calling: [a]/kold ˈkɔlɪŋ/; [n]不请自来的推销电话;
put (sb) through: [a]/pʊt θrʊ/; [vt]接通(电话),顺利完成;
economic growth: [a]/ˌiːkəˈnɑːmɪk ɡroʊθ/; [n]经济成长,经济增长;
be aimed at: [a]/bi eɪmd ət/; [prep]目的在于,致力于;
insider dealing: [a]/ɪnˈsaɪdər ˈdiːlɪŋ/; [n](股市的)内部交易;
job market: [a]/dʒɑb ˈmɑrkɪt/; [n]工作市场,就业市场;
low income: [a]/lo ˈɪnˌkʌm/; [n]低收入;
ad valorem: [a]/ˌæd vəˈlɔːrem/; [adj]按价的,从价的;
jaws of death: [a]/dʒɔːz əv deθ/; [n]死地(鬼门关,险境);
nautical mile: [a]/ˌnɔːtɪkl ˈmaɪl/; [n]海里;
fill out: [a]/fɪl aʊt/; [v]填写;长胖;充实;
speak well of: [a]/spik wɛl ʌv/; [v]称赞;
move away: [a]/muv əˈwe/; [v]搬走;搬开;
tuck in: [a]/tʌk ɪn/; [vt]塞入;大吃一顿;
index finger: [a]/ˈɪndeks fɪŋɡər/;  食指;
lung cancer: [a]/lʌŋ ˈkænsɚ/; [n]肺癌;
be safe from: [a]/bi sef frʌm/; [prep]免受;
without reservation: [a]/wɪðˈaʊt ˌrɛzɚˈveʃən/; [adj]无保留地,无条件地;坦白地);
be adapted to: [a]/bi əˈdæptid tu/; [v]适合于;适应于;
lend an ear: [a]/lɛnd ən ɪr/; [vi]听(倾听);
lose control of: [a]/luz kənˈtrol ʌv/; [v]失控;
be susceptible to: [a]/bi səˈsɛptəbəl tu/; [vt]易感染(对...敏感);
stay in touch with: [a]/steɪ ɪn tʌtʃ wɪð/; [v]与...保持联系;