get your wish: 如你所愿;
make all that right: 使这些都变好起来了;
PR disaster: 公共关系麻烦;
make the right decision: 做出正确的决定;
take five: 休息五分钟;
mental arithmetic: 心算能力;
photo copier: 复印机;
a mug of: 一杯..;
Knightley himself: 奈特利本人;
recurrence to the past: 重蹈覆辙;
show-watching zombies: 看热闹的呆子,吃瓜群众;
wash away your sin: 洗掉你的罪恶;
make peace: 讲和;
train schedule: 火车时刻表;
support group: 互助小组;
any ache: 所有病痛,例如,headache,toothache,earache;
preferential treatment: 优待;
acquit sb: 无罪释放某人;
lymphatic tissue: 淋巴组织;
nervous energy: 神情紧张;
coldness or hotness: 冷还是热;
painstaking research: 艰苦的研究;
infallible liniment: 万能神油;
some analgesics: 一些止痛药;
win back sth: 赢回..东西;
diverse community: 多元化社区 ;
normal face: 大众脸;
family tradition: 家庭传统;
take a piss: 上厕所;
a whole new level: 一个全新的高度;
photo shoot: 写真;
a single thing: (任何)一件事;
old pal: 老伙计;
dust to dust: 尘归尘;
earth to earth: 土归土;
ashes to ashes: 尘归尘;
eyes and ears: 耳目;
clear sb's name: 为某人洗清罪名;
members of royalty: 皇室成员;
make an exception: 破例;
sb at your service: 某人愿为你效劳;
hollow promise: 空头诺言;
be in no mood to do sth: 没有心情做某事;
birth right: 与生俱来的权利;
come straight to the point: 直截了当;
scratch pad: 便笺簿;
change the sheets: 换床单;
fake sb's death : 伪造某人的死亡;
mashed potato: 土豆泥;
pawn shop: 典当行 ;
reality show: 真人秀;
wrong sb: 陷害某人;
in the woods: 在树林里;
chicken blood: 鸡血;
play mental games: 玩心理战术;
confirmation number: 验证码;
in person: 亲自;
three rounds: 三个回合;
against the grain: 与..相违背;
Lake Baikal: 贝加尔湖;
Soviet Union: 苏联(苏维尔联盟);
yield or death: 投降或者死亡;
my calling: 我的使命;
split up: 分开走;
hold tight: 抓紧;
every walk of life: 各行各业;
first rank: 一流的;
get..in tune: 与..相呼应;
mirror into: 反映到..  ;
black out: 昏过去;
live in the now: 活在当下;
be under arrest: 被捕;
promised land: 应许之地,乐土;
slot machine: 老虎机;
a life for a life: 一命换一命;
piss pot: 尿壶;
seat belt: 安全带;
pain killers: 止痛药;
sleeping pills: 安眠药;
free food: 免费的食物;
new you: 一个崭新的你;
chase me: 来抓我啊;
shut the fuckup: 闭嘴;
dead soul: 灵魂已死;
stay close: 紧跟着我 ;
the cross: 十字架;
inner circle: 核心集团;
stay back: 退后;
purge the evil: 净化邪恶;
purge the sins: 净化罪过;
sign and date: 签字并注明日期;
keep showing up: 阴魂不算 ;
sb. has seen/known too much: 某人知道的太多了;
move on: 释然;
ice cold: 冰凉的(酒);
make the first move: 走出第一步;
break a leg: 演出成功;
to celebrate the upcoming Year of the Pig: 庆祝即将来临的猪年;
render sth. realizable: 是..变为现实;
incessant rain confined them indoors: 不停的雨把他们限制在室内;
hero or villain: 英雄还是恶棍;
my bad: 我的锅;
sick ward: 病房;
bird poop: 鸟屎;
mess with sb's head: 迷惑某人;
have a sad face: (看起来)不高兴;
find a way in: 找个方法进去(封闭的场所);
make you pretty: 把你打扮的漂漂亮亮;
the moral of the story: 这个故事的寓意;
surrender myself to you: 把自己奉献(投降)给你;
warm up: 热身;
slow sb down: 拖某人后腿;
many a time: 很多次;
not even close: 差得远;
for good: 永远;
read people: 看人;
finders keepers: 谁找到是谁的;
no more plans: 没有别的计划了;
get sb some water: 给某人倒点水;
hold position: 保持(你的)姿势;
the top of the food chain: 食物链顶端;
stick together: 待在一起;
make sb do sth: 逼迫某人做某事;
have 50/50 shot: 有五成机会;
deal with one problem at a time: 一次解决一个问题;
sb is a quick learner: 某人学的快;
detail instructions: 详细指导;
pick up the pace: 跟上步伐,快点;
pick up the bill(check): 付账,买单;
pick up the candidates: 挑选候选人;
pick up the goods: 提货;
pick up the girl: 结识这个女孩;
pick up the habit: 养成习惯;
pick up the phone: 接起电话;
have no choice but to do sth:除了做..别无选择;
cold-blooded murder: 冷血杀手;
make the same mistake: 犯同样的错;
deserve better: 值得(得到)更好的;
force of habit: 习惯的力量;
be meant to be: 注定是;
hang on: 稍等一下(不要挂电话);坚持住;;
previously on + ..(剧名): ..的前情回顾;
heart beat: 心跳(声);
birth/biological father: 生父;
foster father: 养父;
Lady Justice: 正义女神;
Your Majesty: 陛下;
a lightning rod: 一根避雷针;
pay the price: 付出代价;
wake up: 醒来;
glow stick: 荧光棒;
go through: 通过(考试),挺过(艰难的时期);
slow suicide: 慢性自杀;
stir things up: 挑拨是非;
mid-life crisis: 中年危机;
drop sb off: 让某人下车;
flip a coin: 抛硬币(决定某事);
crossword puzzle: 纵横字谜游戏;
side effect: 副作用;
Walt junior: 小Walt(大Walt的儿子);
hair loss: 脱发;
shopping list: 购物清单;
take it out on sb: 把气出在..身上;
big time: 历史性时刻;
one true love: 唯一的爱;
money laundering: 洗钱;
put sb in jail: 把某人送进监狱;
put sth away: 把..收起来;
tough guy: 硬汉;
walk away: 走开;
boarding school: 寄宿学校 ;
formal invitation: 正式邀请;
take a day off: 请一天假;
drive sb crazy: 把某人逼疯;
set sb up: 设计陷害某人;
vice present: 副总统;
work ethic: 职业道德;
give a hand to sb: 帮助某人;
check my balance: 检查我的收支(账户);
three out of five: 五局三胜;
here and there: 乱逛;
the best view in town: 小镇最好的风景;
time after time: 一次又一次;
take a breath: 深呼吸;
take sb's life: 取某人的性命;
serial number: (抢上的)序列号 ;
start over: 重新开始;
Great Lakes: 北美五大湖, Superior,Michigan,Huron,Erie,Ontario.;
little by little: 渐渐地;
backup plan: 后备计划 ;
hard way or easy way: 来硬的还是软的;
lucky cat: 招财猫;
bucket list: 遗愿清单 ;
be messy and clumsy: 笨手笨脚;
psychic: 灵媒;灵魂的;
an eye for an eye: 以牙还牙;
safe travels: 一路顺风;
nail salon: 修甲沙龙;
undercover cop: 卧底警察;
collar them: 给它们带上项圈 ;
holy spirit: 圣灵;
open season: 非禁渔期;狩猎季节;
weiner dog: 腊肠犬;
to-do list: 待办列表;
final decision: 最后通牒;
big dumb limb: 四肢发达的笨蛋;
drag  yourself out of the shit: 把自己从这糟糕的状况中拉出来;
real word: 现实世界;
be abducted by aliens: 被外星人绑架;
storeroom: 存储室;
minder reader: 读心者;
hobo look: 流浪汉的样子;
arranged marriage: 包办婚姻;
cheerleader: 啦啦队长;
a second chance: 第二次机会;
Rotten Romans: 腐朽的古罗马;
Smashing Saxons: 牛气的撒克逊人;
Terrible Tudors: 恐怖的都邑王朝;
a member of crew: 一名工作人员;
Vicious Viking: 凶残的维京人;
Groovy Greeks: 绝妙的希腊人;
gun control: 枪支管控;
Magma Carta: 自由大宪章;
Genghis Khan: 成吉思汗;
civil war: 内战;
group therapy: 群体治疗;
stupid stuff: 蠢事;
bro code: 兄弟法则;
check it out: 看一下这个;
nice/good man: 好人;
character flaw: 性格缺陷;
play dead: 装死;
body fluids: 体液;
a big fat loser: 怂胖子;
chicken wings: 鸡翅;
gray area: 灰色地带;
from time to time: 不时地;
hurtful comment: 刻薄的话;
prawn crackers: 虾条;
lost your faith: 你去了你的信仰;
make you fell small: 打压他人;
give me a hand: 来搭把手;
push sb away: 疏远某人;
make myself useful: 让自己变得有用.;
be quiet as a mouse: 像老鼠一样安静;
on a different frequency: 跟正常人不在同一个频率上;
instinct and training: 直觉和训练;
mind control: 精神控制;
long day: 漫长的一天;
panic attack: 惊慌发作;
one-night stand: 一夜情;
be no ease job: 不是简单的事;
the past: 过去;
the present: 现在;
the future: 未来;
road map: 路线图;
freelance junk collector: 自由废品收购人;
on your territory: 在你的地盘上;
without clearance: 未经许可;
charge sb with murder: 控告某人谋杀;
make coffe: 煮咖啡;
a road trip: 一趟公路旅行;
take sb's instructions: 听从某人的指示;
a cat person: 一个喜欢猫的人;
right time: 合适的时间;
single losers: 单身狗们 ;
uninvited guest: 不速之客 ;
black out: 昏过去;
live in the now: 活在当下;
be under arrest: 被捕;
promised land: 应许之地,乐土;
Lake Baikal: 贝加尔湖;
slot machine: 老虎机;
Soviet Union: 苏联(苏维尔联盟);
start over: 重新开始;从头再来;
wake up: 自己醒来或被别人唤醒(醒一醒);激起;;
last word: 遗言;
young offenders: 少年犯;
log in: 登陆;
community service: 社区服务;
make fan of people: 取笑别人;
log off/out: 退出;注销;离开;
serial killer: 连环杀手;
walk sb home: 陪某人走回家;
be sb'ears and eyes: 做某人的耳目;
weak point: 弱点;
fake sb: 冒充某人;
raw/cooked potatoes: 生土豆;熟土豆;
don't want sb seeing me like this: 不想让某人看到我这个样子;
get out of my way: 给我让开;
dark thought: 黑暗思想;
a pair of merry little twins: 一对快乐的双胞胎(兄弟俩);
a haunted house: 鬼屋;
sb/sth be haunted: 某人被鬼追,某物闹鬼;
maintain the peace: 维持秩序;
multiply times: 乘;
divided evenly: 被整除;
radical sign, root sign: 根号;
round to: 四舍五入;
to the nearest: 四舍五入;
proper subset: 真子集;
solution set: 解集;
algebraic term: 代数项;
like terms, similar terms: 同类项;
numerical coefficient: 数字系数;
literal coefficient: 字母系数;
triangle inequality: 三角不等式;
original equation: 原方程;
equivalent equation 同解方程: 等价方程;
linear equation: 线性方程e.g.5x+6=22;
proper fraction: 真分数;
improper fraction: 假分数;
mixed number: 带分数;
vulgar fraction,common fraction: 普通分数;
simple fraction: 简分数;
complex fraction: 繁分数;
leastcommon denominator: 最小公分母;
decimal fraction: 纯小数;
infinite decimal: 无穷小数;
recurring decimal: 循环小数;
tenths unit: 十分位;
arithmetic mean: 算术平均值;
weighted average: 加权平均值;
geometric mean: 几何平均数;
square root: 平方根;
cube root: 立方根;
common logarithm: 常用对数;
inverse function: 反函数;
complementary function: 余函数;
absolute value: 绝对值;
round off: 四舍五入;
natural number: 自然数;
positive number: 正数;
negative number: 负数;
odd integer: 奇整数,;
odd number: 奇数;
even integer, even number: 偶数;
integer, whole number: 整数;
positive whole number: 正整数;
negative whole number: 负整数;
consecutive number: 连续整数;
real number, rational number: 实数,有理数;
composite number 合数: e.g.4,6,8,9,10,12,14,15..;
common divisor: 公约数;
leastcommon multiple: 最小公倍数;
common factor: 公因子;
prime number  质数: e.g.2,3,5,7,11,13,15..;
ordinary scale, decimal scale: 十进制;
common ratio: 公比;
arithmetic progressionsequence: 等差数列;
geometric progressionsequence: 等比数列;
direct proportion: 正比;
trigonometric function: 三角函数;
alternate angle: 内错角;
corresponding angle: 同位角;
vertical angle: 对顶角;
central angle: 圆心角;
interior angle: 内角;
exterior angle: 外角;
supplementary angles: 补角;
complementary angle: 余角;
adjacent angle: 邻角;
acute angle: 锐角;
obtuse angle: 钝角;
right angle: 直角;
round angle: 周角;
straight angle: 平角;
included angle: 夹角;
equilateral triangle: 等边三角形;
scalene triangle: 不等边三角形;
isosceles triangle: 等腰三角形;
right triangle: 直角三角形;
inscribed triangle: 内接三角形;
concentric circles: 同心圆;
regular polygon: 正多边形;
line, straight line: 直线;
line segment: 线段;
parallel lines: 平行线;
segment of a circle: 弧形;
rectangular solid: 长方体;
regular solid/regular polyhedron: 正多面体;
circular cylinder: 圆柱体;
circumference, perimeter: 周长;
surface area: 表面积;
cross section: 横截面;
center of acircle: 圆心;
angle bisector: 角平分线;
face of a solid: 立体的面;
included side: 夹边;
median of a triangle: 三角形的中线;
coordinate system: 坐标系;
rectangular coordinate: 直角坐标系;
Number line: 数轴;
complex plane: 复平面;
plane geometry: 平面几何;
Pythagorean theorem: 勾股定理;
square measure: 平方单位制;
cubic meter: 立方米;
breeding ground: 温床;
be cross: 生气,发怒;
