Africa: [a]/ˈæfrɪkə/; [n]非洲; [or]zk;
African: [a]/ˈæfrɪkən/; [adj]非洲的,非洲人的; [n]非洲人; [or]zk;
America: [a]/ə'merɪkə/; [n]美国;美洲; [or]zk;
American: [a]/əˈmerɪkən/; [n]美洲人;美国人,美国; [adj]美洲的;美国的,美国人的; [or]zk;
Antarctica: [a]/ænˈtɑːrktɪkə/; [n]南极洲; [or]zk;
April: [a]/ˈeɪprəl/; [n]四月(略作Apr.); [or]zk;
Arab: [a]/ˈærəb/; [n]阿拉伯人; [adj]阿拉伯的;阿拉伯语言的; [or]zk;
Arabic: [a]/ˈærəbɪk/; [adj]阿拉伯的; [n]阿拉伯语; [or]zk;
Asia: [a]/ˈeɪʒə/; [n]亚洲; [or]zk;
Asian: [a]/ˈeɪʃn/; [adj]亚洲人的;亚洲的; [n]亚洲人; [or]zk;
Atlantic: [a]/æt'læntɪk/; [n]大西洋; [adj]大西洋的; [or]zk;
August: [a]/ˈɔːɡəst/; [n]八月; [or]zk;
Australia: [a]/ɔ'streljə/; [n]澳大利亚; [or]zk;
Australian: [a]/ɔːˈstreɪliən/; [adj]澳洲的;澳洲人的; [n]澳洲人; [or]zk;
Brazil: [a]/brəˈzɪl/; [n]巴西(拉丁美洲国家); [or]zk;
Britain: [a]/ˈbrɪtn/; [n]大不列颠,英国(包括英格兰,威尔士和苏格兰); [or]zk;
British: [a]/ˈbrɪtɪʃ/; [adj]不列颠的,英联邦的; [n]英国人;英式英语; [or]zk;
Canada: [a]/'kænədə/; [n]加拿大; [or]zk;
Canadian: [a]/kəˈneɪdiən/; [adj]加拿大的; [n]加拿大人; [or]zk;
China: [a]/ˈtʃaɪnə/; [n]中国;瓷器(china); [or]zk;
Chinese: [a]/ˌtʃaɪˈniːz/; [adj]中国的; [n]中国人;中文; [or]zk;
Christmas: [a]/ˈkrɪsməs/; [n]圣诞节; [or]zk;
December: [a]/dɪˈsembər/; [n]十二月; [or]zk;
Easter: [a]/ˈiːstər/; [n]复活节; [or]zk;
Egypt: [a]/ˈiːdʒɪpt/; [n]埃及; [or]zk;
Egyptian: [a]/iˈdʒɪpʃn/; [n]埃及人; [or]zk;
England: [a]/ˈɪŋɡlənd/; [n]英格兰,英国; [or]zk;
English-speaking: [a]/ˈɪŋɡlɪʃ ˈspikɪŋ/; [adj]说英语的; [or]zk;
English: [a]/ˈɪŋɡlɪʃ/; [n]英语,英国人; [adj]英国的,英国人的,英语的; [or]zk;
Europe: [a]/ˈjʊrəp/; [n]欧洲; [or]zk;
European: [a]/ˌjʊrəˈpiːən/; [adj]欧洲的;欧洲人的; [n]欧洲人; [or]zk;
February: [a]/ˈfebrueri/; [n]二月(略作Feb.); [or]zk;
France: [a]/fræns/; [n]法国; [or]zk;
French: [a]/frentʃ/; [n]法国人;法语; [adj]法国的;法国人的;法语的; [or]zk;
Frenchman: [a]/ˈfrentʃmən/; [n]法国人; [or]zk;
Friday: [a]/ˈfraɪdeɪ/; [n]星期五; [or]zk;
German: [a]/ˈdʒɜːrmən/; [adj]德国的; [n]德语,德国人; [or]zk;
Germany: [a]/ˈdʒɜːrməni/; [n]德国; [or]zk;
Greece: [a]/ɡriːs/; [n]希腊; [or]zk;
Greek: [a]/ɡriːk/; [n]希腊人,希腊语; [adj]希腊的,希腊人的,希腊语的; [or]zk;
Hawaii: [a]/hɑ:'waii:/; [n]夏威夷岛;夏威夷(美国州名); [or]zk;
Himalaya: [a]/ˌhɪmə'leɪə/; [n]喜马拉雅山脉; [or]zk;
Hong Kong: [a]/hɒŋ kɒŋ/; [n]香港; [or]zk;
ID: [a]/ˌaɪ ˈdiː/; abbr. 身份(identification,identity); [n]私我;本我; [v]<口>认出;识别; [or]zk;
India: [a]/'ɪndɪə/; [n]印度; [or]zk;
Indian: [a]/ˈɪndiən/; [n]印度人;印第安人;印第安语; [adj]印度的;印第安人的;印第安语的; [or]zk;
Italian: [a]/ɪˈtæliən/; [adj]意大利的,意大利人的,意大利语的; [n]意大利人,意大利语; [or]zk;
Italy: [a]/ˈɪtəli/; [n]意大利; [or]zk;
January: [a]/ˈdʒænjueri/; [n]一月; [or]zk;
Japan: [a]/dʒəˈpæn/; [n]日本; [or]zk;
Japanese: [a]/ˌdʒæpəˈniːz/; [adj]日本的,日本人的,日语的; [n]日本人,日语; [or]zk;
July: [a]/dʒuˈlaɪ/; [n]七月; [or]zk;
June: [a]/dʒuːn/; [n]六月; [or]zk;
London: [a]/ˈlʌndən/; [n]伦敦; [or]zk;
Macao: [a]/məˈkaʊ/; [n]澳门; [or]zk;
Mexican: [a]/ˈmeksɪkən/; [adj]墨西哥的; [n]墨西哥人; [or]zk;
Mexico: [a]/ˈmeksɪkoʊ/; [n]墨西哥; [or]zk;
Mid-autumn: [a]/mɪd ˈɔtəm/; [n]中秋; [or]zk;
Monday: [a]/ˈmʌndeɪ/; [n]星期一; [or]zk;
November: [a]/noʊˈvembər/; [n]十一月; [or]zk;
Oceania: [a]/ˌoʊʃiˈɑːniə/; [n]大洋洲; [or]zk;
October: [a]/ɑːkˈtoʊbər/; [n]十月; [or]zk;
Olympic: [a]/əˈlɪmpɪk/; [adj]奥林匹克运动会的; [or]zk;
Ottawa: [a]/ˈɑːtəwə/; [n]渥太华; [or]zk;
Russia: [a]/ˈrʌʃə/; [n]俄罗斯,俄国; [or]zk;
Russian: [a]/ˈrʌʃn/; [adj]俄罗斯的,俄国的,俄国人的,俄语的; [n]俄罗斯人,俄语; [or]zk;
San Francisco: [a]/sæn fræn'siskəu/; [n]旧金山(美国城市); [or]zk;
Saturday: [a]/ˈsætərdeɪ/; [n]星期六; [or]zk;
Scotland: [a]/ˈskɑːtlənd/; [n]苏格兰; [or]zk;
September: [a]/sepˈtembər/; [n]九月; [or]zk;
Sunday: [a]/ˈsʌndeɪ/; [n]星期日; [adj]星期日的; [or]zk;
Sweden: [a]/ˈswiːdn/; [n]瑞典; [or]zk;
Swedish: [a]/ˈswiːdɪʃ/; [adj]瑞典语的;瑞典人的;瑞典的; [n]瑞典语; [or]zk;
T-shirt: [a]/ˈtiː ʃɜːrt/; [n]T恤衫; [or]zk;
Thursday: [a]/ˈθɜːrzdeɪ/; [n]星期四; [or]zk;
Tokyo: [a]/ˈtəʊkɪəʊ/; [n]东京; [or]zk;
Tuesday: [a]/ˈtuːzdeɪ/; [n]星期二; [or]zk;
Turkey: [a]/ˈtɜːrki/; [n]土耳其; [or]zk;
Wednesday: [a]/ˈwenzdeɪ/; [n]星期三; [or]zk;
X-ray: [a]/ˈeks reɪ/; [n]X射线;X光照片; [v]用X射线检查; [or]zk;
abacus: [a]/ˈæbəkəs/; [n]算盘; [or]zk;
ability: [a]/əˈbɪləti/; [n]能力,技能,本领; [or]zk;
able: [a]/ˈeɪbl/; [adj]能够..的;有能力的; [or]zk;
about: [a]/əˈbaʊt/; [adv]附近,大约,转向,左右,周围; [prep]在附近,关于,在..周围,忙于; [adj]即将的,正要的,在流行中的; [or]zk;
above: [a]/əˈbʌv/; [adj]上面的,上述的,上文的; [adv]在上面,在上文; [prep]在.上方,在.之上;过于,超出,超过; [n]上面的东西,上文; [or]zk;
abroad: [a]/əˈbrɔːd/; [adv]到国外,在国外;在户外; [or]zk;
absent: [a]/ˈæbsənt/; [adj]缺席的,不在的;心不在焉的,出神的; [v]缺席;使缺席; [prep]缺乏; [or]zk;
academy: [a]/əˈkædəmi/; [n]学院; [or]zk;
accent: [a]/ˈæksent/; [n]口音,腔调;重音;重音符号; [v]重读; [or]zk;
accept: [a]/əkˈsept/; [v]接受;接受(所提供或给予的物品); [or]zk;
accident: [a]/ˈæksɪdənt/; [n]事故;意外;偶然; [or]zk;
ache: [a]/eɪk/; [n]疼痛; [v]觉得疼痛;渴望; [or]zk;
achieve: [a]/əˈtʃiːv/; [v]完成,达到,获得,实现; [or]zk;
across: [a]/əˈkrɔːs/; [prep]越过,在..的那边; [adv]横过,在对面; [or]zk;
act: [a]/ækt/; [v]行动,举止,假装,表演,扮演,充当,有效果; [n]行为,行动,法案,(戏剧,歌剧等的)一幕;假装,装出,装作; [or]zk;
action: [a]/ˈækʃn/; [n]行动,行为,动作,运转; [v]对...进行处理; [or]zk;
active: [a]/ˈæktɪv/; [adj]积极的,主动的;活跃的,好动的;起作用的,有效的;现役的; [n]积极分子;主动语态; [or]zk;
activity: [a]/ækˈtɪvəti/; [n]活动;行动;活跃; [or]zk;
add: [a]/æd/; [v](to)加,增加;补充说,又说; [n]加法,加法运算,(一篇报道的)补充部分; [or]zk;
address: [a]/əˈdres/; [n]地址;致词; [v]致函;写姓名地址;向..讲话;处理; [or]zk;
adjustable: [a]/əˈdʒʌstəbl/; [adj]可调整的; [or]zk;
advantage: [a]/ədˈvæntɪdʒ/; [v]使处于有利地位;有利于;有助于; [n]优势,利益,有利条件; [or]zk;
adventure: [a]/ədˈventʃər/; [n]冒险,冒险活动;冒险精神; [or]zk;
advertisement: [a]/ˌædvərˈtaɪzmənt/; [n]广告;公告;登广告;宣传; [or]zk;
advice: [a]/ədˈvaɪs/; [n](医生等的)意见,建议;劝告;忠告; [or]zk;
advise: [a]/ədˈvaɪz/; [v]劝告,忠告;建议;通知; [or]zk;
aeroplane: [a]/ˈerəpleɪn/; [n]飞机; [or]zk;
afford: [a]/əˈfɔːrd/; [v]买得起;抽得出时间;担负得起;提供;产生;赐予; [vi]担负得起;买得起; [or]zk;
afraid: [a]/əˈfreɪd/; [adj]害怕的,恐怕,担心的; [or]zk;
after: [a]/ˈæftər/; [prep]在.以后; [adv]后来,以后; [conj]在..之后,在..后面,模仿,与..一致,以..命名,后来的,后面的; [adj]以后的; [n]〈英俚〉正餐的最后一道食品(如点心,水果等); [or]zk;
afternoon: [a]/ˌæftərˈnuːn/; [n]午后,下午; [or]zk;
again: [a]/əˈɡen/; [adv]又,再次,此外,再一次; [or]zk;
against: [a]/əˈɡeɪnst/; [prep]对(着),逆;反对;违反;靠近,倚在;对比;映衬;以..为背景; [or]zk;
age: [a]/eɪdʒ/; [n]年龄,时代,时期; [v](使)变老,(使)陈化; [or]zk;
agent: [a]/ˈeɪdʒənt/; [n]政府特工;代理商,代理人; [or]zk;
aggressive: [a]/əˈɡresɪv/; [adj]好斗的,挑衅性的;有闯劲的,积极进取的; [or]zk;
ago: [a]/əˈɡoʊ/; [adv]以前; [or]zk;
agree: [a]/əˈɡriː/; [v]同意,赞成,承认,符合; [or]zk;
agreement: [a]/əˈɡriːmənt/; [n]协议,协定;一致,相合; [or]zk;
aim: [a]/eɪm/; [v]瞄准;以..为目标; [n]目标;对准; [or]zk;
air: [a]/er/; [n]空气;天空,空中;感觉,神态;曲调; [vi]通风; [vt]晾干;公开发表; [or]zk;
aircraft: [a]/ˈerkræft/; [n]飞机,飞行器,航空器; [or]zk;
airline: [a]/ˈerlaɪn/; [n]航空公司,航空系统,(飞机的)航线; [adj]航空公司的;在航线上的; [or]zk;
airplane: [a]/ˈerpleɪn/; [n]飞机; [or]zk;
airport: [a]/ˈerpɔːrt/; [n]机场,航空站; [or]zk;
album: [a]/ˈælbəm/; [n]相册;唱片集,专辑;集邮册; [or]zk;
algebra: [a]/ˈældʒɪbrə/; [n]代数; [or]zk;
alien: [a]/ˈeɪliən/; [n]外国人;外星人; [adj]陌生的;外国的,外星(人)的;异己的,不相容的; [or]zk;
alike: [a]/əˈlaɪk/; [adj]相同的,相似的;相像的; [adv]相像地,相似地;同样都; [or]zk;
alive: [a]/əˈlaɪv/; [adj]活着的;活跃的,有生气的;存在的; [or]zk;
allow: [a]/əˈlaʊ/; [v]准许,允许;同意给;承认; [or]zk;
almost: [a]/ˈɔːlmoʊst/; [adv]几乎,差不多;相近的; [or]zk;
alone: [a]/əˈloʊn/; [adj]单独的,独一无二的,孤独的,独自的; [adv]独自地; [or]zk;
along: [a]/əˈlɔːŋ/; [prep]沿着; [adv]向前地;一道地,一起; [or]zk;
aloud: [a]/əˈlaʊd/; [adv]出声地,大声地; [or]zk;
already: [a]/ɔːlˈredi/; [adv]已经; [or]zk;
although: [a]/ɔːlˈðoʊ/; [conj]虽然,尽管; [or]zk;
always: [a]/ˈɔːlweɪz/; [adv]总是;一直,不断地;在任何时候;毫无例外地; [or]zk;
amaze: [a]/əˈmeɪz/; [v]使惊奇,使惊诧; [or]zk;
amazing: [a]/əˈmeɪzɪŋ/; [adj]令人吃惊的,非凡的; [or]zk;
amazon: [a]/ˈæməzən/; [n]亚马逊(河);古希腊女战士; [or]zk;
among: [a]/əˈmʌŋ/; [prep]在.中间,在.之中;包括其中; [or]zk;
amusement: [a]/əˈmjuːzmənt/; [n]娱乐,消遣;乐趣; [or]zk;
ancient: [a]/ˈeɪnʃənt/; [adj]远古的,古代的,古老的; [n]古代人;古文明国的国民; [or]zk;
angel: [a]/ˈeɪndʒl/; [n]天使;可爱的人;善人,好人(感激某人时所说); [or]zk;
anger: [a]/ˈæŋɡər/; [n]怒,愤怒; [v]使发怒,激怒; [or]zk;
angry: [a]/ˈæŋɡri/; [adj]愤怒的,生气的 [sw]mangy,tangy,gangly; [or]zk;
animal: [a]/ˈænɪml/; [n]动物; [adj]动物的,本能的; [or]zk;
annoy: [a]/əˈnɔɪ/; [v]使烦恼,使生气; [n]烦恼(等于annoyance); [or]zk;
another: [a]/əˈnʌðər/; [det]另外的,又一,不同的;另一个,类似的一个,别的; [prep]另一个,另一个人,同类的东西; [or]zk;
answer: [a]/ˈænsər/; [n]答案,回答;反响,响应; [v]回答说,答复说,符合; [or]zk;
ant: [a]/ænt/; [n]蚂蚁; [or]zk;
anxious: [a]/ˈæŋkʃəs/; [adj](about)忧虑的,担心的,焦急的;渴望的; [or]zk;
anyhow: [a]/ˈenihaʊ/; [adv]不论用何种方法,无论如何;随意地;尽管如此; [or]zk;
apart: [a]/əˈpɑːrt/; [adv]相隔,相距; 分散地,分开地; [adj]分隔的,拆开的,撇开的; [or]zk;
apologize: [a]/əˈpɑːlədʒaɪz/; [v]道歉,认错; [or]zk;
apology: [a]/əˈpɑːlədʒi/; [n]道歉,(表达)歉意; [or]zk;
appear: [a]/əˈpɪr/; [v]出现,露面;显得,好像,;出版; [or]zk;
apple: [a]/ˈæpl/; [n]苹果; [or]zk;
area: [a]/ˈeriə/; [n]范围,面积,区域,空地; [or]zk;
argue: [a]/ˈɑːrɡjuː/; [v]争吵;主张,认为;提供.证据,提出证明;表明(原因等); [or]zk;
arm: [a]/ɑːrm/; [n]手臂;臂状物;武器;衣袖;海湾; [vt]供给,提供,武装,装备; [vi]准备(斗争),准备行动(against); [or]zk;
army: [a]/ˈɑːrmi/; [n]陆军,军队,大群,大军; [or]zk;
around: [a]/əˈraʊnd/; [prep]在..周围,四处; [adv]大约;周围,环绕;存在着; [or]zk;
arrive: [a]/əˈraɪv/; [v]到达;(时间等)来临;达成; [or]zk;
arrow: [a]/ˈæroʊ/; [n]箭;箭头; [or]zk;
art: [a]/ɑːrt/; [n]艺术,艺术品,技艺; [or]zk;
article: [a]/ˈɑːrtɪkl/; [n]物品;文章;条款;冠词; [or]zk;
artist: [a]/ˈɑːrtɪst/; [n]艺术家,画家; [or]zk;
ask: [a]/æsk/; [v]询问;要求;邀请; [n]要求,开价; [or]zk;
asleep: [a]/əˈsliːp/; [adj]睡着的,睡熟的; [or]zk;
assistant: [a]/əˈsɪstənt/; [n]助理,助手;售货员; [adj]助理的,辅助的; [or]zk;
attack: [a]/əˈtæk/; [n](病)发作,攻击; [v]攻击,进攻,抨击;毁坏; [or]zk;
attempt: [a]/əˈtempt/; [n]尝试;企图; [vt]努力去做;试图,尝试; [or]zk;
attend: [a]/əˈtend/; [vi]护理;照顾; [vt]出席;参加; [v]上(学); [or]zk;
attention: [a]/əˈtenʃn/; [n]专心,留心,注意,注意力,关心,体贴,礼貌; [int]立正,注意; [or]zk;
attract: [a]/əˈtrækt/; [v]吸引,引诱; [or]zk;
audience: [a]/ˈɔːdiəns/; [n](演讲,音乐会等的)听众,观众;正式会见;拥护者; [or]zk;
auditorium: [a]/ˌɔːdɪˈtɔːriəm/; [n]〈美〉讲堂;听众席; [or]zk;
aunt: [a]/ænt/; [n]小姨,姑妈,伯母,舅妈;阿姨; [or]zk;
author: [a]/ˈɔːθər/; [n]作者;发起人; [v]成为作家; [or]zk;
authority: [a]/əˈθɔːrəti/; [n]权威;威信;当局,官方;权力,职权; [or]zk;
autumn: [a]/ˈɔːtəm/; [n]秋天; [or]zk;
available: [a]/əˈveɪləbl/; [adj]可得到的,可利用的,有空的,有效的; [or]zk;
average: [a]/ˈævərɪdʒ/; [n]平均数,平均水平; [adj]通常的,一般的;平均的; [v]平均为; [or]zk;
avoid: [a]/əˈvɔɪd/; [v]躲开,避开;避免,防止; [or]zk;
awake: [a]/əˈweɪk/; [adj]醒着的,警觉的; [v]唤醒;觉醒,认识到;认识到; [or]zk;
away: [a]/əˈweɪ/; [adv]离开,远离;..掉; [adj]不在的;遥远的;<棒>出局的;客场的; [or]zk;
baby: [a]/ˈbeɪbi/; [n]宝宝;婴儿;孩子气的人; [adj]幼嫩的; [or]zk;
back: [a]/bæk/; [adj]后面的; [adv]回原处;退回; [n]背部; [v]支持;后退; [or]zk;
backache: [a]/ˈbækeɪk/; [n]背痛; [or]zk;
background: [a]/ˈbækɡraʊnd/; [n]图片背景,底色;出身;背景;时代背景; [or]zk;
bad: [a]/bæd/; [adj]坏的,恶的,错的;低劣的,拙劣的;不舒服的,病的;严重的,糟糕的; [n]坏人,坏事; [adv]非常,不好地; [or]zk;
badly: [a]/ˈbædli/; [adv]坏,恶劣地;严重地,非常; [or]zk;
bag: [a]/bæɡ/; [n]袋,包; [v]把..装进口袋; [or]zk;
bake: [a]/beɪk/; [v]烤,烘焙;烧制; [n]晒;烘烤食品; [or]zk;
bakery: [a]/ˈbeɪkəri/; [n]面包房; [or]zk;
ball: [a]/bɔːl/; [n]球;舞会; [v]使成球状; [or]zk;
balloon: [a]/bəˈluːn/; [n]气球;热气球; [v]充气;膨胀; [adj]气球般的; [or]zk;
bamboo: [a]/ˌbæmˈbuː/; [n]竹,竹子; [or]zk;
banana: [a]/bəˈnænə/; [n]香蕉;芭蕉属植物; [or]zk;
band: [a]/bænd/; [n]乐队;帮伙;带; [v]用带捆扎;联合; [or]zk;
bank: [a]/bæŋk/; [n]银行,岸,库,堤; [v]把钱存入银行,筑堤防护; [or]zk;
bark: [a]/bɑːrk/; [v]狗吠;厉声发令; [n]树皮;吠声; [or]zk;
barn: [a]/bɑːrn/; [n]谷仓,牲口棚;简陋的大房子; [or]zk;
base: [a]/beɪs/; [n]地基,基础;底座;<化>碱; [adj]卑鄙的,无耻的; [vt]以..作基础; [or]zk;
baseball: [a]/ˈbeɪsbɔːl/; [n]棒球(运动);棒球; [or]zk;
basic: [a]/ˈbeɪsɪk/; [adj]含硅少的;基本的;基础的;初级的; [n]根本;基础;<计>BASIC语言; [or]zk;
basket: [a]/ˈbæskɪt/; [n]篮,篓,筐; [v]把.装入篮内,把.丢入字纸篓里; [or]zk;
basketball: [a]/ˈbæskɪtbɔːl/; [n]篮球;篮球比赛; [or]zk;
bat: [a]/bæt/; [n]蝙蝠;球棒,球拍; [v]用球板击球;拍打(空中飞舞的小东西); [or]zk;
bath: [a]/bæθ/; [n]洗澡,沐浴,浴缸; [v]给..洗澡;洗澡; [adj]沐浴着(光线);汗流浃背;泪流满面; [or]zk;
bathing: [a]/ˈbeɪðɪŋ/; [n]沐浴;游泳;洗海水澡;洗浴; [or]zk;
bathroom: [a]/ˈbæθruːm/; [n]浴室;盥洗室; [or]zk;
beach: [a]/biːtʃ/; [n]海滩,河滩; [v]把..拖上岸,使(船)靠岸; [or]zk;
bear: [a]/ber/; [n]熊;(股市)看跌的人; [v]容忍,忍受;承担;带有;生育;开花结果,结(果实); [or]zk;
beat: [a]/biːt/; [v]敲打;打败;打;(心脏)跳动;搅拌; [n]敲打;拍子; [adj]精疲力竭的,疲惫不堪的;垮掉的,属于"垮掉的一代"的; [or]zk;
beautiful: [a]/ˈbjuːtɪfl/; [adj]美丽的,美好的,极好的;出色的; [or]zk;
because: [a]/bɪˈkɔːz/; [conj]因为; [or]zk;
become: [a]/bɪˈkʌm/; [v]成为,开始变得,变成;适合,适宜;相称; [or]zk;
bed: [a]/bed/; [n]床,床位;圃;河床; [vt]把..固定在;(某人)发生性关系;给人铺床; [vi]上床;分层; [or]zk;
bedroom: [a]/ˈbedruːm/; [n]卧室; [adj]两性关系的; [or]zk;
bee: [a]/biː/; [n]蜜蜂;忙碌的人; [or]zk;
beef: [a]/biːf/; [n]牛肉; [v]抱怨; [or]zk;
beeper: [a]/ˈbiːpər/; [n]BP机;能发出哔哔声音的仪器;导弹遥控员; [or]zk;
beer: [a]/bɪr/; [n]啤酒; [or]zk;
before: [a]/bɪˈfɔːr/; [prep]在..以前(时间);在..前面(空间); [adv]以前; [conj]在..之前(时间); [or]zk;
beg: [a]/beɡ/; [v]乞求,恳求;乞讨; [or]zk;
beggar: [a]/ˈbeɡər/; [n]乞丐; [v]使贫穷; [or]zk;
begin: [a]/bɪˈɡɪn/; [v]开始; [or]zk;
behave: [a]/bɪˈheɪv/; [v]举动;举止端正(或良好,适当); [or]zk;
behavior: [a]/bɪ'heɪvjə/; [n]行为;举止;态度; [or]zk;
behind: [a]/bɪˈhaɪnd/; [prep]在..后面;迟于..,落后于;基于;追赶; [n]<口语>屁股; [adv]在后面地,落后地,迟,不如; [or]zk;
believe: [a]/bɪˈliːv/; [v]相信;认为; [or]zk;
bell: [a]/bel/; [n]钟,铃,门铃;钟声; [or]zk;
belong: [a]/bɪˈlɔːŋ/; [v]属于,附属;归属; [or]zk;
below: [a]/bɪˈloʊ/; [prep]在.之下,低于; [adv]在下面,向下,在零下; [n]下面; [or]zk;
beneath: [a]/bɪˈniːθ/; [prep]在..下方;低于; [adv]在下方; [or]zk;
beside: [a]/bɪˈsaɪd/; [prep]在.旁边;与.相比; [or]zk;
besides: [a]/bɪˈsaɪdz/; [prep]除..之外; [adv]而且,还有; [or]zk;
best-seller: [a]/ˌbest'selər/; [n]畅销书; [or]zk;
best: [a]/best/; [adj]最好的,最优的; [v]打败,胜过; [or]zk;
between: [a]/bɪˈtwiːn/; [prep]在..中间; [adv]在中间; [or]zk;
beyond: [a]/bɪˈjɑːnd/; [adv]更远处,更多,以后; [prep]超过;在能力,理解力之外;除..之外; [or]zk;
big: [a]/bɪɡ/; [adj]大的,巨大的; [adv]大大,给人印象深地; [n]大亨,大公司; [or]zk;
bike: [a]/baɪk/; [n]自行车; [v]骑自行车; [or]zk;
bill: [a]/bɪl/; [n]账单;纸币,钞票;议案,法案;广告;鸟嘴; [v]给..开账单; [or]zk;
billion: [a]/ˈbɪljən/; [num]十亿,万亿;万亿,一万亿;大量,无数; [adj]大量的; [or]zk;
biology: [a]/baɪˈɑːlədʒi/; [n]生物学;生物;生命周期; [or]zk;
bird: [a]/bɜːrd/; [n]鸟,禽;家伙; [v]观察研究野鸟; [or]zk;
birth: [a]/bɜːrθ/; [n]分娩,出生;出身;创始; [or]zk;
birthday: [a]/ˈbɜːrθdeɪ/; [n]生日,诞生的日期; [or]zk;
biscuit: [a]/ˈbɪskɪt/; [n]饼干;软饼;褐色; [or]zk;
bit: [a]/bɪt/; [n]少量,小片;比特; [or]zk;
bitter: [a]/ˈbɪtər/; [adj](有)苦(味)的;痛苦的;厉害的;严寒的;痛苦的,尖刻的,充满仇恨的; [v]使变苦; [n]苦;苦味物;苦啤酒;<航>系缆柱上的一圈缆索; [or]zk;
black: [a]/blæk/; [adj]黑色的;黑暗的; [n]黑人,黑色; [v](使)变黑;把(眼睛)打得发青;拒绝; [or]zk;
blackboard: [a]/ˈblækbɔːrd/; [n]黑板; [or]zk;
blank: [a]/blæŋk/; [adj](纸等)空白的,茫然的; [n]空白,空白处; [v]忽视; [or]zk;
bleat: [a]/bliːt/; [v]咩咩叫;胡扯;抱怨; [n]咩咩叫声; [or]zk;
bless: [a]/bles/; [v]保佑,祝福,赐福,有幸具有; [or]zk;
blind: [a]/blaɪnd/; [adj]瞎的,盲目的; [v]使失明;蒙蔽; [n]盲点,百叶窗; [adv]盲目地; [or]zk;
block: [a]/blɑːk/; [v]阻挡;妨碍;阻塞; [n]街区;块状物;积木;阻碍;大厦; [or]zk;
blood: [a]/blʌd/; [n]血(液);血统,宗族,门第; [v]抽血; [or]zk;
blow: [a]/bloʊ/; [v]吹,吹动,吹气;吹响;打击,殴打;爆炸; [n]打击,殴打; [or]zk;
blue: [a]/bluː/; [adj]蓝色的;忧郁的; [n]蓝色; [or]zk;
board: [a]/bɔːrd/; [n]木板;董事会;甲板;膳食; [v]乘船,登机;用板铺;供膳食;寄宿; [or]zk;
boat: [a]/boʊt/; [n]小船,艇; [vi]乘船; [vt]用船运输; [or]zk;
body: [a]/ˈbɑːdi/; [n]身体;主体;尸体; [or]zk;
boil: [a]/bɔɪl/; [v]烧开,沸腾;用开水煮,在沸水中煮; [n]煮沸,沸腾;疔,疖子;<医>疡肿,脓肿; [or]zk;
book: [a]/bʊk/; [n]书,书籍; [v]预订;预约; [or]zk;
bookmark: [a]/ˈbʊkmɑːrk/; [n]书签; [or]zk;
bookseller: [a]/ˈbʊkselər/; [n]书商;售书员; [or]zk;
bookshop: [a]/ˈbʊkʃɑːp/; [n]书店; [or]zk;
boot: [a]/buːt/; [n](长筒)靴;箱子,行李箱;解雇; [v]踢;启动; [or]zk;
boring: [a]/ˈbɔːrɪŋ/; [adj]令人厌烦的;单调的;无聊的,乏味的; [or]zk;
born: [a]/bɔːrn/; [v]出世; [adj]天生的; [or]zk;
borrow: [a]/ˈbɑːroʊ/; [vt]借,借入;借用; [or]zk;
boss: [a]/bɔːs/; [n]老板,上司; [vt]指挥; [vi]当首领,发号施令; [adj]<俚>很好的,一流的; [or]zk;
both: [a]/boʊθ/; [pron]两者(都); [conj]既.且.; [det]两个的;两者的;并;又;两者皆; [or]zk;
bottle: [a]/ˈbɑːtl/; [n]瓶(子); [v]装瓶;抑制,约束,遏制,控制; [or]zk;
bottom: [a]/ˈbɑːtəm/; [n]底部;尽头;末端;臀部;水底; [adj]底部的; [v]触底; [or]zk;
bowl: [a]/boʊl/; [n]碗;保龄球戏; [vi]参加保龄球赛;<体>投球;<体>玩滚木球;稳而快地行驶; [vt]投掷或滚动(球);滚球得分;表演保龄球;打倒;撞击; [or]zk;
box: [a]/bɑːks/; [n]盒子,箱子; [v]拳击; [or]zk;
boxer: [a]/ˈbɑːksər/; [n]拳师;拳击手;拳师狗; [or]zk;
boxing: [a]/ˈbɑːksɪŋ/; [n]拳击;盒式包装,制箱材料; [or]zk;
boy: [a]/bɔɪ/; [n]男孩;少年;小家伙; [int]表示惊奇,高兴,痛苦等; [or]zk;
boyfriend: [a]/ˈbɔɪfrend/; [n]男朋友,情郎; [or]zk;
boyhood: [a]/ˈbɔɪhʊd/; [n]童年,少年时代;男孩们; [or]zk;
brain: [a]/breɪn/; [n]脑,脑髓;脑力,头脑,智力; [v]猛击头部; [or]zk;
brave: [a]/breɪv/; [adj]勇敢的;崭新的; [v]勇敢面对;不怕,不顾; [n]勇士;美洲印第安武士; [or]zk;
bread: [a]/bred/; [n]面包;食物;粮食; [vt]在..上撒面包屑; [or]zk;
break: [a]/breɪk/; [n]中断;破裂处;休息; [vt]打破,弄破;(使)破,裂,碎;中断;违犯;背弃;把...换成零钱;找开; [vi]破晓;(风暴)开始; [or]zk;
breakfast: [a]/ˈbrekfəst/; [n]早饭,早餐; [v]吃早饭; [or]zk;
breath: [a]/breθ/; [n]呼吸;气息;气味; [or]zk;
breathe: [a]/briːð/; [vi]呼吸; [vt]呼吸; [or]zk;
bridge: [a]/brɪdʒ/; [n]桥,桥梁;起联系作用的东西,纽带; [v]把..连结起来;缩短距离;架桥; [or]zk;
bright: [a]/braɪt/; [adj]明亮的,聪明的,欢快的; [adv]光亮地;明亮地; [n]头灯; [or]zk;
bring: [a]/brɪŋ/; [vt]带来,引起,劝诱; [v]产生;促使; [or]zk;
brochure: [a]/broʊˈʃʊr/; [n]手册,小册子; [or]zk;
broken: [a]/ˈbroʊkən/; [adj]坏掉的,破裂的,破碎(了)的; [or]zk;
broom: [a]/bruːm/; [n]扫帚;金雀花; [or]zk;
brother: [a]/ˈbrʌðər/; [n]兄弟;同事;同胞; [int]表示生气或吃惊; [v]和..结成弟兄; [or]zk;
brown: [a]/braʊn/; [n]褐色,棕色; [adj]褐色的,棕色的; [v](使)变褐色; [or]zk;
brush: [a]/brʌʃ/; [vi]刷牙;刷;掠过; [vt]刷;涂;写,画;拭去;掠过; [n]画笔;毛笔;刷子;刷状物;小冲突; [or]zk;
build: [a]/bɪld/; [v]逐步增强;建造;建立; [n]构造;体形;体格; [or]zk;
building: [a]/ˈbɪldɪŋ/; [n]建筑物,大楼;建筑; [or]zk;
burn: [a]/bɜːrn/; [v]烧,燃烧; [n]烧伤; [or]zk;
bury: [a]/ˈberi/; [v]埋葬;隐藏,埋藏;埋头于;抛开; [or]zk;
bus: [a]/bʌs/; [n]公共汽车; [v]用公共汽车运送; [or]zk;
bush: [a]/bʊʃ/; [n]灌木;灌木丛;矮树; [vi]丛生;灌木般丛生;浓密(或茂密)地生长;生密枝; [vt]加(金属)衬套于;加套管于;用耙耙平(耕地);以灌木(或灌木丛)装饰(或覆盖,围绕,围住,支撑,标志,保护等); [adj](豆科植物等)如灌木般长得低矮的;粗野的;粗鲁的;粗糙但实用的; [or]zk;
business: [a]/ˈbɪznəs/; [n]商业,生意;事务; [or]zk;
businessman: [a]/ˈbɪznəsmæn/; [n]商人; [or]zk;
busy: [a]/ˈbɪzi/; [adj]忙的,忙碌的,正被占用的; [v]使忙于; [n]包打听; [or]zk;
butter: [a]/ˈbʌtər/; [n]黄油;奉承话; [vt]涂黄油于.上,用黄油烹调;讨好; [or]zk;
butterfly: [a]/ˈbʌtərflaɪ/; [n]蝴蝶; [vt](烹饪时把鱼肉等)切开摊平; [or]zk;
button: [a]/ˈbʌtn/; [n]纽扣;按钮(开关); [v]扣紧;扣上纽扣; [or]zk;
buy: [a]/baɪ/; [v]买;收买; [n]所购的物品; [or]zk;
bye: [a]/baɪ/; [int]再见[n]轮空; [or]zk;
cabbage: [a]/ˈkæbɪdʒ/; [n]洋白菜,卷心菜; [or]zk;
cafe: [a]/kæˈfeɪ/; [n]咖啡馆,餐馆; [or]zk;
cage: [a]/keɪdʒ/; [n]笼;鸟笼;囚笼; [v]关进(笼子); [or]zk;
cake: [a]/keɪk/; [n]蛋糕,饼,糕; [v](使)结块;(使)胶;涂厚厚的一层; [or]zk;
call: [a]/kɔːl/; [v]把.叫做;叫,喊;打电话给.; [n]通话,打电话; [or]zk;
camel: [a]/ˈkæml/; [n]骆驼,浮船箱,驼色; [or]zk;
camera: [a]/ˈkæmərə/; [n]照相机,摄影机; [or]zk;
camp: [a]/kæmp/; [v]露营; [n]野营;帐篷;阵营; [or]zk;
cancel: [a]/ˈkænsl/; [v]取消;撤消;删去; [or]zk;
cancer: [a]/ˈkænsər/; [n]癌,癌症;迅速蔓延的恶劣的或危险的事物; [or]zk;
candle: [a]/ˈkændl/; [n]蜡烛; [or]zk;
candy: [a]/ˈkændi/; [n]糖果; [vt](用糖煮过以)保存;使结晶为砂糖; [adj]〈美俚〉(服饰)花哨的;甜言蜜语的; [or]zk;
cannon: [a]/ˈkænən/; [n]大炮;机关炮; [v]相撞;开炮; [or]zk;
canoe: [a]/kəˈnuː/; [n]独木舟,轻舟; [v]乘独木舟; [or]zk;
canteen: [a]/kænˈtiːn/; [n]食堂,小卖部;水壶; [or]zk;
cap: [a]/kæp/; [n]帽子; [v]覆盖;给..定限额; [or]zk;
capital: [a]/ˈkæpɪtl/; [n]资金,资本;首都;大写(字母); [adj]大写的;资本的;优秀的;处以死刑的;致命的; [or]zk;
captain: [a]/ˈkæptɪn/; [n]船长,机长;上校,上尉;队长;领袖;消防中队长; [vt]做..的首领; [or]zk;
car: [a]/kɑːr/; [n]汽车,小汽车,轿车;车厢; [or]zk;
card: [a]/kɑːrd/; [n]卡,卡片,名片; [v](纺纱前纤维)梳理,梳,刷;把..记入卡片,把..制成卡片; [or]zk;
care: [a]/ker/; [n]小心;照顾; [v]介意;关心; [or]zk;
careful: [a]/ˈkerfl/; [adj]仔细的,小心的;细心的;精心的; [or]zk;
careless: [a]/ˈkerləs/; [adj]粗心的,漫不经心的; [or]zk;
carpenter: [a]/ˈkɑːrpəntər/; [n]木匠;木工; [or]zk;
carpet: [a]/ˈkɑːrpɪt/; [n]地毯; [v]铺以地毯; [or]zk;
carrot: [a]/ˈkærət/; [n]胡萝卜; [or]zk;
carry: [a]/ˈkæri/; [vt]携带(疾病,病菌);运载;传送; [vi]扔(或踢)到.距离;(马等)具有某种姿势;(声音)传得很远; [v](报纸,海报)登载,刊登,印有;使提案通过,赞成;具有,带有(特点,后果等); [n](枪炮,火箭等的)射程;运输,运送; [or]zk;
cartoon: [a]/kɑːrˈtuːn/; [n]卡通(片),动画片;(尤指报刊上讽刺政客或时事的)漫画,幽默画; [or]zk;
case: [a]/keɪs/; [n]箱子,盒;案例,例子,情况; [v]装箱,踩点,仔细检查; [or]zk;
cat: [a]/kæt/; [n]猫;猫科动物; [or]zk;
catch: [a]/kætʃ/; [v]捕捉,接住;赶上;噎住; [n]陷阱,圈套,诡计;料不到的困难;接球; [or]zk;
cattle: [a]/ˈkætl/; [n](总称)牛,牲口; [or]zk;
cause: [a]/kɔːz/; [v]引起,使发生; [n]原因,理由;事业;目标; [or]zk;
ceiling: [a]/ˈsiːlɪŋ/; [n]天花板;屋顶; [or]zk;
celebrate: [a]/ˈselɪbreɪt/; [v]庆祝;主持 (宗教仪式);赞美; [or]zk;
celebration: [a]/ˌselɪˈbreɪʃn/; [n]庆典,庆祝; [or]zk;
cent: [a]/sent/; [n]分;分币; [or]zk;
center: [a]/ˈsentər/; [n]中央,中心; [v]集中;居中; [or]zk;
central: [a]/ˈsentrəl/; [adj]中心的;主要的; [or]zk;
century: [a]/ˈsentʃəri/; [n]世纪;百年; [or]zk;
ceremony: [a]/ˈserəmoʊni/; [n]典礼,仪式;礼节; [or]zk;
certain: [a]/ˈsɜːrtn/; [adj]有把握的;肯定的,必然的;某个,特定的; [pron]某些,某几个; [or]zk;
certainly: [a]/ˈsɜːrtnli/; [adv]无疑,确定;当然,没问题(用于回答); [or]zk;
chain: [a]/tʃeɪn/; [v]束缚;用链条拴住; [n]链;链条;项圈;连锁;一系列; [or]zk;
chair: [a]/tʃer/; [n]椅子;主席(职位);大学教授; [v]担任主席; [or]zk;
chairman: [a]/ˈtʃermən/; [n]主席;议长,会长,董事长; [or]zk;
chairwoman: [a]/ˈtʃerwʊmən/; [n]女主席,女会长,女议长; [or]zk;
chalk: [a]/tʃɔːk/; [n]粉笔,白垩; [vt]用粉笔写; [adj]用粉笔写的; [or]zk;
challenge: [a]/ˈtʃælɪndʒ/; [n]挑战;质疑; [v]挑战;质疑; [or]zk;
chance: [a]/tʃæns/; [n]机会;偶发事件;可能性;几率; [vi]偶然发生; [adj]偶然的; [vt]冒.的险; [or]zk;
change: [a]/tʃeɪndʒ/; [n]改变,变化;零钱; [v]兑换; [vi]变化; [vt]改变; [or]zk;
channel: [a]/ˈtʃænl/; [n]频道;渠道,方法;海峡; [v]引导;经沟槽输送; [or]zk;
chant: [a]/tʃænt/; [v]吟唱;诵扬; [n]圣歌;赞美诗;旋律; [or]zk;
chapter: [a]/ˈtʃæptər/; [n]章,回,篇;时期; [or]zk;
character: [a]/ˈkærəktər/; [n]人物,角色;性格;(书写或印刷)符号,(汉)字;特点;人格,品性; [or]zk;
charge: [a]/tʃɑːrdʒ/; [v]充电,充值;索价;控告;向.冲去; [n]费用;主管;控告; [or]zk;
chart: [a]/tʃɑːrt/; [n]图表,表格;航海图;每周排行榜; [v]制成图表;制航海图; [or]zk;
cheap: [a]/tʃiːp/; [adj]便宜的;低劣的,不值钱的; [adv]便宜地,卑鄙地; [or]zk;
cheat: [a]/tʃiːt/; [v]欺骗,哄骗,蒙骗;作弊; [n]欺骗,作弊;骗子,骗术; [or]zk;
check: [a]/tʃek/; [v]检查;阻止; [n]支票;阻止;检查;阻止物; [or]zk;
cheek: [a]/tʃiːk/; [n]面颊,脸蛋; [vt]<口语>无礼地说; [or]zk;
cheer: [a]/tʃɪr/; [v]鼓劲,使振作;欢呼; [n]鼓励,振奋; [or]zk;
cheese: [a]/tʃiːz/; [n]乳酪,干酪; [vt]〈俚〉停止; [or]zk;
chemist: [a]/ˈkemɪst/; [n]化学家;(英)药剂师; [or]zk;
chemistry: [a]/ˈkemɪstri/; [n]化学; [or]zk;
chess: [a]/tʃes/; [n]棋;国际象棋; [or]zk;
chest: [a]/tʃest/; [n]胸膛;箱子; [or]zk;
chick: [a]/tʃɪk/; [n]小鸡;小鸟;<美俚>少妇; [adj]胆小的;懦弱的; [or]zk;
chicken: [a]/ˈtʃɪkɪn/; [n]鸡;鸡肉;胆小者; [vi]畏缩不前; [adj]胆小的; [or]zk;
chief: [a]/tʃiːf/; [n]老板,头子;主管;(部落) 首领;酋长;长官; [adj]主要的;首席的; [or]zk;
child: [a]/tʃaɪld/; [n]小孩,儿童;子女; [or]zk;
childhood: [a]/ˈtʃaɪldhʊd/; [n]童年,幼年; [or]zk;
chimney: [a]/ˈtʃɪmni/; [n]烟囱; [or]zk;
chips: [a]/tʃɪps/; [n](pl.)炸土豆条(片); [or]zk;
chocolate: [a]/ˈtʃɑːklət/; [n]巧克力;赭色;巧克力糖;巧克力饮料; [or]zk;
choice: [a]/tʃɔɪs/; [n]选择(机会),抉择;选项;精华; [adj](食物)精选的,上等的,优等的; [or]zk;
choose: [a]/tʃuːz/; [v]选择,挑选; [or]zk;
chopsticks: [a]/ˈtʃɑːpstɪks/; [n]筷子; [or]zk;
church: [a]/tʃɜːrtʃ/; [n]教堂; [or]zk;
cigar: [a]/sɪˈɡɑːr/; [n]雪茄烟; [or]zk;
cigarette: [a]/ˈsɪɡəret/; [n]香烟,纸烟,卷烟; [or]zk;
cinema: [a]/ˈsɪnəmə/; [n]电影院;电影,影片; [or]zk;
circle: [a]/ˈsɜːrkl/; [n]周期;范围;圆圈; [v]围绕; [or]zk;
city: [a]/ˈsɪti/; [n]城市,都市; [or]zk;
clap: [a]/klæp/; [v]拍(手),鼓(掌);轻拍,轻敲;砰然出声,啪地关上,发出噼啪声; [n]轻拍(以示热情招呼),拍手(喝彩),鼓掌(欢迎),善意的拍打;霹雳声,破裂声,噼啪声,突然的爆炸声,砰然巨响; [or]zk;
class: [a]/klæs/; [n]课,上课;种类,门类;阶级,社会等级,阶层,等级制度;班级,同届学生;等级,级别,舱位等级; [v]把..分组,分组,分班;把..归入某等级; [or]zk;
classmate: [a]/ˈklæsmeɪt/; [n]同班同学; [or]zk;
classroom: [a]/ˈklæsruːm/; [n]教室,课堂; [or]zk;
claw: [a]/klɔː/; [n]爪,钳;(某些节肢动物的),钳; [v]抓,挖; [vi]抓,挖; [or]zk;
clean: [a]/kliːn/; [n]打扫,清洁; [adj]干净的; [v]打扫,清洁; [ex]~ the house; [sw]glean,clan,cleanse; [or]zk;
cleaner: [a]/ˈkliːnər/; [n]清洁工;干洗店; [or]zk;
clear: [a]/klɪr/; [adj]清澈的;显然的;容易看见的,清楚的,清晰的;没有的; [vi]变明朗;变清澈; [vt]扫净;清除;消除; [n]空隙;空间; [adv]清晰地;整整;完全; [or]zk;
clerk: [a]/klɜːrk/; [n]店员;职员;办事员; [vi]当职员; [or]zk;
clever: [a]/ˈklevər/; [adj]聪明的;机智的,熟练的; [or]zk;
click: [a]/klɪk/; [v]点击(鼠标);(使)发出咔哒声;情投意合;博得喝彩; [n]咔哒声,点击; [or]zk;
climate: [a]/ˈklaɪmət/; [n]气候;(社会思想等)趋势; [or]zk;
climb: [a]/klaɪm/; [v]攀登,爬,上升; [n]爬,攀爬处; [or]zk;
clinic: [a]/ˈklɪnɪk/; [n]诊所;门诊(部,室); [or]zk;
clock: [a]/klɑːk/; [n]钟,仪表; [v]测时间,为..计时; [or]zk;
clone: [a]/kloʊn/; [n]克隆;无性繁殖系个体;复制品; [v]复制;克隆; [or]zk;
close: [a]/kloʊz/; [v]关闭; [n]结束,(私人)围地; [adj]关闭着的,密闭的,严丝合缝的;严密的;亲密的,相似的; [adv](时间/距离)接近地; [or]zk;
closed: [a]/kloʊzd/; [adj]关着的;不公开的; [v]关;结束;接近; [or]zk;
cloth: [a]/klɔːθ/; [n]布;衣料;桌布; [or]zk;
clothes: [a]/kloʊðz/; [n]衣服,服装; [or]zk;
clothing: [a]/ˈkloʊðɪŋ/; [n]衣服;被褥; [or]zk;
cloud: [a]/klaʊd/; [n]云;云状物;阴影; [v]使混浊,使混乱,搅浑(问题),混淆;在(心)上投下苦恼的暗影,使心情黯然,使不快;覆盖,遮蔽;使阴暗,使变黑暗; [or]zk;
cloudiness: [a]/ˈklaʊdinəs/; [n]阴沉;暗晦;朦胧; [or]zk;
cloudy: [a]/ˈklaʊdi/; [adj]多云的;混浊的; [or]zk;
club: [a]/klʌb/; [n]俱乐部,夜总会,球棒; [v]用棍棒打; [or]zk;
coach: [a]/koʊtʃ/; [n]四轮大马车;教练;长途汽车; [v]训练,指导; [or]zk;
coal: [a]/koʊl/; [n]煤,煤块; [or]zk;
coast: [a]/koʊst/; [n]海岸,湖岸; [v]一帆风顺,沿海航行; [or]zk;
coat: [a]/koʊt/; [n]外套,上衣;表皮; [vt]涂上;覆盖;包上; [or]zk;
cock: [a]/kɑːk/; [n]公鸡;雄鸟;龙头;首领;架子十足的人; [vt]使某物竖起;使某物倾斜;使朝上;扳上扳机; [vi]翘起,竖起;大摇大摆; [or]zk;
code: [a]/koʊd/; [n]编码,代码;准则,法典;密码; [v]将.编码; [or]zk;
coffee: [a]/ˈkɔːfi/; [n]咖啡;咖啡豆;咖啡色; [or]zk;
coin: [a]/kɔɪn/; [n]硬币; [v]铸造(硬币);创造; [adj]硬币的;投币的; [or]zk;
coke: [a]/koʊk/; [n]可乐;焦炭; [or]zk;
cold: [a]/koʊld/; [adj]寒冷的;阴冷的;冷漠的; [n]寒冷; [or]zk;
collar: [a]/ˈkɑːlər/; [n]项圈,衣领,<机>轴环; [v]抓住,为..戴上项圈,为..上领子; [or]zk;
collect: [a]/kəˈlekt/; [v]收集;领取;聚集;募捐; [adj]接收者付费的; [adv]接收者付费地; [or]zk;
college: [a]/ˈkɑːlɪdʒ/; [n]学院,高等专科学校;大学; [or]zk;
color: [a]/ˈkʌlər/; [n]颜色;颜料;肤色; [v]上颜色;(观念等)受..影响;脸红; [or]zk;
colorful: [a]/ˈkʌlərfl/; [adj]多彩的,华美的,色彩的,有趣的; [or]zk;
comb: [a]/koʊm/; [v]梳理; [n]梳子;梳理; [or]zk;
come: [a]/kʌm/; [v]来,来到;(想法,主意或记忆等) 突然出现;源自,来自; [int]得啦; [prep](提及的时间)到来; [or]zk;
comfort: [a]/ˈkʌmfərt/; [n]舒适;安慰; [v]安慰;使舒适; [or]zk;
comfortable: [a]/ˈkʌmfərtəbl/; [adj]舒适的,安慰的; [n]绒线围巾;〈美〉鸭绒被; [or]zk;
common: [a]/ˈkɑːmən/; [adj]普通的;共同的; [n]公地;平民;普通;公园; [or]zk;
communicate: [a]/kəˈmjuːnɪkeɪt/; [v]沟通,交流;传达,传递;传染;相连,相通;显露; [or]zk;
communication: [a]/kəˌmjuːnɪˈkeɪʃn/; [n]沟通方式;交流,通讯;信息; [or]zk;
communist: [a]/ˈkɑːmjənɪst/; [adj]共产主义的; [n]共产主义者,共产党员; [or]zk;
companion: [a]/kəmˈpæniən/; [n]同伴,志同道合的人;参考书; [or]zk;
company: [a]/ˈkʌmpəni/; [n]公司;交往;陪伴; [v]陪伴; [or]zk;
compare: [a]/kəmˈper/; [v]比较,比作; [n]比较;对照; [or]zk;
competition: [a]/ˌkɑːmpəˈtɪʃn/; [n]比赛;竞争;竞争者; [or]zk;
competitor: [a]/kəmˈpetɪtər/; [n]竞争对手,参赛者; [or]zk;
complain: [a]/kəmˈpleɪn/; [v]抱怨;诉苦;申诉;控诉;诉说;控告; [vt]申诉; [n]抱怨,诉苦; [or]zk;
complete: [a]/kəmˈpliːt/; [adj]完整的;完成的; [v]完成;使完整; [or]zk;
completely: [a]/kəmˈpliːtli/; [adv]完整地,彻底地; [or]zk;
composition: [a]/ˌkɑːmpəˈzɪʃn/; [n]构成;作文;(文章或音乐的)创作;成分; [or]zk;
computer: [a]/kəmˈpjuːtər/; [n]计算机,电脑;计算者; [or]zk;
comrade: [a]/ˈkɑːmræd/; [n]同伴;同志;战友; [or]zk;
concert: [a]/ˈkɑːnsərt/; [n]音乐会;一致;和谐,合作; [or]zk;
condition: [a]/kənˈdɪʃn/; [n]状况,状态;疾病,症状;环境,形势,条件; [v]使适应,使处于良好状态; [or]zk;
conductor: [a]/kənˈdʌktər/; [n]售票员;指挥;导体; [or]zk;
conference: [a]/ˈkɑːnfərəns/; [n]会议;讨论会; [or]zk;
confidence: [a]/ˈkɑːnfɪdəns/; [n]自信,信心 [sw]confluence; [or]zk;
confident: [a]/ˈkɑːnfɪdənt/; [adj]自信的;确信的,深信的; [or]zk;
congratulate: [a]/kənˈɡrætʃuleɪt/; [v]祝贺,向..致贺词; [or]zk;
congratulation: [a]/kənˌɡrætʃuˈleɪʃn/; [n]祝贺;祝贺信; [or]zk;
connect: [a]/kəˈnekt/; [v]连接;联想;使有联系; [or]zk;
consider: [a]/kənˈsɪdər/; [v]考虑,细想;认为,觉得; [or]zk;
constant: [a]/ˈkɑːnstənt/; [adj]不变的,始终如一的;持续不断的; [n]常数,恒量; [or]zk;
contain: [a]/kənˈteɪn/; [vt]包含,容纳; [vi]自制,抑制,克制; [or]zk;
content: [a]/ˈkɑːntent/; [n]内容,目录;满足; [adj]满足的; [v]使满意; [or]zk;
continent: [a]/ˈkɑːntɪnənt/; [n]大陆,洲; [adj]克制的,禁欲的; [or]zk;
continue: [a]/kənˈtɪnjuː/; [v]继续; [or]zk;
contribution: [a]/ˌkɑːntrɪˈbjuːʃn/; [n]贡献,投稿稿件,捐献物; [or]zk;
control: [a]/kənˈtroʊl/; [n]控制;对照实验;控制装置; [vt]控制,管理; [or]zk;
convenient: [a]/kənˈviːniənt/; [adj]方便的;便利的; [or]zk;
conversation: [a]/ˌkɑːnvərˈseɪʃn/; [n]会话,谈话; [or]zk;
cook: [a]/kʊk/; [n]厨师; [v]烹饪; [vi]烹调,煮,烧; [or]zk;
cooker: [a]/ˈkʊkər/; [n]炉灶; [or]zk;
cookie: [a]/ˈkʊki/; [n](英)甜面包;(美)小甜饼;饼干;<计>不经使用者的认可就由伺服器电脑直接写入使用者硬碟中的小型文字档案; [or]zk;
cool: [a]/kuːl/; [adj]凉的,冷静的,极好的,绝妙的,"酷"; [v](使)冷却,(使)镇静; [n]凉气,凉快的地方;凉爽,凉爽的空气; [or]zk;
copy: [a]/ˈkɑːpi/; [v]抄写,复制,复印; [n]副本,拷贝; [or]zk;
coral: [a]/ˈkɔːrəl/; [n]珊瑚; [or]zk;
corn: [a]/kɔːrn/; [n]玉米;谷物,谷粒; [v]形成(颗粒状);腌;(用谷物)喂; [or]zk;
corner: [a]/ˈkɔːrnər/; [n]角落;拐角;困境; [v]将..逼入困境; [or]zk;
correct: [a]/kəˈrekt/; [adj]正确的;恰当的,合适的; [v]改正,纠正;矫正;批改; [or]zk;
correction: [a]/kəˈrekʃn/; [n]改正,修正;更正; [or]zk;
cost: [a]/kɔːst/; [n]价格,成本;花费; [vi]花费;需要付出高昂代价; [vt]估算..的费用;使付出; [or]zk;
cottage: [a]/ˈkɑːtɪdʒ/; [n]村舍,小屋;小房子; [or]zk;
cotton: [a]/ˈkɑːtn/; [n]棉花,棉线,棉布; [or]zk;
cough: [a]/kɔːf/; [v]咳嗽; [n]咳嗽; [or]zk;
count: [a]/kaʊnt/; [v]计算;认为;看作;重要,有价值;依赖; [n]计数;总数;计算; [or]zk;
country: [a]/ˈkʌntri/; [n]国家;乡村; [or]zk;
countryside: [a]/ˈkʌntrisaɪd/; [n]乡村,郊野; [or]zk;
couple: [a]/ˈkʌpl/; [n]夫妇;(一)对;几个; [v]配对,连接,结合; [or]zk;
courage: [a]/ˈkɜːrɪdʒ/; [n]勇气,胆量,胆识; [or]zk;
course: [a]/kɔːrs/; [n]发展;进程,课程,一道菜; [v]跑过,穿过;追赶; [or]zk;
court: [a]/kɔːrt/; [n]法院,法庭;庭院;球场;宫廷; [v]讨好,取悦;招致危险;追求; [or]zk;
courtyard: [a]/ˈkɔːrtjɑːrd/; [n]庭院,院子; [add]pl/courtyards; [sw]courtroom,courtly; [or]zk;
cousin: [a]/ˈkʌzn/; [n]堂(或表)兄弟(姐妹);远亲; [or]zk;
cover: [a]/ˈkʌvər/; [v]报道,采访;足以支付,够付; [n]盖子;封面; [vt]盖住;包括,掩护;通过; [or]zk;
cow: [a]/kaʊ/; [n]母牛,奶牛;母兽; [v]恐吓,吓倒; [or]zk;
crash: [a]/kræʃ/; [n]碰撞,坠落,轰隆声; [v]碰撞,坠落,崩溃; adj.紧急的; [add]pl/crashes,s3/crashes,pr/crashing,pt/crashed,pp/crashed; [sw]crass,brash,rash,clash; [or]zk;
crayon: [a]/ˈkreɪən/; [n]蜡笔,彩色粉笔; [v]以蜡笔作画,用彩色粉笔画; [or]zk;
crazy: [a]/ˈkreɪzi/; [adj]疯狂的,荒唐的;狂热的,迷恋的;生气的,气愤的; [n]荒唐的人; [adv]疯狂地; [or]zk;
cream: [a]/kriːm/; [n]面霜;奶油,乳脂;奶油色;精英; [v]凝成乳脂,起泡沫; [or]zk;
create: [a]/kriˈeɪt/; [v]创造;引起,产生; [or]zk;
creature: [a]/ˈkriːtʃər/; [n]人;生物;动物;工具; [or]zk;
credit: [a]/ˈkredɪt/; [n]信用;荣誉;学分;信贷;称赞;债权; [v]信赖;归因于;记学分; [or]zk;
criminal: [a]/ˈkrɪmɪnl/; [n]罪犯; [adj]犯罪的,违法的,刑法的;可耻的; [or]zk;
crop: [a]/krɑːp/; [n]作物,庄稼;(谷类等的)一熟收成;一批,大量; [v]收获;啃吃;裁切;突然出现; [or]zk;
cross: [a]/krɔːs/; [adj]易怒的,脾气坏的; [v]穿过;使交叉; [n]十字架,十字物; [or]zk;
crossing: [a]/ˈkrɔːsɪŋ/; [n]人行横道;十字路口;横渡; [or]zk;
crowd: [a]/kraʊd/; [n]人群,一群;民众;朋友; [v]聚集;涌入(脑海);挤满; [or]zk;
cruel: [a]/ˈkruːəl/; [adj]残忍的,残酷的;伤人的; [or]zk;
cry: [a]/kraɪ/; [v]哭泣,大声叫喊; [n]哭声,嚎叫;口号;呼吁; [add]pl/cries,s3/cries,pr/crying,pt/cried,pp/cried; [or]zk;
culture: [a]/ˈkʌltʃər/; [n]文化;文明;修养;栽培; [v]使有教养;培养; [or]zk;
cup: [a]/kʌp/; [n]杯子;(一)杯(的容量);杯状物;杯,杯子;奖杯; [v]拔火罐;窝成杯形;使成杯状;用杯盛;为.拔火罐; [or]zk;
cupboard: [a]/ˈkʌbərd/; [n]碗橱,衣柜,壁橱; [or]zk;
curtain: [a]/ˈkɜːrtn/; [n]窗帘;幕(布); [v]装帘子,遮掉; [or]zk;
cushion: [a]/ˈkʊʃn/; [n]坐垫; [v]减轻,缓和; [or]zk;
custom: [a]/ˈkʌstəm/; [n]习惯;风俗; [adj]定制的; [or]zk;
customer: [a]/ˈkʌstəmər/; [n]顾客,主顾; [or]zk;
cut: [a]/kʌt/; [v]切,割,剪;减少; [n]伤口;划口;(锋利物留下的)开口;缩减; [or]zk;
cycle: [a]/ˈsaɪkl/; [n]自行车;周期,循环; [v](英)骑自行车;循环; [or]zk;
cyclist: [a]/ˈsaɪklɪst/; [n]骑脚踏车的人; [or]zk;
dad: [a]/dæd/; [n]爸爸,爹爹; [or]zk;
daily: [a]/ˈdeɪli/; [adj]每日的,日常的; [n]日报; [adv]每日,天天; [or]zk;
dance: [a]/dæns/; [v]跳舞;摇晃; [n]舞; [adj]舞的,舞蹈的;用于跳舞的; [or]zk;
danger: [a]/ˈdeɪndʒər/; [n]危险,危险物(或人),威胁; [or]zk;
dangerous: [a]/ˈdeɪndʒərəs/; [adj]有危险的,不安全的,引起危险的; [or]zk;
dare: [a]/der/; [v]敢,胆敢; [n]激将;挑战,挑逗; [or]zk;
dark: [a]/dɑːrk/; [n]黑暗,暗处;深色; [adj]神秘的;邪恶的;黑暗的,昏暗的;深色的; [or]zk;
darkness: [a]/ˈdɑːrknəs/; [n]黑暗;模糊;无知;邪恶; [or]zk;
date: [a]/deɪt/; [n]日期;约会对象;约会;枣子; [v]约会;始于(某一历史时期);给..注明日期,记载日期;确定..的年代; [or]zk;
daughter: [a]/ˈdɔːtər/; [n]女儿; [or]zk;
day: [a]/deɪ/; [n](一)天,白昼,白天; [adj]日间的;逐日的; [adv]每天;经常在白天地; [or]zk;
daytime: [a]/ˈdeɪtaɪm/; [n]白天; [adj]白天的,日间的; [or]zk;
dead: [a]/ded/; [adv]完全地; [n]死者,死人; [adj]死的,无生命的; [or]zk;
deaf: [a]/def/; [adj]聋的;不愿听的; [n]聋子;耳聋的人; [or]zk;
deal: [a]/diːl/; [n]协议;交易,生意;待遇;大量,很多;交易; [v]处理; [adj]冷杉木制的,松木制的; [or]zk;
dear: [a]/dɪr/; [adj]亲爱的;昂贵的; [n]亲爱的人; [int]啊; [or]zk;
death: [a]/deθ/; [n]死,死亡;灭亡; [or]zk;
debt: [a]/det/; [n]债,债务,欠债;人情债; [or]zk;
decide: [a]/dɪˈsaɪd/; [v]决定,决心,判断; [or]zk;
decision: [a]/dɪˈsɪʒn/; [n]决定;决断力;做决定; [or]zk;
decorate: [a]/ˈdekəreɪt/; [v]装饰,布置;把(勋章)授给(某人); [or]zk;
deed: [a]/diːd/; [n]行为 [ex]good ~/好事; [or]zk;
deep: [a]/diːp/; [adj]深的,深刻的,深切的; [adv]深深地; [n]深处;海; [or]zk;
deer: [a]/dɪr/; [n]鹿; [or]zk;
defeat: [a]/dɪˈfiːt/; [n]挫败;击败,战胜; [v]打败;战胜; [or]zk;
defend: [a]/dɪˈfend/; [v]防卫,保卫,防守;为..辩护,为..辩解;捍卫,维护; [or]zk;
defense: [a]/dɪ'fens/; [n]防御,防护; [or]zk;
degree: [a]/dɪˈɡriː/; [n]程度,等级;学位;度;阶层; [or]zk;
delicious: [a]/dɪˈlɪʃəs/; [adj]美味的,可口的; [or]zk;
delight: [a]/dɪˈlaɪt/; [n]高兴,愉快;高兴事; [v]使高兴; [or]zk;
delighted: [a]/dɪˈlaɪtɪd/; [adj]欣喜的,快乐的 [sw]delight,blighted,delightful,enlighten,lighter; [or]zk;
demand: [a]/dɪˈmænd/; [n]要求(坚决的),需求; [v]强烈要求,需要; [or]zk;
dentist: [a]/ˈdentɪst/; [n]牙医; [or]zk;
department: [a]/dɪˈpɑːrtmənt/; [n]部门;系;部; [or]zk;
depend: [a]/dɪˈpend/; [v]依靠,相信,依赖; [or]zk;
depth: [a]/depθ/; [n]纵深;深奥,奥妙;深度;深海;最深处; [or]zk;
describe: [a]/dɪˈskraɪb/; [v]描述;形容; [or]zk;
description: [a]/dɪˈskrɪpʃn/; [n]描写,形容,叙述;种类,类型; [or]zk;
desert: [a]/ˈdezərt/; [n]沙漠; [v]离开; [or]zk;
deserve: [a]/dɪˈzɜːrv/; [v]值得,应得;应受; [or]zk;
design: [a]/dɪˈzaɪn/; [vt]设计; [n]设计;图样; [vi]设计略图;(为工艺品,装潢项目等)设计;当设计师;构思; [or]zk;
desire: [a]/dɪˈzaɪər/; [n]渴望;欲望;愿望;要求; [vi]有希望,期望,愿望; [vt]希望,渴望;请求,要求; [or]zk;
desk: [a]/desk/; [n]书桌,办公桌;工作台;服务台; [adj]书桌上用的;书桌的; [v]派某人做办公室工作; [or]zk;
dessert: [a]/dɪˈzɜːrt/; [n]甜点; [or]zk;
destroy: [a]/dɪˈstrɔɪ/; [v]破坏,消灭,毁灭; [or]zk;
detective: [a]/dɪˈtektɪv/; [n]侦探,私人侦探; [adj]侦探的; [or]zk;
determine: [a]/dɪˈtɜːrmɪn/; [v]确定,决定; [or]zk;
develop: [a]/dɪˈveləp/; [v]生长,发育,发展,开发,显影; [or]zk;
development: [a]/dɪˈveləpmənt/; [n]发展,逐渐形成;开发区;开发; [or]zk;
devote: [a]/dɪˈvoʊt/; [vt]奉献;献身于,专心致力于; [or]zk;
devotion: [a]/dɪˈvoʊʃn/; [n]奉献,献身于...;热爱;投入;忠诚; [or]zk;
diagram: [a]/ˈdaɪəɡræm/; [n]图解,图表; [or]zk;
dial: [a]/ˈdaɪəl/; [v]拨(电话号码);打电话; [n]钟面;仪表盘;拨号盘; [or]zk;
dialog: [a]/ˈdaɪəlɑːɡ/; [n]对话,对白; [v]对话;用对话表达; [or]zk;
diamond: [a]/ˈdaɪəmənd/; [n]钻石,金刚石;方块牌;菱形;棒球内场; [or]zk;
diary: [a]/ˈdaɪəri/; [n]日记,日志;工作日程登记簿(或台历); [or]zk;
dictation: [a]/dɪkˈteɪʃn/; [n]口授,口述;听写; [or]zk;
dictionary: [a]/ˈdɪkʃəneri/; [n]词典,字典; [or]zk;
die: [a]/daɪ/; [v]消失,消亡;<口>渴望;死亡,死; [n]钢型,硬模; [or]zk;
diet: [a]/ˈdaɪət/; [n]日常饮食;(病人或减肥者的)特种饮食;大量; [v]节食; [or]zk;
difference: [a]/ˈdɪfrəns/; [n]差别;差额;分歧; [or]zk;
different: [a]/ˈdɪfrənt/; [adj]不同的,有差异的;各种的; [or]zk;
difficult: [a]/ˈdɪfɪkəlt/; [adj]困难的,难做的;难解的;难对付的,不易相处的; [or]zk;
difficulty: [a]/ˈdɪfɪkəlti/; [n]困难;难事,难点;经济拮据;障碍;麻烦; [or]zk;
dig: [a]/dɪɡ/; [n]挖,掘; [v]挖掘,翻土; [or]zk;
digital: [a]/ˈdɪdʒɪtl/; [adj]数字显示的;数字的,数码的; [n]键;数字仪表,时钟; [or]zk;
dim: [a]/dɪm/; [adj]暗淡的;模糊的;朦胧的; [v]变暗淡; [or]zk;
dining: [a]/ˈdaɪnɪŋ/; [n]吃饭,进餐; [or]zk;
dinner: [a]/ˈdɪnər/; [n]正餐,(现通例指)晚餐; [or]zk;
dinosaur: [a]/ˈdaɪnəsɔːr/; [n]恐龙; [or]zk;
dip: [a]/dɪp/; [v]浸,蘸; [n]倾斜,下降;调味汁; [or]zk;
direct: [a]/dəˈrekt/; [adj]直达的;笔直的;直接的;率直的; [vt]指导,引导;管理;引路,当向导;导演; [vi]指导;导演;领唱; [adv]直接地,径直地; [or]zk;
direction: [a]/dəˈrekʃn/; [n]方向,方位;指令,说明; [or]zk;
director: [a]/dəˈrektər/; [n]导演;指导者;主管;董事; [or]zk;
directory: [a]/dəˈrektəri/; [n]人名地址录,(电话)号码簿;目录; [or]zk;
dirt: [a]/dɜːrt/; [n]灰尘,泥土,污垢;丑事,丑行; [or]zk;
dirty: [a]/ˈdɜːrti/; [adj]不干净的,肮脏的,有灰尘的;下流的,黄色的,色情的,猥亵的;卑鄙的,不道德的; [v]弄脏,玷污; [adv]不公平地,不诚实地; [or]zk;
disability: [a]/ˌdɪsəˈbɪləti/; [n]残疾;残疾状态; [or]zk;
disabled: [a]/dɪsˈeɪbld/; [adj]伤残的;有残疾的;丧失能力的; [or]zk;
disagree: [a]/ˌdɪsəˈɡriː/; [v]不同意,反对,(意见)有分歧;(有关同一事件或形势的陈述,数字或报道)不一致,不相符; [or]zk;
disagreement: [a]/ˌdɪsəˈɡriːmənt/; [n]分歧,不和;不一致; [or]zk;
disappear: [a]/ˌdɪsəˈpɪr/; [v]消失,失踪;灭绝,消亡; [or]zk;
disappearance: [a]/ˌdɪsəˈpɪrəns/; [n]失踪,消失;绝迹; [or]zk;
disappointed: [a]/ˌdɪsəˈpɔɪntɪd/; [adj]失望的; [or]zk;
disaster: [a]/dɪˈzæstər/; [n]灾难,天灾; [or]zk;
discover: [a]/dɪˈskʌvər/; [v]发现,找到;揭露; [or]zk;
discovery: [a]/dɪˈskʌvəri/; [n]发现;被发现的事物; [or]zk;
discuss: [a]/dɪˈskʌs/; [v]讨论;论述; [or]zk;
discussion: [a]/dɪˈskʌʃn/; [n]讨论,谈论;论述; [or]zk;
disease: [a]/dɪˈziːz/; [n]疾病; [or]zk;
dish: [a]/dɪʃ/; [n]碟,盘子;菜肴; [or]zk;
disk: [a]/dɪsk/; [n]圆盘,唱片;磁盘; [or]zk;
dislike: [a]/dɪsˈlaɪk/; [v]不喜欢,厌恶; [n]不喜欢,厌恶; [or]zk;
dismiss: [a]/dɪsˈmɪs/; [v]开除;解散;摒除,不再考虑; [or]zk;
display: [a]/dɪˈspleɪ/; [v]展示;显示;陈列; [n]表现,流露,展示;显示,显示器;陈列品; [or]zk;
distance: [a]/ˈdɪstəns/; [n]距离;间距;远处; [or]zk;
distant: [a]/ˈdɪstənt/; [adj]遥远的;远方的;疏远的; [or]zk;
distinction: [a]/dɪˈstɪŋkʃn/; [n]差别,区分;优秀,卓越,杰出;特性,独特,不同凡响;优等评分,荣誉分数,殊荣; [or]zk;
district: [a]/ˈdɪstrɪkt/; [n]地区;区域; [vt]把..划分成区; [or]zk;
disturb: [a]/dɪˈstɜːrb/; [v]打扰,妨碍;弄乱;使烦恼; [or]zk;
dive: [a]/daɪv/; [n]跳水;潜水;俯冲;骤降; [vi]跳水;潜水;俯冲;急剧下降; [or]zk;
diver: [a]/ˈdaɪvər/; [n]潜水员; [or]zk;
divide: [a]/dɪˈvaɪd/; [v]分开,划分;分配;除;产生分歧;分岔;分裂; [n]差异;分水岭; [or]zk;
doctor: [a]/ˈdɑːktər/; [n]医生,医师;博士; [v]诊治;修理,修复,改写文稿; [or]zk;
document: [a]/ˈdɑːkjumənt/; [n]文件,公文;(计算机的)文档; [v]记录;证明; [or]zk;
dog: [a]/dɔːɡ/; [n]狗,犬,犬科动物; [v](灾难等)缠住;跟踪;尾随; [or]zk;
doll: [a]/dɑːl/; [n]玩具娃娃,玩偶; [or]zk;
dollar: [a]/ˈdɑːlər/; [n]美元; [or]zk;
dolphin: [a]/ˈdɑːlfɪn/; [n]海豚; [or]zk;
door: [a]/dɔːr/; [n]门;门口,通道;建筑物; [or]zk;
doorbell: [a]/ˈdɔːrbel/; [n]门铃; [or]zk;
dormitory: [a]/ˈdɔːrmətɔːri/; [n]宿舍楼<美国英语>;宿舍,学生宿舍; [adj]住宅区的; [or]zk;
doubt: [a]/daʊt/; [n]怀疑;疑虑; [v]怀疑; [or]zk;
down: [a]/daʊn/; [adv]向下,在下面; [n]绒毛,汗毛; [adj]沮丧的,情绪低落的; [prep]向下; [or]zk;
download: [a]/ˌdaʊnˈloʊd/; [n]下载,下载的文件; [v]下载; [or]zk;
downstairs: [a]/ˌdaʊnˈsterz/; [adv]在楼下,往楼下; [adj]楼下的; [n]楼下; [or]zk;
downtown: [a]/ˈdaʊntaʊn/; [adj]商业区的,闹市区的; [adv]在商业区,在市中心; [n]市中心区,市中心; [or]zk;
dozen: [a]/ˈdʌzn/; [n]一打,十二个;一打的;十二个的; [or]zk;
drag: [a]/dræɡ/; [v]拉,拽,拖着(沉重的步伐或疲惫的身躯);拖动,拖沓; [n]拖,拖累物; [adj]女穿男服的;男穿女服的; [adv]带有女伴; [or]zk;
draw: [a]/drɔː/; [v]画;拉;吸引; [n]平局; [or]zk;
drawer: [a]/drɔːr/; [n]抽屉; [or]zk;
drawing: [a]/ˈdrɔːɪŋ/; [n]绘图,图样; [or]zk;
dream: [a]/driːm/; [v]做梦,梦想; [n]梦,梦想; [or]zk;
dress: [a]/dres/; [v]打扮,穿着;给..穿衣; [n]连衣裙;服装; [or]zk;
drill: [a]/drɪl/; [n]训练;反复操练;钻头; [v]在..上钻孔;钻孔; [or]zk;
drink: [a]/drɪŋk/; [v]饮,喝; [n]饮料; [or]zk;
drive: [a]/draɪv/; [v]驾车;驱使; [n]驾车旅行;驾车路程;强烈欲望;动力,干劲;驱动器; [or]zk;
driver: [a]/ˈdraɪvər/; [n]驾驶员,司机;<机>传动器,驱动器,主动轮,<机>驱动程序; [or]zk;
drop: [a]/drɑːp/; [v]使落下;降低,落下; [prep]顺道拜访(drop by); [n]下降;滴剂;滴状物;下落物;随口说出;写;略去;放弃;输掉; [or]zk;
drought: [a]/draʊt/; [n]干旱,旱灾; [or]zk;
drown: [a]/draʊn/; [v]淹死;淹没; [or]zk;
drug: [a]/drʌɡ/; [n]药物,麻醉品,毒品; [v]下麻药; [or]zk;
drum: [a]/drʌm/; [v]击鼓;连续敲击; [n]鼓;圆桶; [or]zk;
dry: [a]/draɪ/; [adj]干的; [v]弄干; [or]zk;
duck: [a]/dʌk/; [n]鸭,雌鸭;鸭肉; [v]回避,躲闪; [or]zk;
dumpling: [a]/ˈdʌmplɪŋ/; [n]饺子;水果布丁; [or]zk;
during: [a]/ˈdʊrɪŋ/; [prep]在.期间,在.过程中; [or]zk;
dusk: [a]/dʌsk/; [n]薄暮,黄昏; [v](天)变黑;变暗; [or]zk;
dust: [a]/dʌst/; [n]尘土,灰尘; [vi]掸尘;涂上粉末; [vt]掸掉,擦去;使成粉末; [v]擦去.的灰尘; [or]zk;
dustbin: [a]/ˈdʌstbɪn/; [n]垃圾箱; [or]zk;
duty: [a]/ˈduːti/; [n]责任,职责,义务,税; [or]zk;
each: [a]/iːtʃ/; [det]每人的,每个的; [pron]每人,每个,每件; [adv]每个; [or]zk;
eagle: [a]/ˈiːɡl/; [n]鹰,老鹰;鹰状标志;(高尔夫球赛中)少击两棒入穴的成绩; [vt](高尔夫球赛中)比标准杆数少击两杆入; [or]zk;
ear: [a]/ɪr/; [n]耳朵;听力,听觉;穗; [or]zk;
early: [a]/ˈɜːrli/; [adj]早的,早期的; [adv]早,先; [or]zk;
earn: [a]/ɜːrn/; [v]赚得,挣得,获得; [or]zk;
earth: [a]/ɜːrθ/; [n]地球;陆地;地面; [or]zk;
earthquake: [a]/ˈɜːrθkweɪk/; [n]地震; [or]zk;
easily: [a]/ˈiːzəli/; [adv]容易地,无疑地,很可能地; [or]zk;
east: [a]/iːst/; [n]东;东方; [adj]东方的;朝(或向)东方的; [adv]向东方;在东方; [or]zk;
eastern: [a]/ˈiːstərn/; [adj]东方的,东部的,朝东的; [n]东方人;(美国)东部地区的人;东正教信徒; [or]zk;
eastwards: [a]/ˈiːstwərdz/; [adv]向东; [or]zk;
easy: [a]/ˈiːzi/; [adj]舒适的,从容的;易受攻击的,易遭批评的;容易的,不费力的;友好的,好相处的; [adv]小心地; [or]zk;
eat: [a]/iːt/; [v]吃,喝,吃饭; [or]zk;
edge: [a]/edʒ/; [n](悬崖,峭壁的)边缘;边缘;锋利,尖锐;刀口,刃;优势; [v]徐徐移动;给.开刃,使锐利; [or]zk;
editor: [a]/ˈedɪtər/; [n]编辑;主编; [or]zk;
educate: [a]/ˈedʒukeɪt/; [v]教育,培养,训练; [or]zk;
education: [a]/ˌedʒuˈkeɪʃn/; [n]教育,培养;教育学; [or]zk;
educator: [a]/ˈedʒukeɪtər/; [n]教育者,教师;教育学家; [or]zk;
effort: [a]/ˈefərt/; [n]努力;成就; [or]zk;
egg: [a]/eɡ/; [n]蛋;鸡蛋;卵; [vt]用蛋覆盖;向..扔蛋; [or]zk;
eggplant: [a]/ˈeɡplænt/; [n]茄子,黑紫色; [or]zk;
eight: [a]/eɪt/; [num]八;八个; [n]八个;八点; [or]zk;
eighteen: [a]/ˌeɪˈtiːn/; [num]十八,十八个;十八; [or]zk;
eighteenth: [a]/ˌeɪˈtiːnθ/; [n](每月的)第十八日;第十八,十八分之一; [num]第十八;十八分之一; [adj]第十八的,第十八个的;十八分之一的; [or]zk;
eighth: [a]/eɪtθ/; [num]第八; [n]八分之一; [or]zk;
eighty: [a]/ˈeɪti/; [num]八十,八十个; [adj]八十的; [n]八十; [or]zk;
either: [a]/ˈaɪðər/; [det]两方;二者之一;要么..要么..; [adv]二者之一地;(用于否定句或短语后)也; [pron]任一; [or]zk;
elder: [a]/ˈeldər/; [n]长辈; [adj]年长的,资格老的; [or]zk;
electric: [a]/ɪˈlektrɪk/; [adj]电的,电动的,带电的;刺激的; [n]供电; [or]zk;
electrical: [a]/ɪˈlektrɪkl/; [adj]有关电的;电气科学的; [or]zk;
electricity: [a]/ɪˌlekˈtrɪsəti/; [n]电,电力;电流;电学; [or]zk;
electronic: [a]/ɪˌlekˈtrɑːnɪk/; [adj]电子的;电子学的;电子操控的;电子设备的; [or]zk;
elephant: [a]/ˈelɪfənt/; [n]象; [or]zk;
elevator: [a]/ˈelɪveɪtər/; [n]电梯;起重机;升降舵;粮库; [or]zk;
eleven: [a]/ɪˈlevn/; [num]十一,十一个; [n]由十一人组成的足球队,棒球队等;十一个一组; [adj]十一的; [pron]十一个; [or]zk;
else: [a]/els/; [adv]别的;其他的; [n]女子名; [or]zk;
embarrass: [a]/ɪmˈbærəs/; [vt]使窘迫,使尴尬(尤指在社交场合);困窘,困扰; [or]zk;
embassy: [a]/ˈembəsi/; [n]大使馆;大使馆全体人员; [or]zk;
emergency: [a]/iˈmɜːrdʒənsi/; [n]紧急情况;突发事件; [or]zk;
employ: [a]/ɪmˈplɔɪ/; [v]雇用;雇佣;使忙于;使用;用于.; [n]受雇;职业;使用; [or]zk;
empty: [a]/ˈempti/; [adj]空的,空洞的; [v]倒空,使成为空的; [or]zk;
encourage: [a]/ɪnˈkɜːrɪdʒ/; [v]鼓励,支持;促使;怂恿; [or]zk;
end: [a]/end/; [n]终点;末端;结果,结局;终止,结束,极限,终极; [adj]最后的,最终的; [v]结束; [or]zk;
ending: [a]/ˈendɪŋ/; [n]结尾,结局,末尾; [or]zk;
enemy: [a]/ˈenəmi/; [n]敌人;敌国;敌军;危害物; [or]zk;
energy: [a]/ˈenərdʒi/; [n]能量;能源;活力;精力;能; [or]zk;
engine: [a]/ˈendʒɪn/; [n]引擎;发动机; [v]给..装引擎; [or]zk;
engineer: [a]/ˌendʒɪˈnɪr/; [n]工程师;技师;火车司机;技工; [v]设计;建造;当工程师;计划; [or]zk;
enjoy: [a]/ɪnˈdʒɔɪ/; [v]享受..的乐趣,欣赏,喜爱;自得其乐; [or]zk;
enjoyable: [a]/ɪnˈdʒɔɪəbl/; [adj]令人愉快的,可享受的; [or]zk;
enough: [a]/ɪˈnʌf/; [det]足够的; [adv]足够地; [pron]很多;充足; [int]够了; [or]zk;
enter: [a]/ˈentər/; [v]走进,参加,加入; [n]输入,<计>回车; [or]zk;
entire: [a]/ɪnˈtaɪər/; [adj]全部的,完整的,整个的; [n]全部,整体; [or]zk;
entrance: [a]/ˈentrəns/; [n]入口,通道,大门口;出场,登场;进入权; [v]使出神,使入迷; [or]zk;
entry: [a]/ˈentri/; [n]入口处;登记;进入; [or]zk;
envelope: [a]/ˈenvəloʊp/; [n]信封;包装物,外壳,膜;气囊; [or]zk;
environment: [a]/ɪnˈvaɪrənmənt/; [n]环境;外界;工作平台; [or]zk;
environmental: [a]/ɪnˌvaɪrənˈmentl/; [adj]周围的;环境的; [or]zk;
envy: [a]/ˈenvi/; [n]妒忌;妒忌的对象; [v]嫉妒,羡慕; [or]zk;
equal: [a]/ˈiːkwəl/; [adj]相等的;平等的; [v]等于;比得上; [n]对手; [or]zk;
equipment: [a]/ɪˈkwɪpmənt/; [n]设备;装备,装置; [or]zk;
eraser: [a]/ɪˈreɪsər/; [n]橡皮擦,擦除器; [or]zk;
escape: [a]/ɪˈskeɪp/; [v]逃跑,避开,避免;泄露; [n]逃跑,逃脱; [or]zk;
especially: [a]/ɪˈspeʃəli/; [adv]特别;尤其;格外;异常地; [or]zk;
essay: [a]/ˈeseɪ/; [n]文章;论文;尝试;随笔; [v]尝试; [or]zk;
essential: [a]/ɪˈsenʃl/; [adj]必不可少的,必要的;本质的;重要的;基本的; [n]要素;必需品; [or]zk;
eve: [a]/iːv/; [n](节日等的)前夜,前夕; [or]zk;
even: [a]/ˈiːvn/; [adj]实力相当的;均等的;偶数的; [adv]甚至;即使,竟然; [v]使平,使相等; [or]zk;
evening: [a]/ˈiːvnɪŋ/; [n]傍晚,晚上;黄昏; [or]zk;
event: [a]/ɪˈvent/; [n]事件,大事;社交活动;比赛项目; [or]zk;
ever: [a]/ˈevər/; [adv]曾经,在任何时候,究竟,一直,永远; pref. (构成形容词)表示"永远","持续"; [or]zk;
every: [a]/ˈevri/; [det]每个,每一,每一个;每隔(一定的数目或时间)的,每..之中的;一切可能的,所有可能的; [or]zk;
everybody: [a]/ˈevribɑːdi/; [pron]每人,人人; [or]zk;
everyday: [a]/ˈevrideɪ/; [adj]日常的,每天的; [or]zk;
everyone: [a]/ˈevriwʌn/; [pron]每个人,人人; [n]每个人,人人; [or]zk;
everywhere: [a]/ˈevriwer/; [adv]到处,处处; [n]每个地方; [or]zk;
exact: [a]/ɪɡˈzækt/; [adj]确切的,精密严谨的; [v]强求; [or]zk;
exam: [a]/ɪɡˈzæm/; [n]考试;检查,细查; [or]zk;
examine: [a]/ɪɡˈzæmɪn/; [v]检查,细查;对..进行考试; [or]zk;
example: [a]/ɪɡˈzæmpl/; [n]例子,实例;模范; [or]zk;
excellent: [a]/ˈeksələnt/; [adj]优秀的;卓越的;极好的; [or]zk;
except: [a]/ɪkˈsept/; [prep]除..之外; [v]把..除外; [conj]除.以外; [or]zk;
excite: [a]/ɪkˈsaɪt/; [v]使激动,使兴奋;引起,激起; [or]zk;
excited: [a]/ɪkˈsaɪtɪd/; [adj](人)兴奋的;激动的;紧张的; [or]zk;
exciting: [a]/ɪkˈsaɪtɪŋ/; [adj]令人兴奋的;使人激动的; [or]zk;
excuse: [a]/ɪkˈskjuːs/; [n]借口,辩解; [vt]原谅;免除; [vi]作为借口;请示宽恕;表示宽恕; [or]zk;
exercise: [a]/ˈeksərsaɪz/; [v]运动;锻炼;行使,运用; [n]操练,运动;习题; [or]zk;
exhibition: [a]/ˌeksɪˈbɪʃn/; [n]展览,展览会;陈列;奖学金; [or]zk;
exist: [a]/ɪɡˈzɪst/; [v]生存,生活;存在; [or]zk;
exit: [a]/ˈeksɪt/; [n]出口;退场; [v]退出; [or]zk;
expect: [a]/ɪkˈspekt/; [v]期待;指望;预计; [or]zk;
expensive: [a]/ɪkˈspensɪv/; [adj]昂贵的; [or]zk;
experience: [a]/ɪkˈspɪriəns/; [n]经历,感受,体验,经验; [v]体验,感受;经历; [or]zk;
experiment: [a]/ɪkˈsperɪmənt/; [n]试验; [v](on)进行实验; [or]zk;
expert: [a]/ˈekspɜːrt/; [n]专家; [adj]熟练的,专业的; [or]zk;
explain: [a]/ɪkˈspleɪn/; [v]解释;说明; [or]zk;
explore: [a]/ɪkˈsplɔːr/; [v]探险,探索,尝试; [or]zk;
explorer: [a]/ɪkˈsplɔːrər/; [n]探险家; [or]zk;
export: [a]/ˈekspɔːrt/; [v]出口,输出; [n]输出,出口,输出品; [or]zk;
express: [a]/ɪkˈspres/; [adj]特定的;明确的;快速的; [n]快递;快车; [v]表达;用快递邮出;挤,榨; [adv]使用快速服务; [or]zk;
expression: [a]/ɪkˈspreʃn/; [n]表情,神情;表达,表述;措辞; [or]zk;
extra: [a]/ˈekstrə/; [adj]额外的,附加的;特优的; [adv]额外地; [n]附加物品;临时演员;(报纸)号外; [or]zk;
extraordinary: [a]/ɪkˈstrɔːrdəneri/; [adj]非同寻常的;特别的; [or]zk;
extreme: [a]/ɪkˈstriːm/; [adj]极端的;极远的;极限的;极度的;偏激的; [n]极端;极度(状态),最大程度; [or]zk;
eye: [a]/aɪ/; [n]眼睛;眼球;眼圈;眼神;注意;判断力;眼状物;视角; [v]向.送秋波;注视;考虑; [or]zk;
eyesight: [a]/ˈaɪsaɪt/; [n]视力,目力; [or]zk;
face: [a]/feɪs/; [v]面对,朝向,面临; [n]表面;外表;脸,表情; [or]zk;
fact: [a]/fækt/; [n]事实,真相,实际; [or]zk;
factory: [a]/ˈfæktəri/; [n]工厂,制造厂; [or]zk;
fail: [a]/feɪl/; [v]失败,不及格; [n]失败;失误; [or]zk;
failure: [a]/ˈfeɪljər/; [n]失败;失败者;破产; [or]zk;
fair: [a]/fer/; [adj]公平的,合理的;相当的,尚好的;晴朗的;白皙的;金发的; [n]集市,交易会;义卖会; [adv]公平地;直接地;清楚地;正大光明地; [v](卡通制作)顺利接合;(动作)衔接协调;(飞机)装配平整;使(飞机接合部)平滑;转晴; [or]zk;
fairly: [a]/ˈferli/; [adv]相当地;公正地,公平地,正当地;清楚地;完全,简直; [or]zk;
fall: [a]/fɔːl/; [n]秋天; [vi]落下;跌倒;坠落; [adj]秋天的;秋天成熟的;(衣服等)秋天用的; [or]zk;
false: [a]/fɔːls/; [adj]错误的;假的;虚伪的; [or]zk;
fame: [a]/feɪm/; [n]名望,名声,声誉; [vt]使有名,使著名; [or]zk;
familiar: [a]/fəˈmɪliər/; [adj]熟悉的;不拘礼节的;亲密的;随便的; [n]密友;常客;高级官吏的家属; [or]zk;
family: [a]/ˈfæməli/; [n]族,科;家,家庭成员;氏族,家庭; [adj]家庭的,家族的,适合于全家的; [or]zk;
famous: [a]/ˈfeɪməs/; [adj]著名的,出名的; [or]zk;
fan: [a]/fæn/; [n]扇子,风扇;(影,球等)迷; [v]扇;成扇形;<棒>三振出局; [or]zk;
fantastic: [a]/fænˈtæstɪk/; [adj]极好的;极大的;不真实的;荒诞离奇的;不可思议的; [n]〈古〉古怪的人; [or]zk;
far: [a]/fɑːr/; [adv]远,(时间)久远,很,远远,进展程度; [adj]较远的,最远的,远方的; [n]远方; [or]zk;
fare: [a]/fer/; [n]交通费;票价;食物;出租车乘客; [v](事情)进行得(好或坏); [or]zk;
farm: [a]/fɑːrm/; [n]农场,饲养场; [v]种田,经营农牧业; [or]zk;
farmer: [a]/ˈfɑːrmər/; [n]农民,农夫;农场主; [or]zk;
farming: [a]/ˈfɑːrmɪŋ/; [n]农业,耕作; [adj]农业的;农场的; [or]zk;
farmland: [a]/ˈfɑːrmlænd/; [n]农田; [or]zk;
farther: [a]/ˈfɑːrðər/; [adv]更远地,再往前地; [adj]更远的; [or]zk;
farthest: [a]/ˈfɑːrðɪst/; [adv]最远地;最大程度地; [adj]最远的;最久的; [or]zk;
fast: [a]/fæst/; [adj]迅速的,动作敏捷的;很快做完的;头脑灵活的;不褪色的;牢固的;扎牢的;耐..的; [adv]迅速地;牢固地;彻底地; [n]斋戒,禁食期; [v]节制饮食,节食; [or]zk;
fasten: [a]/ˈfæsn/; [v]系;扎牢;扣住;固定; [or]zk;
fat: [a]/fæt/; [adj]肥胖的; [n]脂肪,油脂; [or]zk;
father: [a]/ˈfɑːðər/; [n]父亲;神父;创始人; [v]发明,创立; [or]zk;
fault: [a]/fɔːlt/; [n]过失,过错;弱点,缺点;故障,缺陷;(地质学)断层;发球失误; [v]责备,挑错; [or]zk;
favor: [a]/ˈfeɪvər/; [n]偏爱,帮助,特权,赞成; [vt]偏爱,支持,利于,长得像; [or]zk;
favorite: [a]/'feɪvərɪt/; [adj]最爱的; [n]最喜爱的人或物,有希望获胜的选手; [or]zk;
fax: [a]/fæks/; [n]传真(机);传真件; [v]用传真传输; [or]zk;
fear: [a]/fɪr/; [n]顾虑,胆怯 [v]害怕,担心; [or]zk;
feather: [a]/ˈfeðər/; [n]羽毛; [or]zk;
federal: [a]/ˈfedərəl/; [adj]联邦制的;联邦政府的; [or]zk;
fee: [a]/fiː/; [n]费用,酬金; [or]zk;
feed: [a]/fiːd/; [v]喂(养),吃饲料; [n]饲料,一餐,饲养; [or]zk;
feel: [a]/fiːl/; [v]有知觉;触,摸; [or]zk;
feeling: [a]/ˈfiːlɪŋ/; [n]情绪,感觉,知觉,气氛,鉴赏力; [v]感觉; [or]zk;
fence: [a]/fens/; [n]篱笆,围栏,栅栏; [v]击剑;用篱笆围住;束缚; [or]zk;
festival: [a]/ˈfestɪvl/; [n]节日;欢宴,庆祝; [or]zk;
fetch: [a]/fetʃ/; [v]取来;接来;使发出;售得;带来;接住; [n]拿来,取来;诡计;风浪区; [or]zk;
fever: [a]/ˈfiːvər/; [n]发热,狂热; [or]zk;
few: [a]/fjuː/; [adj]很少的,几乎没有的;少数的; [pron]很少;有些(人,事物,地方);少数人;不和.一般多;很少数; [det]几个; [or]zk;
field: [a]/fiːld/; [n]田野,大片地方;运动场;领域;战场;全体参赛者; [v]处理,应付;选派.上场;把.投入使用; [or]zk;
fierce: [a]/fɪrs/; [adj]凶猛的;激烈的;猛烈的; [or]zk;
fifteen: [a]/ˌfɪfˈtiːn/; [num]十五,十五个; [n]十五人制英式橄榄球队; [or]zk;
fifth: [a]/fɪfθ/; [n]五分之一; [num]第五; [or]zk;
fifty: [a]/ˈfɪfti/; [n]五十,五十个; [num]五十,五十个;五十的,五十个的; [or]zk;
fight: [a]/faɪt/; [n]搏斗;斗争; [vt]对抗,与..打架;[vi]争吵,斗争; [sw]flight,fright; [or]zk;
fill: [a]/fɪl/; [v]装满,盛满,加满;占满;填补,满足; [or]zk;
film: [a]/fɪlm/; [n]电影;胶卷;薄层; [v]拍摄; [or]zk;
final: [a]/ˈfaɪnl/; [adj]最后的;决定性的; [n]决赛;期末考试;当日报纸的末版; [or]zk;
find: [a]/faɪnd/; [v]找到;发现;找出,定位; [n]发现物,被发现的人; [or]zk;
fine: [a]/faɪn/; [v]罚款; [n]罚款,罚金; [adj]好的,优质的,精致的,晴朗的; [adv]合适地,恰好地; [or]zk;
finger: [a]/ˈfɪŋɡər/; [n]手指;指状物; [v]触碰,用指抚摸; [or]zk;
finish: [a]/ˈfɪnɪʃ/; [v]完成,结束,最后加工,用完; [n]结束,完成; [or]zk;
fire: [a]/ˈfaɪər/; [n]火;火灾; [v]开火;解雇; [or]zk;
fireplace: [a]/ˈfaɪərpleɪs/; [n]壁炉; [or]zk;
first: [a]/fɜːrst/; [det]第一; [adv]最初; [n]第一个;最初; [or]zk;
fish: [a]/fɪʃ/; [n]鱼,鱼肉; [v]钓鱼; [or]zk;
fisherman: [a]/ˈfɪʃərmən/; [n]渔民,渔夫,打渔人; [or]zk;
fist: [a]/fɪst/; [n]拳头;笔迹; [vt]用拳头打;握成拳;紧握; [or]zk;
fit: [a]/fɪt/; [v]适合;安装; [adj]健康的;合适的; [n]合身;发作;匹配,相配; [or]zk;
five: [a]/faɪv/; [num]五,五个; [adj]五个的; [n]五,五个; [or]zk;
fix: [a]/fɪks/; [n]方位,定位,位置; [vt]使固定;修理;决定;凝视; [vi]固着;变硬;安定; [or]zk;
flag: [a]/flæɡ/; [v](以旗子)标出,标记;疲乏,热情衰减; [n]国旗,旗帜; [or]zk;
flat: [a]/flæt/; [adj]平坦的;浅的;平面的;单调的; [n]平面;公寓; [adv]平直地; [or]zk;
flight: [a]/flaɪt/; [n]楼梯的一段;飞机的航程;航班;飞行;逃跑; [v]使球在空中飞行; [or]zk;
flood: [a]/flʌd/; [n]洪水;大量; [v]淹没,充满;(河)溢出; [or]zk;
floor: [a]/flɔːr/; [n]地板,地面,楼层,底部; [vt]铺地板,击倒,(油门)踩到底; [or]zk;
flour: [a]/ˈflaʊər/; [n]面粉;粉状物质; [v]撒上粉; [or]zk;
flow: [a]/floʊ/; [v]流动;飘垂;涨潮;来自..的结果;流畅; [n]流动;流畅; [or]zk;
flower: [a]/ˈflaʊər/; [n]花,花卉;精华; [v]开花; [or]zk;
flu: [a]/fluː/; [n]流感; [or]zk;
fluent: [a]/ˈfluːənt/; [adj]流畅的,(说话)流利的;顺畅的,流畅熟练的; [or]zk;
fly: [a]/flaɪ/; [n]蝇,苍蝇; [v]飞行; [adj]机灵的;机警的;不会上当的;时髦迷人的; [or]zk;
focus: [a]/ˈfoʊkəs/; [n]焦点,聚焦;焦距;关注; [v]使聚焦,集中注意力; [or]zk;
fog: [a]/fɔːɡ/; [n]雾;烟雾,尘雾; [v]以雾笼罩,使模糊,迷惑; [or]zk;
foggy: [a]/ˈfɔːɡi/; [adj]有雾的;模糊的; [or]zk;
fold: [a]/foʊld/; [v]折叠;彻底失败;合拢; [n]折叠;褶; [or]zk;
follow: [a]/ˈfɑːloʊ/; [vi]跟随;接踵而至; [v]追随;跟随;理解;力求上进,追赶;跟随,追随;追踪;继承;随后做;采用;遵循;沿着..走;能理解;追求; [or]zk;
following: [a]/ˈfɑːloʊɪŋ/; [adj]接着的;下列的; [n]下列事物;一批追随者; [prep]随后,在.以后; [or]zk;
fond: [a]/fɑːnd/; [adj]喜欢的,喜爱的,溺爱的,精神错乱的; [v]显出钟爱之情; [or]zk;
food: [a]/fuːd/; [n]食物,食品,养料; [or]zk;
fool: [a]/fuːl/; [n]笨蛋,傻瓜; [v]玩弄,愚弄; [or]zk;
foolish: [a]/ˈfuːlɪʃ/; [adj]愚蠢的;傻乎乎的; [or]zk;
foot: [a]/fʊt/; [n]脚;最下部;英尺; [vi]步行; [vt]步行;走在..之上; [or]zk;
football: [a]/ˈfʊtbɔːl/; [n]足球,橄榄球; [v]踢足球,打橄榄球; [or]zk;
force: [a]/fɔːrs/; [v]强迫;推动;凭借武力前进; [n]力量;武力;势力; [or]zk;
foreign: [a]/ˈfɔːrən/; [adj]外国的,外来的;陌生的,非自身的; [or]zk;
foreigner: [a]/ˈfɔːrənər/; [n]外国人,外人; [or]zk;
forest: [a]/ˈfɔːrɪst/; [n]森林; [v]植树于,使成为森林; [or]zk;
forever: [a]/fərˈevər/; [adv]永远;总是,老是; [or]zk;
forget: [a]/fərˈɡet/; [v]忘记,遗忘; [or]zk;
forgetful: [a]/fərˈɡetfl/; [adj]健忘的;不注意的;疏忽的;使遗忘的; [or]zk;
forgive: [a]/fərˈɡɪv/; [v]原谅,饶恕,宽恕;(国家,银行等)免除(债务); [or]zk;
fork: [a]/fɔːrk/; [n]叉,餐叉;耙子;分叉,分岔处,岔路; [or]zk;
form: [a]/fɔːrm/; [n]形状,表格;形体,方式; [v]形成,产生;排(队),列(队);组织,建立;塑造,养成;制作,做成; [or]zk;
forth: [a]/fɔːrθ/; [adv]向前;向外;离去; [prep]出自,从.离开; [or]zk;
fortunate: [a]/ˈfɔːrtʃənət/; [adj]幸运的; [sw]importunate; [or]zk;
forty: [a]/ˈfɔːrti/; [num]四十,第四十;四十的;四十(个);四十个的; [n]四十年代; [or]zk;
forward: [a]/ˈfɔːrwərd/; [adv]向前,前进; [adj]向前的,前部的;进步的;冒失的; [v]转交,转递; [n]前锋; [or]zk;
fossil: [a]/ˈfɑːsl/; [n]化石; [adj]从地下发掘出来的;化石的;属于旧时代的;陈腐的; [or]zk;
found: [a]/faʊnd/; [v]成立,建立,创办;发现(find的过去式); [or]zk;
foundation: [a]/faʊnˈdeɪʃn/; [n]地基;基础;基金(会);建立;粉底; [or]zk;
fountain: [a]/ˈfaʊntn/; [n]泉水,喷泉;源泉;人造喷泉装置; [or]zk;
four: [a]/fɔːr/; [num]四; [n]四个;板球中得四分的一击; [or]zk;
fourteen: [a]/ˌfɔːrˈtiːn/; [num]十四; [or]zk;
fourth: [a]/fɔːrθ/; [num]第四的,第四个的,四分之一的;第四; [n]四分之一,第四档; [or]zk;
fox: [a]/fɑːks/; [n]狐狸;狡猾的人;时髦女郎; [v]用诡计,假装;欺骗,迷惑; [or]zk;
fragile: [a]/ˈfrædʒl/; [adj]易碎的;易损坏的;虚弱的;脆弱的; [or]zk;
free: [a]/friː/; [adj]免费的;自由的,不受约束的; [v]使自由,解放; [adv]自由地;免费; [or]zk;
freedom: [a]/ˈfriːdəm/; [n]自由;自主; [or]zk;
freeway: [a]/ˈfriːweɪ/; [n]高速公路; [or]zk;
freeze: [a]/friːz/; [v]冻结;使冻僵; [n]严寒,冻结; [or]zk;
frequently: [a]/ˈfriːkwəntli/; [adv]频繁,经常地; [or]zk;
fresh: [a]/freʃ/; [adj]新鲜的,清新的,新近的,无经验的; [n]开始;新生; [adv]最近地; [or]zk;
fridge: [a]/frɪdʒ/; [n]电冰箱; [or]zk;
friend: [a]/frend/; [n]朋友,友人;支持者; [or]zk;
friendly: [a]/ˈfrendli/; [adj]友好的,友谊的; [adv]友好地;朋友般地; [n](足球等的)友谊赛; [or]zk;
friendship: [a]/ˈfrendʃɪp/; [n]友谊,友好; [or]zk;
frighten: [a]/ˈfraɪtn/; [v]使惊恐,使害怕; [or]zk;
frightened: [a]/ˈfraɪtnd/; [adj]受惊的,受恐吓的; [or]zk;
frog: [a]/frɔːɡ/; [n]蛙; [or]zk;
front: [a]/frʌnt/; [adj]前面的,正面的; [n]前部,前面,正面; [adv]在前面,向前; [v]面对,朝向,对付; [or]zk;
frost: [a]/frɔːst/; [n]霜冻,严寒; [v]结霜,冻死; [or]zk;
fruit: [a]/fruːt/; [n]水果;成果,产物; [vi]结果实; [vt]使结果实; [or]zk;
frustrate: [a]/ˈfrʌstreɪt/; [v]使灰心;挫败;阻挠; [or]zk;
fry: [a]/fraɪ/; [v]油煎;油炸; [n]鱼苗,鱼秧;弗赖伊(姓氏);油炸食物;(口语)烦恼,愤激; [adj]油炸的,油煎的(fried); [or]zk;
full: [a]/fʊl/; [n]完全,全部;盛期; [adj]满的,充满的;详尽的;饱的;完全的;最高度的;同父同母的;很受感动的;专心的; [adv]直接地,径直地;完全地,充分地,到最大程度;整整,足(足); [or]zk;
fun: [a]/fʌn/; [n]玩笑;娱乐,乐趣; [vi]开玩笑,嬉戏; [adj]有趣的,供娱乐用的; [or]zk;
function: [a]/ˈfʌŋkʃn/; [n]功能,作用;函数;应变量;盛大聚会;职务,职责; [v]起作用;正常运转; [or]zk;
funny: [a]/ˈfʌni/; [n]笑话;滑稽戏;反常的怪事; [adj]有趣的,好玩的;奇怪的; [or]zk;
fur: [a]/fɜːr/; [n]毛皮,毛皮外套,人造毛; [or]zk;
furniture: [a]/ˈfɜːrnɪtʃər/; [n]家具;装置;设备; [or]zk;
furthest: [a]/ˈfɜːrðɪst/; [adj]最远的;最遥远的; [adv]最远地;最大程度地; [or]zk;
future: [a]/ˈfjuːtʃər/; [n]将来,未来;前途; [or]zk;
game: [a]/ɡeɪm/; [n]游戏,比赛;猎物; [adj]甘愿尝试,有冒险精神; [v]打赌,赌输赢; [or]zk;
garden: [a]/ˈɡɑːrdn/; [n]花园,菜园;公园; [v]从事园艺; [or]zk;
gas: [a]/ɡæs/; [n]煤气;气体;汽油; [v]使吸入毒气;毒(死);给 ... 加汽油;空谈;加汽油; [adj]〈美俚〉喝醉酒的; [or]zk;
gate: [a]/ɡeɪt/; [n]大门;登机口;观众数; [or]zk;
gatekeeper: [a]/ˈɡeɪtkiːpər/; [n]看门人;守门人;中介人;把守; [or]zk;
general: [a]/ˈdʒenrəl/; [adj]普遍的,全面的,一般性的,大致的,笼统的,常规的,总的; [n]将军,一般; [or]zk;
generosity: [a]/ˌdʒenəˈrɑːsəti/; [n]慷慨,大方; [or]zk;
generous: [a]/ˈdʒenərəs/; [adj]慷慨的;充裕的,宽厚的;肥沃的; [or]zk;
gentle: [a]/ˈdʒentl/; [adj]温和的,轻柔的,文雅的; [or]zk;
gentleman: [a]/ˈdʒentlmən/; [n]绅士;有教养的人; [or]zk;
geography: [a]/dʒiˈɑːɡrəfi/; [n]地理(学); [or]zk;
gesture: [a]/ˈdʒestʃər/; [n]手势,表情;姿态; [v]做手势,用动作示意; [vt]用手势表达; [or]zk;
get-together: [a]/ˈɡet təɡeðər/; [n]聚会; [or]zk;
get: [a]/ɡet/; [v]得到,获得,赢得;成为,变成,变为,变得;生(病),得(病),感染上(病);购买,买到;理解,记住; [or]zk;
gift: [a]/ɡɪft/; [n]礼物,赠品;天赋; [v]赋予,赠送; [or]zk;
giraffe: [a]/dʒəˈræf/; [n]长颈鹿; [or]zk;
girl: [a]/ɡɜːrl/; [n]少女;女孩; [or]zk;
give: [a]/ɡɪv/; [v]给,交给 [sw]hive,gibe; [or]zk;
glad: [a]/ɡlæd/; [adj]高兴的;乐意的; [or]zk;
glass-topped: [a]/'glaːsˌtɒpt/; [adj]玻璃罩的; [or]zk;
glass: [a]/ɡlæs/; [n]玻璃;玻璃杯; [v]用玻璃杯击(某人)的脸部; [or]zk;
glory: [a]/ˈɡlɔːri/; [vi]因某事而喜悦,为某事而欣喜; [n]光荣,荣誉; [or]zk;
glove: [a]/ɡlʌv/; [n]手套; [or]zk;
glue: [a]/ɡluː/; [n]胶水; [v]用胶粘; [or]zk;
goal: [a]/ɡoʊl/; [n]目标;球门;(进球)得分; [or]zk;
goat: [a]/ɡoʊt/; [n]山羊; [or]zk;
god: [a]/ɡɑːd/; [n]神; [or]zk;
gold: [a]/ɡoʊld/; [n]黄金,金币; [adj]金的;金制的; [or]zk;
golden: [a]/ˈɡoʊldən/; [adj]金黄色的;贵重的,极好的; [or]zk;
golf: [a]/ɡɑːlf/; [n]高尔夫球运动; [or]zk;
goodness: [a]/ˈɡʊdnəs/; [n]善良;仁慈;优良;精髓; [int]天哪,哎呀; [or]zk;
goods: [a]/ɡʊdz/; [n]货物,商品; [or]zk;
government: [a]/ˈɡʌvərnmənt/; [n]政府;治理;政治; [or]zk;
grade: [a]/ɡreɪd/; [n]等级,成绩; [v]给(试卷或作业)评分;给..分等级; [or]zk;
graduate: [a]/ˈɡrædʒuət/; [v]毕业;渐变;渐渐变为;取得资格;授予.学位; [n]大学毕业生;学位获得者; [adj]毕业的;研究生的; [or]zk;
grammar: [a]/ˈɡræmər/; [n]语法,语法书; [or]zk;
grand: [a]/ɡrænd/; [adj]壮丽的,宏伟的,重大的;傲慢的;极好的; [n]一千美元;大钢琴; [or]zk;
grandchild: [a]/ˈɡræntʃaɪld/; [n]孙子,孙女;孙女; [or]zk;
granddaughter: [a]/ˈɡrændɔːtər/; [n]孙女,外孙女; [or]zk;
grandfather: [a]/ˈɡrænfɑːðər/; [n]祖父,外祖父;祖先; [or]zk;
grandma: [a]/ˈɡrænmɑː/; [n]奶奶,外婆; [or]zk;
grandpa: [a]/ˈɡrænpɑː/; [n]爷爷; [or]zk;
grandparent: [a]/ˈɡrænperənt/; [n]祖父或祖母,祖父母; [or]zk;
grandson: [a]/ˈɡrænsʌn/; [n]孙子,外孙; [or]zk;
granny: [a]/ˈɡræni/; [n]祖母,奶奶,外婆;老奶奶; [adj]奶奶的,老婆婆的; [or]zk;
grape: [a]/ɡreɪp/; [n]葡萄;葡萄藤; [or]zk;
grasp: [a]/ɡræsp/; [v]抓住;领会;理解; [n]紧握;理解;把手; [or]zk;
grass: [a]/ɡræs/; [n]草,草原,草地;<俚>大麻; [v]放牧,种植草;告发; [or]zk;
grateful: [a]/ˈɡreɪtfl/; [adj]感激的;感谢的; [or]zk;
gray: [a]/ɡreɪ/; [adj]灰色的;暗淡的; [n]灰色,暗淡; [v]变灰色,使..变灰色; [or]zk;
great: [a]/ɡreɪt/; [adj]伟大的;重大的;很好的,美妙的;大量的,极大的; [n]大师;大人物;伟人们; [or]zk;
green: [a]/ɡriːn/; [adj]绿色的,青的,草绿色的;缺乏经验的;嫉妒的,眼红的;(赞成)环境保护的;生的,未熟的; [n]绿色;草地,草坪,公共绿地;绿色蔬菜,绿叶蔬菜; [v]使成为绿色,成为绿色,变绿;使..恢复活力; [or]zk;
greengrocer: [a]/ˈɡriːnɡroʊsər/; [n](英)蔬菜水果商; [or]zk;
greet: [a]/ɡriːt/; [v]问候,招呼;对..作出反应; [or]zk;
greeting: [a]/ˈɡriːtɪŋ/; [n]问候,致敬; [or]zk;
ground: [a]/ɡraʊnd/; [n]地面,土壤,场地,原因; [adj]磨细的;剁碎的; [or]zk;
group: [a]/ɡruːp/; [n]群,组; [vi]聚集; [or]zk;
grow: [a]/ɡroʊ/; [v]生长,成长;增长;渐渐变得;种植; [or]zk;
growth: [a]/ɡroʊθ/; [n]生长,发展;增长;肿瘤; [or]zk;
guard: [a]/ɡɑːrd/; [n]警卫员,哨兵,守卫,护卫队; [vi]警惕; [vt]保卫,守护,保护;看守,监视; [or]zk;
guess: [a]/ɡes/; [v]猜测,推测; [n]猜测,推测; [or]zk;
guest: [a]/ɡest/; [n]客人,宾客;旅客;特邀嘉宾; [vi]做特邀嘉宾; [or]zk;
guide: [a]/ɡaɪd/; [n]导游;指南; [v]引导,指导;给.领路;给.导游,带领; [or]zk;
guilty: [a]/ˈɡɪlti/; [adj]内疚的;有罪的; [or]zk;
guitar: [a]/ɡɪˈtɑːr/; [n]吉他,六弦琴; [or]zk;
gun: [a]/ɡʌn/; [n]枪,炮,手枪; [vt]枪击,打开节流阀; [vi]用枪打猎; [or]zk;
guy: [a]/ɡaɪ/; [n]男人;家伙; [or]zk;
gym: [a]/dʒɪm/; [n]体育馆,健身房;体育; [or]zk;
habit: [a]/ˈhæbɪt/; [n]习惯,习性,脾性; [or]zk;
hair: [a]/her/; [n]头发,毛发;毛; [or]zk;
haircut: [a]/ˈherkʌt/; [n]理发,发型; [or]zk;
half: [a]/hæf/; [n]半,一半; [adj]一半的; [or]zk;
hall: [a]/hɔːl/; [n]会堂,门厅,过道;学生宿舍,学生食堂; [or]zk;
ham: [a]/hæm/; [n]火腿; [adj]做作的,蹩脚的; [or]zk;
hamburger: [a]/ˈhæmbɜːrɡər/; [n]汉堡包;煎牛肉饼; [or]zk;
hand: [a]/hænd/; [n]手;手掌;指针;掌管; [vt]传递;交给;搀扶;支持; [or]zk;
handbag: [a]/ˈhændbæɡ/; [n](女用)手提包; [or]zk;
handkerchief: [a]/ˈhæŋkərtʃɪf/; [n]手帕;头巾;方巾; [or]zk;
handsome: [a]/ˈhænsəm/; [adj]英俊的,帅气的;漂亮的,大方的; [or]zk;
handwriting: [a]/ˈhændraɪtɪŋ/; [n]笔迹,字迹;书写;亲手写; [or]zk;
hang: [a]/hæŋ/; [v]吊死,悬挂,悬浮;垂下; [n]悬挂;绞刑; [or]zk;
happen: [a]/ˈhæpən/; [v]发生,碰巧,出现,偶遇;碰巧;恰好; [or]zk;
happiness: [a]/ˈhæpinəs/; [n]幸福,快乐; [or]zk;
happy: [a]/ˈhæpi/; [adj]快乐的;幸福的; [or]zk;
hard: [a]/hɑːrd/; [adj]坚硬的,困难的,严厉的; [adv]努力地,艰难地,费力地;猛烈地,重重地; [or]zk;
hardly: [a]/ˈhɑːrdli/; [adv]几乎不,简直不; [or]zk;
harm: [a]/hɑːrm/; [n]伤害,损害; [v]伤害; [or]zk;
harvest: [a]/ˈhɑːrvɪst/; [v]收割; [n]收获; [or]zk;
hat: [a]/hæt/; [n]帽子(一般指有边的); [v]给..戴上帽子,为..提供帽子;供应帽子;制造帽子; [or]zk;
hate: [a]/heɪt/; [v]恨,憎恨;不喜欢; [n]恨,憎恶; [or]zk;
head: [a]/hed/; [n]头;上端;领导人; [v]率领;前进;出发; [or]zk;
headache: [a]/ˈhedeɪk/; [n]头痛;头痛的事; [or]zk;
headline: [a]/ˈhedlaɪn/; [n]大字标题;新闻摘要; [v]给..加标题;担当主角; [or]zk;
headmaster: [a]/ˌhedˈmæstər/; [n]男校长(尤指私立学校); [or]zk;
headmistress: [a]/ˌhedˈmɪstrəs/; [n]女校长; [or]zk;
headteacher: [a]/ˌhedˈtiːtʃər/; [n](中小学的)校长; [or]zk;
heal: [a]/hiːl/; [v]治愈,治疗;痊愈;恢复; [or]zk;
health: [a]/helθ/; [n]健康,健康状况; [or]zk;
healthy: [a]/ˈhelθi/; [adj]健康的;健全的;有益健康的;合理的;兴旺发达的; [or]zk;
hear: [a]/hɪr/; [vi]听见; [vt]审讯;听说;听,听见; [or]zk;
hearing: [a]/ˈhɪrɪŋ/; [n]听觉;听距;听证会;申辩的机会; [v]听到; [or]zk;
heart: [a]/hɑːrt/; [n]心,内心;勇气; [or]zk;
heat: [a]/hiːt/; [n]高温;压力;热度;<物理学>热;热烈; [vt]给..加热;使激动,激发; [or]zk;
heaven: [a]/ˈhevn/; [n]天国;天堂;乐土;极乐世界; [or]zk;
heavy: [a]/ˈhevi/; [adj]沉重的;重的;大量的;浓密的;重型的; [n]重物;保镖; [adv]密集地;大量地;笨重地; [or]zk;
heel: [a]/hiːl/; [n]脚后跟;(鞋)后跟; [v]给(鞋)钉后掌,倾侧,紧跟; [or]zk;
height: [a]/haɪt/; [n]高,高度;高处;非常,极度; [or]zk;
helicopter: [a]/ˈhelɪkɑːptər/; [n]直升机; [v]用直升飞机载送,乘直升机; [or]zk;
hello: [a]/həˈloʊ/; [int]喂(打电话时的招呼语);哈啰; [n]你好(打招呼用语);表示问候,惊奇或唤起注意时的用语; [or]zk;
help: [a]/help/; [v]帮助;援助; [n]帮助; [or]zk;
helpful: [a]/ˈhelpfl/; [adj]肯帮忙的,给予帮助的;有用的; [or]zk;
hen: [a]/hen/; [n]母鸡,雌禽; [or]zk;
here: [a]/hɪr/; [adv]这里;在这里,到这里,从这里,朝这里; [n]这里; [int]嘿;喂(用于引起注意); [or]zk;
hero: [a]/ˈhɪroʊ/; [n]英雄;男主角;勇士; [or]zk;
hers: [a]/hɜːrz/; [pron]她的(所有格代词); [or]zk;
herself: [a]/hɜːrˈself/; [pron]她自己;她本人; [or]zk;
hide: [a]/haɪd/; [vt]躲藏,把.藏起来;隐瞒; [n]藏身处;隐密场所,隐蔽处;(尤指买卖或用作皮革的)皮;兽皮;人身安全; [or]zk;
high: [a]/haɪ/; [n]高处;天空;高潮;最高水平; [adj]高的;昂贵的;高级的;高尚的;高傲的; [adv]高;高高地;高价地;强烈地;奢侈地; [or]zk;
highway: [a]/ˈhaɪweɪ/; [n]大路,高速公路;公路; [or]zk;
hike: [a]/haɪk/; [n]远足,徒步旅行;(数量,价格等)增加,上升; [v]作长途徒步旅行;使高涨,提高(价格); [or]zk;
hill: [a]/hɪl/; [n]小山,山岗;斜坡; [or]zk;
himself: [a]/hɪmˈself/; [pron]他自己;他亲自; [or]zk;
hire: [a]/ˈhaɪər/; [v]雇用,出租; [n]租金,雇用,租用; [or]zk;
history: [a]/ˈhɪstri/; [n]历史,历史课;历史记录; [or]zk;
hit: [a]/hɪt/; [v]打击;命中;完成(指标);偶然遇见;突然想到; [n]击打;碰撞;得分;风行一时的作品;引人注意的东西,技巧; [or]zk;
hobby: [a]/ˈhɑːbi/; [n]业余爱好,癖好; [or]zk;
hold: [a]/hoʊld/; [n]掌握;拥有;货仓; [vt]掌握;拥有;拿住,握住; [vi]拿住;同意,赞成;保持不变;有效; [or]zk;
holiday: [a]/ˈhɑːlədeɪ/; [n]假日,节日,假期,休假; [v]度假,休假; [adj]节日适用的;活泼的; [or]zk;
home: [a]/hoʊm/; [n]家,家庭; [adj]家的;主场的;本国的; [adv]在家,到家;到正确的位置; [v]回家,有家,朝向,自动导航; [or]zk;
homeland: [a]/ˈhoʊmlænd/; [n]祖国;家园,故乡; [or]zk;
hometown: [a]/ˈhoʊmtaʊn/; [n]故乡; [or]zk;
homework: [a]/ˈhoʊmwɜːrk/; [n]家庭作业,功课;(重要活动之前的)准备工作; [or]zk;
honest: [a]/ˈɑːnɪst/; [adj]诚实的;正直的,坦率的; [or]zk;
honor: [a]/'ɑːnər/; [n]荣誉,荣幸; [v]尊敬,使荣幸,对..表示敬意; [or]zk;
hooray: [a]/huˈreɪ/; [int]万岁; [or]zk;
hope: [a]/hoʊp/; [n]希望; [v]希望; [or]zk;
hopeful: [a]/ˈhoʊpfl/; [adj]有希望的;怀有希望的;给人以希望的; [n]希望能成功的人; [or]zk;
hopeless: [a]/ˈhoʊpləs/; [adj]没有希望的,绝望的,不能胜任的,无望的; [or]zk;
horrible: [a]/ˈhɔːrəbl/; [adj]可怕的,恐怖的;讨厌的,糟糕的;粗鲁的,不友好的; [or]zk;
horse: [a]/hɔːrs/; [n]马;马科动物; [or]zk;
hospital: [a]/ˈhɑːspɪtl/; [n]医院; [or]zk;
host: [a]/hoʊst/; [n]东道主,主持人;大量; [v]主持,主办; [or]zk;
hostess: [a]/ˈhoʊstəs/; [n]女主人,女主持人,女服务员(乘务员); [or]zk;
hot: [a]/hɑːt/; [adj]热的,辣的,强烈的; [adv]激动地,趁热地; [v](使)变热; [or]zk;
hotdog: [a]/'hɒtˌdɒg/; [n]热狗(面包); [vi]卖弄,出风头; [or]zk;
hotel: [a]/hoʊˈtel/; [n]酒店,旅馆,饭店,宾馆; [or]zk;
hour: [a]/ˈaʊər/; [n]小时;时间,时刻; [or]zk;
house: [a]/haʊs/; [n]房屋,住宅;商号;议会;机构; [v]覆盖;给.房子住; [or]zk;
household: [a]/ˈhaʊshoʊld/; [n]同住在一家的人;家务;家常普通的; [adj]家庭的,家内的,一家的;家喻户晓的; [or]zk;
housewife: [a]/ˈhaʊswaɪf/; [n]家庭主妇; [or]zk;
housework: [a]/ˈhaʊswɜːrk/; [n]家务,劳动,家务事; [or]zk;
however: [a]/haʊˈevər/; [adv]然而,不过;无论如何,不管多么; [or]zk;
huge: [a]/hjuːdʒ/; [adj]巨大的; [or]zk;
human: [a]/ˈhjuːmən/; [n]人; [adj]人的,人类的; [or]zk;
humor: [a]/ˈhjuːmər/; [n]幽默,诙谐; [or]zk;
hundred: [a]/ˈhʌndrəd/; [num]百,百个; [n]许多; [or]zk;
hunger: [a]/ˈhʌŋɡər/; [n]饥饿;渴望; [v]渴望,饥饿; [or]zk;
hungry: [a]/ˈhʌŋɡri/; [adj]饥饿的;渴望的; [or]zk;
hunt: [a]/hʌnt/; [n]打猎;搜寻; [v]打猎;搜索;猎杀,追捕; [or]zk;
hunter: [a]/ˈhʌntər/; [n]猎人;猎犬;搜寻者;猎户座; [or]zk;
hurry: [a]/ˈhɜːri/; [n]匆忙,急忙; [vi]赶紧; [vt]催促; [or]zk;
hurt: [a]/hɜːrt/; [v]使受伤;疼痛,感到痛苦; [or]zk;
husband: [a]/ˈhʌzbənd/; [n]丈夫; [v]节约,节俭,节省,节用; [or]zk;
hydrogen: [a]/ˈhaɪdrədʒən/; [n]氢,氢气; [or]zk;
ice: [a]/aɪs/; [n]冰,冰块; [v]冰镇; [or]zk;
iceberg: [a]/ˈaɪsbɜːrɡ/; [n]冰山; [or]zk;
idea: [a]/aɪˈdiːə/; [n]想法,主意;思想,概念; [or]zk;
identity: [a]/aɪˈdentəti/; [n]身份;特性;一致; [or]zk;
idiom: [a]/ˈɪdiəm/; [n]习语;成语;惯用语法; [or]zk;
ill: [a]/ɪl/; [adj]生病的,有病的;坏的;恶意的,引起痛苦的; [adv]恶劣地,勉强地; [n]邪恶,不幸,祸害,坏话; [or]zk;
illegal: [a]/ɪˈliːɡl/; [adj]不合法的,非法的; [n]非法移民,非法劳工;间谍; [or]zk;
illness: [a]/ˈɪlnəs/; [n]病,疾病; [or]zk;
imagine: [a]/ɪˈmædʒɪn/; [v]想象;设想;料想;认为; [or]zk;
immediately: [a]/ɪˈmiːdiətli/; [adv]立即,马上;直接地;靠近地; [conj]一..(就); [or]zk;
importance: [a]/ɪmˈpɔːrtns/; [n]重要;重要性; [or]zk;
important: [a]/ɪmˈpɔːrtnt/; [adj]重要的,重大的,有地位的,有权力的; [or]zk;
impossible: [a]/ɪmˈpɑːsəbl/; [adj]不可能的; [n]不可能的事; [or]zk;
impress: [a]/ɪmˈpres/; [v]使有印象,使铭记; [or]zk;
impression: [a]/ɪmˈpreʃn/; [n]印记;印象,感觉,感想;压痕; [or]zk;
improve: [a]/ɪmˈpruːv/; [v]改进,改善,提高; [or]zk;
inch: [a]/ɪntʃ/; [n]英寸;少许,少量; [vi]缓慢地移动; [vt]使缓慢地移动,使渐进; [or]zk;
incident: [a]/ˈɪnsɪdənt/; [n]事件;事变,军事冲突,冲突;事故; [adj]<法>附带的;<光>入射的;易发生的,伴随而来的; [or]zk;
include: [a]/ɪnˈkluːd/; [v]包括,包含,列入; [or]zk;
income: [a]/ˈɪnkʌm/; [n]收入; [or]zk;
increase: [a]/ɪnˈkriːs/; [v]增加,提高; [n]增加,增强,提高; [or]zk;
indeed: [a]/ɪnˈdiːd/; [adv]的确,真正地,事实上; [or]zk;
independent: [a]/ˌɪndɪˈpendənt/; [adj]独立自主的,独自的,无偏见的; [n]无党派者,独立派人士; [or]zk;
industry: [a]/ˈɪndəstri/; [n]工业,产业;勤劳;专题研究; [or]zk;
influence: [a]/ˈɪnfluəns/; [n]影响,势力;有影响的人或事; [v]影响; [or]zk;
information: [a]/ˌɪnfərˈmeɪʃn/; [n]信息,情报,资料,通知; [or]zk;
injection: [a]/ɪnˈdʒekʃn/; [n]打针;注射,注入;充满; [or]zk;
injury: [a]/ˈɪndʒəri/; [n]损害,伤害;受伤; [or]zk;
ink: [a]/ɪŋk/; [n]墨水,油墨; [or]zk;
inn: [a]/ɪn/; [n]客栈,小旅馆; [or]zk;
innocent: [a]/ˈɪnəsnt/; [adj]天真的,单纯的;无辜的,清白的;无恶意的; [n]天真无邪的人; [or]zk;
insect: [a]/ˈɪnsekt/; [n]昆虫; [or]zk;
insert: [a]/ɪnˈsɜːrt/; [vt]插入,嵌入; [n]插入物;插页; [or]zk;
inside: [a]/ˌɪnˈsaɪd/; [adj]里面的,内部的,内幕的; [adv]在里面,在内部; [n]内部,里面,内侧; [prep]在..里,在..内; [or]zk;
insist: [a]/ɪnˈsɪst/; [v]坚持;坚持要求;坚持认为; [or]zk;
inspect: [a]/ɪnˈspekt/; [v]检查,审查; [or]zk;
inspector: [a]/ɪnˈspektər/; [n]检查员,督察员;视察者,检阅者;(英)查票员; [or]zk;
instant: [a]/ˈɪnstənt/; [n]瞬间; [adj]立即的;即食的;紧急的; [or]zk;
instead: [a]/ɪnˈsted/; [adv]代替,顶替,反而; [or]zk;
instruct: [a]/ɪnˈstrʌkt/; [v]指导;教;指示;通知; [or]zk;
instruction: [a]/ɪnˈstrʌkʃn/; [n]说明;指令,命令;指示;指导,讲授; [adj]说明用法的;操作指南的; [or]zk;
instrument: [a]/ˈɪnstrəmənt/; [n]仪器;工具;乐器;手段; [or]zk;
intelligence: [a]/ɪnˈtelɪdʒəns/; [n]智力;情报;理解力; [or]zk;
intention: [a]/ɪnˈtenʃn/; [n]意图,意向,目的,打算; [or]zk;
interest: [a]/ˈɪntrəst/; [n]兴趣;利息;利益; [v]使感兴趣; [or]zk;
interested: [a]/ˈɪntrəstɪd/; [adj]感兴趣的;有权益的; [or]zk;
interesting: [a]/ˈɪntrəstɪŋ/; [adj]有趣的,吸引人的; [or]zk;
international: [a]/ˌɪntərˈnæʃnəl/; [adj]国际的,世界的; [n]国际比赛,参加国际运动或体育比赛的选手,外国人; [or]zk;
internet: [a]/'ɪntərnet/; [n]互联网,英特网; [or]zk;
interpreter: [a]/ɪnˈtɜːrprɪtər/; [n]口译员,口译者; [or]zk;
interrupt: [a]/ˌɪntəˈrʌpt/; [v]打扰;打断,中断;插嘴;妨碍; [or]zk;
interview: [a]/ˈɪntərvjuː/; [n]面谈,面试,采访; [v]面试,采访; [or]zk;
introduce: [a]/ˌɪntrəˈduːs/; [v]介绍;传入,引进;提出;采用; [or]zk;
introduction: [a]/ˌɪntrəˈdʌkʃn/; [n]介绍;引进;引言; [or]zk;
invent: [a]/ɪnˈvent/; [v]发明;编造; [or]zk;
invention: [a]/ɪnˈvenʃn/; [n]发明,发明物;虚构;发明才能; [or]zk;
inventor: [a]/ɪnˈventər/; [n]发明家; [or]zk;
invitation: [a]/ˌɪnvɪˈteɪʃn/; [n]请柬;邀请;招致; [or]zk;
invite: [a]/ɪnˈvaɪt/; [v]邀请;招待;招致; [or]zk;
iron: [a]/ˈaɪərn/; [v]烫(衣),熨; [n]铁;熨斗; [adj]铁的;刚强的;严酷的; [or]zk;
island: [a]/ˈaɪlənd/; [n]岛,岛屿; [or]zk;
itself: [a]/ɪtˈself/; [pron]它自己;自身,本身; [or]zk;
jacket: [a]/ˈdʒækɪt/; [n]短上衣,夹克衫;(书籍的)护封;唱片套; [v]穿上夹克; [or]zk;
jam: [a]/dʒæm/; [n]果酱;阻塞; [v](使)阻塞,使塞满; [or]zk;
jar: [a]/dʒɑːr/; [n]罐坛,广口瓶,坛子,刺耳声,震动; [v]冲突,震动,刺激,发出刺耳声;刺激(神经);给.不快之感(神经); [or]zk;
jaw: [a]/dʒɔː/; [n]颌,颚,下巴; [v]唠唠叨叨,喋喋不休; [or]zk;
jazz: [a]/dʒæz/; [n]爵士乐; [or]zk;
jeans: [a]/dʒiːnz/; [n]牛仔裤;工装裤; [or]zk;
jeep: [a]/dʒiːp/; [n]吉普车; [or]zk;
jewelry: [a]/ˈdʒuːəlri/; [n]珠宝; [or]zk;
job: [a]/dʒɑːb/; [n]职业,职位;工作;责任; [or]zk;
join: [a]/dʒɔɪn/; [v]参加;加入;结合; [n]连接,结合,接合点; [or]zk;
joke: [a]/dʒoʊk/; [v]说笑话; [n]笑话; [or]zk;
journalist: [a]/ˈdʒɜːrnəlɪst/; [n]记者,新闻工作者; [or]zk;
journey: [a]/ˈdʒɜːrni/; [n]旅行,旅程; [v]旅行; [or]zk;
joy: [a]/dʒɔɪ/; [n]欢乐,喜悦,乐事; [or]zk;
judge: [a]/dʒʌdʒ/; [v]判决,审判,评价; [n]裁判员;法官;鉴赏者; [or]zk;
judgment: [a]/'dʒʌdʒmənt/; [n]审判,宣判;意见,看法;判断力; [or]zk;
juice: [a]/dʒuːs/; [n]液,(水果等)汁; [v]榨汁; [or]zk;
jump: [a]/dʒʌmp/; [v]跳;暴涨; [n]跳跃,跳,跃; [or]zk;
jungle: [a]/ˈdʒʌŋɡl/; [n]丛林,密林;危险地带;丛林音乐; [or]zk;
junior: [a]/ˈdʒuːniər/; [adj]年少的;下级的;低年级的; [n]年少者,晚辈;(美国四年制大学)三年级学生;职位较低者; [or]zk;
justice: [a]/ˈdʒʌstɪs/; [n]正义;公平;合理;妥当;应得的赏罚;审判;审判员; [or]zk;
kangaroo: [a]/ˌkæŋɡəˈruː/; [n]袋鼠; [or]zk;
keep: [a]/kiːp/; [v]保持,坚持,保留,继续,贮藏,经营,遵守,供给,照管; [n]保持,保养;城堡主楼;生活,生计;饲料;牧草; [or]zk;
kettle: [a]/ˈketl/; [n]茶壶; [or]zk;
key: [a]/kiː/; [n]钥匙;键;答案;(达到目的或解决问题的)方法,手段,关键,要诀;<音>调,主音; [adj]关键的; [v]用键盘输入,键控,发报; [or]zk;
keyboard: [a]/ˈkiːbɔːrd/; [n]键盘;琴键; [v]录入信息; [or]zk;
kick: [a]/kɪk/; [v]踢;踢腿; [n]踢; [or]zk;
kid: [a]/kɪd/; [n]小孩,儿童;年轻人;小山羊; [v]开玩笑,欺骗; [adj]年幼的;小山羊皮制的; [or]zk;
kill: [a]/kɪl/; [v]杀死;消磨(时间);使停止;缓解 (疼痛等); [or]zk;
kilo: [a]/ˈkiːloʊ/; [n]公斤;千克;公里(等于kilogram); pref. 表示"千"; [or]zk;
kilometer: [a]/kɪˈlɑːmɪtər/; [n]千米,公里; [or]zk;
kind-hearted: [a]/ˌkaɪnd ˈhɑːrtɪd/; [adj]好心的; [or]zk;
kind: [a]/kaɪnd/; [n]种类; [adj]善良的,仁慈的,亲切的,和蔼的; [or]zk;
kindergarten: [a]/ˈkɪndərɡɑːrtn/; [n]幼儿园; [or]zk;
kindness: [a]/ˈkaɪndnəs/; [n]仁慈,亲切;好意;友好行为; [or]zk;
king: [a]/kɪŋ/; [n]国王,君主; [or]zk;
kingdom: [a]/ˈkɪŋdəm/; [n]王国,领域; [or]zk;
kiss: [a]/kɪs/; [v]吻,接吻; [n]吻; [or]zk;
kitchen: [a]/ˈkɪtʃɪn/; [n]厨房;炊具; [or]zk;
kite: [a]/kaɪt/; [n]风筝; [vt]涂改(支票),骗钱; [or]zk;
knee: [a]/niː/; [n]膝,膝盖; [vt]用膝盖碰; [or]zk;
knife: [a]/naɪf/; [n]小刀,刀,餐刀; [v]用刀切割; [or]zk;
knock: [a]/nɑːk/; [v]敲击,重击; [n]敲,敲门,打击; [or]zk;
know-all: [a]/ˈnoʊ ɔːl/; [n]自以为无所不知的人; [adj]自以为无所不知的; [or]zk;
know: [a]/noʊ/; [v]知道;认识;通晓; [n]知情; [or]zk;
knowledge: [a]/ˈnɑːlɪdʒ/; [n]知识,学识,知道,了解; [or]zk;
lab: [a]/læb/; [n]实验室,研究室; [or]zk;
labor: [a]/'leɪbər/; [n]劳动,劳力,劳工; [v]劳动,苦干; [adj]劳动的; [or]zk;
ladder: [a]/ˈlædər/; [n]梯子,阶梯; [vi](长筒袜等)抽丝; [or]zk;
lady: [a]/ˈleɪdi/; [n]女士,夫人; [or]zk;
lake: [a]/leɪk/; [n]湖; [or]zk;
lamb: [a]/læm/; [n]小羊;羊羔肉; [or]zk;
lamp: [a]/læmp/; [n]灯,台灯; [or]zk;
land: [a]/lænd/; [n]陆地,土地;国土,国家; [v](使)登陆;(使)着陆; [or]zk;
language: [a]/ˈlæŋɡwɪdʒ/; [n]语言,语言文字,表达方式; [or]zk;
lap: [a]/læp/; [n]腰以下及大腿的前面部分;(跑道的)一圈; [v](赛跑中)比(某人)领先一圈;轻拍; [or]zk;
laptop: [a]/ˈlæptɑːp/; [n]笔记本电脑; [adj]膝上型的; [or]zk;
large: [a]/lɑːrdʒ/; [adj]大量的;大的; [n]自由(现仅用于at large,in the large);大号,大尺寸; [adv]夸大地; [v](尤指跳舞和饮酒)作乐; [or]zk;
last: [a]/læst/; [det]末尾的,最后(剩下)的,最终的;最新(流行)的,最时髦的; [v]度过,拖过;持续,继续,延续,存续; [n]最后,最终,终于;上个;末尾; [adv]最后,终于,最终,终结;最近; [or]zk;
late: [a]/leɪt/; [adj]已故的;去世不久的;最近的;迟的;晚期的,后期的; [adv]迟,晚; [or]zk;
lately: [a]/ˈleɪtli/; [adv]最近; [or]zk;
later: [a]/ˈleɪtər/; [adv]后来;过一会儿; [adj]后来的;以后的;接近末期的; [or]zk;
laugh: [a]/læf/; [v]笑,发笑; [n]笑; [or]zk;
laughter: [a]/ˈlæftər/; [n]笑,笑声; [or]zk;
law: [a]/lɔː/; [n]法律,法令,法则; [or]zk;
lawyer: [a]/ˈlɔːjər/; [n]律师; [or]zk;
lay: [a]/leɪ/; [vt]躺着,置放,铺设;下蛋;设置; [adj]世俗的;外行的;没有经验的; [n]叙事诗;性伙伴; [or]zk;
lazy: [a]/ˈleɪzi/; [adj]懒惰的;懒散的;慢吞吞的; [or]zk;
lead: [a]/liːd/; [v]带领;领导;导致; [n]带领;引导;铅; [or]zk;
leader: [a]/ˈliːdər/; [n]领导,领袖,指挥者,领先的人; [or]zk;
leaf: [a]/liːf/; [n]叶,叶子; [or]zk;
league: [a]/liːɡ/; [n]联盟;社团;里格(=3.18海里); [v]使..结盟,与..联合; [or]zk;
leak: [a]/liːk/; [v]漏;泄露; [n]漏洞;泄漏,裂缝; [or]zk;
learn: [a]/lɜːrn/; [v]学习; [or]zk;
least: [a]/liːst/; [adj]最小的,最少的; [adv]最少地,最小地; [n]最小,最少量; [or]zk;
leather: [a]/ˈleðər/; [n]皮革;皮制品; [vt]用皮鞭抽打;用皮革覆盖; [or]zk;
leave: [a]/liːv/; [v]离开;留下; [n]许可,准假;告别; [or]zk;
left: [a]/left/; [adv]在左边,往左边; [adj]左边的; [n]左边;左派,激进分子; [or]zk;
leg: [a]/leɡ/; [n]腿,腿部; [v]逃逸,逃跑; [or]zk;
legal: [a]/ˈliːɡl/; [adj]合法的,法定的;法律的; [or]zk;
lemon: [a]/ˈlemən/; [n]柠檬;柠檬黄;柠檬汁; [adj]浅黄色的; [or]zk;
lemonade: [a]/ˌleməˈneɪd/; [n]柠檬水; [or]zk;
lend: [a]/lend/; [v]把.借给,贷(款); [or]zk;
length: [a]/leŋθ/; [n]长,长度,持续时间;一段 (绳子,布,木头等); [or]zk;
less: [a]/les/; [det]更少的; [adv]更少地; [or]zk;
lesson: [a]/ˈlesn/; [n]功课,课;课程;教训,经验; [or]zk;
let: [a]/let/; [v]允许,让;使; [n]出租;阻碍;(网球等)触网重发; [or]zk;
letter: [a]/ˈletər/; [n]信;证书;字母; [vt]用字母标明;加标题; [or]zk;
level: [a]/ˈlevl/; [n]水平面,水平,标准,等级; [vi]瞄准;拉平; [adj]水平的;平坦的;等高的; [vt]使平等;对准目标; [or]zk;
liberation: [a]/ˌlɪbəˈreɪʃn/; [n]解脱,解放; [or]zk;
librarian: [a]/laɪˈbreriən/; [n]图书管理员,图书馆馆长; [or]zk;
library: [a]/ˈlaɪbreri/; [n]图书馆,藏书室;出租图书室;丛书;藏书;保存的资料; [or]zk;
license: [a]/ˈlaɪsns/; [n]许可;执照; [v]许可,准许;发许可证; [or]zk;
lid: [a]/lɪd/; [n]盖,盖子; [or]zk;
lie: [a]/laɪ/; [n]谎话,假象; [vi]躺,位于;说谎,欺骗; [or]zk;
life: [a]/laɪf/; [n]生命;生活,生存; [or]zk;
lifestyle: [a]/ˈlaɪfstaɪl/; [n]生活方式; [adj]关于时尚生活的 (杂志,电视节目,产品等); [or]zk;
lifetime: [a]/ˈlaɪftaɪm/; [n]寿命,一生,终身;使用期,有效期限; [adj]一生的,终生的; [or]zk;
lift: [a]/lɪft/; [v](使)升起,举起;偷窃;运送;解除,终止;抄袭,偷窃; [n]<英>电梯;举起;免费搭车;情绪激昂,精神振奋; [or]zk;
light: [a]/laɪt/; [v]点火,照亮; [adj]轻的;明亮的;不严重的; [n]光亮;灯; [adv]轻轻地; [or]zk;
lightning: [a]/ˈlaɪtnɪŋ/; [n]闪电;意外的好运; [vi]闪电; [adj]闪电的;闪电般的,迅速的; [or]zk;
like: [a]/laɪk/; [prep]像; [v]喜欢; [adj]相似的; [n]相类似的人或事物;爱好; [conj]像.一样;如同,好像,仿佛; [adv](非正式口语,代替 as)和.一样,如;(非正式口语,思考说下句话,解释或举例时用)大概;可能; [or]zk;
likely: [a]/ˈlaɪkli/; [adj]有可能;可信的;适合的; [adv]很可能; [or]zk;
limit: [a]/ˈlɪmɪt/; [n]界限,限度,范围; [v]限制,限定; [or]zk;
line: [a]/laɪn/; [n]线,排,路线; [v]画线;排队; [or]zk;
lion: [a]/ˈlaɪən/; [n]狮子; [or]zk;
lip: [a]/lɪp/; [n]嘴唇;唇状物; [v]接吻;说话;拍打; [adj]唇的;口头上的; [or]zk;
liquid: [a]/ˈlɪkwɪd/; [n]液体; [adj]液体的;清脆的; [or]zk;
list: [a]/lɪst/; [n]目录,表,名单;倾斜; [v]列举;记入名单内; [or]zk;
listen: [a]/ˈlɪsn/; [v]听,倾听;听从,听信; [n]听,倾听; [or]zk;
liter: [a]/ˈliːtər/; [n](=litre)升,公升; [or]zk;
literary: [a]/ˈlɪtəreri/; [adj]文学的,文学上的;精通文学的;以写作为职业的;书本上的;书面的;书面语的; [or]zk;
literature: [a]/ˈlɪtrətʃər/; [n]文学;宣传册;文献; [or]zk;
litter: [a]/ˈlɪtər/; [n]垃圾;杂乱; [v]乱丢; [or]zk;
little: [a]/ˈlɪtl/; [adj]幼小的,小的;少的; [adv]甚少,毫不,难得; [det]几乎没有; [or]zk;
live: [a]/lɪv/; [v]活着,过着,居住; [adj]直播的;实况播送的;现场的; [adv]现场; [or]zk;
lively: [a]/ˈlaɪvli/; [adj]活泼的,生动的;轻快的,富有活力的;生机勃勃的; [or]zk;
load: [a]/loʊd/; [v]使担负;装载;加载;填装; [vi]装货; [n]负载;负荷;工作量;装载量; [or]zk;
local: [a]/ˈloʊkl/; [adj]当地的,本地的;(身体)局部的; [n]当地人; [or]zk;
lock: [a]/lɑːk/; [n]锁; [v]锁上,锁住; [or]zk;
locust: [a]/ˈloʊkəst/; [n]蝗虫; [or]zk;
lodge: [a]/lɑːdʒ/; [v]住宿;存放,保管; [n]小屋;兽穴; [or]zk;
lonely: [a]/ˈloʊnli/; [adj]孤独的,孤单的;荒凉的; [or]zk;
long: [a]/lɔːŋ/; [adj]长的,远的,长久的,长期的; [adv]长久,长期地; [v](for)渴望,极想; [or]zk;
look: [a]/lʊk/; [v]看,显得; [n]看,浏览;样子; [or]zk;
loose: [a]/luːs/; [adj]宽松的;(指言行等)不严谨的; [v]放松; [n]自由; [adv]松散地;不严格地; [or]zk;
lorry: [a]/ˈlɔːri/; [n]卡车;运货汽车; [or]zk;
lose: [a]/luːz/; [vt]失去;丧失;遗失;浪费;亏损; [vi](在竞争或比赛中)输掉; [or]zk;
lot: [a]/lɑːt/; [pron]大量,许多;场地;一批;某一类人; [adv](与形容词和副词连用)很;非常;(与动词连用)非常; [v]分组;把.划分(常与out连用);把(土地)划分成块;抽签;拈阄; [or]zk;
loud: [a]/laʊd/; [adj]大声的,吵闹的,喧嚣的; [or]zk;
loudspeaker: [a]/ˌlaʊdˈspiːkər/; [n]喇叭,扬声器,扩音器; [or]zk;
love: [a]/lʌv/; [v]爱,喜欢; [n]爱; [or]zk;
lovely: [a]/ˈlʌvli/; [adj]可爱的;令人愉快的; [n]美女,美人,佳人;漂亮的东西; [or]zk;
low: [a]/loʊ/; [adj]低的,矮的;低下的; [adv]低声地;谦卑地;低下地; [n]低点;低水平;牛的叫声; [vi](牛)哞哞叫; [or]zk;
luck: [a]/lʌk/; [n]运气,好运,幸运; [or]zk;
lucky: [a]/ˈlʌki/; [adj]幸运的;吉祥的,带来好运的; [or]zk;
lunch: [a]/lʌntʃ/; [n]午餐,(美)便餐; [v]吃(午餐),提供(午餐); [or]zk;
machine: [a]/məˈʃiːn/; [n]机器,机械; [v]用机器加工; [or]zk;
mad: [a]/mæd/; [adj]异常狂暴的;蠢笨的;精神错乱的;疯狂的;狂热的;生气的,狂怒的; [n]狂怒; [or]zk;
madam: [a]/ˈmædəm/; [n]夫人;女士; [or]zk;
magazine: [a]/ˈmæɡəziːn/; [n]杂志,期刊;弹夹;弹药库; [or]zk;
magic: [a]/ˈmædʒɪk/; [n]魔术,戏法;魔法; [adj]有魔力的,魔术的; [or]zk;
magical: [a]/ˈmædʒɪkl/; [adj]不可思议的;有魔力的;魔术的,魔法的; [or]zk;
mail: [a]/meɪl/; [v]邮寄; [n]邮件; [or]zk;
mailbox: [a]/ˈmeɪlbɑːks/; [n]邮筒;邮箱; [or]zk;
main: [a]/meɪn/; [adj]主要的,最重要的; [n]干线,总管道; [or]zk;
mainland: [a]/ˈmeɪnlænd/; [n]大陆; [adj]大陆的; [or]zk;
make: [a]/meɪk/; [v]使;做,制造;使成为;使产生;生产,制定; [n]制造,生产量;性格;形状,样式; [or]zk;
male: [a]/meɪl/; [n]男性,雄性; [adj]男性的,雄性的; [or]zk;
man-made: [a]/ˌmæn ˈmeɪd/; [adj]人造的,人工的,合成的; [or]zk;
manage: [a]/ˈmænɪdʒ/; [v]管理;控制;设法做成;有时间做,安排(时间)做;应付过去,设法对付过去; [n]马术练习所; [or]zk;
manager: [a]/ˈmænɪdʒər/; [n]经理,管理人; [or]zk;
map: [a]/mæp/; [v]测绘,为..绘制地图; [n]地图;路线图;天体图; [or]zk;
march: [a]/mɑːrtʃ/; [n]行军,游行示威,三月; [vi]行军,前进;游行示威; [vt]使前进;使行军; [or]zk;
mark: [a]/mɑːrk/; [v]打分数; [vt]在..上作记号,标记出; [n]分数;污点,痕迹;记号,符号,标志; [or]zk;
market: [a]/ˈmɑːrkɪt/; [n]市场;行情;销路; [v]销售;出售; [or]zk;
marriage: [a]/ˈmærɪdʒ/; [n]结婚;婚姻;婚礼;密切结合; [or]zk;
married: [a]/ˈmærid/; [adj]已婚的,夫妇的;密切结合的; [or]zk;
marry: [a]/ˈmæri/; [v]娶,嫁,结婚; [or]zk;
mask: [a]/mæsk/; [n]面具;遮蔽物;伪装; [v]隐藏(感情);掩盖,掩饰,掩护;伪装; [or]zk;
master: [a]/ˈmæstər/; [n]主人;大师;硕士; [adj]精通的,主要的; [v]掌握,精通; [or]zk;
match: [a]/mætʃ/; [n]比赛;敌手;伙伴,搭档;婚姻,配偶;火柴; [v]使相配,使对抗; [or]zk;
math: [a]/mæθ/; [n]数学;计算过程; [or]zk;
matter: [a]/ˈmætər/; [v]要紧;有关系; [n]问题,事件,物质; [or]zk;
may: [a]/meɪ/; aux. 可以,能够,可能,也许,祝,愿; [or]zk;
maybe: [a]/ˈmeɪbi/; [adv]可能,大概,也许; [n]不确定性; [or]zk;
meal: [a]/miːl/; [n]膳食,一餐; [or]zk;
mean: [a]/miːn/; [n]平均值,中庸; [v]意思是,打算,导致; [adj]吝啬的,低劣的,刻薄的,卑鄙的,平均的,中等的; [or]zk;
meaning: [a]/ˈmiːnɪŋ/; [n]意义,意思;意图; [adj]意味深长的; [or]zk;
means: [a]/miːnz/; [n]方法,手段;工具;财富,收入; [v]意味着(mean的第三人称单数);打算或注定要某人成为或做某事; [or]zk;
measure: [a]/ˈmeʒər/; [v]测量;估量; [n]措施;方法;尺寸;量度标准; [or]zk;
meat: [a]/miːt/; [n]肉; [or]zk;
medal: [a]/ˈmedl/; [n]奖牌;勋章; [v]授予奖章; [or]zk;
medical: [a]/ˈmedɪkl/; [adj]医学的,医疗的;内科的; [n]体格检查; [or]zk;
medicine: [a]/ˈmedɪsn/; [n]内服药,医药,医学,内科学; [or]zk;
meet: [a]/miːt/; [v]遇见,相遇,开会;满足; [n]集会; [or]zk;
meeting: [a]/ˈmiːtɪŋ/; [n]会议;会合,聚集; [or]zk;
melon: [a]/ˈmelən/; [n](各种的)瓜; [or]zk;
member: [a]/ˈmembər/; [n]成员,一员;会员; [or]zk;
memory: [a]/ˈmeməri/; [n]记忆;回忆;存储; [or]zk;
mend: [a]/mend/; [v]修理,缝补;改正,改进;好转;治愈; [n]痊愈;改进; [or]zk;
mental: [a]/ˈmentl/; [adj]精神的 [ex]~ sickness 精神病; [sw]menial,rental; [or]zk;
mention: [a]/ˈmenʃn/; [v]提及,提名; [n]谈到,提及; [or]zk;
menu: [a]/ˈmenjuː/; [n]菜单,菜谱,菜; [or]zk;
mercy: [a]/ˈmɜːrsi/; [n]宽恕,仁慈,怜悯,恩惠; [or]zk;
merry: [a]/ˈmeri/; [adj]欢乐的,愉快的;<口>微醉的; [or]zk;
message: [a]/ˈmesɪdʒ/; [n]消息,信息,留言;启示; [v]报信;通知; [or]zk;
metal: [a]/ˈmetl/; [n]金属,合金,金属制品; [vt](以金属)覆盖,装配; [adj]金属制的; [or]zk;
meter: [a]/ˈmiːtər/; [n]计,表,仪表;米; [v]用仪表测量; [or]zk;
method: [a]/ˈmeθəd/; [n]办法,方法;秩序,规律; [or]zk;
midday: [a]/ˌmɪdˈdeɪ/; [n]中午,正午; [adj]正午的; [or]zk;
middle: [a]/ˈmɪdl/; [n]中部,中间; [adj]中部的,中间的; [or]zk;
midnight: [a]/ˈmɪdnaɪt/; [n]午夜,半夜;午夜蓝; [or]zk;
might: [a]/maɪt/; [n]力量,强权,势力; [auxv]可以;或许;可能,也许; [or]zk;
mild: [a]/maɪld/; [adj]味淡的;温暖的;轻微的;温和的; [n]淡味啤酒; [or]zk;
mile: [a]/maɪl/; [n]英里; [or]zk;
milk: [a]/mɪlk/; [n]牛奶,乳状物; [v]挤奶,抽取,套出(秘密等); [or]zk;
million: [a]/ˈmɪljən/; [num]百万,许多; [or]zk;
millionaire: [a]/ˌmɪljəˈner/; [n]百万富翁,大富翁; [or]zk;
mind: [a]/maɪnd/; [n]头脑,精神;智能;想法;心情;记忆;有才智的人; [v]注意;记住;照料;介意; [or]zk;
mine: [a]/maɪn/; [n]矿,矿山;地雷; [v]开采,采矿;埋设地雷; [pron]我的(所有物); [or]zk;
minibus: [a]/ˈmɪnibʌs/; [n]小型公共汽车,小型巴士; [or]zk;
minus: [a]/ˈmaɪnəs/; [prep]减(去); [adj]负的; [n]减号;劣势; [or]zk;
minute: [a]/ˈmɪnɪt/; [adj]微小的;详细的; [n]一分钟,瞬间; [v]记录; [or]zk;
mirror: [a]/ˈmɪrər/; [n]镜子;真实的写照,反映; [v]反射,反映; [or]zk;
miss: [a]/mɪs/; [v]漏掉,没中;错过;想念; [n]小姐; [or]zk;
missile: [a]/ˈmɪsl/; [n]导弹;投射出的物体或武器; [adj]导弹的;可投掷的;用以发射导弹的; [or]zk;
missing: [a]/ˈmɪsɪŋ/; [adj]失踪的;缺少的; [or]zk;
mist: [a]/mɪst/; [n]薄雾,朦胧; [v]使模糊,下雾; [or]zk;
mistake: [a]/mɪˈsteɪk/; [n]错误,过失; [v]误解,弄错; [adj]错误;不正确;判断错误的;被误解的; [or]zk;
misty: [a]/ˈmɪsti/; [adj]模糊的;有雾的; [n]女子名; [or]zk;
mobile: [a]/ˈmoʊbl/; [n]风铃,悬挂饰物;手机,移动电话; [adj]可移动的;行动方便的; [or]zk;
model: [a]/ˈmɑːdl/; [n]模型;模特; [v]模仿;当模特;(用黏土,木头等)做..的造型,塑造;当模特展示服装; [adj]模范的;典型的; [or]zk;
modem: [a]/ˈmoʊdem/; [n]调制解调器; [v]<计>通过调制解调器向.发送电子邮件;用调制解调器联通; [or]zk;
modern: [a]/ˈmɑːdərn/; [adj]现代的,时髦的; [or]zk;
modest: [a]/ˈmɑːdɪst/; [adj]谦虚的,谦逊的;端庄的,羞怯的;不太大(或太贵,太重要)的,适度的; [or]zk;
mom: [a]/mɑːm/; [n]妈妈; [or]zk;
moment: [a]/ˈmoʊmənt/; [n]片刻,瞬间;时刻; [or]zk;
mommy: [a]/ˈmɑːmi/; [n]妈咪; [or]zk;
money: [a]/ˈmʌni/; [n]货币;金钱,财富; [or]zk;
monitor: [a]/ˈmɑːnɪtər/; [n]显示器;监视器;班长; [v]监视;监督;监测; [or]zk;
monkey: [a]/ˈmʌŋki/; [n]猴子,猿;顽童,淘气精,调皮鬼,捣蛋鬼;五百英镑; [v]恶戏,恶作剧,捣蛋,胡闹; [or]zk;
month: [a]/mʌnθ/; [n]月,月份; [or]zk;
monument: [a]/ˈmɑːnjumənt/; [n]纪念碑;遗迹,遗址; [or]zk;
moon: [a]/muːn/; [n]月球,月亮;卫星; [or]zk;
mooncake: [a]/ˈmuːn keik/; [n]月饼; [or]zk;
moral: [a]/ˈmɔːrəl/; [adj]道德(上)的,道义的; [n]道德,品行;寓意; [or]zk;
morning: [a]/ˈmɔːrnɪŋ/; [n]早晨,上午; [or]zk;
mosquito: [a]/məˈskiːtoʊ/; [n]蚊子; [or]zk;
most: [a]/moʊst/; [adv]最;非常,极其;最多;几乎; [adj]大部分的,多数的;最多的; [n]大部分,大多数; [pron]大多数,大部分; [or]zk;
mother: [a]/ˈmʌðər/; [n]母亲,妈妈; [adj]母亲的;母体的; [v]生育;像母亲一样关爱; [or]zk;
motherland: [a]/ˈmʌðərlænd/; [n]祖国; [or]zk;
motor: [a]/ˈmoʊtər/; [n]发动机,马达;车; [or]zk;
motorcycle: [a]/ˈmoʊtərsaɪkl/; [n]摩托车;机动车; [vi]骑摩托车; [or]zk;
mount: [a]/maʊnt/; [v]登上;爬上;骑上;增长;组织,安排; [n]山;峰; [or]zk;
mountain: [a]/ˈmaʊntn/; [n]山,山脉;大堆; [or]zk;
mouth: [a]/maʊθ/; [n]口;嘴; [v]做作地说,装腔作势地说;不出声地说,以嘴唇的动作不出声地讲; [or]zk;
move: [a]/muːv/; [v]移动;发展,推移,变化;感动; [n]迁居;移动; [or]zk;
movement: [a]/ˈmuːvmənt/; [n]动作,移动;运动;(交响乐)乐章; [or]zk;
movie: [a]/ˈmuːvi/; [n]电影;电影院;电影制片业; [or]zk;
multiply: [a]/ˈmʌltɪplaɪ/; [v]乘;繁殖;增加; [or]zk;
murder: [a]/ˈmɜːrdər/; [n]谋杀,凶杀,谋杀罪;遭罪的经历; [v]谋杀,凶杀; [or]zk;
muscle: [a]/ˈmʌsl/; [n]肌肉,肌;体力; [v]用强迫手段获得; [or]zk;
museum: [a]/mjuˈziːəm/; [n]博物馆,展览馆; [or]zk;
mushroom: [a]/ˈmʌʃrʊm/; [n]蘑菇; [vi]迅速发展;采蘑菇; [or]zk;
music: [a]/ˈmjuːzɪk/; [n]音乐,乐曲,乐谱; [or]zk;
mustache: [a]/ˈmʌstæʃ/; [n]髭,小胡子;触须; [or]zk;
mutton: [a]/ˈmʌtn/; [n]羊肉,羊; [or]zk;
myself: [a]/maɪˈself/; [pron]我亲自;我自己; [or]zk;
nail: [a]/neɪl/; [n]指甲,爪;钉; [v]将..钉牢,钉住; [or]zk;
name: [a]/neɪm/; [n]名字;名声; [v]给..取(或命)名;指出; [or]zk;
narrow: [a]/ˈnæroʊ/; [adj]狭窄的;差距小的,微小的; [n]海峡;狭窄部分; [v]使变窄,缩小; [or]zk;
nation: [a]/ˈneɪʃn/; [n]民族,国家;国民; [or]zk;
national: [a]/ˈnæʃnəl/; [n]国民; [adj]国家的,民族的; [or]zk;
natural: [a]/ˈnætʃrəl/; [adj]天然的,正常的,自然的;自然界的;天赋的,天生的; [or]zk;
nature: [a]/ˈneɪtʃər/; [n]大自然;性质;天性; [or]zk;
near: [a]/nɪr/; [adv]近,接近; [adj]近的; [prep]靠近; [v]接近,靠近; [or]zk;
nearby: [a]/ˌnɪrˈbaɪ/; [adj]附近的; [adv]在附近; [or]zk;
nearly: [a]/ˈnɪrli/; [adv]将近,几乎;接近地; [or]zk;
necessary: [a]/ˈnesəseri/; [adj]必要的,必需的;必然的,势必的; [n]必需品; [or]zk;
neck: [a]/nek/; [vt]与..亲嘴;使变细; [n]颈,脖子;衣领; [vi]搂脖子亲嘴; [or]zk;
necklace: [a]/ˈnekləs/; [n]项链; [or]zk;
necktie: [a]/ˈnektaɪ/; [n]领带; [or]zk;
need: [a]/niːd/; [v]需要,必需; [n]需要,必要,缺乏; [or]zk;
needle: [a]/ˈniːdl/; [n]针;针状物;指针; [v]刺激; [or]zk;
neighbor: [a]/'neɪbə/; [n]邻居,邻人;邻国; [adj]邻近的,邻接的; [vi]友好;毗邻而居; [vt]邻接; [or]zk;
neighborhood: [a]/ˈneɪbərhʊd/; [n]社区,临近地区; [or]zk;
neither: [a]/ˈnaɪðər, ˈniːðər/; [conj]也不;既不; [adj]两者都不的; [adv]两个都不;既不..也不; [pron]两者都不; [or]zk;
nephew: [a]/ˈnefjuː/; [n]侄子,外甥; [or]zk;
nervous: [a]/ˈnɜːrvəs/; [adj]紧张的,焦虑不安的;害怕的;神经系统的,神经方面的; [or]zk;
nest: [a]/nest/; [n]巢;温床; [v]筑巢;嵌入; [or]zk;
net: [a]/net/; [n]网,网状物; [adj]纯利的,净值的,净的; [v]用网捕;捕获;净赚;踢入球门; [or]zk;
network: [a]/ˈnetwɜːrk/; [n]广播网,电视网;网络; [vi]建立关系网; [vt]联播;使联网; [or]zk;
never: [a]/ˈnevər/; [adv]永不,决不;不; [or]zk;
news: [a]/nuːz/; [n]新闻,消息; [or]zk;
newspaper: [a]/ˈnuːzpeɪpər/; [n]报纸,报;旧报纸; [or]zk;
next: [a]/nekst/; [adj]下次的;贴近的;紧接的; [n]下一个人(东西); [adv]其次,然后,下次; [or]zk;
nice: [a]/naɪs/; [adj]美好的,令人愉快的; [or]zk;
niece: [a]/niːs/; [n]侄女,外甥女; [or]zk;
night: [a]/naɪt/; [n]夜,夜间; [adj]夜晚的,夜间的; [or]zk;
nine: [a]/naɪn/; [num]九;九个; [or]zk;
nineteen: [a]/ˌnaɪnˈtiːn/; [num]十九,十九个; [n]十九点;十九岁; [or]zk;
ninety: [a]/ˈnaɪnti/; [num]九十; [or]zk;
ninth: [a]/naɪnθ/; [num]第九; [n]九分之一; [or]zk;
nobody: [a]/ˈnoʊbədi/; [pron]没有人;谁也不; [n]无名小卒; [or]zk;
nod: [a]/nɑːd/; [v]点(头),打盹; [n]点头;点头同意;打瞌睡,打盹;粗心大意; [or]zk;
noise: [a]/nɔɪz/; [n]喧闹声,噪声,吵嚷声; [or]zk;
noisy: [a]/ˈnɔɪzi/; [adj]嘈杂的;喧闹的; [or]zk;
none: [a]/nʌn/; [pron]没有(一人或一物); [adv]毫不; [or]zk;
noodle: [a]/ˈnuːdl/; [n](常pl.)面条; [or]zk;
noon: [a]/nuːn/; [n]正午,中午; [v]〈美〉午时休息; [or]zk;
nor: [a]/nɔːr/; [conj]也不; [adv]也不; [or]zk;
normal: [a]/ˈnɔːrml/; [adj]正常的; [or]zk;
north: [a]/nɔːrθ/; [adj]北方的,北的; [adv]向北方; [n]北方,北; [or]zk;
northern: [a]/ˈnɔːrðərn/; [adj]北部的,北方的,有北方特征的; [or]zk;
northwest: [a]/ˌnɔːrθˈwest/; [n]西北方;西北; [adj]在西北的;向西北的;来自西北的; [adv]在西北;向西北;自西北; [or]zk;
nose: [a]/noʊz/; [n]鼻子;前部;嗅觉; [v]小心探索着前进;嗅; [or]zk;
note: [a]/noʊt/; [n]笔记,便条,注释;纸币;音符; [v]注意,记录; [or]zk;
notebook: [a]/ˈnoʊtbʊk/; [n]笔记本电脑;笔记本;手册; [or]zk;
nothing: [a]/ˈnʌθɪŋ/; [pron]没有东西,没有任何事;没有(别的)事情;无关紧要的事物(或人);极低的价格;没有什么; [adv]毫不; [or]zk;
notice: [a]/ˈnoʊtɪs/; [n]通知,告示;注意; [v]注意,察觉; [or]zk;
novel: [a]/ˈnɑːvl/; [n]小说,长篇故事; [adj]新奇的,新颖的,不同的; [or]zk;
nowadays: [a]/ˈnaʊədeɪz/; [adv]现今,现在; [n]当今,现代; [or]zk;
number: [a]/ˈnʌmbər/; [n]数,数字;号码; [v]达,总计;编号; [or]zk;
nurse: [a]/nɜːrs/; [n]护士,保姆; [v]护理,看护; [or]zk;
nursery: [a]/ˈnɜːrsəri/; [n]托儿所;保育室;苗圃; [or]zk;
nut: [a]/nʌt/; [n]坚果;疯子,怪人; [or]zk;
o'clock: [a]/əˈklɑːk/; [adv].点钟; [or]zk;
obey: [a]/oʊˈbeɪ/; [v]服从,听从,遵从;顺从,听从摆布; [or]zk;
object: [a]/ˈɑːbdʒekt/; [n]物体;宾语;目标; [v]提出..作为反对的理由;反对; [or]zk;
occupy: [a]/ˈɑːkjupaɪ/; [v]占用(时间,空间等);居住;任职;侵占(by military force); [add]s3/occupies,pr/occupying,pt/occupied,pp/occupied; [sw]occult; [or]zk;
ocean: [a]/ˈoʊʃn/; [n]海洋; [or]zk;
off: [a]/ɔːf/; [adv](离)开;不再供应,停止,不再工作; [prep]离开;在..之外; [adj]空闲的;离开的;关闭的; [v]离开;脱下; [int]走开; [n]<板>(打球员的)右前方; [or]zk;
offer: [a]/ˈɔːfər/; [n]提供;特价;出价;录取(用)通知书;提议; [vt]给予,奉上;表示愿意 (做某事);提供;出价; [or]zk;
office: [a]/ˈɔːfɪs/; [n]办公室;职位;处,局,社; [or]zk;
officer: [a]/ˈɑːfɪsər/; [n]官员;干事;军官;警官; [or]zk;
official: [a]/əˈfɪʃl/; [n]官员;行政官员;裁判; [adj]官方的,正式的,公务的; [or]zk;
often: [a]/ˈɑːfn/; [adv]经常,时常,屡次; [or]zk;
oil: [a]/ɔɪl/; [n]油,石油,油类; [v]给(机器等)上油,涂油; [or]zk;
old: [a]/oʊld/; [adj]年纪大的,老的;..岁的;旧的,破旧的; [n]老年人;旧时; [or]zk;
once: [a]/wʌns/; [adv]一次,曾经; [n]一次; [conj]一旦,立刻; [or]zk;
one-way: [a]/ˌwʌn ˈweɪ/; [adj]单程的;单行道的;单方面的; [or]zk;
oneself: [a]/wʌnˈself/; [pron]亲自;自己; [or]zk;
onion: [a]/ˈʌnjən/; [n]洋葱,洋葱头; [or]zk;
online: [a]/ˌɑːnˈlaɪn/; [adj](活动,服务)在线的,网上的,受电脑控制的,联机的; [adv]联机地,在运行,开始运行; [n]在线;联机; [or]zk;
only: [a]/ˈoʊnli/; [adj]唯一的; [adv]只,仅仅; [conj]但是;除非;然而;毕竟; [or]zk;
onto: [a]/ˈɑːntə/; [prep]到..上;面向; [or]zk;
open: [a]/ˈoʊpən/; [v]打开;睁开; [adj]营业的;打开的,公开的; [n]户外,野外; [or]zk;
opening: [a]/ˈoʊpnɪŋ/; [n]开口;孔;开始;开幕;职位空缺; [adj]开始的,开场的; [or]zk;
opera: [a]/ˈɑːprə/; [n]歌剧,歌剧艺术;歌剧团;歌剧院; [or]zk;
operate: [a]/ˈɑːpəreɪt/; [v]操作;运转;施行手术;运营;(军队)在某一地区作战,执行任务; [or]zk;
operation: [a]/ˌɑːpəˈreɪʃn/; [n]运转;操作;手术; [or]zk;
opinion: [a]/əˈpɪnjən/; [n]意见,看法,主张; [or]zk;
opposite: [a]/ˈɑːpəzɪt/; [adj]相反的;对立的;对面的; [adv]对立地;反面地; [n]对立物;反义词; [prep]与.相对;在.对面;与.合演;与.联袂演出; [or]zk;
optimistic: [a]/ˌɑːptɪˈmɪstɪk/; [adj]乐观的,乐观主义的; [sw]optimist,optimism,pessimistic,optimize,altruistic; [or]zk;
oral: [a]/ˈɔːrəl/; [adj]口腔的,口头的,口语的; [n]口试; [or]zk;
orange: [a]/ˈɔːrɪndʒ/; [n]柑,桔,橙子;橙色; [adj]橙色的,橘色的,桔红色的; [or]zk;
order: [a]/ˈɔːrdər/; [v]点(酒菜);订购;命令;安排,整理; [n]顺序,条理,状况,规程;体制;治安,秩序;订单,订货;指令,命令;等级,阶层; [or]zk;
ordinary: [a]/ˈɔːrdneri/; [adj]普通的,平常的,平凡的;平淡的,平庸的; [or]zk;
organization: [a]/ˌɔːrɡənəˈzeɪʃn/; [n]组织,体制,团体,机构; [or]zk;
other: [a]/ˈʌðər/; [adj]其他的,另外的; [n]其他(人或物); [pron]其他人(或事); [adv]以其他方式; [or]zk;
otherwise: [a]/ˈʌðərwaɪz/; [adv]否则,要不然;除此之外; [conj]否则,不然; [or]zk;
ought: [a]/ɔːt/; [v]应该,应当,本该;应该(指道义上有责任);(表示可能性,希望) 该,可能会;(表示推测)预料会做(某事); [or]zk;
ours: [a]/ɑːrz/; [pron]我们的;我们的家; [or]zk;
ourselves: [a]/ɑːrˈselvz/; [pron]我们自己; [or]zk;
outdoors: [a]/ˌaʊtˈdɔːrz/; [adv]在户外,在野外; [n]户外(活动),野外(活动); [adj]在户外的; [or]zk;
outer: [a]/ˈaʊtər/; [adj]外部的,外面的,外层的; [n]靶子环外的部分;环外命中; [or]zk;
outgoing: [a]/ˈaʊtɡoʊɪŋ/; [adj]外向的;外出的;乐于助人的;即将离职的,卸任的; [n]流出;开支; [or]zk;
outing: [a]/ˈaʊtɪŋ/; [n]远足;短途旅游; [or]zk;
outside: [a]/ˌaʊtˈsaɪd/; [adv]在户外,在外面,向外面; [n]外部;外表; [adj]外部的; [prep]在..外面,不在..范围内; [or]zk;
over: [a]/ˈoʊvər/; [adv]越过;翻倒;遍布;结束; [adj]过去的;外面的;在上的;上级的;过分的,多余的; [n]额外,剩余,剩余(或多余)的量,剩余物; [int]<电信学>报文完,请回复!; [prep]在..上方;遍及; [vt]走过,跳过,<美国方言>从.恢复过来; [or]zk;
overcoat: [a]/ˈoʊvərkoʊt/; [n]大衣,外套; [or]zk;
overcome: [a]/ˌoʊvərˈkʌm/; [v]战胜;克服;压倒;得胜,征服; [or]zk;
own: [a]/oʊn/; [adj]自己的; [v]有,拥有; [pron]自己的; [or]zk;
owner: [a]/ˈoʊnər/; [n]所有者,物主; [or]zk;
ox: [a]/ɑːks/; [n]牛,公牛; [or]zk;
oxygen: [a]/ˈɑːksɪdʒən/; [n]氧气; [or]zk;
pace: [a]/peɪs/; [n]速度;步,步伐; [v]踱步; [or]zk;
pacific: [a]/pəˈsɪfɪk/; [adj]太平洋的;与太平洋有关的;爱好和平的,温和的; [n]太平洋; [or]zk;
pack: [a]/pæk/; [v]打包;包装;塞满; [n]行李;背包;一群;一伙; [adj]包装用的;搬运用的;由驮运牲畜组成的;填满了的; [or]zk;
package: [a]/ˈpækɪdʒ/; [n]包裹;一揽子,一整套; [or]zk;
pain: [a]/peɪn/; [n]痛,痛苦;努力,劳苦; [or]zk;
painful: [a]/ˈpeɪnfl/; [adj]疼痛的;费力的 [sw]spoonful,rainfull,painter; [or]zk;
paint: [a]/peɪnt/; [v]描绘,绘画;粉饰,涂油漆,涂色于; [n]颜料;油漆,涂料; [or]zk;
painting: [a]/ˈpeɪntɪŋ/; [n]画作,绘画;将(画作)挂起来; [or]zk;
pair: [a]/per/; [n]一对; [v]成对,配对; [or]zk;
palace: [a]/ˈpæləs/; [n]宫殿,豪华住宅; [or]zk;
pale: [a]/peɪl/; [adj]苍白的,灰白的,暗淡的,无力的; [vi]变苍白; [n]栅栏; [vt]用栅栏围;使失色;使变苍白; [or]zk;
pan: [a]/pæn/; [n]平底锅; [v]严厉批评;淘金; [or]zk;
pancake: [a]/ˈpænkeɪk/; [n]烙饼,薄饼; [or]zk;
panda: [a]/ˈpændə/; [n]熊猫; [or]zk;
paper: [a]/ˈpeɪpər/; [n]纸;试卷,论文,报纸; [v]裱糊; [adj]纸制的,似纸的,有名无实的; [or]zk;
paragraph: [a]/ˈpærəɡræf/; [n](文章的)段,节; [or]zk;
parcel: [a]/ˈpɑːrsl/; [n]包裹;一片,一块; [v]打包; [or]zk;
pardon: [a]/ˈpɑːrdn/; [v]原谅,宽恕; [n]原谅,饶恕,赦免; [int]对不起;请再说一遍; [or]zk;
parent: [a]/ˈperənt/; [n]父母;母体; [or]zk;
park: [a]/pɑːrk/; [n]公园;(作为专用场地的)..区,..园; [v]停放(汽车等); [or]zk;
parking: [a]/ˈpɑːrkɪŋ/; [n]停车; [or]zk;
part-time: [a]/ˌpɑːrt ˈtaɪm/; [adj]部分时间的;兼职的; [adv]以部分时间;作为兼职; [or]zk;
part: [a]/pɑːrt/; [n]部分;角色;零件; [adj]部分的; [v]分离;分配;断裂;分手; [adv]部分地; [or]zk;
partner: [a]/ˈpɑːrtnər/; [n]伙伴,搭档;配偶,伴侣;合伙人; [v]成为..的合伙人; [or]zk;
party: [a]/ˈpɑːrti/; [n]派对,聚会;(共同工作的)队,组; [or]zk;
pass: [a]/pæs/; [n]飞机或人造卫星等的一次掠过; [vt]经过;通过;传递,度过; [or]zk;
passage: [a]/ˈpæsɪdʒ/; [n]通道,走廊;(法案的)通过;段落;推移;旅程; [or]zk;
passport: [a]/ˈpæspɔːrt/; [n]护照;途径,手段; [or]zk;
past: [a]/pæst/; [adv]过,经过; [prep]过,经过,越过; [adj]过去的,结束的; [n]过去; [or]zk;
path: [a]/pæθ/; [n]路,小道,道路; [or]zk;
patience: [a]/ˈpeɪʃns/; [n]耐心,忍耐;毅力; [or]zk;
patient: [a]/ˈpeɪʃnt/; [n]病人,患者; [adj]有耐心的,能忍耐的; [or]zk;
pattern: [a]/ˈpætərn/; [n]模型,模式;典型;图案;版式;样品; [vi]形成图案; [vt]用图案装饰; [or]zk;
pause: [a]/pɔːz/; [vi]暂停,中止,停顿; [vt]暂停播放; [n]中止,暂停;暂停键; [or]zk;
pavement: [a]/ˈpeɪvmənt/; [n]人行道; [or]zk;
pay: [a]/peɪ/; [v]支付,偿还;获利,受益; [n]工资,薪金; [or]zk;
pea: [a]/piː/; [n]豌豆; [or]zk;
peace: [a]/piːs/; [n]和平;和睦;平静; [or]zk;
peaceful: [a]/ˈpiːsfl/; [adj]和平的;平静的,安宁的 [sw]graceful; [or]zk;
peach: [a]/piːtʃ/; [n]桃子,桃树;极可爱的(人或事物),非常迷人的(人或事物);桃红色; [adj]桃红色的,用桃子制成的; [or]zk;
pear: [a]/per/; [n]梨子,梨树; [or]zk;
pen: [a]/pen/; [n]笔,钢笔;围栏,畜栏; [v]书写;关押,监禁; [or]zk;
pencil case: [a]/ˈpensl keɪs/; [n]文具盒; [or]zk;
pencil: [a]/ˈpensl/; [n]铅笔; [vt]用铅笔写; [or]zk;
penguin: [a]/ˈpeŋɡwɪn/; [n]企鹅; [or]zk;
penny: [a]/ˈpeni/; [n]便士;美分; [or]zk;
people: [a]/ˈpiːpl/; [n]人,人民,民族; [v]居住于; [or]zk;
pepper: [a]/ˈpepər/; [n]胡椒粉,胡椒;辣椒; [v]使布满;加胡椒粉于; [or]zk;
per: [a]/pər/; [prep]每,每一;按照; [or]zk;
percent: [a]/pərˈsent/; [n]百分之..; [or]zk;
perfect: [a]/ˈpɜːrfɪkt/; [adj]完美的;极好的;精通的; [v]使完美; [n]<语>完成时; [or]zk;
performance: [a]/pərˈfɔːrməns/; [n]表演,演出;表现;执行;性能; [or]zk;
performer: [a]/pərˈfɔːrmər/; [n]表演者; [or]zk;
perhaps: [a]/pərˈhæps/; [adv]也许,可能; [or]zk;
period: [a]/ˈpɪriəd/; [n]句号;时期;例假; [or]zk;
permission: [a]/pərˈmɪʃn/; [n]允许,同意; [or]zk;
permit: [a]/pərˈmɪt/; [vt]允许,许可; [n]执照; [v]使可能; [or]zk;
person: [a]/ˈpɜːrsn/; [n]人,本人,自身; [or]zk;
personal: [a]/ˈpɜːrsənl/; [adj]个人的,私人的; [n]个人;人身攻击;<法>动产;<语>人称代名词; [or]zk;
persuade: [a]/pərˈsweɪd/; [v]说服,劝说;使相信; [or]zk;
pet: [a]/pet/; [n]宠物;宠儿; [adj]宠爱的,重要的; [v]宠爱,爱抚; [or]zk;
petrol: [a]/ˈpetrəl/; [n](英)汽油; [or]zk;
phone: [a]/foʊn/; [n]电话,电话机; [v]打电话; [or]zk;
photo: [a]/ˈfoʊtoʊ/; [n]照片,相片; [or]zk;
photographer: [a]/fəˈtɑːɡrəfər/; [n]摄影师; [or]zk;
phrase: [a]/freɪz/; [n]简短的警句;短语,习语;措辞,乐句; [v]措辞,将(乐曲)分成乐句; [or]zk;
physician: [a]/fɪˈzɪʃn/; [n]内科医生; [or]zk;
physicist: [a]/ˈfɪzɪsɪst/; [n]物理学者,物理学家; [or]zk;
physics: [a]/ˈfɪzɪks/; [n]物理(学); [or]zk;
pianist: [a]/ˈpiːənɪst/; [n]钢琴家,钢琴演奏家; [or]zk;
piano: [a]/piˈænoʊ/; [n]钢琴; [adv](弹或唱时)轻柔地; [adj](弹或唱时)轻柔的; [or]zk;
pick: [a]/pɪk/; [v]挑选;拾,捡起;摘,采摘;剔,戳; [n]选择;精品; [or]zk;
picnic: [a]/ˈpɪknɪk/; [n]郊游,野餐; [vi]野餐; [or]zk;
picture: [a]/ˈpɪktʃər/; [v]想像,设想;画; [n]画,图片,照片; [or]zk;
pie: [a]/paɪ/; [n]甜馅饼;饼图,饼状图; [or]zk;
piece: [a]/piːs/; [n]块;件;篇; [v]修补;接合;凑合; [or]zk;
pig: [a]/pɪɡ/; [n]猪;小猪,野猪; [vi]生小猪;像猪一样过活; [vt]贪婪地吃; [or]zk;
pigeon: [a]/ˈpɪdʒɪn/; [n]鸽子; [or]zk;
pill: [a]/pɪl/; [n]药丸; [or]zk;
pillow: [a]/ˈpɪloʊ/; [n]枕头; [v]垫,枕着; [or]zk;
pilot: [a]/ˈpaɪlət/; [n]领航员;飞行员; [adj]试验性的; [v]给..领航,驾驶;试验; [or]zk;
pine: [a]/paɪn/; [n]松树; [v](因死亡,离别等)难过,悲伤; [or]zk;
pineapple: [a]/ˈpaɪnæpl/; [n]凤梨,菠萝; [or]zk;
ping-pong: [a]/ˈpɪŋ pɔːŋ/; [n]乒乓球; [or]zk;
pink: [a]/pɪŋk/; [adj]粉红色的; [n]粉红色; [vi]发出碰撞声; [or]zk;
pioneer: [a]/ˌpaɪəˈnɪr/; [n]先驱,先锋,开拓者; [v]开辟,首倡; [or]zk;
pipe: [a]/paɪp/; [n]管子,导管;烟斗;笛; [v]安静下来(pipe down);用管子输送;用管乐器演奏; [or]zk;
pipette: [a]/paɪˈpet/; [n]移液管;吸移管; [v]用移液器吸取; [or]zk;
pity: [a]/ˈpɪti/; [n]憾事,怜悯; [v](觉得)可怜,惋惜; [or]zk;
pizza: [a]/ˈpiːtsə/; [n]比萨饼; [or]zk;
place: [a]/pleɪs/; [n]地方,地点;住所; [v]放置; [or]zk;
plain: [a]/pleɪn/; [adj]平凡的;明白的;坦率的;朴素的;不尚修饰的(尤指女人); [n]大平原; [or]zk;
plan: [a]/plæn/; [n]平面图,计划; [v]计划,打算; [or]zk;
plane: [a]/pleɪn/; [n]飞机,平面; [v]刨平; [adj]平的,飞机的; [or]zk;
planet: [a]/ˈplænɪt/; [n]行星; [or]zk;
plant: [a]/plænt/; [n]植物;工厂;设备;发电厂; [v]种植;安置; [or]zk;
plastic: [a]/ˈplæstɪk/; [n]塑料,塑料制品; [adj]塑料的;塑性的,可塑的; pl. 塑料,塑料制品(plastics); [or]zk;
plate: [a]/pleɪt/; [n]盘子,板,片; [v]电镀; [or]zk;
platform: [a]/ˈplætfɔːrm/; [n]站台;平台;讲台;舞台;论坛; [or]zk;
play: [a]/pleɪ/; [v]玩,游戏;扮演,演奏; [n]剧本;戏剧;游戏;玩耍; [or]zk;
player: [a]/ˈpleɪər/; [n]演奏者;选手,队员;重要参与者;播放器; [or]zk;
playground: [a]/ˈpleɪɡraʊnd/; [n]操场,游乐区;活动场所; [or]zk;
playhouse: [a]/ˈpleɪhɑʊs/; [n]剧场;玩具房屋;儿童游戏室; [or]zk;
pleasant: [a]/ˈpleznt/; [adj]令人愉快的,舒适的;友好的,和蔼的,有礼貌的; [or]zk;
please: [a]/pliːz/; [v]使高兴,使满意,取悦; [int]请;得了吧,算了吧; [or]zk;
pleased: [a]/pliːzd/; [adj]高兴的,满意的; [v]使高兴;使喜欢; [or]zk;
pleasure: [a]/ˈpleʒər/; [n]愉快,快乐,乐事; [or]zk;
plenty: [a]/ˈplenti/; [n]丰富,大量;充裕; [adv]很多,绰绰有余的,非常; [or]zk;
plus: [a]/plʌs/; [prep]加,加上; [n]加号;有利因素; [adj]正的,多的;有利的;阳性的; [conj]此外,而且,况且; [or]zk;
pocket: [a]/ˈpɑːkɪt/; [n]衣袋;钱; [adj]袖珍的; [v]把..装入口袋; [or]zk;
poem: [a]/ˈpoʊəm/; [n]诗,韵文,诗体文; [or]zk;
poet: [a]/ˈpoʊət/; [n]诗人; [or]zk;
point: [a]/pɔɪnt/; [n]点,尖端;分数;要点; [v]指向,指出;表明;加标点于; [or]zk;
police: [a]/pəˈliːs/; [n]警察,警方; [v]维持治安,管辖,监督; [or]zk;
policeman: [a]/pəˈliːsmən/; [n]警察; [or]zk;
policy: [a]/ˈpɑːləsi/; [n]保险单;政策,方针;原则,策略; [or]zk;
polite: [a]/pəˈlaɪt/; [adj]有礼貌的,客气的,文雅的;高雅的,上流的; [or]zk;
politeness: [a]/pəˈlaɪtnəs/; [n]有礼貌;优雅; [or]zk;
political: [a]/pəˈlɪtɪkl/; [adj]政治的,政治上的; [or]zk;
politics: [a]/ˈpɑːlətɪks/; [n]政治,政治学;政纲,政见; [or]zk;
pollute: [a]/pəˈluːt/; [v]弄脏,污染,沾污; [or]zk;
pollution: [a]/pəˈluːʃn/; [n]污染;噪音污染,光污染;污染物; [or]zk;
pond: [a]/pɑːnd/; [n]池塘; [or]zk;
pool: [a]/puːl/; [n]水塘,集中起来的一批人; [v]挖掘,集中资源(或材料); [or]zk;
poor: [a]/pɔːr/; [adj]可怜的,贫穷的,贫乏的; [n]穷人;贫困者; [or]zk;
pop: [a]/pɑːp/; [v]发出(砰的响声),突然出现,爆开,开枪; [n]砰的一声爆破声;流行音乐;汽水; [adj]流行的,大众的; [or]zk;
popcorn: [a]/ˈpɑːpkɔːrn/; [n]爆米花; [or]zk;
popular: [a]/ˈpɑːpjələr/; [adj]受欢迎的;大众的; [or]zk;
population: [a]/ˌpɑːpjuˈleɪʃn/; [n]人口,全体居民; [or]zk;
pork: [a]/pɔːrk/; [n]猪肉; [or]zk;
porridge: [a]/ˈpɔːrɪdʒ/; [n]粥,麦片粥; [or]zk;
port: [a]/pɔːrt/; [n]舷窗;舱门;港口城市;葡萄酒;港,港口; [or]zk;
position: [a]/pəˈzɪʃn/; [n]位置;职位;姿势;观点; [v]安置; [or]zk;
possibility: [a]/ˌpɑːsəˈbɪləti/; [n]可能,可能性;可能的事,几率; [or]zk;
possible: [a]/ˈpɑːsəbl/; [adj]可能的; [n]可能性,潜在性,可能的人物,可能有的事,最高分; [or]zk;
post: [a]/poʊst/; [n]柱;邮政,邮寄;邮件;职位,岗位;哨所; [vt]贴出;公告;邮寄; [or]zk;
postage: [a]/ˈpoʊstɪdʒ/; [n]邮费,邮资; [or]zk;
postal: [a]/ˈpoʊstl/; [adj]邮政的,邮局的;邮件的; [or]zk;
postcard: [a]/ˈpoʊstkɑːrd/; [n]明信片; [or]zk;
postcode: [a]/ˈpoʊstkoʊd/; [n](英)邮政编码; [v]为(某一邮区)提供邮政编码; [or]zk;
postman: [a]/ˈpoʊstmən/; [n]邮递员; [or]zk;
pot: [a]/pɑːt/; [n]罐,壶,锅,盆; [or]zk;
potato: [a]/pəˈteɪtoʊ/; [n]马铃薯,土豆; [or]zk;
pottery: [a]/ˈpɑːtəri/; [n]陶器;陶艺;陶艺厂; [or]zk;
pound: [a]/paʊnd/; [n]英镑,磅; [v](连续)猛击,捣碎; [or]zk;
pour: [a]/pɔːr/; [v]注,倒,灌;下(雨);不断地大量投入,倾注; [n]倾泻;倾盆大雨; [or]zk;
powder: [a]/ˈpaʊdər/; [n]粉;火药; [v]抹粉; [or]zk;
power: [a]/ˈpaʊər/; [n]力量,能力,权力;电源;电力;功率; [v]提供动力;驱动; [or]zk;
powerful: [a]/ˈpaʊərfl/; [adj]强有力的;有权威的; [adv]很;非常; [or]zk;
practical: [a]/ˈpræktɪkl/; [adj]实际的,实用的,实践的,切合实际的;〔人〕注重实际的,务实的;〔计划,方法等〕有效的,切实可行的;心灵手巧的; [n]实习课;实践课;实验考核; [or]zk;
practice: [a]/ˈpræktɪs/; [v]练习,实践; [n]练习;习惯;业务;实践,实行; [or]zk;
praise: [a]/preɪz/; [v]赞美,表扬,歌颂; [n]赞美(的话); [add]s3/praises,pr/praising,pt/praised,pp/praised; [ex]~ sb/表扬或赞美某人; [sw]raise,appraise,raised,prairie; [or]zk;
prefer: [a]/prɪˈfɜːr/; [v]更喜欢,宁愿;提出; [or]zk;
prepare: [a]/prɪˈper/; [v]准备,预备;做好准备; [or]zk;
presence: [a]/ˈprezns/; [n]出席,到场;存在;风度,仪态; [or]zk;
present: [a]/ˈpreznt/; [n]礼物,赠送物; [adj]出席的,当前的; [v]赠送,呈现;提出,提供,递交; [or]zk;
president: [a]/ˈprezɪdənt/; [n]总统;院长; [or]zk;
press: [a]/pres/; [v]按,压,逼迫; [n]新闻界,出版社,报刊; [or]zk;
pressure: [a]/ˈpreʃər/; [n]压力;压迫,<物>压强;迫使; [v]对..施加压力;密封; [or]zk;
pretend: [a]/prɪˈtend/; [v]假装,装扮; [adj]假装的,仿制的; [or]zk;
pretty: [a]/ˈprɪti/; [adj]漂亮的,标致的,可爱的; [adv]相当地,很; [n]漂亮的东西,美人; [or]zk;
prevent: [a]/prɪˈvent/; [v]预防,阻止; [or]zk;
price: [a]/praɪs/; [n]价格,价钱;代价; [v]标价; [or]zk;
pride: [a]/praɪd/; [v]使得意,以.自豪; [n]自豪;骄傲; [or]zk;
primary: [a]/ˈpraɪmeri/; [adj]初等教育的;初级的;基本的;首要的;主要的; [n]首选;(美)初选; [or]zk;
print: [a]/prɪnt/; [n]印刷,印刷品,;出版;字体; [v]印刷,出版;洗印;印染; [or]zk;
printer: [a]/ˈprɪntər/; [n]印刷机,印刷工;打印机; [or]zk;
printing: [a]/ˈprɪntɪŋ/; [n]印刷;印刷术;打印; [or]zk;
prison: [a]/ˈprɪzn/; [n]监狱;监禁; [v]监禁; [or]zk;
private: [a]/ˈpraɪvət/; [adj]私人的;私密的;私下的; [n]士兵; [or]zk;
prize: [a]/praɪz/; [n]奖品,奖赏; [adj]作为奖品的,得奖的; [v]珍视,宝贵; [or]zk;
probable: [a]/ˈprɑːbəbl/; [adj]可能的;大概的; [n]很可能的事物;很有希望被选中的人; [or]zk;
probably: [a]/ˈprɑːbəbli/; [adv]或许,大概; [or]zk;
problem: [a]/ˈprɑːbləm/; [n]问题;疑难问题,题目;成问题的,难对付的; [or]zk;
process: [a]/ˈprɑːses/; [v]加工;处理; [n]过程,进程;工序,程序;传票; [or]zk;
produce: [a]/prəˈduːs/; [v]生产;创作;产生; [vi]创作;生产;产生; [n]农产品; [or]zk;
product: [a]/ˈprɑːdʌkt/; [n]产品,产物;(乘)积; [or]zk;
production: [a]/prəˈdʌkʃn/; [n]生成,产生;产量;生产;(戏剧,电影等的)制作; [or]zk;
professor: [a]/prəˈfesər/; [n]教授; [or]zk;
profit: [a]/ˈprɑːfɪt/; [n]利润,盈利;益处; [v]得益,有益于; [or]zk;
program: [a]/ˈproʊɡræm/; [n]程序;节目;计划; [v]给..编写程序; [or]zk;
progress: [a]/ˈprɑːɡres/; [n]进步;前进,进展; [v]进步,发展; [or]zk;
project: [a]/ˈprɑːdʒekt/; [n]项目,工程;专题研究;课题方案; [v]映射,放映;计划,设计,打算,拟订方案;投掷,发射,喷射;表明..的特性,使呈现特性;阐述;突出,伸出;估计,预估; [or]zk;
promise: [a]/ˈprɑːmɪs/; [n]诺言;有成功希望的预示;允诺的事; [vt]保证,允诺; [vi]有指望;允诺,保证; [or]zk;
pronounce: [a]/prəˈnaʊns/; [v]发音;发表,宣布; [or]zk;
pronunciation: [a]/prəˌnʌnsiˈeɪʃn/; [n]发音,发音方法; [or]zk;
proper: [a]/ˈprɑːpər/; [adj]适合的,适用的;独特的;真正的;正确的;得体的;完全的; [or]zk;
properly: [a]/ˈprɑːpərli/; [adv]适当地;正确地;恰当地;得体地;完全; [or]zk;
protect: [a]/prəˈtekt/; [v]保护;警戒; [or]zk;
protection: [a]/prəˈtekʃn/; [n]保护,防卫,警戒; [or]zk;
proud: [a]/praʊd/; [adj]骄傲的,引以自豪的;妄自尊大的; [adv]使某人感到荣幸,给某人面子; [or]zk;
prove: [a]/pruːv/; [v]证实; [or]zk;
provide: [a]/prəˈvaɪd/; [v]提供,供给; [or]zk;
province: [a]/ˈprɑːvɪns/; [n]省;领域,部门; [or]zk;
pub: [a]/pʌb/; [n]酒吧,酒馆; [or]zk;
public: [a]/ˈpʌblɪk/; [adj]公共的;公众的;公开的;公然的; [n]公众,民众; [or]zk;
pull: [a]/pʊl/; [v]拉,拖,扯,拔;得到;驾驶; [n]拉力,吸引力,影响力; [or]zk;
pump: [a]/pʌmp/; [v]抽水,抽取;用泵输送;向.灌注;盘问; [n]打气筒;泵,抽水(机);胶底帆布鞋; [or]zk;
pumpkin: [a]/ˈpʌmpkɪn/; [n]南瓜,倭瓜; [or]zk;
punish: [a]/ˈpʌnɪʃ/; [v]惩罚,处罚; [or]zk;
punishment: [a]/ˈpʌnɪʃmənt/; [n]惩罚,处罚; [or]zk;
pupil: [a]/ˈpjuːpl/; [n]小学生;瞳孔; [or]zk;
purple: [a]/ˈpɜːrpl/; [adj]紫色的; [n]紫色; [or]zk;
purpose: [a]/ˈpɜːrpəs/; [n]目的,意图;用途,效果;决心; [v]企图;打算; [or]zk;
purse: [a]/pɜːrs/; [n]钱包(尤指女用的),小钱袋,手袋; [v]使皱起,噘起; [or]zk;
push: [a]/pʊʃ/; [n]推,推力,促进,推进; [v]推,逼迫,推进; [or]zk;
put: [a]/pʊt/; [v]放,摆;使处于;表达,表述;对事件作出说明,提出意见;写上,记上; [or]zk;
puzzle: [a]/ˈpʌzl/; [n]拼图;谜;迷惑;难题; [v]使迷惑; [or]zk;
pyramid: [a]/ˈpɪrəmɪd/; [n]金字塔; [or]zk;
quality: [a]/ˈkwɑːləti/; [n]特性;品性;质量; [adj]优质的; [or]zk;
quantity: [a]/ˈkwɑːntəti/; [n]数量,数目;大量,许多; [or]zk;
quarrel: [a]/ˈkwɔːrəl/; [v]争吵,争论; [n]争吵,口角; [or]zk;
quarter: [a]/ˈkwɔːrtər/; [v]驻扎,扎营;把..四等分; [n]四分之一;季度;一刻钟; [or]zk;
queen: [a]/kwiːn/; [n]王后;女王;出众的女人;皇后; [or]zk;
question: [a]/ˈkwestʃən/; [n]问题,疑问,发问; [v]询问;怀疑;审问; [or]zk;
queue: [a]/kjuː/; [v]排队等候; [n]行列; [or]zk;
quick: [a]/kwɪk/; [adj]迅速的,快捷的; [adv]迅速地; [n](指甲下的)活肉; [or]zk;
quickly: [a]/ˈkwɪkli/; [adv]迅速地,快速地;很快地; [or]zk;
quiet: [a]/ˈkwaɪət/; [adj]寂静的;安静的;(感情)克制的,稳重的,不张扬; [n]安静,平静; [v]使安静,平静; [or]zk;
quite: [a]/kwaɪt/; [adv]相当,十分; [or]zk;
quiz: [a]/kwɪz/; [n]问答比赛,智力竞赛;小测验,小考; [v]考查,盘问; [or]zk;
rabbit: [a]/ˈræbɪt/; [n]兔子,(野)兔; [or]zk;
race: [a]/reɪs/; [n](速度上的)比赛;人种,种族;属,种; [v]全速行进;参加竞赛;(使)比速度; [or]zk;
racket: [a]/ˈrækɪt/; [n]吵闹声;球拍; [v]嚷闹,吵闹,纵情欢闹;用球拍打; [or]zk;
radio: [a]/ˈreɪdioʊ/; [n]无线电;收音机; [v]用无线电通讯; [or]zk;
rail: [a]/reɪl/; [n]铁轨;扶手,栏杆; [v]咒骂; [or]zk;
railway: [a]/ˈreɪlweɪ/; [n]铁路,铁道; [vi]乘火车旅行;在.铺设铁路; [or]zk;
rain: [a]/reɪn/; [n]雨(水); [v]下雨; [ex]in the rain/在雨中; [sw]grain,drain; [or]zk;
raincoat: [a]/ˈreɪnkoʊt/; [n]雨衣; [or]zk;
rainfall: [a]/ˈreɪnfɔːl/; [n]降雨;降雨量; [or]zk;
rainy: [a]/ˈreɪni/; [adj]下雨的,多雨的; [or]zk;
raise: [a]/reɪz/; [v]养殖;养育;筹集(资金);举起;竖起,扶起;站直;提拔;唤起;和.取得联系; [n]加薪;提高; [or]zk;
rank: [a]/ræŋk/; [v]排名;把.分等级;列队; [n]等级;军队中的官阶; [adj]繁茂的,讨厌的,难闻的; [or]zk;
rapid: [a]/ˈræpɪd/; [adj]迅速的;急促的; [or]zk;
rat: [a]/ræt/; [n]老鼠,耗子; [v]揭发; [or]zk;
rather: [a]/ˈræðər/; [adv]宁愿,宁可,相当; [int]<英口> 好呀; [or]zk;
reach: [a]/riːtʃ/; [v]伸手;够得着;到达;抵达; [n]范围;影响力; [or]zk;
read: [a]/riːd/; [v]读,看懂;写着; [n]阅读,读物; [adj]博学的; [or]zk;
reading: [a]/ˈriːdɪŋ/; [n]阅读;读物;读数; [or]zk;
ready: [a]/ˈredi/; [adj]准备好的;现成的;迅速的;愿意的;需要的;即将..的,可能..的; [v]预备,准备; [n]现款;准备好的状态; [adv]已完成地,已就绪地; [or]zk;
real: [a]/ˈriːəl/; [n]实在的东西; [adj]真实的;真的; [adv]真正地; [or]zk;
reality: [a]/riˈæləti/; [n]现实,实际;真实; [or]zk;
realize: [a]/ˈriːəlaɪz/; [v]认识到,体会到;实现; [or]zk;
really: [a]/ˈriːəli/; [adv]真正地,事实上;确实;非常,极其; [or]zk;
reason: [a]/ˈriːzn/; [n]原因,理由,理智,理性; [v]理论,论证,推理,劝说; [or]zk;
reasonable: [a]/ˈriːznəbl/; [adj]适当的;合理的;通情达理的;(价格)公道的; [or]zk;
receive: [a]/rɪˈsiːv/; [vt]收到;遭受;对.作出反应;接待,会客,接见,招待;获得;接受,容纳;<电子学>接收; [v]接球; [or]zk;
receiver: [a]/rɪˈsiːvər/; [n]听筒;收受人,接待者,尤指收款员;接收器;收件人,收款人;〔破产企业或公司的〕管理人,接管人;买卖赃物者; [or]zk;
recent: [a]/ˈriːsnt/; [adj]最近的,近来的; [or]zk;
recite: [a]/rɪˈsaɪt/; [vi]背诵;朗诵; [vt]背诵;朗诵;叙述;列举; [or]zk;
recognize: [a]/ˈrekəɡnaɪz/; [v]辨别,认出;赏识,表彰;承认;赞成; [or]zk;
record: [a]/rɪˈkɔːrd/; [v]记录,把(声音,图像)录下; [n]档案,记录; [or]zk;
recorder: [a]/rɪˈkɔːrdər/; [n]记录员;录音机; [or]zk;
recover: [a]/rɪˈkʌvər/; [v]恢复;痊愈,恢复健康;收回;换回;重新获得;重新找到; [or]zk;
recycle: [a]/ˌriːˈsaɪkl/; [v]回收利用;改建; [n]再循环; [or]zk;
red: [a]/red/; [adj]红色的; [n]红色; [or]zk;
reduce: [a]/rɪˈduːs/; [v]减少,减小,降低,精简; [or]zk;
refrigerator: [a]/rɪˈfrɪdʒəreɪtər/; [n]冰箱,冷藏库; [or]zk;
refuse: [a]/rɪˈfjuːz/; [v]拒绝;抵制; [n]废料;垃圾; [adj]无价值的; [or]zk;
regard: [a]/rɪˈɡɑːrd/; [n]尊敬;问候,关心; [v]尊敬;把..视为; [or]zk;
regards: [a]/rɪˈɡɑːrdz/; [n]问候,致意; [v]认为;注意;(尤指以某种方式)注视;尊敬; [or]zk;
regret: [a]/rɪˈɡret/; [n]后悔,遗憾; [vt]懊悔,后悔;抱歉; [vi]感到后悔,感到抱歉; [or]zk;
regular: [a]/ˈreɡjələr/; [adj]有规律的,定期的,经常的,匀称的; [n]常客;正式队员; [or]zk;
relation: [a]/rɪˈleɪʃn/; [n]家属,亲属;关系,联系; [or]zk;
relationship: [a]/rɪˈleɪʃnʃɪp/; [n]关系,关联; [or]zk;
relative: [a]/ˈrelətɪv/; [n]亲戚,家人,亲属;相关物,关系词,同类事物; [adj]相对的;有关系的,(语)关系的; [or]zk;
relax: [a]/rɪˈlæks/; [v]放松;使..放松;宽慰;放宽; [or]zk;
relay: [a]/ˈriːleɪ/; [n]替班;转播;接力赛跑; [v]转播;传递; [or]zk;
reliable: [a]/rɪˈlaɪəbl/; [adj]可靠的;可信赖的;确实的; [or]zk;
relief: [a]/rɪˈliːf/; [n]安慰;解脱;减轻;浮雕;凸显,起伏;救济金;救济物资;换班人;接替人; [or]zk;
remain: [a]/rɪˈmeɪn/; [v]剩余;逗留;保持不变;依然,继续; [n]剩余物;遗迹;残骸; [or]zk;
remember: [a]/rɪˈmembər/; [v]记得,想起;记住; [or]zk;
remind: [a]/rɪˈmaɪnd/; [v]提醒,使想起; [or]zk;
remote: [a]/rɪˈmoʊt/; [n]遥控器; [adj]遥远的;偏僻的;关系远的; [or]zk;
remove: [a]/rɪˈmuːv/; [v]把..免职;脱下,摘下;除掉,去除;移开; [n]间距; [or]zk;
rent: [a]/rent/; [n]租金; [v]租用,出租; [or]zk;
repair: [a]/rɪˈper/; [v]修理;补救;纠正; [n]修理,修补; [or]zk;
repeat: [a]/rɪˈpiːt/; [v]重复;重做; [n]复制;重奏; [or]zk;
reply: [a]/rɪˈplaɪ/; [n]回答,答复; [v]回答,答复; [ex]~ to sb/回复某人; [add]pl/replies,s3/replies,pr/replying,pt/replied,pp/replied; [or]zk;
report: [a]/rɪˈpɔːrt/; [n]报告,汇报,报道; [v]报告,汇报,报道; [or]zk;
require: [a]/rɪˈkwaɪər/; [v]需要;(of)要求,命令; [or]zk;
research: [a]/ˈriːsɜːrtʃ/; [v]研究,调查; [n]研究,调查; [or]zk;
rest: [a]/rest/; [v]休息,静止; [n]剩余的部分;休息,静止; [or]zk;
restaurant: [a]/ˈrestrɑːnt/; [n]饭馆,餐馆; [or]zk;
result: [a]/rɪˈzʌlt/; [n]结果,成效; [v]导致,..的结果; [or]zk;
return: [a]/rɪˈtɜːrn/; [n]返回;回答; [adj]返回的;报答的;重现的; [v]返回;归还;回报;回答; [or]zk;
review: [a]/rɪˈvjuː/; [v]温习,复习;评论;回顾,反思; [n]复习,回顾;检讨;评审,审查; [or]zk;
reward: [a]/rɪˈwɔːrd/; [n]奖品,报酬,回报;悬赏; [v]报答,酬谢; [or]zk;
rice: [a]/raɪs/; [n]米饭;米;稻; [v]筛选; [or]zk;
rich: [a]/rɪtʃ/; [adj]富有的;肥沃的;昂贵的; [or]zk;
riddle: [a]/ˈrɪdl/; [n]谜,谜语; [v]解谜,出谜题,满是弹孔; [or]zk;
ride: [a]/raɪd/; [v]骑,乘; [n]乘坐,骑;搭便车;兜风; [or]zk;
right: [a]/raɪt/; [n]正义;正确,权利;右边; [adj]正当的;对的,正确的;合适的;健康的;完全的; [adv]正当地;正确地;立即地;完全地,彻底地,在右边; [or]zk;
ring: [a]/rɪŋ/; [n]戒指;环;集团;响声; [v]套上环;成环状;敲钟;打电话; [or]zk;
rise: [a]/raɪz/; [n]上升,上涨,增加; [v]上升,上涨,升起,起身,增长; [or]zk;
risk: [a]/rɪsk/; [n]风险;危险;冒险; [v]冒..的危险,使..冒风险; [or]zk;
river: [a]/ˈrɪvər/; [n]河,江; [or]zk;
riverbed: [a]/ˈrɪvərˌbed/; [n]河床; [or]zk;
riverside: [a]/ˈrɪvərsaɪd/; [n]河岸,河畔; [adj]河边的,河畔的; [or]zk;
road: [a]/roʊd/; [n]路,道路;公路,大道; [adj]巡回的; [or]zk;
roadside: [a]/ˈroʊdsaɪd/; [n]路边,路旁; [adj]路边的,路旁的; [or]zk;
roast: [a]/roʊst/; [v]烤,炙,烘;挖苦;逗乐; [n]烤肉; [adj]烤的,烘的; [or]zk;
rob: [a]/rɑːb/; [v]抢劫,盗取,非法剥夺; [or]zk;
robber: [a]/ˈrɑːbər/; [n]强盗,盗贼; [or]zk;
robbery: [a]/ˈrɑːbəri/; [n]抢掠,抢夺; [or]zk;
robot: [a]/ˈroʊbɑːt/; [n]机器人;自动机; [or]zk;
rock: [a]/rɑːk/; [v]摇晃,震动,演奏摇滚; [n]岩石;摇滚乐; [or]zk;
rocket: [a]/ˈrɑːkɪt/; [n]火箭;芝麻菜; [vi]飞快地移动;猛涨; [or]zk;
role: [a]/roʊl/; [n]角色;作用; [or]zk;
roof: [a]/ruːf/; [n]屋顶;顶部; [vt]覆盖,给..盖屋顶; [or]zk;
room: [a]/ruːm/; [n]房间;空间;机会,可能性; [v]合住; [or]zk;
rope: [a]/roʊp/; [n]绳,索;一串;绞刑; [v]用绳捆(或扎等); [or]zk;
rose: [a]/roʊz/; [n]玫瑰,蔷薇; [adj]玫瑰色的; [or]zk;
rough: [a]/rʌf/; [adj]粗糙的;大致的,粗略的;(海)波涛汹涌的;困难的,令人不快的; [n]草稿; [adv]粗暴地; [v]艰苦生活; [or]zk;
round: [a]/raʊnd/; [adj]圆的,球形的; [n]圆,圆形物; [adv]围绕着,循环地; [v]使成圆形; [prep]围着,绕过,在周围; [or]zk;
route: [a]/raʊt/; [n]路线;固定路线;途径;渠道; [vt]按某路线发送;给.规定路线[次序,程序]; [or]zk;
row: [a]/roʊ/; [n]排,行;争吵; [vi]划(船等);争吵; [vt]划船; [or]zk;
rub: [a]/rʌb/; [v]抚摸;摩擦;擦破; [n]蹭;障碍;磨损处; [or]zk;
rubber: [a]/ˈrʌbər/; [n]橡皮,橡胶;橡胶制品,胶鞋; [or]zk;
rubbish: [a]/ˈrʌbɪʃ/; [n]垃圾,废物;废话; [or]zk;
rude: [a]/ruːd/; [adj]粗鲁的,无礼貌的;猛烈的,狂暴的; [or]zk;
rule: [a]/ruːl/; [v]统治,控制;支配;裁决; [n]规定,规章,条例;习惯;统治,管辖; [or]zk;
ruler: [a]/ˈruːlər/; [n]尺,直尺;统治者,支配者; [or]zk;
run: [a]/rʌn/; [v]跑步,奔跑;组织,掌管,管理,运营(公司等);运转,运作; [n]跑步,赛跑,跑的距离,跑的时间;(某产品一次性生产出的)数量;一连串,一系列; [or]zk;
runner: [a]/ˈrʌnər/; [n]跑步者;信差;蔓藤植物; [or]zk;
rush: [a]/rʌʃ/; [v]冲,奔;赶忙做;匆忙; [n]冲,急速行进;繁忙时期;仓促;(交通)繁忙时段; [or]zk;
sad: [a]/sæd/; [adj]难过的,悲伤的,忧愁的;悲哀的,令人悲痛的,令人伤心的;(状况)糟糕的,令人无法接受的;乏味的,无趣的; [or]zk;
safe: [a]/seɪf/; [n]保险箱;冷藏箱; [adj]安全的;可靠的;有把握的;稳妥的;可靠的,稳妥的; [adv]安全地; [or]zk;
safety: [a]/ˈseɪfti/; [n]安全,保险;安全设备,保险装置;安全场所; [adj]保障安全的; [or]zk;
sail: [a]/seɪl/; [n]帆,航行; [v]航行; [or]zk;
salad: [a]/ˈsæləd/; [n]色拉,沙拉;凉拌菜; [or]zk;
sale: [a]/seɪl/; [n]廉价出售,销售额,拍卖; [or]zk;
salesgirl: [a]/ˈseɪlzɡɜːrl/; [n]女售货员; [or]zk;
salesman: [a]/ˈseɪlzmən/; [n]售货员,推销员; [or]zk;
salt: [a]/sɔːlt/; [n]食盐; [adj]含盐的,腌制的; [v]加盐于,用盐腌; [or]zk;
same: [a]/seɪm/; [adj]相同的,同样的,同一的,一模一样的;上述的;千篇一律的,单调的,无变化的,依然如故的; [pron]同样的事物,同样的人; [adv]同样地;仍然; [or]zk;
sand: [a]/sænd/; [n]沙,沙子,沙堆; [v]用砂纸打磨; [or]zk;
sandwich: [a]/ˈsænwɪtʃ/; [n]三明治,夹肉面包; [vt]夹入,挤进; [or]zk;
satellite: [a]/ˈsætəlaɪt/; [n]卫星;人造卫星;随体; [adj]卫视的; [or]zk;
satisfaction: [a]/ˌsætɪsˈfækʃn/; [n]满足,满意;乐事;补偿; [or]zk;
satisfactory: [a]/ˌsætɪsˈfæktəri/; [adj]令人满意的;良好的; [or]zk;
satisfy: [a]/ˈsætɪsfaɪ/; [v](使)满意,满足;符合.的标准;使确信,说服; [or]zk;
sausage: [a]/ˈsɔːsɪdʒ/; [n]香肠; [or]zk;
save: [a]/seɪv/; [v]救,救助;节省; [vt]拯救;保留;节省;储蓄; [n]救球,救援; [prep]除...外; [or]zk;
say: [a]/seɪ/; [v]说; [n]发言权; [or]zk;
scarf: [a]/skɑːrf/; [n]围巾,披肩; [v]围(围巾);打(领带);披(披巾);用围巾台布围盖;贪婪地吃;狼吞虎咽; [or]zk;
scenery: [a]/ˈsiːnəri/; [n]风景;布景; [or]zk;
school: [a]/skuːl/; [n]学校;学院;流派;(鱼,海豚的)一群; [v]教育; [or]zk;
schoolbag: [a]/'skuːlbæg/; [n]书包; [or]zk;
schoolboy: [a]/ˈskuːlbɔɪ/; [n]男学生;学童; [adj]男学生的; [or]zk;
schoolmate: [a]/ˈskuːlmeɪt/; [n]同学; [or]zk;
science: [a]/ˈsaɪəns/; [n]科学;(科学的) 学科; [or]zk;
scientist: [a]/ˈsaɪəntɪst/; [n]科学家; [or]zk;
scissors: [a]/ˈsɪzərz/; [n]剪刀; [or]zk;
score: [a]/skɔːr/; [n]得分;刻痕;二十;配乐; [vi]刻痕; [v]得分; [vt]在.上刻痕; [or]zk;
scream: [a]/skriːm/; [vi]发出歇斯底里的声音,尖叫; [vt]尖叫着说出; [n]尖叫声; [or]zk;
screen: [a]/skriːn/; [n]屏幕,荧光屏;纱窗; [v]遮蔽;放映;检查; [or]zk;
sea: [a]/siː/; [n]海洋,海域,许多; [or]zk;
seafood: [a]/ˈsiːfuːd/; [n]海产食品,海味; [or]zk;
seagull: [a]/ˈsiːɡʌl/; [n]海鸥; [or]zk;
seal: [a]/siːl/; [n]海豹;邮戳;封条;火漆印; [v]封(信封),密封,盖章;封锁;缄口; [or]zk;
search: [a]/sɜːrtʃ/; [v]搜索;搜寻;探查; [n]搜索;搜寻;探求; [or]zk;
season: [a]/ˈsiːzn/; [n]季(节),节期,时期; [v]给.调味,风干(木柴); [or]zk;
seat: [a]/siːt/; [n]座位,地位,位置; [v]安装,使坐下; [or]zk;
secondhand: [a]/ˌsekənd ˈhænd/; [adj]二手的,旧的;间接获得的; [adv]间接地;二手货地; [or]zk;
secret: [a]/ˈsiːkrət/; [n]秘密; [adj]秘密的,机密的; [or]zk;
secretary: [a]/ˈsekrəteri/; [n]秘书;干事,文书;部长,大臣; [or]zk;
see: [a]/siː/; [v]看;了解,领会;注意;经历; [n]主教教区;主角权限; [or]zk;
seed: [a]/siːd/; [n]种子,籽;种子选手; [v]播种,结籽; [or]zk;
seem: [a]/siːm/; [v]似乎,好像; [or]zk;
seldom: [a]/ˈseldəm/; [adv]很少,不常; [adj]不常的;稀少的; [or]zk;
self-respect: [a]/ˌself rɪˈspekt/; [n]自重,自尊; [or]zk;
sell: [a]/sel/; [v]出售,卖; [or]zk;
send: [a]/send/; [v]送,寄;发送; [adj]用于发送的(仅用作定语); [n]波浪的推(进)力; [or]zk;
sense: [a]/sens/; [n]感官,官能;感觉;判断力;见识; [v]觉得,意识到; [or]zk;
sentence: [a]/ˈsentəns/; [v]判决,宣判; [n]句子;判决; [or]zk;
separate: [a]/ˈsepəreɪt/; [adj]独立的;分开的;单独的; [v]使分开,分离,分割,划分; [or]zk;
serious: [a]/ˈsɪriəs/; [adj]严重的,危急的;重要的,重大的;认真的,严肃的; [or]zk;
servant: [a]/ˈsɜːrvənt/; [n]仆人; [or]zk;
serve: [a]/sɜːrv/; [v]为.服务;招待;供应;服役; [n]网球等发球;发球权;所发的球; [or]zk;
service: [a]/ˈsɜːrvɪs/; [n]服务,帮助;公共设施,公用事业;维修保养;服务机构;发球,发球方式; [v]保养,维修;支付(借款)利息;为..服务,提供服务; [adj](军队)服现役的,服务性的,仆人的,耐用的; [or]zk;
set: [a]/set/; [n]一套,一副,一批,装置,趋势,布景; [adj]固定的,规定的,坚决的; [v]放置,使,树立,调整; [or]zk;
settle: [a]/ˈsetl/; [v]安顿;定居;解决;调停;(目光)停留;结算,算清; [n]背长椅,座位;定居,安顿; [or]zk;
seven: [a]/ˈsevn/; [num]七,七个; [n]七个,七点; [or]zk;
seventeen: [a]/ˌsevnˈtiːn/; [num]十七;十七岁的,十七(个)的; [or]zk;
seventh: [a]/ˈsevnθ/; [n]第七;七分之一; [adj]第七的;七分之一的; [adv]居第七位地; [num]第七;七分之一; [or]zk;
seventy: [a]/ˈsevnti/; [num]七十,七十个;七十的,七十个的; [n]七十;从七十到七十九的数目,年数或温度; [or]zk;
several: [a]/ˈsevrəl/; [det]几个,若干,数个; [adj]各自的,分别的; [or]zk;
shake: [a]/ʃeɪk/; [n]摇动,摇;颤抖,震动; [v]摇动; [or]zk;
shall: [a]/ʃæl/; aux. 表示提供建议,将要,应该,一定; [or]zk;
shame: [a]/ʃeɪm/; [n]羞耻,羞愧;羞愧感;耻辱; [vt]使感到羞耻;使蒙羞; [or]zk;
shape: [a]/ʃeɪp/; [v]使形成,塑造; [n]外形,形状,轮廓;状态;结构; [or]zk;
share: [a]/ʃer/; [v]合用;分配,均分;分享;分担; [n]一份,份额;股票,股份; [or]zk;
shark: [a]/ʃɑːrk/; [n]鲨鱼;骗子; [or]zk;
sharp: [a]/ʃɑːrp/; [adj]锋利的;敏锐的;清晰的; [adv]急剧地;锐利地;突然地;整点; [n](音乐)升半音;磨; [or]zk;
sharpen: [a]/ˈʃɑːrpən/; [v]削尖;磨快;使敏捷;使提高; [or]zk;
sharpener: [a]/ˈʃɑːrpnər/; [n]削尖用的器具; [or]zk;
shave: [a]/ʃeɪv/; [v]剃,刮 [n]修面 [sw]shaver; [or]zk;
sheep: [a]/ʃiːp/; [n]羊,绵羊,羞答答的人,胆小鬼,信徒; [or]zk;
shelf: [a]/ʃelf/; [n]架子,搁板; [or]zk;
shellfish: [a]/ˈʃelfɪʃ/; [n]贝;有壳的水生动物; [or]zk;
shepherd: [a]/ˈʃepərd/; [n]牧羊人; [v]带领; [or]zk;
shine: [a]/ʃaɪn/; [v]照耀,发光;擦亮; [n]光泽,光; [or]zk;
ship: [a]/ʃɪp/; [n]船,海船,舰,飞船; [v]装上船;运送,航运; [or]zk;
shirt: [a]/ʃɜːrt/; [n]衬衫,衬衣; [v]给..穿上衬衫; [or]zk;
shoe: [a]/ʃuː/; [n]鞋; [v]穿鞋;给(马)钉蹄铁; [or]zk;
shoot: [a]/ʃuːt/; [n]发芽; [v]射击,射杀; [sw]shot,soot; [or]zk;
shop: [a]/ʃɑːp/; [n]商店,店铺; [v]买东西;购货; [or]zk;
shopkeeper: [a]/ˈʃɑːpkiːpər/; [n]店主; [or]zk;
shopping: [a]/ˈʃɑːpɪŋ/; [n]购物;商品; [or]zk;
short: [a]/ʃɔːrt/; [adj]矮的,短的,短期的,短缺的,简略的,粗暴无礼的; [adv]缺少,未达到,半中间(打断),过早地(终止); [n]电影短片;少量烈酒; [vt](比平时)快速完成; [v]短路; [or]zk;
shorts: [a]/ʃɔːrts/; [n]短裤;运动短裤; [or]zk;
shot: [a]/ʃɑːt/; [n]发射;炮弹,射击,枪声;射手;击球;少量烈酒;照片,影片,镜头;注射; [v]射击; [adj]用尽的;破旧的;杂色的,闪光的; [or]zk;
shoulder: [a]/ˈʃoʊldər/; [n]肩膀,肩部; [vt]肩负,承当; [or]zk;
shout: [a]/ʃaʊt/; [v]呼喊,呼叫; [n]呼喊,呼叫; [add]pl/shouts; s3/shouts,pr/shouting,pt/shouted,pp/shouted; [ex]give someone a shout/引起某人注意(非正式); [sw]stout,spout; [or]zk;
show: [a]/ʃoʊ/; [v]展示;显示,表明; [n]演出,展览; [or]zk;
shower: [a]/ˈʃaʊər/; [n]淋浴,淋浴器;阵雨; [v]洗淋浴,淋湿; [or]zk;
showery: [a]/ˈʃaʊəri/; [adj]阵雨的;多阵雨的; [or]zk;
shut: [a]/ʃʌt/; [v]关上,闭上; [or]zk;
shy: [a]/ʃaɪ/; [adj]怕羞的,害羞的;畏缩的; [v](马)惊走,惊退; [n]惊退; [or]zk;
sick: [a]/sɪk/; [adj]有病的,恶心的; [n]病人; [v]呕吐; [or]zk;
side: [a]/saɪd/; [n]边;面;一方,一面; [adj]旁边的,侧面的,副的,枝节的; [v]站在同一边; [or]zk;
sight: [a]/saɪt/; [n]视力,看见,视线,景物; [v]瞄准,看见,观测; [adj]见票即付的;即席的; [or]zk;
sightseeing: [a]/ˈsaɪtsiːɪŋ/; [n]观光;游览; [adj]观光的,浏览的; [or]zk;
sign: [a]/saɪn/; [v]签署;使眼色;做暗号;做手势; [n]记号,符号;标志,手势; [or]zk;
silence: [a]/ˈsaɪləns/; [n]沉默; [v]使沉默; [or]zk;
silent: [a]/ˈsaɪlənt/; [adj]沉默的,寂静的; [n]无声电影; [or]zk;
silk: [a]/sɪlk/; [n]丝,丝绸; [or]zk;
silly: [a]/ˈsɪli/; [adj]傻的;愚蠢的; [n](通常指小孩子)淘气鬼;傻孩子; [or]zk;
silver: [a]/ˈsɪlvər/; [n]银,银子;银器;银币;银牌; [adj]银的;银色的;银婚的; [vt]镀银于,使..成银色; [or]zk;
similar: [a]/ˈsɪmələr/; [adj]相似的;类似的; [n]类似物;相像的人;相似物; [or]zk;
simple: [a]/ˈsɪmpl/; [adj]简单的;简朴的;天真的;无经验的; [or]zk;
since: [a]/sɪns/; [adv]从那时以来; [conj]从..以来,..以后,由于; [prep]从..以来; [or]zk;
sing: [a]/sɪŋ/; [v]唱;演唱; [n]合唱会; [or]zk;
singer: [a]/ˈsɪŋər/; [n]歌手; [or]zk;
single: [a]/ˈsɪŋɡl/; [adj]单个的;未婚的;单身的;单人的; [n]单程票; [v]拣出,挑选(现通常与out连用);作一垒手; [or]zk;
sink: [a]/sɪŋk/; [n]水槽,洗碗池; [v](使)下沉,(使)降低;淹没,下落;使沉没; [adj]贫民窟的; [or]zk;
sir: [a]/sɜːr/; [n]先生;敬启者;爵士; [or]zk;
sister: [a]/ˈsɪstər/; [n]姐妹,姐,妹;修女;女会员;女同胞; [or]zk;
sit: [a]/sɪt/; [v]坐;(使)就座,(使)坐; [or]zk;
situation: [a]/ˌsɪtʃuˈeɪʃn/; [n]形势,局面,处境,状况;位置,场所;职位,职务; [or]zk;
six: [a]/sɪks/; [num]六,六个; [or]zk;
sixteen: [a]/ˌsɪksˈtiːn/; [num]十六,十六个;十六岁的,十六年的;十六的; [n]十六,十六个;十六岁;十六点钟;十六的记号; [or]zk;
sixth: [a]/sɪksθ/; [num]第六个; [n]第六个;六分之一; [adj]第六个的; [pron]第六; [or]zk;
sixty: [a]/ˈsɪksti/; [num]六十,六十个;六十的; [n]六十,六十个; [or]zk;
size: [a]/saɪz/; [n]大小,尺寸,规模;尺码; [v]估算,估量尺寸大小,估量,判断; [or]zk;
skate: [a]/skeɪt/; [v]溜冰,滑冰;掠过; [n]冰鞋,滑冰; [or]zk;
skill: [a]/skɪl/; [n]技能;技巧,技艺;巧妙; [or]zk;
skirt: [a]/skɜːrt/; [n]裙子; [v]装边于; [or]zk;
sky: [a]/skaɪ/; [n]天空; [v]将..击向空中; [or]zk;
sleep: [a]/sliːp/; [v]睡,睡觉; [n]睡眠,梦乡; [or]zk;
sleepy: [a]/ˈsliːpi/; [adj]困乏的,欲睡的; [or]zk;
slipper: [a]/ˈslɪpər/; [n]拖鞋;便鞋; [v]穿着拖鞋走;用拖鞋打; [or]zk;
slow: [a]/sloʊ/; [adj]迟钝的,不活跃的,缓慢的; [adv]缓慢地; [v](使)慢下来,(使)减速,减缓; [or]zk;
small: [a]/smɔːl/; [adj]小的,少的;卑微的;感到惭愧的; [adv]小地;小块地;小声地; [n]狭小部分;(pl.)零星物品;(pl.)小件衣服;(人体的) 后腰; [or]zk;
smart: [a]/smɑːrt/; [adj]时髦的,衣着讲究的;聪明的;干净的,整洁的; [v]剧痛,刺疼; [or]zk;
smile: [a]/smaɪl/; [v]微笑; [n]微笑; [or]zk;
smog: [a]/smɑːɡ/; [n]烟雾; [or]zk;
smoke: [a]/smoʊk/; [n]烟,烟尘; [v]抽(烟),冒烟; [or]zk;
smoking: [a]/ˈsmoʊkɪŋ/; [n]抽烟,冒烟; [or]zk;
smooth: [a]/smuːð/; [adj]光滑的;平稳的; [v]使光滑;使平稳; [or]zk;
snake: [a]/sneɪk/; [n]蛇; [v]迂回前进; [or]zk;
snow: [a]/snoʊ/; [n]雪; [v]下雪; [or]zk;
snowman: [a]/ˈsnoʊmæn/; [n]雪人; [or]zk;
snowy: [a]/ˈsnoʊi/; [adj]下雪的;被雪覆盖的;洁白无瑕的; [or]zk;
so-called: [a]/ˌsoʊ ˈkɔːld/; [adj]所谓的,号称的; [or]zk;
soap: [a]/soʊp/; [n]肥皂; [v]用肥皂擦洗; [or]zk;
soccer: [a]/ˈsɑːkər/; [n]足球; [or]zk;
social: [a]/ˈsoʊʃl/; [adj]社会的;交际的,社交的; [n]联谊会,联欢会;社交聚会; [or]zk;
society: [a]/səˈsaɪəti/; [n]社会;协会;社交界; [or]zk;
sofa: [a]/ˈsoʊfə/; [n](长)沙发; [or]zk;
soft: [a]/sɔːft/; [adj]软的;温柔的;细嫩的,光滑的;不含酒精的; [n]柔软的东西; [adv]柔软地,柔和地; [or]zk;
software: [a]/ˈsɔːftwer/; [n]软件; [or]zk;
soil: [a]/sɔɪl/; [n]泥土,土壤;土地,国土; [v]弄脏;污损; [or]zk;
soldier: [a]/ˈsoʊldʒər/; [n]士兵,军人; [v]当兵; [or]zk;
solid: [a]/ˈsɑːlɪd/; [adj]结实的;坚固的;固体的; [n]固体; [or]zk;
solve: [a]/sɔːlv/; [v]解决;解释,解答; [or]zk;
somebody: [a]/ˈsʌmbədi/; [pron]某人;有人;大人物,重要人物; [or]zk;
someday: [a]/ˈsʌmˌdeɪ/; [adv]有一天,有朝一日; [or]zk;
someone: [a]/ˈsʌmwʌn/; [pron]有人,某人;重要人物; [or]zk;
something: [a]/ˈsʌmθɪŋ/; [pron]某事物,有价值或重要的人或事物,大致; [adv]有点,非常;有点像,大约; [n](表示不确切的描述或数量)某事,某物; [or]zk;
sometime: [a]/ˈsʌmtaɪm/; [adv]在某一时候; [adj]某一时间的;以前的; [or]zk;
sometimes: [a]/ˈsʌmtaɪmz/; [adv]有时,间或; [or]zk;
somewhere: [a]/ˈsʌmwer/; [adv]到某处,在某处; [n]某处; [or]zk;
son: [a]/sʌn/; [n]儿子;(长者对晚辈的爱称)孩子; [or]zk;
sonata: [a]/səˈnɑːtə/; [n]奏鸣曲; [or]zk;
song: [a]/sɔːŋ/; [n]歌曲;诗歌,韵文;鸟鸣;低价; [or]zk;
soon: [a]/suːn/; [adv]立刻,不久;快,早; [or]zk;
sorry: [a]/ˈsɑːri/; [adj]遗憾的,对不起的,可怜的,抱歉的; [int]对不起,抱歉; [or]zk;
sort: [a]/sɔːrt/; [v]把..分类,挑选;修理,整理; [n]种类; [or]zk;
sound: [a]/saʊnd/; [v]发声,听起来;听起来好像,让人听着好像; [n]声音,声响; [adj]健全的,完好的;正当的,有根据的;彻底的,充分的; [adv]酣(睡),(睡得)沉; [or]zk;
soup: [a]/suːp/; [n]汤; [or]zk;
sour: [a]/ˈsaʊər/; [adj]酸的;(人)尖酸刻薄的,不友好的; [v](友谊,局势,态度等)变坏;使恶化; [or]zk;
south: [a]/saʊθ/; [adv]在南方,向南方; [adj]南的,南方的; [n]南部,南方; [or]zk;
southeast: [a]/ˌsaʊθˈiːst/; [n]东南(方),东南部; [adv]向东南; [adj]东南方的,东南部的; [or]zk;
southern: [a]/ˈsʌðərn/; [adj]南的,南方的; [n]南方人,南部人; [or]zk;
southwest: [a]/ˌsaʊθˈwest/; [n]西南; [adj]西南方的; [adv]在西南方,来自西南; [or]zk;
space: [a]/speɪs/; [n](两物或某物两部分之间的)空当,空隙,间隔,距离;(尤指有特定用途的)空地,余地,空间,空位,处所;空间,太空;(个人的)生活空间,个人自由(尤指在与别人的关系里); [v]留间隔,隔开; [or]zk;
spaceship: [a]/ˈspeɪsʃɪp/; [n]宇宙飞船; [or]zk;
spanish: [a]/ˈspænɪʃ/; [adj]西班牙(人)的; [n]西班牙语; [or]zk;
speak: [a]/spiːk/; [v]说话;说某种语言;发言,表述意见;说出;朗读; [or]zk;
speaker: [a]/ˈspiːkər/; [n]说话人,演讲人,扬声器; [or]zk;
special: [a]/ˈspeʃl/; [adj]特殊的,专门的;附加的,额外的; [n]特色菜;特价;特别节目;专长; [or]zk;
speech: [a]/spiːtʃ/; [n]演说,讲话;言语,语言; [or]zk;
speed: [a]/spiːd/; [n]速度,速率;迅速; [v]加速; [or]zk;
spell: [a]/spel/; [n]符咒,魅力,一段时间,轮班; [v]拼写,拼成,意味着,轮值,招致,迷住; [vi]轮替,拼字; [or]zk;
spend: [a]/spend/; [v]花费,用钱;花(时间或精力);度过; [n](为某目的或某段时间内的)花销,花费,开销; [or]zk;
spill: [a]/spɪl/; [v]使溢出;使流出;撒;浇(花等); [n]溢出,溅出;溢出量;摔下; [or]zk;
spirit: [a]/ˈspɪrɪt/; [n]灵魂,精神;心灵;幽灵;意志,精力;实质;情绪;烈酒(spirits); [v]鼓励;使振作;诱拐; [or]zk;
spit: [a]/spɪt/; [v]吐(唾沫); [n]唾液,唾沫,叉子; [or]zk;
splendid: [a]/ˈsplendɪd/; [adj]壮观的,辉煌的,华丽的;极好的,出色的; [or]zk;
spoil: [a]/spɔɪl/; [v]溺爱;娇惯;(食物)变质;毁坏; [n]溺爱;战利品;犒劳;成功所带来的好处; [or]zk;
spoon: [a]/spuːn/; [n]匙,调羹; [vt]用匙舀; [or]zk;
sport: [a]/spɔːrt/; [n]运动,娱乐; [v]炫耀,卖弄; [or]zk;
spot: [a]/spɑːt/; [n]斑点;污点;地点,场所;排名位置;困境;滴;节目档; [v]发现,认出;玷污; [or]zk;
spread: [a]/spred/; [v]伸开,伸展,散布,传播,摊开,覆盖; [n]伸开,伸展,散布,传播,摊开,范围; [adj]广大的;大幅的;(宝石)薄而无光泽的; [or]zk;
spring: [a]/sprɪŋ/; [n]春天;弹簧,弹性;泉,泉源;跳跃; [v]反弹,跳,跃,(使)跳起,(使)弹开;生长,涌出,跃出; [or]zk;
spy: [a]/spaɪ/; [n]间谍,密探; [v]当间谍,暗中监视(或侦察); [or]zk;
square: [a]/skwer/; [n]正方形;广场; [adj]正方形的;平方的;直角的; [v]把..弄成方形; [adv]直接地; [or]zk;
stamp: [a]/stæmp/; [n]印,章;邮票; [v]盖印;贴邮票于;毁掉;标出,表示;跺脚; [or]zk;
stand: [a]/stænd/; [n]讲台;货摊;看台; [vi]站立;起立; [vt]使站立;维持原状;位于; [or]zk;
standard: [a]/ˈstændərd/; [n]标准,规格;规范; [adj]标准的; [or]zk;
star: [a]/stɑːr/; [n]星,恒星,明星,名角; [adj]用星装饰的; [v]主演; [or]zk;
start: [a]/stɑːrt/; [v]开始,着手;动身;吃惊;开办,开动; [n]开端,起点,惊起,吃惊; [or]zk;
state: [a]/steɪt/; [n]情况,情形,状态,状况;州;国家; [v]说明,陈述; [adj]国家的,州的;国务的,公务的;正式的; [or]zk;
station: [a]/ˈsteɪʃn/; [n]车站;站,台;身份,地位; [v]安置,驻扎; [or]zk;
stay: [a]/steɪ/; [v]停留,待在,暂住,坚持,止住,抑制,延缓,停(下); [n]逗留,延缓;中止,支柱; [or]zk;
steak: [a]/steɪk/; [n]牛排;肉块;鱼块; [or]zk;
steal: [a]/stiːl/; [v]偷盗,行窃;悄悄地走; [n]便宜货; [or]zk;
steam: [a]/stiːm/; [n]蒸汽;轮船; [v]蒸发,冒热气;蒸;快速行进; [or]zk;
steel: [a]/stiːl/; [n]钢,钢铁,钢制品; [v]使坚强; [adj]钢的,与钢有关的; [or]zk;
steep: [a]/stiːp/; [v]沉浸于..; [adj]陡峭的;急剧的;过高的; [n]陡坡; [or]zk;
steer: [a]/stɪr/; [v]操纵,驾驶,掌舵,引导; [n]公牛,食用牛; [or]zk;
step: [a]/step/; [n]脚步,脚印,脚步声;步骤,措施,阶段;台阶,门阶; [v]踩;走,举步,移步; [or]zk;
stick: [a]/stɪk/; [v]坚持;粘贴,刺,戳,扎; [n]棍,棒,手杖; [or]zk;
still: [a]/stɪl/; [n]寂静,剧照,照片; [v]使安静,使镇定下来; [adj]静止的,静寂的; [adv]还,仍,尽管如此,依然; [conj]但是,然而; [or]zk;
stocking: [a]/ˈstɑːkɪŋ/; [n]长(筒)袜; [or]zk;
stomach: [a]/ˈstʌmək/; [n]胃,胃口; [vt]忍受;吃得下; [or]zk;
stone: [a]/stoʊn/; [n]石头,石料,英石; [or]zk;
stop: [a]/stɑːp/; [v]停止;塞住;阻止;逗留; [n]停车站;停止,中止; [or]zk;
store: [a]/stɔːr/; [n]商店;储存品; [v]贮藏,储存; [or]zk;
storm: [a]/stɔːrm/; [n]风暴;暴风雨,暴风雪; [vi]起风暴;大发雷霆;横冲直撞; [vt]使受到暴风雨的袭击;袭击; [or]zk;
story: [a]/ˈstɔːri/; [n]故事,小说;叙述,描述;新闻报道;谎言,假话;楼层; [or]zk;
stove: [a]/stoʊv/; [n]炉,火炉,电炉; [or]zk;
straight: [a]/streɪt/; [adj]直的;正直的; [adv]直接地;不断地,一直地;立即;直地,笔直地; [n]直线;直线部分; [or]zk;
strange: [a]/streɪndʒ/; [adj]陌生的;奇怪的; [or]zk;
stranger: [a]/ˈstreɪndʒər/; [n]陌生人;新来者; [or]zk;
strawberry: [a]/ˈstrɔːberi/; [n]草莓; [or]zk;
stream: [a]/striːm/; [n]小河,溪流;流,一股,一串; [v]流(出),涌(出);按能力分班(或分组); [or]zk;
street: [a]/striːt/; [n]街,街道; [or]zk;
strict: [a]/strɪkt/; [adj]严厉的;严格的(条例,法规等);恪守信条的;确切的; [or]zk;
strike: [a]/straɪk/; [v]击打;袭击;罢工; [n]罢工;打击;袭击; [or]zk;
striker: [a]/ˈstraɪkər/; [n]罢工者;(足球的)前锋;锤,报点时钟; [or]zk;
strong: [a]/strɔːŋ/; [adj]强壮的,坚固的;强烈的;强大的;强硬的; [or]zk;
struggle: [a]/ˈstrʌɡl/; [n]奋斗;斗争; [v]挣扎,抗争;奋斗; [or]zk;
student: [a]/ˈstuːdnt/; [n]学生;学者; 大学生; [or]zk;
study: [a]/ˈstʌdi/; [v]学习;研究; [n]学习;书房; [or]zk;
stupid: [a]/ˈstuːpɪd/; [adj]愚蠢的,麻木的,乏味的; [or]zk;
subject: [a]/ˈsʌbdʒɪkt/; [n]科目;主题;受试者;国民; [adj]易患的,服从的; [vt]使服从,使隶属,使遭遇; [or]zk;
subway: [a]/ˈsʌbweɪ/; [n]地铁; [or]zk;
succeed: [a]/səkˈsiːd/; [v]成功;接替;继承; [or]zk;
success: [a]/səkˈses/; [n]成功,成就,胜利,成功的人或事; [or]zk;
successful: [a]/səkˈsesfl/; [adj]成功的; [or]zk;
suck: [a]/sʌk/; [v]啜,吸入,吸收;使卷入;糟糕,差劲; [n]吸吮,吸力; [or]zk;
sudden: [a]/ˈsʌdn/; [adj]突然的,意外的; [or]zk;
suddenly: [a]/ˈsʌdənli/; [adv]突然地; [or]zk;
suffer: [a]/ˈsʌfər/; [v]遭受,忍受,承受,受苦; [or]zk;
sugar: [a]/ˈʃʊɡər/; [n]食糖;糖;<口语>心爱的人,心肝,宝贝; [vi]糖化; [vt]加糖于; [or]zk;
suggest: [a]/səˈdʒest/; [v]建议,提议;使人想起,暗示; [or]zk;
suggestion: [a]/səˈdʒestʃən/; [n]建议,意见;细微的迹象;暗示;联想; [or]zk;
suit: [a]/suːt/; [n]服装;诉讼;套装; [v]合适;适宜于;使穿上套服; [or]zk;
summer: [a]/ˈsʌmər/; [n]夏季; [adj]夏季的,在夏季的; [v]避暑,过夏天; [or]zk;
sun: [a]/sʌn/; [n]太阳;阳光;恒星; [v]晒; [or]zk;
sunglasses: [a]/ˈsʌnɡlæsɪz/; [n]太阳镜,墨镜;凸透镜; [or]zk;
sunlight: [a]/ˈsʌnlaɪt/; [n]日光,阳光; [or]zk;
sunny: [a]/ˈsʌni/; [adj]阳光充足的;乐观的,快乐的; [or]zk;
sunrise: [a]/ˈsʌnraɪz/; [n]日出;朝霞; [adj]新兴的; [or]zk;
sunset: [a]/ˈsʌnset/; [n]日落; [adj]日落的; [or]zk;
sunshine: [a]/ˈsʌnʃaɪn/; [n]日光,日照; [or]zk;
super: [a]/ˈsuːpər/; [adj]极好的;超级的; [adv]非常地;十分,非常; [n]警长;(一栋楼的)监管人; [or]zk;
supermarket: [a]/ˈsuːpərmɑːrkət/; [n]超级市场,自助售货商店; [or]zk;
supper: [a]/ˈsʌpər/; [n]晚餐; [or]zk;
supply: [a]/səˈplaɪ/; [n]供应(量);补给品,用品(supplies); [vt]供应,提供,补充; [or]zk;
support: [a]/səˈpɔːrt/; [v]支撑;支持;拥护;支援;资助;证实; [n]支撑,支持;支撑者,支撑物; [or]zk;
suppose: [a]/səˈpoʊz/; [vt]想,认为; [vi]推测; [v]假定,假设;设想; [or]zk;
sure: [a]/ʃʊr/; [adv]当然,确实地,无疑地; [adj]肯定的;确信的; [or]zk;
surf: [a]/sɜːrf/; [n]海浪,拍岸浪; [vi]作冲浪运动; [vt]在激浪上驾(船),在..冲浪; [or]zk;
surface: [a]/ˈsɜːrfɪs/; [v]浮上水面;显露; [n]表面,面,水面;外表,外观; [adj]表面的;水面的;外观的;(对高架及地下铁路说的)平地上的; [or]zk;
surfing: [a]/ˈsɜːrfɪŋ/; [n]冲浪运动;网上冲浪; [or]zk;
surprise: [a]/sərˈpraɪz/; [n]惊奇,诧异;惊喜; [v]出其不意地袭击;使惊奇,使诧异,使感到意外; [or]zk;
sweater: [a]/ˈswetər/; [n]毛衣,厚运动衫,羊毛衫; [or]zk;
sweep: [a]/swiːp/; [v]打扫;快速移动; [n]清扫;一挥(手,胳膊等);范围,广度;绵延弯曲的地带; [or]zk;
sweet: [a]/swiːt/; [adj]甜的,可爱的,美好的,芳香的; [n]糖果,甜食;亲爱的(人),宝贝; [or]zk;
swim: [a]/swɪm/; [v]游泳;漂浮; [vi]浸泡;眩晕; [n]游泳; [or]zk;
swimming: [a]/ˈswɪmɪŋ/; [n]游泳;目眩; [adj]游泳的;游泳用的;善于游泳的;晕眩的; [v]游泳;漂浮;旋转; [or]zk;
swing: [a]/swɪŋ/; [v]摇荡,来回摆动,转动,转向;使摇摆,使转动,使转向; [n]秋千,摇摆,摆幅,转弯,打击,旋律; [or]zk;
symbol: [a]/ˈsɪmbl/; [n]象征;符号,图标;记号;标志; [or]zk;
table tennis: [a]/ˈteɪbl tenɪs/; [n]乒乓球; [or]zk;
table: [a]/ˈteɪbl/; [n]桌子;表格; [v]搁置; [or]zk;
tail: [a]/teɪl/; [n]尾巴,末端;尾随者; [v]紧跟,尾随; [or]zk;
tailor: [a]/ˈteɪlər/; [n]裁缝; [v]修改;使合适;调整使适应; [vt]裁制;剪裁; [or]zk;
take: [a]/teɪk/; [v]拿走;获得(财产),取得,得;采取,执行;修(课程);花费;搭乘; [n]获得物; [or]zk;
tale: [a]/teɪl/; [n]故事,叙述,传说;流言; [v]谈论,讲述,搬弄是非; [or]zk;
talk: [a]/tɔːk/; [v]讲话;谈论; [n]谈话; [or]zk;
tall: [a]/tɔːl/; [adj]身材高的,高大的;用于询问某人/某物的高度; [or]zk;
tap: [a]/tæp/; [n]塞子;水龙头;轻敲; [v]轻叩,轻敲;监听,窃听 (电话);开发,发掘;利用; [or]zk;
tape: [a]/teɪp/; [n]录音带,磁带;胶带,带子; [vt]粘贴;录音; [or]zk;
task: [a]/tæsk/; [n]作业;任务; [vt]交给某人(任务);使过于劳累; [or]zk;
taste: [a]/teɪst/; [v]品尝,尝起来;品鉴;体验,体会; [n]滋味,味道;鉴赏力;品尝; [or]zk;
tasty: [a]/ˈteɪsti/; [adj]好吃的;(尤指女子)迷人的,性感的; [or]zk;
taxi: [a]/ˈtæksi/; [n]出租汽车; [v](飞机) 缓慢滑行; [or]zk;
tea: [a]/tiː/; [n]茶(叶);茶点; [v]给..沏茶;喝茶; [or]zk;
teach: [a]/tiːtʃ/; [v]讲授;教授; [or]zk;
teacher: [a]/ˈtiːtʃər/; [n]教师,老师,教员; [or]zk;
team: [a]/tiːm/; [n]队,组; [v]结成一队,使结成一队; [or]zk;
teamwork: [a]/ˈtiːmwɜːrk/; [n]团队合作,协力; [or]zk;
teapot: [a]/ˈtiːpɑːt/; [n]茶壶; [or]zk;
tear: [a]/ter/; [v]撕裂,撕碎; [n]眼泪; [or]zk;
technology: [a]/tekˈnɑːlədʒi/; [n]科技;技术,工艺; [or]zk;
teenager: [a]/ˈtiːneɪdʒər/; [n](13-19岁的)少年; [or]zk;
telegram: [a]/ˈtelɪɡræm/; [n]电报; [or]zk;
telegraph: [a]/ˈtelɪɡræf/; [n]电报;电报机; [v]打电报;流露 (要做某事);显示; [or]zk;
telephone: [a]/ˈtelɪfoʊn/; [v]打电话; [n]电话(机); [or]zk;
television: [a]/ˈtelɪvɪʒn/; [n]电视(机); [or]zk;
tell: [a]/tel/; [v]告诉;辨别;断定;讲述;告发,泄密;识别; [or]zk;
temperature: [a]/ˈtemprətʃər/; [n]热度,发烧;温度,气温,体温;〔人们反应的〕激烈程度,气氛; [or]zk;
ten: [a]/ten/; [num]十,十个; [n]十个人;十点钟;十岁;十元纸币; [or]zk;
tennis: [a]/ˈtenɪs/; [n]网球; [adj]网球的,用于网球运动的; [vi]打网球; [or]zk;
tent: [a]/tent/; [n]帐篷; [or]zk;
tenth: [a]/tenθ/; [n]第十;十分之一; [num]第十;第十(的); [or]zk;
term: [a]/tɜːrm/; [n]措辞;期限;学期,任期;(pl.)条款;(pl.)关系; [vt]把.称为,把.叫作; [or]zk;
terrible: [a]/ˈterəbl/; [adj]极糟的;可怕的;极度的; [or]zk;
terrific: [a]/təˈrɪfɪk/; [adj]极好的;可怕的;(尺寸或程度)极其巨大的,大的惊人的; [or]zk;
test: [a]/test/; [n]测试,考验,试验; [vt]测试,考验,试验; [or]zk;
text: [a]/tekst/; [n]正文,原文,课文,课本; [v]发送短信; [or]zk;
textbook: [a]/ˈtekstbʊk/; [n]教科书; [or]zk;
thank: [a]/θæŋk/; [v]感谢; [n]谢意,感谢; [or]zk;
thankful: [a]/ˈθæŋkfl/; [adj]感谢的,开心的; [or]zk;
theater: [a]/'θɪətə/; [n]剧场,戏院,电影院;戏剧,戏剧事业;阶梯教室;战区,战场; [or]zk;
theirs: [a]/ðerz/; [pron]他们的(所有物),属于他们的(东西); [or]zk;
themselves: [a]/ðəmˈselvz/; [pron]他/她/它们自己; [or]zk;
thick: [a]/θɪk/; [adj]厚的,粗的;稠的,浓的; [or]zk;
thief: [a]/θiːf/; [n]小偷,贼; [or]zk;
thin: [a]/θɪn/; [adj]薄的;稀薄的,淡的;瘦的;空泛的; [v]变薄,变细;变稀; [adv]薄薄地; [or]zk;
thing: [a]/θɪŋ/; [n]东西,事物;事件,事态; [or]zk;
think: [a]/θɪŋk/; [v]想,思索,认为;以为,预料; [or]zk;
third: [a]/θɜːrd/; [adj]第三的; [num]第三; [n]三分之一; [or]zk;
thirst: [a]/θɜːrst/; [n]渴;干渴,缺水;渴求,渴望; [v]渴求; [or]zk;
thirsty: [a]/ˈθɜːrsti/; [adj]口渴的,口干的;渴望的,渴求的; [or]zk;
thirteen: [a]/ˌθɜːrˈtiːn/; [num]十三; [or]zk;
thirty: [a]/ˈθɜːrti/; [num]三十; [adj]三十的;三十个的; [n]三十,三十个; [or]zk;
though: [a]/ðoʊ/; [conj]虽然,可是; [adv]可是,但是;不过;然而;话虽这样说; [prep]但; [or]zk;
thought: [a]/θɔːt/; [n]想法;思维,思考;思想,思潮; [v]想,认为; [or]zk;
thousand: [a]/ˈθaʊznd/; [num]一千,一千个; [n]许多,无数; [adj]一千的;一千个的;成千的;许许多多的; [or]zk;
thread: [a]/θred/; [n]线;主线; [vt]穿过;穿线于; [or]zk;
three: [a]/θriː/; [num]三;三个; [or]zk;
through: [a]/θruː/; [prep]通过; [adv]自始至终,彻底; [adj]直达的,直通的; [or]zk;
throw: [a]/θroʊ/; [n]投,掷; [v]扔,抛,投掷; [or]zk;
thus: [a]/ðʌs/; [adv]因此;这样,如此; [or]zk;
tick: [a]/tɪk/; [n]勾号,(钟表)滴答声,一刹那; [v]用勾作为记号,发出滴答声; [or]zk;
ticket: [a]/ˈtɪkɪt/; [n]票,入场券; [vt]售票;给..门票;加标签于;指派;对..开交通违章通知单; [or]zk;
tidy: [a]/ˈtaɪdi/; [adj]整洁的,整齐的; [v]整理,收拾; [n]盛零碎物品的容器; [or]zk;
tie: [a]/taɪ/; [n]领带;关系;束缚; [v]系;打结;打成平局;绑,捆;打,打结; [or]zk;
tiger: [a]/ˈtaɪɡər/; [n]老虎; [or]zk;
till: [a]/tɪl/; [v]翻地,耕地; [conj]直到⋯⋯才; [prep]直到⋯⋯才; [n]放钱的抽屉,冰碛物; [or]zk;
time: [a]/taɪm/; [n]时间;节拍;次数,时期;比赛限时; [v]安排..的时间;计时,定时;打拍子; [adj]时间的;定时的;分期的; [or]zk;
tiny: [a]/ˈtaɪni/; [adj]很少的;微小的;矮小的; [n]小孩子;<医>癣;女子名; [or]zk;
tired: [a]/ˈtaɪərd/; [adj]疲劳的;厌倦的,厌烦的; [or]zk;
title: [a]/ˈtaɪtl/; [n]标题;头衔;权利; [vt]加标题于;授予.称号; [adj]标题的,题目的;称呼的; [or]zk;
tobacco: [a]/təˈbækoʊ/; [n]烟草,烟叶; [or]zk;
today: [a]/təˈdeɪ/; [n]今天;现今; [adv]现在;在今天; [or]zk;
toe: [a]/toʊ/; [n]脚趾; [v]用脚尖走; [or]zk;
tofu: [a]/ˈtoʊfuː/; [n]豆腐; [or]zk;
together: [a]/təˈɡeðər/; [adv]一起;共同;合起来;集拢地; [adj]新潮的;情绪稳定的,做事有效率的; [or]zk;
toilet: [a]/ˈtɔɪlət/; [n]马桶,坐便器,厕所,卫生间; [or]zk;
tomato: [a]/təˈmeɪtoʊ/; [n]番茄,西红柿; [or]zk;
tomb: [a]/tuːm/; [n]墓穴,坟墓; [vt]埋葬; [or]zk;
tomorrow: [a]/təˈmɔːroʊ/; [n]明天,未来; [adv]在明天,在明日; [or]zk;
ton: [a]/tʌn/; [n]吨;大量,许多; [or]zk;
tongue: [a]/tʌŋ/; [n]舌头;语言,说话方式; [vt]舔; [vi]吹管乐器; [or]zk;
tonight: [a]/təˈnaɪt/; [n]今晚,今夜; [adv]今晚; [or]zk;
tool: [a]/tuːl/; [n]工具;爪牙,傀儡; [or]zk;
tooth: [a]/tuːθ/; [n]牙齿,齿;齿状物; [or]zk;
toothache: [a]/ˈtuːθeɪk/; [n]牙痛; [or]zk;
toothbrush: [a]/ˈtuːθbrʌʃ/; [n]牙刷; [or]zk;
toothpaste: [a]/ˈtuːθpeɪst/; [n]牙膏; [or]zk;
top: [a]/tɑːp/; [n]顶部;尖端;上衣;上边,上面; [adj]最高的;头等的; [v]盖;达到顶端;结束;胜过; [or]zk;
total: [a]/ˈtoʊtl/; [adj]完全的;整个的,总体的; [n]总数,总额; [or]zk;
touch: [a]/tʌtʃ/; [n]接触,联系;触觉; [v]触摸;联系;接触; [vt]触动;感动; [or]zk;
tour: [a]/tʊr/; [n]旅游;巡游; [v]旅游;做巡回演出; [or]zk;
tourist: [a]/ˈtʊrɪst/; [n]旅行者,观光者; [or]zk;
toward: [a]/tɔːrd/; [prep]向;朝;对于; [or]zk;
towel: [a]/ˈtaʊəl/; [n]毛巾,手巾; [v]用毛巾擦; [or]zk;
tower: [a]/ˈtaʊər/; [n]塔,楼塔; [v]高耸;胜过; [or]zk;
town: [a]/taʊn/; [n]城镇,市镇;闹市区;(市镇)居民; [adj]城镇的; [or]zk;
toy: [a]/tɔɪ/; [n]玩具; [v]不认真考虑,玩弄; [adj]作为玩具的; [or]zk;
track: [a]/træk/; [v]跟踪追赶;用纤拉船; [n]跑道;小路;行动路线;足迹;轨道; [or]zk;
tractor: [a]/ˈtræktər/; [n]拖拉机,牵引车; [or]zk;
traditional: [a]/trəˈdɪʃənl/; [adj]传统的; [or]zk;
traffic: [a]/ˈtræfɪk/; [n]交通,车流;交通量;交通运输;非法买卖,非法交易; [v]用.作交换;在.通行;交易;买卖; [or]zk;
train: [a]/treɪn/; [n]火车;行列;一系列; [v]受教育;进行训练;训练,培养; [or]zk;
training: [a]/ˈtreɪnɪŋ/; [n]训练,培养;培训; [or]zk;
translate: [a]/trænsˈleɪt/; [v]翻译;转化; [or]zk;
trap: [a]/træp/; [n]陷阱;捕兽夹;圈套,诡计;双轮轻便马车;嘴; [v]诱骗;困住; [or]zk;
travel: [a]/ˈtrævl/; [n]旅行,旅游; [v]旅行;行进,被传播;走过,驶过; [or]zk;
traveler: [a]/ˈtrævələr/; [n]旅行者,旅客,旅行推销员; [or]zk;
treasure: [a]/ˈtreʒər/; [n]金银财宝;财富;珍宝;不可多得的人才; [v]珍藏;储藏;珍视; [or]zk;
treat: [a]/triːt/; [v]对待;治疗;讨论;请客; [n]请客; [or]zk;
treatment: [a]/ˈtriːtmənt/; [n]对待;治疗,疗法; [or]zk;
tree: [a]/triː/; [n]树; [or]zk;
trip: [a]/trɪp/; [n]旅行,远足; [v]绊倒,失足;轻快地走或跑; [or]zk;
trouble: [a]/ˈtrʌbl/; [n]烦恼,动乱,纠纷;故障;疾病; [v](使)烦恼,麻烦; [or]zk;
trousers: [a]/ˈtraʊzərz/; [n]裤子; [or]zk;
truck: [a]/trʌk/; [n]卡车;载重汽车; [vt]用卡车装运; [vi]驾驶卡车;以物易物; [or]zk;
true: [a]/truː/; [adj]真实的,真正的;忠诚的;符合的; [adv]精准地;正确地;真正地; [n]真实,真理; [or]zk;
trust: [a]/trʌst/; [v]信任;盼望,希望;委托; [n]信任;委托; [or]zk;
truth: [a]/truːθ/; [n]真理,真相;真实;真实性; [or]zk;
try: [a]/traɪ/; [v]试图,努力;试验;审讯;考验; [n]努力,尝试; [or]zk;
turn: [a]/tɜːrn/; [v]使变成,转动,超过(年龄,数量); [n]转动,轮流,时机,倾向,转弯; [or]zk;
turning: [a]/ˈtɜːrnɪŋ/; [n]转弯处; [or]zk;
twelfth: [a]/twelfθ/; [num]第十二;第十二的;十二分之一的; [n]第十二;十二日;第十二音; [or]zk;
twelve: [a]/twelv/; [num]十二;十二个的; [n]十二个;十二点钟; [or]zk;
twentieth: [a]/ˈtwentiəθ/; [num]第二十;第二十的;二十分之一的; [n]二十分之一;第二十日; [or]zk;
twenty: [a]/ˈtwenti/; [num]二十;二十个; [adj]二十的; [or]zk;
twice: [a]/twaɪs/; [adv]两次,两倍; [or]zk;
twin: [a]/twɪn/; [adj]孪生的; [n]孪生儿; [or]zk;
type: [a]/taɪp/; [n]类型,种类; [v]打字;<医学>测定(血型);按类型把.归类;成为.的典型;<印刷>浇铸(铅字等); [or]zk;
ugly: [a]/ˈʌɡli/; [adj]丑陋的;险恶的; [n](十九世纪流行的)女帽(上的丝质)遮阳; [or]zk;
umbrella: [a]/ʌmˈbrelə/; [n]伞,雨伞; [or]zk;
uncle: [a]/ˈʌŋkl/; [n]伯父,叔父,舅夫,姑父;叔叔; [or]zk;
under: [a]/ˈʌndər/; [prep]在..之下,在..之内;在..领导下,假借;少于,低于;根据,按照;处于..情况之下; [adj]下面的,下方的; [adv]在下面,在下方; [or]zk;
underground: [a]/ˌʌndərˈɡraʊnd/; [adj]地下的,秘密的; [adv]在地下,秘密地; [n]地铁;地下; [or]zk;
undersea: [a]/ˈʌndərsiː/; [adj]水下的;海面下的; [adv]在海面下; [or]zk;
understand: [a]/ˌʌndərˈstænd/; [v]理解,推断,熟悉; [or]zk;
unfair: [a]/ˌʌnˈfer/; [adj]不公正的,不公平的; [or]zk;
unfit: [a]/ʌnˈfɪt/; [adj]不适宜的,不合适的;不适当的;不健康的; [v]不适合; [or]zk;
unit: [a]/ˈjuːnɪt/; [n]整体,单位;部门;课本单元;(机器)一部分的装置,设备,部件; [or]zk;
unite: [a]/juˈnaɪt/; [v]团结,联合,统一,合并; [or]zk;
universe: [a]/ˈjuːnɪvɜːrs/; [n]宇宙,万物,世界,领域,范围; [or]zk;
university: [a]/ˌjuːnɪˈvɜːrsəti/; [n]大学; [or]zk;
unless: [a]/ənˈles/; [conj]除非,如果不;除..外; [or]zk;
unlike: [a]/ˌʌnˈlaɪk/; [adj]不同的; [prep]不像;和..不同; [or]zk;
unlucky: [a]/ʌnˈlʌki/; [adj]不幸的;不吉利的,不祥的; [or]zk;
until: [a]/ənˈtɪl/; [prep]到..为止,在..以前; [conj]到..为止,在..以前,直到..才; [or]zk;
unusual: [a]/ʌnˈjuːʒuəl/; [adj]不寻常的,不常见的;与众不同的; [or]zk;
upon: [a]/əˈpɑːn/; [prep]在..上面; [or]zk;
upstairs: [a]/ˌʌpˈsterz/; [n]楼上; [adj]楼上的; [adv]在楼上;往高处; [or]zk;
use: [a]/juːz/; [v]使用,利用,对待; [n]使用,运用;用法;使用权;; [or]zk;
used: [a]/juːst/; [adj]用旧了的,旧的;习惯的,惯常的; [or]zk;
useful: [a]/ˈjuːsfl/; [adj]有用的,有益的; [or]zk;
useless: [a]/ˈjuːsləs/; [adj]无用的,无价值的,无效的; [or]zk;
usual: [a]/ˈjuːʒuəl/; [adj]通常的,惯常的; [or]zk;
usually: [a]/ˈjuːʒuəli/; [adv]通常,平常; [or]zk;
vacation: [a]/veɪˈkeɪʃn/; [n]休假,假期; [v]休假,度假; [or]zk;
valley: [a]/ˈvæli/; [n]山谷,溪谷,低谷; [or]zk;
value: [a]/ˈvæljuː/; [v]给.定价,评价;重视,珍视,尊重; [n]价值;有用性; [or]zk;
vase: [a]/veɪs/; [n]花瓶; [or]zk;
vegetable: [a]/ˈvedʒtəbl/; [n]蔬菜,植物;植物人; [adj]蔬菜的,植物的; [or]zk;
vehicle: [a]/ˈviːəkl/; [n]交通工具,机动车;传播媒介;工具,手段; [or]zk;
verb: [a]/vɜːrb/; [n]动词; [or]zk;
vet: [a]/vet/; [n]兽医; [v]作兽医;诊疗;审查; [or]zk;
victim: [a]/ˈvɪktɪm/; [n]牺牲品,受害者,替罪羊; [or]zk;
victory: [a]/ˈvɪktəri/; [n]胜利;成功; [or]zk;
video: [a]/ˈvɪdioʊ/; [n]视频,录像;录像带; [v]制作..的录像; [or]zk;
view: [a]/vjuː/; [n]风景;视野;见解; [v]观看,看,望;查看,察看,视察,检查;看待,将..看成是,把..视为,认为; [or]zk;
village: [a]/ˈvɪlɪdʒ/; [n]村庄,乡村;村民; [or]zk;
violin: [a]/ˌvaɪəˈlɪn/; [n]小提琴; [or]zk;
virus: [a]/ˈvaɪrəs/; [n]病毒;(计算机) 病毒;病毒性疾病; [or]zk;
visit: [a]/ˈvɪzɪt/; [n]访问参观,游览;拜访; [vt]参观,访问;拜访;看望,探望; [vi]来访;访问,参观; [or]zk;
visitor: [a]/ˈvɪzɪtər/; [n]访问者,来宾,游客; [or]zk;
voice: [a]/vɔɪs/; [n]声音;意见;发言权; [v]表达,吐露; [or]zk;
volleyball: [a]/ˈvɑːlibɔːl/; [n]排球; [or]zk;
wait: [a]/weɪt/; [v]等候,等,等待;耽搁,搁置; [n]等待,等待时间; [or]zk;
waiter: [a]/ˈweɪtər/; [n]侍者,服务员; [or]zk;
wake: [a]/weɪk/; [v]醒来,使觉醒;激发,引起; [n]守灵,守夜;(船航过时的)尾波;年度假期; [or]zk;
walk: [a]/wɔːk/; [n]走;人行道;散步; [vi]走;行走散步; [vt]沿着.走;慢步走;护送.走; [or]zk;
wall: [a]/wɔːl/; [n]围墙;墙; [v]堵塞; [vt]用墙围住; [or]zk;
wallet: [a]/ˈwɑːlɪt/; [n]皮夹,钱包; [or]zk;
want: [a]/wɑːnt/; [v]想要;需要;短缺;缺少; [n]短缺,必需品; [or]zk;
war: [a]/wɔːr/; [n]战争;作战;打仗; [or]zk;
wardrobe: [a]/ˈwɔːrdroʊb/; [n]衣橱;全部服装;剧服; [or]zk;
warm: [a]/wɔːrm/; [adj]温暖的; [v]使温暖; [adv]温暖地,暖和地; [n]暖和(的地方),保暖(的东西); [or]zk;
warn: [a]/wɔːrn/; [v]警告,告诫; [or]zk;
wash: [a]/wɑːʃ/; [v]洗,洗掉;冲洗,冲刷; [n]洗,冲积物,洗涤物; [or]zk;
washroom: [a]/ˈwɑːʃruːm/; [n]盥洗室; [or]zk;
waste: [a]/weɪst/; [n]浪费;废物; [v]浪费;消耗;未充分利用; [adj]无用的;废弃的; [or]zk;
watch: [a]/wɑːtʃ/; [v]观看,注视;看守,监视; [n]表;看守;监视; [or]zk;
water: [a]/ˈwɔːtər/; [n]水;水域;雨水,海水; [vt]给..浇水,给..供水; [or]zk;
watermelon: [a]/ˈwɔːtərmelən/; [n]西瓜; [or]zk;
wave: [a]/weɪv/; [n]波浪;(挥手)示意;起伏;涌现的人,涌现的事物;卷发,卷曲; [v](挥手)示意,波动,飘动波浪; [or]zk;
way: [a]/weɪ/; [n]方法;道路;方向;行业;习惯; [adv]大大地;远远地; [or]zk;
weak: [a]/wiːk/; [adj]虚弱的;软弱的;差的,衰弱的;淡薄的,无力的; [or]zk;
wealth: [a]/welθ/; [n]财富;财产;大量; [or]zk;
wear: [a]/wer/; [v]穿,穿着;磨损;带着(表情); [n]穿着;穿戴物,衣物;磨损; [or]zk;
weather: [a]/ˈweðər/; [n]天气,气候,处境; [v]风化,受风蚀,经受风雨;平安地渡过(难关); [or]zk;
website: [a]/ˈwebsaɪt/; [n]网站; [or]zk;
week: [a]/wiːk/; [n]星期,周; [or]zk;
weekday: [a]/ˈwiːkdeɪ/; [n]工作日,平日; [or]zk;
weekend: [a]/ˈwiːkend/; [n]周末,周末休假; [vi]过周末; [or]zk;
weekly: [a]/ˈwiːkli/; [adv]一周一次地; [adj]每周的,一周一次的; [n]周报,周刊; [or]zk;
weigh: [a]/weɪ/; [vt]称重;认真考虑; [vi]重压,有影响; [or]zk;
weight: [a]/weɪt/; [n]重力,重量,分量,砝码,重要(性),势力,负担,重累; [v]加重量于,使变重; [or]zk;
welcome: [a]/ˈwelkəm/; [v]欢迎; [n]欢迎; [adj]受欢迎的; [or]zk;
west: [a]/west/; [n]西方,西部; [adj]西的,西方的; [adv]向西方; [or]zk;
western: [a]/ˈwestərn/; [adj]西的,西方的,来自西方的人,有西方特征的; [n]西方人,西部片,西部小说; [or]zk;
wet: [a]/wet/; [adj]湿的,多雨的; [v]把.弄湿,使潮湿; [n]湿地;液体;窝囊废;雨天; [or]zk;
whale: [a]/weɪl/; [n]鲸; [or]zk;
whatever: [a]/wətˈevər/; [pron]无论什么,不管什么,具体指到底,究竟;任何..的事物; [det]无论什么样的;所有的,全部的; [adv]任何,丝毫;不管什么,无论什么,任何..的事物; [or]zk;
wheat: [a]/wiːt/; [n]小麦; [or]zk;
wheel: [a]/wiːl/; [n]轮子,方向盘;轮转; [v]旋转;推动; [or]zk;
whenever: [a]/wenˈevər/; [conj]每当,无论何时; [adv]不论何时;随便什么时候; [or]zk;
wherever: [a]/werˈevər/; [conj]无论在哪里; [adv]无论在什么地方; [or]zk;
whether: [a]/ˈweðər/; [conj]两者中的哪一个;是否; [or]zk;
while: [a]/waɪl/; [conj]但是,然而;虽然;正值...之时 (表示一件事是在另一件事发生过程中的某个时间发生的);在..的时候,和..同时; [n]一会儿,一段时间; [prep]〈古〉直至(某时); [or]zk;
white: [a]/waɪt/; [adj]白色的,白种人的; [n]眼白 (指眼球中的白色部分);白色,白种人,蛋白; [or]zk;
whole: [a]/hoʊl/; [n]全部;整体; [adj]完全的;整个的;全部的; [adv]完全,整个; [or]zk;
whom: [a]/huːm/; [pron]谁; [or]zk;
whose: [a]/huːz/; [det]谁的;其; [pron]那(些)人的; [conj]谁的; [or]zk;
why: [a]/waɪ/; [adv]为什么,..的(理由); [int](表吃惊,满意等)哎呀什么?; [conj]..的理由;为什么; [n]原因;原因,理由; [or]zk;
wide: [a]/waɪd/; [adj]宽阔的;广泛的; [adv]完全地;充分地; [or]zk;
wife: [a]/waɪf/; [n]妻子; [or]zk;
wild: [a]/waɪld/; [adj]野性的;野生的;狂热的;荒芜的;疯狂的; [or]zk;
win: [a]/wɪn/; [v](获)胜,赢得; [n]赢,胜利; [or]zk;
wind: [a]/wɪnd/; [n]风;呼吸;时势; [v]蜿蜒曲折,缠绕,上发条; [or]zk;
window: [a]/ˈwɪndoʊ/; [n]窗,窗口;一丝机会, 暂短的时机; [or]zk;
windy: [a]/ˈwɪndi/; [adj]刮风的;腹胀的,吹牛的; [or]zk;
wine: [a]/waɪn/; [n]葡萄酒,果酒; [or]zk;
wing: [a]/wɪŋ/; [n]翅膀;机翼;门厅; [v]飞过,空运; [or]zk;
winner: [a]/ˈwɪnər/; [n]获胜者,得奖者,稳操胜券者; [or]zk;
winter: [a]/ˈwɪntər/; [n]冬,冬季; [adj]冬天的; [v]过冬; [or]zk;
wise: [a]/waɪz/; [adj]聪明的;有智慧的,博学的;知情的; [v]知道,教导; [or]zk;
wish: [a]/wɪʃ/; [n]愿望;希望得到的东西;希望;祝愿; [v]希望,想要;祝愿;但愿; [vt]渴望; [or]zk;
without: [a]/wɪˈðaʊt/; [prep]没有,不,(表条件)如果没有,要没有; [adv]在外,在屋外;在没有(某种不言而喻的东西)的情况下,在缺乏的情况下; [or]zk;
wolf: [a]/wʊlf/; [n]狼;贪婪的人; [v]狼吞虎咽地吃; [or]zk;
woman: [a]/ˈwʊmən/; [n]女人,妇女;女仆; [adj]女人的,女性的,妇女的; [vt]为..配备妇女,使成女人腔; [or]zk;
wonder: [a]/ˈwʌndər/; [v]想知道;感到惊讶; [n]奇迹,奇观;惊奇,惊异; [or]zk;
wonderful: [a]/ˈwʌndərfl/; [adj]惊人的,奇妙的;极好的,精彩的; [or]zk;
wood: [a]/wʊd/; [n]木头,木材,木料;林地,树林; [or]zk;
wool: [a]/wʊl/; [n]羊毛;毛线;毛织品; [or]zk;
word: [a]/wɜːrd/; [n]字,词,话; [v]用言词表达; [or]zk;
work: [a]/wɜːrk/; [n]工作;作品; [v]工作,劳动,做体力工作,从事..工作,干活,精工细作; [or]zk;
worker: [a]/ˈwɜːrkər/; [n]工人; [or]zk;
workplace: [a]/ˈwɜːrkpleɪs/; [n]工作场所,车间; [or]zk;
world: [a]/wɜːrld/; [n]世界;生活世界,生活圈; [or]zk;
worried: [a]/ˈwɜːrid/; [adj]发愁的,担心的,烦恼的; [or]zk;
worry: [a]/ˈwɜːri/; [v](使)焦虑,(使)烦恼; [n]烦恼,焦虑,担忧; [or]zk;
worse: [a]/wɜːrs/; [n]更坏的事,更恶劣的事; [adj]更坏的,更恶劣的; [adv]更坏地,更恶劣地; [or]zk;
worst: [a]/wɜːrst/; [n]最坏的事; [adj]最坏的,最差的; [v]打击,胜过; [adv]最坏地; [or]zk;
worth: [a]/wɜːrθ/; [adj]值..钱;有..价值; [n]价值,财产; [or]zk;
wound: [a]/wuːnd/; [n]创伤,伤口; [v]伤,伤害; [or]zk;
write: [a]/raɪt/; [v]书写,著述,写满;写信给;填写,记下; [or]zk;
writer: [a]/ˈraɪtər/; [n]作家;文书;作曲者; [or]zk;
writing: [a]/ˈraɪtɪŋ/; [n]写作;著作;书面形式; [or]zk;
wrong: [a]/rɔːŋ/; [adj]违法的;不合适的;错误的;有故障的; [adv]错;不公正地; [n]坏事;不公正; [vt]无理地对待;冤枉;欺骗; [or]zk;
yard: [a]/jɑːrd/; [n]院,场地,码; [or]zk;
year: [a]/jɪr/; [n]年,年龄,年岁; [or]zk;
yellow: [a]/ˈjeloʊ/; [adj]黄色的,胆小的; [n]黄色; [v](使某物)变黄或发黄; [or]zk;
yesterday: [a]/ˈjestərdeɪ/; [n]昨天;往昔; [adv]昨天; [adj]过时的; [or]zk;
yet: [a]/jet/; [adv]尚,还,仍然; [conj]然而,但是; [or]zk;
young: [a]/jʌŋ/; [adj]年轻的,年纪小的;没有经验的;尚早的;初期的; [n](动物的)崽; [or]zk;
yours: [a]/jɔːrz/; [pron]你的,你们的(所属物);信末署名前用语; [or]zk;
yourself: [a]/jɔːrˈself/; [pron]你自己; [or]zk;
yourselves: [a]/jə'selvz/; [pron]你们自己;你们本人; [or]zk;
youth: [a]/juːθ/; [n]青年;青年时期;青年们;青春; [or]zk;
zebra: [a]/ˈziːbrə/; [n]斑马; [or]zk;
zero: [a]/ˈzɪroʊ/; [num]零; [n]零,零度; [adj]零的;无价值的;零视度的; [v]把 ... 调零;瞄准;集中注意;迫近; [or]zk;
zoo: [a]/zuː/; [n]动物园; [or]zk;
