Armada: [a]/ɑːrˈmɑːdə/; [n](西班牙的)无敌舰队; [or]z8;
August: [a]/ˈɔːɡəst/; [n]八月; [or]z8;
Baroque: [a]/bəˈroʊk/; [adj]巴洛克式的,结构复杂的,形式怪样的; [n]巴洛克风格,巴洛克艺术; [or]z8;
Canon: [a]/ˈkænən/; [n]标准,教规,正典圣经,教士; [or]z8;
Halloween: [a]/ˌhæloʊˈiːn/; [n]万圣节前夕(指十月三十一日夜晚); [or]z8;
Hispanic: [a]/hɪˈspænɪk/; [adj]拉丁美洲的;西班牙人的;西班牙的; [n]讲西班牙语的人;拉美裔美国人; [or]z8;
Quaker: [a]/ˈkweɪkər/; [n]夸克党,教友派信徒; [or]z8;
RAM: [a]/ræm/; [n]公羊,撞锤,<计>随机存取内存; [v]猛击,撞; [or]z8;
Sabbath: [a]/ˈsæbəθ/; [n]安息日; [or]z8;
Satanic: [a]/səˈtænɪk/; [adj]邪恶的,魔鬼的; [or]z8;
Titanic: [a]/taɪˈtænɪk/; [adj]巨人的,力大无比的; [n]泰坦尼克号; [or]z8;
Utopia: [a]/juːˈtoʊpiə/; [n]乌托邦(理想中最美好的社会),理想国; [or]z8;
Yank: [a]/jæŋk/; [n]美国人(等于Yankee); [or]z8;
abacus: [a]/ˈæbəkəs/; [n]算盘; [or]z8;
abase: [a]/əˈbeɪs/; [v]贬抑;使卑下;降低.的地位; [n]贬低;屈辱;贬低别人的人; [or]z8;
abbreviate: [a]/əˈbriːvieɪt/; [v]缩写,使省略,使用缩写词; [n]使用缩写词的人;缩短,缩写(词,短语,名字,名称); [or]z8;
abbreviation: [a]/əˌbriːviˈeɪʃn/; [n]缩短;缩写词;省略号; [or]z8;
abdicate: [a]/ˈæbdɪkeɪt/; [adj]放弃权力的;退位的; [n]放弃权力者;退位者; [vi]退位,辞职; [vt]辞;放弃; [or]z8;
abdominal: [a]/æbˈdɑːmɪnl/; [adj]腹部的,有腹鳍的; [or]z8;
abduct: [a]/æbˈdʌkt/; [v]绑架,拐走; [or]z8;
aberrant: [a]/æˈberənt/; [n]离开正路的人,反常的人; [adj]偏离正轨的;异常的,畸变的; [or]z8;
abhor: [a]/əbˈhɔːr/; [v]痛恨;憎恶; [or]z8;
abide: [a]/əˈbaɪd/; [v]遵守;忍受;居住; [or]z8;
abiding: [a]/əˈbaɪdɪŋ/; [adj]持久的;永久的,不变的; [or]z8;
abject: [a]/ˈæbdʒekt/; [adj]糟糕透顶的;可怜的,不幸的; [or]z8;
ablaze: [a]/əˈbleɪz/; [adj]着火的,燃烧的;激昂的;光彩夺目的; [or]z8;
abode: [a]/əˈboʊd/; [n]住处,住所; [vt]<古>预兆,预示; [or]z8;
abominable: [a]/əˈbɑːmɪnəbl/; [adj]讨厌的,令人憎恶的,糟透的; [n]讨厌,可恶; [adv]恶劣地,令人厌恶地; [or]z8;
abort: [a]/əˈbɔːrt/; [v]异常中断,中途失败,流产,发育不全; [or]z8;
abrasive: [a]/əˈbreɪsɪv/; [adj]粗糙的;有研磨作用的;伤人感情的; [n]研磨料; [or]z8;
abreast: [a]/əˈbrest/; [adv]并肩地,并列; [adj]并排的;并肩的; [or]z8;
absentee: [a]/ˌæbsənˈtiː/; [n]缺席者; [adj]缺席者的;在外地主的,在外业主的; [or]z8;
abstain: [a]/əbˈsteɪn/; [v]戒掉(烟\酒等);避开;弃权; [or]z8;
abstention: [a]/əbˈstenʃn/; [n]戒除,回避;弃权;弃权者; [or]z8;
abstinence: [a]/ˈæbstɪnəns/; [n]节制,禁欲; [or]z8;
abusive: [a]/əˈbjuːsɪv/; [adj]辱骂的;滥用的;虐待的; [or]z8;
abyss: [a]/əˈbɪs/; [n]深渊;深不可测的事物,绝境;深海;深邃;炼狱; [or]z8;
academician: [a]/ˌækədəˈmɪʃn/; [n]院士;大学生;学会会员; [or]z8;
accede: [a]/əkˈsiːd/; [v]同意,就任,加入; [or]z8;
accentuate: [a]/əkˈsentʃueɪt/; [v]强调;重读; [or]z8;
accessible: [a]/əkˈsesəbl/; [adj]可使用的;可到达的;可进入的;易懂的; [or]z8;
accession: [a]/ækˈseʃn/; [n]加入(国际组织);登基,即位;增加物;增加;接近,到达;同意; [vt]登录,登入新增目录;获得; [or]z8;
acclaim: [a]/əˈkleɪm/; [n]欢呼,赞扬,称赞; [v]欢呼,喝彩,鼓掌欢迎; [vt]鼓掌欢迎,向.欢呼,为.喝彩;推选; [or]z8;
accompanist: [a]/əˈkʌmpənɪst/; [n]伴奏者,伴随者; [or]z8;
accomplice: [a]/əˈkɑːmplɪs/; [n]同谋者,帮凶; [or]z8;
accountable: [a]/əˈkaʊntəbl/; [adj]应负责的,应作解释的;可解释的; [or]z8;
accountancy: [a]/əˈkaʊntənsi/; [n]会计工作,会计学,会计职业; [or]z8;
accredit: [a]/əˈkredɪt/; [v]授权;信任;委派;归因于; [or]z8;
accrue: [a]/əˈkruː/; [v](利息等)增大,增多; [or]z8;
acoustics: [a]/əˈkuːstɪks/; [n]声学; [or]z8;
acquiesce: [a]/ˌækwiˈes/; [v]默许;勉强同意; [adj]默认的; [or]z8;
acquittal: [a]/əˈkwɪtl/; [n]宣告无罪,开释; [or]z8;
acrimony: [a]/ˈækrɪmoʊni/; [n]尖刻,刻薄; [or]z8;
actuality: [a]/ˌæktʃuˈæləti/; [n]现状,现实,事实; [or]z8;
acumen: [a]/ˈækjəmən/; [n]聪明,敏锐; [or]z8;
adamant: [a]/ˈædəmənt/; [adj]强硬的,固执的; [n]坚硬的东西;坚石; [or]z8;
addictive: [a]/əˈdɪktɪv/; [adj]使人上瘾的; [or]z8;
additive: [a]/ˈædətɪv/; [n]添加剂,添加物; [adj]附加的;<数>加法的; [or]z8;
adept: [a]/əˈdept/; [n]专家,能手; [adj]熟练的;巧妙的; [or]z8;
adhesive: [a]/ədˈhiːsɪv/; [n]粘合剂,胶水; [adj]带粘性的;粘着的;难忘的; [or]z8;
adjoin: [a]/əˈdʒɔɪn/; [v]与.毗连;贴近; [or]z8;
adjourn: [a]/əˈdʒɜːrn/; [v]延期,休会,推迟对.采取行动; [vi]休会; [or]z8;
adjudicate: [a]/əˈdʒuːdɪkeɪt/; [v]充当裁判,判决; [n]判决,宣判;裁判员; [or]z8;
adjunct: [a]/ˈædʒʌŋkt/; [n]附属物,配件,添加剂;助手,部下; [adj]附加的,辅助的,下级的; [or]z8;
admonish: [a]/ədˈmɑːnɪʃ/; [v]训诫,警告; [or]z8;
adorn: [a]/əˈdɔːrn/; [v]装饰; [or]z8;
adrift: [a]/əˈdrɪft/; [adj]漂泊的,漂浮着的; [adv]随波逐流地;漂流无定;<比喻>无定职;<口>孤陋寡闻; [or]z8;
adroit: [a]/əˈdrɔɪt/; [adj]熟练的,灵巧的; [or]z8;
adulterate: [a]/əˈdʌltəreɪt/; [v]掺假; [adj]通奸的;搀杂的; [n]掺假; [or]z8;
advent: [a]/ˈædvent/; [n]来临;到来;出现; [or]z8;
adversary: [a]/ˈædvərseri/; [n]对手,敌手; [or]z8;
adverse: [a]/ˈædvɜːrs/; [adj]不利的;(方向上)逆的;在相反的方向上移动(或运转);相反的; [or]z8;
adversity: [a]/ədˈvɜːrsəti/; [n]逆境,不幸,灾难; [or]z8;
advocacy: [a]/ˈædvəkəsi/; [n]主张;拥护;辩护; [or]z8;
aerodynamics: [a]/ˌeroʊdaɪˈnæmɪks/; [n]<流>气体力学;空气动力学; [adj]空气动力(学)的; [or]z8;
aerosol: [a]/ˈerəsɔːl/; [n]烟雾,［化］气溶,烟雾剂; [adj]喷雾的,喷雾器的; [or]z8;
affable: [a]/ˈæfəbl/; [adj]易于交谈的,和蔼的; [or]z8;
affinity: [a]/əˈfɪnəti/; [n]姻亲关系;密切关系;近似,类似关系;亲近; [or]z8;
afflict: [a]/əˈflɪkt/; [v]使痛苦;使苦恼; [or]z8;
affront: [a]/əˈfrʌnt/; [v]冒犯,有意冒犯,公开侮辱;面对; [n]轻蔑;公开侮辱; [or]z8;
afield: [a]/əˈfiːld/; [adv]在战场上,去野外,在远处,远离着; [or]z8;
afloat: [a]/əˈfloʊt/; [adj]在海上的;飘浮的;浸满水的;在传播的; [adv]在海上;飘浮著;浸满水; [or]z8;
aggravate: [a]/ˈæɡrəveɪt/; [v]使恶化,加重;使气恼,激怒; [or]z8;
aggregate: [a]/ˈæɡrɪɡət/; [n]合计;总数;混凝料;总计; [v]集合;聚集;合计; [adj]总的,总数的;集合的; [or]z8;
aggrieved: [a]/əˈɡriːvd/; [adj]忿忿不平的,痛心的;权利受到不法侵害的; [or]z8;
agile: [a]/ˈædʒl/; [adj]灵活的,敏捷的; [or]z8;
agitate: [a]/ˈædʒɪteɪt/; [v](尤指为法律,社会状况的改变而)激烈争论,鼓动,煽动;搅动(液体);激怒; [or]z8;
agitation: [a]/ˌædʒɪˈteɪʃn/; [n]摇动;焦虑,忧虑;煽动; [or]z8;
agnostic: [a]/æɡˈnɑːstɪk/; [adj]不可知论的; [n]不可知论者; [or]z8;
ailing: [a]/ˈeɪlɪŋ/; [adj]生病的,身体不舒服的;体衰的; [or]z8;
ailment: [a]/ˈeɪlmənt/; [n]疾病(尤指微恙),不宁,不安; [or]z8;
airborne: [a]/ˈerbɔːrn/; [adj]空运的;在空中的; [or]z8;
airy: [a]/ˈeri/; [adj]空气的;通风的;幻想的;轻快的;空中的; [or]z8;
ajar: [a]/əˈdʒɑːr/; [adj]半开的;微开的; [or]z8;
alchemy: [a]/ˈælkəmi/; [n]炼金术;魔力; [or]z8;
alcoholism: [a]/ˈælkəhɔːlɪzəm/; [n]酒精中毒; [or]z8;
alias: [a]/ˈeɪliəs/; [n]别名,化名; [adv]别名为,化名为; [or]z8;
alight: [a]/əˈlaɪt/; [vi]下来;飞落; [adj]烧着的;点亮着的; [or]z8;
align: [a]/əˈlaɪn/; [vi]排队,排成一行; [vt]使成一直线; [or]z8;
alimony: [a]/ˈælɪmoʊni/; [n](法)赡养费,生活费; [or]z8;
allay: [a]/əˈleɪ/; [v]减轻;使缓和;使平静; [or]z8;
allegiance: [a]/əˈliːdʒəns/; [n]忠诚,拥护; [or]z8;
allegory: [a]/ˈæləɡɔːri/; [n]讽喻;寓意;寓言; [or]z8;
allergic: [a]/əˈlɜːrdʒɪk/; [adj]过敏的,对.讨厌的; [or]z8;
allergy: [a]/ˈælərdʒi/; [n]过敏症,厌恶; [or]z8;
alleviate: [a]/əˈliːvieɪt/; [v]减轻;缓解;缓和; [or]z8;
allude: [a]/əˈluːd/; [v]间接提到,暗指,暗示; [or]z8;
allure: [a]/əˈlʊr/; [v]吸引;诱使; [n]诱惑力; [or]z8;
allusion: [a]/əˈluːʒn/; [n]暗示;提及; [or]z8;
amalgamate: [a]/əˈmælɡəmeɪt/; [v]合并,混合; [or]z8;
amass: [a]/əˈmæs/; [vi]聚集; [vt]收集;积累,积聚; [or]z8;
ambivalent: [a]/æmˈbɪvələnt/; [adj]矛盾的;摇摆不定的;好恶相克的; [n]两性人; [or]z8;
ambush: [a]/ˈæmbʊʃ/; [n]埋伏,伏击;伏兵; [v]埋伏,伏击; [or]z8;
amenity: [a]/əˈmenəti/; [n]适意;舒适;便利设施;舒适,愉快;礼仪; [or]z8;
amiable: [a]/ˈeɪmiəbl/; [adj]和蔼的,亲切的;温和的; [or]z8;
amicable: [a]/ˈæmɪkəbl/; [adj]友善的,温和的,平心静气的; [or]z8;
amnesia: [a]/æmˈniːʒə/; [n]<医学>遗忘症; [or]z8;
amnesty: [a]/ˈæmnəsti/; [n]赦免; [v]对.实行大赦; [or]z8;
amoral: [a]/ˌeɪˈmɔːrəl/; [adj]不知是非的; [or]z8;
amphibian: [a]/æmˈfɪbiən/; [n]两栖动物;水陆两用飞机和车辆; [adj]两栖类的;<车辆>水陆两用的;具有双重性格的; [or]z8;
amphibious: [a]/æmˈfɪbiəs/; [adj]两栖的; [or]z8;
anarchist: [a]/ˈænərkɪst/; [n]无政府主义者; [or]z8;
anarchy: [a]/ˈænərki/; [n]无政府状态,政治混乱; [or]z8;
anemia: [a]/ə'niːmiːə/; [n]贫血,贫血症; [or]z8;
anesthesia: [a]/ˌænəsˈθiʒə/; [n]麻醉;麻木(等于anaesthesia); [or]z8;
anesthetic: [a]/ˌænəs'θetɪk/; [n]麻醉剂,麻药; [adj]麻醉的,感觉缺失的; [or]z8;
anew: [a]/əˈnuː/; [adv]重新,再; [or]z8;
anguish: [a]/ˈæŋɡwɪʃ/; [n]痛苦;苦恼; [v]感到极度痛苦; [or]z8;
animate: [a]/ˈænɪmeɪt/; [v]使有生气,使活泼;鼓舞,推动; [adj]有生命的; [or]z8;
animation: [a]/ˌænɪˈmeɪʃn/; [n]活泼,有生气,动画片,动画片制作; [or]z8;
animosity: [a]/ˌænɪˈmɑːsəti/; [n]憎恶,仇恨; [or]z8;
annihilate: [a]/əˈnaɪəleɪt/; [v]消灭; [or]z8;
annuity: [a]/əˈnuːəti/; [n]年金,养老金;年金保险;年金享受权; [or]z8;
anomaly: [a]/əˈnɑːməli/; [n]异常,不规则,反常事物; [or]z8;
anonymity: [a]/ˌænəˈnɪməti/; [n]匿名,作者不明(或不详),无名之辈; [or]z8;
antagonize: [a]/ænˈtæɡənaɪz/; [v]使.敌对,使.对抗,引起反抗; [or]z8;
anthology: [a]/ænˈθɑːlədʒi/; [n](诗,文,曲,画等的)选集; [or]z8;
anthropology: [a]/ˌænθrəˈpɑːlədʒi/; [n]人类学; [or]z8;
antibody: [a]/ˈæntibɑːdi/; [n]<免疫>抗体; [or]z8;
antidote: [a]/ˈæntidoʊt/; [n]<药>解毒剂,解药;矫正方法; [or]z8;
antipathy: [a]/ænˈtɪpəθi/; [n]反感,厌恶,憎恶; [or]z8;
antiseptic: [a]/ˌæntiˈseptɪk/; [n]杀菌剂; [adj]防腐的,抗菌的; [or]z8;
antler: [a]/ˈæntlər/; [n]鹿角,茸角; [or]z8;
apathy: [a]/ˈæpəθi/; [n]冷漠,无兴趣;漠不关心,无感情; [or]z8;
apex: [a]/ˈeɪpeks/; [n]顶点;尖端; [or]z8;
apiece: [a]/əˈpiːs/; [adv]每人;每个;各自地; [or]z8;
apparel: [a]/əˈpærəl/; [n]服装,衣服; [vt]给.穿衣服(尤指华丽或特殊的服装); [or]z8;
appease: [a]/əˈpiːz/; [v]抚慰;平息; [or]z8;
appendix: [a]/əˈpendɪks/; [n]附录;阑尾;附属物; [or]z8;
appraise: [a]/əˈpreɪz/; [v]评价,鉴定;估价; [or]z8;
apprehend: [a]/ˌæprɪˈhend/; [vt]理解,领会;逮捕;对.忧虑;把.视作; [vi]忧虑; [or]z8;
apprehension: [a]/ˌæprɪˈhenʃn/; [n]忧虑,担心,疑惧;逮捕;理解; [or]z8;
aquarium: [a]/əˈkweriəm/; [n]水族馆,水族箱,鱼缸; [or]z8;
arbitrate: [a]/ˈɑːrbɪtreɪt/; [v]仲裁,公断; [or]z8;
arcade: [a]/ɑːrˈkeɪd/; [n]拱廊;有拱廊的街道;游乐场所,游戏厅; [or]z8;
archaic: [a]/ɑːrˈkeɪɪk/; [adj]古代的;陈旧的,过时的,老式的;已不通用的; [or]z8;
archer: [a]/ˈɑːrtʃər/; [n]弓箭手; [or]z8;
archetype: [a]/ˈɑːrkitaɪp/; [n]原型,典型; [or]z8;
archipelago: [a]/ˌɑːrkɪˈpeləɡoʊ/; [n]群岛; [or]z8;
archive: [a]/ˈɑːrkaɪv/; [n]档案室,档案; [vt]把.收集归档; [or]z8;
ardent: [a]/ˈɑːrdnt/; [adj]热心的,热烈的; [or]z8;
ardor: [a]/'ɑːdə/; [n]热情,狂热; [or]z8;
arduous: [a]/ˈɑːrdʒuəs/; [adj]艰巨的;努力的;陡峭的; [or]z8;
aroma: [a]/əˈroʊmə/; [n]芳香,香气; [or]z8;
aromatic: [a]/ˌærəˈmætɪk/; [adj]芳香的; [n]芳香植物;芳香族化合物; [or]z8;
arrears: [a]/əˈrɪrz/; [n]债,欠债; [or]z8;
arsenal: [a]/ˈɑːrsənl/; [n]兵工厂,军械库;储藏; [or]z8;
arson: [a]/ˈɑːrsn/; [n]<法律>纵火,纵火罪; [or]z8;
artful: [a]/ˈɑːrtfl/; [adj]巧妙的,有技巧的,狡猾的,欺诈的; [or]z8;
arthritis: [a]/ɑːrˈθraɪtɪs/; [n]<外科>关节炎; [or]z8;
articulate: [a]/ɑːrˈtɪkjuleɪt/; [adj]善于表达的;发音清晰的; [v]清晰地发音;清楚地讲话;连接,接合;与.合成整体 ,使相互连贯; [or]z8;
artifact: [a]/ˈɑːrtɪfækt/; [n]人工制品;手工艺品; [or]z8;
artifice: [a]/ˈɑːrtɪfɪs/; [n]诡计;欺骗;巧妙的办法; [or]z8;
artisan: [a]/ˈɑːrtəzn/; [n]工匠,手艺人; [or]z8;
ascendant: [a]/əˈsendənt/; [n]优势,支配地位; [adj]上升的,优越的; [or]z8;
ascertain: [a]/ˌæsərˈteɪn/; [v]探知,弄清,查明(真相等); [or]z8;
ascetic: [a]/əˈsetɪk/; [adj]禁欲的;苦行的; [n]禁欲者;苦行者; [or]z8;
ascribe: [a]/əˈskraɪb/; [v]把.归因于;把.归属于; [or]z8;
aspiration: [a]/ˌæspəˈreɪʃn/; [n]抱负,志向;发 h 音; [or]z8;
aspire: [a]/əˈspaɪər/; [vi]渴望,有志于(与to,for,after连用或后接不定式); [or]z8;
assail: [a]/əˈseɪl/; [v]攻击;质问;着手解决; [or]z8;
assent: [a]/əˈsent/; [v]同意,赞成; [n]同意;赞成; [or]z8;
assertive: [a]/əˈsɜːrtɪv/; [adj]肯定的;决断的;坚定而自信的;独断的; [or]z8;
assiduous: [a]/əˈsɪdʒuəs/; [adj]勤勉的,刻苦的; [or]z8;
assimilate: [a]/əˈsɪməleɪt/; [v]使同化;吸收;消化; [or]z8;
assorted: [a]/əˈsɔːrtəd/; [adj]各式各样的; [or]z8;
assortment: [a]/əˈsɔːrtmənt/; [n]分类;混合物; [or]z8;
asthma: [a]/ˈæzmə/; [n]哮喘症; [or]z8;
astrology: [a]/əˈstrɑːlədʒi/; [n]占星学,占星术,星座; [or]z8;
asylum: [a]/əˈsaɪləm/; [n]精神病院,疯人院;避难所; [or]z8;
asymmetric: [a]/ˌeɪsɪˈmetrɪk/; [adj]不对称的,不匀称的; [or]z8;
atrocious: [a]/əˈtroʊʃəs/; [adj]糟透的,残暴的,骇人听闻的; [or]z8;
atrocity: [a]/əˈtrɑːsəti/; [n]残暴,暴行; [or]z8;
attest: [a]/əˈtest/; [vt]证明;证实;为.作证; [vi]证明;作证; [or]z8;
audacious: [a]/ɔːˈdeɪʃəs/; [adj]大胆的,鲁莽的,大胆创新的; [or]z8;
audible: [a]/ˈɔːdəbl/; [adj]听得见的; [or]z8;
audition: [a]/ɔːˈdɪʃn/; [n]听力,听觉;试听;试镜; [vi]试唱; [vt]对.进行面试;让.试唱; [or]z8;
augment: [a]/ɔːɡˈment/; [v]增加;助长; [or]z8;
aura: [a]/ˈɔːrə/; [n](人或物发出的)气味,气氛,先兆; [or]z8;
auspicious: [a]/ɔːˈspɪʃəs/; [adj]吉兆的,幸运的; [or]z8;
austere: [a]/ɔːˈstɪr/; [adj]严峻的;简朴的;苦行的;无装饰的; [or]z8;
authoritarian: [a]/əˌθɔːrəˈteriən/; [adj]独裁主义的,权力主义的; [n]权力主义者,独裁主义者; [or]z8;
autocrat: [a]/ˈɔːtəkræt/; [n]独裁者; [or]z8;
autocratic: [a]/ˌɔːtəˈkrætɪk/; [adj]独裁的,专断的; [or]z8;
autograph: [a]/ˈɔːtəɡræf/; [n]亲笔签名; [v]署名; [adj]亲笔的; [or]z8;
automate: [a]/ˈɔːtəmeɪt/; [v]使自动化,自动操作; [or]z8;
autopsy: [a]/ˈɔːtɑːpsi/; [n]验尸;<病理><特医>剖检; [or]z8;
avalanche: [a]/ˈævəlæntʃ/; [n]雪崩;大量拥至; [vi]崩塌; [or]z8;
aversion: [a]/əˈvɜːrʒn/; [n]厌恶;讨厌的人,(或东西); [or]z8;
avid: [a]/ˈævɪd/; [adj]渴望的,贪婪的;热心的; [or]z8;
awesome: [a]/ˈɔːsəm/; [adj]〔俚语〕极好的,棒极了的;引起敬畏的,可怕的; [or]z8;
babble: [a]/ˈbæbl/; [v]呀呀学语,喋喋不休,作潺潺声;泄露(秘密); [n]儿语,胡言乱语,潺潺声; [or]z8;
backbreaking: [a]/'bækˌbreɪkɪŋ/; [adj]非常辛劳的,费力的; [or]z8;
backdrop: [a]/ˈbækdrɑːp/; [n]背景幕;(事件的)背景; [or]z8;
backfire: [a]/ˌbækˈfaɪər/; [v]放出逆火,产生出乎意料及事与愿违的结果; [n]逆火;后爆的巨大响声; [or]z8;
badger: [a]/ˈbædʒər/; [n]獾;獾皮毛; [v]纠缠;烦扰(反复提提出问题或要求); [or]z8;
baffle: [a]/ˈbæfl/; [v]使困惑;难住;阻碍; [n]挡板; [or]z8;
baleful: [a]/ˈbeɪlfl/; [adj]邪恶的,恶意的; [adv]凶恶地,有害地; [or]z8;
balk: [a]/bɔːk/; [v]畏缩;阻止;停止; [n]障碍;错误; [or]z8;
ballad: [a]/ˈbæləd/; [n]歌谣;小曲; [or]z8;
ballast: [a]/ˈbæləst/; [n](船等)压舱物;稳定因素;<比喻>沉着; [vt]给某物装上压舱物;给.铺道渣;使稳定;使沉着; [or]z8;
balm: [a]/bɑːm/; [n]香油,止痛膏,安慰物,香气; [or]z8;
balmy: [a]/ˈbɑːmi/; [adj](气候)温和的; [or]z8;
banal: [a]/bəˈnɑːl/; [adj]陈腐的;平庸的;老一套的; [or]z8;
bane: [a]/beɪn/; [n]祸根; [or]z8;
banish: [a]/ˈbænɪʃ/; [v]放逐;摒弃; [or]z8;
banister: [a]/ˈbænɪstər/; [n]栏杆的支柱,楼梯的扶栏; [or]z8;
banjo: [a]/ˈbændʒoʊ/; [n]班卓琴;五弦琴; [or]z8;
banter: [a]/ˈbæntər/; [n]善意地取笑,逗弄; [v]善意的与人开玩笑; [or]z8;
barrage: [a]/bəˈrɑːʒ/; [n]大量;阻塞;齐射式攻击;<水利>拦河坝; [v]以密集火力阻击; [or]z8;
barricade: [a]/ˌbærɪˈkeɪd/; [n]路障;障碍物;栅栏; [v]设路障;挡住; [or]z8;
barrister: [a]/ˈbærɪstər/; [n]辩护律师,出庭律师; [or]z8;
barrow: [a]/ˈbæroʊ/; [n]搬运架,手推车,弃矿,古坟; [or]z8;
barter: [a]/ˈbɑːrtər/; [v]物物交换;以货易货; [n]物物交换;实物交易; [or]z8;
bash: [a]/bæʃ/; [v]猛击,痛击;怒殴; [n]猛烈的一击,痛击; [or]z8;
bashful: [a]/ˈbæʃfl/; [adj]害羞的;羞怯的; [or]z8;
bask: [a]/bæsk/; [vi]晒太阳(享受温暖),感到温暖,愉快或舒适; [n]晒太阳,取暖;沉浸于; [or]z8;
bastion: [a]/ˈbæstiən/; [n]堡垒;棱堡; [or]z8;
baton: [a]/bəˈtɑːn/; [n]警棍,指挥棒,接力棒; [v]用短棒打; [or]z8;
battalion: [a]/bəˈtæliən/; [n]营,军营;军队,部队; [or]z8;
bawl: [a]/bɔːl/; [v]大叫,大喊,放声痛哭; [n]叫喊声,叫骂声,号哭; [or]z8;
bay: [a]/beɪ/; [n]海湾,港湾;困境; [vi](尤指猎犬等)吠,叫,咆哮;筑堤遏(水); [v]穷追,使陷入绝境;阻止(敌人)不使前进;向.吠叫; [adj]赤褐色的,栗色的; [or]z8;
bazaar: [a]/bəˈzɑːr/; [n]集市,商店集中区; [or]z8;
bearing: [a]/ˈberɪŋ/; [n]方向;举止;轴承; [or]z8;
beastly: [a]/ˈbiːstli/; [adj]兽性的,恶毒的,刻薄的;令人厌恶的,令人极其不快的; [or]z8;
bedding: [a]/ˈbedɪŋ/; [n]寝具,基床,草垫; [adj]适于花坛种植的; [or]z8;
begrudge: [a]/bɪˈɡrʌdʒ/; [v]嫉妒,吝惜,舍不得给; [or]z8;
beguile: [a]/bɪˈɡaɪl/; [v]欺骗,迷住,吸引; [or]z8;
beige: [a]/beɪʒ/; [n]米黄色; [adj]浅褐色的,米黄色的; [or]z8;
belie: [a]/bɪˈlaɪ/; [vt]与.不符;矛盾,误解; [or]z8;
bemoan: [a]/bɪˈmoʊn/; [v]哀悼;为..恸哭;哀叹,对..表示惋惜; [or]z8;
bemused: [a]/bɪˈmjuːzd/; [adj]困惑的,发呆的; [or]z8;
benchmark: [a]/ˈbentʃmɑːrk/; [n]基准;标准检查程序; [v]用基准问题测试(计算机系统等); [or]z8;
benediction: [a]/ˌbenɪˈdɪkʃn/; [n]祝福,祈祷; [or]z8;
beneficiary: [a]/ˌbenɪˈfɪʃieri/; [n]<金融>受益人,受惠者;封臣; [adj]拥有封地的;受圣俸的; [or]z8;
benevolent: [a]/bəˈnevələnt/; [adj]慈爱的,仁慈的;乐善好施的;慈善的; [or]z8;
benign: [a]/bɪˈnaɪn/; [adj]仁慈的;慈祥的;(病)良性的; [or]z8;
bequeath: [a]/bɪˈkwiːð/; [v]遗赠(留); [or]z8;
bequest: [a]/bɪˈkwest/; [n]遗产;遗赠物; [or]z8;
bereaved: [a]/bɪˈriːvd/; [adj]丧失的;死了.的; [n]丧失亲人的人; [or]z8;
beset: [a]/bɪˈset/; [v]困扰;镶嵌;围绕; [or]z8;
bewitch: [a]/bɪˈwɪtʃ/; [v]施魔法于,蛊惑,使着迷; [or]z8;
bicker: [a]/ˈbɪkər/; [v]斗嘴,流动,闪动; [n]口角,流水声; [or]z8;
bigot: [a]/ˈbɪɡət/; [n](宗教,种族,政治等的)偏执者,盲信者; [or]z8;
bile: [a]/baɪl/; [n]胆汁;愤怒; [or]z8;
billiards: [a]/ˈbɪljərdz/; [n]台球;英式台球;弹子戏; [or]z8;
billow: [a]/ˈbɪloʊ/; [n]巨浪,波浪般滚滚向前的东西;滚滚烟尘; [v]翻腾; [or]z8;
binge: [a]/bɪndʒ/; [n]狂饮,无节制的行为; [v]狂饮作乐;大吃大喝; [or]z8;
bingo: [a]/ˈbɪŋɡoʊ/; [n]宾戈游戏; [or]z8;
bipartisan: [a]/ˌbaɪˈpɑːrtɪzn/; [adj]由两党成员组成的;被两党支持的; [or]z8;
bisect: [a]/baɪˈsekt/; [n]对剖邮票; [vi]分开; [vt]把.分切为二,把.二等分;二等分; [or]z8;
bitch: [a]/bɪtʃ/; [n]母狗;泼妇; [vi]发牢骚; [adj]不合标准的; [vt]轻率拙劣地把.弄糟; [or]z8;
bizarre: [a]/bɪˈzɑːr/; [adj]稀奇古怪的; [or]z8;
blackmail: [a]/ˈblækmeɪl/; [n]敲诈,勒索;保护费; [vt]向.敲诈; [or]z8;
blackout: [a]/ˈblækaʊt/; [n]断电; [adj]防空袭的; [or]z8;
blanch: [a]/blæntʃ/; [v]变白;漂白; [n]铅矿石; [adj]漂白的;银白色的; [or]z8;
blare: [a]/bler/; [v]高声鸣叫,发嘟嘟声; [n]嘟嘟声,号声,巨响; [or]z8;
blatant: [a]/ˈbleɪtnt/; [adj]喧哗的;露骨的;公然的;明目张胆的; [or]z8;
blemish: [a]/ˈblemɪʃ/; [v]损害,玷污; [n]瑕疵,缺点; [or]z8;
bliss: [a]/blɪs/; [n]福佑,天赐的福; [vt]使欣喜若狂,使狂喜; [vi]欣喜若狂,狂喜; [or]z8;
blizzard: [a]/ˈblɪzərd/; [n]暴风雪; [or]z8;
blob: [a]/blɑːb/; [n]一滴,一抹,难以名状的一团; [v]弄脏,把.做错,得零分; [or]z8;
blues: [a]/bluːz/; [n]忧郁布鲁斯歌曲;蓝色物;忧郁,悲伤; [or]z8;
blunder: [a]/ˈblʌndər/; [n]愚蠢之举;大错; [vi]犯大错; [v]失策;绊倒; [or]z8;
blur: [a]/blɜːr/; [n]污点,模糊; [v]使.模糊;弄脏;变模糊; [or]z8;
blurt: [a]/blɜːrt/; [v]突然说出,冲动地说; [or]z8;
bog: [a]/bɑːɡ/; [n]沼泽;泥塘; [v]陷于泥沼;动弹不得; [or]z8;
boggle: [a]/ˈbɑːɡl/; [v]畏缩不前;惊恐;使..困惑; [or]z8;
bogus: [a]/ˈboʊɡəs/; [adj]假的,假装的; [n]伪币;冒牌货; [or]z8;
boisterous: [a]/ˈbɔɪstərəs/; [adj]喧闹的,欢闹的; [or]z8;
bombard: [a]/bɑːmˈbɑːrd/; [v]不断攻击,炮击; [or]z8;
bonfire: [a]/ˈbɑːnfaɪər/; [n]篝火;营火; [or]z8;
bonnet: [a]/ˈbɑːnət/; [n]圆帽,扁平软帽; [vt]给.戴上; [or]z8;
boo: [a]/buː/; [n]嘘声; [v]嘘(以表示不满或嘲笑); [or]z8;
boon: [a]/buːn/; [n]恩惠,福利,利益; [adj]愉快的; [or]z8;
boost: [a]/buːst/; [v]增加;偷盗; [n]提高;激励;后推;助推发动机; [or]z8;
booze: [a]/buːz/; [n]酒宴,酒; [v]暴饮; [or]z8;
bountiful: [a]/ˈbaʊntɪfl/; [adj]充足的,慷慨的,丰裕的; [or]z8;
bounty: [a]/ˈbaʊnti/; [n]慷慨;赠物;奖金; [vt]发给.奖金; [or]z8;
bout: [a]/baʊt/; [n]一回合,较量,一阵; [or]z8;
boutique: [a]/buːˈtiːk/; [n]专卖流行衣服的小商店; [adj](商店)精品的; [or]z8;
brace: [a]/breɪs/; [n]<医学>牙齿定位器; [v]支柱;支撑;加固;使绷紧; [or]z8;
braid: [a]/breɪd/; [n]辫子;编带; [vi]交叉往来,迂回前进; [vt]编织;把头发编成辫子; [or]z8;
brash: [a]/bræʃ/; [adj]无礼的,傲慢的;仓促的,性急的; [n]骤雨;碎片;<医>胃灼热; [or]z8;
bravado: [a]/brəˈvɑːdoʊ/; [n]故作勇敢,逞能; [or]z8;
brevity: [a]/ˈbrevəti/; [n]简短,短小,精炼; [or]z8;
bridal: [a]/ˈbraɪdl/; [adj]新娘的;婚礼的; [n]婚礼; [or]z8;
bridle: [a]/ˈbraɪdl/; [n]马笼头,缰绳; [v]上笼头;昂首(表傲慢,愤怒等);抑制,控制; [or]z8;
brittle: [a]/ˈbrɪtl/; [adj]易碎的;脆弱的;靠不住的; [n]薄片脆糖; [or]z8;
broccoli: [a]/ˈbrɑːkəli/; [n]硬花球花椰菜;花茎甘蓝; [or]z8;
broke: [a]/broʊk/; [adj]一文不名的,破产的; [vt]打破,弄破;(使)破,裂,碎;中断;违犯;背弃;把...换成零钱;找开; [vi]破晓;(风暴)开始; [or]z8;
broker: [a]/ˈbroʊkər/; [n]经纪人,掮客; [v]作为经纪人进行谈判,以中间人等身份安排; [or]z8;
brokerage: [a]/ˈbroʊkərɪdʒ/; [n]中间人业务,经济业;付给经纪人的经手费,佣金,回扣; [or]z8;
bronchitis: [a]/brɑːŋˈkaɪtɪs/; [n]<内科>支气管炎; [or]z8;
brunt: [a]/brʌnt/; [n]冲击,主要冲力; [or]z8;
brusque: [a]/brʌsk/; [adj]唐突的,直率的,无礼的; [or]z8;
buddy: [a]/ˈbʌdi/; [n]密友,好朋友,伙伴;小男孩; [vi]交朋友,做好朋友; [or]z8;
budge: [a]/bʌdʒ/; [v]移动一点;妥协; [or]z8;
buff: [a]/bʌf/; [vt]擦亮,擦净; [n]浅黄,浅黄色,爱好者; [adj]浅黄牛皮革制的,浅黄色的; [or]z8;
buffer: [a]/ˈbʌfər/; [n]缓冲,缓冲区; [v]缓冲; [or]z8;
buggy: [a]/ˈbʌɡi/; [n]轻型马车,婴儿车; [or]z8;
bulge: [a]/bʌldʒ/; [n]凸出部分; [v]凸出,膨胀; [or]z8;
bulk: [a]/bʌlk/; [n]大批;容量;体积;大块; [adj]大量的;散装的; [v]膨胀;显得重要; [or]z8;
bulky: [a]/ˈbʌlki/; [adj]体积大的,庞大的;笨重的; [or]z8;
bum: [a]/bʌm/; [n]流浪汉,乞讨者,游手好闲的人; [v]流浪,乞讨,过游民生活; [adj]差劲的; [or]z8;
bumper: [a]/ˈbʌmpər/; [n]汽车前后的保险杆; [adj]特大的;丰盛的; [vt]装满;为.祝酒; [vi]干杯; [or]z8;
bunk: [a]/bʌŋk/; [n](火车等)床铺,铺位,卧铺;骗人的话,废话; [v]睡(在床铺上),去睡; [or]z8;
buoyancy: [a]/ˈbɔɪənsi/; [n]浮力,浮性,浮动性; [or]z8;
burrow: [a]/ˈbɜːroʊ/; [n]洞穴,地道;藏身处,住处; [v]挖;钻进;搜寻; [vt]掩蔽; [or]z8;
bustle: [a]/ˈbʌsl/; [n]喧闹,熙攘;腰垫;奔走,奔忙; [v]喧闹;忙乱,奔忙; [or]z8;
buttock: [a]/ˈbʌtək/; [n]屁股的一半,屁股,船尾; [v]<跤>背摔; [or]z8;
bypass: [a]/ˈbaɪpæs/; [v]绕过;回避; [n]旁路;心脏分流手术; [or]z8;
cache: [a]/kæʃ/; [n]隐藏处所,隐藏的粮食或物资,贮藏物; [vt]贮藏; [vi]躲藏; [or]z8;
cajole: [a]/kəˈdʒoʊl/; [v]以甜言蜜语哄骗,勾引; [or]z8;
calamity: [a]/kəˈlæməti/; [n]大灾祸,不幸之事; [or]z8;
callous: [a]/ˈkæləs/; [adj]无情的,铁石心肠的,硬结的; [vt](使)变硬,(使)起茧;(使)冷酷无情; [or]z8;
callow: [a]/ˈkæloʊ/; [adj](鸟)未生羽毛的;年轻而无经验的; [or]z8;
cameo: [a]/ˈkæmioʊ/; [n]石雕,贝雕;浮雕玉石;文学小品; [or]z8;
camouflage: [a]/ˈkæməflɑːʒ/; [n]伪装;掩饰; [v]使改头换面,伪装,掩饰;欺瞒; [or]z8;
candid: [a]/ˈkændɪd/; [adj]坦白的;无偏见的;公正的;率直的; [or]z8;
cannibal: [a]/ˈkænɪbl/; [n]食人者,食同类的动物; [adj]食人者的;同类相食的;凶残的; [or]z8;
canny: [a]/ˈkæni/; [adj]精明的,谨慎的,节约的; [adv]<苏格兰>仔细地; [or]z8;
canoe: [a]/kəˈnuː/; [n]独木舟,轻舟; [v]乘独木舟; [or]z8;
canopy: [a]/ˈkænəpi/; [n]华盖;天篷;顶篷;苍穹; [vt]用天篷遮盖;遮蔽; [or]z8;
canter: [a]/ˈkæntər/; [n]慢跑(多用于马); [or]z8;
canvass: [a]/ˈkænvəs/; [v]仔细检查或详尽地讨论;审查,游说; [n]讨论;细查;劝诱; [or]z8;
cape: [a]/keɪp/; [n]斗篷;披肩;岬,海岬,海角; [or]z8;
capillary: [a]/ˈkæpəleri/; [n]毛细血管; [adj]毛细血管的;毛状的; [or]z8;
capitulate: [a]/kəˈpɪtʃuleɪt/; [vi]有条件投降,认输,屈服,让步,停止抵抗; [or]z8;
caprice: [a]/kəˈpriːs/; [n]任性,反复无常,随想曲; [or]z8;
capricious: [a]/kəˈprɪʃəs/; [adj]变化无常的,任性的; [or]z8;
captivate: [a]/ˈkæptɪveɪt/; [v]吸引,迷惑; [or]z8;
captivity: [a]/kæpˈtɪvəti/; [n]囚禁;被关; [or]z8;
carat: [a]/ˈkærət/; [n]公制克拉;(金子)开; [or]z8;
carbohydrate: [a]/ˌkɑːrboʊˈhaɪdreɪt/; [n]<化>碳水化合物;淀粉质食物; [or]z8;
cardiac: [a]/ˈkɑːrdiæk/; [adj]心脏的,心脏病的; [n]心脏病患者;强心剂;健胃剂; [or]z8;
caress: [a]/kəˈres/; [v]抚摸; [vt]拥抱; [n]爱抚;拥抱;亲吻; [or]z8;
caricature: [a]/ˈkærɪkətʃər/; [n]讽刺画,滑稽模仿;扭曲,夸张的描述; [or]z8;
carnage: [a]/ˈkɑːrnɪdʒ/; [n]大屠杀,残杀,大量绝灭; [or]z8;
carnal: [a]/ˈkɑːrnl/; [adj]肉体的,肉欲的,性欲的,色欲的,淫荡的; [or]z8;
carnation: [a]/kɑːrˈneɪʃn/; [n]康乃馨,粉红色; [adj]淡红色的;肉色的; [or]z8;
carnivore: [a]/ˈkɑːrnɪvɔːr/; [n]食肉动物,食虫植物; [or]z8;
carp: [a]/kɑːrp/; [n]鲤鱼; [v]吹毛求疵; [or]z8;
cartridge: [a]/ˈkɑːrtrɪdʒ/; [n]墨盒;弹药筒,弹药;墨水,笔芯; [or]z8;
cascade: [a]/kæˈskeɪd/; [n]层叠;小瀑布;喷流; [v]像瀑布般冲下或倾泻; [or]z8;
caste: [a]/kæst/; [n](印度社会中的)种姓;(具有严格等级差别的)社会地位;(排他的)社会团体; [or]z8;
catalyst: [a]/ˈkætəlɪst/; [n]催化剂;造成变化的人或事; [or]z8;
categorical: [a]/ˌkætəˈɡɔːrɪkl/; [adj]绝对的;直接了当的;无条件的;属于某一范畴的; [or]z8;
cathode: [a]/ˈkæθoʊd/; [n](电)阴极,正极; [or]z8;
causal: [a]/ˈkɔːzl/; [adj]因果关系的,有原因的; [n]表示原因的连词; [or]z8;
cavern: [a]/ˈkævərn/; [n]洞穴;凹处; [v]挖空;置.于洞穴中; [or]z8;
caviar: [a]/ˈkæviɑːr/; [n]鱼子酱; [or]z8;
cavity: [a]/ˈkævəti/; [n]洞;龋洞; [or]z8;
cedar: [a]/ˈsiːdər/; [n]雪松,香柏,西洋杉木; [or]z8;
cede: [a]/siːd/; [v]放弃;割让(领土); [or]z8;
celestial: [a]/səˈlestʃl/; [adj]天体的,天上的; [n]天人,神仙;(指封建时代的)中国人,天朝之人; [or]z8;
censor: [a]/ˈsensər/; [n]检查员; [vt]审查,检查;修改; [or]z8;
censorious: [a]/senˈsɔːriəs/; [adj]爱挑剔的,吹毛求疵的,严厉批评的; [or]z8;
censorship: [a]/ˈsensərʃɪp/; [n]审查制度;审查机构; [or]z8;
censure: [a]/ˈsenʃər/; [v]责难,责备; [n]责难,责备; [or]z8;
centenary: [a]/senˈtenəri/; [n]一百年; [adj]一百年的; [or]z8;
centralize: [a]/ˈsentrəlaɪz/; [v]使集中;使成为.的中心;使集权; [or]z8;
cerebral: [a]/səˈriːbrəl/; [adj]大脑的,深思的; [or]z8;
ceremonious: [a]/ˌserəˈmoʊniəs/; [adj]隆重的;讲究仪式的;正式的; [or]z8;
certify: [a]/ˈsɜːrtɪfaɪ/; [v](发给证书)证明;证实; [or]z8;
certitude: [a]/ˈsɜːrtɪtuːd/; [n]确实;确信;必然性; [or]z8;
chant: [a]/tʃænt/; [v]吟唱;诵扬; [n]圣歌;赞美诗;旋律; [or]z8;
chaplain: [a]/ˈtʃæplɪn/; [n]牧师,专职教士; [or]z8;
charisma: [a]/kəˈrɪzmə/; [n]魅力; [or]z8;
charismatic: [a]/ˌkærɪzˈmætɪk/; [adj]超凡魅力的;神赐能力的;有魅力的; [n]有特恩的基督徒; [or]z8;
chaste: [a]/tʃeɪst/; [adj]贞洁的;纯洁的;朴素的; [or]z8;
chauvinism: [a]/ˈʃoʊvɪnɪzəm/; [n]沙文主义者,盲目爱国主义; [or]z8;
checkmate: [a]/ˌtʃekˈmeɪt/; [n](国际象棋)将死,输棋,败局,败北; [or]z8;
chic: [a]/ʃiːk/; [n]时髦,款式别致; [adj]别致的;时髦的; [or]z8;
chime: [a]/tʃaɪm/; [n]一套钟,合奏钟声; [v]鸣响,敲出和谐的声音; [or]z8;
chimpanzee: [a]/ˌtʃɪmpænˈziː/; [n]<动物>黑猩猩; [or]z8;
chirp: [a]/tʃɜːrp/; [n]唧唧声;喳喳声; [v](鸟或虫)唧唧叫; [or]z8;
chisel: [a]/ˈtʃɪzl/; [v]刻,凿; [n]凿子; [or]z8;
chivalry: [a]/ˈʃɪvəlri/; [n]骑士精神,骑士气概;骑士制度; [or]z8;
cholesterol: [a]/kəˈlestərɔːl/; [n]胆固醇; [or]z8;
choppy: [a]/ˈtʃɑːpi/; [adj]波涛汹涌的;不断改变方向的; [or]z8;
choreography: [a]/ˌkɔːriˈɑːɡrəfi/; [n]编舞艺术;舞蹈编排;舞蹈编排; [or]z8;
christen: [a]/ˈkrɪsn/; [v]为.命名,为.施洗礼; [n]<女名>女子名; [or]z8;
chromosome: [a]/ˈkroʊməsoʊm/; [n]染色体; [or]z8;
chronology: [a]/krəˈnɑːlədʒi/; [n]年代学;(事件等)按年月次序的排列;年表; [or]z8;
chubby: [a]/ˈtʃʌbi/; [adj]圆脸的,胖乎乎的; [or]z8;
chuck: [a]/tʃʌk/; [v]轻轻地扔;抛;丢弃; [or]z8;
chum: [a]/tʃʌm/; [n]密友,鱼饵; [v]结为密友,用鱼饵引诱; [or]z8;
churlish: [a]/ˈtʃɜːrlɪʃ/; [adj]脾气暴躁的;没有礼貌的; [or]z8;
churn: [a]/tʃɜːrn/; [n](炼制黄油用的)搅乳器; [v]用搅乳器搅拌; [or]z8;
cinder: [a]/ˈsɪndər/; [n]余烬,矿渣; [or]z8;
circumvent: [a]/ˌsɜːrkəmˈvent/; [v]用计避免,规避; [or]z8;
claimant: [a]/ˈkleɪmənt/; [n]原告,<贸易>索赔人,提出要求者; [or]z8;
clamber: [a]/ˈklæmbər/; [v]攀登,爬上; [n]攀登,攀爬; [or]z8;
clandestine: [a]/klænˈdestɪn/; [adj]秘密的,私下的,暗中的; [or]z8;
clatter: [a]/ˈklætər/; [n]咔嗒;哗啦声;嘈杂的谈笑声; [v]发出哗啦声;喧闹的谈笑; [or]z8;
claustrophobia: [a]/ˌklɔːstrəˈfoʊbiə/; [n]幽闭恐怖症; [or]z8;
cleanse: [a]/klenz/; [v]净化; [or]z8;
cleavage: [a]/ˈkliːvɪdʒ/; [n]分裂;乳沟;裂缝; [or]z8;
cleave: [a]/kliːv/; [v]劈开,分裂; [or]z8;
cliche: [a]/klɪˈʃeɪ/; [n]陈腐思想,陈词滥调; [adj]陈腐的; [or]z8;
clinch: [a]/klɪntʃ/; [n]扭抱;紧紧相拥; [v]达成,取得;解决; [or]z8;
clog: [a]/klɑːɡ/; [v]阻塞,阻碍; [n]障碍;木底鞋; [or]z8;
closure: [a]/ˈkloʊʒər/; [n]关闭,终止,结束; [or]z8;
clot: [a]/klɑːt/; [v]使凝成块; [n]凝块; [or]z8;
clump: [a]/klʌmp/; [n]土块; [v]丛生; [or]z8;
clutter: [a]/ˈklʌtər/; [n]混乱,凌乱; [v]弄乱,搅乱; [or]z8;
coax: [a]/koʊks/; [v]哄,哄诱; [or]z8;
cobble: [a]/ˈkɑːbl/; [v]修,拙劣地修补;铺鹅卵石,用圆石铺面; [n]鹅卵石,圆石; [or]z8;
cocaine: [a]/koʊˈkeɪn/; [n]可卡因,古柯碱; [or]z8;
coddle: [a]/ˈkɑːdl/; [v]溺爱;用文火煮; [n]〈口〉娇生惯养的人; [or]z8;
coed: [a]/ˌkoʊˈed/; [n]男女同校的女生; [adj]男女同校的; [or]z8;
coefficient: [a]/ˌkoʊɪˈfɪʃnt/; [n]<数>系数; [adj]共同作用的; [or]z8;
coerce: [a]/koʊˈɜːrs/; [v]强迫,压制; [or]z8;
coercion: [a]/koʊˈɜːrʒn/; [n]胁迫,威压; [or]z8;
coexist: [a]/ˌkoʊɪɡˈzɪst/; [v]共存;和平共处; [or]z8;
cognitive: [a]/ˈkɑːɡnətɪv/; [adj]认识能力的;认知的; [or]z8;
coherent: [a]/koʊˈhɪrənt/; [adj]协调一致的;条理清楚的,有条理的;连贯的;有黏性的,黏合在一起的,粘着的; [or]z8;
cohesive: [a]/koʊˈhiːsɪv/; [adj]团结的;紧密结合的;有黏着力的; [or]z8;
collate: [a]/kəˈleɪt/; [v]核对,校对;校勘; [or]z8;
collude: [a]/kəˈluːd/; [v]串通,共谋; [or]z8;
collusion: [a]/kəˈluːʒn/; [n]勾结;共谋; [or]z8;
colonize: [a]/ˈkɑːlənaɪz/; [v]在(某处)开拓殖民地;占据;(为政治目的)打入,混入(某部门等); [or]z8;
colossal: [a]/kəˈlɑːsl/; [adj]巨像(似)的;巨大的,庞大的; [or]z8;
colossus: [a]/kəˈlɑːsəs/; [n]巨像,巨人,巨大的东西; [or]z8;
colt: [a]/koʊlt/; [n]小马,生手; [v]以笞绳鞭打; [or]z8;
combustible: [a]/kəmˈbʌstəbl/; [adj]易燃的;易激动的; [n]可燃物;易燃物; [or]z8;
commensurate: [a]/kəˈmenʃərət/; [adj]相称的,相应的;同量的;同样大小的; [or]z8;
communicable: [a]/kəˈmjuːnɪkəbl/; [adj]可传达的,会传染的,爱说话的; [or]z8;
communion: [a]/kəˈmjuːniən/; [n]共享,恳谈,宗教团体,圣餐仪式; [or]z8;
compatible: [a]/kəmˈpætəbl/; [adj]可和谐共存的;兼容的; [or]z8;
compatriot: [a]/kəmˈpeɪtriət/; [n]同胞; [adj]同胞的; [or]z8;
complementary: [a]/ˌkɑːmplɪˈmentri/; [adj]补足的,补充的,互补的; [or]z8;
complexion: [a]/kəmˈplekʃn/; [n]肤色;特性; [or]z8;
composite: [a]/kəmˈpɑːzət/; [adj]合成的,复合的; [n]合成物,复合材料; [v]使合成,使混合; [or]z8;
composure: [a]/kəmˈpoʊʒər/; [n]镇静,沉着; [or]z8;
compulsion: [a]/kəmˈpʌlʃn/; [n]强制,强迫,强制力; [or]z8;
compunction: [a]/kəmˈpʌŋkʃn/; [n]懊悔,良心不安; [or]z8;
con: [a]/kɑːn/; [v]熟读,精读;哄骗; [adv]反对;从反面; prep. 反对;<意大利语><音乐>以; [n]指挥操舵;指挥操舵者的位置;反对(论点); [adj]骗取信任的; [or]z8;
concede: [a]/kənˈsiːd/; [v]承认;承认失败;让给,让与;让步; [or]z8;
concentric: [a]/kənˈsentrɪk/; [adj]同中心的; [adv]同一中心地;同轴地; [or]z8;
concerto: [a]/kənˈtʃɜːrtoʊ/; [n]<音乐>协奏曲; [or]z8;
conciliate: [a]/kənˈsɪlieɪt/; [v]调和,安抚; [or]z8;
concord: [a]/ˈkɑːŋkɔːrd/; [n]和睦,公约; [or]z8;
concur: [a]/kənˈkɜːr/; [v]同意;一致; [or]z8;
condom: [a]/ˈkɑːndəm/; [n]安全套,避孕套; [or]z8;
confection: [a]/kənˈfekʃn/; [n]糖果,蜜饯,调制,糖膏(剂),精制工艺品; [v]〈古〉调制; [or]z8;
confederacy: [a]/kənˈfedərəsi/; [n]联盟;同谋; [or]z8;
confederate: [a]/kənˈfedərət/; [n]同盟国,同盟者; [adj]同盟的,联合的; [v]结盟,联合; [or]z8;
confer: [a]/kənˈfɜːr/; [v]授予(奖项,学位,荣誉或权利);商讨,协商; [or]z8;
confetti: [a]/kənˈfeti/; [n](婚礼,狂欢节中抛撒的)五彩纸屑; [or]z8;
confidant: [a]/ˈkɑːnfɪdænt/; [n]密友; [or]z8;
confide: [a]/kənˈfaɪd/; [v]倾诉;委托;信赖; [or]z8;
configuration: [a]/kənˌfɪɡjəˈreɪʃn/; [n]配置,布局,构造; [or]z8;
confinement: [a]/kənˈfaɪnmənt/; [n]限制;监禁;分娩; [or]z8;
conflate: [a]/kənˈfleɪt/; [v]合并; [or]z8;
congenial: [a]/kənˈdʒiːniəl/; [adj]意气相投的,令人愉快的,意气相投的,协调的; [or]z8;
congenital: [a]/kənˈdʒenɪtl/; [adj]天生的,固有的; [or]z8;
congested: [a]/kənˈdʒestɪd/; [adj]拥挤的,密集的; [or]z8;
conjecture: [a]/kənˈdʒektʃər/; [n]推测;猜想; [v]推测;揣摩; [or]z8;
conjure: [a]/ˈkʌndʒər/; [v]变魔术;使...变戏法般地出现(或消失);使想起;使...呈现于脑际;(a name to conjure with)大名鼎鼎的人;影响巨大的事物;恳求; [or]z8;
connoisseur: [a]/ˌkɑːnəˈsɜːr/; [n](艺术品等的)鉴赏家,鉴定家,行家; [or]z8;
consecrate: [a]/ˈkɑːnsɪkreɪt/; [v]使神圣,(用宗教仪式)授予..以某种职位; [adj]神圣的;被献给神的; [or]z8;
consensus: [a]/kənˈsensəs/; [n]一致同意,合意; [or]z8;
consign: [a]/kənˈsaɪn/; [v]托运,托卖,寄存; [or]z8;
consignment: [a]/kənˈsaɪnmənt/; [n]委托;运送;托付物; [or]z8;
console: [a]/kənˈsoʊl/; [v]安慰,慰问; [n]控制台,仪表板;落地柜; [or]z8;
conspiracy: [a]/kənˈspɪrəsi/; [n]密谋,阴谋; [or]z8;
conspire: [a]/kənˈspaɪər/; [v]密谋策划;共谋,串通一气; [or]z8;
constancy: [a]/ˈkɑːnstənsi/; [n]坚贞,忠诚,专一;稳定性,恒定性; [or]z8;
constituent: [a]/kənˈstɪtʃuənt/; [adj]组成的;有选举权的; [n]选民;成分; [or]z8;
constrain: [a]/kənˈstreɪn/; [v]约束;限制;强迫; [or]z8;
constraint: [a]/kənˈstreɪnt/; [n]限制;强迫,拘束;强制; [or]z8;
consummate: [a]/ˈkɑːnsəmət/; [adj]至上的,完美的; [v]完成,使达到极点; [or]z8;
contemplate: [a]/ˈkɑːntəmpleɪt/; [v]沉思;对..周密考虑;注视; [or]z8;
contend: [a]/kənˈtend/; [v]争辩;坚决主张;搏斗; [or]z8;
contingency: [a]/kənˈtɪndʒənsi/; [n]偶然性;<安全>意外事故;可能性;<审计>意外开支; [or]z8;
contingent: [a]/kənˈtɪndʒənt/; [n]分遣队; [adj]意外的,视情况条件而定的; [or]z8;
continuum: [a]/kənˈtɪnjuəm/; [n]连续,连续统,闭连集; [or]z8;
contort: [a]/kənˈtɔːrt/; [v]扭曲,歪曲; [or]z8;
contour: [a]/ˈkɑːntʊr/; [n]轮廓,等高线,概要; [vt]画轮廓,画等高线; [adj](表示<循着>)等高线的;与轮廓相合的; [or]z8;
contraception: [a]/ˌkɑːntrəˈsepʃn/; [n]避孕,避孕法; [or]z8;
contraceptive: [a]/ˌkɑːntrəˈseptɪv/; [adj]避孕的; [n]避孕品,避孕用具; [or]z8;
contrive: [a]/kənˈtraɪv/; [v]发明;设计出;设法做到;谋划;策划; [or]z8;
convene: [a]/kənˈviːn/; [v]集合,召集,召唤; [or]z8;
converge: [a]/kənˈvɜːrdʒ/; [v](向某一点)相交,会合;汇集,聚集,集中; [or]z8;
conversant: [a]/kənˈvɜːrsnt/; [adj]熟悉的;精通的;亲近的; [or]z8;
convoy: [a]/ˈkɑːnvɔɪ/; [n]护送,护卫,护航队; [v]护航,护送; [or]z8;
convulse: [a]/kənˈvʌls/; [v]使抽搐,使震动,震惊; [or]z8;
coop: [a]/kuːp/; [v]把.关进笼子里;限制;拘禁; [n]鸡笼;小屋;捕鱼篓; [or]z8;
cornet: [a]/ˈkɔːrnɪt/; [n]短号;圆锥形蛋卷; [or]z8;
corollary: [a]/ˈkɔːrəleri/; [n]推论;必然的结果; [or]z8;
coronation: [a]/ˌkɔːrəˈneɪʃn/; [n]加冕,加冕礼; [or]z8;
coroner: [a]/ˈkɔːrənər/; [n]验尸官; [or]z8;
corps: [a]/kɔːr/; [n](由两个或以上师组成的)军,兵团;一群人;特别小组; [or]z8;
corpulent: [a]/ˈkɔːrpjələnt/; [adj]肥胖的; [or]z8;
correlate: [a]/ˈkɔːrələt/; [v](使)相关联; [n]相关物; [or]z8;
corroborate: [a]/kəˈrɑːbəreɪt/; [v]支持或证实,强化; [n]确证者,证物; [or]z8;
corrode: [a]/kəˈroʊd/; [v]受腐蚀;腐蚀,侵蚀; [or]z8;
corrosion: [a]/kəˈroʊʒn/; [n]侵蚀,腐蚀状态; [or]z8;
corrugated: [a]/ˈkɔːrəɡeɪtɪd/; [adj]褶皱的; [or]z8;
countenance: [a]/ˈkaʊntənəns/; [n]面容,表情,气色; [v]支持,赞成; [or]z8;
counteract: [a]/ˌkaʊntərˈækt/; [v]抵消;中和;阻碍; [or]z8;
counterbalance: [a]/ˌkaʊntərˈbæləns/; [n]平衡力;抵销; [v]使平衡;抵消; [or]z8;
counterfeit: [a]/ˈkaʊntərfɪt/; [n]仿制品,伪造物; [adj]仿造的.假冒的; [v]伪造,仿造; [or]z8;
coup: [a]/kuː/; [n]政变;出乎意料的行动或胜利; [or]z8;
courier: [a]/ˈkʊriər/; [n]快递员,通讯员,导游; [or]z8;
courtship: [a]/ˈkɔːrtʃɪp/; [n]求爱,求爱时期,交往期间; [or]z8;
covenant: [a]/ˈkʌvənənt/; [n]契约; [v]立书保证; [or]z8;
coverage: [a]/ˈkʌvərɪdʒ/; [n]新闻报道;可达范围;覆盖范围; [or]z8;
covet: [a]/ˈkʌvət/; [v]垂涎;觊觎; [or]z8;
cowardice: [a]/ˈkaʊərdɪs/; [n]胆小,懦弱; [or]z8;
coy: [a]/kɔɪ/; [adj]腼腆的,怕羞的;卖弄风情的; [or]z8;
cram: [a]/kræm/; [v]塞满;猛吃;仓促备考; [or]z8;
cramp: [a]/kræmp/; [n]痉挛,绞痛;<五金>铁夹钳; [v]束缚,限制;使.抽筋;以铁箍扣紧; [or]z8;
cranky: [a]/ˈkræŋki/; [adj]暴躁的;古怪的;动摇的; [or]z8;
crap: [a]/kræp/; [n]废话,废物,屎; [v]掷骰子,拉屎; [adj]坏的;糟糕的;劣质的; [or]z8;
crater: [a]/ˈkreɪtər/; [n]火山口;弹坑; [v]在.上形成坑;毁坏; [or]z8;
crave: [a]/kreɪv/; [v]渴望;恳求; [or]z8;
craven: [a]/ˈkreɪvn/; [adj]懦弱的,畏缩的; [or]z8;
crease: [a]/kriːs/; [n]折缝,皱痕; [v]起折痕; [or]z8;
credibility: [a]/ˌkredəˈbɪləti/; [n]可靠性,可信性,确实有效性; [or]z8;
crescent: [a]/ˈkresnt/; [n]新月,新月状物,伊斯兰教的标记,土耳其的新月形国徽; [adj]新月形的,逐渐增加的; [v]以新月形物装饰,使成新月形; [or]z8;
cringe: [a]/krɪndʒ/; [vi]畏缩;觉得尴尬不安或难为情; [v]奉承,阿谀; [n]畏缩;奉承; [or]z8;
crinkle: [a]/ˈkrɪŋkl/; [n]皱纹,波纹,沙沙声; [v]起皱,使沙沙作响; [or]z8;
critique: [a]/krɪˈtiːk/; [n]批评;评论文章; [v]批判,评论;评论; [or]z8;
croak: [a]/kroʊk/; [n]蛙鸣声; [or]z8;
crook: [a]/krʊk/; [n]骗子;弯曲处;钩;河弯;诡计; [v]使弯曲; [adj]不正当的;骗人的; [or]z8;
crooked: [a]/ˈkrʊkɪd/; [adj]弯曲的;歪的;不正当的;不正直的; [or]z8;
crossword: [a]/ˈkrɔːswɜːrd/; [n]纵横字谜,纵横填字谜; [or]z8;
crucify: [a]/ˈkruːsɪfaɪ/; [v]折磨,迫害;十字架上钉死;克制; [or]z8;
crunch: [a]/krʌntʃ/; [n]嘎吱嘎吱的声音; [vt]嘎吱嘎吱地咀嚼; [vi]嘎吱嘎吱地咀嚼;嘎吱嘎吱地动;发嘎吱嘎吱声; [or]z8;
crux: [a]/krʌks/; [n]关键,难题,十字架形,坩埚; [or]z8;
crypt: [a]/krɪpt/; [n]地窟,［解］腺窝,小囊; pref. 隐藏的;秘密的(=crypto); [or]z8;
cryptic: [a]/ˈkrɪptɪk/; [adj]秘密的,含义模糊的,神秘的,隐藏的; [or]z8;
cub: [a]/kʌb/; [n]幼兽,年轻无经验的人; [v](野兽)生仔; [adj]没经验的; [or]z8;
cuckoo: [a]/ˈkʊkuː/; [n]杜鹃鸟;布谷鸟; [adj]疯狂的; [or]z8;
cuddle: [a]/ˈkʌdl/; [n]拥抱; [v]拥抱,搂抱;紧贴着身子睡; [or]z8;
culminate: [a]/ˈkʌlmɪneɪt/; [v]使达高潮,使结束; [or]z8;
culprit: [a]/ˈkʌlprɪt/; [n]罪犯,犯人,犯错者; [or]z8;
cult: [a]/kʌlt/; [n]异教;风尚,热潮;信徒; [adj]流行的;风靡一时的; [or]z8;
cumbersome: [a]/ˈkʌmbərsəm/; [adj]笨重的;麻烦的; [or]z8;
cumulative: [a]/ˈkjuːmjəleɪtɪv/; [adj]渐增的;累积的; [or]z8;
curfew: [a]/ˈkɜːrfjuː/; [n]宵禁,宵禁令,晚钟声,熄灯就寝时刻; [or]z8;
cursive: [a]/ˈkɜːrsɪv/; [n]草书;草书原稿; [adj]草书的;草书体的; [or]z8;
cursory: [a]/ˈkɜːrsəri/; [adj]匆忙的,不注意细节的;草率地;粗略地; [or]z8;
curt: [a]/kɜːrt/; [adj]简略的; [or]z8;
curtail: [a]/kɜːrˈteɪl/; [vt]截短;削减;剥夺.特权; [or]z8;
custard: [a]/ˈkʌstərd/; [n]奶油冻,奶油蛋羹; [or]z8;
dab: [a]/dæb/; [n]轻拍,少量,熟手,比目鱼; [v]轻拍,涂,轻擦,轻敷; [or]z8;
daffodil: [a]/ˈdæfədɪl/; [n]水仙花; [adj]水仙花色的; [or]z8;
daft: [a]/dæft/; [adj]愚蠢的; [or]z8;
dais: [a]/ˈdeɪɪs/; [n]主席台,嘉宾席; [or]z8;
daisy: [a]/ˈdeɪzi/; [n]雏菊;菊科植物;极好的东西; [adj]极好的;上等的; [or]z8;
dampen: [a]/ˈdæmpən/; [v]变潮湿; [vi]沮丧; [vt]使潮湿;抑制,使扫兴; [or]z8;
damsel: [a]/ˈdæmzl/; [n]少女,年轻女子; [or]z8;
dandelion: [a]/ˈdændɪlaɪən/; [n]蒲公英; [or]z8;
dandy: [a]/ˈdændi/; [n]花花公子; [adj]服装华丽的,极好的,上等的; [or]z8;
dank: [a]/dæŋk/; [adj]潮湿的,阴湿的;透水的; [or]z8;
dapper: [a]/ˈdæpər/; [adj]干净利落的,衣冠楚楚的; [or]z8;
dappled: [a]/ˈdæpld/; [adj]有斑点的,斑驳的; [or]z8;
daredevil: [a]/ˈderdevl/; [n]铤而走险的人,蛮勇的人; [adj]蛮勇的,不怕死的; [or]z8;
darn: [a]/dɑːrn/; [v]缝补; [adj]可恶的;完全的; [adv]极其; [int]可恶; [n]补丁;织补之处; [or]z8;
dated: [a]/ˈdeɪtɪd/; [adj]注有(或注明)日期的;过时的,旧式的; [or]z8;
daunt: [a]/dɔːnt/; [v]使气馁,使畏缩,威吓; [or]z8;
dauntless: [a]/ˈdɔːntləs/; [adj]勇敢的,无畏的;不屈不挠的; [or]z8;
dawdle: [a]/ˈdɔːdl/; [v]闲荡,浪费时间; [or]z8;
deadlock: [a]/ˈdedlɑːk/; [vt](使)相持不下; [vi]僵持; [n]僵局;不分胜负; [or]z8;
debacle: [a]/dɪˈbɑːkl/; [n]解冻,崩溃;灾害; [or]z8;
debase: [a]/dɪˈbeɪs/; [v]贬值,降低; [or]z8;
debilitate: [a]/dɪˈbɪlɪteɪt/; [v]使衰弱; [or]z8;
debit: [a]/ˈdebɪt/; [vt]记入借方,登入借方; [n]借方; [or]z8;
debris: [a]/dəˈbriː/; [n]废墟,残骸; [or]z8;
decadent: [a]/ˈdekədənt/; [adj]颓废的;衰退的; [or]z8;
decease: [a]/dɪˈsiːs/; [n]死亡; [v]死; [or]z8;
decelerate: [a]/ˌdiːˈseləreɪt/; [v](使)减速; [or]z8;
decency: [a]/ˈdiːsnsi/; [n]正派,体面,庄重,合乎礼仪,礼貌; [or]z8;
decipher: [a]/dɪˈsaɪfər/; [n]密电译文; [vt]解释;破译; [or]z8;
declaim: [a]/dɪˈkleɪm/; [v]高谈阔论,雄辩,大声说; [or]z8;
decompose: [a]/ˌdiːkəmˈpoʊz/; [v](使)腐烂;分解; [or]z8;
decor: [a]/deɪˈkɔːr/; [n]装饰,布置; [or]z8;
decorous: [a]/ˈdekərəs/; [adj]端庄稳重的,正派得体的,有礼貌的,高雅的; [or]z8;
decorum: [a]/dɪˈkɔːrəm/; [n]礼节,礼貌,端庄,正派; [or]z8;
decoy: [a]/dɪˈkɔɪ/; [n]诱饵;诱骗; [v]诱骗; [or]z8;
decry: [a]/dɪˈkraɪ/; [v]谴责,责难,诽谤; [or]z8;
deem: [a]/diːm/; [v]认为,视为;知道,相信; [or]z8;
deface: [a]/dɪˈfeɪs/; [v]损伤外观,丑化; [or]z8;
defame: [a]/dɪˈfeɪm/; [v]诽谤,中伤; [or]z8;
defer: [a]/dɪˈfɜːr/; [v]使推迟,使延期;听从,顺从; [vi]延期; [or]z8;
defile: [a]/dɪˈfaɪl/; [v]污损,弄脏;以纵队前进; [n]狭谷;隘路; [or]z8;
definitive: [a]/dɪˈfɪnətɪv/; [adj]可靠的,明确的,权威的;决定性的; [or]z8;
deflate: [a]/dɪˈfleɪt/; [v]放气;使缩小;紧缩通货;打击;使泄气;物价下降; [or]z8;
defoliate: [a]/ˌdiːˈfoʊlieɪt/; [v]落叶; [adj]〈罕〉落了叶的; [or]z8;
deform: [a]/dɪˈfɔːrm/; [v](使)变形; [adj]畸形的;丑陋的; [or]z8;
defraud: [a]/dɪˈfrɔːd/; [v]欺诈,诈取,骗取; [or]z8;
defrost: [a]/ˌdiːˈfrɔːst/; [v]除霜,解冻; [or]z8;
deft: [a]/deft/; [adj]灵巧的,敏捷的,熟练的; [or]z8;
defunct: [a]/dɪˈfʌŋkt/; [adj]已故的,不复存在的;不再使用的; [or]z8;
defuse: [a]/ˌdiːˈfjuːz/; [vi]平息,变弱; [vt]拆除;使消除危险性,平息; [or]z8;
degenerate: [a]/dɪˈdʒenəreɪt/; [v]堕落,衰减; [adj]腐化的,颓废的,退化的;变质的; [n]堕落者; [or]z8;
degrade: [a]/dɪˈɡreɪd/; [v]贬低;降低品格(身价,价值等);分解;降低; [or]z8;
dehydrate: [a]/diːˈhaɪdreɪt/; [v]除去水份,脱水; [or]z8;
deify: [a]/ˈdeɪɪfaɪ/; [v]奉为神;崇拜; [or]z8;
deity: [a]/ˈdiːəti/; [n]上帝,神性; [or]z8;
deliberate: [a]/dɪˈlɪbərət/; [adj]故意的;深思熟虑的;从容不迫的; [v]仔细考虑;研讨; [or]z8;
delimit: [a]/diˈlɪmɪt/; [v]定界,划界; [or]z8;
delineate: [a]/dɪˈlɪnieɪt/; [v]描画;画出..轮廓; [or]z8;
delirious: [a]/dɪˈlɪriəs/; [adj]精神错乱的,发狂的; [or]z8;
delude: [a]/dɪˈluːd/; [v]欺骗,哄骗; [or]z8;
deluge: [a]/ˈdeljuːdʒ/; [n]洪水;暴雨;泛滥; [v]使泛滥;压倒; [or]z8;
deluxe: [a]/dɪˈlʌks/; [adj]豪华的,华丽的; [or]z8;
delve: [a]/delv/; [v]钻研;探究;挖; [n]穴;洞; [or]z8;
demean: [a]/dɪˈmiːn/; [v]贬抑,降低; [or]z8;
demeanor: [a]/dɪ'miːnə/; [n]举止,行为,风度; [or]z8;
demented: [a]/dɪˈmentɪd/; [adj]发狂的,精神错乱的; [v]精神错乱;变得痴呆; [or]z8;
demobilize: [a]/diːˈmoʊbəlaɪz/; [v]遣散,使退伍; [or]z8;
demography: [a]/dɪˈmɑːɡrəfi/; [n]人口统计,人口统计学; [or]z8;
demon: [a]/ˈdiːmən/; [n]魔鬼,极残忍的人; [or]z8;
demoralize: [a]/dɪˈmɔːrəlaɪz/; [v]使低落,使沮丧;使道德败坏;使士气低落; [or]z8;
demote: [a]/ˌdiːˈmoʊt/; [v]降级,降职; [or]z8;
denizen: [a]/ˈdenɪzn/; [n]居民,外籍居民; [or]z8;
denominate: [a]/dɪˈnɑːmɪneɪt/; [v]命名,取名; [adj]有说明性名称的; [or]z8;
dent: [a]/dent/; [n]缺口,凹痕; [v]使凹下,凹进,削弱; [or]z8;
dentistry: [a]/ˈdentɪstri/; [n]牙科学;牙医职业; [or]z8;
deodorant: [a]/diˈoʊdərənt/; [adj]除臭的;防臭的; [n]除臭剂; [or]z8;
deplete: [a]/dɪˈpliːt/; [v]使大大减少;耗尽,用尽; [or]z8;
deplore: [a]/dɪˈplɔːr/; [v]谴责;对...深感遗憾;悲悼;痛惜; [or]z8;
depose: [a]/dɪˈpoʊz/; [v]免职,废黜,作证; [or]z8;
depository: [a]/dɪˈpɑːzətɔːri/; [n]贮藏所,受托者; [adj]保管的,存储的; [or]z8;
deprecate: [a]/ˈdeprəkeɪt/; [v]反对;轻视; [or]z8;
depreciate: [a]/dɪˈpriːʃieɪt/; [v]贬低,轻视;贬值;折旧; [or]z8;
deride: [a]/dɪˈraɪd/; [v]嘲弄,愚弄; [or]z8;
derision: [a]/dɪˈrɪʒn/; [n]嘲笑,嘲笑的目标,笑柄; [or]z8;
derogatory: [a]/dɪˈrɑːɡətɔːri/; [adj]不敬的,诽谤的; [or]z8;
derrick: [a]/ˈderɪk/; [n]起重机,转臂起重机,油井的铁架塔; [or]z8;
desiccate: [a]/'desɪˌkeɪt/; [v](使)完全干涸,脱水; [or]z8;
despicable: [a]/dɪˈspɪkəbl/; [adj]可鄙的,卑劣的; [or]z8;
despoil: [a]/dɪˈspɔɪl/; [v]掠夺,剥夺;夺取; [or]z8;
destitute: [a]/ˈdestɪtuːt/; [adj]贫穷的,缺乏的; [or]z8;
deterrent: [a]/dɪˈtɜːrənt/; [n]威慑物; [v]威慑的; [or]z8;
detest: [a]/dɪˈtest/; [vt]厌恶,憎恨,痛恨; [or]z8;
detonate: [a]/ˈdetəneɪt/; [v](使)爆炸,引爆; [or]z8;
detour: [a]/ˈdiːtʊr/; [n]弯路,绕行之路; [v]绕道,迂回; [or]z8;
devastate: [a]/ˈdevəsteɪt/; [v]摧毁;使垮掉,使不知所措,使陷于混乱; [or]z8;
deviant: [a]/ˈdiːviənt/; [adj]变态的,反常的(多指性行为);越出常规的; [n]异常的人;性变态者; [or]z8;
deviate: [a]/ˈdiːvieɪt/; [v]偏离;背离; [adj]脱离常轨的; [n]脱离常轨的人; [or]z8;
deviation: [a]/ˌdiːviˈeɪʃn/; [n]偏离,背离; [or]z8;
devious: [a]/ˈdiːviəs/; [adj]迂回弯曲的,狡猾的; [or]z8;
devoid: [a]/dɪˈvɔɪd/; [adj]全无的,缺乏的; [or]z8;
devolve: [a]/dɪˈvɑːlv/; [v]被移交;转让;移交;使滚下;衰落; [or]z8;
devout: [a]/dɪˈvaʊt/; [adj]虔诚的,真挚的,诚恳的; [n]虔诚;真挚,诚恳; [or]z8;
dexterity: [a]/dekˈsterəti/; [n]纯熟;灵巧; [or]z8;
diabetes: [a]/ˌdaɪəˈbiːtiːz/; [n]糖尿病,多尿症; [or]z8;
diagonal: [a]/daɪˈæɡənl/; [n]对角线; [adj]对角线的;斜的;斜纹的; [or]z8;
diarrhea: [a]/ˌdaɪə'riːə/; [n]腹泻,拉肚子; [or]z8;
diarrhoea: [a]/ˌdaɪəˈriːə/; [n]腹泻; [or]z8;
dice: [a]/daɪs/; [n]骰子,小方块; [v]掷骰子;切成方块; [or]z8;
dichotomy: [a]/daɪˈkɑːtəmi/; [n]二分,本质对立; [or]z8;
dictum: [a]/ˈdɪktəm/; [n]名言,格言;法官的附带意见; [or]z8;
didactic: [a]/daɪˈdæktɪk/; [adj]说教的;教诲的; [or]z8;
diehard: [a]/ˈdaɪhɑːrd/; [n]顽固分子,保守分子; [adj]顽固的,执拗的; [or]z8;
differentiate: [a]/ˌdɪfəˈrenʃieɪt/; [v]使有差异;区别; [or]z8;
diffident: [a]/ˈdɪfɪdənt/; [adj]羞怯的,缺乏自信的,谦虚谨慎的; [or]z8;
digress: [a]/daɪˈɡres/; [v]离题;走向岔道; [or]z8;
dilapidated: [a]/dɪˈlæpɪdeɪtɪd/; [adj]破旧的,破烂的;倾坍的; [or]z8;
dilate: [a]/daɪˈleɪt/; [v]使膨胀,扩张,膨胀;详述; [or]z8;
dilettante: [a]/ˌdɪləˈtænti/; [n]半吊子; [or]z8;
dimple: [a]/ˈdɪmpl/; [n]酒窝,涟漪,浅凹;酒窝;浅凹;酒涡,涟漪,浅凹; [v]做出凹痕;(使)起波纹;(使)起涟漪; [or]z8;
din: [a]/dɪn/; [n]喧闹声,嘈杂声; [v]喧闹,喋喋不休地说; [or]z8;
dinghy: [a]/ˈdɪŋi/; [n]无篷小船,小艇; [or]z8;
dingy: [a]/ˈdɪndʒi/; [adj]昏暗的,肮脏的;褴褛的; [n]同"dingey"; [or]z8;
diphthong: [a]/ˈdɪfθɑːŋ/; [n]双元音,元音连字; [or]z8;
dire: [a]/ˈdaɪər/; [adj]可怕的;悲惨的;极端的; [or]z8;
directive: [a]/dəˈrektɪv/; [n]指示,指令; [adj]指导的,管理的;方向的; [or]z8;
disarray: [a]/ˌdɪsəˈreɪ/; [n]混乱,漫无秩序; [or]z8;
disavow: [a]/ˌdɪsəˈvaʊ/; [v]不承认,抵赖,拒绝对..承担责任; [or]z8;
discernible: [a]/dɪˈsɜːrnəbl/; [adj]可辨别的;可识别的; [or]z8;
discerning: [a]/dɪˈsɜːrnɪŋ/; [adj]有辨别力的,敏锐的; [or]z8;
disclaim: [a]/dɪsˈkleɪm/; [v]放弃权利,拒绝承认,拒绝; [or]z8;
disconcert: [a]/ˌdɪskənˈsɜːrt/; [v]使仓皇失措;使困惑;破坏; [or]z8;
discredit: [a]/dɪsˈkredɪt/; [v]使不相信,使怀疑;败坏.的名声; [n]丧失信誉,丧失名誉;败坏名声的人或事,耻辱; [or]z8;
discreet: [a]/dɪˈskriːt/; [adj]谨慎的;思虑周全的,小心的; [or]z8;
discrete: [a]/dɪˈskriːt/; [adj]分开的;不连续的; [or]z8;
disenchant: [a]/ˌdɪsɪn'tʃænt/; [v]使觉悟,使摆脱幻想; [or]z8;
dishonor: [a]/dɪs'ɒnə/; [n]不光彩,不名誉; [v]使丢脸,凌辱; [or]z8;
dishonour: [a]/dɪsˈɑːnər/; [n]失去名誉;不光彩,耻辱;丢脸的人;无礼; [v]使受耻辱;不遵守;奸污; [or]z8;
disinterested: [a]/dɪsˈɪntrəstɪd/; [adj]公正的;不感兴趣的;无私的;廉洁的; [or]z8;
disjointed: [a]/dɪsˈdʒɔɪntɪd/; [adj]杂乱的,无逻辑的,脱节的; [or]z8;
dislocate: [a]/ˈdɪsloʊkeɪt/; [v]使脱臼;把.弄乱; [or]z8;
dislodge: [a]/dɪsˈlɑːdʒ/; [v]驱逐;移去;取出; [or]z8;
disparate: [a]/ˈdɪspərət/; [adj]迥然不同的; [or]z8;
disparity: [a]/dɪˈspærəti/; [n]不同,不一致,不等; [or]z8;
dispensable: [a]/dɪˈspensəbl/; [adj]不必要的,可有可无的; [or]z8;
dispirited: [a]/dɪˈspɪrɪtɪd/; [adj]沮丧的;消沉的;情绪低落的;灰心的; [or]z8;
disprove: [a]/ˌdɪsˈpruːv/; [v]反驳,证明.是虚假的; [or]z8;
disrepute: [a]/ˌdɪsrɪˈpjuːt/; [n]不光彩,坏名声; [or]z8;
disrespect: [a]/ˌdɪsrɪˈspekt/; [n]不礼貌,无礼,失礼; [vt]不尊重,藐视,轻视; [or]z8;
disseminate: [a]/dɪˈsemɪneɪt/; [v]宣传,传播;散布; [or]z8;
dissension: [a]/dɪˈsenʃn/; [n]意见分歧;纷争;倾轧; [or]z8;
dissipated: [a]/ˈdɪsɪpeɪtɪd/; [adj]消散的;沉迷于酒色的;闲游浪荡的;放荡的; [or]z8;
dissolute: [a]/ˈdɪsəluːt/; [adj]无节制的;放荡的; [or]z8;
dissonance: [a]/ˈdɪsənəns/; [n]不一致;不调和;不和谐音; [or]z8;
dissuade: [a]/dɪˈsweɪd/; [v]劝阻,阻止; [or]z8;
distaste: [a]/dɪsˈteɪst/; [n]厌恶,讨厌; [v]厌恶,不喜欢; [or]z8;
distraught: [a]/dɪˈstrɔːt/; [adj]发狂的;心烦意乱的; [or]z8;
dither: [a]/ˈdɪðər/; [n]慌乱,犹豫,颤抖; [v]慌乱,踌躇犹豫,颤抖; [or]z8;
diverge: [a]/daɪˈvɜːrdʒ/; [v]分歧,分开; [or]z8;
divergent: [a]/daɪˈvɜːrdʒənt/; [adj]叉开的;分歧的; [or]z8;
dividend: [a]/ˈdɪvɪdend/; [n](股份的)红利,回报,效益,被除数; [or]z8;
divine: [a]/dɪˈvaɪn/; [adj]神的,神圣的;极好的; [v](凭直觉)发现,猜到; [n]神学家;圣职人员;教士;上帝; [or]z8;
divinity: [a]/dɪˈvɪnəti/; [n]神,神性,神学; [or]z8;
divisive: [a]/dɪˈvaɪsɪv/; [adj]分裂的;区分的;造成不和的; [or]z8;
divulge: [a]/daɪˈvʌldʒ/; [v]泄露,透露; [or]z8;
docile: [a]/ˈdɑːsl/; [adj]驯服的,温顺的; [or]z8;
doctorate: [a]/ˈdɑːktərət/; [n]博士头衔; [or]z8;
dogma: [a]/ˈdɔːɡmə/; [n]教条;武断的意见; [adj]教义的,教条的,信条的; [or]z8;
dogmatic: [a]/dɔːɡˈmætɪk/; [adj]教条的,武断的; [or]z8;
doldrums: [a]/ˈdoʊldrəmz/; [n](海洋上的)无风带,情绪低沉; [or]z8;
dole: [a]/doʊl/; [n]救济,(失业)救济金; [v]发放,发给; [or]z8;
doleful: [a]/ˈdoʊlfl/; [adj]寂寞的;悲哀的;阴沉的; [or]z8;
domain: [a]/doʊˈmeɪn/; [n]域名;领土;管区,势力圈; [or]z8;
domesticate: [a]/dəˈmestɪkeɪt/; [vt]使习惯于家庭生活;驯养;引进; [or]z8;
domesticity: [a]/ˌdoʊmeˈstɪsəti/; [n]家庭生活,专心于家务,对家庭的挚爱; [or]z8;
domicile: [a]/ˈdɑːmɪsaɪl/; [n]住宅;永久居住地;期票支付场所; [v]居住;使在指定的场所支付(期票等; [adj]定居;在固定住所生活; [or]z8;
doodle: [a]/ˈduːdl/; [v](无目的地)乱画,漫无目的地打发时光; [n]涂鸦; [or]z8;
dope: [a]/doʊp/; [n]毒品;粘稠物,胶状物,添加剂;傻瓜,蠢货;内幕消息; [v]给.服用麻醉剂; [adj]<俚>极好的; [or]z8;
dormant: [a]/ˈdɔːrmənt/; [adj]睡眠的,休眠的;静止的,隐伏的; [or]z8;
dosage: [a]/ˈdoʊsɪdʒ/; [n]剂量; [or]z8;
dossier: [a]/ˈdɔːsieɪ/; [n]档案,卷宗;病历表册; [or]z8;
dote: [a]/doʊt/; [v]溺爱;昏愦; [or]z8;
downhill: [a]/ˈdaʊnhɪl/; [adv]下坡,向下,每况愈下; [adj]下坡的,容易的; [n]下坡,滑降; [or]z8;
downright: [a]/ˈdaʊnraɪt/; [adj]明白的,直率的,显明的; [adv]完全,彻底,全然; [or]z8;
downstream: [a]/ˌdaʊnˈstriːm/; [adv]下游地; [adj]下游的; [n]下行;顺流;〔体〕顺水;下游侧; [or]z8;
dowry: [a]/ˈdaʊri/; [n]嫁妆,天资,亡夫遗产; [or]z8;
drab: [a]/dræb/; [adj]枯黄色的,无聊的,单调的; [n]单调;淡褐色;[印,纺]淡褐色厚呢;邋遢女人; [or]z8;
drape: [a]/dreɪp/; [v]用布帘覆盖,使呈褶裥状; [n]窗帘,褶裥; [or]z8;
draught: [a]/dræft/; [n]气流,通风,穿堂风;药水; [v]起草;选派; [adj]桶装的;驮物的; [or]z8;
dregs: [a]/dreɡz/; [n]渣滓;少量;沉淀物; [or]z8;
drench: [a]/drentʃ/; [v]使淋透;使湿透; [n]淋透;雨淋;浸渍液;(制革时浸泡熟皮的)脱灰水; [or]z8;
dribble: [a]/ˈdrɪbl/; [v](液体)往下滴,淌,流口水,运球; [n]口水,运球; [or]z8;
drone: [a]/droʊn/; [n]无人机,无人驾驶飞机;雄蜂;单调的低音; [v]嗡嗡地响; [vi]混日子; [or]z8;
drool: [a]/druːl/; [v]流口水,胡说; [n]口水,梦话,胡说; [or]z8;
drowse: [a]/draʊz/; [v]打瞌睡;发呆;昏昏沉沉地消磨(时光); [n]瞌睡; [or]z8;
dub: [a]/dʌb/; [v]授予(称号);为(电影)配音;混录录制(音乐); [n](西印度群岛的)强节奏音乐; [or]z8;
duchy: [a]/ˈdʌtʃi/; [n]公国,公爵领地,直辖领地; [or]z8;
duet: [a]/duˈet/; [n]二重唱; [vi]演奏二重奏或二重唱; [or]z8;
dune: [a]/duːn/; [n](由风吹积而成的)沙丘; [or]z8;
duo: [a]/ˈduːoʊ/; [n]一对,二重唱; pref. 表示"二";"一对"; [or]z8;
dupe: [a]/duːp/; [n]受骗的人,上当者; [v]欺骗,愚弄; [or]z8;
duplicity: [a]/duːˈplɪsəti/; [n]口是心非;表里不一;不诚实; [or]z8;
dusky: [a]/ˈdʌski/; [adj]暗淡的,微暗的,忧郁的,朦胧的; [adv]昏暗地,黑暗地; [n]昏暗,黑暗; [or]z8;
dynamics: [a]/daɪ'næmɪks/; [n]动力学;力学; [or]z8;
earthenware: [a]/ˈɜːrθnwer/; [n]<总称>陶器; [adj]陶制的; [or]z8;
eaves: [a]/iːvz/; [n]屋檐,凸出的边缘; pl. 屋檐; [or]z8;
eavesdrop: [a]/ˈiːvzdrɑːp/; [v]偷听,窃听; [n]屋檐水; [or]z8;
eccentricity: [a]/ˌeksenˈtrɪsəti/; [n]古怪;怪癖;<数>离心率; [or]z8;
eclectic: [a]/ɪˈklektɪk/; [adj]折衷主义的;选择的; [n]折衷主义者,折衷派的人; [or]z8;
ecstasy: [a]/ˈekstəsi/; [n]狂喜,心醉神怡; [or]z8;
eddy: [a]/ˈedi/; [n]漩涡; [v]旋转;起漩涡; [or]z8;
edict: [a]/ˈiːdɪkt/; [n]法令,布告; [or]z8;
edifice: [a]/ˈedɪfɪs/; [n]宏伟的建筑物;大厦;(知识的)体系,结构; [or]z8;
eerie: [a]/ˈɪri/; [adj]胆怯的,引起恐惧的; [or]z8;
efface: [a]/ɪˈfeɪs/; [v]擦掉,抹去;消去; [or]z8;
effeminate: [a]/ɪˈfemɪnət/; [adj]柔弱的,女人气的,娇气的; [v](使)带女人气; [or]z8;
efficacy: [a]/ˈefɪkəsi/; [n]功效,效力; [or]z8;
effluent: [a]/ˈefluənt/; [n]污水; [adj]流出的; [or]z8;
egocentric: [a]/ˌiːɡoʊˈsentrɪk/; [adj]自我中心的,利己的; [n]自我主义者; [or]z8;
egoist: [a]/ˈiːɡoʊɪst/; [n]自我主义者,利己主义者; [or]z8;
ejaculate: [a]/iˈdʒækjuleɪt/; [v]突然叫出,射出; [n]射出;射出者;一次射出的精液;突然的喊出; [or]z8;
eject: [a]/iˈdʒekt/; [v](使)弹出;喷射;放逐; [or]z8;
elated: [a]/iˈleɪtɪd/; [adj]得意洋洋的;振奋的; [or]z8;
electorate: [a]/ɪˈlektərət/; [n]选民;选区; [or]z8;
electrify: [a]/ɪˈlektrɪfaɪ/; [v]通电;使触电;使激动;使震惊; [or]z8;
electrocute: [a]/ɪˈlektrəkjuːt/; [v](美)以电椅处死,使触电致死; [or]z8;
electrode: [a]/ɪˈlektroʊd/; [n]电极; [or]z8;
elemental: [a]/ˌelɪˈmentl/; [adj]基本的;自然力的; [or]z8;
elicit: [a]/iˈlɪsɪt/; [v]引出;诱出;探出; [or]z8;
eligible: [a]/ˈelɪdʒəbl/; [adj]适合被选的,符合条件的;(尤指婚姻等)合适的,合意的; [or]z8;
elite: [a]/ɪˈliːt/; [n]精英; [adj]高级的; [or]z8;
elope: [a]/ɪˈloʊp/; [v]私奔;潜逃;出走; [or]z8;
elucidate: [a]/iˈluːsɪdeɪt/; [v]阐明,说明; [or]z8;
elude: [a]/iˈluːd/; [v]逃避,躲避;使.错过,使.找不到;使.不记得;把.难住; [or]z8;
elusive: [a]/iˈluːsɪv/; [adj]难懂的;难捉摸的;难找的;难懂的;易忘的;逃避的;难捉摸的; [or]z8;
emaciated: [a]/ɪˈmeɪʃieɪtɪd/; [adj]瘦弱的;憔悴的; [or]z8;
emanate: [a]/ˈeməneɪt/; [v]发出;放射; [or]z8;
embed: [a]/ɪmˈbed/; [v]把.嵌入;使嵌入; [or]z8;
embellish: [a]/ɪmˈbelɪʃ/; [vt]装饰; [v]吹嘘;润色(文章); [vi]装饰起来;加以润色;添加细节,对...添枝加叶; [or]z8;
embezzle: [a]/ɪmˈbezl/; [v]盗用,挪用,贪污; [or]z8;
emblem: [a]/ˈembləm/; [n]象征;徽章;符号; [or]z8;
embody: [a]/ɪmˈbɑːdi/; [v]包含;体现,象征; [or]z8;
emboss: [a]/ɪmˈbɔːs/; [v]加浮雕花纹于;使凸出;装饰; [or]z8;
embroil: [a]/ɪmˈbrɔɪl/; [v]使卷入;使混乱; [or]z8;
emissary: [a]/ˈemɪseri/; [n]代理,信使,使者; [or]z8;
empathy: [a]/ˈempəθi/; [n]共鸣,同感;移情作用; [or]z8;
empiricism: [a]/ɪmˈpɪrɪsɪzəm/; [n]经验主义,经验论; [or]z8;
emulate: [a]/ˈemjuleɪt/; [v]努力赶上(超过),仿效; [n]仿真; [or]z8;
encampment: [a]/ɪnˈkæmpmənt/; [n]营地,露营; [or]z8;
encase: [a]/ɪnˈkeɪs/; [v]装入,包住,围; [or]z8;
enclave: [a]/ˈenkleɪv/; [n]飞地(指在本国境内的隶属另一国的一块领土),被包围的领土,被包围物; [or]z8;
encompass: [a]/ɪnˈkʌmpəs/; [vt]环绕,包围;包含;完成; [or]z8;
encore: [a]/ˈɑːŋkɔːr/; [n]再演唱的要求,经要求而再唱; [v]要求再演或唱; [int]再来一个; [or]z8;
encroach: [a]/ɪnˈkroʊtʃ/; [v]侵犯,侵占;蚕食(on); [or]z8;
encumber: [a]/ɪnˈkʌmbər/; [v]阻塞,妨害,拖累; [or]z8;
endanger: [a]/ɪnˈdeɪndʒər/; [v]危及,危害; [or]z8;
endemic: [a]/enˈdemɪk/; [adj]地方性的; [n]地方病; [or]z8;
endorse: [a]/ɪnˈdɔːrs/; [v]赞同,认可;签注(文件); [or]z8;
energize: [a]/ˈenərdʒaɪz/; [v]使活跃;给予精力;使兴奋; [or]z8;
enfold: [a]/ɪnˈfoʊld/; [v]拥抱,包裹,折叠; [or]z8;
engender: [a]/ɪnˈdʒendər/; [v]产生; [or]z8;
engross: [a]/ɪnˈɡroʊs/; [v]独占;正式誊写;使全神贯注于;用大字体书写; [or]z8;
enhance: [a]/ɪnˈhæns/; [v]提高(强度,力量,数量等);增加,加强; [or]z8;
enigma: [a]/ɪˈnɪɡmə/; [n]谜,哑谜;闷葫芦; [or]z8;
enigmatic: [a]/ˌenɪɡˈmætɪk/; [adj]神秘的,高深莫测的,谜一般的; [or]z8;
enmity: [a]/ˈenməti/; [n]敌意,憎恨; [or]z8;
enormity: [a]/ɪˈnɔːrməti/; [n]巨大;暴行;极恶; [or]z8;
enrage: [a]/ɪnˈreɪdʒ/; [v]使狂怒,激怒; [or]z8;
ensconce: [a]/ɪnˈskɑːns/; [v]安置;安顿下来;使.隐藏; [or]z8;
ensemble: [a]/ɑːnˈsɑːmbl/; [n]合唱团,表演团体;总效果;全套服装;全套家具; [or]z8;
enshrine: [a]/ɪnˈʃraɪn/; [v]把.置于神龛内;铭记,珍藏;把.奉为神圣; [or]z8;
ensign: [a]/ˈensən/; [n]旗,海军少尉,徽章; [or]z8;
ensue: [a]/ɪnˈsuː/; [v]跟着发生,接踵而来;因而产生; [or]z8;
entangle: [a]/ɪnˈtæŋɡl/; [v]使纠缠,卷入; [or]z8;
entice: [a]/ɪnˈtaɪs/; [v]怂恿,引诱; [or]z8;
entourage: [a]/ˈɑːnturɑːʒ/; [n]随从,周围,环境; [or]z8;
entreat: [a]/ɪnˈtriːt/; [v]恳求,请求; [or]z8;
entree: [a]/ˈɑːntreɪ/; [n]进入,入场权,［美］主菜,(歌剧等)开始的乐章; [or]z8;
entrust: [a]/ɪnˈtrʌst/; [v]委托,托管; [or]z8;
entwine: [a]/ɪnˈtwaɪn/; [v]使缠绕,交织; [or]z8;
enumerate: [a]/ɪˈnuːməreɪt/; [v]列举; [or]z8;
ephemeral: [a]/ɪˈfemərəl/; [adj]短暂的,短命的; [n]生存极短时间的事物; [or]z8;
epigram: [a]/ˈepɪɡræm/; [n]机智的言语; [or]z8;
epilogue: [a]/ˈepɪlɔːɡ/; [n]收场白;尾声; [or]z8;
epitaph: [a]/ˈepɪtæf/; [n]碑文,墓志铭; [or]z8;
epitome: [a]/ɪˈpɪtəmi/; [n]摘要,缩影; [or]z8;
epitomize: [a]/ɪˈpɪtəmaɪz/; [v]摘要;化身;成为.的缩影; [or]z8;
equable: [a]/ˈekwəbl/; [adj]温和,平均,稳定的,不变的,(脾气)温和的; [or]z8;
equilibrium: [a]/ˌiːkwɪˈlɪbriəm/; [n](心态情感等)平静;平衡; [or]z8;
equinox: [a]/ˈiːkwɪnɑːks/; [n]春分;秋分;昼夜平分点; [or]z8;
equitable: [a]/ˈekwɪtəbl/; [adj]公正的,公平的; [or]z8;
equivocal: [a]/ɪˈkwɪvəkl/; [adj]模棱两可的,不明确的,可疑的; [or]z8;
erasure: [a]/ɪˈreɪʒər/; [n]消除,涂擦的痕迹,消磁; [or]z8;
erotic: [a]/ɪˈrɑːtɪk/; [adj]性爱的,性欲的,色情的; [n]好色之徒; [adv]引起性欲地; [or]z8;
errant: [a]/ˈerənt/; [adj]错误的,脱离正途的,迷路的;周游的,漂泊的;无定的; [n]游侠; [or]z8;
erratic: [a]/ɪˈrætɪk/; [adj]古怪的;反复无常的,不稳定的; [or]z8;
erudite: [a]/ˈerudaɪt/; [adj]博学的,有学问的; [n]饱学之士,有学问的人; [or]z8;
escalate: [a]/ˈeskəleɪt/; [v]逐步升高,逐步增强,加剧恶化; [or]z8;
eschew: [a]/ɪsˈtʃuː/; [v]避开;戒绝; [or]z8;
esoteric: [a]/ˌesəˈterɪk/; [adj]秘传的,神秘的,限于少数人的; [n]受秘传的人; [or]z8;
espionage: [a]/ˈespiənɑːʒ/; [n]间谍活动,侦查,监视; [or]z8;
espouse: [a]/ɪˈspaʊz/; [v]支持,拥护; [or]z8;
estimable: [a]/ˈestɪməbl/; [adj]可估计的;可尊敬的;有价值的; [or]z8;
estrange: [a]/ɪ'streɪndʒ/; [v]使疏远,离间; [or]z8;
etch: [a]/etʃ/; [n]蚀刻; [vi]蚀刻; [vt]蚀镂,蚀刻,描述,铭记; [or]z8;
ethereal: [a]/iˈθɪriəl/; [adj]太空的,轻巧的,像空气的; [or]z8;
ethical: [a]/ˈeθɪkl/; [adj]伦理的;道德的;凭处方出售的; [n]处方药; [or]z8;
ethics: [a]/'eθɪks/; [n]行为准则;道德规范; [or]z8;
ethos: [a]/ˈiːθɑːs/; [n]民族精神,气质,社会思潮; [or]z8;
etiquette: [a]/ˈetɪket/; [n]礼仪; [or]z8;
eulogy: [a]/ˈjuːlədʒi/; [n]颂词,赞美词; [or]z8;
euphemism: [a]/ˈjuːfəmɪzəm/; [n]婉言,委婉的说法; [or]z8;
euphoria: [a]/juːˈfɔːriə/; [n]幸福愉快感; [or]z8;
euthanasia: [a]/ˌjuːθəˈneɪʒə/; [n]安乐死,安乐死术; [or]z8;
evacuate: [a]/ɪˈvækjueɪt/; [v]撤离,疏散,排清; [or]z8;
evade: [a]/ɪˈveɪd/; [v]躲避,回避; [or]z8;
evanescent: [a]/ˌevəˈnesnt/; [adj]短暂的,容易消散的,(印象等)逐渐消失的,会凋零的; [or]z8;
evangelical: [a]/ˌiːvænˈdʒelɪkl/; [adj]福音的,热切的; [n]福音派信徒; [or]z8;
evasive: [a]/ɪˈveɪsɪv/; [adj]逃避的;托辞的,推托的; [or]z8;
evict: [a]/ɪˈvɪkt/; [v]驱逐,逐出; [or]z8;
evince: [a]/ɪˈvɪns/; [v]表明,表示,引起; [or]z8;
evocative: [a]/ɪˈvɑːkətɪv/; [adj]唤起的;唤出的; [or]z8;
evoke: [a]/ɪˈvoʊk/; [v]唤起;引起;使人想起; [or]z8;
evolutionary: [a]/ˌevəˈluːʃəneri/; [adj]进化的,演进的; [or]z8;
ewe: [a]/juː/; [n]<畜牧>母羊; [or]z8;
exacerbate: [a]/ɪɡˈzæsərbeɪt/; [v]加重;恶化;激怒; [or]z8;
exalt: [a]/ɪɡˈzɔːlt/; [v]提升,提拔,赞扬,使得意; [or]z8;
exaltation: [a]/ˌeɡzɔːlˈteɪʃn/; [n]提升,提高,兴奋,得意洋洋; [or]z8;
exalted: [a]/ɪɡˈzɔːltɪd/; [adj]尊贵的,高位的;兴奋的;高尚的; [or]z8;
exasperate: [a]/ɪɡˈzæspəreɪt/; [vt]激怒;加剧; [or]z8;
excavate: [a]/ˈekskəveɪt/; [v]挖掘,挖出;挖(空),挖(洞); [or]z8;
excerpt: [a]/ˈeksɜːrpt/; [n]摘录,节选; [v]摘,选;引用; [or]z8;
excise: [a]/ˈeksaɪz/; [v]切除,删去; [n]消费税,货物税,国产税; [or]z8;
execrable: [a]/ˈeksɪkrəbl/; [adj]极坏的; [or]z8;
exemplary: [a]/ɪɡˈzempləri/; [adj]模范的,可仿效的; [or]z8;
exemplify: [a]/ɪɡˈzemplɪfaɪ/; [v]举例说明;例示,是..的典范; [or]z8;
exhilarate: [a]/ɪɡˈzɪləreɪt/; [v]使高兴;使兴奋; [adj]使人高兴的,令人兴奋的; [or]z8;
exhilarating: [a]/ɪɡˈzɪləreɪtɪŋ/; [adj]令人高兴的; [v]使高兴;使兴奋; [or]z8;
exhort: [a]/ɪɡˈzɔːrt/; [vt]敦促,劝告; [vi]规劝,劝告; [or]z8;
existential: [a]/ˌeɡzɪˈstenʃəl/; [adj]存在主义的,有关存在的,存在判断的; [or]z8;
exodus: [a]/ˈeksədəs/; [n]大批离去,成群外出; [or]z8;
exonerate: [a]/ɪɡˈzɑːnəreɪt/; [v]使免罪; [or]z8;
exotic: [a]/ɪɡˈzɑːtɪk/; [adj]奇异的,珍奇的,来自异国的; [or]z8;
expansive: [a]/ɪkˈspænsɪv/; [adj]广阔的,扩张的,豪爽的; [or]z8;
expectancy: [a]/ɪkˈspektənsi/; [n]期待;预期;期望的东西; [or]z8;
expectant: [a]/ɪkˈspektənt/; [adj]期待的;怀孕的;预期中的; [n]期待者;候选; [or]z8;
expedient: [a]/ɪkˈspiːdiənt/; [n]权宜之计,手段; [adj]有利的,方便的;权宜之计的; [or]z8;
expedite: [a]/ˈekspədaɪt/; [v]加快;促进;发出; [adj]畅通的;迅速的;方便的; [or]z8;
expiry: [a]/ɪkˈspaɪəri/; [n]满期,逾期,呼气,终结; [or]z8;
exploit: [a]/ɪkˈsplɔɪt/; [v]剥削,利用;开发,开拓; [n]辉煌功绩; [or]z8;
exponent: [a]/ɪkˈspoʊnənt/; [n]<数>指数;典型;说明者,说明物; [adj]说明的; [or]z8;
expound: [a]/ɪkˈspaʊnd/; [v]详细说明,解释,阐述; [or]z8;
expulsion: [a]/ɪkˈspʌlʃn/; [n]驱逐;开除; [or]z8;
expunge: [a]/ɪkˈspʌndʒ/; [v]删除; [or]z8;
expurgate: [a]/ˈekspərɡeɪt/; [v]净化,删去; [or]z8;
extant: [a]/ekˈstænt/; [adj]现存的;显著的; [or]z8;
exterminate: [a]/ɪkˈstɜːrmɪneɪt/; [v]消灭,灭绝;根除; [or]z8;
extol: [a]/ɪkˈstoʊl/; [v]赞美,称赞,颂扬; [or]z8;
extort: [a]/ɪkˈstɔːrt/; [vt]敲诈,勒索; [or]z8;
extract: [a]/ɪkˈstrækt/; [v]取出;提取;摘录;设法得到;索取; [n]摘录;提出物; [or]z8;
extraction: [a]/ɪkˈstrækʃn/; [n]抽出,取出;家世,出身;抽出物; [or]z8;
extradite: [a]/ˈekstrədaɪt/; [v]引渡,获取.的引渡; [or]z8;
extrapolate: [a]/ɪkˈstræpəleɪt/; [v]进行推断; [or]z8;
extraterrestrial: [a]/ˌekstrətəˈrestriəl/; [adj]地球外的,地球大气圈外的; [n]外星人,外星生物,宇航员; [or]z8;
extremity: [a]/ɪkˈstreməti/; [n]尽头,末端,极端;绝境;身体末端 (尤指手和脚);脚趾; [or]z8;
extricate: [a]/ˈekstrɪkeɪt/; [v]拯救,救出; [n]解脱;解脱者; [or]z8;
extrovert: [a]/ˈekstrəvɜːrt/; [v]变成外向性格;使成外向性格; [n]性格外向者; [adj]性格外向的; [or]z8;
exuberant: [a]/ɪɡˈzuːbərənt/; [adj](植物)茂盛的,(人)充满活力的; [or]z8;
exude: [a]/ɪɡˈzuːd/; [v]慢慢流出,四溢,渗出,散发; [or]z8;
exult: [a]/ɪɡˈzʌlt/; [v]狂喜,欢欣鼓舞; [or]z8;
eye-catching: [a]/ˈaɪ kætʃɪŋ/; [adj]引人注目的;耀眼的; [or]z8;
fabricate: [a]/ˈfæbrɪkeɪt/; [v]建造,制造,伪造(文件等),捏造,编造(谎言,借口等); [or]z8;
facade: [a]/fəˈsɑːd/; [n]建筑物的正面,外表; [or]z8;
facet: [a]/ˈfæsɪt/; [n](多面体的)面,小平面;琢面,侧面; [vt]在.上琢面; [or]z8;
facing: [a]/ˈfeɪsɪŋ/; [n]饰面,衣服等的贴边; [or]z8;
faction: [a]/ˈfækʃn/; [n]派别,小集团,小派系;派系斗争,内讧; [or]z8;
fad: [a]/fæd/; [n]风尚,风行一时的东西; [adj]极好的; [or]z8;
fairground: [a]/ˈferɡraʊnd/; [n]露天市场,举行赛会的场所; [or]z8;
falcon: [a]/ˈfælkən/; [n]猎鹰; [or]z8;
fallacious: [a]/fəˈleɪʃəs/; [adj]谬误的,易误解的,虚妄的; [or]z8;
fallacy: [a]/ˈfæləsi/; [n]谬论,谬见;错误,谬误; [or]z8;
fallible: [a]/ˈfæləbl/; [adj]会犯错的,易犯错的; [or]z8;
fallow: [a]/ˈfæloʊ/; [adj]休耕的;不活跃的;休闲地,休闲的; [n]休耕地;休耕; [v]使(翻耕后的土地)休闲; [or]z8;
falsehood: [a]/ˈfɔːlshʊd/; [n]谬误,不真实,谎言,虚假; [or]z8;
falsify: [a]/ˈfɔːlsɪfaɪ/; [v]篡改,说谎; [or]z8;
falsity: [a]/ˈfɔːlsəti/; [n]谎言,不真实; [or]z8;
fanciful: [a]/ˈfænsɪfl/; [adj]异想天开的;别出心裁的; [or]z8;
faraway: [a]/ˈfɑːrəweɪ/; [adj]遥远的,久远的,恍惚的,朦胧的; [n]遥远的事物; [or]z8;
farce: [a]/fɑːrs/; [n]闹剧;胡闹;笑剧; [or]z8;
fastidious: [a]/fæˈstɪdiəs/; [adj]难讨好的,爱挑剔的; [or]z8;
fatality: [a]/fəˈtæləti/; [n]死亡;宿命;致命性;不幸,灾祸; [or]z8;
fateful: [a]/ˈfeɪtfl/; [adj]重大的;决定性的;宿命的; [or]z8;
fatuous: [a]/ˈfætʃuəs/; [adj]愚昧而不自知的; [or]z8;
faucet: [a]/ˈfɔːsɪt/; [n]龙头,旋塞,(连接管子的)插口; [or]z8;
fauna: [a]/ˈfɔːnə/; [n]动物区系,动物群; [or]z8;
favoritism: [a]/'feɪvərɪtˌɪzəm/; [n]偏爱,偏袒; [or]z8;
fawn: [a]/fɔːn/; [v]奉承;生(小鹿或小动物); [n]小鹿;浅黄褐色; [or]z8;
faze: [a]/feɪz/; [v]打扰,折磨,使狼狈,使担忧; [or]z8;
feckless: [a]/ˈfekləs/; [adj]不负责任的,无目标无计划的,无效的; [adv]没有价值地;没有长远目标地;不负责任地; [n]没有价值,没有长远目标,不负责任; [or]z8;
fecund: [a]/ˈfiːkənd/; [adj]肥沃的;多产的;丰饶的;生殖力旺盛的; [or]z8;
feign: [a]/feɪn/; [v]假装,装作; [or]z8;
feint: [a]/feɪnt/; [v]佯攻,虚击; [n]佯攻; [adj]虚假的; [or]z8;
felicity: [a]/fəˈlɪsəti/; [n]幸福,快乐,幸运; [or]z8;
felony: [a]/ˈfeləni/; [n]重罪; [or]z8;
fence: [a]/fens/; [n]篱笆,围栏,栅栏; [v]击剑;用篱笆围住;束缚; [or]z8;
fend: [a]/fend/; [v](靠自己)照顾,照料;保护;力争; [or]z8;
fender: [a]/ˈfendər/; [n]火炉围栏;挡泥板,防护板;(汽车的)保险杠; [or]z8;
ferocity: [a]/fəˈrɑːsəti/; [n]凶猛,残暴; [or]z8;
ferret: [a]/ˈferɪt/; [n]雪貂;白鼬;侦探; [v]搜寻;查获;驱出;用雪貂猎取; [adj]雪貂似的;搜索者般的;爱窥探的; [or]z8;
fervent: [a]/ˈfɜːrvənt/; [adj]热烈的,满怀热情的;狂热的; [or]z8;
fervor: [a]/ˈfɜrvər/; [n]强烈感情,激情,热情; [or]z8;
fester: [a]/ˈfestər/; [v]溃烂;化脓;使..痛苦;使..恶化; [n]溃烂;脓疮,脓疱; [or]z8;
festive: [a]/ˈfestɪv/; [adj]庆祝的,喜庆的,欢乐的,节日似的; [or]z8;
festivity: [a]/feˈstɪvəti/; [n]欢庆,欢宴,庆典,欢乐; [or]z8;
fetid: [a]/ˈfetɪd/; [adj]有恶臭的; [or]z8;
fetter: [a]/ˈfetər/; [n]脚镣;束缚; [vt]给.上脚镣;束缚; [or]z8;
fetus: [a]/ˈfiːtəs/; [n]胎儿; [or]z8;
feud: [a]/fjuːd/; [n]不和;争执;封地; [v]长期不和,长期争斗; [or]z8;
feverish: [a]/ˈfiːvərɪʃ/; [adj]发烧的;狂热的,极其兴奋的;不稳定的; [or]z8;
fiasco: [a]/fiˈæskoʊ/; [n]大失败,惨败; [or]z8;
fickle: [a]/ˈfɪkl/; [adj](在感情等方面)反复无常的,轻浮的,善变的; [or]z8;
fictitious: [a]/fɪkˈtɪʃəs/; [adj]虚构的; [or]z8;
fidget: [a]/ˈfɪdʒɪt/; [v]坐立不安; [n]烦躁之人,烦躁; [adj]坐立不安的,不安定的,为琐事操心的; [or]z8;
fieldwork: [a]/ˈfiːldwɜːrk/; [n]现场工作,野外工作; [or]z8;
fiend: [a]/fiːnd/; [n]恶魔;能手;..迷; [or]z8;
fig: [a]/fɪɡ/; [n]无花果;无花果树;少许,一些;无价值的东西;服装; [vt]打扮;使马跑快; [or]z8;
figment: [a]/ˈfɪɡmənt/; [n]空想;虚构的理论,故事等; [or]z8;
figurative: [a]/ˈfɪɡərətɪv/; [adj]比喻的,修饰丰富的,形容多的; [or]z8;
figurehead: [a]/ˈfɪɡjərhed/; [n]名义领袖; [or]z8;
filial: [a]/ˈfɪliəl/; [adj]子女的,孝顺的;<生物>子代的,后代的; [adv]子女地; [or]z8;
fillet: [a]/fɪˈleɪ/; [n]肉片;头带;平边;饰线; [v]用带缚;把.切成片; [or]z8;
finalist: [a]/ˈfaɪnəlɪst/; [n]参加决赛的选手; [or]z8;
finely: [a]/ˈfaɪnli/; [adv]细小地;美好地; [or]z8;
finery: [a]/ˈfaɪnəri/; [n]服饰,华丽的服饰,鲜艳服装,装饰; [or]z8;
finesse: [a]/fɪˈnes/; [n]技巧,计谋,策略; [v]以技巧取胜; [or]z8;
fingertip: [a]/ˈfɪŋɡərtɪp/; [n]指尖;指套; [or]z8;
finicky: [a]/ˈfɪnɪki/; [adj]苛求的,过份讲究的; [or]z8;
fiscal: [a]/ˈfɪskl/; [adj]会计的;财政的;国库的; [or]z8;
fishery: [a]/ˈfɪʃəri/; [n]渔场;养鱼场所; [or]z8;
fissure: [a]/ˈfɪʃər/; [v]裂开,龟裂; [n]裂缝,裂隙; [or]z8;
fitful: [a]/ˈfɪtfl/; [adj]发作的,间歇的,不定的; [or]z8;
fixture: [a]/ˈfɪkstʃər/; [n]固定装置;体育项目; [or]z8;
flabby: [a]/ˈflæbi/; [adj](肌肉)松软的,意志薄弱的; [adv]肌肉松垂地,肥胖地; [n](肌肉等)不结实,松弛; [or]z8;
flaccid: [a]/ˈflæsɪd/; [adj]软弱的,无活力的,没气力的,松弛的; [or]z8;
flag: [a]/flæɡ/; [v](以旗子)标出,标记;疲乏,热情衰减; [n]国旗,旗帜; [or]z8;
flagrant: [a]/ˈfleɪɡrənt/; [adj]罪恶昭彰的,残暴的,丑恶可耻的,明目张胆的; [or]z8;
flair: [a]/fler/; [n]天资,特别的本领;敏锐的洞察力;嗜好;格调; [or]z8;
flak: [a]/flæk/; [n]高射炮,抨击,谴责; [or]z8;
flamboyant: [a]/flæmˈbɔɪənt/; [adj]辉耀的;华丽的,艳丽的;火焰似的; [or]z8;
flank: [a]/flæŋk/; [v]位于.的侧面; [n]肋,肋腹,侧翼; [or]z8;
flare: [a]/fler/; [v]燃烧(摇曳着);突然发怒; [n]照明弹;摇曳的火焰;闪光信号; [or]z8;
flaunt: [a]/flɔːnt/; [n]招摇;飘扬;藐视; [vi]炫耀;飘扬; [vt]炫耀; [or]z8;
flavoring: [a]/ˈfleɪvərɪŋ/; [n]调味品; [or]z8;
flawless: [a]/ˈflɔːləs/; [adj]完美的,无瑕疵的; [or]z8;
flax: [a]/flæks/; [n]亚麻,亚麻纤维; [adj]亚麻科; [or]z8;
fleck: [a]/flek/; [n]斑点,斑纹;雀斑;微粒,小片; [v]使起斑点;使有斑纹; [or]z8;
fleeting: [a]/ˈfliːtɪŋ/; [adj]短暂的,飞逝的; [or]z8;
flex: [a]/fleks/; [v]弯曲;伸缩;屈曲;(使)收缩; [n]花线;弯曲;弹性;电线;松紧带; [adj]弹性工作制的; [or]z8;
flicker: [a]/ˈflɪkər/; [v]闪烁,摇曳;颤动;扑动翅膀;假装昏倒; [n]闪烁,闪光; [or]z8;
flighty: [a]/ˈflaɪti/; [adj]轻浮的;轻狂的;心情浮动的,容易激动的;(马等)易惊的; [or]z8;
flimsy: [a]/ˈflɪmzi/; [adj]轻而薄的,脆弱的,没有价值的,不足信的; [or]z8;
flinch: [a]/flɪntʃ/; [v]畏缩,退缩; [n]退缩,畏惧; [or]z8;
flip: [a]/flɪp/; [v]把.往上抛;掷;抽打;用指轻弹;空翻; [adj]轻率的,无礼的; [or]z8;
flippant: [a]/ˈflɪpənt/; [adj]无礼的,轻率的,随意的; [or]z8;
flirt: [a]/flɜːrt/; [n]急扔;调情者; [vi]卖弄风情,调情;戏弄,不认真地对待;摆动; [vt]急速摆动,挥动; [or]z8;
flit: [a]/flɪt/; [n]轻快的飞行;迁移; [vi]掠过;轻快地飞过;偷偷溜走;去世; [or]z8;
flop: [a]/flɑːp/; [vt]重重地摔落; [vi]惨败;扑通落下; [n]失败; [adv]扑通一声; [or]z8;
floral: [a]/ˈflɔːrəl/; [adj]花的,像花的;植物区系的; [n]以花占主要的图片或设计; [or]z8;
florid: [a]/ˈflɔːrɪd/; [adj]涨红的,华丽的,红润的; [or]z8;
florist: [a]/ˈflɔːrɪst/; [n]花商,种花者,花卉研究者; [or]z8;
flounder: [a]/ˈflaʊndər/; [n]比目鱼;踉跄前进; [v]踉跄前行;(在水或泥浆中)挣扎,陷入困境; [or]z8;
flout: [a]/flaʊt/; [n]表示轻蔑的言行;嘲弄;嘲笑; [vi]藐视;嘲弄;嘲笑; [vt]嘲弄;嘲笑;藐视; [or]z8;
fluke: [a]/fluːk/; [n]侥幸成功;意外的挫折; [v]侥幸做成;意外受挫; [or]z8;
flunk: [a]/flʌŋk/; [v]考试不及格; [n]失败,不及格; [or]z8;
flurry: [a]/ˈflɜːri/; [n]阵雪,慌张; [v]慌张,激动; [or]z8;
flux: [a]/flʌks/; [n]流动,不断的变动; [or]z8;
foible: [a]/ˈfɔɪbl/; [n]弱点,小缺点,癖好; [or]z8;
foil: [a]/fɔɪl/; [n]箔;锡箔纸;衬托; [v]挫败;使受挫折; [or]z8;
fold: [a]/foʊld/; [v]折叠;彻底失败;合拢; [n]折叠;褶; [or]z8;
folklore: [a]/ˈfoʊklɔːr/; [n]民俗学,民间传说;民间看法;民俗; [or]z8;
fondle: [a]/ˈfɑːndl/; [v]抚弄,抚摸; [or]z8;
foolproof: [a]/ˈfuːlpruːf/; [adj]万无一失的,简单的,肯定成功的; [or]z8;
foothold: [a]/ˈfʊthoʊld/; [n]立足点,根据地; [or]z8;
footloose: [a]/ˈfʊtluːs/; [adj]自由自在的,无拘束的,到处走动的; [or]z8;
forage: [a]/ˈfɔːrɪdʒ/; [v]搜寻,翻寻,觅食; [n](牛马的)饲料,粮草; [or]z8;
foray: [a]/ˈfɔːreɪ/; [n]突袭;首次尝试;短途旅行; [v]袭击; [or]z8;
forbidding: [a]/fərˈbɪdɪŋ/; [adj]可怕的,令人生畏的;(表情)冷峻的;形势险恶的; [or]z8;
forceps: [a]/ˈfɔːrseps/; [n]钳子,镊子,手术钳; [or]z8;
forebode: [a]/foʊr'boʊd/; [v]预示,预兆,预言; [or]z8;
foreboding: [a]/fɔːrˈboʊdɪŋ/; [n]预感,预兆; [adj]预感的,不祥之兆的; [or]z8;
foreground: [a]/ˈfɔːrɡraʊnd/; [n]前景,最显著的位置; [v]强调; [or]z8;
forensic: [a]/fəˈrensɪk/; [adj]科学手段的,法庭的,辩论的; [n]辩论练习;辩论学,辩论术; [or]z8;
forerunner: [a]/ˈfɔːrʌnər/; [n]先驱;祖先;前兆;预兆; [or]z8;
foreshadow: [a]/fɔːrˈʃædoʊ/; [v]预示; [n]预兆; [or]z8;
forestall: [a]/fɔːrˈstɔːl/; [v]领先;占先一步;先发制人,阻止,妨碍;垄断;占先一步; [or]z8;
forge: [a]/fɔːrdʒ/; [n]熔炉;锻工车间;铁匠店; [v]锻造;经锻炼而形成;伪造;推进,加强; [or]z8;
forgo: [a]/fɔːrˈɡoʊ/; [v]放弃;停止;对.断念; [or]z8;
forlorn: [a]/fərˈlɔːrn/; [adj]被遗弃的; [or]z8;
formative: [a]/ˈfɔːrmətɪv/; [adj]形成的;造形的;影响发展的;造型的;格式化的; [n]构词要素; [or]z8;
formulate: [a]/ˈfɔːrmjuleɪt/; [v]构想出(计划,方法等);系统地阐述; [or]z8;
formulation: [a]/ˌfɔːrmjuˈleɪʃn/; [n]表述方式;构想,规划;公式化; [or]z8;
fornicate: [a]/ˈfɔːrnɪkeɪt/; [v]与..通奸,私通; [or]z8;
forsake: [a]/fərˈseɪk/; [v]放弃;抛弃,离开; [or]z8;
forte: [a]/fɔːrt/; [n]长处,特长; [adj]强音的;响的; [adv]响亮地; [or]z8;
forthright: [a]/ˈfɔːrθraɪt/; [adj]直接的,直率的,坦白的,豪爽的; [adv]马上,立即; [n]直路; [or]z8;
fortify: [a]/ˈfɔːrtɪfaɪ/; [v]设防于;增强; [or]z8;
fortuitous: [a]/fɔːrˈtuːɪtəs/; [adj]偶然的;幸运的; [or]z8;
forum: [a]/ˈfɔːrəm/; [n]论坛;讨论会; [or]z8;
foul: [a]/faʊl/; [adj]难闻的,发臭的;糟透了的;污秽的;犯规的; [n]犯规; [vi]犯规; [vt]弄脏,使污秽;使纠缠; [or]z8;
fractious: [a]/ˈfrækʃəs/; [adj]易怒的;难以对待的;倔强的;好争吵的; [or]z8;
fracture: [a]/ˈfræktʃər/; [n]骨折;折断;裂口; [v]使折断;使骨折; [or]z8;
franchise: [a]/ˈfræntʃaɪz/; [n]特许(经营权),公民权,选举权; [v]赋予特权,赋予公民权; [or]z8;
frantic: [a]/ˈfræntɪk/; [adj]疯狂的;狂乱的;慌乱的; [or]z8;
fraternal: [a]/frəˈtɜːrnl/; [adj]兄弟的,兄弟般的,友爱的; [or]z8;
fraudulent: [a]/ˈfrɔːdʒələnt/; [adj]欺诈的,欺骗性的,骗得的; [or]z8;
fraught: [a]/frɔːt/; [adj]担心的,忧虑的;充满.的; [n]货物,装载物; [vt]装货于; [or]z8;
fray: [a]/freɪ/; [n]吵架,打斗,磨损处; [v]磨损,摩擦,使关系紧张; [or]z8;
freak: [a]/friːk/; [n]怪人,怪物,奇事; [adj]反常的,怪诞的; [vt]使强烈反应(震惊;畏惧); [vi]在药物影响下变得异乎寻常; [or]z8;
freckle: [a]/ˈfrekl/; [n]雀斑;斑点; [or]z8;
freelance: [a]/ˈfriːlæns/; [adv]作为自由职业者地; [adj]自由投稿的; [vi]当自由职业者; [or]z8;
freighter: [a]/ˈfreɪtər/; [n]<水运><船>货船;承运人; [or]z8;
frenetic: [a]/frəˈnetɪk/; [adj]狂乱的;非常激动的; [n]疯子;狂人; [or]z8;
frenzy: [a]/ˈfrenzi/; [n]狂暴;狂怒,暴怒;疯狂,迷乱; [v]使发狂,使狂怒; [or]z8;
fresco: [a]/ˈfreskoʊ/; [n]壁画;壁画法; [v]在..上做壁画;用壁画法画出; [or]z8;
fret: [a]/fret/; [v]使烦恼,使焦急;使腐蚀;使磨损; [n](斑卓琴,吉他,曼陀林琴等弦乐器指板上定音的)档;侵蚀; [or]z8;
frigid: [a]/ˈfrɪdʒɪd/; [adj]寒冷的,冷淡的,死板的,呆板的,性冷淡的; [or]z8;
frisk: [a]/frɪsk/; [v]搜身;蹦跳,欢跃; [n]欢跃,蹦跳,快活的时刻; [or]z8;
frivolity: [a]/frɪˈvɑːləti/; [n]轻浮;轻佻;轻薄的话(或举动); [or]z8;
frivolous: [a]/ˈfrɪvələs/; [adj]轻佻的,不重要的,缺乏基础的; [or]z8;
frock: [a]/frɑːk/; [n]僧袍;(妇女,小儿的连衣裙式)长衣; [or]z8;
frolic: [a]/ˈfrɑːlɪk/; [n]嬉闹; [v]嬉戏,雀跃; [adj]嬉戏的,欢乐的; [or]z8;
frontal: [a]/ˈfrʌntl/; [adj]额的,正面的,前面的; [n]额骨,额部,房屋的正面; [or]z8;
froth: [a]/frɔːθ/; [n]泡沫,泡;口沫; [v]吐白沫;起泡沫; [or]z8;
fruition: [a]/fruˈɪʃn/; [n]享有;最后完成,实现,取得成果; [or]z8;
fry: [a]/fraɪ/; [v]油煎;油炸; [n]鱼苗,鱼秧;弗赖伊(姓氏);油炸食物;(口语)烦恼,愤激; [adj]油炸的,油煎的(fried); [or]z8;
fugitive: [a]/ˈfjuːdʒətɪv/; [adj]逃亡的,易逝的; [n]逃犯,逃亡者; [or]z8;
fumble: [a]/ˈfʌmbl/; [v]摸索,笨拙地做,漏球; [n]摸索,笨拙的处理,漏球; [adj]笨拙的;迟疑的; [or]z8;
funk: [a]/fʌŋk/; [n]恐慌,怯懦,早期爵士乐; [vt](因恐惧)避开(某事物);害怕;使闻到刺鼻的味道; [vi]畏缩;发出刺鼻臭味; [or]z8;
furrow: [a]/ˈfɜːroʊ/; [n]犁沟,皱纹; [v]犁田,开沟,犁出浪迹; [or]z8;
furtive: [a]/ˈfɜːrtɪv/; [adj]偷偷的,秘密的,鬼鬼祟祟的,; [or]z8;
fuse: [a]/fjuːz/; [n]导火线,引信,保险丝; [v](使)因保险丝熔断而中断工作,熔合,合并; [or]z8;
fuzz: [a]/fʌz/; [n]绒毛,模糊,细毛,警员; [vi]作绒毛状飞散,变成绒毛状,变得模糊; [vt]使模糊,起毛; [or]z8;
gabble: [a]/ˈɡæbl/; [n]急促不清的话,胡言乱语; [vi]急促而不清楚地说,闲聊,啰嗦,喋喋不休地说; [vt]急促而不清楚地说,胡说八道; [or]z8;
gag: [a]/ɡæɡ/; [n]塞口物,随口科白,打诨,箝口物,言论,讨论终结; [v]塞物于..的口中,禁止,使窒息,使呕吐,欺骗,作呕; [or]z8;
gaiety: [a]/ˈɡeɪəti/; [n]欢乐,快活,庆祝活动,(服饰)华丽,艳丽; [or]z8;
gallant: [a]/ˈɡælənt/; [adj]勇敢的;(男子对女子)殷勤的; [v]向(女子)献殷勤;护卫;求爱; [n](尤指对女子殷勤的)时髦男子; [or]z8;
galvanize: [a]/ˈɡælvənaɪz/; [v]镀锌,通电,刺激; [or]z8;
gambit: [a]/ˈɡæmbɪt/; [n](常指带风险的)策略,弃兵局(指国际象棋开局弃一卒以取得优势),话题,开始,开场白; [or]z8;
gape: [a]/ɡeɪp/; [n]裂口,张嘴,打哈欠; [v]目瞪口呆地凝视,打哈欠,张开,裂开; [or]z8;
garland: [a]/ˈɡɑːrlənd/; [n]花环; [vt]戴花环; [or]z8;
gastric: [a]/ˈɡæstrɪk/; [adj]胃的,胃部的; [or]z8;
gastritis: [a]/ɡæˈstraɪtɪs/; [n]<医>胃炎; [or]z8;
gauge: [a]/ɡeɪdʒ/; [n]测量仪;尺度,标准; [v]估计,判断;计量; [or]z8;
gaunt: [a]/ɡɔːnt/; [adj]憔悴的,瘦削的; [n]憔悴,荒凉; [or]z8;
gazette: [a]/ɡəˈzet/; [n]报纸; [v]在报上刊载; [or]z8;
generate: [a]/ˈdʒenəreɪt/; [v]产生(热,电等能量),创造; [or]z8;
generic: [a]/dʒəˈnerɪk/; [n]无注册商标产品;通名; [adj]一般的;非商标的;属的,类的; [or]z8;
genesis: [a]/ˈdʒenəsɪs/; [n](事物的)起源,发生; [or]z8;
genial: [a]/ˈdʒiːniəl/; [adj]愉快的,脾气好的,友好的; [or]z8;
genteel: [a]/dʒenˈtiːl/; [adj]有教养的,文雅的;高雅的;假斯文的,装作体面的; [or]z8;
gentility: [a]/dʒenˈtɪləti/; [n]上流阶层;文雅;有教养; [or]z8;
germinate: [a]/ˈdʒɜːrmɪneɪt/; [v]发芽,发展,生长; [or]z8;
gesticulate: [a]/dʒeˈstɪkjuleɪt/; [vt]用手势表达,用姿势,表示; [vi](讲话时)做手势; [n]做手势,做示意动作,手势; [or]z8;
ghastly: [a]/ˈɡæstli/; [adj]苍白的,可怕的,令人不快的; [adv]恐怖地,惨白地; [or]z8;
gibberish: [a]/ˈdʒɪbərɪʃ/; [n]乱语;快速而不清楚的言语; [or]z8;
gibbon: [a]/ˈɡɪbən/; [n]长臂猿; [or]z8;
giddy: [a]/ˈɡɪdi/; [adj]眼花缭乱的,头晕的,轻率的; [v](使)眼花,(使)眩晕; [or]z8;
gill: [a]/ɡɪl/; [n]鳃,菌褶; [vi]被刺网缠住; [vt]用刺网捕,取出(鱼的)鳃和内脏; [or]z8;
gimmick: [a]/ˈɡɪmɪk/; [n]吸引人的花招,噱头; [vt]用暗机关改变或影响; [or]z8;
girder: [a]/ˈɡɜːrdər/; [n]<建>大梁;纵梁;撑住; [or]z8;
girdle: [a]/ˈɡɜːrdl/; [n]腰带;妇女紧身褡; [v]围,包围,环绕; [or]z8;
glacial: [a]/ˈɡleɪʃl/; [adj]冰的;冰冷的;冰河时代的; [or]z8;
gladiator: [a]/ˈɡlædieɪtər/; [n]职业格斗者;角斗士,斗剑者; [or]z8;
glaze: [a]/ɡleɪz/; [n](浇在糕点上的)糖浆,蛋浆,釉;<气>雨淞; [v](眼睛)变呆滞;浇浆汁于 (食物) 表面;给.安装玻璃; [or]z8;
glean: [a]/ɡliːn/; [v]收集(资料); [or]z8;
glee: [a]/ɡliː/; [n]欢喜,高兴; [or]z8;
gloat: [a]/ɡloʊt/; [v]幸灾乐祸地看,窃喜; [or]z8;
gloss: [a]/ɡlɑːs/; [n]光泽;假象;唇膏; [vt]使有光彩;掩盖; [or]z8;
glossary: [a]/ˈɡlɑːsəri/; [n]词汇表,术语汇编; [or]z8;
glum: [a]/ɡlʌm/; [adj]闷闷不乐的,阴郁的; [n]闷闷不乐;忧郁; [or]z8;
glutton: [a]/ˈɡlʌtn/; [n]贪吃者,对..贪婪的人; [or]z8;
gnarled: [a]/nɑːrld/; [adj]多节的,粗糙的;多瘤的;弯曲的; [or]z8;
gobble: [a]/ˈɡɑːbl/; [v]狼吞虎咽;急急抓住,任意花完;如饥似渴地阅读;发出雄火鸡般的咯咯叫声; [n](火鸡的)咯咯声; [or]z8;
goggle: [a]/ˈɡɑːɡl/; [n]眼睛睁视,风镜,护目镜; [adj]睁眼的,瞪眼的; [v]眼珠转动,瞪眼看,使瞪眼; [or]z8;
goody: [a]/ˈɡʊdi/; [n]好吃的东西;吸引人的东西,好东西; [int]太好啦; [or]z8;
gorge: [a]/ɡɔːrdʒ/; [n]峡谷;胃;暴食;咽喉;障碍物; [v]拼命吃;吞下,狼吞虎咽;塞满,填满; [or]z8;
gospel: [a]/ˈɡɑːspl/; [n]教义,信条;福音书; [adj]传播福音的;福音赞美诗的; [or]z8;
graffiti: [a]/ɡrəˈfiːti/; [n]乱涂乱写; [v]在.上涂鸦; [or]z8;
graft: [a]/ɡræft/; [n]嫁接;嫁接株;移植; [vi]接枝; [vt]将.嫁接;移植(器官); [or]z8;
grandeur: [a]/ˈɡrændʒər/; [n]壮观,宏伟,庄严; [or]z8;
grandiose: [a]/ˈɡrændioʊs/; [adj]浮夸的,夸大的,宏伟的; [or]z8;
granular: [a]/ˈɡrænjələr/; [adj]粒状的,含颗粒的; [or]z8;
granule: [a]/ˈɡrænjuːl/; [n]颗粒,微粒,粒状斑点; [or]z8;
grapple: [a]/ˈɡræpl/; [v]抓住;格斗; [n]抓住;格斗; [or]z8;
grate: [a]/ɡreɪt/; [n]壁炉;格栅; [v]磨碎,使人烦燥; [or]z8;
gratify: [a]/ˈɡrætɪfaɪ/; [v]使高兴,使满足; [or]z8;
gratuitous: [a]/ɡrəˈtuːɪtəs/; [adj]无根据的,无理由的,无报酬的,免费的,多余的; [or]z8;
gravel: [a]/ˈɡrævl/; [n]沙砾,小石,砾石; [adj]粗重而沙哑的,刺耳的; [vt]用砾石铺;使困惑; [or]z8;
gravitate: [a]/ˈɡrævɪteɪt/; [v]受引力作用;被吸引; [or]z8;
gregarious: [a]/ɡrɪˈɡeriəs/; [adj]群居的,爱社交的; [or]z8;
grid: [a]/ɡrɪd/; [n]格子,地图坐标; [or]z8;
grievance: [a]/ˈɡriːvəns/; [n]牢骚,委屈,抱怨; [or]z8;
grievous: [a]/ˈɡriːvəs/; [adj]悲痛的,痛苦的,可叹的,痛心的,剧烈的,严重的,难忍的; [or]z8;
gripe: [a]/ɡraɪp/; [n]控制,发牢骚,肠绞痛; [v]抱怨,发牢骚; [or]z8;
grisly: [a]/ˈɡrɪzli/; [adj]恐怖的;令人震惊的;厉害的; [or]z8;
grotesque: [a]/ɡroʊˈtesk/; [adj]奇形怪状的,奇异的; [n]奇形怪状的人(或物,图案等);奇异风格; [or]z8;
grove: [a]/ɡroʊv/; [n]小树林;果园; [or]z8;
grovel: [a]/ˈɡrɑːvl/; [v]摇尾乞怜;奴颜婢膝;匍匐; [or]z8;
gruesome: [a]/ˈɡruːsəm/; [adj]阴森的;可怕的; [or]z8;
gruff: [a]/ɡrʌf/; [adj]粗暴的,粗哑的,脾气坏的; [vt]粗鲁地说,生硬地说; [vi]粗鲁地说,生硬地说话; [or]z8;
grumpy: [a]/ˈɡrʌmpi/; [adj]脾气暴躁的,性情乖戾的; [n]脾气坏的人,爱抱怨的人; [or]z8;
guise: [a]/ɡaɪz/; [n]外观,姿态,装束,伪装; [v]伪装; [or]z8;
gush: [a]/ɡʌʃ/; [v]涌出;滔滔不绝地说,洋洋洒洒地写; [n]迸发; [or]z8;
gusto: [a]/ˈɡʌstoʊ/; [n]由衷的高兴;爱好,嗜好; [or]z8;
hack: [a]/hæk/; [n]砍,劈;出租马车;出租车; [vt]砍,乱劈;胡乱删改;<计算机>(熟练地编辑或修改)程序;非法侵入(他人计算机系统); [adj]出租的;用旧了的;(文人等)被雇佣的;雇佣文人做的; [or]z8;
hackneyed: [a]/ˈhæknid/; [adj]陈腐的,平常的; [or]z8;
haggard: [a]/ˈhæɡərd/; [adj]憔悴的,消瘦的; [n]哈格德;未驯服的鹰;悍鹰; [or]z8;
haggle: [a]/ˈhæɡl/; [n]讨价还价; [v]争论,讨价还价; [or]z8;
hairdo: [a]/ˈherduː/; [n]发型; [or]z8;
hale: [a]/heɪl/; [adj]矍铄的(尤指老人);强壮的; [adv]完全地; [v]迫使;猛拉;不断流出; [or]z8;
hallmark: [a]/ˈhɔːlmɑːrk/; [n]特点;品质证明; [v]给.盖上品质证明印记;使具有.标志; [or]z8;
hallowed: [a]/ˈhæloʊd/; [adj]神圣的; [or]z8;
hallucination: [a]/həˌluːsɪˈneɪʃn/; [n]幻觉,幻想; [or]z8;
halo: [a]/ˈheɪloʊ/; [n](日月等)晕;神像之光环; [vt]使有晕轮;围以光环; [vi]成晕轮; [or]z8;
hamlet: [a]/ˈhæmlət/; [n]小村庄;哈姆雷特; [or]z8;
hamper: [a]/ˈhæmpər/; [v]阻碍,妨碍,牵制; [n](有盖的)大篮子; [or]z8;
hamstring: [a]/ˈhæmstrɪŋ/; [n]腿筋; [v]切断腿筋使成跛腿;使无效; [or]z8;
handicraft: [a]/ˈhændikræft/; [n]手工艺;手工制品; [or]z8;
handily: [a]/ˈhændɪli/; [adv]方便地,敏捷地,灵巧地; [or]z8;
handiwork: [a]/ˈhændiwɜːrk/; [n]手工艺,手工制品,行为后果; [or]z8;
handsomely: [a]/ˈhænsəmli/; [adv]漂亮地,慷慨地,相当大地; [or]z8;
handstand: [a]/ˈhændstænd/; [n]手倒立; [or]z8;
hangar: [a]/ˈhæŋər/; [n]飞机库; [or]z8;
hanger: [a]/ˈhæŋər/; [n]衣架,挂衣钩; [or]z8;
hangnail: [a]/ˈhæŋneɪl/; [n]手指头的倒拉刺(指甲旁的逆刺皮); [or]z8;
hangover: [a]/ˈhæŋoʊvər/; [n]宿醉; [or]z8;
hanker: [a]/ˈhæŋkər/; [vi]渴望,追求; [or]z8;
haphazard: [a]/hæpˈhæzərd/; [adj]偶然的;随意的;凑合的;胡乱的; [or]z8;
harangue: [a]/həˈræŋ/; [n]长篇大论; [v]高谈阔论;大声训斥; [or]z8;
harass: [a]/həˈræs/; [v]使困扰,使烦恼,反复袭击; [or]z8;
harbinger: [a]/ˈhɑːrbɪndʒər/; [n]先驱,先兆; [vt]预告;充做.的前驱; [or]z8;
hardheaded: [a]/'hɑːd'hedɪd/; [adj]现实的,精明的,顽固的; [or]z8;
harmonica: [a]/hɑːrˈmɑːnɪkə/; [n]口琴; [or]z8;
harmonize: [a]/ˈhɑːrmənaɪz/; [v]使调和,使一致; [or]z8;
harness: [a]/ˈhɑːrnɪs/; [n]挽具,马具,降落伞背带; [v]上挽具;治理(河流等);利用; [or]z8;
harp: [a]/hɑːrp/; [n]竖琴; [v]不停地说,喋喋不休; [or]z8;
harpoon: [a]/hɑːrˈpuːn/; [n](捕鲸的)鱼叉; [vt]用鱼叉叉;用鱼叉捕获; [or]z8;
harrow: [a]/ˈhæroʊ/; [n]耙; [v]耙地,使苦恼,被耙松; [or]z8;
harrowing: [a]/ˈhæroʊɪŋ/; [adj]悲痛的,难受的; [or]z8;
hassle: [a]/ˈhæsl/; [vt]找麻烦,搅扰;与.争辩;使.烦恼; [n]困难,麻烦;激战; [vi]争论,争辩; [or]z8;
hatchback: [a]/ˈhætʃbæk/; [n]［美］有可向上开启天窗的汽车背部; [or]z8;
hatchery: [a]/ˈhætʃəri/; [n]孵卵处,孵化场; [or]z8;
hatchet: [a]/ˈhætʃɪt/; [n]短柄小斧; [vt]扼杀; [adj]瘦削而棱角分明的; [or]z8;
haven: [a]/ˈheɪvn/; [n]港湾;避难所; [vt]为.提供庇护所; [or]z8;
haversack: [a]/ˈhævərsæk/; [n]干粮袋,背袋; [or]z8;
havoc: [a]/ˈhævək/; [n](天灾,战争等造成的)大破坏,大毁灭; [vi]损毁; [vt]严重破坏; [or]z8;
haze: [a]/heɪz/; [n]阴霾;薄雾;疑惑,迷糊; [v](使)变朦胧;(使)变糊涂; [or]z8;
hazel: [a]/ˈheɪzl/; [n]淡褐色;榛子; [adj]淡褐色的;榛树的; [or]z8;
headdress: [a]/ˈheddres/; [n]头巾,头饰; [or]z8;
headstrong: [a]/ˈhedstrɔːŋ/; [adj]任性的;顽固的; [or]z8;
heady: [a]/ˈhedi/; [adj]兴奋的,任性的,性急的,顽固的,使人头晕的; [or]z8;
hearsay: [a]/ˈhɪrseɪ/; [n]传闻,谣言; [adj]传闻的,风闻的; [or]z8;
hearten: [a]/ˈhɑːrtn/; [v]激励,鼓励,(使)振作; [or]z8;
heathen: [a]/ˈhiːðn/; [n]无宗教信仰者,异教徒; [adj]不信神的,未开化的,异教徒的,异国的; [or]z8;
heckle: [a]/ˈhekl/; [v]诘问,困扰; [n]麻梳;梳理;<印>针排; [or]z8;
hectic: [a]/ˈhektɪk/; [adj]紧张的,忙碌的;患肺病的;(因患肺病等)发烧的,有病态潮红的;脸上发红,发热的,兴奋的,狂热的,肺病的; [or]z8;
hector: [a]/ˈhektər/; [v]凌辱,威吓; [n]暴徒,威吓者,作威作福的人; [or]z8;
hedonism: [a]/ˈhiːdənɪzəm/; [n]享乐主义; [or]z8;
hedonist: [a]/ˈhiːdənɪst/; [n]享乐主义者,［心］欢乐主义者; [adj]享乐主义者的; [or]z8;
heed: [a]/hiːd/; [vt]注意;留心; [v]注意; [vi]留心; [n]注意;留心; [or]z8;
hefty: [a]/ˈhefti/; [adj]重的,肌肉发达的,异常大的; [adv]强有力地,非常; [n]体格健壮的人; [or]z8;
hegemony: [a]/hɪˈdʒemoʊni/; [n]霸权,领导权; [or]z8;
heinous: [a]/ˈheɪnəs/; [adj]可憎的;极凶恶的; [or]z8;
heirloom: [a]/ˈerluːm/; [n]传家宝,祖传遗物; [adj](植物)原种的(通常指过去大量种植,但已不再作为经济作物而种植的植物); [or]z8;
helium: [a]/ˈhiːliəm/; [n]<化学>氦(元素符号He); [or]z8;
helm: [a]/helm/; [n]舵;驾驶盘;领导地位; [v]指挥;给..掌舵; [or]z8;
hemlock: [a]/ˈhemlɑːk/; [n]铁杉,常青树; [or]z8;
henpecked: [a]/ˈhenpekt/; [adj]妻管严,怕老婆的; [or]z8;
hepatitis: [a]/ˌhepəˈtaɪtɪs/; [n]肝炎; [or]z8;
herbivorous: [a]/ɜːrˈbɪvərəs/; [adj]食草的; [or]z8;
hereafter: [a]/ˌhɪrˈæftər/; [adv]今后,从此以后; [n]将来,来世; [or]z8;
hereditary: [a]/həˈredɪteri/; [adj]世袭的,遗传的; [or]z8;
heredity: [a]/həˈredəti/; [n]遗传;遗传特征; [or]z8;
heresy: [a]/ˈherəsi/; [n]异端邪说;异教; [or]z8;
heretic: [a]/ˈherətɪk/; [n]异教徒,持异端者; [adj]异端的,异教的; [or]z8;
heretical: [a]/həˈretɪkl/; [adj]异端的,异教的; [or]z8;
hermetic: [a]/hɜːrˈmetɪk/; [adj]密封的;与外界隔绝的;不透气的;炼金术的; [or]z8;
hermitage: [a]/ˈhɜːrmɪtɪdʒ/; [n]隐士生活;隐士住处; [or]z8;
heterogeneous: [a]/ˌhetərəˈdʒiːniəs/; [adj]多相的,异种的,不均匀的,由不同成分形成的; [or]z8;
hew: [a]/hjuː/; [v]砍伐;劈;遵守,坚持; [or]z8;
heyday: [a]/ˈheɪdeɪ/; [n]全盛期; [int]嘿(表喜悦或惊奇等); [or]z8;
hiatus: [a]/haɪˈeɪtəs/; [n]空隙,裂缝,中断; [or]z8;
hibernate: [a]/ˈhaɪbərneɪt/; [vi]冬眠,蛰居; [or]z8;
hiccup: [a]/ˈhɪkʌp/; [n]打嗝,小问题; [v]打嗝; [or]z8;
hidebound: [a]/ˈhaɪdbaʊnd/; [adj]死板的,顽固的,墨守成规的; [or]z8;
hierarchical: [a]/ˌhaɪəˈrɑːrkɪkl/; [adj]分等级的; [or]z8;
hierarchy: [a]/ˈhaɪərɑːrki/; [n]阶层,等级制度; [or]z8;
highness: [a]/ˈhaɪnəs/; [n]殿下,阁下,高度,高位,高尚,高贵; [or]z8;
hike: [a]/haɪk/; [n]远足,徒步旅行;(数量,价格等)增加,上升; [v]作长途徒步旅行;使高涨,提高(价格); [or]z8;
hilarious: [a]/hɪˈleriəs/; [adj]有趣的;令人捧腹的;滑稽的;欢闹的; [or]z8;
hillock: [a]/ˈhɪlək/; [n]小丘,小山似的一堆; [or]z8;
hilt: [a]/hɪlt/; [n]刀把,柄; [vt]给.装柄; [or]z8;
hiss: [a]/hɪs/; [n]嘶嘶声;发嘘声; [vi]发出嘶嘶声; [vt]嘶嘶地发出;发嘘声让(某人)别做声; [or]z8;
histrionic: [a]/ˌhɪstriˈɑːnɪk/; [adj]戏剧的,装腔作势的,作戏的; [n]演员;戏剧表演;舞台艺术;戏剧似的言行; [or]z8;
hive: [a]/haɪv/; [n]蜂房,忙碌之地; [v]分开,隔开; [or]z8;
hoard: [a]/hɔːrd/; [v]贮藏,秘藏; [n]贮藏物; [or]z8;
hoary: [a]/ˈhɔːri/; [adj]年纪高迈的;(头发等)灰白的;古老的; [or]z8;
hoax: [a]/hoʊks/; [n]骗局;恶作剧; [vt]愚弄;欺骗; [or]z8;
hobble: [a]/ˈhɑːbl/; [v]蹒跚,跛行; [n]跛行;韵律不全的诗;马的脚绊;〈口,方〉困境; [or]z8;
hobgoblin: [a]/ˈhɑːbɡɑːblɪn/; [n]妖怪; [or]z8;
holiness: [a]/ˈhoʊlinəs/; [n]神圣,圣座(大写,对教宗等的尊称); [or]z8;
holly: [a]/ˈhɑːli/; [n]冬青树(等于holm oak); [adj]冬青属植物的; [or]z8;
holocaust: [a]/ˈhɑːləkɔːst/; [n]大屠杀,浩劫; [or]z8;
holster: [a]/ˈhoʊlstər/; [n]手枪皮套; [or]z8;
homage: [a]/ˈhɑːmɪdʒ/; [n]敬意;尊敬;效忠; [or]z8;
homestead: [a]/ˈhoʊmsted/; [n]家园; [or]z8;
homicide: [a]/ˈhɑːmɪsaɪd/; [n]杀人,杀人者; [or]z8;
homogeneous: [a]/ˌhoʊməˈdʒiːniəs/; [adj]同类的,同质的,有相同特征的; [or]z8;
homogenize: [a]/həˈmɑdʒəˌnaɪz/; [vi]变均匀; [vt]使均匀,使类同; [or]z8;
homosexual: [a]/ˌhoʊməˈsekʃuəl/; [adj]同性恋的; [n]同性恋; [or]z8;
honeycomb: [a]/ˈhʌnikoʊm/; [n]蜜蜂巢; [vt]使成蜂巢状;把.弄得千疮百孔; [adj]似蜂巢的; [vi]变成蜂巢状; [or]z8;
honk: [a]/hɑːŋk/; [n]雁叫声,汽车喇叭声; [vi]发雁鸣或汽车喇叭声; [vt]按汽车喇叭; [or]z8;
hoodwink: [a]/ˈhʊdwɪŋk/; [v]欺骗,遮眼,蒙蔽; [or]z8;
hooligan: [a]/ˈhuːlɪɡən/; [n]流氓,歹徒; [or]z8;
hooray: [a]/huˈreɪ/; [int]万岁; [or]z8;
horde: [a]/hɔːrd/; [n]一大群,群,游牧部落; [v]成群;结成部落而居; [or]z8;
hormone: [a]/ˈhɔːrmoʊn/; [n]荷尔蒙,激素; [or]z8;
hornet: [a]/ˈhɔːrnɪt/; [n]大黄蜂; [or]z8;
horoscope: [a]/ˈhɔːrəskoʊp/; [n]占星术,星象,十二宫图; [or]z8;
horrendous: [a]/həˈrendəs/; [adj]可怕的,令人惊惧的; [or]z8;
horrid: [a]/ˈhɔːrɪd/; [adj]可怕的,恐怖的,极讨厌的; [or]z8;
horrific: [a]/həˈrɪfɪk/; [adj]可怖的,令人恐惧的,极其可怕的; [or]z8;
horseshoe: [a]/ˈhɔːrʃʃuː/; [n]马蹄铁,U形物; [vt]装蹄铁于; [or]z8;
horsewhip: [a]/ˈhɔːrswɪp/; [n]马鞭; [vt]用马鞭鞭打,惩罚; [or]z8;
horticulture: [a]/ˈhɔːrtɪkʌltʃər/; [n]园艺;园艺学; [or]z8;
hospice: [a]/ˈhɑːspɪs/; [n]收容所,旅客招待所,救济院; [or]z8;
hotbed: [a]/ˈhɑːtbed/; [n]温床,滋长地; [or]z8;
hovel: [a]/ˈhʌvl/; [n]茅舍,肮脏的小屋; [or]z8;
howler: [a]/ˈhaʊlər/; [n]嚎叫的人或动物,滑稽可笑的错误; [or]z8;
hub: [a]/hʌb/; [n]轴心,中心;木片; [or]z8;
hubbub: [a]/ˈhʌbʌb/; [n]嘈杂,喧哗; [or]z8;
huckster: [a]/ˈhʌkstər/; [v]叫卖,讨价还价; [n]叫卖的小贩,小商人,零售商; [or]z8;
hue: [a]/hjuː/; [n]色彩;色度,颜色;叫声; [or]z8;
hulk: [a]/hʌlk/; [n]废船;笨重的人或物; [vi]赫然显现;<英口>笨拙地挪动; [or]z8;
hulking: [a]/ˈhʌlkɪŋ/; [adj]笨重的; [or]z8;
hull: [a]/hʌl/; [n](果实等的)外壳,船体; [v]剥壳; [or]z8;
humdrum: [a]/ˈhʌmdrʌm/; [adj]单调的;乏味的; [n]平凡;单调; [vi]单调乏味地进行; [or]z8;
humility: [a]/hjuːˈmɪləti/; [n]谦逊,谦恭; [or]z8;
hump: [a]/hʌmp/; [n]驼峰;小园丘,峰丘; [v](使)隆起,弓起; [or]z8;
humus: [a]/ˈhjuːməs/; [n]腐殖质,腐植土; [or]z8;
hunch: [a]/hʌntʃ/; [n]预感,大块,肉峰; [vt]耸肩,预感到,弯腰驼背; [vi]隆起,向前移动; [or]z8;
hunk: [a]/hʌŋk/; [n]大块,有魅力的健壮男子; [or]z8;
hurdle: [a]/ˈhɜːrdl/; [n]跳栏,障碍; [v]用篱笆围; [or]z8;
hurtle: [a]/ˈhɜːrtl/; [v]猛冲,猛烈碰撞,使冲向; [n]碰撞;碰撞声;猛冲; [or]z8;
husbandry: [a]/ˈhʌzbəndri/; [n]饲养;务农,耕种;家政; [or]z8;
husk: [a]/hʌsk/; [n]外壳,皮;无价值之物; [v]削皮;以粗哑的嗓音说; [or]z8;
hutch: [a]/hʌtʃ/; [n]笼,小屋,贮藏箱,矿车; [vt]把.装箱; [or]z8;
hybrid: [a]/ˈhaɪbrɪd/; [n]杂种,混血儿,混合物; [adj]混合的;杂种的; [or]z8;
hydrant: [a]/ˈhaɪdrənt/; [n]消防栓,消防龙头; [or]z8;
hydraulic: [a]/haɪˈdrɔːlɪk/; [adj]水力的,水压的; [or]z8;
hydrocarbon: [a]/ˌhaɪdrəˈkɑːrbən/; [n]碳氢化合物,烃; [or]z8;
hype: [a]/haɪp/; [n]大肆宣传; [v]大肆宣传;使.兴奋; [or]z8;
hypertension: [a]/ˌhaɪpərˈtenʃn/; [n]［医］高血压,过度紧张; [or]z8;
hyphen: [a]/ˈhaɪfn/; [n]连词号,连字符; [vt]以连字号连接; [or]z8;
hypnosis: [a]/hɪpˈnoʊsɪs/; [n]催眠,催眠状态; [or]z8;
hypnotic: [a]/hɪpˈnɑːtɪk/; [n]安眠药; [adj]催眠的,令人着迷的; [or]z8;
hypocrisy: [a]/hɪˈpɑːkrəsi/; [n]虚伪;伪善; [or]z8;
hypodermic: [a]/ˌhaɪpəˈdɜːrmɪk/; [adj]皮下注射的; [n]皮下注射器; [or]z8;
hypotenuse: [a]/haɪˈpɑːtənuːs/; [n](直角三角形的)斜边; [or]z8;
hypothesis: [a]/haɪˈpɑːθəsɪs/; [n]假说;假设; [or]z8;
icicle: [a]/ˈaɪsɪkl/; [n]冰柱,冰垂; [or]z8;
icing: [a]/ˈaɪsɪŋ/; [n]结冰,糖衣,酥皮; [v]冰冻; [or]z8;
icon: [a]/ˈaɪkɑːn/; [n]图标,肖像,偶像; [or]z8;
idiosyncrasy: [a]/ˌɪdiəˈsɪŋkrəsi/; [n]特殊癖性或行为; [or]z8;
idyllic: [a]/aɪˈdɪlɪk/; [adj]田园短诗的,牧歌的,生动逼真的; [or]z8;
ignite: [a]/ɪɡˈnaɪt/; [v]点燃,发光,燃烧; [or]z8;
ignition: [a]/ɪɡˈnɪʃn/; [n]点火,着火;点火开关; [or]z8;
ignominy: [a]/ˈɪɡnəmɪni/; [n]耻辱,不体面,丑行; [or]z8;
illicit: [a]/ɪˈlɪsɪt/; [adj]违法的,违禁的; [or]z8;
illustrious: [a]/ɪˈlʌstriəs/; [adj]著名的,杰出的;辉煌的; [or]z8;
imagery: [a]/ˈɪmɪdʒəri/; [n]像,肖像,画像,雕像;意象;比喻;形象化的描述; [or]z8;
imbecile: [a]/ˈɪmbəsl/; [n]低能者,愚蠢的人; [adj]低能的,愚笨的,虚弱的; [or]z8;
imbecility: [a]/ˌɪmbəˈsɪləti/; [n]愚钝,低能,愚蠢的行为或言语; [or]z8;
imbibe: [a]/ɪmˈbaɪb/; [v]喝,饮;吸收,接受; [or]z8;
immaculate: [a]/ɪˈmækjələt/; [adj]完美的,无瑕疵的;洁净的; [or]z8;
immaterial: [a]/ˌɪməˈtɪriəl/; [adj]非实体的,无关紧要的; [or]z8;
immerse: [a]/ɪˈmɜːrs/; [v]沉浸,沉浸于;使陷入; [or]z8;
immobile: [a]/ɪˈmoʊbl/; [adj]不动的;不能活动的;不变的;静止的; [or]z8;
immune: [a]/ɪˈmjuːn/; [adj]免疫的,有免疫力的;不受影响的;免除的; [or]z8;
impair: [a]/ɪmˈper/; [v]损害;削弱; [or]z8;
impale: [a]/ɪmˈpeɪl/; [v]刺穿,刺住; [or]z8;
impart: [a]/ɪmˈpɑːrt/; [v]传授,给予,将(某性质)给予或赋予某事物; [or]z8;
impartial: [a]/ɪmˈpɑːrʃl/; [adj]公平的,不偏不倚的; [or]z8;
impasse: [a]/ˈɪmpæs/; [n]僵局;死路; [or]z8;
impassioned: [a]/ɪmˈpæʃnd/; [adj]慷慨激昂的,充满激情的; [or]z8;
impassive: [a]/ɪmˈpæsɪv/; [adj]无动于衷的,冷漠的; [or]z8;
impeccable: [a]/ɪmˈpekəbl/; [adj]无瑕疵的,没有缺点的; [or]z8;
impede: [a]/ɪmˈpiːd/; [v]妨碍,阻碍; [or]z8;
impediment: [a]/ɪmˈpedɪmənt/; [n]妨碍,阻碍;障碍物;(言语)障碍;口吃; [or]z8;
impel: [a]/ɪmˈpel/; [v]推进,驱使; [or]z8;
impending: [a]/ɪmˈpendɪŋ/; [adj]即将到来的;迫在眉睫的,紧急的; [or]z8;
impenetrable: [a]/ɪmˈpenɪtrəbl/; [adj]难以渗透的,坚不可摧的; [or]z8;
imperceptible: [a]/ˌɪmpərˈseptəbl/; [adj]极细微的,觉察不到的,感觉不到的,; [or]z8;
imperious: [a]/ɪmˈpɪriəs/; [adj]傲慢的,专横的; [or]z8;
impersonate: [a]/ɪmˈpɜːrsəneɪt/; [v]模仿,扮演,人格化,拟人; [or]z8;
impertinent: [a]/ɪmˈpɜːrtnənt/; [adj]不恰当的,粗鲁的; [or]z8;
impetuous: [a]/ɪmˈpetʃuəs/; [adj]冲动的,鲁莽的; [or]z8;
impetus: [a]/ˈɪmpɪtəs/; [n]推动力;促进; [or]z8;
impinge: [a]/ɪmˈpɪndʒ/; [v]侵犯,撞击,碰撞; [or]z8;
impious: [a]/ɪmˈpaɪəs/; [adj]不敬神的,不虔诚的,不孝的; [or]z8;
implacable: [a]/ɪmˈplækəbl/; [adj]难以满足的,难平息的; [or]z8;
implant: [a]/ɪmˈplænt/; [v]嵌入,注入,灌输; [n]<医>植入物,植入管; [or]z8;
implicit: [a]/ɪmˈplɪsɪt/; [adj]隐含的;盲目的;完全的,绝对的;成为一部分的; [or]z8;
implore: [a]/ɪmˈplɔːr/; [v]恳求; [or]z8;
impostor: [a]/ɪmˈpɑːstər/; [n]骗子;冒充者; [or]z8;
impotent: [a]/ˈɪmpətənt/; [adj]无力的,无能的,阳痿的; [n]虚弱者;阳痿者; [or]z8;
impound: [a]/ɪmˈpaʊnd/; [v]没收,拘留; [or]z8;
impoverish: [a]/ɪmˈpɑːvərɪʃ/; [v]使成赤贫,使枯竭; [or]z8;
impregnable: [a]/ɪmˈpreɡnəbl/; [adj]攻不破的,征服不了的; [or]z8;
impregnate: [a]/ɪmˈpreɡneɪt/; [v]使怀孕,使充满; [or]z8;
impressionable: [a]/ɪmˈpreʃənəbl/; [adj]敏感的;易受影响的; [or]z8;
imprint: [a]/ɪmˈprɪnt/; [n]印痕;特征;版本说明; [vt]盖;铭刻; [or]z8;
impromptu: [a]/ɪmˈprɑːmptuː/; [adj]一触即发的;即席的,即兴的; [adv]即席地,即兴地; [n]即兴之作; [or]z8;
improvise: [a]/ˈɪmprəvaɪz/; [v]即席创作,临时凑成; 随机应变; [or]z8;
imprudent: [a]/ɪmˈpruːdnt/; [adj]轻率的,鲁莽的; [or]z8;
inadvertent: [a]/ˌɪnədˈvɜːrtənt/; [adj]疏忽的,漫不经心的,无意中的; [or]z8;
inanimate: [a]/ɪnˈænɪmət/; [adj]无生命的;无生气的; [or]z8;
inborn: [a]/ˌɪnˈbɔːrn/; [adj]天生的;先天的; [or]z8;
incantation: [a]/ˌɪnkænˈteɪʃn/; [n]咒语; [or]z8;
incapacitate: [a]/ˌɪnkəˈpæsɪteɪt/; [v]使不能;使瘫痪;使无能力;使不适合; [or]z8;
incarnate: [a]/ɪnˈkɑːrnət/; [adj]化身的,人体化的,肉色的; [v]体现,使.具体化,使实体化; [or]z8;
incarnation: [a]/ˌɪnkɑːrˈneɪʃn/; [n]赋与肉体,具人形,化身; [or]z8;
incendiary: [a]/ɪnˈsendieri/; [n]放火者,纵火者,燃烧弹,煽动者; [adj]放火的,纵火的,能燃烧的,煽动性的; [or]z8;
incense: [a]/ˈɪnsens/; [n]焚香时的烟,香味; [v]激怒; [or]z8;
inception: [a]/ɪnˈsepʃn/; [n]起初;获得学位; [or]z8;
incessant: [a]/ɪnˈsesnt/; [adj]无间断的,连续的; [or]z8;
incest: [a]/ˈɪnsest/; [n]乱伦,近亲通婚; [or]z8;
incinerate: [a]/ɪnˈsɪnəreɪt/; [v]焚化,毁弃; [or]z8;
incipient: [a]/ɪnˈsɪpiənt/; [adj]初期的;刚出现的; [or]z8;
incise: [a]/ɪnˈsaɪz/; [v]切,切割;雕刻; [or]z8;
incisive: [a]/ɪnˈsaɪsɪv/; [adj]一针见血的,敏锐的; [or]z8;
incite: [a]/ɪnˈsaɪt/; [v]刺激;煽动; [or]z8;
incoherent: [a]/ˌɪnkoʊˈhɪrənt/; [adj]语无伦次的;不合逻辑的;不连贯的; [or]z8;
incoming: [a]/ˈɪnkʌmɪŋ/; [adj]引入的,到来的,打入的; [n]进来,到来,收入; [or]z8;
incompatible: [a]/ˌɪnkəmˈpætəbl/; [adj]不兼容的,矛盾的,不调和的; [or]z8;
incontrovertible: [a]/ˌɪnkɑːntrəˈvɜːrtəbl/; [adj]无可争议的; [or]z8;
incredulous: [a]/ɪnˈkredʒələs/; [adj]怀疑的,不轻信的; [or]z8;
incriminate: [a]/ɪnˈkrɪmɪneɪt/; [v]控告,暗示..有罪; [or]z8;
incubate: [a]/ˈɪŋkjubeɪt/; [v]孵卵; [or]z8;
incubation: [a]/ˌɪŋkjuˈbeɪʃn/; [n]孵化,孵卵,酝酿,培育,(传染病的)潜伏期; [or]z8;
incubator: [a]/ˈɪŋkjubeɪtər/; [n]孵卵器,保温箱,早产儿保育器,细菌培养器; [or]z8;
inculcate: [a]/ɪnˈkʌlkeɪt/; [v]灌输,谆谆教诲; [or]z8;
incumbent: [a]/ɪnˈkʌmbənt/; [n]在职者,现任者; [adj]现任的;依靠的;负有职责的; [or]z8;
incur: [a]/ɪnˈkɜːr/; [v]遭受;招致;引起; [or]z8;
incursion: [a]/ɪnˈkɜːrʒn/; [n]入侵,侵犯; [or]z8;
indelible: [a]/ɪnˈdeləbl/; [adj](印记等)无法擦除的,无法忘怀的; [or]z8;
indemnity: [a]/ɪnˈdemnəti/; [n]赔偿物;补偿,赔偿;保障; [or]z8;
indent: [a]/ɪnˈdent/; [v]切割成锯齿状;(书写)缩排,印刷;定货;印凹痕; [n]缩进;契约;订货单;凹痕; [or]z8;
indict: [a]/ɪnˈdaɪt/; [v]控诉,起诉; [or]z8;
indigenous: [a]/ɪnˈdɪdʒənəs/; [adj]土生土长的,本土的; [or]z8;
indigestion: [a]/ˌɪndɪˈdʒestʃən/; [n]消化不良;不消化; [or]z8;
indiscriminate: [a]/ˌɪndɪˈskrɪmɪnət/; [adj]任意的;不加区别的,不加选择的; [or]z8;
indisposed: [a]/ˌɪndɪˈspoʊzd/; [adj]不舒服的,不愿意的,不合适的; [or]z8;
indisputable: [a]/ˌɪndɪˈspjuːtəbl/; [adj]没有争论余地,非常清楚的; [or]z8;
indoctrinate: [a]/ɪnˈdɑːktrɪneɪt/; [v]灌输思想; [or]z8;
indolent: [a]/ˈɪndələnt/; [adj]懒惰的,懒洋洋的; [or]z8;
ineluctable: [a]/ˌɪnɪˈlʌktəbl/; [adj]不可改变的,无法逃避的; [or]z8;
inept: [a]/ɪˈnept/; [adj]无能的;不称职的;笨拙的; [or]z8;
inexhaustible: [a]/ˌɪnɪɡˈzɔːstəbl/; [adj]无穷无尽的,取之不竭的; [or]z8;
inexorable: [a]/ɪnˈeksərəbl/; [adj]不为所动的,坚决不变的; [n]坚定不移的人; [or]z8;
inexplicable: [a]/ˌɪnɪkˈsplɪkəbl/; [adj]无法解释的,难理解的,莫名其妙的; [or]z8;
infamous: [a]/ˈɪnfəməs/; [adj]声名狼藉的,无耻的; [or]z8;
infantile: [a]/ˈɪnfəntaɪl/; [adj]婴儿的,幼稚的,初期的; [or]z8;
infantry: [a]/ˈɪnfəntri/; [n]步兵,步兵团; [or]z8;
infatuated: [a]/ɪnˈfætʃueɪtɪd/; [adj]入迷的,昏头昏脑的; [or]z8;
infernal: [a]/ɪnˈfɜːrnl/; [adj]地狱的;恶魔的;可憎的; [or]z8;
infest: [a]/ɪnˈfest/; [v]骚扰,寄生于,大批出没; [or]z8;
infidelity: [a]/ˌɪnfɪˈdeləti/; [n]不忠实,不贞; [or]z8;
infiltrate: [a]/ˈɪnfɪltreɪt/; [v]渗入,潜入 (某地方或组织);(气,液)渗透; [n]渗透物; [or]z8;
infirm: [a]/ɪnˈfɜːrm/; [adj]衰弱的;意志薄弱的;不坚固的; [or]z8;
infirmary: [a]/ɪnˈfɜːrməri/; [n]医院,医务室(尤指学校等附设的病房或配药处); [or]z8;
infirmity: [a]/ɪnˈfɜːrməti/; [n]虚弱; [or]z8;
inflame: [a]/ɪnˈfleɪm/; [v]使燃烧,激怒(某人); [or]z8;
inflamed: [a]/ɪnˈfleɪmd/; [adj]发炎的,红肿的,激怒的,燃烧的; [or]z8;
inflammable: [a]/ɪnˈflæməbl/; [adj]可燃的,易激怒的; [n]易燃物; [or]z8;
inflammation: [a]/ˌɪnfləˈmeɪʃn/; [n]<病理>炎症,<医>发炎,燃烧,发火; [or]z8;
inflammatory: [a]/ɪnˈflæmətɔːri/; [adj]炎症性的;煽动性的;激动的; [or]z8;
inflection: [a]/ɪnˈflekʃn/; [n]弯曲,变形,音调变化; [or]z8;
inflexible: [a]/ɪnˈfleksəbl/; [adj]顽固的;不可弯曲的;不屈挠的;不可改变的; [or]z8;
inflict: [a]/ɪnˈflɪkt/; [v]使遭受(损伤,痛苦等);使承担(负担等); [or]z8;
influx: [a]/ˈɪnflʌks/; [n]流入,涌入;河口; [or]z8;
infrared: [a]/ˌɪnfrəˈred/; [adj]红外线的; [n]红外线; [or]z8;
infrastructure: [a]/ˈɪnfrəstrʌktʃər/; [n]基础设施; [or]z8;
infringe: [a]/ɪnˈfrɪndʒ/; [v]侵犯,违反,侵害; [or]z8;
infuriate: [a]/ɪnˈfjʊrieɪt/; [v]使(人)极为愤怒; [or]z8;
infuse: [a]/ɪnˈfjuːz/; [v]沏(茶),泡(草药);灌输;使充满; [or]z8;
ingratiating: [a]/ɪnˈɡreɪʃieɪtɪŋ/; [adj]讨好的,谄媚的; [or]z8;
inhibit: [a]/ɪnˈhɪbɪt/; [v]阻碍;阻止,防止;抑制,约束; [or]z8;
injunction: [a]/ɪnˈdʒʌŋkʃn/; [n]<法>指令,禁令; [or]z8;
injurious: [a]/ɪnˈdʒʊriəs/; [adj]有害的,造成伤害的; [or]z8;
inkling: [a]/ˈɪŋklɪŋ/; [n]轻微暗示,小提示,略知; [or]z8;
inmate: [a]/ˈɪnmeɪt/; [n]囚犯;(精神病院等中的)被收容者; [or]z8;
innate: [a]/ɪˈneɪt/; [adj]与生俱来的,天生的; [or]z8;
inoculate: [a]/ɪˈnɑːkjuleɪt/; [v]<医>给..接种,给..注射预防针,<植>嫁接,灌输; [or]z8;
inoffensive: [a]/ˌɪnəˈfensɪv/; [adj]无害的;不冒犯人的;不令人讨厌的,不引起反对的; [or]z8;
inordinate: [a]/ɪnˈɔːrdɪnət/; [adj]过度的,无节制的;紊乱的; [or]z8;
inquisitive: [a]/ɪnˈkwɪzətɪv/; [adj]好奇的,好打听的; [or]z8;
insanity: [a]/ɪnˈsænəti/; [n]疯狂;精神错乱,精神病;荒谬,愚蠢; [or]z8;
insatiable: [a]/ɪnˈseɪʃəbl/; [adj]不能满足的,贪得无厌的; [or]z8;
insidious: [a]/ɪnˈsɪdiəs/; [adj](暗中或逐渐)为害的; [or]z8;
insinuate: [a]/ɪnˈsɪnjueɪt/; [v]暗指,暗示; [or]z8;
insipid: [a]/ɪnˈsɪpɪd/; [adj]淡而无味的;枯燥乏味的; [or]z8;
insolent: [a]/ˈɪnsələnt/; [adj]傲慢的,粗鲁的,无礼的; [or]z8;
insomnia: [a]/ɪnˈsɑːmniə/; [n]失眠; [or]z8;
instantaneous: [a]/ˌɪnstənˈteɪniəs/; [adj]瞬间的;即刻的;猝发的; [or]z8;
instigate: [a]/ˈɪnstɪɡeɪt/; [v]发起,煽动; [or]z8;
insular: [a]/ˈɪnsələr/; [adj]岛屿的,与世隔绝的; [or]z8;
insulate: [a]/ˈɪnsəleɪt/; [v]隔离,使隔绝(以免受到影响);使隔热; [or]z8;
insuperable: [a]/ɪnˈsuːpərəbl/; [adj]难以克服的,无敌的; [or]z8;
insurgent: [a]/ɪnˈsɜːrdʒənt/; [n]叛乱分子; [adj]叛乱的,起事的; [or]z8;
insurmountable: [a]/ˌɪnsərˈmaʊntəbl/; [adj]不能克服的,不能超越的,难以对付的; [or]z8;
insurrection: [a]/ˌɪnsəˈrekʃn/; [n]造反,叛乱; [or]z8;
intake: [a]/ˈɪnteɪk/; [n]吸入,收纳;纳入(数量); [or]z8;
intangible: [a]/ɪnˈtændʒəbl/; [adj]不可捉摸的,无形的; [n]无形的东西; [or]z8;
integer: [a]/ˈɪntɪdʒər/; [n]整数;整体; [or]z8;
intelligible: [a]/ɪnˈtelɪdʒəbl/; [adj]可理解的,明白易懂的; [or]z8;
interface: [a]/ˈɪntərfeɪs/; [n]界面;<地质>分界面,接触面; [v]相互作用(或影响);交流,交谈; [or]z8;
interject: [a]/ˌɪntərˈdʒekt/; [v]突然插入,插嘴; [or]z8;
interjection: [a]/ˌɪntərˈdʒekʃn/; [n]感叹词,插入语; [or]z8;
interlock: [a]/ˌɪntərˈlɑːk/; [v]连锁,连串; [n]〔电信〕结合;联锁装置;相关;联动; [or]z8;
interlocutor: [a]/ˌɪntərˈlɑːkjətər/; [n]对话者,谈话者; [or]z8;
interlude: [a]/ˈɪntərluːd/; [n]插曲;穿插;间歇;幕间节目; [or]z8;
intermediary: [a]/ˌɪntərˈmiːdieri/; [adj]中间的;媒介的;中途的; [n]中间人;仲裁者;调解者;媒介物; [or]z8;
interminable: [a]/ɪnˈtɜːrmɪnəbl/; [adj]没完没了的,无穷无尽的,冗长的; [or]z8;
intermingle: [a]/ˌɪntərˈmɪŋɡl/; [v]混合,搀杂; [or]z8;
intermittent: [a]/ˌɪntərˈmɪtənt/; [adj]断断续续的,间歇的; [or]z8;
intern: [a]/ɪnˈtɜːrn/; [n]实习生;实习医师;被拘留者; [v]作实习医师;拘留; [or]z8;
interrogate: [a]/ɪnˈterəɡeɪt/; [v]审问,审讯; [or]z8;
intestinal: [a]/ɪnˈtestɪnl/; [adj]肠的; [or]z8;
intimacy: [a]/ˈɪntɪməsi/; [n]亲密,亲近;亲昵行为;<婉>性行为;<婉辞>私通; [or]z8;
intimidate: [a]/ɪnˈtɪmɪdeɪt/; [v]恫吓,威胁; [or]z8;
intoxicant: [a]/ɪnˈtɑːksɪkənt/; [adj]醉人的,麻醉的,沉醉的; [n]酒精饮料,麻醉品; [or]z8;
intoxicate: [a]/ɪnˈtɑːksɪkeɪt/; [v]使醉,使陶醉,使中毒; [adj]陶醉的; [or]z8;
intractable: [a]/ɪnˈtræktəbl/; [adj]棘手的;难治的;倔强的;不听话的; [or]z8;
intransigent: [a]/ɪnˈtrænzɪdʒənt/; [adj]固执的,不妥协的,不让步的; [n]不妥协,不妥协的人; [or]z8;
intrepid: [a]/ɪnˈtrepɪd/; [adj]无畏的;刚毅的,勇敢的; [or]z8;
intrigue: [a]/ɪnˈtriːɡ/; [n]阴谋;诡计; [v]密谋;欺骗;引起极大兴趣; [or]z8;
intriguing: [a]/ɪnˈtriːɡɪŋ/; [adj]迷人的,有迷惑力的,引起兴趣(或好奇心)的; [or]z8;
intrinsic: [a]/ɪnˈtrɪnsɪk/; [adj]固有的; [or]z8;
introvert: [a]/ˈɪntrəvɜːrt/; [v]使内翻,使内向,使内省; [n]内向的人,内弯(内翻)的东西; [or]z8;
intrusive: [a]/ɪnˈtruːsɪv/; [adj]侵入的;打扰的; [or]z8;
intuition: [a]/ˌɪntuˈɪʃn/; [n]直觉;感觉; [or]z8;
intuitive: [a]/ɪnˈtuːɪtɪv/; [adj]直觉的,凭直觉获知的; [or]z8;
inundate: [a]/ˈɪnʌndeɪt/; [v]淹没,泛滥; [or]z8;
invalidate: [a]/ɪnˈvælɪdeɪt/; [v]使无效;使无价值; [or]z8;
inveterate: [a]/ɪnˈvetərət/; [adj]积习已深的,根深蒂固的,长期形成的; [or]z8;
invidious: [a]/ɪnˈvɪdiəs/; [adj]惹人反感的,招人嫉妒的,令人厌恶的,诽谤的,不公平的; [or]z8;
invigilate: [a]/ɪnˈvɪdʒɪleɪt/; [v]监考;监视; [or]z8;
invigorate: [a]/ɪnˈvɪɡəreɪt/; [v]鼓舞;提神,使精力充沛; [adj]生气勃勃的,精力充沛的,健壮的; [n]滋补;鼓舞; [or]z8;
invincible: [a]/ɪnˈvɪnsəbl/; [adj]无敌的;不能征服的; [or]z8;
invocation: [a]/ˌɪnvəˈkeɪʃn/; [n]祈祷;咒语;(法权的)行驶; [or]z8;
invoice: [a]/ˈɪnvɔɪs/; [n]发票; [v]开发票;记清单; [or]z8;
invoke: [a]/ɪnˈvoʊk/; [v]调用,祈求,恳求,引起; [or]z8;
involuntary: [a]/ɪnˈvɑːlənteri/; [adj]非自愿的,非出自本意的;无意识的,不自觉的; [or]z8;
invulnerable: [a]/ɪnˈvʌlnərəbl/; [adj]无法伤害的;无懈可击的; [or]z8;
iodine: [a]/ˈaɪədaɪn/; [n]碘,碘酒; [or]z8;
ion: [a]/ˈaɪən/; [n]［物］离子; [or]z8;
irascible: [a]/ɪˈræsəbl/; [adj]易怒的,性情暴躁的; [or]z8;
iris: [a]/ˈaɪrɪs/; [n]虹膜,鸢尾属植物; [or]z8;
irk: [a]/ɜːrk/; [v]使苦恼,使厌烦; [n]厌烦,厌倦; [or]z8;
irksome: [a]/ˈɜːrksəm/; [adj]令人厌烦的,讨厌的; [or]z8;
irradiate: [a]/ɪˈreɪdieɪt/; [vt]照亮;扩散;启发; [vi]发光; [adj]发光的; [or]z8;
irreconcilable: [a]/ɪˈrekənsaɪləbl/; [adj]不能妥协的,不能和解的,不能协调的; [n]不能和解的人,(政治上的)死硬派; [or]z8;
irreparable: [a]/ɪˈrepərəbl/; [adj]不能修复的;不可弥补的; [or]z8;
irrespective: [a]/ˌɪrɪˈspektɪv/; [adj]不考虑的,不顾的; [or]z8;
irreverent: [a]/ɪˈrevərənt/; [adj]不敬的,无礼的; [or]z8;
irreversible: [a]/ˌɪrɪˈvɜːrsəbl/; [adj]不能翻转的;不可撤销的;不可逆的; [or]z8;
irrevocable: [a]/ɪˈrevəkəbl/; [adj]不可改变的;不能取消的;不能挽回的; [or]z8;
irritant: [a]/ˈɪrɪtənt/; [adj]刺激的,刺激性的; [n]<医>刺激物,刺激剂; [or]z8;
isotope: [a]/ˈaɪsətoʊp/; [n]同位素; [or]z8;
itch: [a]/ɪtʃ/; [n]发痒,渴望; [v]发痒,渴望; [or]z8;
iterate: [a]/ˈɪtəreɪt/; [vt]重申,重复,反复申说; [or]z8;
itinerant: [a]/aɪˈtɪnərənt/; [n]巡回工作者; [adj]巡回的;流动的; [or]z8;
itinerary: [a]/aɪˈtɪnəreri/; [n]旅程,路线;旅行计划; [or]z8;
jagged: [a]/ˈdʒæɡɪd/; [adj]锯齿状的,参差不齐的;锯齿状的; [or]z8;
jargon: [a]/ˈdʒɑːrɡən/; [n]行话,术语;黄锆石; [or]z8;
javelin: [a]/ˈdʒævlɪn/; [n]标枪,投枪; [or]z8;
jeer: [a]/dʒɪr/; [n]嘲笑,戏弄,揶揄的言语; [v]嘲笑,戏弄; [or]z8;
jellyfish: [a]/ˈdʒelifɪʃ/; [n]水母,海蜇; [or]z8;
jeopardize: [a]/ˈdʒepərdaɪz/; [v]危及,损害(也作jeopardise); [or]z8;
jest: [a]/dʒest/; [n]笑话,俏皮话;玩笑; [v]开玩笑;嘲笑; [or]z8;
jigsaw: [a]/ˈdʒɪɡsɔː/; [n]拼图游戏,竖锯; [vt]用竖锯锯,使互相交错搭接; [or]z8;
jingle: [a]/ˈdʒɪŋɡl/; [n](硬币,铃铛等发出的)叮当声;含有轻松而有节奏的韵律的诗篇; [v]发出叮当声; [or]z8;
jocular: [a]/ˈdʒɑːkjələr/; [adj]搞笑的,欢乐的; [or]z8;
jog: [a]/dʒɑːɡ/; [v]慢跑;轻碰; [n]轻推,慢跑,漫步; [or]z8;
jolt: [a]/dʒoʊlt/; [n]猛的一击,摇晃,震惊; [v](使)颠簸,摇晃;使震惊; [or]z8;
jubilant: [a]/ˈdʒuːbɪlənt/; [adj]喜悦的,欢呼的; [or]z8;
judicious: [a]/dʒuˈdɪʃəs/; [adj]有判断力的;明智的; [or]z8;
juggle: [a]/ˈdʒʌɡl/; [v]玩杂耍;同时做;对.巧妙应付; [or]z8;
jumble: [a]/ˈdʒʌmbl/; [n]混杂;混乱;待义卖的一堆旧什物; [v]使混乱;搞乱; [or]z8;
jumbo: [a]/ˈdʒʌmboʊ/; [adj]巨大的,特大的; [n]体大而笨拙的人或物;大型喷气式客机;庞然大物; [or]z8;
juncture: [a]/ˈdʒʌŋktʃər/; [n]连接;交接处,交界;关键时刻;形势; [or]z8;
jurisdiction: [a]/ˌdʒʊrɪsˈdɪkʃn/; [n]司法权,审判权;管辖权;权限,权力; [or]z8;
juror: [a]/ˈdʒʊrər/; [n]审查委员,陪审员; [or]z8;
juvenile: [a]/ˈdʒuːvənl/; [n]青少年;雏鸟; [adj]青少年的;幼稚的; [or]z8;
juxtapose: [a]/ˌdʒʌkstəˈpoʊz/; [v]使并排;使并置;使并列; [or]z8;
kennel: [a]/ˈkenl/; [n]狗窝;一群狗;阴沟; [v]使住在狗窝,进狗窝; [or]z8;
kernel: [a]/ˈkɜːrnl/; [n]子粒,谷粒;核心; [or]z8;
kin: [a]/kɪn/; [n]亲属; [or]z8;
kindred: [a]/ˈkɪndrəd/; [n]亲戚,家族,亲属关系,相似; [adj]有血缘关系的,同宗的,同源的,类似的; [or]z8;
kinship: [a]/ˈkɪnʃɪp/; [n]<法>亲属关系,家属关系;亲密关系; [or]z8;
kiwi: [a]/ˈkiːwiː/; [n]猕猴桃,奇异果; [adj]〈非正式〉与新西兰或新西兰人有关的; [or]z8;
knack: [a]/næk/; [n]诀窍;本领;熟练技术;巧妙手法; [or]z8;
knead: [a]/niːd/; [v]揉捏,塑造; [or]z8;
laborious: [a]/ləˈbɔːriəs/; [adj]费时费力的,辛苦的;艰苦的; [or]z8;
lacquer: [a]/ˈlækər/; [n]漆器;天然漆; [v]涂漆; [or]z8;
lagoon: [a]/ləˈɡuːn/; [n]泻湖,环礁湖,咸水湖; [or]z8;
lament: [a]/ləˈment/; [v]哀悼;惋惜;悲叹; [n]悲叹;悼词; [or]z8;
lance: [a]/læns/; [n]长矛; [v]以长矛攻击; [or]z8;
languid: [a]/ˈlæŋɡwɪd/; [adj]没精打采的,倦怠的; [or]z8;
languish: [a]/ˈlæŋɡwɪʃ/; [v]凋萎,衰弱,变得消瘦; [or]z8;
lapse: [a]/læps/; [n]失误,过失;行为失检;(时间)流逝; [v]退步,倒退,衰退;失效;背弃,放弃(宗教信仰); [or]z8;
laryngitis: [a]/ˌlærɪnˈdʒaɪtɪs/; [n]喉炎; [or]z8;
larynx: [a]/ˈlærɪŋks/; [n]喉; [or]z8;
latch: [a]/lætʃ/; [n]闩,碰锁,弹簧锁; [v]用闩把..闩上; [or]z8;
lateral: [a]/ˈlætərəl/; [n]侧面部分;支线; [adj]侧面的;横向的; [or]z8;
lathe: [a]/leɪð/; [n]车床; [or]z8;
laurel: [a]/ˈlɔːrəl/; [n]月桂树,桂冠,殊荣; [v]使戴桂冠;给以荣誉; [or]z8;
lavish: [a]/ˈlævɪʃ/; [adj]奢华的;铺张浪费的; [v]浪费;慷慨给予; [or]z8;
lawsuit: [a]/ˈlɔːsuːt/; [n]诉讼,诉讼案件; [or]z8;
lax: [a]/læks/; [adj]松懈的;松弛的;<语>松弛元音的; [n]松元音;泻肚; [or]z8;
ledge: [a]/ledʒ/; [n]暗礁;突出部分; [or]z8;
ledger: [a]/ˈledʒər/; [n]账簿;总账;(手脚架上的)横木;<会计>分类账; [or]z8;
leeway: [a]/ˈliːweɪ/; [n]［海］［空］风压差;余地; [or]z8;
legendary: [a]/ˈledʒənderi/; [adj]传说的;传奇的; [n]传说集;圣徒传; [or]z8;
legible: [a]/ˈledʒəbl/; [adj]清晰的;易读的;易辨认的; [or]z8;
legislate: [a]/ˈledʒɪsleɪt/; [v]立法,制定法律; [or]z8;
lenience: [a]/'liːnɪəns/; [n]宽大,温和; [or]z8;
lenient: [a]/ˈliːniənt/; [adj]宽大的,宽容的,仁慈的; [or]z8;
lesbian: [a]/ˈlezbiən/; [n]女性同性恋者; [adj]女同性恋的;女同性恋者的; [or]z8;
lethal: [a]/ˈliːθl/; [adj]致命的,致死的;杀伤性的; [n]致死因子; [or]z8;
leverage: [a]/ˈlevərɪdʒ/; [n]杠杆作用;杠杆效率; [v]举债经营;借贷收购;利用; [or]z8;
levity: [a]/ˈlevəti/; [n]轻率,轻浮,多变,不稳定; [or]z8;
lexical: [a]/ˈleksɪkl/; [adj]词汇的,词典的; [or]z8;
lieu: [a]/luː/; [n]代替;场所; [or]z8;
liken: [a]/ˈlaɪkən/; [v]把..比作,比拟; [or]z8;
likeness: [a]/ˈlaɪknəs/; [n]相像,相似;画像,写真; [or]z8;
lilac: [a]/ˈlaɪlək/; [n]淡紫色,丁香花; [adj]淡紫色的; [or]z8;
lineage: [a]/ˈlɪniɪdʒ/; [n]血统,世系,门第,宗族;传承; [or]z8;
liquidate: [a]/ˈlɪkwɪdeɪt/; [vt]清理,清算,停业清理;清偿,清理,清算(破产的公司等),变卖,杀戮,废除; [or]z8;
literal: [a]/ˈlɪtərəl/; [adj]字面上的;照字面的;缺乏想像力的; [or]z8;
literate: [a]/ˈlɪtərət/; [adj]受过教育的;精通文学的; [n]学者; [or]z8;
litigation: [a]/ˌlɪtɪˈɡeɪʃn/; [n]诉讼;起诉; [or]z8;
livid: [a]/ˈlɪvɪd/; [adj]气急败坏的,铅色的; [or]z8;
loathe: [a]/loʊð/; [v]憎恨,厌恶; [or]z8;
lobe: [a]/loʊb/; [n]耳垂,波瓣,(脑,肺等的)叶,裂片; [or]z8;
loft: [a]/lɔːft/; [n]阁楼,顶楼; [v]把.储放在阁楼内;将球高击;发射(人造卫星等); [or]z8;
logistics: [a]/ləˈdʒɪstɪks/; [n]后勤,后勤学,物流; [or]z8;
loiter: [a]/ˈlɔɪtər/; [v]虚度,闲荡,徘徊,走走停停; [or]z8;
loll: [a]/lɑːl/; [vi]懒洋洋地倚靠;闲荡; [vt]懒洋洋地倚靠着;使悬垂; [or]z8;
lookout: [a]/ˈlʊkaʊt/; [n]眺望台;守望,看守,警戒,守望者,看守者; [or]z8;
loophole: [a]/ˈluːphoʊl/; [n]漏洞;枪眼;换气孔;射弹孔; [vt]钻空子;开孔; [or]z8;
lopsided: [a]/ˌlɑːpˈsaɪdɪd/; [adj]不平衡的,倾向一方的; [or]z8;
lotion: [a]/ˈloʊʃn/; [n]洗液,洗涤剂; [or]z8;
lousy: [a]/ˈlaʊzi/; [adj]蹩脚的,糟糕的,不清洁的; [or]z8;
lubricant: [a]/ˈluːbrɪkənt/; [n]润滑剂,润滑油; [adj]润滑的; [or]z8;
lucid: [a]/ˈluːsɪd/; [adj]明晰的;透明的;易懂的;头脑清楚的; [or]z8;
lucrative: [a]/ˈluːkrətɪv/; [adj]合算的;获利的;有利可图的; [or]z8;
ludicrous: [a]/ˈluːdɪkrəs/; [adj]荒谬的,可笑的,滑稽的; [or]z8;
lug: [a]/lʌɡ/; [n]耳状物;把手;笨家伙; [v]拖拉; [or]z8;
lull: [a]/lʌl/; [v]使平静,使安静,哄骗; [n]间歇,暂停,暂时平静; [or]z8;
lullaby: [a]/ˈlʌləbaɪ/; [n]催眠曲,摇篮曲,轻柔的声音; [v]唱催眠曲使入睡; [or]z8;
luminous: [a]/ˈluːmɪnəs/; [adj]发光的;鲜艳的;明亮的;夜光的; [or]z8;
lunacy: [a]/ˈluːnəsi/; [n]精神失常,愚蠢的行为; [or]z8;
lunge: [a]/lʌndʒ/; [n]突然刺(入);突然向前冲〔扑等);套马索; [v](用剑等)刺,戳;猛向前冲,猛扑; [or]z8;
lurch: [a]/lɜːrtʃ/; [n]突然倾斜,挫折,举步蹒跚,徘徊,困境; [v]惨败,倾斜,徘徊,击败; [or]z8;
lure: [a]/lʊr/; [v]引诱;以诱饵吸引; [n]诱惑力;诱惑物;鱼饵; [or]z8;
lurk: [a]/lɜːrk/; [n]潜伏,潜行; [vi]潜伏;潜藏;鬼鬼祟祟地走; [or]z8;
luscious: [a]/ˈlʌʃəs/; [adj]美味的;满足感官的; [or]z8;
lush: [a]/lʌʃ/; [adj]草木茂盛的,多的,丰富豪华的; [n]酒;醉汉; [or]z8;
lust: [a]/lʌst/; [n]性欲,强烈的欲望; [v]产生性欲,渴望; [or]z8;
luxuriant: [a]/lʌɡˈʒʊriənt/; [adj]繁茂的;多产的;绚烂的;奢华的; [or]z8;
lynch: [a]/lɪntʃ/; [v]私刑处死; [n]私刑;私罚; [or]z8;
lyric: [a]/ˈlɪrɪk/; [n]抒情诗;歌词; [adj](供)吟唱的;抒情的; [or]z8;
lyrical: [a]/ˈlɪrɪkl/; [adj]抒情诗调的;感情丰富的;充满愉悦的; [or]z8;
macho: [a]/ˈmɑːtʃoʊ/; [adj]大男子气概的;大男人的; [n]男子汉; [or]z8;
madden: [a]/ˈmædn/; [v]使发疯,使发狂; [or]z8;
magnanimous: [a]/mæɡˈnænɪməs/; [adj]宽宏大量的,大度的;慷慨的; [or]z8;
magnate: [a]/ˈmæɡneɪt/; [n]大人物;大亨,巨头;权贵; [or]z8;
magnetism: [a]/ˈmæɡnətɪzəm/; [n]吸引力;磁性; [or]z8;
magnitude: [a]/ˈmæɡnɪtuːd/; [n]巨大;震级;重要性;<数>量值; [or]z8;
magpie: [a]/ˈmæɡpaɪ/; [n]<鸟类>喜鹊,饶舌者; [adj]似喜鹊的,喜欢随便收集的; [or]z8;
maim: [a]/meɪm/; [v]使残废; [or]z8;
mainspring: [a]/ˈmeɪnsprɪŋ/; [n]主要动力;主要原因;(钟表)主发条; [or]z8;
mainstay: [a]/ˈmeɪnsteɪ/; [n]支柱,中流砥柱,主要的依靠,主桅支索; [or]z8;
mainstream: [a]/ˈmeɪnstriːm/; [n]主流,主要倾向; [v]使.成为主流;将(残障儿童等)纳入正规班级; [adj]主流的; [or]z8;
majestic: [a]/məˈdʒestɪk/; [adj]威严的;雄伟的;壮丽的; [or]z8;
makeshift: [a]/ˈmeɪkʃɪft/; [adj]临时的,权宜之计的,凑合的; [n]权宜之计,凑合,临时措施,将就; [or]z8;
malfunction: [a]/ˌmælˈfʌŋkʃn/; [v]发生故障;不起作用; [n]故障;失灵;疾病; [or]z8;
malign: [a]/məˈlaɪn/; [v]诽谤,中伤; [adj]邪恶的;有害的; [or]z8;
malignant: [a]/məˈlɪɡnənt/; [adj]恶性的,恶毒的,充满恨意的; [n]怀有恶意的人;保王党员; [or]z8;
malt: [a]/mɔːlt/; [n]麦芽,麦芽酒; [vt]使(谷物)成为麦芽;制麦芽; [adj]麦芽的;含麦芽的;用麦芽作的; [or]z8;
mammoth: [a]/ˈmæməθ/; [n]长毛象,猛犸象,庞然大物; [adj]巨大的,庞大的,猛犸似的; [or]z8;
manacle: [a]/ˈmænəkl/; [v]上手铐,束缚; [n]手铐; [or]z8;
managerial: [a]/ˌmænəˈdʒɪriəl/; [adj]管理上的,经理的; [or]z8;
mandate: [a]/ˈmændeɪt/; [n]授权;命令,指令;委托管理;受命进行的工作; [v]授权;托管; [or]z8;
mandatory: [a]/ˈmændətɔːri/; [adj]命令的,强制性的; [or]z8;
mane: [a]/meɪn/; [n](马,狮子等的)鬃毛,(人的)长头发; [or]z8;
mania: [a]/ˈmeɪniə/; [n]癫狂,狂热; [or]z8;
maniac: [a]/ˈmeɪniæk/; [adj]发狂的,癫狂的,疯狂的; [n]燥狂(症)者,疯子; [or]z8;
manicure: [a]/ˈmænɪkjʊr/; [n]修指甲; [v]修剪; [or]z8;
manifestation: [a]/ˌmænɪfeˈsteɪʃn/; [n]表现,表示;显灵;示威运动; [or]z8;
manifesto: [a]/ˌmænɪˈfestoʊ/; [n]宣言,声明;告示; [v]发表宣言; [or]z8;
manoeuvre: [a]/məˈnuːvər/; [n]谨慎或熟练的动作;花招,巧计;(军队)调遣,演习; [or]z8;
mantle: [a]/ˈmæntl/; [n]外壳;披风;地幔; [v]覆盖; [or]z8;
manure: [a]/məˈnʊr/; [n]肥料; [v]施肥于;耕种; [or]z8;
mar: [a]/mɑːr/; [v]毁坏,弄糟,玷污; [or]z8;
mare: [a]/mer/; [n]母马; [or]z8;
marginal: [a]/ˈmɑːrdʒɪnl/; [adj]微小的,不重要的;仅以微弱多数票获胜的; [n](议会或地方委员会的)边缘席位; [or]z8;
marijuana: [a]/ˌmærəˈwɑːnə/; [n]大麻,大麻中的毒质; [or]z8;
marital: [a]/ˈmærɪtl/; [adj]婚姻的; [or]z8;
marquee: [a]/mɑːrˈkiː/; [n]选取框;大天幕;华盖; [adj]〈美〉最重要的; [or]z8;
martial: [a]/ˈmɑːrʃl/; [adj]武术的;好战的;军事的; [or]z8;
mash: [a]/mæʃ/; [v]捣碎; [n]糊状物; [or]z8;
masquerade: [a]/ˌmæskəˈreɪd/; [n]化装舞会;伪装,假扮; [vi]假扮; [or]z8;
mastery: [a]/ˈmæstəri/; [n]权力;优势;精通,掌握; [or]z8;
materialize: [a]/məˈtɪriəlaɪz/; [v]赋予形体,具体化,物质化; [or]z8;
matriculate: [a]/məˈtrɪkjuleɪt/; [n]被录取者; [v]准许.入学; [or]z8;
matrix: [a]/ˈmeɪtrɪks/; [n]<数>矩阵,模子; [or]z8;
matron: [a]/ˈmeɪtrən/; [n]妇女;保姆;女舍监; [or]z8;
maverick: [a]/ˈmævərɪk/; [n]独行者,想法与众不同的人; [adj]行为不合常规的; [v]用不正当手段获取;迷路; [or]z8;
maxim: [a]/ˈmæksɪm/; [n]格言;准则;座右铭; [or]z8;
maze: [a]/meɪz/; [n]曲径,迷宫,迷津,迷惘,迷惑,糊涂; [v]使迷惘,使混乱,迷失; [or]z8;
meager: [a]/ˈmiːɡər/; [adj]瘦的;贫乏的;粗劣的;少量的; [or]z8;
mean: [a]/miːn/; [n]平均值,中庸; [v]意思是,打算,导致; [adj]吝啬的,低劣的,刻薄的,卑鄙的,平均的,中等的; [or]z8;
meander: [a]/miˈændər/; [n]蜿蜒曲折,迂回曲折的旅程;漫步; [v]迂回曲折;漫步;漫谈; [or]z8;
measles: [a]/ˈmiːzlz/; [n]<医>麻疹; [or]z8;
measurable: [a]/ˈmeʒərəbl/; [adj]可测量的;重要的,重大的; [or]z8;
meddle: [a]/ˈmedl/; [vi]干预,多管闲事; [or]z8;
mediate: [a]/ˈmiːdieɪt/; [v]调解,调停,斡旋; [or]z8;
medication: [a]/ˌmedɪˈkeɪʃn/; [n]药物;药物治疗;药物处理; [or]z8;
mediocre: [a]/ˌmiːdiˈoʊkər/; [adj]普通的;平凡的;中等的; [or]z8;
meditate: [a]/ˈmedɪteɪt/; [v]考虑,沉思,冥想; [or]z8;
meek: [a]/miːk/; [adj]温顺的,逆来顺受的;谦恭的; [n]温顺的人;谦恭的人; [or]z8;
megaphone: [a]/ˈmeɡəfoʊn/; [n]扩音器,喇叭筒; [v]用扩音器讲; [or]z8;
melodrama: [a]/ˈmelədrɑːmə/; [n]情节剧,传奇剧;音乐戏剧; [or]z8;
membrane: [a]/ˈmembreɪn/; [n]膜;薄膜;羊皮纸; [or]z8;
memento: [a]/məˈmentoʊ/; [n]纪念品; [or]z8;
memorandum: [a]/ˌmeməˈrændəm/; [n]便签,备忘录;报告; [or]z8;
menial: [a]/ˈmiːniəl/; [adj]仆人的,乏味的; [n]家仆; [or]z8;
menopause: [a]/ˈmenəpɔːz/; [n]更年期,活动终止期; [or]z8;
mercantile: [a]/ˈmɜːrkəntaɪl/; [adj]商人的,商业的; [or]z8;
mercenary: [a]/ˈmɜːrsəneri/; [n]外国雇佣兵;唯利是图者; [adj]唯利是图的;雇佣的; [or]z8;
mermaid: [a]/ˈmɜːrmeɪd/; [n]美人鱼(传说中的),女子游泳健将; [or]z8;
mesh: [a]/meʃ/; [n]网,筛孔; [v]相啮合; [or]z8;
mesmerize: [a]/ˈmezməraɪz/; [v]施催眠术;吸引,使神魂颠倒; [or]z8;
metabolism: [a]/məˈtæbəlɪzəm/; [n]新陈代谢; [or]z8;
metallurgy: [a]/ˈmetlɜːrdʒi/; [n]冶金学,冶金术; [or]z8;
metaphysical: [a]/ˌmetəˈfɪzɪkl/; [adj]形而上学的;超自然的;玄学派诗歌的; [or]z8;
meteor: [a]/ˈmiːtiər/; [n]流星,大气现象; [or]z8;
meteorology: [a]/ˌmiːtiəˈrɑːlədʒi/; [n]气象学; [or]z8;
methane: [a]/ˈmeθeɪn/; [n]<有化>甲烷,<能源>沼气; [or]z8;
methodical: [a]/məˈθɑːdɪkl/; [adj]有系统的,有方法的; [or]z8;
methodology: [a]/ˌmeθəˈdɑːlədʒi/; [n]方法论,方法学;(某一学科的)一套方法; [or]z8;
meticulous: [a]/məˈtɪkjələs/; [adj]谨小慎微的;一丝不苟的; [or]z8;
microscope: [a]/ˈmaɪkrəskoʊp/; [n]显微镜; [or]z8;
migraine: [a]/ˈmaɪɡreɪn/; [n]［法］［医］周期性偏头痛; [or]z8;
migrant: [a]/ˈmaɪɡrənt/; [n]候鸟;移民; [or]z8;
mileometer: [a]/maɪˈlɑːmɪtər/; [n]计程表; [or]z8;
militant: [a]/ˈmɪlɪtənt/; [adj]好战的,好暴力的; [n]激进分子,斗士; [or]z8;
mime: [a]/maɪm/; [n]哑剧演员,小丑,笑剧,丑角; [v]作摹拟表演; [or]z8;
mimic: [a]/ˈmɪmɪk/; [v]模仿,戏弄; [n]模仿者; [adj]模拟的;假的,伪装的; [or]z8;
mince: [a]/mɪns/; [v]切碎,小步走路; [n]切碎物; [or]z8;
mirage: [a]/məˈrɑːʒ/; [n]幻影,海市蜃楼; [or]z8;
mire: [a]/ˈmaɪər/; [n]泥沼,困境; [or]z8;
mirth: [a]/mɜːrθ/; [n]欢乐,欢笑; [or]z8;
misappropriate: [a]/ˌmɪsəˈproʊprieɪt/; [v]滥用,误用; [adj]=inappropriate; [or]z8;
miscarriage: [a]/ˈmɪskærɪdʒ/; [n]流产,失败,误送; [or]z8;
miscellaneous: [a]/ˌmɪsəˈleɪniəs/; [adj]多种的,混杂的; [n]杂货;杂项; [or]z8;
misgiving: [a]/ˌmɪsˈɡɪvɪŋ/; [n]疑虑; [vt]担忧;使.疑虑;害怕(misgive的变形); [or]z8;
misplace: [a]/ˌmɪsˈpleɪs/; [v]放错地方; [or]z8;
mitigate: [a]/ˈmɪtɪɡeɪt/; [v]减轻,缓和; [or]z8;
mitten: [a]/ˈmɪtn/; [n]连指手套; [or]z8;
moat: [a]/moʊt/; [n]壕沟,护城河; [or]z8;
mobilize: [a]/ˈmoʊbəlaɪz/; [v]动员起来;动员;鼓动起; [or]z8;
mockery: [a]/ˈmɑːkəri/; [n]嘲弄;笑柄;徒劳无功;拙劣可笑的模仿或歪曲; [or]z8;
module: [a]/ˈmɑːdʒuːl/; [n]组件,模件,(航天器的)舱;(组成一门课程的)独立单元; [or]z8;
molest: [a]/məˈlest/; [v]骚扰,干扰; [or]z8;
mollify: [a]/ˈmɑːlɪfaɪ/; [v]安慰,安抚; [or]z8;
momentary: [a]/ˈmoʊmənteri/; [adj]短暂的,瞬间的; [or]z8;
momentum: [a]/moʊˈmentəm/; [n](物理)动量;势头;动力; [or]z8;
mongrel: [a]/ˈmʌŋɡrəl/; [n]杂种动物,混血儿; [adj]杂种的;杂交的;混血的; [or]z8;
monochrome: [a]/ˈmɑːnəkroʊm/; [adj]单色的; [n]单色画;单色照片,黑白照片; [or]z8;
monogamy: [a]/məˈnɑːɡəmi/; [n]一夫一妻制; [or]z8;
monolingual: [a]/ˌmɑːnəˈlɪŋɡwəl/; [n]只用一种语言的人; [adj]单语的,仅用一种语言的; [or]z8;
monologue: [a]/ˈmɑːnəlɔːɡ/; [n]独白,个人长篇演说; [or]z8;
monotony: [a]/məˈnɑːtəni/; [n]单调乏味,无聊;无变化; [or]z8;
monsoon: [a]/ˌmɑːnˈsuːn/; [n]季雨,季风,大雨; [or]z8;
montage: [a]/ˌmɑːnˈtɑːʒ/; [n]蒙太奇(电影的基本结构手段和叙事方式),混合画,拼集的照片; [or]z8;
monumental: [a]/ˌmɑːnjuˈmentl/; [adj]纪念碑的;不朽的;非常的; [or]z8;
mope: [a]/moʊp/; [v]忧郁,百无聊赖,没精打采地度过; [n]抑郁不乐; [or]z8;
morbid: [a]/ˈmɔːrbɪd/; [adj]疾病的;(精神等)病态的;恐怖的; [or]z8;
mores: [a]/ˈmɔːreɪz/; [n]风俗习惯,道德观念; [or]z8;
moribund: [a]/ˈmɔːrɪbʌnd/; [adj]濒临失败的,垂死的; [n]垂死的人; [or]z8;
morphine: [a]/ˈmɔːrfiːn/; [n]吗啡; [or]z8;
mortality: [a]/mɔːrˈtæləti/; [n]死亡数,死亡率;必死的命运; [or]z8;
mortar: [a]/ˈmɔːrtər/; [n]小臼,乳钵,迫击炮,(砌砖用的)灰浆; [v]用迫击炮攻击;用灰泥涂抹; [or]z8;
mortgage: [a]/ˈmɔːrɡɪdʒ/; [n]按揭贷款,抵押贷款; [v]抵押; [or]z8;
mortuary: [a]/ˈmɔːrtʃueri/; [n]太平间,停尸间; [adj]死的,悲哀的; [or]z8;
mosaic: [a]/moʊˈzeɪɪk/; [n]镶嵌细工,马赛克; [adj]摩西的;拼花的; [vt]镶嵌;用马赛克装饰; [or]z8;
motif: [a]/moʊˈtiːf/; [n]基本图案;主题,中心思想,<音>乐旨; [or]z8;
motionless: [a]/ˈmoʊʃnləs/; [adj]静止的;不运动的; [or]z8;
motley: [a]/ˈmɑːtli/; [adj]混杂的,杂色的; [n]混杂;杂色衣服;小丑; [or]z8;
mound: [a]/maʊnd/; [n]堆,高地,护堤; [v]堆起,积成堆; [or]z8;
movable: [a]/ˈmuːvəbl/; [adj]动产的;可移动的;不固定的; [n]动产;可移动的东西; [or]z8;
muddle: [a]/ˈmʌdl/; [n]混乱,杂乱,(头脑的)糊涂; [v](使)混乱,(使)迷惑,混淆; [adj]引起困惑的;使人糊涂的;难以理解的; [or]z8;
muffin: [a]/ˈmʌfɪn/; [n]小松饼; [or]z8;
multilateral: [a]/ˌmʌltiˈlætərəl/; [adj]<数学>多边的;多国之间的,多国(或多方)参加的; [or]z8;
multitude: [a]/ˈmʌltɪtuːd/; [n]大量;众多;大批;群众; [or]z8;
mumble: [a]/ˈmʌmbl/; [v]含糊地说;抿着嘴嚼; [n]含糊的话;咕噜; [or]z8;
mummy: [a]/ˈmʌmi/; [n]木乃伊,干瘪的人,妈咪(口语); [or]z8;
mumps: [a]/mʌmps/; [n]<内科>流行性腮腺炎; [or]z8;
mundane: [a]/mʌnˈdeɪn/; [adj]普通的,平凡的;单调的;现世的,世俗的; [or]z8;
municipality: [a]/mjuːˌnɪsɪˈpæləti/; [n]市民;市政当局;自治市或区; [or]z8;
mural: [a]/ˈmjʊrəl/; [n]壁画;壁饰; [adj]墙壁的;挂在墙壁上的; [or]z8;
muse: [a]/mjuːz/; [v]沉思;冥想; [n]<希神>缪斯女神,灵感; [or]z8;
mussel: [a]/ˈmʌsl/; [n]蚌类; [or]z8;
muster: [a]/ˈmʌstər/; [vi]集合;聚集; [vt]集合;召集; [n]集合;集合人员; [or]z8;
mutant: [a]/ˈmjuːtənt/; [n]突变体,突变异种; [adj]突变的; [or]z8;
mutilate: [a]/ˈmjuːtɪleɪt/; [v]残害,切断(手足等),使残缺不全; [or]z8;
muzzle: [a]/ˈmʌzl/; [n]动物之鼻口,(动物的)口套,钳制言论的手段,枪口,喷嘴; [vt]戴口络于,上口罩; [or]z8;
myriad: [a]/ˈmɪriəd/; [n]无数;极大数量; [adj]无数的; [or]z8;
mythology: [a]/mɪˈθɑːlədʒi/; [n]神话,神话学; [or]z8;
nab: [a]/næb/; [v]逮捕,攫取; [or]z8;
nag: [a]/næɡ/; [n]老马,驽马,劣等竞赛马,(作坐骑的)矮小马,唠叨; [v]不断地唠叨,恼人; [or]z8;
nappy: [a]/ˈnæpi/; [n]尿布; [adj]起毛的; [or]z8;
narcissus: [a]/nɑːrˈsɪsəs/; [n]水仙; [or]z8;
nasal: [a]/ˈneɪzl/; [adj]鼻的,鼻音的; [n]鼻骨,鼻音,鼻音字; [or]z8;
nautical: [a]/ˈnɔːtɪkl/; [adj]航海的;海上的;海员的; [or]z8;
nebulous: [a]/ˈnebjələs/; [adj]朦胧的,星云的,星云状的; [or]z8;
nectar: [a]/ˈnektər/; [n]花蜜,甘露; [adj]〈古〉充满美酒的,芳香甜蜜的; [or]z8;
negate: [a]/nɪˈɡeɪt/; [vt]取消,使无效;否定,否认; [n]反面,对立面; [vi]否定,否认; [or]z8;
negligent: [a]/ˈneɡlɪdʒənt/; [adj]疏忽的,粗心大意的;随意的; [or]z8;
negligible: [a]/ˈneɡlɪdʒəbl/; [adj]微不足道的,可忽略不计的; [or]z8;
negotiable: [a]/nɪˈɡoʊʃiəbl/; [adj]可谈判的,可商议的;可兑换现金的;可通行的(道路,河流); [or]z8;
neoclassical: [a]/ˌniːoʊˈklæsɪkl/; [adj]新古典主义的; [or]z8;
neon: [a]/ˈniːɑːn/; [n]氖;霓虹灯; [adj]霓虹的; [or]z8;
nestle: [a]/ˈnesl/; [vt]依偎; [vi](舒适地)安顿;抱; [v]半隐半现地处于;安顿下来; [or]z8;
neural: [a]/ˈnʊrəl/; [adj]神经的;神经系统的;背的;神经中枢的; [or]z8;
neurosis: [a]/nʊˈroʊsɪs/; [n]<心理>神经症,神经衰弱症; [or]z8;
neurotic: [a]/nʊˈrɑːtɪk/; [adj]神经质的;神经官能病的; [n]神经病患者; [or]z8;
neutralize: [a]/ˈnuːtrəlaɪz/; [v]宣布中立,使中立化;使无效;中和; [or]z8;
nib: [a]/nɪb/; [n]钢笔尖; [or]z8;
nibble: [a]/ˈnɪbl/; [v]一点点地咬,慢慢啃,吹毛求疵; [n]细咬,轻咬,啃; [or]z8;
niche: [a]/nɪtʃ/; [n]壁龛;合适的职业,生活方式;(有利可图的)市场,商机; [vt]放在适当的位置; [or]z8;
nicotine: [a]/ˈnɪkətiːn/; [n]尼古丁; [or]z8;
nimble: [a]/ˈnɪmbl/; [adj]敏捷的,灵活的,机智的; [or]z8;
nip: [a]/nɪp/; [v]咬;捏;剪断;冻伤;阻止; [n]夹;捏;刺骨;小饮; [or]z8;
nipple: [a]/ˈnɪpl/; [n]乳头;奶嘴; [or]z8;
nirvana: [a]/nɪrˈvɑːnə/; [n]涅槃,心灵的平静,极乐; [or]z8;
nitrate: [a]/ˈnaɪtreɪt/; [n]硝酸盐,氮肥; [vt]用硝酸处理;使硝化; [or]z8;
node: [a]/noʊd/; [n]节点,瘤,<数>叉点; [or]z8;
nomad: [a]/ˈnoʊmæd/; [n]流浪者,游牧民; [adj]游牧的;流浪的; [or]z8;
nomadic: [a]/noʊˈmædɪk/; [adj]游牧的;流浪的;游动的; [or]z8;
nomenclature: [a]/ˈnoʊmənkleɪtʃər/; [n]术语,命名系统; [or]z8;
nominal: [a]/ˈnɑːmɪnl/; [adj]名义上的;象征性的,很少的;名词性的; [or]z8;
nominee: [a]/ˌnɑːmɪˈniː/; [n]被任命者,被提名的人,代名人; [or]z8;
nonchalant: [a]/ˌnɑːnʃəˈlɑːnt/; [adj]若无其事的;满不在乎的;冷静的;冷漠的; [or]z8;
nonstop: [a]/nɒn'stɒp/; [adj]直达的,不休息的,不着陆的; [adv]不休息地; [n]直达车,班机; [or]z8;
norm: [a]/nɔːrm/; [n]准则;模范;规范,标准; [or]z8;
nostalgia: [a]/nəˈstældʒə/; [n]怀旧之情,思乡病; [or]z8;
nostalgic: [a]/nəˈstældʒɪk/; [adj]乡愁的,怀旧的;怀旧的; [or]z8;
notary: [a]/ˈnoʊtəri/; [n]公证人;公证员; [or]z8;
notation: [a]/noʊˈteɪʃn/; [n]记号;标记法;记录; [or]z8;
notification: [a]/ˌnoʊtɪfɪˈkeɪʃn/; [n]通知,布告,告示; [or]z8;
notwithstanding: [a]/ˌnɑːtwɪθˈstændɪŋ/; prep. 尽管,虽然; [adv]尽管,虽然; [conj]尽管,虽然; [or]z8;
novelty: [a]/ˈnɑːvlti/; [n]新奇;新奇的事物;新颖小巧而廉价的小物品; [adj]新奇的;风格独特的; [or]z8;
novice: [a]/ˈnɑːvɪs/; [n]生手,新手; [or]z8;
nuance: [a]/ˈnuːɑːns/; [n]细微差别; [or]z8;
nucleus: [a]/ˈnuːkliəs/; [n]原子核,核心,细胞核; [or]z8;
nude: [a]/nuːd/; [adj]赤裸的,与生俱有的,无装饰的; [n]裸体者;裸体画; [v]〈罕〉使裸; [or]z8;
nudge: [a]/nʌdʒ/; [v](用臂肘)轻推(促其注意),鼓动,接近; [n]推动,用肘轻推; [or]z8;
nudity: [a]/ˈnuːdəti/; [n]裸露,裸体像; [or]z8;
numb: [a]/nʌm/; [adj]麻木的,失去知觉的; [vt]使麻木,使失去知觉; [or]z8;
nurture: [a]/ˈnɜːrtʃər/; [v]养育,培育;培植; [n]养育,培养;教养;营养物; [or]z8;
nutrient: [a]/ˈnuːtriənt/; [n]营养物;滋养物; [adj]营养的;滋养的; [or]z8;
nuzzle: [a]/ˈnʌzl/; [v]用鼻紧挨,用鼻爱抚,紧贴某人; [or]z8;
nymph: [a]/nɪmf/; [n]年轻女神,少女,蛹; [or]z8;
oasis: [a]/oʊˈeɪsɪs/; [n]绿洲;令人欣慰的事物; [or]z8;
obese: [a]/oʊˈbiːs/; [adj]肥胖的;过胖的; [or]z8;
obesity: [a]/oʊˈbiːsəti/; [n]肥胖; [or]z8;
obituary: [a]/oʊˈbɪtʃueri/; [n]讣告; [adj]关于死者的,讣告的; [or]z8;
obligatory: [a]/əˈblɪɡətɔːri/; [adj]强制性的;义务的;必须的; [or]z8;
obliterate: [a]/əˈblɪtəreɪt/; [v]消灭;涂去;冲刷;忘掉; [or]z8;
obscene: [a]/əbˈsiːn/; [adj]下流的,淫秽的; [or]z8;
observance: [a]/əbˈzɜːrvəns/; [n](法律习俗等的)遵守;奉行;庆祝,礼仪,仪式; [or]z8;
observant: [a]/əbˈzɜːrvənt/; [adj]机警的;严格遵守的;善于观察的; [or]z8;
obsess: [a]/əbˈses/; [vt]迷住,使着迷,使烦扰; [or]z8;
obsessive: [a]/əbˈsesɪv/; [adj]强迫性的;着迷的;分神的; [n]强迫症患者; [or]z8;
obsolete: [a]/ˌɑːbsəˈliːt/; [adj]已过时的;已废弃的; [v]使过时;使作废; [n]废词;被废弃的事物; [or]z8;
occidental: [a]/ˌɑːksɪˈdentl/; [n]西方,西洋人; [adj]西方(的); [or]z8;
octopus: [a]/ˈɑːktəpʊs/; [n]章鱼; [or]z8;
odds: [a]/ɑːdz/; [n]几率;可能性;投注赔率;优势;差异,不平等; [or]z8;
ode: [a]/oʊd/; [n]长诗,颂歌; [or]z8;
odor: [a]/ˈoʊdər/; [n]气味; [or]z8;
offensive: [a]/əˈfensɪv/; [adj]冒犯的,进攻的,无礼的,令人不快的,得罪人的; [n]进攻; [or]z8;
ointment: [a]/ˈɔɪntmənt/; [n]药膏,<药>油膏; [or]z8;
omelet: [a]/ˈɑːmlət/; [n]煎蛋卷; [or]z8;
omelette: [a]/ˈɑːmlət/; [n]煎蛋卷,摊鸡蛋,鸡蛋饼; [or]z8;
ominous: [a]/ˈɑːmɪnəs/; [adj]不祥的,不吉利的; [or]z8;
omniscient: [a]/ɑːmˈnɪsiənt/; [adj]无所不知的,博识的; [n]无所不知者,上帝; [or]z8;
ongoing: [a]/ˈɑːnɡoʊɪŋ/; [n]进行,前进,发展; [adj]进行中的,不间断的; [or]z8;
onomatopoeia: [a]/ˌɑːnəˌmætəˈpiːə/; [n]拟声,拟声词; [or]z8;
onset: [a]/ˈɑːnset/; [n]开始;攻击,袭击; [or]z8;
onslaught: [a]/ˈɑːnslɔːt/; [n]猛攻,猛袭; [or]z8;
ooze: [a]/uːz/; [v](使)渗出,流出,泄漏; [n]软泥,渗出物; [or]z8;
opaque: [a]/oʊˈpeɪk/; [adj]不透明的;难懂的; [or]z8;
operational: [a]/ˌɑːpəˈreɪʃənl/; [adj]操作的,运转的; [or]z8;
operative: [a]/ˈɑːpərətɪv/; [n]技工;特工;侦探; [adj]运转着的,从事生产劳动的;有效的; [or]z8;
opt: [a]/ɑːpt/; [v]选择; [or]z8;
optimum: [a]/ˈɑːptɪməm/; [adj]最适宜的;最佳的; [n]最适条件;最适宜; [or]z8;
opulent: [a]/ˈɑːpjələnt/; [adj]富裕的,充足的; [or]z8;
opus: [a]/ˈoʊpəs/; [n]作品; [or]z8;
oracle: [a]/ˈɔːrəkl/; [n]代神发布神谕的人,神使,圣贤; [or]z8;
orator: [a]/ˈɔːrətər/; [n]演说者,演讲者,雄辩家,原告; [or]z8;
orbital: [a]/ˈɔːrbɪtl/; [adj]轨道的;(城市)外环路的; [or]z8;
orchestrate: [a]/ˈɔːrkɪstreɪt/; [v]精心安排,编管弦乐曲,协调; [or]z8;
orchid: [a]/ˈɔːrkɪd/; [n]兰花,淡紫色; [or]z8;
ordain: [a]/ɔːrˈdeɪn/; [v]注定;规定;任命(牧师);颁布命令; [or]z8;
ordinance: [a]/ˈɔːrdɪnəns/; [n]法令;条例;条例;圣餐式; [or]z8;
orgy: [a]/ˈɔːrdʒi/; [n]狂欢;放荡; [or]z8;
orientation: [a]/ˌɔːriənˈteɪʃn/; [n]信仰;倾向;<计>定向;(学生)迎新会;定向,方向;(任职,上学等之前的) 情况介绍;训练; [or]z8;
ornate: [a]/ɔːrˈneɪt/; [adj]装饰华丽的;修辞上极考究的; [or]z8;
orthodoxy: [a]/ˈɔːrθədɑːksi/; [n]正统,正教,正统说法; [or]z8;
ostentatious: [a]/ˌɑːstenˈteɪʃəs/; [adj]浮华的,虚饰的,外观美丽的; [or]z8;
oust: [a]/aʊst/; [v]罢免,驱逐,剥夺,取代; [or]z8;
outcast: [a]/ˈaʊtkæst/; [n]被逐出者;流浪者; [adj]被抛弃的,被逐出的; [or]z8;
outcry: [a]/ˈaʊtkraɪ/; [n]大声喊叫;强烈抗议;拍卖; [or]z8;
outfit: [a]/ˈaʊtfɪt/; [n]装备,全部用品,(协同工作)的一组人; [v]提供装备; [or]z8;
outgoing: [a]/ˈaʊtɡoʊɪŋ/; [adj]外向的;外出的;乐于助人的;即将离职的,卸任的; [n]流出;开支; [or]z8;
outgrow: [a]/ˌaʊtˈɡroʊ/; [v]长得过大而不适于;长大成熟而不再;长的比..快; [or]z8;
outlandish: [a]/aʊtˈlændɪʃ/; [adj]稀奇古怪的,奇特的;异国风情的; [or]z8;
outlay: [a]/ˈaʊtleɪ/; [v]花费; [n]<会计>费用;支出;经费; [or]z8;
outnumber: [a]/ˌaʊtˈnʌmbər/; [v]在数量上超过; [or]z8;
outright: [a]/ˈaʊtraɪt/; [adj]完全的,彻底的,全部地;直率的; [adv]完全地;直率地,痛快地;直截了当地; [or]z8;
outspoken: [a]/aʊtˈspoʊkən/; [adj]直言的,坦率的; [or]z8;
outweigh: [a]/ˌaʊtˈweɪ/; [v]比..重要;比..有价值;比.重; [or]z8;
ovation: [a]/oʊˈveɪʃn/; [n]热烈欢迎,欢呼; [or]z8;
overshadow: [a]/ˌoʊvərˈʃædoʊ/; [v]遮蔽,使显得不重要; [or]z8;
oversight: [a]/ˈoʊvərsaɪt/; [n]勘漏,疏忽,失察;监督; [or]z8;
overt: [a]/oʊˈvɜːrt/; [adj]明显的;公开的;公然的; [or]z8;
overture: [a]/ˈoʊvərtʃər/; [n]主动表示,姿态;前奏曲;序言,事件的开端;提出问题; [vt]作为一种主动姿态提出;向.提出建议; [or]z8;
overview: [a]/ˈoʊvərvjuː/; [n]综述,概观; [or]z8;
oxidize: [a]/ˈɑːksɪdaɪz/; [v]生锈;氧化; [or]z8;
pacify: [a]/ˈpæsɪfaɪ/; [v]使平静,安慰,抚慰; [or]z8;
padlock: [a]/ˈpædlɑːk/; [n]挂锁,关闭,禁止进入; [v]用挂锁锁上,关闭; [or]z8;
pageant: [a]/ˈpædʒənt/; [n]盛会,历史剧,选美; [or]z8;
painstaking: [a]/ˈpeɪnzteɪkɪŋ/; [adj](不辞)劳苦的,辛勤的; [n]辛劳,煞费苦心; [or]z8;
pal: [a]/pæl/; [n]伙伴,好朋友; [v]交友; [or]z8;
palatable: [a]/ˈpælətəbl/; [adj]美味的,合口味的,合心意的; [or]z8;
palate: [a]/ˈpælət/; [n]味觉;上颚;趣味; [or]z8;
palette: [a]/ˈpælət/; [n]调色板,一套颜料; [or]z8;
palpable: [a]/ˈpælpəbl/; [adj]明显的,易觉察的,可触知的; [or]z8;
pamper: [a]/ˈpæmpər/; [v]纵容,过分关怀,精心照料; [or]z8;
panacea: [a]/ˌpænəˈsiːə/; [n]灵丹妙药,万能药; [or]z8;
pancake: [a]/ˈpænkeɪk/; [n]烙饼,薄饼; [or]z8;
pang: [a]/pæŋ/; [n]剧痛,痛苦; [v]使剧痛,折磨; [or]z8;
panoramic: [a]/ˌpænəˈræmɪk/; [adj]全景的; [or]z8;
pant: [a]/pænt/; [v]喘息;气喘吁吁地说;喘气; [n]喘气; [or]z8;
panther: [a]/ˈpænθər/; [n]豹;黑豹; [or]z8;
pantomime: [a]/ˈpæntəmaɪm/; [n]哑剧,〈英〉(圣诞节上演的)童话剧; [vi]打手势,演哑剧; [or]z8;
parable: [a]/ˈpærəbl/; [n]寓言,比喻; [or]z8;
paradigm: [a]/ˈpærədaɪm/; [n]范例,示范; [or]z8;
paralysis: [a]/pəˈræləsɪs/; [n]瘫痪(症),麻痹(症); [or]z8;
parameter: [a]/pəˈræmɪtər/; [n]决定因素;界限;参(变)数;参量; [or]z8;
paramount: [a]/ˈpærəmaʊnt/; [n]元首;最高; [adj]最高的,至上的,首要的; [or]z8;
paranoia: [a]/ˌpærəˈnɔɪə/; [n](心理)偏执狂,多疑症; [or]z8;
paranoid: [a]/ˈpærənɔɪd/; [adj]偏执狂的,过分怀疑的; [or]z8;
paraphrase: [a]/ˈpærəfreɪz/; [v]解释,释义; [n]转述,释义; [or]z8;
parasite: [a]/ˈpærəsaɪt/; [n]寄生虫;靠他人为生的人; [or]z8;
pare: [a]/per/; [v]削去,剥去; [or]z8;
parenthetical: [a]/ˌpærənˈθetɪkl/; [adj]作为插入语的,放在括号里的,［喻］插曲的; [or]z8;
parenthood: [a]/ˈperənthʊd/; [n]亲子关系,父母身份; [or]z8;
parody: [a]/ˈpærədi/; [n]嘲弄文章,拙劣的模仿; [v]拙劣模仿; [or]z8;
parole: [a]/pəˈroʊl/; [n]特别口令;假释; [v]有条件释放,假释;使假释出狱;宣誓后释放; [adj]假释的; [or]z8;
parry: [a]/ˈpæri/; [v]挡开,避开(武器,问题等); [or]z8;
parson: [a]/ˈpɑːrsn/; [n]教区牧师; [or]z8;
partake: [a]/pɑːrˈteɪk/; [v]分享,参与,分担; [n]参与者,分担者; [or]z8;
partisan: [a]/ˈpɑːrtəzn/; [adj]党派的;效忠的;偏袒的;盲目推崇的; [n]党羽;虔诚信徒;游击队; [or]z8;
pasta: [a]/ˈpɑːstə/; [n]意大利面食; [or]z8;
pastel: [a]/pæˈstel/; [n]柔和的色彩,彩色粉笔画;粉蜡笔; [adj]柔和的;彩色蜡笔的,粉蜡笔的; [or]z8;
pastoral: [a]/ˈpæstərəl/; [adj]田园生活的,牧师的; [n]牧歌;田园诗;田园景色;牧师写给教区居民的公开信; [or]z8;
pastry: [a]/ˈpeɪstri/; [n]糕点,点心; [or]z8;
patchy: [a]/ˈpætʃi/; [adj]断续的,不连贯的;良莠不齐的,好坏掺杂的;不充足的; [or]z8;
patio: [a]/ˈpætioʊ/; [n]屋内庭院,天井;平台; [or]z8;
patriarch: [a]/ˈpeɪtriɑːrk/; [n]家长;族长;创办人;最年长者; [or]z8;
patriarchal: [a]/ˌpeɪtriˈɑːrkl/; [adj]族长的;家长的;可尊敬的;德高望重的; [or]z8;
patronage: [a]/ˈpætrənɪdʒ/; [n]惠顾;赞助;任免权; [or]z8;
patronize: [a]/ˈpeɪtrənaɪz/; [v]惠顾;赞助,资助; [or]z8;
patter: [a]/ˈpætər/; [n]行话,轻快脚步声,急速拍打声; [v]滴答地响,急速地说,发出急速轻拍声,使.发出嗒嗒声; [or]z8;
pawn: [a]/pɔːn/; [n]典当;抵押物;兵,卒;人质; [v]当掉;以..担保; [or]z8;
payroll: [a]/ˈpeɪroʊl/; [n]工资单; [or]z8;
peat: [a]/piːt/; [n]泥煤,泥炭块,泥炭色; [or]z8;
pedagogic: [a]/ˌpedəˈɡɑːdʒɪk/; [adj]教育学的; [or]z8;
pedestal: [a]/ˈpedɪstl/; [n](雕像等)基座,支座,受人尊敬的地位; [vt]搁在台上,颂扬; [or]z8;
pedigree: [a]/ˈpedɪɡriː/; [n]血统,家谱;出身,门第;(纯种家畜的)血统表;纯种;(语言的)起源; [or]z8;
peek: [a]/piːk/; [v]偷看,窥视; [n]偷看,窥见; [or]z8;
penalize: [a]/ˈpiːnəlaɪz/; [v]置(某人)于不利地位,处罚; [or]z8;
pendant: [a]/ˈpendənt/; [n]吊坠,下垂物; [or]z8;
pendent: [a]/'pendənt/; [adj]吊着的,悬挂的; [or]z8;
penis: [a]/ˈpiːnɪs/; [n]阳物,阴茎; [or]z8;
pensioner: [a]/ˈpenʃənər/; [n]领取养老金者,退休的人;随从; [or]z8;
pentathlon: [a]/penˈtæθlən/; [n]五项运动,五项全能运动; [or]z8;
perceptible: [a]/pərˈseptəbl/; [adj]可察觉的,可注意到的; [or]z8;
perception: [a]/pərˈsepʃn/; [n]洞察力,理解力;洞察力,理解力,认识,观念,看法; [or]z8;
perceptive: [a]/pərˈseptɪv/; [adj]感知的,知觉的;有知觉力的; [or]z8;
percussion: [a]/pərˈkʌʃn/; [n]撞击,敲击;敲打乐器; [or]z8;
perfunctory: [a]/pərˈfʌŋktəri/; [adj]草率的,敷衍搪塞的; [or]z8;
perilous: [a]/ˈperələs/; [adj]危险的; [or]z8;
perimeter: [a]/pəˈrɪmɪtər/; [n]周长;周界; [or]z8;
peripheral: [a]/pəˈrɪfərəl/; [adj]外围的; [n]外围设备; [or]z8;
periphery: [a]/pəˈrɪfəri/; [n]外围,不重要的部份; [or]z8;
perish: [a]/ˈperɪʃ/; [vi]死去;毁灭,灭亡; [v]脆裂,老化,腐烂; [or]z8;
perjury: [a]/ˈpɜːrdʒəri/; [n]伪证,假誓; [or]z8;
perk: [a]/pɜːrk/; [v]昂首,意气洋洋,振作; [n]好处;福利; [adj]〈罕〉同"perky"; [or]z8;
permeate: [a]/ˈpɜːrmieɪt/; [v]弥漫;普及;渗透; [or]z8;
permissible: [a]/pərˈmɪsəbl/; [adj]容许的;许可的; [or]z8;
pernicious: [a]/pərˈnɪʃəs/; [adj]有害的,恶性的,致命的; [or]z8;
perpetrate: [a]/ˈpɜːrpətreɪt/; [vt]犯罪,作恶;干坏事; [or]z8;
perpetrator: [a]/ˈpɜːrpətreɪtər/; [n]作恶者,犯罪者,行凶者; [or]z8;
perpetuate: [a]/pərˈpetʃueɪt/; [adj]长存的; [vt]使永久存在,使不朽; [or]z8;
pertain: [a]/pərˈteɪn/; [vi]属于;适合;有关; [or]z8;
pertinent: [a]/ˈpɜːrtnənt/; [adj]有关的;适当的;中肯的; [n]附属物;参考; [or]z8;
perturb: [a]/pərˈtɜːrb/; [vt]使不安;烦扰;使紊乱; [or]z8;
pervade: [a]/pərˈveɪd/; [vt]普及;渗透;弥漫; [vi]弥漫;渗透; [or]z8;
pervert: [a]/ˈpɜːrvɜːrt/; [v]使堕落,误导,曲解; [n]变态,色狼; [or]z8;
pester: [a]/ˈpestər/; [v]使烦恼,纠缠; [or]z8;
pesticide: [a]/ˈpestɪsaɪd/; [n]杀虫剂;农药; [or]z8;
pharmaceutical: [a]/ˌfɑːrməˈsuːtɪkl/; [adj]制药的,药物的; [n]药物; [or]z8;
pheasant: [a]/ˈfeznt/; [n]野鸡,雉科鸟; [or]z8;
phenomenal: [a]/fəˈnɑːmɪnl/; [adj]非凡的;现象的;显著的; [or]z8;
philanthropic: [a]/ˌfɪlənˈθrɑːpɪk/; [adj]博爱的,为他人着想的; [or]z8;
phosphorus: [a]/ˈfɑːsfərəs/; [n]磷; [or]z8;
physique: [a]/fɪˈziːk/; [n]体格,体魄; [or]z8;
picket: [a]/ˈpɪkɪt/; [n]警戒哨,纠察队,尖木桩; [v]派..担任纠察,担任纠察; [or]z8;
pickle: [a]/ˈpɪkl/; [n]盐汁;泡菜; [v]腌; [or]z8;
pier: [a]/pɪr/; [n]码头;桥墩; [or]z8;
piety: [a]/ˈpaɪəti/; [n]虔诚,虔诚的行为或语言; [or]z8;
pigsty: [a]/ˈpɪɡstaɪ/; [n]猪圈,脏乱的地方; [or]z8;
pike: [a]/paɪk/; [n]矛,长枪,梭子鱼; [vt]用矛刺穿; [or]z8;
pinch: [a]/pɪntʃ/; [v]捏,掐,夹痛; [n]捏;少量,一撮;困苦; [or]z8;
pinpoint: [a]/ˈpɪnpɔɪnt/; [v]准确地解释或说明; [adj]精确的; [n]针尖,极小之物,极不重要的事物; [or]z8;
piracy: [a]/ˈpaɪrəsi/; [n]海上掠夺;剽窃;侵犯版权; [or]z8;
piss: [a]/pɪs/; [int]〈美俚〉呸; [v]小便; [n]小便; [or]z8;
piston: [a]/ˈpɪstən/; [n]活塞,瓣; [or]z8;
pitcher: [a]/ˈpɪtʃər/; [n]<棒球>投手,水罐,<植>瓶状叶; [or]z8;
pitfall: [a]/ˈpɪtfɔːl/; [n]陷阱,未料到的危险或困难; [or]z8;
pivot: [a]/ˈpɪvət/; [n]枢轴,中心; [v]以..为中心转动; [adj]枢轴的;关键的; [or]z8;
pivotal: [a]/ˈpɪvətl/; [adj]关键的,枢轴的; [or]z8;
plaintiff: [a]/ˈpleɪntɪf/; [n]原告; [or]z8;
plank: [a]/plæŋk/; [n]厚木板;木板制成物;政纲条款;要点; [v]在..上铺板;砰一声放下;用菜板端出; [or]z8;
plaque: [a]/plæk/; [n]饰板,匾,斑块; [or]z8;
plasma: [a]/ˈplæzmə/; [n]血浆;等离子体;深绿玉髓; [or]z8;
plaster: [a]/ˈplæstər/; [n]灰泥,石膏; [v]抹泥; [or]z8;
platoon: [a]/pləˈtuːn/; [n]排,一组,一队人,警察队; [vt]把.分成小队; [or]z8;
plea: [a]/pliː/; [n](法律)抗辩;恳求;请求,托词,口实; [or]z8;
plead: [a]/pliːd/; [v]恳求,辩护,(不)认罪;提出.为理由; [or]z8;
pleat: [a]/pliːt/; [n]褶,褶状物; [or]z8;
plight: [a]/plaɪt/; [n]困境; [v]宣誓,保证; [or]z8;
plumb: [a]/plʌm/; [n]铅锤,测锤; [vi]垂直悬挂; [adj]垂直的; [vt]用铅锤测量; [adv]垂直地; [or]z8;
plummet: [a]/ˈplʌmɪt/; [v]垂直或突然地堕下,骤然下降; [n]测锤(钓丝的)坠子;线锤;铅锤线;锤规; [or]z8;
plush: [a]/plʌʃ/; [n]长毛绒; [adj]豪华的,长毛绒做的,舒服的; [or]z8;
poach: [a]/poʊtʃ/; [v]水煮;小火煮;偷猎;窃取; [or]z8;
polarity: [a]/pəˈlærəti/; [n](分)极性;相对的观点; [or]z8;
polemic: [a]/pəˈlemɪk/; [n]争论,论战,驳斥; [adj]论战的;喜欢争论的; [or]z8;
pollen: [a]/ˈpɑːlən/; [n]花粉; [or]z8;
pollster: [a]/ˈpoʊlstər/; [n]民意测验专家,民意调查人;整理民意测验结果的人; [or]z8;
pompous: [a]/ˈpɑːmpəs/; [adj]傲慢的,浮华的; [or]z8;
poplar: [a]/ˈpɑːplər/; [n]白杨; [or]z8;
poppy: [a]/ˈpɑːpi/; [n]罂粟花,罂粟属植物; [or]z8;
populous: [a]/ˈpɑːpjələs/; [adj]人口稠密的,人口众多的; [or]z8;
pore: [a]/pɔːr/; [n]毛孔,细孔; [v]深思熟虑,仔细阅读,审视; [or]z8;
portfolio: [a]/pɔːrtˈfoʊlioʊ/; [n]公文包,文件夹,投资组合;股份单; [or]z8;
posthumous: [a]/ˈpɑːstʃəməs/; [adj]遗腹的;著作者死后出版的;死后的; [or]z8;
postscript: [a]/ˈpoʊstskrɪpt/; [n]附言;后评; [or]z8;
posture: [a]/ˈpɑːstʃər/; [n]姿势;看法;态度; [v]装模作样; [or]z8;
potent: [a]/ˈpoʊtnt/; [adj]强有力的;有权势的;有说服力的; [or]z8;
pouch: [a]/paʊtʃ/; [n]小袋,烟草袋,钱袋,育儿袋; [v]把..装入袋中,使成袋状; [or]z8;
pounce: [a]/paʊns/; [n]猛扑,飞扑; [vi]猛扑,突然袭击; [vt]扑过去抓住; [or]z8;
practicality: [a]/ˌpræktɪˈkæləti/; [n]实用性,实际性;实际,实例; [or]z8;
pragmatic: [a]/præɡˈmætɪk/; [adj]国事的,团体事务的;实际的,注重实效的; [n]爱管闲事的人;专断的人;国事诏书;实际家; [or]z8;
precarious: [a]/prɪˈkeriəs/; [adj]不稳定的;危险的;可疑的;说不定的; [or]z8;
precinct: [a]/ˈpriːsɪŋkt/; [n]管理区,管辖区;选区;界限,范围; [or]z8;
precipitate: [a]/prɪˈsɪpɪteɪt/; [v]促成,使..沉淀,猛摔;<气象>凝结; [n]沉淀物,冷凝物; [adj]突如其来的,仓促的,迅猛的;感情用事的; [or]z8;
precipitous: [a]/prɪˈsɪpɪtəs/; [adj]险峻的;急躁的,鲁莽的; [or]z8;
preclude: [a]/prɪˈkluːd/; [v]阻止;排除; [or]z8;
predatory: [a]/ˈpredətɔːri/; [adj]掠夺的;捕食生物的; [or]z8;
predicament: [a]/prɪˈdɪkəmənt/; [n]困境,穷境,尴尬的处境; [or]z8;
preferential: [a]/ˌprefəˈrenʃl/; [adj]优先的;选择的;特惠的; [or]z8;
premature: [a]/ˌpriːməˈtʃʊr/; [adj]早产的,过早的,早熟的; [n]早产儿; [or]z8;
premiere: [a]/prɪˈmɪr/; [n]首次公演; [vi]首次上演; [vt]初次演出; [adj]初次的,女主角的; [or]z8;
premium: [a]/ˈpriːmiəm/; [adj]高级的;高价的;(汽油)辛烷值高的; [n]额外费用,溢价;保险金; [or]z8;
premonition: [a]/ˌpriːməˈnɪʃn/; [n]预告,征兆,预感; [or]z8;
prenatal: [a]/ˌpriːˈneɪtl/; [adj]产前的,胎儿期的,<医>出生以前的; [or]z8;
preoccupied: [a]/priˈɑːkjupaɪd/; [adj]全神贯注的,心事重重的,被先占的; [or]z8;
prerequisite: [a]/ˌpriːˈrekwəzɪt/; [n]先决条件,必要条件; [adj]必须先具备的,必要的; [or]z8;
preschool: [a]/ˈpriːskuːl/; [adj]未满学龄的,就学前的,入学前的; [n]幼儿园,育幼院; [or]z8;
presumption: [a]/prɪˈzʌmpʃn/; [n]放肆,傲慢;推测; [or]z8;
pretentious: [a]/prɪˈtenʃəs/; [adj]做作的,自命不凡的,炫耀的; [or]z8;
prevalent: [a]/ˈprevələnt/; [adj]普遍的,流行的; [or]z8;
prism: [a]/ˈprɪzəm/; [n]棱镜;棱柱; [or]z8;
pristine: [a]/ˈprɪstiːn/; [adj]原始的;古时的;纯朴的;崭新的; [or]z8;
probation: [a]/proʊˈbeɪʃn/; [n]试用;缓刑;察看; [or]z8;
problematic: [a]/ˌprɑːbləˈmætɪk/; [adj]问题的;有疑问的;不确定的; [or]z8;
procedural: [a]/prəˈsiːdʒərəl/; [adj]程序上的; [or]z8;
procure: [a]/prəˈkjʊr/; [vt](努力)取得;获得;导致;完成; [vi]介绍娼妓;拉皮条; [or]z8;
prod: [a]/prɑːd/; [n]刺针;刺棒;签子; [v]刺;戳;刺激; [or]z8;
prodigal: [a]/ˈprɑːdɪɡl/; [adj]挥霍的,十分慷慨的; [n]浪子,挥霍者; [or]z8;
prodigy: [a]/ˈprɑːdədʒi/; [n]天才; [or]z8;
profess: [a]/prəˈfes/; [v]表示,承认;宣称; [or]z8;
profiteer: [a]/ˌprɑːfəˈtɪr/; [n]奸商,牟取暴利者; [or]z8;
projection: [a]/prəˈdʒekʃn/; [n]预测,投射,投影规划; [or]z8;
proliferation: [a]/prəˌlɪfəˈreɪʃn/; [n]增殖;增加; [or]z8;
prolific: [a]/prəˈlɪfɪk/; [adj]多育的,多产的;丰富的,富饶的; [or]z8;
prologue: [a]/ˈproʊlɔːɡ/; [n]开场白,序幕; [or]z8;
prominence: [a]/ˈprɑːmɪnəns/; [n]卓越;突出物;显著,突出; [or]z8;
prone: [a]/proʊn/; [adj]易于.的;有.倾向的;俯卧的; [or]z8;
propagate: [a]/ˈprɑːpəɡeɪt/; [v]繁殖,增殖; [vt]传播,宣传; [or]z8;
propel: [a]/prəˈpel/; [v]推进,推动,激励; [or]z8;
prophecy: [a]/ˈprɑːfəsi/; [n]预言书;预言,预言能力; [or]z8;
prophesy: [a]/ˈprɑːfəsaɪ/; [v]预言,预报; [or]z8;
proponent: [a]/prəˈpoʊnənt/; [n]支持者;提议者;主张者;提出认证遗嘱者; [adj]建议的;支持的;辩护的; [or]z8;
proposition: [a]/ˌprɑːpəˈzɪʃn/; [n]提议,计划,命题; [v]向.求欢; [or]z8;
prospective: [a]/prəˈspektɪv/; [adj]未来的;预期的; [n]预期; [or]z8;
protagonist: [a]/prəˈtæɡənɪst/; [n]主角,领导者,积极参加者; [or]z8;
protocol: [a]/ˈproʊtəkɔːl/; [n]外交礼节;草案;外交议定书; [vi]拟定议定书; [vt]把.写入议定书; [or]z8;
prototype: [a]/ˈproʊtətaɪp/; [n]原型,典型,样本; [or]z8;
protrude: [a]/proʊˈtruːd/; [v]伸出,突出,凸出; [or]z8;
provident: [a]/ˈprɑːvɪdənt/; [adj]节俭的,深谋远虑的,顾及未来的; [or]z8;
provisional: [a]/prəˈvɪʒənl/; [n]临时邮票; [adj]临时的,暂时的,暂定的; [or]z8;
prowess: [a]/ˈpraʊəs/; [n]勇敢,不凡的能力;超凡技术; [or]z8;
proximity: [a]/prɑːkˈsɪməti/; [n]接近;邻近; [or]z8;
prudent: [a]/ˈpruːdnt/; [adj]谨慎的,精明的; [or]z8;
psychiatrist: [a]/saɪˈkaɪətrɪst/; [n]精神病医生;精神病学家; [or]z8;
psychotherapy: [a]/ˌsaɪkoʊˈθerəpi/; [n]心理疗法,精神疗法; [or]z8;
puberty: [a]/ˈpjuːbərti/; [n]青春期; [or]z8;
pun: [a]/pʌn/; [n]双关语; [v]说双关语,用双关语; [or]z8;
pungent: [a]/ˈpʌndʒənt/; [adj]刺激性的;刺鼻的;尖锐的; [or]z8;
punitive: [a]/ˈpjuːnətɪv/; [adj]给予惩罚,刑罚的; [or]z8;
purge: [a]/pɜːrdʒ/; [v]通便,净化,使(身,心)清净; [n]驱赶,泻药,净化; [or]z8;
python: [a]/ˈpaɪθɑːn/; [n]蟒蛇,巨蛇; [or]z8;
quack: [a]/kwæk/; [n]庸医;鸭叫声; [v]嘎嘎叫;吹嘘;大声闲聊; [adj]骗人的,江湖医生的; [or]z8;
quadrant: [a]/ˈkwɑːdrənt/; [n]象限,四分之一圆; [or]z8;
quadrilateral: [a]/ˌkwɑːdrɪˈlætərəl/; [adj]四边形的; [or]z8;
quail: [a]/kweɪl/; [n]鹌鹑; [v]畏缩;感到恐惧; [or]z8;
quaint: [a]/kweɪnt/; [adj]精巧的;古雅的; [or]z8;
qualm: [a]/kwɑːm/; [n]疑惧,紧张不安; [or]z8;
quantum: [a]/ˈkwɑːntəm/; [n]量子论; [or]z8;
quarantine: [a]/ˈkwɔːrəntiːn/; [v]检疫;隔离;使隔离; [n]检疫;隔离;检疫期;封锁; [or]z8;
quartet: [a]/kwɔːrˈtet/; [n]四重奏,四重唱,四件一组; [or]z8;
quartz: [a]/kwɔːrts/; [n]石英; [or]z8;
quash: [a]/kwɔːʃ/; [v]镇压,平息,废除,使无效; [or]z8;
quaver: [a]/ˈkweɪvər/; [v]颤抖,发颤音; [n]八分音符,颤音; [or]z8;
quell: [a]/kwel/; [v]镇压,消除,减轻(激动,恐惧等); [n]镇压,平息,减轻; [or]z8;
quench: [a]/kwentʃ/; [v]扑灭(火);止渴; [or]z8;
querulous: [a]/ˈkwerələs/; [adj]抱怨的,挑剔的; [or]z8;
quibble: [a]/ˈkwɪbl/; [n]谬论;双关语;遁辞; [v]诡辩;挑剔;说模棱两可的话; [or]z8;
quick: [a]/kwɪk/; [adj]迅速的,快捷的; [adv]迅速地; [n](指甲下的)活肉; [or]z8;
quip: [a]/kwɪp/; [n]妙语,嘲弄,讽刺语; [v]嘲弄,讥讽; [or]z8;
rabid: [a]/ˈræbɪd/; [adj]激烈的;狂暴的;偏激的;患狂犬病的; [or]z8;
rabies: [a]/ˈreɪbiːz/; [n](单复同型)狂犬病; [or]z8;
racket: [a]/ˈrækɪt/; [n]吵闹声;球拍; [v]嚷闹,吵闹,纵情欢闹;用球拍打; [or]z8;
radiance: [a]/ˈreɪdiəns/; [n]发光,容光焕发; [or]z8;
radiant: [a]/ˈreɪdiənt/; [adj]光芒四射的,绚丽的;喜悦的; [or]z8;
raffle: [a]/ˈræfl/; [n]废物;抽彩票; [v]抽彩票; [or]z8;
raft: [a]/ræft/; [n]木筏;救生艇; [or]z8;
rake: [a]/reɪk/; [n]耙子,耙机; [v]耙;搜索,探索; [or]z8;
ramble: [a]/ˈræmbl/; [vi]瞎扯;溜达;漫步于; [n]漫步; [or]z8;
ramification: [a]/ˌræmɪfɪˈkeɪʃn/; [n]分枝;分枝(或分叉)的结果; [or]z8;
rampage: [a]/ræmˈpeɪdʒ/; [n]粗暴;胡闹; [v]暴跳;暴怒;狂暴地乱冲; [or]z8;
rampant: [a]/ˈræmpənt/; [adj]猖獗的,蔓生的; [or]z8;
rampart: [a]/ˈræmpɑːrt/; [n]壁垒,城墙; [vt]用壁垒围绕,防卫;守卫; [or]z8;
rancid: [a]/ˈrænsɪd/; [adj]腐臭的;令人作呕的,讨厌的; [or]z8;
randy: [a]/ˈrændi/; [adj]好色的; [n]<苏格兰>粗野的女人,强讨的叫花子,莽汉,粗鲁悍妇; [or]z8;
ranger: [a]/ˈreɪndʒər/; [n]游侠,巡逻骑兵,突击队员,护林员,游荡的人,测距仪; [or]z8;
rap: [a]/ræp/; [n]饶舌歌; [v]轻敲;表演说唱;严厉批评; [or]z8;
rapport: [a]/ræˈpɔːr/; [n]密切关系,交往;和谐一致;意见一致; [or]z8;
rapprochement: [a]/ˌræproʊʃˈmɑːn/; [n]和好,恢复邦交; [or]z8;
rapt: [a]/ræpt/; [adj]全神贯注的,着迷的;狂喜的; [or]z8;
rapture: [a]/ˈræptʃər/; [n]狂喜; [or]z8;
rarity: [a]/ˈrerəti/; [n]罕见,珍贵,珍品,稀薄; [or]z8;
rationale: [a]/ˌræʃəˈnæl/; [n]基本原理;原理的阐述; [or]z8;
rattle: [a]/ˈrætl/; [n]格格声,发出嘎嘎声的儿童玩具,(响尾蛇)音响器官; [v](使)发出格格声,(人或车)疾驰,使烦扰; [or]z8;
ravine: [a]/rəˈviːn/; [n]山涧,小峡谷; [or]z8;
ravish: [a]/ˈrævɪʃ/; [v]强夺,强奸,使着迷; [or]z8;
reassure: [a]/ˌriːəˈʃʊr/; [v]使放心,使消除疑虑; [or]z8;
rebate: [a]/ˈriːbeɪt/; [vt]减少;打折扣; [vi]退还部分付款,打折扣; [n]折扣; [or]z8;
rebound: [a]/rɪˈbaʊnd/; [v]弹回,恢复,振作; [n]弹回,重新振作,回应; [or]z8;
recipient: [a]/rɪˈsɪpiənt/; [n]接受者;容器;间接宾语; [adj]接受的;善于接受的;接受能力强的; [or]z8;
reciprocate: [a]/rɪˈsɪprəkeɪt/; [v]互给;酬答;互换;报答; [or]z8;
recital: [a]/rɪˈsaɪtl/; [n]独奏,吟诵,演奏会; [or]z8;
recline: [a]/rɪˈklaɪn/; [vi]躺,斜倚(常与on,upon或against连用);信赖; [vt]使后靠,使斜倚; [or]z8;
reconciliation: [a]/ˌrekənsɪliˈeɪʃn/; [n]和解,修好,和好,调停,调解; [or]z8;
recount: [a]/rɪˈkaʊnt/; [v]叙述; [n]重新计算; [or]z8;
recoup: [a]/rɪˈkuːp/; [v]收回;恢复;偿还;扣除; [n]获得补偿; [or]z8;
recourse: [a]/ˈriːkɔːrs/; [n]求援(对象),求助(对象,<商><律>追索权; [or]z8;
rectify: [a]/ˈrektɪfaɪ/; [v]纠正;修复; [or]z8;
rectitude: [a]/ˈrektɪtuːd/; [n]正直,公正,正确; [or]z8;
recur: [a]/rɪˈkɜːr/; [v]重新出现;再次发生;重新提起;诉诸;反复; [or]z8;
recurrent: [a]/rɪˈkɜːrənt/; [adj]复发的;周期性的,经常发生的; [or]z8;
redemption: [a]/rɪˈdempʃn/; [n]赎回,拯救,偿还,实践; [or]z8;
redolent: [a]/ˈredələnt/; [adj]气味强烈的,芬芳的,令人想起..的; [or]z8;
redraw: [a]/ˌriːˈdrɔː/; [v]重画; [or]z8;
redress: [a]/rɪˈdres/; [n]纠正,革除,救济; [v]修正,救济,革除; [or]z8;
redundancy: [a]/rɪˈdʌndənsi/; [n]裁员,<计><数>冗余(等于redundance),人浮于事; [or]z8;
redundant: [a]/rɪˈdʌndənt/; [adj]多余的,过剩的;被下岗的; [or]z8;
referendum: [a]/ˌrefəˈrendəm/; [n]公民投票,复决权; [or]z8;
refurbish: [a]/ˌriːˈfɜːrbɪʃ/; [v]刷新,再磨光; [or]z8;
regal: [a]/ˈriːɡl/; [adj]帝王的,豪华的,帝王般的; [or]z8;
regeneration: [a]/rɪˌdʒenəˈreɪʃn/; [n]新生,更新,重建; [or]z8;
registrar: [a]/ˌredʒɪˈstrɑːr/; [n]登记员,记录员; [or]z8;
regress: [a]/rɪˈɡres/; [v]后退,退化,恶化; [n]回归;退回; [or]z8;
regressive: [a]/rɪˈɡresɪv/; [adj]回归的,后退的,退化的; [or]z8;
regret: [a]/rɪˈɡret/; [n]后悔,遗憾; [vt]懊悔,后悔;抱歉; [vi]感到后悔,感到抱歉; [or]z8;
regularity: [a]/ˌreɡjuˈlærəti/; [n]规律性,整齐,正规事物; [or]z8;
reimburse: [a]/ˌriːɪmˈbɜːrs/; [v]偿还;赔偿;退还(钱),付还; [or]z8;
rein: [a]/reɪn/; [n]缰绳; [v]控制; [or]z8;
reinstate: [a]/ˌriːɪnˈsteɪt/; [vt]使恢复;使复原; [or]z8;
rejuvenate: [a]/rɪˈdʒuːvəneɪt/; [v]使..年轻;使..恢复精神;变年轻; [vi]返老还童,恢复活力,复原; [or]z8;
relapse: [a]/rɪˈlæps/; [n](旧病的)复发,重陷,回复; [vi]重新陷入,回复; [or]z8;
relent: [a]/rɪˈlent/; [v]变温和,变宽厚;减弱;缓和;终于答应;不再拒绝; [or]z8;
relentless: [a]/rɪˈlentləs/; [adj]顽强的;持续的;坚定地;冷酷的; [or]z8;
relinquish: [a]/rɪˈlɪŋkwɪʃ/; [v]放弃,让出(权利,财产等),撤回; [or]z8;
relish: [a]/ˈrelɪʃ/; [v]享受;享受.的味道;品味; [n]乐趣;调味品; [or]z8;
remedial: [a]/rɪˈmiːdiəl/; [adj]治疗的;补救的;矫正的; [or]z8;
reminiscent: [a]/ˌremɪˈnɪsnt/; [adj]怀旧的,回忆的,喜谈往事的,暗示..的,提醒的,使人联想..的; [or]z8;
remission: [a]/rɪˈmɪʃn/; [n]缓解;宽恕;豁免; [or]z8;
remit: [a]/ˈriːmɪt/; [v]汇款,汇寄,饶恕,免除; [n]职权范围,职责; [or]z8;
remittance: [a]/rɪˈmɪtns/; [n]汇款,汇款额; [or]z8;
remnant: [a]/ˈremnənt/; [n]遗迹;边角剩料; [or]z8;
remorse: [a]/rɪˈmɔːrs/; [n]懊悔,自责,同情,怜悯; [or]z8;
remunerate: [a]/rɪˈmjuːnəreɪt/; [v]酬劳;给与报酬;赔偿; [or]z8;
rend: [a]/rend/; [v]撕碎;分裂;强夺; [or]z8;
rendezvous: [a]/ˈrɑːndɪvuː/; [n]集会,幽会,约会地点; [v]约会,幽会,(秘密)集会; [or]z8;
rendition: [a]/renˈdɪʃn/; [n]表演,演奏;译文;给予,提供; [or]z8;
renegade: [a]/ˈrenɪɡeɪd/; [n]叛教者,脱党者,叛徒; [v]背叛,背教,变节; [adj]叛教的,背叛的,变节的; [or]z8;
renown: [a]/rɪˈnaʊn/; [n]声誉;名望; [vt]使有声望; [or]z8;
renunciation: [a]/rɪˌnʌnsiˈeɪʃn/; [n]放弃;脱离关系;拒绝承认;抛弃;弃权;出家; [or]z8;
repellent: [a]/rɪˈpelənt/; [adj]令人厌恶的; [n]消肿药,驱虫剂; [or]z8;
repentance: [a]/rɪˈpentəns/; [n]悔恨; [or]z8;
repercussion: [a]/ˌriːpərˈkʌʃn/; [n]反响;弹回;反射; [or]z8;
repertoire: [a]/ˈrepərtwɑːr/; [n](剧团,演员等的)全部节目;全部才能; [or]z8;
repine: [a]/rɪ'paɪn/; [v]不满,心中抱怨; [or]z8;
replenish: [a]/rɪˈplenɪʃ/; [v]补充,再装满;把.装满;给.添加燃料; [or]z8;
replica: [a]/ˈreplɪkə/; [n]复制品; [or]z8;
replicate: [a]/ˈreplɪkeɪt/; [v]复制;重复,反复; [or]z8;
repository: [a]/rɪˈpɑːzətɔːri/; [n]储藏室;仓库;智囊人物;知识库; [or]z8;
repress: [a]/rɪˈpres/; [vt]抑制;镇压;约束; [or]z8;
repression: [a]/rɪˈpreʃn/; [n]压抑,压制,镇压; [or]z8;
repressive: [a]/rɪˈpresɪv/; [adj]压抑的;抑制的,强制的; [or]z8;
reprimand: [a]/ˈreprɪmænd/; [n](特指当权者进行的)严责,谴责,申斥; [v]申斥,谴责,惩戒; [or]z8;
reprisal: [a]/rɪˈpraɪzl/; [n]报复;报复性劫掠; [or]z8;
reprove: [a]/rɪˈpruːv/; [v]责骂,申斥; [or]z8;
repudiate: [a]/rɪˈpjuːdieɪt/; [v]拒绝,否定,驳斥; [or]z8;
repugnant: [a]/rɪˈpʌɡnənt/; [adj]令人厌恶的; [or]z8;
repulse: [a]/rɪˈpʌls/; [n]击退;断然拒绝; [vt]击退;断然拒绝;憎恶; [v]使排斥,使厌恶; [or]z8;
repulsion: [a]/rɪˈpʌlʃn/; [n]排斥;厌恶;反驳; [or]z8;
repulsive: [a]/rɪˈpʌlsɪv/; [adj]排斥的,严拒的,令人厌恶的; [or]z8;
reputable: [a]/ˈrepjətəbl/; [adj]声誉好的;受尊敬的;卓越的; [or]z8;
repute: [a]/rɪˈpjuːt/; [n]名声,荣誉; [vt]被认为,被称为; [or]z8;
requiem: [a]/ˈrekwiəm/; [n]安魂曲;追思弥撒; [or]z8;
requisite: [a]/ˈrekwɪzɪt/; [n]必需品; [adj]需要的,必不可少的,必备的; [or]z8;
requisition: [a]/ˌrekwɪˈzɪʃn/; [n]征用,要求,申请书,引渡要求; [v]征用,申请领取; [or]z8;
reshape: [a]/ˌriːˈʃeɪp/; [v]改造,改变形式; [or]z8;
reshuffle: [a]/ˈriːʃʌfl/; [v]再洗牌,改组,重新安排; [n]改组;重新洗牌; [or]z8;
resigned: [a]/rɪˈzaɪnd/; [adj]逆来顺受的;已辞职的;已放弃的; [or]z8;
resilience: [a]/rɪˈzɪliəns/; [n]恢复力;弹力;顺应力; [or]z8;
resin: [a]/ˈrezn/; [n]树脂,松香; [vt]涂树脂,用树脂处理; [or]z8;
respectability: [a]/rɪˌspektəˈbɪləti/; [n]体面,可尊敬,有社会地位; [or]z8;
respite: [a]/ˈrespɪt/; [n]缓解;暂缓;暂时的休息;缓期执行; [v]使缓解;使暂缓;使延期;缓期执行; [or]z8;
resplendent: [a]/rɪˈsplendənt/; [adj]华丽的,辉煌的; [or]z8;
restitution: [a]/ˌrestɪˈtuːʃn/; [n]归还,赔偿; [or]z8;
resultant: [a]/rɪˈzʌltənt/; [adj]作为结果的; [or]z8;
resurrect: [a]/ˌrezəˈrekt/; [v]复苏,复兴;使复活; [or]z8;
resuscitation: [a]/rɪˌsʌsɪˈteɪʃn/; [n]复活,苏醒; [or]z8;
retainer: [a]/rɪˈteɪnər/; [n]保持器;家臣;保持者;<机>护圈;预付费用; [or]z8;
retaliate: [a]/rɪˈtælieɪt/; [v]报复,反击; [or]z8;
retard: [a]/rɪˈtɑːrd/; [v]延迟,使减速; [n]妨碍,阻碍; [or]z8;
retention: [a]/rɪˈtenʃn/; [n]保留,保持; [or]z8;
reticent: [a]/ˈretɪsnt/; [adj]沉默不语的;有保留的;含蓄的; [or]z8;
retribution: [a]/ˌretrɪˈbjuːʃn/; [n]报应,惩罚,报答,报偿; [or]z8;
retrieve: [a]/rɪˈtriːv/; [v]取回,重新得到,挽回,检索; [or]z8;
retrospective: [a]/ˌretrəˈspektɪv/; [adj]回顾的;怀旧的;可追溯的; [n]作品回顾展出; [or]z8;
revamp: [a]/ˈriːvæmp/; [v]翻新,整修,升级; [n]改进,换新鞋面; [or]z8;
revel: [a]/ˈrevl/; [n]狂欢; [v]狂欢; [or]z8;
revere: [a]/rɪˈvɪr/; [v]敬畏;尊敬;崇敬; [or]z8;
reverence: [a]/ˈrevərəns/; [n]崇敬,尊严,敬礼; [v]敬畏,尊敬; [or]z8;
reverent: [a]/ˈrevərənt/; [adj]虔诚的,恭敬的; [or]z8;
reverie: [a]/ˈrevəri/; [n]幻想,沉思,幻想曲; [or]z8;
reversion: [a]/rɪˈvɜːrʒn/; [n]逆转,回复,归还,<遗>隔代遗传,<法>继承权; [or]z8;
revoke: [a]/rɪˈvoʊk/; [v]撤回,取消;废除; [n]有牌不跟; [or]z8;
revulsion: [a]/rɪˈvʌlʃn/; [n]剧变,厌恶,强烈反感; [or]z8;
rhinoceros: [a]/raɪˈnɑːsərəs/; [n]犀牛; [or]z8;
rickety: [a]/ˈrɪkəti/; [adj]佝偻病的;摇晃的;蹒跚的;不结实的; [or]z8;
rift: [a]/rɪft/; [n]裂缝,裂口; [or]z8;
rig: [a]/rɪɡ/; [n]钻井架;装备;帆具;成套器械; [v]操纵;装配;欺骗; [or]z8;
righteous: [a]/ˈraɪtʃəs/; [adj]正直的,正当的,公正的; [or]z8;
rigmarole: [a]/ˈrɪɡməroʊl/; [n]冗长无聊的废话; [or]z8;
rigorous: [a]/ˈrɪɡərəs/; [adj]严厉的,严格的; [or]z8;
rind: [a]/raɪnd/; [n]壳,外皮; [vt]剥去.的皮; [or]z8;
rink: [a]/rɪŋk/; [n]溜冰场,冰球场,室内溜冰场; [vi]溜冰; [or]z8;
rinse: [a]/rɪns/; [v](用清水)刷,冲洗掉,漂净,漱口; [n]嗽洗,漂洗,漂清,冲洗; [or]z8;
rivet: [a]/ˈrɪvɪt/; [n]铆钉; [v](用铆钉)铆接,敲打(螺栓)使成铆钉头,吸引(注意力); [or]z8;
roach: [a]/roʊtʃ/; [n]蟑螂,蜚蠊; [vt]梳(发)使成拱状,切短(马鬃等)使竖立; [or]z8;
robust: [a]/roʊˈbʌst/; [adj]健壮的,强壮的;精力充沛的;坚固的;粗鲁的; [or]z8;
rocker: [a]/ˈrɑːkər/; [n]摇者,摇杆,摇滚乐歌手,镰刀弯,套钩; [or]z8;
rodent: [a]/ˈroʊdnt/; [n]啮齿类动物(如鼠等); [or]z8;
rodeo: [a]/ˈroʊdioʊ/; [n]牧马骑术表演,竞技者; [v]竞技; [or]z8;
rookie: [a]/ˈrʊki/; [n]新手,新兵,新球员; [or]z8;
roost: [a]/ruːst/; [n]鸟窝,巢穴,栖木; [vi]栖息; [or]z8;
rostrum: [a]/ˈrɑːstrəm/; [n]讲坛,讲台; [or]z8;
roundup: [a]/'raʊndˌʌp/; [n]综述,集拢,围捕; [or]z8;
rouse: [a]/raʊz/; [vt]唤醒,唤起;激起; [or]z8;
rove: [a]/roʊv/; [vt]漫游于,漂泊于; [vi]流浪,飘忽不定; [n]流浪,徘徊,粗纺线; [or]z8;
rubble: [a]/ˈrʌbl/; [n]碎石,瓦砾; [or]z8;
ruddy: [a]/ˈrʌdi/; [adj]红的,红润的; [adv]极度,非常; [vt]使变红; [or]z8;
rudimentary: [a]/ˌruːdɪˈmentri/; [adj]基本的,初期的;发育不完全的;退化的; [or]z8;
rue: [a]/ruː/; [v]后悔,遗憾; [or]z8;
rueful: [a]/ˈruːfl/; [adj]悔恨的; [or]z8;
ruffian: [a]/ˈrʌfiən/; [n]流氓,无赖,恶棍; [adj]凶狠的,残暴的,无法无天的; [or]z8;
ruffle: [a]/ˈrʌfl/; [vt]弄皱;使生气,扰乱;连续地轻敲;使起波浪; [n]皱纹;生气;混乱; [vi]起皱;愤怒; [or]z8;
ruinous: [a]/ˈruːɪnəs/; [adj]毁坏的;毁灭性的,破坏性的; [or]z8;
rumble: [a]/ˈrʌmbl/; [vt]使隆隆响; [v]低沉地说; [n]隆隆声;抱怨声; [vi]隆隆响; [or]z8;
rummage: [a]/ˈrʌmɪdʒ/; [n]杂物,翻寻; [v]彻底搜查,翻箱倒柜; [or]z8;
rupture: [a]/ˈrʌptʃər/; [n]破裂;割裂; [v]使破裂;断绝(关系); [or]z8;
rustle: [a]/ˈrʌsl/; [v]发出沙沙声,使沙沙作响,偷窃; [n]沙沙声; [or]z8;
rut: [a]/rʌt/; [n]发情期,惯例,车辙; [vt]犁; [vi]处于发情发动期; [adj]处于发情期的; [or]z8;
sabotage: [a]/ˈsæbətɑːʒ/; [n]怠工,蓄意破坏,妨碍; [v]怠工,从事破坏活动,故意阻挠; [or]z8;
sabre: [a]/ˈseɪbər/; [n]军刀,击剑用刀; [or]z8;
sacrament: [a]/ˈsækrəmənt/; [n]圣礼,圣事; [vt]使立誓,使宣誓; [or]z8;
sacrilegious: [a]/ˌsækrəˈlɪdʒəs/; [adj]该受天谴的,亵渎神明的; [or]z8;
safari: [a]/səˈfɑːri/; [n]狩猎旅行(特指在非洲东部〕,长途考察,野生动物园; [or]z8;
sag: [a]/sæɡ/; [v]下跌,下垂,消沉; [n]下垂,下陷,物价下跌; [or]z8;
saga: [a]/ˈsɑːɡə/; [n]传奇故事;冒险故事;一连串的事件(或经历); [or]z8;
sagacious: [a]/səˈɡeɪʃəs/; [adj]有洞察力的,有远见的,精明的,敏锐的; [or]z8;
sage: [a]/seɪdʒ/; [adj]贤明的,审慎的; [n]圣人,年高望重的人; [or]z8;
salient: [a]/ˈseɪliənt/; [adj]显著的;突出的;跳跃的; [n]凸角;突出部分; [or]z8;
saline: [a]/ˈseɪliːn/; [adj]咸的,含盐的; [or]z8;
sallow: [a]/ˈsæloʊ/; [adj]病黄色的,气色不好的; [n]黄华柳;山毛柳;黄华柳细枝;黄华柳木; [or]z8;
salutary: [a]/ˈsæljəteri/; [adj]有益的,有益健康的; [or]z8;
salvage: [a]/ˈsælvɪdʒ/; [n]抢救;从灾难中抢救出的物资; [vt]拯救;打捞; [or]z8;
salvo: [a]/ˈsælvoʊ/; [n]齐射,齐鸣,齐声欢呼喝彩,保留条款,遁辞; [v]齐鸣; [or]z8;
sanctify: [a]/ˈsæŋktɪfaɪ/; [vt]使神圣化,使合法化; [or]z8;
sanctuary: [a]/ˈsæŋktʃueri/; [n]圣堂,避难所; [or]z8;
sanctum: [a]/ˈsæŋktəm/; [n]圣地,密室; [or]z8;
sanguine: [a]/ˈsæŋɡwɪn/; [adj]乐观的,(脸色等)有血色的,多血质的; [n]血红色,乐观; [or]z8;
sap: [a]/sæp/; [n]树液,汁液;易上当的人; [v]削弱;逐渐耗竭; [vt]使伤元气; [vi]挖坑道进攻; [or]z8;
sardonic: [a]/sɑːrˈdɑːnɪk/; [adj]讽刺的,嘲笑的; [or]z8;
sartorial: [a]/sɑːrˈtɔːriəl/; [adj]裁缝匠的,裁缝的;缝纫的; [or]z8;
sash: [a]/sæʃ/; [n]饰带,肩带,腰带; [v]用饰带装饰;给.系上腰带<饰带>;在.上装吊窗;给.装上窗格; [or]z8;
satiate: [a]/ˈseɪʃieɪt/; [v]使饱足,生腻; [adj]饱足的;厌腻的; [or]z8;
savant: [a]/sæˈvɑːnt/; [n]博学之士,大学士; [or]z8;
savor: [a]/ˈseɪvər/; [n]味道,气味,特点,趣味; [v]调味,品尝,欣赏,玩味; [or]z8;
scaffold: [a]/ˈskæfoʊld/; [n]支架;断头台;脚手架;脚手架材料; [vt]给.搭脚手架; [or]z8;
scalpel: [a]/ˈskælpəl/; [n]外科手术刀,解剖刀; [or]z8;
scathing: [a]/ˈskeɪðɪŋ/; [adj]严厉的;损伤的; [v]损伤;伤害; [or]z8;
scavenge: [a]/ˈskævɪndʒ/; [v](在废物中)寻觅;(动物)食腐肉;打扫;排除废气; [or]z8;
scavenger: [a]/ˈskævɪndʒər/; [n]捡垃圾者;食腐动物;净化剂; [vi]作清道夫; [or]z8;
scenario: [a]/səˈnærioʊ/; [n]剧情梗概;情况,情节;设想; [or]z8;
schizophrenia: [a]/ˌskɪtsəˈfriːniə/; [n]<内科>精神分裂症; [or]z8;
scholarly: [a]/ˈskɑːlərli/; [adj]学者气质的,学者风度的,学术的; [or]z8;
scoff: [a]/skɔːf/; [vi]讥笑; [v]嘲笑; [n]愚弄; [or]z8;
scour: [a]/ˈskaʊər/; [v]搜查;洗涤,洗刷,擦洗;冲刷成,冲刷出; [or]z8;
scowl: [a]/skaʊl/; [n]愁容,怒容,暴风雨前的阴沉晦暗; [v]皱眉头,怒目而视; [or]z8;
scrawl: [a]/skrɔːl/; [n]潦草的笔迹; [v]乱涂,乱写,潦草地写; [or]z8;
screech: [a]/skriːtʃ/; [vi]发出尖锐的声音,发出恐惧或痛苦的叫喊声; [n]尖叫声,尖利刺耳的声音,尖声喊叫; [vt]尖着声音讲或喊; [or]z8;
scripture: [a]/ˈskrɪptʃər/; [n]经文;圣经; [or]z8;
scrub: [a]/skrʌb/; [v]用力擦洗;宣布中止; [n]灌木丛;擦洗; [or]z8;
scruple: [a]/ˈskruːpl/; [n]顾虑,不安; [vi]有顾虑,良心上感到不安; [or]z8;
scrupulous: [a]/ˈskruːpjələs/; [adj]小心谨慎的;严谨的;细心的; [or]z8;
scrutinize: [a]/ˈskruːtənaɪz/; [v]仔细检查,细看; [or]z8;
scuba: [a]/'skjuːbə/; [n]自携式水下呼吸器; [or]z8;
scuffle: [a]/ˈskʌfl/; [v]混战,扭打,拖着脚步快速行走; [n]混战,扭打; [or]z8;
scum: [a]/skʌm/; [n]浮沫,浮渣; [or]z8;
scurry: [a]/ˈskɜːri/; [v]快速疾走,急跑,急躁不安地来回走动; [n]快步急跑;疾走;仓皇奔跑声;骤雨; [or]z8;
secession: [a]/sɪˈseʃn/; [n]脱离,退出; [or]z8;
seclude: [a]/sɪˈkluːd/; [v]与世隔绝,使隔绝; [or]z8;
secluded: [a]/sɪˈkluːdɪd/; [adj]隐遁的,隔绝的; [or]z8;
secrete: [a]/sɪˈkriːt/; [v]藏匿;私下侵吞;分泌; [or]z8;
secretive: [a]/ˈsiːkrətɪv/; [adj]秘密的;偷偷摸摸的;促进分泌的; [or]z8;
sedan: [a]/sɪˈdæn/; [n]轿子,轿车,单舱汽艇; [or]z8;
sedative: [a]/ˈsedətɪv/; [adj](药物)镇静的,起镇定作用的; [n](药物)镇静剂,起镇定作用的东西; [or]z8;
seduce: [a]/sɪˈduːs/; [v]引诱,诱使,诱惑,勾引;着迷; [or]z8;
seduction: [a]/sɪˈdʌkʃn/; [n]诱惑,魅力;诱惑物; [or]z8;
seductive: [a]/sɪˈdʌktɪv/; [adj]有魅力的;性感的;引人注意的; [or]z8;
seedy: [a]/ˈsiːdi/; [adj]多种子的,结籽的,破旧的,褴褛的; [or]z8;
seep: [a]/siːp/; [v](液体等)渗漏,(观念等)渗入,(疾病恐惧等)扩散; [n]小泉,水陆两用的吉普车; [or]z8;
seethe: [a]/siːð/; [v]沸腾;汹涌;激动; [or]z8;
segregate: [a]/ˈseɡrɪɡeɪt/; [v]分开,隔离,进行种族隔离; [or]z8;
segregation: [a]/ˌseɡrɪˈɡeɪʃn/; [n]分离,隔离,种族隔离; [or]z8;
selenium: [a]/səˈliːniəm/; [n]硒; [or]z8;
semblance: [a]/ˈsembləns/; [n]相似;外表,外貌; [or]z8;
seminal: [a]/ˈsemɪnl/; [adj]重要的,精液的,种子的; [or]z8;
senile: [a]/ˈsiːnaɪl/; [adj]年老的,衰老的,因年老发生的(记忆力衰退等); [or]z8;
sensor: [a]/ˈsensər/; [n]传感器,灵敏元件; [or]z8;
sensory: [a]/ˈsensəri/; [adj]知觉的;感觉的;知觉器官的;感觉的; [or]z8;
sensual: [a]/ˈsenʃuəl/; [adj]感官的;色情的,肉欲的; [or]z8;
sensuous: [a]/ˈsenʃuəs/; [adj]感觉上的,依感观的,诉诸美感的; [or]z8;
sentinel: [a]/ˈsentɪnl/; [n]哨兵,看守; [v]守卫,放哨; [or]z8;
sentry: [a]/ˈsentri/; [n]哨兵,警卫; [vi]站岗,放哨; [vt]设岗哨; [or]z8;
sequel: [a]/ˈsiːkwəl/; [n]续集;结局;继续;后果; [or]z8;
serrated: [a]/səˈreɪtɪd/; [adj]呈锯齿状的; [or]z8;
servile: [a]/ˈsɜːrvl/; [adj]奴颜婢膝的,卑屈的,隶属的; [n]奴隶; [or]z8;
servitude: [a]/ˈsɜːrvətuːd/; [n]劳役,奴役; [or]z8;
severity: [a]/sɪˈverəti/; [n]严格,严肃; [or]z8;
sexism: [a]/ˈseksɪzəm/; [n](针对女性的)性别歧视,男性至上主义; [or]z8;
sexist: [a]/ˈseksɪst/; [n]性别歧视者,男性至上主义者; [adj]性别主义者的,性别歧视者的; [or]z8;
shack: [a]/ʃæk/; [n]棚屋;小室; [v]居住; [or]z8;
shag: [a]/ʃæɡ/; [n]粗毛,粗烟丝,蓬乱一团; [v]使杂乱,使蓬松; [adj]有粗毛的,蓬乱的; [or]z8;
sham: [a]/ʃæm/; [n]假货;虚假;欺诈; [v]假装; [adj]虚假的,假装的; [or]z8;
shamble: [a]/ˈʃæmbl/; [v]蹒跚,拖沓; [n]蹒跚;摇晃的脚步;(pl.)混乱,废墟; [or]z8;
shapely: [a]/ˈʃeɪpli/; [adj]定形的;形状美观的;样子好的;有条理的; [or]z8;
shatter: [a]/ˈʃætər/; [v]使粉碎;砸碎;打碎;粉碎; [or]z8;
sheaf: [a]/ʃiːf/; [n]一捆,一束; [v]捆,束; [or]z8;
shear: [a]/ʃɪr/; [vt]剪羊毛;剪头发; [n](复数)大剪刀; [or]z8;
sheath: [a]/ʃiːθ/; [n](刀,剑)鞘,护套,(植)叶鞘; [or]z8;
sheepish: [a]/ˈʃiːpɪʃ/; [adj]羞怯的,腼腆的(像绵羊一样)驯顺的,胆怯的,愚钝的; [or]z8;
shimmer: [a]/ˈʃɪmər/; [v]闪烁,微微发亮; [n]微光,闪光; [or]z8;
shin: [a]/ʃɪn/; [n]胫骨; [v]爬,攀,快步走; [or]z8;
shirk: [a]/ʃɜːrk/; [v]逃避;规避(义务,责任等); [n]偷懒者; [or]z8;
shoal: [a]/ʃoʊl/; [n]浅滩,沙洲,一群(鱼); [adj](水)浅的; [v]变成浅滩;驶入浅水的地方;(鱼)成群集聚; [or]z8;
shoddy: [a]/ˈʃɑːdi/; [adj]劣等的;假的;冒充的;虚有其表的; [n]赝品,不值钱的东西; [or]z8;
shortfall: [a]/ˈʃɔːrtfɔːl/; [n]不足,亏空; [or]z8;
shove: [a]/ʃʌv/; [v]推;猛推; [n]推搡; [or]z8;
showy: [a]/ˈʃoʊi/; [adj]华丽的,(过分)艳丽的,浮华的; [or]z8;
shred: [a]/ʃred/; [n]碎片,少量,毁灭; [v]切成细条,撕成碎片; [or]z8;
shrinkage: [a]/ˈʃrɪŋkɪdʒ/; [n]收缩;减低; [or]z8;
shrivel: [a]/ˈʃrɪvl/; [v]枯萎,皱缩; [or]z8;
shroud: [a]/ʃraʊd/; [n]寿衣,覆盖物; [v]覆盖,包以尸衣; [or]z8;
shuffle: [a]/ˈʃʌfl/; [n]拖着脚走路;混淆;洗牌; [vi]拖着脚走;推诿;洗牌; [vt]拖着;弄混;洗牌; [or]z8;
shun: [a]/ʃʌn/; [v](有意或习惯性地)避开,躲开; [or]z8;
shunt: [a]/ʃʌnt/; [n]转轨;<电>分流器; [v]使(火车)转到另一轨道,转移方向; [or]z8;
sibling: [a]/ˈsɪblɪŋ/; [n]兄弟姊妹;同胞;(生物)同科,同属; [or]z8;
sideline: [a]/ˈsaɪdlaɪn/; [n]球场边线,副业; [v]迫使退出; [or]z8;
sidestep: [a]/ˈsaɪdstep/; [n](侧面)台阶;拳击等横跨一步躲避打击;［喻］回避(困难); [v]回避;横跨一步躲避; [or]z8;
sierra: [a]/siˈerə/; [n]锯齿山脊,呈齿状起伏的山脉; [or]z8;
silhouette: [a]/ˌsɪluˈet/; [v]使显出轮廓(或影像); [n]影子,轮廓; [or]z8;
silica: [a]/ˈsɪlɪkə/; [n]二氧化硅,硅石; [or]z8;
silt: [a]/sɪlt/; [n]淤泥,淤沙; [v]淤塞; [or]z8;
simpleton: [a]/ˈsɪmpltən/; [n]傻子;笨蛋; [or]z8;
simulate: [a]/ˈsɪmjuleɪt/; [v]假装;模仿;模拟; [or]z8;
sinew: [a]/ˈsɪnjuː/; [n]腱,筋,中坚力量; [v]用腱连结,(好像使用肌筋似的)给..以力量,支持; [or]z8;
singe: [a]/sɪndʒ/; [n](轻微的)烧焦; [v](轻微地)烧焦,烫焦; [or]z8;
sinuous: [a]/ˈsɪnjuəs/; [adj]弯曲的,蜿蜒的; [or]z8;
sip: [a]/sɪp/; [v]啜饮; [n]一小口; [or]z8;
skid: [a]/skɪd/; [v]打滑; [n]打滑; [or]z8;
skinny: [a]/ˈskɪni/; [adj]瘦削的,皮包骨的;皮状的,皮质的〈俚〉吝啬的; [n](不公开的)信息,内幕消息; [or]z8;
skipper: [a]/ˈskɪpər/; [n]队长,船长,机长; [v]带领,作.的船长(或机长); [or]z8;
slab: [a]/slæb/; [n]厚片,硬板; [v]把.分成厚片;用石板铺; [or]z8;
slag: [a]/slæɡ/; [n]炉渣,矿渣; [or]z8;
slash: [a]/slæʃ/; [n]砍痕;砍; [v]砍,大幅度削减; [or]z8;
slavish: [a]/ˈsleɪvɪʃ/; [adj]照搬的,刻板模仿的;盲从的; [or]z8;
sleazy: [a]/ˈsliːzi/; [adj]质地单薄的,低劣的,肮脏的; [or]z8;
sleek: [a]/sliːk/; [adj](毛发等)柔滑的;性格油滑的,嘴甜的,圆滑的; [v]使光滑,使有光泽;(口语)滑动(口语)打扮整洁; [or]z8;
sleeper: [a]/ˈsliːpər/; [n]睡眠者;卧车,卧铺;枕木; [or]z8;
slick: [a]/slɪk/; [adj]光滑的;圆滑的;顺利的;不费力的; [n]海面浮油;小块湿润的区域; [v]使平滑; [or]z8;
slime: [a]/slaɪm/; [n]烂泥;粘土;黏液; [vi]覆有黏液; [vt]用(稀泥,粘液等)涂抹,使变黏滑; [or]z8;
slimy: [a]/ˈslaɪmi/; [adj]黏糊糊的;黏滑的;谄媚的; [or]z8;
slink: [a]/slɪŋk/; [v]潜逃,溜走,早产,潜逃; [n]早产的动物,鬼鬼祟祟的人; [adj]早产的; [or]z8;
slit: [a]/slɪt/; [n]投币口,裂缝; [v]切开; [or]z8;
slither: [a]/ˈslɪðər/; [v](蛇)滑动,滑行; [n]滑动;滑行; [or]z8;
sliver: [a]/ˈslɪvər/; [n]长条,细片; [v]裂成细片; [or]z8;
slouch: [a]/slaʊtʃ/; [v]耷拉,低垂,使低垂; [n](帽边等的)下垂,耷拉,萎靡不振的人; [or]z8;
slug: [a]/slʌɡ/; [n]鼻涕虫,子弹,懒汉; [vi]偷懒; [vt]<印刷>在.插嵌片; [or]z8;
slump: [a]/slʌmp/; [v]突然倒下;暴跌; [n]下降;经济萧条时期; [or]z8;
slur: [a]/slɜːr/; [n]含糊的发音,藐视,污点,连线符; [vi]含糊地说; [vt]对.忽略,含糊不清地说出,贬低; [or]z8;
smolder: [a]/ˈsmoʊldər/; [v]无火焰地闷烧,(仇恨,嫉妒,愤怒等)在心里郁积; [n]焖烧,文火,冒烟; [or]z8;
smother: [a]/ˈsmʌðər/; [v]窒息; [or]z8;
smug: [a]/smʌɡ/; [adj]自鸣得意的; [or]z8;
snare: [a]/sner/; [n]罗网;陷阱;圈套; [or]z8;
snarl: [a]/snɑːrl/; [v]缠结,混乱,吠,咆哮,怒骂; [n]咆哮,吼叫,怒骂,缠结,混乱; [or]z8;
snigger: [a]/ˈsnɪɡər/; [v]嘻皮笑脸地笑,吃吃地笑,窃笑; [n]窃笑; [or]z8;
snivel: [a]/ˈsnɪvl/; [v]流鼻涕;啜泣; [or]z8;
snooty: [a]/ˈsnuːti/; [adj]自大的,傲慢的; [or]z8;
snort: [a]/snɔːrt/; [v]轻蔑或愤怒地发出哼声,喷出蒸汽声,吸毒品; [n]喷鼻息,一小杯酒; [or]z8;
snout: [a]/snaʊt/; [n]猪嘴,猪鼻子; [v]装管嘴; [or]z8;
snub: [a]/snʌb/; [n]冷落,怠慢; [vt]冷落;断然拒绝;掐灭; [adj]故意冷落的,断然拒绝的,斥责的; [or]z8;
snuff: [a]/snʌf/; [v](伤风鼻阻时)用鼻子使劲地吸,扑灭; [n]灯花,烛花,鼻吸气息,气息; [or]z8;
sobriety: [a]/səˈbraɪəti/; [n]清醒,冷静,节制,严肃; [or]z8;
sod: [a]/sɑːd/; [n]草地,草皮; [v]铺上草皮,以生草土覆盖,铺草皮于; [int]该死的,该死的; [or]z8;
solace: [a]/ˈsɑːləs/; [n]慰藉,给予安慰的人或事物; [v]安慰,缓和,使开心; [or]z8;
solemnity: [a]/səˈlemnəti/; [n]庄严,肃穆,庄严的仪式; [or]z8;
soliloquy: [a]/səˈlɪləkwi/; [n]自言自语,独白; [or]z8;
solvency: [a]/ˈsɑːlvənsi/; [n]偿付能力;溶解力; [or]z8;
solvent: [a]/ˈsɑːlvənt/; [adj]有偿付能力的;有溶解力的; [n]溶剂;解决方法; [or]z8;
somber: [a]/'sɒmbə/; [adj]忧郁的;昏暗的,阴天的; [or]z8;
sonata: [a]/səˈnɑːtə/; [n]奏鸣曲; [or]z8;
sophist: [a]/ˈsɑːfɪst/; [n]诡辩家,哲学家; [or]z8;
soprano: [a]/səˈprɑːnoʊ/; [n]女高音,女高音歌手,女高音声部; [adj]女高音的,童声高音的,女高音声部的; [or]z8;
sordid: [a]/ˈsɔːrdɪd/; [adj]卑鄙的,肮脏的,色彩死气沉沉暗淡的; [or]z8;
spar: [a]/spɑːr/; [n]圆材(如桅,桁等),争论,拳斗; [v]争论,拳击; [or]z8;
sparingly: [a]/ˈsperɪŋli/; [adv]节俭地,有节制地; [or]z8;
spasm: [a]/ˈspæzəm/; [v]痉挛,抽搐; [n]痉挛; [or]z8;
spate: [a]/speɪt/; [n]洪水;一阵;大雨;突然迸发; [or]z8;
spatial: [a]/ˈspeɪʃl/; [adj]空间的,关于空间的; [or]z8;
speckle: [a]/ˈspekl/; [n]斑点; [v]使弄上斑点,沾污; [or]z8;
specter: [a]/'spektə/; [n]鬼魂,幽灵,恐惧; [or]z8;
spectrum: [a]/ˈspektrəm/; [n]光谱,范围,系列; [or]z8;
spinner: [a]/ˈspɪnər/; [n]纺纱机,纺纱工人,旋式诱饵; [or]z8;
spleen: [a]/spliːn/; [n]脾,脾气,怒气; [or]z8;
splutter: [a]/ˈsplʌtər/; [n]劈啪声,急忙说出的话,杂乱的声音; [v]喷溅,气急败坏地说; [or]z8;
sporadic: [a]/spəˈrædɪk/; [adj]不定时发生的;零星的;分散的; [or]z8;
spout: [a]/spaʊt/; [v]滔滔不绝地讲;喷出;(鲸鱼)喷射; [vt]把.典当掉; [n]喷口;水管;水柱;水龙卷;水落管; [or]z8;
sprawl: [a]/sprɔːl/; [n]四肢伸开的躺卧姿势;蔓生; [v]四肢伸开地坐(或卧);爬行;蔓生; [or]z8;
sprint: [a]/sprɪnt/; [v]疾跑,冲刺; [n]全速奔跑; [or]z8;
spurious: [a]/ˈspjʊriəs/; [adj]假的,伪造的,欺骗的; [or]z8;
squabble: [a]/ˈskwɑːbl/; [v]发生口角,大声争吵; [n]争吵,口角; [or]z8;
squalid: [a]/ˈskwɑːlɪd/; [adj]污秽的,肮脏的,卑劣的; [or]z8;
squall: [a]/skwɔːl/; [n](通常伴随着雨或雪的)风暴,暴风雪; [v]尖叫; [or]z8;
squalor: [a]/ˈskwɑːlər/; [n]肮脏,邋遢,(道德品质等的)卑劣; [or]z8;
squash: [a]/skwɑːʃ/; [v]压扁,压制; [n]南瓜,易压烂的物品,拥挤的人群,壁球; [or]z8;
squeak: [a]/skwiːk/; [v]尖叫,以短促尖锐声发出,险胜; [n]吱吱声,机会; [or]z8;
squeal: [a]/skwiːl/; [n]长而尖锐的刺耳叫声; [vi]发出长而尖锐的刺耳叫声; [vt]以尖厉刺耳的声音发出; [or]z8;
squeamish: [a]/ˈskwiːmɪʃ/; [adj]害怕的,易受惊的,想呕吐的; [n]易心烦意乱的人;神经脆弱的人; [or]z8;
squint: [a]/skwɪnt/; [v]斜视,眯眼睛看; [adj]斜着眼的;斜视的;细眯着眼看的;倾斜的;偏移的; [n]斜视眼;斜视斜眼;趋势; [or]z8;
squirm: [a]/skwɜːrm/; [v]蠕动,面容扭曲; [n]蠕动; [or]z8;
squirt: [a]/skwɜːrt/; [v]喷射,喷湿,喷出; [n]喷,细的喷流,讨厌鬼; [or]z8;
staccato: [a]/stəˈkɑːtoʊ/; [adj](音乐)断音的,不连贯的; [n]断奏;断续的一段音乐;不连贯的东西(如说话,发动机的声音等); [adv]断音地;不连接地; [or]z8;
stag: [a]/stæɡ/; [n]牡鹿;不带女伴的舞客;阉割过的雄鹿; [adj]全是男人的; [v]不带女伴参加晚会; [or]z8;
stalemate: [a]/ˈsteɪlmeɪt/; [n]和棋局面,僵局; [v]使陷入僵局; [or]z8;
stalk: [a]/stɔːk/; [n]茎,梗; [v]隐伏跟踪,(为搜索而)走遍;高视阔步,蔓延; [or]z8;
stallion: [a]/ˈstæliən/; [n]种马,成年公马; [or]z8;
stalwart: [a]/ˈstɔːlwərt/; [n]坚定的成员;健壮的人; [adj]强壮的,坚定的,忠诚的; [or]z8;
stamina: [a]/ˈstæmɪnə/; [n]耐力,持久力; [or]z8;
stance: [a]/stæns/; [n]立场,姿态,位置; [or]z8;
stanza: [a]/ˈstænzə/; [n]诗节; [or]z8;
stardom: [a]/ˈstɑːrdəm/; [n]明星地位;演员身份;明星界; [or]z8;
stark: [a]/stɑːrk/; [adj]完全的,明显的,荒凉的; [adv]完全,明显地; [or]z8;
stately: [a]/ˈsteɪtli/; [adj]雄伟的;庄重的,庄严的; [adv]雄伟,壮观; [or]z8;
stealth: [a]/stelθ/; [n]隐秘,秘密; [or]z8;
stealthily: [a]/ˈstelθɪli/; [adv]暗地里,悄悄地; [or]z8;
steep: [a]/stiːp/; [v]沉浸于..; [adj]陡峭的;急剧的;过高的; [n]陡坡; [or]z8;
stereotype: [a]/ˈsteriətaɪp/; [n]老套的模式,陈规,成见; [v]对..产生成见; [or]z8;
sterilize: [a]/ˈsterəlaɪz/; [vt]消毒;使不孕;使(土地)不毛; [or]z8;
stethoscope: [a]/ˈsteθəskoʊp/; [n]听诊器; [v]用听诊器诊察; [or]z8;
stimulant: [a]/ˈstɪmjələnt/; [n]<药>兴奋剂;刺激物;酒精饮料; [adj]激励的;使人兴奋的; [or]z8;
stint: [a]/stɪnt/; [n]节约;从事某工作的时间;固定; [v]节省;限制; [or]z8;
stipend: [a]/ˈstaɪpend/; [n]奖学金;固定薪金;定期津贴;养老金; [or]z8;
stipulate: [a]/ˈstɪpjuleɪt/; [v]规定;保证;保证;要求以.为条件; [or]z8;
stoic: [a]/ˈstoʊɪkl/; [n]斯多葛学派哲学家;禁欲主义者;坚守克己之人; [adj]斯多葛派的;禁欲主义的; [or]z8;
stoke: [a]/stoʊk/; [v]添加燃料,把(火)拨旺,狼吞虎咽吃; [n]斯托克;<物>沲; [or]z8;
stoppage: [a]/ˈstɑːpɪdʒ/; [n]停止,故障,罢工; [or]z8;
stow: [a]/stoʊ/; [v]装载,收藏,使暂留; [n]斯托; [or]z8;
strained: [a]/streɪnd/; [adj]紧张的,不友善的,勉强的,不自然的(态度等),牵强附会的; [or]z8;
strand: [a]/strænd/; [n](线等的)股,缕;一个组成部分;海滨,河岸,海滩,湖滨; [v]使陷入困境;使滞留,使搁浅; [or]z8;
stratify: [a]/ˈstrætɪfaɪ/; [v]分层,成层,阶层化; [or]z8;
stratum: [a]/ˈstreɪtəm/; [n]层次;薄层;地层;阶层; [or]z8;
strenuous: [a]/ˈstrenjuəs/; [adj]费力的;奋发的;热心的;艰苦的;紧张的; [or]z8;
strew: [a]/struː/; [vt]撒;把.撒在.上;散播,点缀; [or]z8;
stricture: [a]/ˈstrɪktʃər/; [n]谴责;严厉;束缚; [or]z8;
strident: [a]/ˈstraɪdnt/; [adj]尖声的,刺耳的; [or]z8;
stringent: [a]/ˈstrɪndʒənt/; [adj]严厉的;迫切的;银根紧的; [or]z8;
strut: [a]/strʌt/; [n]高视阔步,抗压装置; [v]昂首阔步地走,趾高气昂地走; [or]z8;
stub: [a]/stʌb/; [n]存根;烟蒂;树桩;断株; [v]踩熄;连根拔除; [or]z8;
stubble: [a]/ˈstʌbl/; [n]残株,发茬,须茬; [or]z8;
stuffy: [a]/ˈstʌfi/; [adj]闷热的;古板的;鼻子不通气的; [or]z8;
stupendous: [a]/stuːˈpendəs/; [adj]巨大的,大得惊人的; [or]z8;
stupor: [a]/ˈstuːpər/; [n]恍惚,昏迷,不醒人事; [or]z8;
subjection: [a]/səbˈdʒekʃn/; [n]隶属;服从;支配; [or]z8;
sublime: [a]/səˈblaɪm/; [adj]雄伟的,崇高的,极端的,超群的;(行为,态度)极端的,漠不关心的; [n]顶峰,崇高; [v]使.纯化,使.升华,变高尚; [or]z8;
subside: [a]/səbˈsaɪd/; [vi]平息,减弱;减弱;(建筑)下陷;(尤指洪水的水位) 回落; [or]z8;
substantiate: [a]/səbˈstænʃieɪt/; [v]证实;使实体化; [or]z8;
substantive: [a]/səbˈstæntɪv/; [adj]有实质的;大量的;真实的;独立存在的; [n]实词,名词,名词性词组; [or]z8;
suburbanite: [a]/səˈbɜːrbənaɪt/; [n]郊区居民; [or]z8;
subversive: [a]/səbˈvɜːrsɪv/; [n]颠覆分子,破坏分子; [adj]颠覆性的,破坏性的; [or]z8;
succor: [a]/ˈsʌkər/; [n]救援,援助者,救援人员; [v]援助,救援; [or]z8;
succulent: [a]/ˈsʌkjələnt/; [n]肉质植物; [adj]多汁鲜美的;丰富多彩的; [or]z8;
succumb: [a]/səˈkʌm/; [v]屈从,屈服,因.死亡(to); [or]z8;
suffice: [a]/səˈfaɪs/; [v]足够; [or]z8;
suffrage: [a]/ˈsʌfrɪdʒ/; [n]选举权,投票权; [or]z8;
suggestive: [a]/səˈdʒestɪv/; [adj]提示的,启发的,暗示的; [or]z8;
suitor: [a]/ˈsuːtər/; [n]求婚者,(法律)原告; [or]z8;
sulk: [a]/sʌlk/; [n]生气,愠怒,愠怒的人; [v]生气,愠怒; [or]z8;
sully: [a]/ˈsʌli/; [v]玷污,污染; [or]z8;
sultan: [a]/ˈsʌltən/; [n]苏丹(某些伊斯兰国家最高统治者称号); [or]z8;
sultry: [a]/ˈsʌltri/; [adj]闷热的,狂暴的,淫荡的; [or]z8;
sumptuous: [a]/ˈsʌmptʃuəs/; [adj]奢侈的;华丽的; [or]z8;
sunken: [a]/ˈsʌŋkən/; [adj]沉没的,凹陷的; [or]z8;
superfluous: [a]/suːˈpɜːrfluəs/; [adj]多余的,过剩的;不必要的; [or]z8;
superimpose: [a]/ˌsuːpərɪmˈpoʊz/; [v]添加;重叠;附加;安装; [or]z8;
superintend: [a]/ˌsuːpərɪnˈtend/; [v]监督;主管;指挥; [or]z8;
supersede: [a]/ˌsuːpərˈsiːd/; [v]代替;紧接着而到来; [or]z8;
supplant: [a]/səˈplænt/; [v]代替;排挤掉; [or]z8;
supple: [a]/ˈsʌpl/; [adj]柔软的;柔顺的; [or]z8;
supplementary: [a]/ˌsʌplɪˈmentri/; [adj]补充的;附加的; [n]补充者; [or]z8;
supremacy: [a]/suːˈpreməsi/; [n]至高;最高权力,霸权; [or]z8;
surcharge: [a]/ˈsɜːrtʃɑːrdʒ/; [n]额外费用,过高的要价; [v]追加罚款;使.装载过多;使.负担过重; [or]z8;
surly: [a]/ˈsɜːrli/; [adj]乖戾的;无礼的;阴沉的; [or]z8;
surreptitious: [a]/ˌsɜːrəpˈtɪʃəs/; [adj]鬼鬼祟祟的,暗中的,秘密的; [or]z8;
surrogate: [a]/ˈsɜːrəɡət/; [n]代替品,代理人,代孕妈妈; [adj]代理的,替代的; [v]代替,代理;指定为自己的代理人,接替; [or]z8;
susceptibility: [a]/səˌseptəˈbɪləti/; [n]易感性的,敏感性,感情; [or]z8;
susceptible: [a]/səˈseptəbl/; [adj]易受感染的;易受影响的;多情的; [or]z8;
sustenance: [a]/ˈsʌstənəns/; [n]生计;食物,粮食; [or]z8;
swagger: [a]/ˈswæɡər/; [n]傲慢的态度,大摇大摆; [v]大摇大摆地走,吹牛,傲慢; [adj]豪华时髦的; [or]z8;
swap: [a]/swɑːp/; [v]交换;替换;对调; [n]交换;交换物; [or]z8;
swathe: [a]/sweɪð/; [n]带子,绷带;包装品; [vt]包围;紧绑;裹; [or]z8;
sweeping: [a]/ˈswiːpɪŋ/; [n]扫除;垃圾; [adj]彻底的;广泛的; [v]扫除; [or]z8;
swine: [a]/swaɪn/; [n]猪,卑鄙的人; [or]z8;
swirl: [a]/swɜːrl/; [n]漩涡;打旋;涡状形; [v]盘绕;打旋;眩晕;大口喝酒; [or]z8;
swoop: [a]/swuːp/; [v]攫取,飞扑,突然袭击; [n]突然下降,猛扑; [or]z8;
syndicate: [a]/ˈsɪndɪkət/; [n]辛迪加;企业联合;财团; [v]联合成辛迪加;组成企业联合组织;在多家报刊上同时发表; [or]z8;
synonymous: [a]/sɪˈnɑːnɪməs/; [adj]同义的;同义词的;同义突变的; [or]z8;
synopsis: [a]/sɪˈnɑːpsɪs/; [n]摘要,概要; [or]z8;
synoptic: [a]/sɪˈnɑːptɪk/; [adj]天气的,概要的,一览无余的; [or]z8;
systematize: [a]/ˈsɪstəmətaɪz/; [v]使系统化;使组织化;将.分类; [or]z8;
tab: [a]/tæb/; [n]标签,制表,帐单; [v]给.贴标签; [or]z8;
tacit: [a]/ˈtæsɪt/; [adj]心照不宣的,静默的; [or]z8;
taciturn: [a]/ˈtæsɪtɜːrn/; [adj]沉默寡言的; [or]z8;
tacky: [a]/ˈtæki/; [adj]粘而未干的,缺乏教养或风度的,俗气的; [or]z8;
tact: [a]/tækt/; [n]机智,得体,老练,圆滑; [or]z8;
tactful: [a]/ˈtæktfl/; [adj]机智的;老练的; [or]z8;
tactical: [a]/ˈtæktɪkl/; [adj]手段的,战术的; [or]z8;
taint: [a]/teɪnt/; [n]污点;感染;异味; [vi]腐败,腐烂; [vt]污染;玷污,使受不良影响; [or]z8;
tamper: [a]/ˈtæmpər/; [v]篡改;玩弄;贿赂; [n]填塞者;捣棒; [or]z8;
tangent: [a]/ˈtændʒənt/; [n]切线; [adj]无关的; [or]z8;
tanner: [a]/ˈtænər/; [n]制革工人,六便士; [or]z8;
tantalize: [a]/ˈtæntəlaɪz/; [v]逗弄,挑逗,使(看到拿不到而)焦急; [or]z8;
tantamount: [a]/ˈtæntəmaʊnt/; [adj]与.相等的; [or]z8;
tantrum: [a]/ˈtæntrəm/; [n](孩子气的)脾气发作; [or]z8;
taper: [a]/ˈteɪpər/; [v]逐渐变细; [n]锥形;渐弱;蜡芯,小蜡烛; [vi]变尖;逐渐减弱; [vt]变尖;逐渐减弱; [adj]渐细的;斜的;依次递减的; [or]z8;
tapeworm: [a]/ˈteɪpwɜːrm/; [n]绦虫; [or]z8;
tarnish: [a]/ˈtɑːrnɪʃ/; [n]弄脏;失去光泽,生锈; [v]变灰暗,失去光泽,破坏(形象等); [or]z8;
tarry: [a]/ˈtæri/; [n]逗留,短期滞在; [v]耽搁,踌躇(等待),拖延; [adj]柏油的,涂柏油的; [or]z8;
tartan: [a]/ˈtɑːrtn/; [n]单桅三角帆船,格子花,格子织物; [adj]格子花呢的; [or]z8;
taunt: [a]/tɔːnt/; [n]辱骂,嘲弄; [vt]嘲弄,奚落; [adj]<海>(桅杆)很高的; [adv]扯满风帆; [or]z8;
taut: [a]/tɔːt/; [adj]拉紧的;紧张的;整洁的; [or]z8;
tawdry: [a]/ˈtɔːdri/; [adj]非常华丽的,廉价而俗丽的; [n]俗丽的东西,廉价而俗丽之物; [adv]俗丽地,华而不实地; [or]z8;
tedium: [a]/ˈtiːdiəm/; [n]单调乏味; [or]z8;
teeter: [a]/ˈtiːtər/; [v]使..摇摆;使..上下晃动;蹒跚; [n]跷跷板;摇摆; [or]z8;
telling: [a]/ˈtelɪŋ/; [adj]明显的;生动的; [n]叙述; [or]z8;
tempo: [a]/ˈtempoʊ/; [n]<音>节奏,拍子;行进速度; [or]z8;
temporal: [a]/ˈtempərəl/; [adj]现世的,世俗的;当时的,暂时的;<解>颞的;时间的; [n]世间万物;教会财产; [or]z8;
tenet: [a]/ˈtenɪt/; [n]信念,原则,教条; [or]z8;
tenor: [a]/ˈtenər/; [n]男高音,要点,要旨,稳定的进程; [adj](乐器)次中音的;(组钟中的)最低音的;男高音的; [or]z8;
tensile: [a]/ˈtensl/; [adj]可拉长的,可伸长的,<物>张力的,拉力的; [or]z8;
tentative: [a]/ˈtentətɪv/; [adj]试探性的;不确定的;暂时的;犹豫不决的; [or]z8;
tenuous: [a]/ˈtenjuəs/; [adj]纤细的;稀薄的;贫乏的;脆弱的; [or]z8;
tenure: [a]/ˈtenjər/; [n]任期;终身职位; [or]z8;
tepid: [a]/ˈtepɪd/; [adj]微温的,不热烈的; [or]z8;
terrain: [a]/təˈreɪn/; [n]地面,地形; [or]z8;
terrestrial: [a]/təˈrestriəl/; [adj]地球的,陆地的; [n]陆地生物;地球上的人; [or]z8;
terse: [a]/tɜːrs/; [adj]简洁的,简明的; [or]z8;
testator: [a]/tes'teɪtə/; [n]立遗嘱者; [or]z8;
tether: [a]/ˈteðər/; [n]范围,系链,拴绳; [v]用绳或链拴住; [or]z8;
thatch: [a]/θætʃ/; [n]草屋顶,盖屋顶的稻草,(茂密的)头发; [v](用稻草等)盖(屋顶); [or]z8;
thee: [a]/ðiː/; [pron]你(古英语thou的宾格); [or]z8;
theorem: [a]/ˈθiːərəm/; [n]<数>定理,法则; [or]z8;
therapeutic: [a]/ˌθerəˈpjuːtɪk/; [adj]治疗的;治疗学的;有益于健康的; [n]治疗剂;治疗学家; [or]z8;
thermodynamics: [a]/ˌθɜːrmoʊdaɪˈnæmɪks/; [n]热力学; [or]z8;
threadbare: [a]/ˈθredber/; [adj]磨破的,衣衫褴褛的,乏味的,俗套的; [or]z8;
thud: [a]/θʌd/; [n]砰的一声,重击; [v]砰的一声掉下,发出砰声,砰地击中; [or]z8;
thyroid: [a]/ˈθaɪrɔɪd/; [adj]［解］甲状腺的; [n]甲状腺; [or]z8;
tilt: [a]/tɪlt/; [v](使)倾斜; [n]倾斜,斜坡; [or]z8;
tinder: [a]/ˈtɪndər/; [n]火绒,火种; [adj]易燃的; [or]z8;
tinge: [a]/tɪndʒ/; [n]淡淡的(颜色,神色),轻微,少量; [v]给.染色,轻微地影响; [or]z8;
tinker: [a]/ˈtɪŋkər/; [n](流动的)补锅工人; [v]做拙劣修补; [or]z8;
tint: [a]/tɪnt/; [n]色彩;染发剂;染色; [v]染色,着色于.; [or]z8;
tirade: [a]/ˈtaɪreɪd/; [n]长篇的攻击性演说; [or]z8;
tongs: [a]/tɔːŋz/; [n]夹子,钳子; [v]用钳子(夹); [or]z8;
tonic: [a]/ˈtɑːnɪk/; [n]补药;主调音或基音; [adj]滋补的;声调的;使精神振作的; [or]z8;
torrid: [a]/ˈtɔːrɪd/; [adj]酷热的,热烈; [or]z8;
torso: [a]/ˈtɔːrsoʊ/; [n](人体的)躯干,躯干像; [or]z8;
totalitarian: [a]/toʊˌtæləˈteriən/; [n]极权主义者; [adj]极权主义的; [or]z8;
totter: [a]/ˈtɑːtər/; [n]蹒跚,踉跄; [vi]蹒跚,踉跄,动摇,摇摇欲坠; [or]z8;
tout: [a]/taʊt/; [v]招徕顾客,极力赞扬; [or]z8;
tract: [a]/trækt/; [n]器官系统;一大片地;短文,小册子; [or]z8;
tractable: [a]/ˈtræktəbl/; [adj]易于管教的,易驾驭的,易处理的,驯良的; [or]z8;
trait: [a]/treɪt/; [n]特征; [or]z8;
trample: [a]/ˈtræmpl/; [v]踩坏(烂),践踏,蔑视; [n]踩踏,蹂躏; [or]z8;
trance: [a]/træns/; [n](因走神发呆而)恍惚,(医)神志昏迷; [v]使着迷; [or]z8;
transcend: [a]/trænˈsend/; [v]超越(经验,理性,信念等)的范围,超过; [or]z8;
transcribe: [a]/trænˈskraɪb/; [v]抄写,转录; [or]z8;
transfigure: [a]/trænsˈfɪɡjər/; [v]美观,改观; [or]z8;
transfuse: [a]/trænsˈfjuz/; [v]输血,充满; [or]z8;
transient: [a]/ˈtrænʃnt/; [adj]短暂的,路过的;转瞬即逝的; [n]过客; [or]z8;
transitory: [a]/ˈtrænsətɔːri/; [adj]短暂的,暂时的,瞬息的; [or]z8;
translucent: [a]/trænsˈluːsnt/; [adj]半透明的;透亮的,有光泽的;易懂的;真实的; [or]z8;
transmute: [a]/trænzˈmjuːt/; [v]使改变,使变形; [or]z8;
trauma: [a]/ˈtraʊmə/; [n]精神创伤,外伤; [or]z8;
traverse: [a]/trəˈvɜːrs/; [v]横越;穿过; [n]横越; [or]z8;
treacherous: [a]/ˈtretʃərəs/; [adj]不牢靠的,危险的;奸诈的,叛逆的,背叛的; [adv]背信弃义地; [n]背信弃义,背叛; [or]z8;
treatise: [a]/ˈtriːtɪs/; [n]论述;论文;专著; [or]z8;
treble: [a]/ˈtrebl/; [n]最高声部; [v]使成三倍; [adj]三倍的,最高声部的; [or]z8;
trek: [a]/trek/; [n]艰苦跋涉; [v]拉(货车),搬运; [or]z8;
tremor: [a]/ˈtremər/; [n](小)地震;<医>震颤,战栗,发抖; [or]z8;
trespass: [a]/ˈtrespæs/; [v]侵入;犯罪; [n]罪过;非法侵入; [or]z8;
trestle: [a]/ˈtresl/; [n]高架桥; [or]z8;
tributary: [a]/ˈtrɪbjəteri/; [n]支流;进贡国;附属国; [adj]支流的;附属的;辅助的; [or]z8;
trilogy: [a]/ˈtrɪlədʒi/; [n]三部曲; [or]z8;
trinket: [a]/ˈtrɪŋkɪt/; [n]小装饰品,不值钱的珠宝; [or]z8;
tripod: [a]/ˈtraɪpɑːd/; [n]三脚架,三脚桌; [or]z8;
trounce: [a]/traʊns/; [v]打败;痛打,严惩; [or]z8;
truce: [a]/truːs/; [n]停战;休战;休战协定; [or]z8;
trudge: [a]/trʌdʒ/; [n]长途跋涉,沉重的步伐; [v]跋涉,吃力地走; [or]z8;
tulip: [a]/ˈtuːlɪp/; [n]<植>郁金香; [or]z8;
turbid: [a]/ˈtɜːrbɪd/; [adj]混浊的,紊乱的; [or]z8;
turbine: [a]/ˈtɜːrbaɪn/; [n]汽轮机,叶轮机; [or]z8;
turmoil: [a]/ˈtɜːrmɔɪl/; [n]骚动,骚乱; [or]z8;
turning: [a]/ˈtɜːrnɪŋ/; [n]转弯处; [or]z8;
turret: [a]/ˈtɜːrət/; [n]塔楼,角塔; [or]z8;
tutelage: [a]/ˈtuːtəlɪdʒ/; [n]监护,指导; [or]z8;
twirl: [a]/twɜːrl/; [n]旋转,转动; [vi]旋转,回旋; [vt]旋转,转动; [or]z8;
twitch: [a]/twɪtʃ/; [v]猛拉,抽筋,痉挛; [n]抽搐,颤动; [or]z8;
tyrannical: [a]/tɪˈrænɪkl/; [adj]暴君的,专制的,残酷的; [or]z8;
ubiquitous: [a]/juːˈbɪkwɪtəs/; [adj]普遍存在的;无所不在的; [or]z8;
ultrasonic: [a]/ˌʌltrəˈsɑːnɪk/; [adj]超声的; [or]z8;
unassuming: [a]/ˌʌnəˈsuːmɪŋ/; [adj]谦逊的,不装腔作势的; [or]z8;
uncanny: [a]/ʌnˈkæni/; [adj]神秘的,不可思议的; [or]z8;
uncouth: [a]/ʌnˈkuːθ/; [adj]笨拙的;粗野的;不舒适的;陌生的; [or]z8;
undercharge: [a]/ˌʌndərˈtʃɑːrdʒ/; [n]索价低于常价;充电不足; [vi]向.少收钱; [vt]向.少收钱; [or]z8;
undercut: [a]/ˌʌndərˈkʌt/; [v]廉价出售;较便宜的工资工作;从下边削球; [n]底切;牛腰部下侧嫩肉;砍口;切球; [adj]下部被削去[切去,挖掉,凿去]的; [or]z8;
underdog: [a]/ˈʌndərdɔːɡ/; [n]弱势的一方,受害者,输家; [or]z8;
underlie: [a]/ˌʌndərˈlaɪ/; [v]位于..之下;成为..的基础; [or]z8;
underling: [a]/ˈʌndərlɪŋ/; [n]下属,手下; [or]z8;
underwrite: [a]/ˌʌndərˈraɪt/; [v]给.保险,承诺支付;同意赔款(海上保险); [or]z8;
undulate: [a]/ˈʌndʒəleɪt/; [adj]波动的;波浪形的; [v]波动,起伏; [or]z8;
unequivocal: [a]/ˌʌnɪˈkwɪvəkl/; [adj]明确的,不含糊的; [or]z8;
unethical: [a]/ʌnˈeθɪkl/; [adj]不道德的;缺乏职业道德的; [or]z8;
unforeseen: [a]/ˌʌnfɔːrˈsiːn/; [adj]无法预料的; [or]z8;
ungainly: [a]/ʌnˈɡeɪnli/; [adj]笨拙的,不雅的; [adv]笨拙地;不雅地; [or]z8;
unicorn: [a]/ˈjuːnɪkɔːrn/; [n]独角兽; [or]z8;
unify: [a]/ˈjuːnɪfaɪ/; [v]使联合,统一;使相同,使一致; [or]z8;
unilateral: [a]/ˌjuːnɪˈlætrəl/; [adj]单边的,单方面的;<植>单侧的;单边音;(父母)单系的; [or]z8;
unison: [a]/ˈjuːnɪsn/; [n]一致,(音)齐唱; [adj]同音的; [or]z8;
unkempt: [a]/ˌʌnˈkempt/; [adj](衣服,头发)不整洁的;蓬乱的; [or]z8;
unnerve: [a]/ˌʌnˈnɜːrv/; [v]使失去勇气,使焦躁,使失常; [or]z8;
unobtrusive: [a]/ˌʌnəbˈtruːsɪv/; [adj]不唐突的,谦虚的,不引人注目的; [or]z8;
unpalatable: [a]/ʌnˈpælətəbl/; [adj]不可口的,不好吃的;令人不愉快的; 使人难以接受的; [or]z8;
unparalleled: [a]/ʌnˈpærəleld/; [adj]无比的,无双的,空前的; [or]z8;
unravel: [a]/ʌnˈrævl/; [v]解开;拆开;阐明;解释; [or]z8;
unruly: [a]/ʌnˈruːli/; [adj]不守规矩的;任性的;难驾驭的; [or]z8;
unseemly: [a]/ʌnˈsiːmli/; [adj]不适宜的;不得体的; [adv]不适当地; [or]z8;
unsightly: [a]/ʌnˈsaɪtli/; [adj]难看的; [or]z8;
untenable: [a]/ʌnˈtenəbl/; [adj]防守不住的,站不住脚的; [or]z8;
untold: [a]/ˌʌnˈtoʊld/; [adj]无数的,数不清的; [or]z8;
unwieldy: [a]/ʌnˈwiːldi/; [adj]使用不便的,不灵巧的,难处理的;笨重的; [or]z8;
unwind: [a]/ˌʌnˈwaɪnd/; [vt]展开,放松,伸直; [or]z8;
unwitting: [a]/ʌnˈwɪtɪŋ/; [adj]不知情的;无意的; [or]z8;
upcoming: [a]/ˈʌpkʌmɪŋ/; [adj]即将来临的; [or]z8;
upheaval: [a]/ʌpˈhiːvl/; [n]动乱,大变动; [or]z8;
upkeep: [a]/ˈʌpkiːp/; [n]保养,维持;维修费; [or]z8;
upmarket: [a]/ˌʌpˈmɑːrkɪt/; [adj]质优价高的;高级的; [adv]在高档之列; [n]高档商品; [v]使进入高消费者市场; [or]z8;
uprising: [a]/ˈʌpraɪzɪŋ/; [n]起义;升起; [adj]升起的; [v]起义;升起; [or]z8;
upstart: [a]/ˈʌpstɑːrt/; [n]傲慢自负的人,暴发户,自命不凡的人; [adj]暴富的,自命不凡的; [v](使)突然跳起,(使)崛起; [or]z8;
upsurge: [a]/ˈʌpsɜːrdʒ/; [n]高潮,高涨; [or]z8;
uranium: [a]/juˈreɪniəm/; [n]铀; [or]z8;
urinate: [a]/ˈjʊrəneɪt/; [v]小便,撒尿; [or]z8;
usurp: [a]/juːˈzɜːrp/; [vi]篡夺,篡位; [vt]篡夺,强夺; [or]z8;
utilitarian: [a]/ˌjuːtɪlɪˈteriən/; [adj]实用的;功利的; [n]实用主义者; [or]z8;
vagabond: [a]/ˈvæɡəbɑːnd/; [n]流浪者; [v]漂泊,流浪; [adj]流浪的,流浪者的,漂泊的; [or]z8;
vagrant: [a]/ˈveɪɡrənt/; [n]游民; [adj]漂泊的; [or]z8;
validate: [a]/ˈvælɪdeɪt/; [v]使.生效,使合法化;证明正确; [or]z8;
valor: [a]/'vælə/; [n]勇猛,英勇; [or]z8;
valve: [a]/vælv/; [n]阀门,活门; [or]z8;
vandalism: [a]/ˈvændəlɪzəm/; [n](对公物)恶意破坏; [or]z8;
vanguard: [a]/ˈvænɡɑːrd/; [n]先锋,前锋;先驱;领导者; [or]z8;
vanilla: [a]/vəˈnɪlə/; [n]香草子,香草精; [or]z8;
vanquish: [a]/ˈvæŋkwɪʃ/; [v]征服,击败; [or]z8;
vantage: [a]/'vɑːntɪdʒ/; [n]优势;有利情况; [or]z8;
varicose: [a]/'værɪˌkoʊs/; [adj]［医］静脉曲张的,治疗静脉曲张用的; [or]z8;
vat: [a]/væt/; [n]大缸,瓮染料制剂; [vt]把.装入大桶; [or]z8;
vault: [a]/vɔːlt/; [n]保险库,金库,拱顶,墓室; [v]越过,跳过; [or]z8;
veal: [a]/viːl/; [n]小牛肉; [or]z8;
veer: [a]/vɪr/; [n]方向的转变; [v]转向,改变(话题等),放松(绳,缆等); [or]z8;
vehement: [a]/ˈviːəmənt/; [adj]猛烈的,强烈的; [or]z8;
velocity: [a]/vəˈlɑːsəti/; [n]速度;迅速,快速; [or]z8;
venerable: [a]/ˈvenərəbl/; [adj]令人尊敬的;(因历史悠久而) 神圣庄严的; [or]z8;
venerate: [a]/ˈvenəreɪt/; [v]崇敬,敬仰; [or]z8;
vengeance: [a]/ˈvendʒəns/; [n]复仇,报仇; [or]z8;
venison: [a]/ˈvenɪsn/; [n]鹿肉;野味; [or]z8;
venom: [a]/ˈvenəm/; [n]毒液;恶意;怨恨; [vt]使有毒;放毒; [or]z8;
venomous: [a]/ˈvenəməs/; [adj]恶毒的;有毒的,分泌毒液的;怨恨的; [or]z8;
verbatim: [a]/vɜːrˈbeɪtɪm/; [adj]逐字的; [adv]逐字地; [or]z8;
vermin: [a]/ˈvɜːrmɪn/; [n]害虫,寄生虫; [or]z8;
vernacular: [a]/vərˈnækjələr/; [adj]本国的,地方的,用本地语写成的; [n]方言;土语;(建筑的)民间风格; [or]z8;
vernal: [a]/ˈvɜːrnl/; [adj]春天的,和煦的,青春的; [or]z8;
versatility: [a]/ˌvɜːrsəˈtɪləti/; [n]多功能;多用途; [or]z8;
verse: [a]/vɜːrs/; [n]诗句,诗节,诗; [or]z8;
vertebrate: [a]/ˈvɜːrtɪbrət/; [adj]有脊椎的; [n]脊椎动物; [or]z8;
verve: [a]/vɜːrv/; [n]热情,神韵,活力,气魄; [or]z8;
vestige: [a]/ˈvestɪdʒ/; [n]遗迹,(生)退化的器官,残余,微量(一般用于否定句); [or]z8;
vet: [a]/vet/; [n]兽医; [v]作兽医;诊疗;审查; [or]z8;
vex: [a]/veks/; [v]使烦恼,使苦恼,使恼怒; [or]z8;
vexation: [a]/vekˈseɪʃn/; [n]苦恼,恼怒,令人烦恼的事; [or]z8;
viable: [a]/ˈvaɪəbl/; [adj]可行的;能养活的;能生育的; [or]z8;
vial: [a]/ˈvaɪəl/; [n]小瓶,药水瓶; [v]装入小瓶; [or]z8;
vicarious: [a]/vaɪˈkeriəs/; [adj]代替别人做的;代理的,代替的;发同感的; [or]z8;
vicinity: [a]/vəˈsɪnəti/; [n]附近地区;近邻;附近; [or]z8;
victimize: [a]/ˈvɪktɪmaɪz/; [v]使受害,使牺牲,欺骗; [or]z8;
vie: [a]/vaɪ/; [v]竞争;使针锋相对;以..作较量; [or]z8;
vignette: [a]/vɪnˈjet/; [n]装饰图案;小插图; [v]把..印放为虚光照,晕映; [or]z8;
vile: [a]/vaɪl/; [adj]令人讨厌的,恶心的;可恨的;可耻的;简陋的; [or]z8;
vindicate: [a]/ˈvɪndɪkeɪt/; [vt]证明.无辜;维护,辩护; [or]z8;
vindictive: [a]/vɪnˈdɪktɪv/; [adj]报复性的,怀恨的,惩罚的; [or]z8;
viola: [a]/viˈoʊlə/; [n]中提琴; [or]z8;
viral: [a]/ˈvaɪrəl/; [adj]滤过性毒菌引起的;滤过性毒菌的; [n]病毒式传播;<经>病毒式营销; [or]z8;
virile: [a]/ˈvɪrəl/; [adj]成年男子的,有男子气概的,强壮的; [or]z8;
virtuous: [a]/ˈvɜːrtʃuəs/; [adj]善良的,有德行的,贞洁的; [or]z8;
virulent: [a]/ˈvɪrələnt/; [adj]剧毒的;恶性的;有恶意的; [or]z8;
visage: [a]/ˈvɪzɪdʒ/; [n]脸,面貌; [or]z8;
visualize: [a]/ˈvɪʒuəlaɪz/; [v]使形象化;想象; [or]z8;
vocalist: [a]/ˈvoʊkəlɪst/; [n]流行歌手,声乐家; [or]z8;
vogue: [a]/voʊɡ/; [n]时髦,时尚; [adj]流行的; [or]z8;
void: [a]/vɔɪd/; [n]空间;空洞;空位;空虚感; [adj]缺乏的;空的,没有的;<律>无效的; [v]使无效,把.作废, 宣布.作废;腾出,清理; [vi]排泄; [or]z8;
volatile: [a]/ˈvɑːlətl/; [adj]易气化的;爆炸性的;反复无常的;短暂的;不稳定的; [or]z8;
voluble: [a]/ˈvɑːljəbl/; [adj]健谈的,缠绕的,易旋转的; [or]z8;
voluminous: [a]/vəˈluːmɪnəs/; [adj]大量的;长篇的,多产的;庞大的; [adv]宽松地;容量大地;篇幅长地; [n]宽松;容量大,篇幅长; [or]z8;
vortex: [a]/ˈvɔːrteks/; [n]旋涡,气旋;涡流; [or]z8;
vulture: [a]/ˈvʌltʃər/; [n]秃鹰,秃鹫;贪婪的人; [or]z8;
waddle: [a]/ˈwɑːdl/; [v](鸭,矮胖子等)摇摇摆摆地走,蹒跚而行; [n]摇摆的步子; [or]z8;
wade: [a]/weɪd/; [v]涉水而行,淌水;跋涉; [or]z8;
wag: [a]/wæɡ/; [n]摇摆;爱说笑的人; [v]摇动; [or]z8;
wail: [a]/weɪl/; [n]恸哭;哀诉; [vi]恸哭;悲叹; [vt]哀悼; [or]z8;
waive: [a]/weɪv/; [v]放弃;不坚持;推迟;搁置; [vt]抑制;搁置; [or]z8;
wallow: [a]/ˈwɑːloʊ/; [v]打滚;沉迷,沉溺;颠簸; [n]打滚;堕落;泥坑; [or]z8;
wane: [a]/weɪn/; [n]衰退(期);月亏(期);减少; [v](月)缺损;(光,势力,治理等)衰落;减少; [or]z8;
wanton: [a]/ˈwɑːntən/; [n]水性杨花的人,任性的孩子,无节制的人; [v]放肆,胡作非为,挥霍; [adj]胡作非为的,淫荡的,无节制的; [or]z8;
warp: [a]/wɔːrp/; [n]弯曲,歪曲,偏见; [v]使变形,使有偏见,曲解; [or]z8;
warranty: [a]/ˈwɔːrənti/; [n]授权;根据;保证书;担保书,保单; [or]z8;
wary: [a]/ˈweri/; [adj]谨慎的,小心的,提防的;考虑周到的; [or]z8;
watery: [a]/ˈwɔːtəri/; [adj]水的;水分多的;水淋淋的,平淡的,稀薄的,松软的,有雨意的;微弱的,淡薄的; [or]z8;
waver: [a]/ˈweɪvər/; [vi]犹豫;摇摆;颤抖; [or]z8;
wayward: [a]/ˈweɪwərd/; [adj]任性的,不规则的,刚愎的; [or]z8;
wean: [a]/wiːn/; [v]断奶,戒掉(off/from),(从早年开始)使用; [n]〈英〉婴儿;小儿; [or]z8;
wedge: [a]/wedʒ/; [v]楔入; [n]楔子; [or]z8;
weird: [a]/wɪrd/; [adj]古怪的;荒唐的; [or]z8;
whack: [a]/wæk/; [v]重打;猛击;击败;削减; [n]重击;尝试;份儿;机会; [or]z8;
whiff: [a]/wɪf/; [n]一吹,一吸,一阵香气,一点点,香烟的一口; [v]轻轻地吹,喷气,<棒>三击出局; [or]z8;
whimsical: [a]/ˈwɪmzɪkl/; [adj]古怪的,异想天开的; [or]z8;
whirlwind: [a]/ˈwɜːrlwɪnd/; [n]旋风,旋风般的快速行动; [adj]旋风般的; [or]z8;
whisk: [a]/wɪsk/; [n]扫帚;毛掸子;搅拌器,打蛋器;拂; [v]扫;拂;挥动;搅拌;飞奔; [or]z8;
whitewash: [a]/ˈwaɪtwɑːʃ/; [v]用石灰水把..刷白; [n]石灰水,白色涂料,白粉胶泥水,涂脂抹粉; [or]z8;
wicked: [a]/ˈwɪkɪd/; [adj]邪恶的,恶毒的;淘气的,恶作剧的; [n]恶人;邪恶的人; [adv]用作加强语气用; [or]z8;
wield: [a]/wiːld/; [v]运用,行使;挥; [vt]使用; [or]z8;
wiggle: [a]/ˈwɪɡl/; [v]扭动,蠕动; [n]扭动; [or]z8;
wilt: [a]/wɪlt/; [v]使.凋谢,枯萎; [n]枯萎;憔悴; [or]z8;
wily: [a]/ˈwaɪli/; [adj]狡猾的; [or]z8;
wince: [a]/wɪns/; [v]避开,畏缩; [n]畏缩;脸部肌肉的抽搐; [or]z8;
windfall: [a]/ˈwɪndfɔːl/; [n]风吹落果;意外的收获,意外幸运; [or]z8;
withstand: [a]/wɪðˈstænd/; [v]忍受;抵挡; [or]z8;
wizard: [a]/ˈwɪzərd/; [n]男巫,奇才; [adj]男巫的,有魔力的; [v]〈罕〉施巫术; [or]z8;
wobble: [a]/ˈwɑːbl/; [v]摇晃;摇摆;游移不定; [n]摆动;摇晃;不稳定; [or]z8;
woe: [a]/woʊ/; [n]悲哀;痛苦; [int]唉(表示痛苦,悲伤或悔恨);咳; [or]z8;
woo: [a]/wuː/; [v]向(女人)求爱,争取.的支持,追求; [or]z8;
wrapper: [a]/ˈræpər/; [n]包装材料;<包装>包装纸;书皮; [or]z8;
wrath: [a]/ræθ/; [n]愤怒; [or]z8;
wreckage: [a]/ˈrekɪdʒ/; [n]残骸;失事;破坏; [or]z8;
wrench: [a]/rentʃ/; [n]扳手;痛苦,难受;猛扭,猛拉; [v]猛拧;挣脱;使扭伤; [or]z8;
wrest: [a]/rest/; [n]扭,拧; [vt]用力拧;强夺;歪曲; [or]z8;
wring: [a]/rɪŋ/; [v]扭,榨取,强求;绞,拧,扭(尤指脖子); [n]扭,榨取,强求;折磨; [or]z8;
writhe: [a]/raɪð/; [v]扭动(身体);扭曲变形;缠绕打结; [n]扭动;翻腾;苦恼; [or]z8;
wry: [a]/raɪ/; [adj]歪斜的,扭歪的,歪曲的; [v]歪曲,扭曲;扭转; [or]z8;
xenophobia: [a]/ˌzenəˈfoʊbiə/; [n]仇外,对外国人的恐惧或憎恨; [or]z8;
yeoman: [a]/ˈjoʊmən/; [n]自耕农;自由民;仆人; [adj]坚毅的,刚毅的,忠实的; [or]z8;
yoga: [a]/ˈjoʊɡə/; [n]瑜珈,瑜珈术; [or]z8;
yummy: [a]/ˈjʌmi/; [adj]美味的,好吃的; [or]z8;
zealot: [a]/ˈzelət/; [n]狂热份子,犹太教狂热信徒; [or]z8;
zenith: [a]/ˈziːnɪθ/; [n]顶点,顶峰;全盛; [or]z8;
zest: [a]/zest/; [n]兴趣,乐趣;滋味,风味; [v]给.调味; [or]z8;
zoom: [a]/zuːm/; [v](镜头)拉近(拉远);急速上升,嗡嗡作响; [n]车辆疾驰的声音,嗡嗡声,(摄影)变焦; [or]z8;
