Antarctic: [a]/ænˈtɑːrktɪk/; [adj]南极的; [n]南极区; [or]yshx;
Arctic: [a]/ˈɑːrktɪk/; [n]北极; [adj]北极的,极寒的; [or]yshx;
Catholic: [a]/ˈkæθlɪk/; [adj](兴趣等)广泛的,(C大写)天主教的; [n](C大写)天主教徒; [or]yshx;
Christian: [a]/ˈkrɪstʃən/; [n]基督教徒; [adj]基督教的,基督教徒的; [or]yshx;
Easter: [a]/ˈiːstər/; [n]复活节; [or]yshx;
Fahrenheit: [a]/ˈfærənhaɪt/; [n]华氏度; [adj]华氏度的,华氏温度计的; [or]yshx;
abandon: [a]/əˈbændən/; [v]抛弃;放弃;放纵; [or]yshx;
abbreviation: [a]/əˌbriːviˈeɪʃn/; [n]缩短;缩写词;省略号; [or]yshx;
abnormal: [a]/æbˈnɔːrml/; [adj]反常的;畸形的; [or]yshx;
abolish: [a]/əˈbɑːlɪʃ/; [v]废除,废止;取消,革除; [or]yshx;
aboriginal: [a]/ˌæbəˈrɪdʒənl/; [adj]土著的,原来的; [n]土著居民; [or]yshx;
abort: [a]/əˈbɔːrt/; [v]异常中断,中途失败,流产,发育不全; [or]yshx;
abound: [a]/əˈbaʊnd/; [v]充满,很多,富于; [or]yshx;
above(beyond) reproach: [a]/əˈbʌv bɪˈjɑːnd rɪˈproʊtʃ/; [adv]无可指责,无可厚非; [or]yshx;
abrasion: [a]/əˈbreɪʒn/; [n]表面磨损;擦伤; [or]yshx;
abridge: [a]/əˈbrɪdʒ/; [v]删节;削减; [or]yshx;
abrupt: [a]/əˈbrʌpt/; [adj]突然的;唐突的;鲁莽的; [or]yshx;
absorb: [a]/əbˈzɔːrb/; [vt]吸收;汲取;吸引..的注意;理解,掌握;承受; [or]yshx;
abstract: [a]/ˈæbstrækt/; [adj]抽象的; [n]摘要,抽象; [v]提取; [or]yshx;
absurd: [a]/əbˈsɜːrd/; [adj]荒唐的;可笑的;不合理的; [n]荒唐; [or]yshx;
abundance: [a]/əˈbʌndəns/; [n]丰富;大量; [or]yshx;
abuse: [a]/əˈbjuːs/; [v]虐待;辱骂;(对麻醉毒品,兴奋剂等的)非法服用;滥用; [n]滥用;虐待;辱骂; [or]yshx;
academic: [a]/ˌækəˈdemɪk/; [adj]学术的;学院的,大学的;理论的; [n]学者; [or]yshx;
accelerate: [a]/əkˈseləreɪt/; [v]加速,增长;使增速,促进; [or]yshx;
access: [a]/ˈækses/; [n]进入;使用权;通道; [v]进入;访问; [or]yshx;
accessory: [a]/əkˈsesəri/; [n](妇女的)装饰品;附件;附属物;同谋; [adj]附属的;辅助的;同谋的; [or]yshx;
accommodate: [a]/əˈkɑːmədeɪt/; [v]向.提供住处(或膳宿);给.提供方便;容纳;使适应,顺应; [or]yshx;
accompany: [a]/əˈkʌmpəni/; [v]陪伴;为..伴奏(或伴唱); [or]yshx;
accomplish: [a]/əˈkɑːmplɪʃ/; [v]完成,做到;实现; [or]yshx;
accord: [a]/əˈkɔːrd/; [n]协议; [v]授予; [or]yshx;
account: [a]/əˈkaʊnt/; [n]账户;原因,理由;叙述; [v]报账,做出说明(或解释),为.负责,受罚;认为,考虑; [or]yshx;
accountable for: [a]/əˈkaʊntəb(ə)l fɔr/; [adj]对.应负责任; [or]yshx;
accumulate: [a]/əˈkjuːmjəleɪt/; [vi]聚积,堆积; [vt]积攒,积累; [or]yshx;
accuse: [a]/əˈkjuːz/; [v]指责;控告;把..归咎于; [or]yshx;
achieve: [a]/əˈtʃiːv/; [v]完成,达到,获得,实现; [or]yshx;
acid: [a]/ˈæsɪd/; [n]<化学>酸;酸性物质;尖酸; [adj]尖刻的;敏锐的;含酸过多的;酸的;酸味的; [or]yshx;
acknowledge: [a]/əkˈnɑːlɪdʒ/; [v]告知收到;对(人)打招呼,招呼(某人)以示相识,致意;就..表示谢忱,鸣谢,感谢,感激,答谢,对..表示感谢;承认(属实),承认(权威,地位); [or]yshx;
acquaint: [a]/əˈkweɪnt/; [v]使熟悉;使认识;介绍; [or]yshx;
acquire: [a]/əˈkwaɪər/; [v](尤指靠自己的努力或行动或经过一个过程)获得;学到;取得; [or]yshx;
activate: [a]/ˈæktɪveɪt/; [v]使活动起来;使开始起作用; [or]yshx;
acute: [a]/əˈkjut/; [adj](疼痛,妒忌等)剧烈的,严重的;敏锐的;急性的;尖声的; [or]yshx;
adapt: [a]/əˈdæpt/; [vi]适应不同情况; [vt]使适合;改编; [or]yshx;
addict: [a]/ˈædɪkt/; [n]上瘾的人;入迷的人; [v]使沉迷,使上瘾; [or]yshx;
address: [a]/əˈdres/; [n]地址;致词; [v]致函;写姓名地址;向..讲话;处理; [or]yshx;
adept: [a]/əˈdept/; [n]专家,能手; [adj]熟练的;巧妙的; [or]yshx;
adequate: [a]/ˈædɪkwət/; [adj]充足的,充分的,足够的;尚可的,过得去的; [or]yshx;
adhere: [a]/ədˈhɪr/; [v]遵守;坚持;粘附;附着,粘在..上; [or]yshx;
adjacent: [a]/əˈdʒeɪsnt/; [adj]邻接的,毗连的;邻近的; [or]yshx;
adjoin: [a]/əˈdʒɔɪn/; [v]与.毗连;贴近; [or]yshx;
adjust: [a]/əˈdʒʌst/; [v]调整,调节;校正;改变.以适应; [or]yshx;
administer: [a]/ədˈmɪnɪstər/; [v]管理;执行;实施;给予;用(药); [or]yshx;
admission: [a]/ədˈmɪʃn/; [n]准许进入;进入权;入场费; [or]yshx;
adolescence: [a]/ˌædəˈlesns/; [n]青春期,青春; [or]yshx;
adopt: [a]/əˈdɑːpt/; [v]收养;采纳,采用; [or]yshx;
adore: [a]/əˈdɔːr/; [v]很喜欢,极喜爱;崇拜;爱慕; [or]yshx;
advent: [a]/ˈædvent/; [n]来临;到来;出现; [or]yshx;
adverse: [a]/ˈædvɜːrs/; [adj]不利的;(方向上)逆的;在相反的方向上移动(或运转);相反的; [or]yshx;
advertise: [a]/ˈædvərtaɪz/; [v]为..做广告;公告;公布; [or]yshx;
advocate: [a]/ˈædvəkeɪt/; [v]提倡;主张;为.辩护; [n]辩护者;提倡者;律师; [or]yshx;
aerial: [a]/ˈeriəl/; [adj]飞机的,航空的,由飞机进行的;空中的,架空的; [n]天线; [or]yshx;
aesthetic: [a]/esˈθetɪk/; [n]美感;审美观; [adj]美学的;审美的;悦目的;雅致的; [or]yshx;
affect: [a]/əˈfekt/; [v]影响,感动,作用; [n]感情,情感,心情;<精神病学>(表露或觉察到的)情绪反应; [or]yshx;
affection: [a]/əˈfekʃn/; [n]关爱,爱慕;感情;作用,影响;疾病; [or]yshx;
affirm: [a]/əˈfɜːrm/; [v]肯定;断定;坚持声称; [or]yshx;
affix: [a]/əˈfɪks/; [v]粘上;署名;将罪责加之于; [n]词缀;附加物; [or]yshx;
afflict: [a]/əˈflɪkt/; [v]使痛苦;使苦恼; [or]yshx;
afford: [a]/əˈfɔːrd/; [v]买得起;抽得出时间;担负得起;提供;产生;赐予; [vi]担负得起;买得起; [or]yshx;
agency: [a]/ˈeɪdʒənsi/; [n]代理(处);政府机构;代理;介入;作用; [or]yshx;
agenda: [a]/əˈdʒendə/; [n]议事日程; [or]yshx;
aggravate: [a]/ˈæɡrəveɪt/; [v]使恶化,加重;使气恼,激怒; [or]yshx;
aggregate: [a]/ˈæɡrɪɡət/; [n]合计;总数;混凝料;总计; [v]集合;聚集;合计; [adj]总的,总数的;集合的; [or]yshx;
aggressive: [a]/əˈɡresɪv/; [adj]好斗的,挑衅性的;有闯劲的,积极进取的; [or]yshx;
agitation: [a]/ˌædʒɪˈteɪʃn/; [n]摇动;焦虑,忧虑;煽动; [or]yshx;
agony: [a]/ˈæɡəni/; [n]极大痛苦; [or]yshx;
agreeable: [a]/əˈɡriːəbl/; [adj](欣然)同意的;愉快的;可以接受的; [or]yshx;
agreement: [a]/əˈɡriːmənt/; [n]协议,协定;一致,相合; [or]yshx;
airing: [a]/ˈerɪŋ/; [n]通风;讨论;晾干; [or]yshx;
aisle: [a]/aɪl/; [n](席位间的)通道,过道; [or]yshx;
alarm: [a]/əˈlɑːrm/; [n]警报器,警报;闹钟;惊恐,忧虑; [v]使惊恐,使忧虑; [or]yshx;
album: [a]/ˈælbəm/; [n]相册;唱片集,专辑;集邮册; [or]yshx;
alien: [a]/ˈeɪliən/; [n]外国人;外星人; [adj]陌生的;外国的,外星(人)的;异己的,不相容的; [or]yshx;
all in all: [a]/ɔːl ɪn ɔːl/; [phr]总而言之;总的来说; [or]yshx;
all out: [a]/ˌɔːl ˈaʊt/; [phr]全力以赴; [or]yshx;
all the same to: [a]/ɔl ðə seɪm tu/; [phr]对.说来都一样;无所谓; [or]yshx;
all the time: [a]/ɔl ðə taɪm/; [adv]始终;一直; [or]yshx;
all told: [a]/ɔːl toʊld/; [adv]总共; [or]yshx;
allege: [a]/əˈledʒ/; [v]断言;硬说; [or]yshx;
allegiance: [a]/əˈliːdʒəns/; [n]忠诚,拥护; [or]yshx;
alleviate: [a]/əˈliːvieɪt/; [v]减轻;缓解;缓和; [or]yshx;
alliance: [a]/əˈlaɪəns/; [n]联盟,同盟;盟约;盟国,同盟者;类同; [or]yshx;
allocate: [a]/ˈæləkeɪt/; [v]分配,配给; [or]yshx;
allowance: [a]/əˈlaʊəns/; [v]定量供应(食物,饮料等物品);配给; [n]零用钱;津贴,补贴;限额;免税额;允许,容忍,让步;考虑; [or]yshx;
alloy: [a]/ˈælɔɪ/; [n]合金; [v]使成合金; [or]yshx;
alongside: [a]/əˌlɔːŋˈsaɪd/; [adv]在旁边,并排地,并肩地; prep. 在.旁边,和.并排;和.一起; [or]yshx;
alphabetical: [a]/ˌælfəˈbetɪkl/; [adj]字母(表)的;按字母(表)顺序的; [or]yshx;
alter: [a]/ˈɔːltər/; [v]改变;改动,使变样;改做; [or]yshx;
alternate: [a]/ˈɔːltərnət/; [adj]交替的,轮流的,间隔的; [v](使)交替,(使)轮流; [n]代替者; [or]yshx;
altitude: [a]/ˈæltɪtuːd/; [n]海拔,高度; [or]yshx;
amateur: [a]/ˈæmətʃər/; [n]业余爱好者;外行; [adj]外行的;业余爱好的,业余(身份)的; [or]yshx;
amaze: [a]/əˈmeɪz/; [v]使惊奇,使惊诧; [or]yshx;
ambassador: [a]/æmˈbæsədər/; [n](特命全权)大使;代表; [or]yshx;
ambiguity: [a]/ˌæmbɪˈɡjuːəti/; [n]模棱两可;歧义;误解; [or]yshx;
ambition: [a]/æmˈbɪʃn/; [n]雄心,强烈欲望,抱负;(具体的)追求目标; [vt]追求;有.野心; [or]yshx;
ambulance: [a]/ˈæmbjələns/; [n]救护车; [or]yshx;
amend: [a]/əˈmend/; [v]改进;修订;修正; [or]yshx;
amid: [a]/əˈmɪd/; prep. 在.中间,被.围绕; [or]yshx;
ammunition: [a]/ˌæmjuˈnɪʃn/; [n]弹药;炮弹; [or]yshx;
amount: [a]/əˈmaʊnt/; [n]数量,总额; [v]合计,共计;等同,接近(to); [or]yshx;
amphibian: [a]/æmˈfɪbiən/; [n]两栖动物;水陆两用飞机和车辆; [adj]两栖类的;<车辆>水陆两用的;具有双重性格的; [or]yshx;
ample: [a]/ˈæmpl/; [adj]富足的,丰满的,宽敞的; [or]yshx;
amplify: [a]/ˈæmplɪfaɪ/; [v]放大(声音等);扩大;增强;详述;进一步阐述; [or]yshx;
amuse: [a]/əˈmjuːz/; [v]娱乐,消遣,使发笑; [or]yshx;
ancestor: [a]/ˈænsestər/; [n]祖宗;祖先;原型; [or]yshx;
anchor: [a]/ˈæŋkər/; [n]担任(广播电视新闻节目)的主持人;支柱;锚; [v]抛锚; [vt]使固定; [or]yshx;
anecdote: [a]/ˈænɪkdoʊt/; [n]轶事,趣闻; [or]yshx;
annihilate: [a]/əˈnaɪəleɪt/; [v]消灭; [or]yshx;
anniversary: [a]/ˌænɪˈvɜːrsəri/; [n]周年纪念日; [adj]周年的,(有关)周年纪念的; [or]yshx;
annoy: [a]/əˈnɔɪ/; [v]使烦恼,使生气; [n]烦恼(等于annoyance); [or]yshx;
annual: [a]/ˈænjuəl/; [adj]一年一次的,年度的; [n]年鉴,一年生植物,一年一度的事件; [or]yshx;
annuity: [a]/əˈnuːəti/; [n]年金,养老金;年金保险;年金享受权; [or]yshx;
anonymous: [a]/əˈnɑːnɪməs/; [adj]匿名的;无名的;不具名的;无特色的;无个性特征; [or]yshx;
antagonism: [a]/ænˈtæɡənɪzəm/; [n]对抗,敌对;敌意; [or]yshx;
antecedent: [a]/ˌæntɪˈsiːdnt/; [adj]先行的,先驱的; [n]祖先,前情; [or]yshx;
anthem: [a]/ˈænθəm/; [n]国歌,赞美诗,圣歌; [or]yshx;
antibiotic: [a]/ˌæntibaɪˈɑːtɪk/; [n]抗生素; [adj]抗菌的; [or]yshx;
anticipation: [a]/ænˌtɪsɪˈpeɪʃn/; [n]预期,预料;期待;预知; [or]yshx;
antique: [a]/ænˈtiːk/; [n]古董;古玩;古物; [adj]古代的;古董的; [or]yshx;
anxiety: [a]/æŋˈzaɪəti/; [n]焦虑;忧虑;担心; [or]yshx;
anyhow: [a]/ˈenihaʊ/; [adv]不论用何种方法,无论如何;随意地;尽管如此; [or]yshx;
apologetic: [a]/əˌpɑːləˈdʒetɪk/; [adj]表示歉意的;赔罪的; [or]yshx;
apparatus: [a]/ˌæpəˈrætəs/; [n]装置,仪器;设备;组织,机构; [or]yshx;
apparent: [a]/əˈpærənt/; [adj]显然的,明白的,清晰可见的;表面上的,貌似(真实)的; [or]yshx;
appeal: [a]/əˈpiːl/; [vi]呼吁,请求;申诉;有吸引力; [n]呼吁;恳求;(为慈善或好的事业所做的) 筹款努力;(人或物的)吸引力; [or]yshx;
appendix: [a]/əˈpendɪks/; [n]附录;阑尾;附属物; [or]yshx;
appetite: [a]/ˈæpɪtaɪt/; [n]食欲,胃口;欲望; [or]yshx;
applaud: [a]/əˈplɔːd/; [v]鼓掌; [vi]喝彩; [vt]向.鼓掌表示赞赏;给.捧场; [or]yshx;
appliance: [a]/əˈplaɪəns/; [n]家用器具;家用电器;装置;应用; [or]yshx;
applicant: [a]/ˈæplɪkənt/; [n]申请人;请求者; [or]yshx;
apply oneself (to sth.): [a]/əˈplaɪ wʌnˈself tu ˈsʌmθɪŋ/; [v]专心致志于; [or]yshx;
apply: [a]/əˈplaɪ/; [v]涂,敷;应用;申请; [or]yshx;
appointment: [a]/əˈpɔɪntmənt/; [n]约会,会面;委派;任命的职位;接受委派者;制定; [or]yshx;
appraisal: [a]/əˈpreɪzl/; [n]评估;估价;评价; [or]yshx;
appreciable: [a]/əˈpriːʃəbl/; [adj]很可观的;可感知的;可察觉的;可评估的; [or]yshx;
apprehension: [a]/ˌæprɪˈhenʃn/; [n]忧虑,担心,疑惧;逮捕;理解; [or]yshx;
apprentice: [a]/əˈprentɪs/; [v]使当学徒; [n]学徒; [or]yshx;
approach: [a]/əˈproʊtʃ/; [v]接近;靠近;着手处理; [n]接近;途径;方法; [or]yshx;
appropriate: [a]/əˈproʊpriət/; [adj]合适的;适当的; [v]挪用;拨款;私占; [or]yshx;
approval: [a]/əˈpruːvl/; [n]批准;赞同;试销; [or]yshx;
approximate: [a]/əˈprɑːksɪmət/; [adj]近似的,约略的; [v]接近,近似; [or]yshx;
apt: [a]/æpt/; [adj]恰当的;有(做某事的)倾向; [or]yshx;
aquarium: [a]/əˈkweriəm/; [n]水族馆,水族箱,鱼缸; [or]yshx;
aquatic: [a]/əˈkwætɪk/; [adj]水生的,水栖的,水中的,水上的; [n]水生动物,水生植物;水上运动; [or]yshx;
arbitrary: [a]/ˈɑːrbətreri/; [adj]随意的,任性的,随心所欲的;霸道的,专制的,专横的;主观的,武断的; [or]yshx;
arch: [a]/ɑːrtʃ/; [n]拱洞;拱门;拱起; [v]做成拱形; [adj]调皮的,淘气的; [or]yshx;
archaic: [a]/ɑːrˈkeɪɪk/; [adj]古代的;陈旧的,过时的,老式的;已不通用的; [or]yshx;
architect: [a]/ˈɑːrkɪtekt/; [n]设计师;建筑师; [or]yshx;
archives: [a]/ˈɑːrkaɪvz/; [n]档案室,档案; [or]yshx;
ardent: [a]/ˈɑːrdnt/; [adj]热心的,热烈的; [or]yshx;
arduous: [a]/ˈɑːrdʒuəs/; [adj]艰巨的;努力的;陡峭的; [or]yshx;
arena: [a]/əˈriːnə/; [n]竞技场,角斗场;(活动,斗争或竞争的)场所,战场,(竞争)舞台; [or]yshx;
argue: [a]/ˈɑːrɡjuː/; [v]争吵;主张,认为;提供.证据,提出证明;表明(原因等); [or]yshx;
arise: [a]/əˈraɪz/; [v]起床;出现;升起;由.引起,发生; [or]yshx;
armour: [a]/ˈɑːrmər/; [n]盔甲; [or]yshx;
array: [a]/əˈreɪ/; [n]一系列;陈列;编队; [v]排列;部署; [or]yshx;
arrogant: [a]/ˈærəɡənt/; [adj]傲慢的,妄自尊大的; [or]yshx;
artery: [a]/ˈɑːrtəri/; [n]动脉;干线; [or]yshx;
article: [a]/ˈɑːrtɪkl/; [n]物品;文章;条款;冠词; [or]yshx;
articulate: [a]/ɑːrˈtɪkjuleɪt/; [adj]善于表达的;发音清晰的; [v]清晰地发音;清楚地讲话;连接,接合;与.合成整体 ,使相互连贯; [or]yshx;
artificial: [a]/ˌɑːrtɪˈfɪʃl/; [adj]人造的,人工的,假的;假装的,虚伪的; [n]人造肥料;<美>假花; [or]yshx;
artillery: [a]/ɑːrˈtɪləri/; [n]大炮,炮兵; [or]yshx;
as for: [a]/əz fɔr/; [phr]至于,就.方面说; [or]yshx;
as opposed to: [a]/æz ə'poʊʊzd tu/; [phr]与.形成对照; [or]yshx;
as well: [a]/əz wel/; [adv]同样地;也; [or]yshx;
ascent: [a]/əˈsent/; [n]上升;上坡路;登高; [or]yshx;
ascertain: [a]/ˌæsərˈteɪn/; [v]探知,弄清,查明(真相等); [or]yshx;
ascribe: [a]/əˈskraɪb/; [v]把.归因于;把.归属于; [or]yshx;
ashamed: [a]/əˈʃeɪmd/; [adj]感到羞愧的;害臊的; [or]yshx;
aspire: [a]/əˈspaɪər/; [vi]渴望,有志于(与to,for,after连用或后接不定式); [or]yshx;
aspirin: [a]/ˈæsprɪn/; [n]阿斯匹林; [or]yshx;
assassination: [a]/əˌsæsəˈneɪʃn/; [n]暗杀; [or]yshx;
assault: [a]/əˈsɔːlt/; [n]攻击,袭击; [v]攻击,袭击,殴打; [or]yshx;
assemble: [a]/əˈsembl/; [v]装配(机器等);集合;召集; [or]yshx;
assert: [a]/əˈsɜːrt/; [v]断言;肯定地说;坚持;维护; [or]yshx;
assess: [a]/əˈses/; [v]评估;估值; [or]yshx;
asset: [a]/ˈæset/; [n]财产,资产,有价值的东西或人; [or]yshx;
assign: [a]/əˈsaɪn/; [v]布置;分配;指定;指派;归因;确定; [or]yshx;
assimilate: [a]/əˈsɪməleɪt/; [v]使同化;吸收;消化; [or]yshx;
associate: [a]/əˈsoʊʃieɪt/; [v]联想;联合;联系,交往; [n]伙伴;同事; [adj]副的; [or]yshx;
assorted: [a]/əˈsɔːrtəd/; [adj]各式各样的; [or]yshx;
assume: [a]/əˈsuːm/; [v]猜想;以为,假设;呈现;就职;(想当然地)认为;承担(责任); [or]yshx;
assure: [a]/əˈʃʊr/; [v]向..保证,使确信;保证,确保; [or]yshx;
astronomy: [a]/əˈstrɑːnəmi/; [n]天文学; [or]yshx;
at a loose end: [a]/ət ə lus end/; [adv]不知做什么好; [or]yshx;
at a stroke: [a]/ət ə stroʊk/; [adv]一下子; [or]yshx;
at all times: [a]/ət ɔl taɪmz/; [adv]经常,一直;无论何时; [or]yshx;
at fault: [a]/ət fɔlt/; [phr]⋯⋯过错,⋯⋯责任; [or]yshx;
at full blast: [a]/æt fʊl blæst/; [adv]最大地; [or]yshx;
at full tilt: [a]/ət fʊl tɪlt/; [adv]全速地;全力以赴地; [or]yshx;
at its best: [a]/ət ɪts best/; [phr]处在最好状态; [or]yshx;
at the mercy of: [a]/ət ðə ˈmɜrsi ɑv/; prep. 在.支配中,任凭.摆布; [or]yshx;
at the outset: [a]/ət ðə ˈaʊtˌset/; [phr]在开头时; [or]yshx;
at the same time: [a]/ət ðə seɪm taɪm/; [adv]同时;然而; [or]yshx;
athlete: [a]/ˈæθliːt/; [n]运动员,体育家,强壮的人; [or]yshx;
atlas: [a]/ˈætləs/; [n]地图集; [or]yshx;
attach: [a]/əˈtætʃ/; [v]系;贴;附上;附加;缚; [or]yshx;
attack: [a]/əˈtæk/; [n](病)发作,攻击; [v]攻击,进攻,抨击;毁坏; [or]yshx;
attain: [a]/əˈteɪn/; [v]获得;达到(某个年纪,水平,条件);实现; [n]成就; [or]yshx;
attempt: [a]/əˈtempt/; [n]尝试;企图; [vt]努力去做;试图,尝试; [or]yshx;
attendant: [a]/əˈtendənt/; [n]服务员,侍者,随从; [adj]伴随的,随之而产生的; [or]yshx;
attorney: [a]/əˈtɜːrni/; [n](辩护)律师; [or]yshx;
attractive: [a]/əˈtræktɪv/; [adj]有魅力的;吸引人的;引起兴趣的; [or]yshx;
auction: [a]/ˈɔːkʃn/; [n]拍卖; [v]拍卖; [or]yshx;
audible: [a]/ˈɔːdəbl/; [adj]听得见的; [or]yshx;
audience: [a]/ˈɔːdiəns/; [n](演讲,音乐会等的)听众,观众;正式会见;拥护者; [or]yshx;
audit: [a]/ˈɔːdɪt/; [v]审计,查账;旁听; [n]审计;查帐; [or]yshx;
audition: [a]/ɔːˈdɪʃn/; [n]听力,听觉;试听;试镜; [vi]试唱; [vt]对.进行面试;让.试唱; [or]yshx;
augment: [a]/ɔːɡˈment/; [v]增加;助长; [or]yshx;
authentic: [a]/ɔːˈθentɪk/; [adj]真实的;真正的;可靠的; [or]yshx;
authority: [a]/əˈθɔːrəti/; [n]权威;威信;当局,官方;权力,职权; [or]yshx;
automatic: [a]/ˌɔːtəˈmætɪk/; [adj]无意识的;自动的;自发的; [n]自动手枪;自动工具; [or]yshx;
automobile: [a]/ˈɔːtəməbiːl/; [n]汽车,机动车; [v]开汽车;坐汽车; [adj]自动的; [or]yshx;
autonomy: [a]/ɔːˈtɑːnəmi/; [n]人身自由;自治;自治权; [or]yshx;
auxiliary: [a]/ɔːɡˈzɪliəri/; [adj]备用的,辅助的,协助的; [or]yshx;
available: [a]/əˈveɪləbl/; [adj]可得到的,可利用的,有空的,有效的; [or]yshx;
avalanche: [a]/ˈævəlæntʃ/; [n]雪崩;大量拥至; [vi]崩塌; [or]yshx;
avert: [a]/əˈvɜːrt/; [v]转移(目光,注意力等);防止;避开; [or]yshx;
aviation: [a]/ˌeɪviˈeɪʃn/; [n]航空,航空学;飞机制造业; [or]yshx;
avoid: [a]/əˈvɔɪd/; [v]躲开,避开;避免,防止; [or]yshx;
aware: [a]/əˈwer/; [adj]意识到的,知道的; [or]yshx;
awful: [a]/ˈɔːfl/; [adj]可怕的,极坏的;糟糕的,讨厌的;极其; [adv]极其,非常; [or]yshx;
awkward: [a]/ˈɔːkwərd/; [adj]尴尬的;笨拙的;棘手的;不雅观的;不方便的;困难的,危险的; [or]yshx;
axis: [a]/ˈæksɪs/; [n]轴;中心线;坐标轴;基准线; [or]yshx;
bachelor: [a]/ˈbætʃələr/; [n]单身汉;学士学位; [or]yshx;
back down (from): [a]/bæk daʊn frəm/; [phr]投降,认输; [or]yshx;
back sb. up: [a]/bæk ˈsʌmbədi ʌp/; [phr]支持某人; [or]yshx;
bacon: [a]/ˈbeɪkən/; [n]熏猪肉,培根; [or]yshx;
bacterium: [a]/bæk'tɪriəm/; [n]细菌; [or]yshx;
badge: [a]/bædʒ/; [n]徽章;象征;标记; [vt]给予.标记;授予.徽章; [or]yshx;
badminton: [a]/ˈbædmɪntən/; [n]羽毛球;羽毛球运动; [or]yshx;
baffle: [a]/ˈbæfl/; [v]使困惑;难住;阻碍; [n]挡板; [or]yshx;
baggage: [a]/ˈbæɡɪdʒ/; [n]行李; [or]yshx;
bake: [a]/beɪk/; [v]烤,烘焙;烧制; [n]晒;烘烤食品; [or]yshx;
balance: [a]/ˈbæləns/; [n]平衡;称;平静;和谐;余额; [v]保持平衡;使平衡;补偿; [or]yshx;
balcony: [a]/ˈbælkəni/; [n]阳台,剧院楼厅; [or]yshx;
bald: [a]/bɔːld/; [adj]秃头的; [or]yshx;
ballet: [a]/bæˈleɪ/; [n]芭蕾舞,芭蕾舞剧;芭蕾舞团; [or]yshx;
ban: [a]/bæn/; [vt]禁止;查禁; [n]禁止,禁令; [or]yshx;
bandage: [a]/ˈbændɪdʒ/; [n]绷带; [v]用绷带绑扎; [or]yshx;
bang: [a]/bæŋ/; [n]巨响;重击;刘海; [adv]准确地,完全地; [v]发出砰的一声;重击;猛敲;砰地关上; [or]yshx;
bankrupt: [a]/ˈbæŋkrʌpt/; [adj]破产的;彻底失败的;彻底缺乏的; [n]破产者; [v]使破产;使枯竭; [or]yshx;
banner: [a]/ˈbænər/; [n]旗帜,横幅,大标题; [or]yshx;
banquet: [a]/ˈbæŋkwɪt/; [n](正式的)宴会;盛宴; [adj]宴会的; [or]yshx;
bar: [a]/bɑːr/; [n]酒吧;(金属)棒;闩;障碍;柜台; [vt]阻挡;禁止;闩住; prep. 除.之外; [or]yshx;
barbecue: [a]/ˈbɑːrbɪkjuː/; [n]烧烤架;烧烤;烤肉; [v]红烧;烧烤; [or]yshx;
barber: [a]/ˈbɑːrbər/; [n]理发师,理发店; [or]yshx;
bare: [a]/ber/; [adj]赤裸的,空的,贫瘠的; [v]使裸露,暴露; [or]yshx;
bargain: [a]/ˈbɑːrɡən/; [n]交易,特价商品;便宜货;契约; [vi]讨价还价,讲价;成交; [vt]经讨价还价成交;用.交换; [adj](价格),低廉的; [or]yshx;
bark: [a]/bɑːrk/; [v]狗吠;厉声发令; [n]树皮;吠声; [or]yshx;
barn: [a]/bɑːrn/; [n]谷仓,牲口棚;简陋的大房子; [or]yshx;
barometer: [a]/bəˈrɑːmɪtər/; [n]晴雨表;气压表; [or]yshx;
barrel: [a]/ˈbærəl/; [n]桶;枪管; [vi]快速移动; [or]yshx;
barren: [a]/ˈbærən/; [adj]贫瘠的,不孕的; [n]荒原,不毛之地; [or]yshx;
barricade: [a]/ˌbærɪˈkeɪd/; [n]路障;障碍物;栅栏; [v]设路障;挡住; [or]yshx;
barter: [a]/ˈbɑːrtər/; [v]物物交换;以货易货; [n]物物交换;实物交易; [or]yshx;
basement: [a]/ˈbeɪsmənt/; [n]<建筑学>地下室;根基; [or]yshx;
batch: [a]/bætʃ/; [n]一批(人或物);一批生产量; [or]yshx;
bathe: [a]/beɪð/; [v]给..洗澡;洗澡;洗澡,游泳; [or]yshx;
batter: [a]/ˈbætər/; [n](用鸡蛋,牛奶等调制的)面糊; [v]连续猛击; [or]yshx;
battery: [a]/ˈbætəri/; [n]电池(组);排炮;一组,许多,众多; [or]yshx;
bay: [a]/beɪ/; [n]海湾,港湾;困境; [vi](尤指猎犬等)吠,叫,咆哮;筑堤遏(水); [v]穷追,使陷入绝境;阻止(敌人)不使前进;向.吠叫; [adj]赤褐色的,栗色的; [or]yshx;
be (go) on board: [a]/biː ɡoʊ ɔːn bɔːrd/; [adv]在船上,在飞机上; [or]yshx;
be all set: [a]/bi ɔl set/; [phr]准备就绪; [or]yshx;
be at odds (with sb.)(over sth.): [a]/biː æt ɑːdz wɪθ ˈsʌmbədi ˈoʊvər ˈsʌmθɪŋ/; [adj]与.有争执; [or]yshx;
be bent on: [a]/bi bent ɔn/; [v]专心致志于;决心要; [or]yshx;
be better off: [a]/bi ˈbetər ɑf/; [phr]较富裕;更好; [or]yshx;
be hard to say: [a]/bi hɑrd tu seɪ/; [phr]难以开口; [or]yshx;
be in two minds about sth.: [a]/biː ɪn tuː maɪndz əˈbaʊt ˈsʌmθɪŋ/; [adj]犹豫不决; [or]yshx;
be obsessed with: [a]/bi əbˈsest wɪð/; [v](指恐惧等)缠住;使烦扰;对.着迷; [or]yshx;
be on edge: [a]/bi ɑn ɛdʒ/; [phr]紧张不安; [or]yshx;
be on good terms (with sb.): [a]/biː ɔːn ɡʊd tɜːrmz wɪθ ˈsʌmbədi/; [phr]关系好; [or]yshx;
be on to: [a]/bi ɔn tu/; [phr]意识到,识透;找..岔子; [or]yshx;
be set on sth.: [a]/biː set ɔːn ˈsʌmθɪŋ/; [adj]决心做某事; [or]yshx;
beam: [a]/biːm/; [n]光线;(房屋等)大梁;(横)梁; [v]发光;照射;发射,播送;微笑;用梁支撑; [or]yshx;
bear sth. in mind: [a]/ber ˈsʌmθɪŋ ɪn maɪnd/; [v]记住某事; [or]yshx;
bear sth.(sb.) out: [a]/ber ˈsʌmθɪŋ ˈsʌmbədi aʊt/; [v]证实; [or]yshx;
bear with (sb.): [a]/ber wɪθ ˈsʌmbədi/; [phr]耐心等待;宽容; [or]yshx;
bear: [a]/ber/; [n]熊;(股市)看跌的人; [v]容忍,忍受;承担;带有;生育;开花结果,结(果实); [or]yshx;
beard: [a]/bɪrd/; [n](下巴上的)胡须; [v]公开反对;抓住胡须; [or]yshx;
bearing: [a]/ˈberɪŋ/; [n]方向;举止;轴承; [or]yshx;
beat about/around the bush: [a]/biːt əˈbaʊt əˈraʊnd ðə bʊʃ/; [v]转弯抹角; [or]yshx;
beat sb. (sth.) off: [a]/biːt ˈsʌmbədi ˈsʌmθɪŋ ɑːf/; [v]击退; [or]yshx;
beat: [a]/biːt/; [v]敲打;打败;打;(心脏)跳动;搅拌; [n]敲打;拍子; [adj]精疲力竭的,疲惫不堪的;垮掉的,属于"垮掉的一代"的; [or]yshx;
beautician: [a]/bjuːˈtɪʃn/; [n]美容师; [or]yshx;
become of: [a]/bɪˈkʌm ɑv/; [v](命运等)降临;使遭遇;发生.情况; [or]yshx;
behalf: [a]/bɪˈhæf/; [n]代表(某人),因为某人;利益;赞同,支持; [or]yshx;
behave: [a]/bɪˈheɪv/; [v]举动;举止端正(或良好,适当); [or]yshx;
behind the times: [a]/bɪˈhaɪnd ðə taɪmz/; [adv]过时的; [or]yshx;
behind time: [a]/bɪˈhaɪnd taɪm/; [adj]迟到; [or]yshx;
belly: [a]/ˈbeli/; [n]圆形或凸起部分;肚子; [or]yshx;
beloved: [a]/bɪˈlʌvɪd/; [n]爱人; [adj]心爱的,所钟爱的;受爱戴的; [or]yshx;
bend: [a]/bend/; [v](使)弯曲,(使)改变(主意),使屈服; [n]弯曲,弯曲处,倾向,屈服;(复数形式)减压症; [or]yshx;
beneficial: [a]/ˌbenɪˈfɪʃl/; [adj]有益的,有利的; [or]yshx;
benefit: [a]/ˈbenɪfɪt/; [v]受益,有助于,使受益; [n]好处,益处;救济金; [or]yshx;
bent: [a]/bent/; [adj]弯曲的,决心的,不诚实的; [v]弯腰,弯曲(bend过去式); [n]爱好,癖好; [or]yshx;
berth: [a]/bɜːrθ/; [n]停泊处;卧铺;<口语>职业; [v]使停泊; [or]yshx;
beset: [a]/bɪˈset/; [v]困扰;镶嵌;围绕; [or]yshx;
bet: [a]/bet/; [n]赌注;打赌; [v]打赌;敢断定; [or]yshx;
betray: [a]/bɪˈtreɪ/; [v]背叛;失信于;泄露(秘密等);(非故意地)暴露; [or]yshx;
beverage: [a]/ˈbevərɪdʒ/; [n](水,酒等之外的)饮料; [or]yshx;
bewilder: [a]/bɪˈwɪldər/; [v]使不知所措;使迷惑;使变糊涂,弄糊涂; [or]yshx;
bias: [a]/ˈbaɪəs/; [n]倾斜;偏心;偏见; [v]使有偏见; [or]yshx;
bibliography: [a]/ˌbɪbliˈɑːɡrəfi/; [n]参考书目;文献学; [or]yshx;
bid: [a]/bɪd/; [n]出价;投标;努力争取; [v]出价;投标;问候;道别;吩咐; [or]yshx;
bind: [a]/baɪnd/; [v]捆绑;装订;约束;结合; [n]窘境,困境;讨厌的事情;捆绑;植物的藤蔓; [or]yshx;
biography: [a]/baɪˈɑːɡrəfi/; [n]传记文学,传记; [or]yshx;
bite: [a]/baɪt/; [v]咬,叮,螫;剌穿; [n]咬;(咬下的)一口;少量食物;简单的一餐; [or]yshx;
bitumen: [a]/bəˈtuːmən/; [n]沥青; [or]yshx;
bizarre: [a]/bɪˈzɑːr/; [adj]稀奇古怪的; [or]yshx;
blame: [a]/bleɪm/; [v]责备,把..归咎于; [n]责备,过失; [or]yshx;
blank: [a]/blæŋk/; [adj](纸等)空白的,茫然的; [n]空白,空白处; [v]忽视; [or]yshx;
blast: [a]/blæst/; [n]一阵(疾风等);爆炸;冲击波; [v](用炸药)炸,摧毁; [or]yshx;
blaze: [a]/bleɪz/; [vi]熊熊燃烧;闪耀;怒视;连续射击; [vt]大肆宣扬; [n]火焰; [or]yshx;
bleach: [a]/bliːtʃ/; [v]漂白; [n]漂白剂; [or]yshx;
bleak: [a]/bliːk/; [adj]凄凉的;萧瑟的;阴郁的;无希望的; [or]yshx;
bleed: [a]/bliːd/; [vi]流血;散开; [vt]榨取,敲诈;使流血;使..排出液体; [n]出血; [adj]<印>出血版的; [or]yshx;
blend: [a]/blend/; [v]混合;把.混成一体; [n]混合物; [or]yshx;
bless: [a]/bles/; [v]保佑,祝福,赐福,有幸具有; [or]yshx;
blink: [a]/blɪŋk/; [v]眨眼睛;闪亮;闪烁; [n]眨眼睛; [or]yshx;
bloc: [a]/blɑːk/; [n]集团; [or]yshx;
block: [a]/blɑːk/; [v]阻挡;妨碍;阻塞; [n]街区;块状物;积木;阻碍;大厦; [or]yshx;
blonde: [a]/blɑːnd/; [adj](头发)亚麻色的,金色的; [n]金(浅)发女郎; [or]yshx;
bloom: [a]/bluːm/; [v]开花; [n]开花期;青春时期;花;兴旺时期; [or]yshx;
blot: [a]/blɑːt/; [n]墨水渍;污点;缺点; [v]涂污;(用吸水纸)吸干墨水;遮暗; [or]yshx;
blunder: [a]/ˈblʌndər/; [n]愚蠢之举;大错; [vi]犯大错; [v]失策;绊倒; [or]yshx;
blunt: [a]/blʌnt/; [adj]钝的;直率的; [v]使情感,感觉,需求减弱;变钝; [or]yshx;
blur: [a]/blɜːr/; [n]污点,模糊; [v]使.模糊;弄脏;变模糊; [or]yshx;
blush: [a]/blʌʃ/; [v]脸红;害臊; [n]脸红; [or]yshx;
board: [a]/bɔːrd/; [n]木板;董事会;甲板;膳食; [v]乘船,登机;用板铺;供膳食;寄宿; [or]yshx;
boast: [a]/boʊst/; [v]夸耀;吹牛,吹嘘;自负; [n]感到骄傲的事; [or]yshx;
boil down to: [a]/bɔɪl daʊn tu/; [v]归结起来是,问题是; [or]yshx;
boil: [a]/bɔɪl/; [v]烧开,沸腾;用开水煮,在沸水中煮; [n]煮沸,沸腾;疔,疖子;<医>疡肿,脓肿; [or]yshx;
bold: [a]/boʊld/; [adj]大胆的,勇敢的;无耻的,放肆的;醒目的; [n]粗体字; [or]yshx;
bolt: [a]/boʊlt/; [n]门栓,螺栓;闪电;弩箭; [v]闩门;(马受惊)脱缰; [adv]突然地;像箭似地;直立地; [or]yshx;
bond: [a]/bɑːnd/; [n]束缚物,联结物;凝聚力;债券;保释金;联系; [vi]结合;团结一致; [or]yshx;
bonus: [a]/ˈboʊnəs/; [n]奖金,额外津贴; [or]yshx;
bookcase: [a]/ˈbʊkkeɪs/; [n]书橱,书架; [or]yshx;
bookkeeper: [a]/ˈbʊkkiːpər/; [n]簿记员;会计员; [or]yshx;
boom: [a]/buːm/; [n]隆隆声;繁荣;景气;激增; [v]发出低沉有回响的声音;迅速发展,蓬勃发展;以低沉有回响的声音发出; [or]yshx;
boost: [a]/buːst/; [v]增加;偷盗; [n]提高;激励;后推;助推发动机; [or]yshx;
booth: [a]/buːθ/; [n]小舍;隔开的小间;公用电话亭;有篷的售货摊;窝棚; [or]yshx;
border on (upon): [a]/ˈbɔːrdər ɔːn əˈpɔːn/; [v]接近,近似; [or]yshx;
border: [a]/ˈbɔːrdər/; [n]边界;花坛;滚边,边沿,包边; [v]近似;毗邻;与..接壤;为..镶边; [or]yshx;
bother: [a]/ˈbɑːðər/; [v]麻烦,打扰;花时间; [n]烦扰,麻烦,打扰; [or]yshx;
bounce: [a]/baʊns/; [vi]弹起,蹦跳; [vt]使弹起; [v]拒付 (支票); [n]弹跳,弹力,活力; [or]yshx;
bound: [a]/baʊnd/; [adj]受约束的;有义务的;一定的; [v]束缚;跳跃着前行; [n]跳跃;范围;界限; [or]yshx;
boundary: [a]/ˈbaʊndri/; [n]边界,分界线;使球越过边界线的击球(得加分); [or]yshx;
bounty: [a]/ˈbaʊnti/; [n]慷慨;赠物;奖金; [vt]发给.奖金; [or]yshx;
bouquet: [a]/buˈkeɪ/; [n]花束,(酒的)芳香; [or]yshx;
bowel: [a]/ˈbaʊəl/; [n]肠;内部; [or]yshx;
boycott: [a]/ˈbɔɪkɑːt/; [vt]抵制; [n]抵制; [or]yshx;
brace: [a]/breɪs/; [n]<医学>牙齿定位器; [v]支柱;支撑;加固;使绷紧; [or]yshx;
brake: [a]/breɪk/; [v]刹车; [n]刹车,制动器,闸; [or]yshx;
brand: [a]/brænd/; [n]商标,品牌;烙印; [v]给..打上烙印;归为 (不好的事物); [or]yshx;
brashness: [a]/ˈbræʃnəs/; [n]莽撞,无礼,轻率; [or]yshx;
breach: [a]/briːtʃ/; [n]破裂;裂痕;冲击;违反; [v]使有裂口;破坏; [or]yshx;
break away (from): [a]/breɪk əˈweɪ frʌm/; [v]突然走开;放弃;革除; [or]yshx;
break down: [a]/brek daʊn/; [phr]发生故障;失败;(精神)垮下来; [or]yshx;
break off (sth.): [a]/breɪk ɑːf ˈsʌmθɪŋ/; [v]折断;突然结束; [or]yshx;
break one's heart: [a]/brek wʌnz hɑrt/; [v]使人心碎; [or]yshx;
breakdown: [a]/ˈbreɪkdaʊn/; [n]损坏;故障;分类,明细;倒塌,崩溃;衰退; [or]yshx;
breakthrough: [a]/ˈbreɪkθruː/; [n]突破,突破性进展,重要的新发现; [adj]突破性的; [or]yshx;
breed: [a]/briːd/; [n]血统;种类; [v]产仔;繁殖;使繁殖; [or]yshx;
breeze: [a]/briːz/; [n]微风,清风;轻而易举的事; [v]飘然而行;轻松通过; [or]yshx;
brew: [a]/bruː/; [v]调制;酿造;冲泡 (茶,咖啡等);酝酿;筹划; [n]酝酿的饮料;啤酒; [or]yshx;
bribe: [a]/braɪb/; [v]向.行贿;买通; [n]贿赂;行贿物; [or]yshx;
briefcase: [a]/ˈbriːfkeɪs/; [n]公文包; [or]yshx;
brilliant: [a]/ˈbrɪliənt/; [adj]聪颖的;卓越的,有才气的;明亮的; [or]yshx;
bring (call) sth. to mind: [a]/brɪŋ kɔːl ˈsʌmθɪŋ tu maɪnd/; [v]想起某事; [or]yshx;
bring about: [a]/brɪŋ əˈbaʊt/; [phr]导致,引起; [or]yshx;
bring back: [a]/briŋbæk/; [phr]拿回来;使.回忆起来; [or]yshx;
bring forward: [a]/brɪŋ ˈfɔrwərd/; [v]提出;提前; [or]yshx;
bring in: [a]/brɪŋ ɪn/; [v]增加,赚取,产生,引进; [or]yshx;
bring up: [a]/brɪŋ ʌp/; [phr]养育;呕出;提出; [or]yshx;
brink: [a]/brɪŋk/; [n](尤指崖边)边缘; [or]yshx;
brisk: [a]/brɪsk/; [adj]轻快的;活跃的;寒冷而清新的; [or]yshx;
brittle: [a]/ˈbrɪtl/; [adj]易碎的;脆弱的;靠不住的; [n]薄片脆糖; [or]yshx;
brochure: [a]/broʊˈʃʊr/; [n]手册,小册子; [or]yshx;
brood: [a]/bruːd/; [n]一窝,同窝幼崽; [vi]冥思苦想; [vt]孵;默想; [adj]传种用的;(母鸡等)抱窝的;(昆虫等)产卵的; [or]yshx;
bruise: [a]/bruːz/; [n](人体组织或表皮等跌,碰撞后产生的)青肿,挫伤;碰伤; [v]撞伤,碰伤,(使)挫伤,擦伤(表皮,表面);打击;擦伤; [or]yshx;
brutal: [a]/ˈbruːtl/; [adj]残忍的,粗鲁的;严酷的,难以忍受的;严峻的; [or]yshx;
bubble: [a]/ˈbʌbl/; [v]起泡;兴奋,欢闹;充满生气,情绪高涨; [n]气泡,水泡;虚幻之事;靠不住的计划;泡影;幻想,妄想; [or]yshx;
buck: [a]/bʌk/; [n]雄鹿;年轻男士;美元; [v]反对;马弓背踢后腿挑起; [or]yshx;
bucket: [a]/ˈbʌkɪt/; [n]水桶,(机器上的)桶装物,大量; [v]颠簸行进,下倾盆大雨;装在桶里; [or]yshx;
buckle: [a]/ˈbʌkl/; [v]用扣子,把.扣紧(或扣住,扣上);扣紧,扣住;变弯曲,使弯曲; [n]金属扣,皮带扣; [or]yshx;
bud: [a]/bʌd/; [n]蓓蕾,芽; [v]使发芽; [or]yshx;
budget: [a]/ˈbʌdʒɪt/; [n]预算; [v]预算,安排; [adj]廉价的; [or]yshx;
buffet: [a]/bəˈfeɪ/; [n]自助餐,(火车内)餐室,冷餐桌; [v]反复敲打,打击,重击; [or]yshx;
bug: [a]/bʌɡ/; [n]<计算机>(制作软件程序所产生的意料不到的)错误,故障;窃听器;热衷于(某事)者;臭虫,小虫子; [v]使厌烦,打扰;窃听; [vt]使烦恼,纠缠; [or]yshx;
bulb: [a]/bʌlb/; [n]电灯泡;球状物;球茎; [or]yshx;
bulge: [a]/bʌldʒ/; [n]凸出部分; [v]凸出,膨胀; [or]yshx;
bulk: [a]/bʌlk/; [n]大批;容量;体积;大块; [adj]大量的;散装的; [v]膨胀;显得重要; [or]yshx;
bull: [a]/bʊl/; [n]公牛,雄性的鲸,象等大动物; [or]yshx;
bulletin: [a]/ˈbʊlətɪn/; [n]公告;公报;公告牌; [or]yshx;
bully: [a]/ˈbʊli/; [n]恃强欺弱者; [v]欺负; [or]yshx;
bump: [a]/bʌmp/; [n]隆起物;撞击;(碰撞造成的)肿块; [v]撞击;颠簸地行驶;凹凸不平;除名,撵走; [or]yshx;
bunch: [a]/bʌntʃ/; [n]束;串;群,伙; [v]集中,挤在一起;使成一束(或一群等); [or]yshx;
bundle: [a]/ˈbʌndl/; [n]捆,包; [vt]捆; [or]yshx;
bungalow: [a]/ˈbʌŋɡəloʊ/; [n]平房,小屋; [or]yshx;
bunk: [a]/bʌŋk/; [n](火车等)床铺,铺位,卧铺;骗人的话,废话; [v]睡(在床铺上),去睡; [or]yshx;
buoyant: [a]/ˈbɔɪənt/; [adj]有浮力的;愉快的;(股市)保持高价的; [or]yshx;
bureaucracy: [a]/bjʊˈrɑːkrəsi/; [n]官僚主义;政府机构; [or]yshx;
burgeon: [a]/ˈbɜːrdʒən/; [v]发芽,迅速成长; [n]嫩枝; [or]yshx;
burial: [a]/ˈberiəl/; [n]埋葬,葬礼;掩埋; [or]yshx;
bust: [a]/bʌst/; [n]半身塑像;胸部; [v]打碎;搜捕;降级;终止; [adj]破产的;打碎的; [or]yshx;
butcher: [a]/ˈbʊtʃər/; [n]屠夫,肉贩子;刽子手; [v]屠宰;屠戮,残杀; [or]yshx;
buzz: [a]/bʌz/; [v]发出嗡嗡声; [n]嗡嗡声;低沉嘈杂的谈话声; [or]yshx;
bypass: [a]/ˈbaɪpæs/; [v]绕过;回避; [n]旁路;心脏分流手术; [or]yshx;
cabin: [a]/ˈkæbɪn/; [n](简陋的)小屋;船舱;客舱,机舱; [v]住在小屋里; [or]yshx;
cabinet: [a]/ˈkæbɪnət/; [n]橱;柜;内阁; [or]yshx;
cable: [a]/ˈkeɪbl/; [n]电缆,缆,索; [v]拍电报; [or]yshx;
cafe: [a]/kæˈfeɪ/; [n]咖啡馆,餐馆; [or]yshx;
cafeteria: [a]/ˌkæfəˈtɪriə/; [n]自助食堂;自助餐馆; [or]yshx;
calcium: [a]/ˈkælsiəm/; [n]钙; [or]yshx;
calendar: [a]/ˈkælɪndər/; [n]日历;时间表;历法; [vt]把.记入日程表中;把.列入表中;为(文件等)作分类索引;将.排入日程表; [or]yshx;
call (sth.) off: [a]/kɔːl ˈsʌmθɪŋ ɑːf/; [phr]停止; [or]yshx;
call for: [a]/kɔːl fɔr/; [v]需要;邀请;呼吁; [or]yshx;
call it a day: [a]/kɔl ɪt ə deɪ/; [v]收工; [or]yshx;
call on: [a]/kɔːl ɑːn/; [phr]拜访,呼吁,请求; [or]yshx;
call sb. (sth.) up: [a]/kɔːl ˈsʌmbədi ˈsʌmθɪŋ ʌp/; [v]打电话;征召; [or]yshx;
calorie: [a]/ˈkæləri/; [n]卡(热量单位); [or]yshx;
campaign: [a]/kæmˈpeɪn/; [n](社会性,政治性)活动,运动;战役; [v]从事活动,参加运动; [or]yshx;
campus: [a]/ˈkæmpəs/; [n]校园,学校场地; [or]yshx;
canal: [a]/kəˈnæl/; [n]运河,河流;水渠;(人体的)导管,食管,气管; [or]yshx;
candidate: [a]/ˈkændɪdət/; [n](官职,获奖资格等的)候选人;投考人;申请求职者; [or]yshx;
cane: [a]/keɪn/; [n]手杖;茎;藤条;甘蔗; [or]yshx;
cannon: [a]/ˈkænən/; [n]大炮;机关炮; [v]相撞;开炮; [or]yshx;
canteen: [a]/kænˈtiːn/; [n]食堂,小卖部;水壶; [or]yshx;
canvas: [a]/ˈkænvəs/; [n]帆布,(帆布)油画; [or]yshx;
capacity: [a]/kəˈpæsəti/; [n]产能;容量;本领;才能;负载量;职位; [or]yshx;
cape: [a]/keɪp/; [n]斗篷;披肩;岬,海岬,海角; [or]yshx;
capital: [a]/ˈkæpɪtl/; [n]资金,资本;首都;大写(字母); [adj]大写的;资本的;优秀的;处以死刑的;致命的; [or]yshx;
capsule: [a]/ˈkæpsl/; [n]胶囊;航天舱,密封舱; [or]yshx;
caption: [a]/ˈkæpʃn/; [n](报刊的)标题;(插图,照片等的)说明文字; [v]给(图片,照片等)加说明文字; [or]yshx;
captive: [a]/ˈkæptɪv/; [adj]被捕获的;被俘虏的; [n]俘虏; [or]yshx;
cardinal: [a]/ˈkɑːrdɪnl/; [adj]主要的;基本的; [n]<天主教>枢机主教,红衣主教;基数; [or]yshx;
carpenter: [a]/ˈkɑːrpəntər/; [n]木匠;木工; [or]yshx;
carrier: [a]/ˈkæriər/; [n]搬运工,运送人;运输公司;航空母舰; [or]yshx;
carrot: [a]/ˈkærət/; [n]胡萝卜; [or]yshx;
carry on: [a]/'kæriː ɔn/; [v]继续开展;坚持;举止失常; [or]yshx;
carry out: [a]/ˈkærɪ aʊt/; [phr]执行,实行;实现;完成; [or]yshx;
carry through: [a]/ˈkeri θru/; [v]维持;使渡过难关,坚持下去; [or]yshx;
cart: [a]/kɑːrt/; [n]手推车,运货马车; [v]用车装载; [or]yshx;
carton: [a]/ˈkɑːrtn/; [n](尤指装食品和液体的)硬纸盒,纸板箱,塑料箱; [or]yshx;
cartoon: [a]/kɑːrˈtuːn/; [n]卡通(片),动画片;(尤指报刊上讽刺政客或时事的)漫画,幽默画; [or]yshx;
carve: [a]/kɑːrv/; [v]雕刻;(把肉等)切成片;开创,开拓; [or]yshx;
cash crop: [a]/ˈkæʃ krɑːp/; [phr]经济作物; [or]yshx;
cash in on: [a]/kæʃ ɪn ɔn/; [v]以.获利,营利; [or]yshx;
cashier: [a]/kæˈʃɪr/; [n]出纳员,收银员; [v]把..撤职;驱逐,革除,废除; [or]yshx;
cassette: [a]/kəˈset/; [n]磁带盒;录像带,盒式磁带; [or]yshx;
cast off: [a]/kæst ɑf/; [v]解缆放船;抛弃,丢弃; [or]yshx;
cast sb. (sth.) aside: [a]/kæst ˈsʌmbədi ˈsʌmθɪŋ əˈsaɪd/; [v]抛弃,废除; [or]yshx;
cast: [a]/kæst/; [v]投;抛下,投射(光线和阴影);瞥,飞快看(一眼),扫视;掷;放钓;投票;选定演员; [n]投掷物;铸件;演员表,演员阵容; [or]yshx;
casual: [a]/ˈkæʒuəl/; [adj]偶然的;临时的;随便的; [n]临时工;便服; [or]yshx;
casualty: [a]/ˈkæʒuəlti/; [n]伤亡人员,死伤者,受害人;急诊室(英); [or]yshx;
catalog: [a]/ˈkætəlɔːɡ/; [n]目录,目录册,商品目录; [v]为..编目录,登记; [or]yshx;
catalyst: [a]/ˈkætəlɪst/; [n]催化剂;造成变化的人或事; [or]yshx;
catch on: [a]/kætʃ ɔn/; [phr]变得流行;理解; [or]yshx;
catch up with sb.: [a]/kætʃ ʌp wɪθ ˈsʌmbədi/; [v]赶上;逮捕; [or]yshx;
catching: [a]/ˈkætʃɪŋ/; [adj]传染的;迷人的,有魅力的; [or]yshx;
category: [a]/ˈkætəɡɔːri/; [n]类别;范畴; [or]yshx;
cater: [a]/ˈkeɪtər/; [v]供应伙食;为(集会,婚礼等)承办酒席; [or]yshx;
cathedral: [a]/kəˈθiːdrəl/; [n]大教堂; [adj]有权威的;大教堂的; [or]yshx;
caustic: [a]/ˈkɔːstɪk/; [adj]腐蚀性的;苛性的;刻薄的;焦散的; [n]腐蚀剂;苛性钠;焦散曲线; [or]yshx;
caution: [a]/ˈkɔːʃn/; [n]小心;警告;告诫; [v]劝.谨慎小心;警告; [or]yshx;
cavity: [a]/ˈkævəti/; [n]洞;龋洞; [or]yshx;
cease: [a]/siːs/; [v]停止,结束; [n]停止,停息; [or]yshx;
cellar: [a]/ˈselər/; [n]地窖;地下室;酒窖; [or]yshx;
cement: [a]/sɪˈment/; [n]水泥,混凝土;胶合剂; [vt]巩固,加强;用水泥涂;接合; [vi]粘牢; [or]yshx;
cemetery: [a]/ˈseməteri/; [n]公墓;墓地; [or]yshx;
cereal: [a]/ˈsɪriəl/; [n]谷物;谷类食物;谷类食品; [adj]谷类的;谷类制成的; [or]yshx;
ceremony: [a]/ˈserəmoʊni/; [n]典礼,仪式;礼节; [or]yshx;
certainty: [a]/ˈsɜːrtnti/; [n]必然;确信;必然的事; [or]yshx;
certify: [a]/ˈsɜːrtɪfaɪ/; [v](发给证书)证明;证实; [or]yshx;
challenge: [a]/ˈtʃælɪndʒ/; [n]挑战;质疑; [v]挑战;质疑; [or]yshx;
chamber: [a]/ˈtʃeɪmbər/; [n]会议室;(作特殊用途的)房间;议院; [or]yshx;
champagne: [a]/ʃæmˈpeɪn/; [n]香槟酒; [or]yshx;
champion: [a]/ˈtʃæmpiən/; [n]冠军;拥护者,战士; [v]拥护;保卫;为..而斗争; [adj]夺得第一名的;优胜的; [or]yshx;
chant: [a]/tʃænt/; [v]吟唱;诵扬; [n]圣歌;赞美诗;旋律; [or]yshx;
chaos: [a]/ˈkeɪɑːs/; [n]混沌;混乱,纷乱; [or]yshx;
chapel: [a]/ˈtʃæpl/; [n]小教堂;私人祈祷室; [or]yshx;
characteristic: [a]/ˌkærəktəˈrɪstɪk/; [n]特点;特性;特色; [adj]典型的;特有的;独特的; [or]yshx;
charge: [a]/tʃɑːrdʒ/; [v]充电,充值;索价;控告;向.冲去; [n]费用;主管;控告; [or]yshx;
charity: [a]/ˈtʃærəti/; [n]慈善团体;慈善;仁慈;施舍; [or]yshx;
charm: [a]/tʃɑːrm/; [n]魅力,吸引力,符咒; [v](使)着迷,施魔法; [or]yshx;
chart: [a]/tʃɑːrt/; [n]图表,表格;航海图;每周排行榜; [v]制成图表;制航海图; [or]yshx;
charter: [a]/ˈtʃɑːrtər/; [n]宪章;特权,豁免权;契约,证书;租赁; [v]包,租(飞机,汽车等); [adj]包租的,租用的; [or]yshx;
chase: [a]/tʃeɪs/; [v]追赶;驱逐;追求; [n]追逐;追求; [or]yshx;
chasm: [a]/ˈkæzəm/; [n](地壳,冰上的)隐窟,深坑,峡谷;显著差距,巨大分歧; [or]yshx;
chaste: [a]/tʃeɪst/; [adj]贞洁的;纯洁的;朴素的; [or]yshx;
check in: [a]/tʃek ɪn/; [phr]报到,记录;登记入住; [or]yshx;
check out: [a]/tʃek aʊt/; [phr]结账后离开,检验,通过考核,合格; [or]yshx;
cherish: [a]/ˈtʃerɪʃ/; [v]珍爱,珍视;抱有(希望); [or]yshx;
chew: [a]/tʃuː/; [v]嚼,咀嚼; [n]嚼碎,咀嚼; [or]yshx;
chic: [a]/ʃiːk/; [n]时髦,款式别致; [adj]别致的;时髦的; [or]yshx;
chief: [a]/tʃiːf/; [n]老板,头子;主管;(部落) 首领;酋长;长官; [adj]主要的;首席的; [or]yshx;
chill: [a]/tʃɪl/; [n]寒冷; [v](使)感到冷,使变冷; [adj]扫兴的; [or]yshx;
chin: [a]/tʃɪn/; [n]颏;下巴; [v]用下巴夹住;聊天;作引体向上动作; [or]yshx;
chip: [a]/tʃɪp/; [n]木屑,碎片;缺口;圆形筹码;芯片;炸薯条,炸薯片; [v]碎裂;削,凿;将.削成,凿成; [or]yshx;
chisel: [a]/ˈtʃɪzl/; [v]刻,凿; [n]凿子; [or]yshx;
choir: [a]/ˈkwaɪər/; [n](教会的)歌唱队,唱诗班; [or]yshx;
choke: [a]/tʃoʊk/; [v]噎住,(使)窒息,阻塞; [n]窒息,噎住; [or]yshx;
chop: [a]/tʃɑːp/; [v](用力)切,砍;降低;向下猛击;终止; [n]砍;劈;剁;排骨;嘴周围的地方; [or]yshx;
chord: [a]/kɔːrd/; [n]和弦;和音;心弦;(数学)弦; [or]yshx;
chore: [a]/tʃɔːr/; [n]日常家庭杂务,日常工作;琐碎烦人的杂务; [or]yshx;
chorus: [a]/ˈkɔːrəs/; [n]副歌部分;合唱团;合唱曲,合唱句; [v]合唱,齐声说;齐声说; [or]yshx;
chronic: [a]/ˈkrɑːnɪk/; [adj](疾病)慢性的;长期的;(人)久病的;积习难改的;严重的; [or]yshx;
chronological: [a]/ˌkrɑːnəˈlɑːdʒɪkl/; [adj]按照时间顺序排列的; [or]yshx;
chunk: [a]/tʃʌŋk/; [n]大块;矮而厚的木块;大量; [or]yshx;
circuit: [a]/ˈsɜːrkɪt/; [n]电路,线路;巡游,环形; [or]yshx;
circulate: [a]/ˈsɜːrkjəleɪt/; [v](使)流通;(使)循环;(使)传播,流传; [or]yshx;
circumference: [a]/sərˈkʌmfərəns/; [n]圆周长度,圆周;周围; [or]yshx;
circumstance: [a]/ˈsɜːrkəmstæns/; [n]条件;情况;命运;客观环境; [or]yshx;
circus: [a]/ˈsɜːrkəs/; [n]马戏团;杂技团;环形广场;闹剧(表示不满); [or]yshx;
cite: [a]/saɪt/; [v]引用,引证;传唤,传讯;表彰,嘉奖; [or]yshx;
civic: [a]/ˈsɪvɪk/; [adj]城市的;公民的,市民的; [or]yshx;
civilian: [a]/səˈvɪliən/; [n]平民,百姓; [adj]平民的,百姓的,民用的; [or]yshx;
claim: [a]/kleɪm/; [v]声称;要求;断言;主张;认领;索赔; [n]索赔;主张;声称;断言;要求; [or]yshx;
clan: [a]/klæn/; [n]家族;氏族;部落;宗派;亲族; [or]yshx;
clarify: [a]/ˈklærəfaɪ/; [v]阐明,澄清;净化; [or]yshx;
clash: [a]/klæʃ/; [vi]发生冲突;发出撞击声;不合,不一致,不调和; [n]冲突;抵触;撞击声; [or]yshx;
clasp: [a]/klæsp/; [v]握紧;扣紧;扣住;抱紧; [n]扣子;钩子;紧抱;紧握; [or]yshx;
classic: [a]/ˈklæsɪk/; [adj]经典的;古典的;高雅的;一流的; [n]经典著作;文豪;优秀典范; [or]yshx;
classify: [a]/ˈklæsɪfaɪ/; [v]把.分类; [or]yshx;
clause: [a]/klɔːz/; [n]条款;从句; [or]yshx;
clear away: [a]/klɪr əˈweɪ/; [v]把.除掉; [or]yshx;
clear out: [a]/klɪr aʊt/; [phr]匆忙离开;逃离;清空;腾空; [or]yshx;
clear the air: [a]/klɪr ðə er/; [v]消除误会; [or]yshx;
clear up: [a]/klɪr ʌp/; [v]放晴,清除,整理; [or]yshx;
clearance: [a]/ˈklɪrəns/; [n]清除;清理;清空;许可; [or]yshx;
cliche: [a]/klɪˈʃeɪ/; [n]陈腐思想,陈词滥调; [adj]陈腐的; [or]yshx;
click: [a]/klɪk/; [v]点击(鼠标);(使)发出咔哒声;情投意合;博得喝彩; [n]咔哒声,点击; [or]yshx;
client: [a]/ˈklaɪənt/; [n]委托人,当事人,主顾,客户;客户端; [or]yshx;
climax: [a]/ˈklaɪmæks/; [n]高潮,最令人兴奋(或感兴趣)的部分; [v](使)达到顶点,(使)达到高潮; [or]yshx;
cling: [a]/klɪŋ/; [v]紧紧抓住;黏着,挨近;依恋,依附;坚持,墨守,忠实于; [or]yshx;
clinic: [a]/ˈklɪnɪk/; [n]诊所;门诊(部,室); [or]yshx;
clip: [a]/klɪp/; [n]回形针,夹子;(电影,广播,电视节目的)片段; [v]夹住;删剪;剪辑; [or]yshx;
clockwise: [a]/ˈklɑːkwaɪz/; [adj]顺时针方向的; [adv]顺时针方向地; [or]yshx;
closet: [a]/ˈklɑːzət/; [n]橱,壁橱,小储藏室; [v]把.引进密室会谈; [adj]私下的,秘密的; [or]yshx;
clue: [a]/kluː/; [n]线索;提示;暗示; [vt]为..提供线索; [or]yshx;
clumsy: [a]/ˈklʌmzi/; [adj]笨拙的,不灵活的;拙劣的,不得体的; [or]yshx;
cluster: [a]/ˈklʌstər/; [n]一串;一簇; [v]群集;丛生; [or]yshx;
clutch: [a]/klʌtʃ/; [v]抓住;紧握; [n]抓住;离合器; [or]yshx;
coach: [a]/koʊtʃ/; [n]四轮大马车;教练;长途汽车; [v]训练,指导; [or]yshx;
coalition: [a]/ˌkoʊəˈlɪʃn/; [n]结合;联盟;联合; [or]yshx;
coarse: [a]/kɔːrs/; [adj]粗糙的;粗俗的;粗鲁的; [or]yshx;
cocaine: [a]/koʊˈkeɪn/; [n]可卡因,古柯碱; [or]yshx;
code: [a]/koʊd/; [n]编码,代码;准则,法典;密码; [v]将.编码; [or]yshx;
coed: [a]/ˌkoʊˈed/; [n]男女同校的女生; [adj]男女同校的; [or]yshx;
coerce: [a]/koʊˈɜːrs/; [v]强迫,压制; [or]yshx;
cognitive: [a]/ˈkɑːɡnətɪv/; [adj]认识能力的;认知的; [or]yshx;
coil: [a]/kɔɪl/; [n](一)卷,(一)圈;线圈; [v]卷,盘绕; [or]yshx;
coincide: [a]/ˌkoʊɪnˈsaɪd/; [v]巧合,一致,相符; [or]yshx;
collaboration: [a]/kəˌlæbəˈreɪʃn/; [n]合作,协作;勾结; [or]yshx;
collapse: [a]/kəˈlæps/; [v](使)倒塌,(使)崩溃,(使)瓦解; [n]倒塌,崩溃,暴跌; [or]yshx;
collide: [a]/kəˈlaɪd/; [vi]碰撞;互撞;抵触; [or]yshx;
colonial: [a]/kəˈloʊniəl/; [adj]殖民地的,关于殖民的; [n]殖民地居民; [or]yshx;
colossal: [a]/kəˈlɑːsl/; [adj]巨像(似)的;巨大的,庞大的; [or]yshx;
column: [a]/ˈkɑːləm/; [n]柱,支柱,圆柱;专栏;长队; [or]yshx;
combat: [a]/ˈkɑːmbæt/; [n]战斗,格斗; [v]与.战斗,与.斗争; [adj]战斗的; [or]yshx;
combine: [a]/kəmˈbaɪn/; [v]使混合(结合,组合,联合);结合;联合;组合; [n]联合体,联合企业;联合收割机; [or]yshx;
combustible: [a]/kəmˈbʌstəbl/; [adj]易燃的;易激动的; [n]可燃物;易燃物; [or]yshx;
come (bring) sth. to light: [a]/kʌm brɪŋ ˈsʌmθɪŋ tu laɪt/; [v]显露,揭露; [or]yshx;
come about: [a]/kʌm ə'baʊt/; [phr]发生; [or]yshx;
come across sb.(sth.): [a]/kʌm əˈkrɑːs ˈsʌmbədi ˈsʌmθɪŋ/; [v]偶然碰见; [or]yshx;
come along: [a]/kʌm ə'lɔːŋ/; [phr]一起;进步;出现; [or]yshx;
come apart: [a]/kʌm əˈpɑrt/; [phr]破碎;瓦解;崩塌; [or]yshx;
come down: [a]/kʌm daʊn/; [phr]倒塌;下降,下来; [or]yshx;
come off: [a]/kʌm ɑf/; [phr]从..掉下,发生,举行,(计划)实现; [or]yshx;
come on: [a]/kʌm ɔn/; [phr]来吧;发展;开始; [or]yshx;
come out: [a]/kʌm aʊt/; [vi]出现,显露,出版,被算出,结果是,公开表态; [or]yshx;
come over sb.: [a]/kʌm ˈoʊvər ˈsʌmbədi/; [v](被感觉等)支配,攥住,拜访; [or]yshx;
come round(around): [a]/kʌm raʊnd əˈraʊnd/; [phr]绕道而来;过访;重又来到;改变主意;苏醒; [or]yshx;
come to nothing: [a]/kʌm tu ˈnʌθɪŋ/; [phr]失败,落空; [or]yshx;
come to nought: [a]/kʌm tu nɔt/; [v]失败; [or]yshx;
come to sb.: [a]/kʌm tu ˈsʌmbədi/; [v]被想到; [or]yshx;
come to terms (with sb.): [a]/kʌm tu tɜːrmz wɪθ ˈsʌmbədi/; [phr]与..达成协议; [or]yshx;
come up against: [a]/kʌm ʌp əˈɡenst/; [v]碰到(困难,反对); [or]yshx;
come up with: [a]/kʌm ʌp wɪð/; [v]提出;想出; [or]yshx;
come up: [a]/kʌm ʌp/; [v]升起;出现;发生;发芽; [or]yshx;
come upon: [a]/kʌm əˈpɑn/; [phr]遇到;对⋯⋯有感觉;突然⋯⋯想做; [or]yshx;
comet: [a]/ˈkɑːmət/; [n]彗星; [or]yshx;
comic: [a]/ˈkɑːmɪk/; [adj]滑稽的,喜剧的,漫画的; [n]连环漫画杂志;喜剧演员; [or]yshx;
commemorate: [a]/kəˈmeməreɪt/; [v]纪念,庆祝; [or]yshx;
commence: [a]/kəˈmens/; [v]开始; [or]yshx;
commend: [a]/kəˈmend/; [v]称赞;推荐;委托保管; [or]yshx;
comment: [a]/ˈkɑːment/; [n]评论,议论;批评,意见;注解; [vt]评论; [vi]进行评论;为.作评语; [or]yshx;
commercial: [a]/kəˈmɜːrʃl/; [adj]商业性的,贸易的; [n]商业广告; [or]yshx;
commission: [a]/kəˈmɪʃn/; [n]委员会;任务;权限;委任;销售佣金; [v]委任; [or]yshx;
commit: [a]/kəˈmɪt/; [v]犯(罪);进行 (自杀);调拨 (钱,资源);监禁;送交 (到精神病院,监狱等);承诺,保证; [or]yshx;
committee: [a]/kəˈmɪti/; [n]委员会;全体委员; [or]yshx;
commodity: [a]/kəˈmɑːdəti/; [n]商品,货物; [or]yshx;
commonwealth: [a]/ˈkɑːmənwelθ/; [n]联邦; [or]yshx;
commotion: [a]/kəˈmoʊʃn/; [n]骚动,动乱; [or]yshx;
communication: [a]/kəˌmjuːnɪˈkeɪʃn/; [n]沟通方式;交流,通讯;信息; [or]yshx;
commute: [a]/kəˈmjuːt/; [n]在两地之间乘车往返; [v]经常乘车往返于两地之间; [vt]减免; [or]yshx;
compact: [a]/ˈkɑːmpækt/; [adj]小巧的,小型的,袖珍的,体积小的;紧密的,紧凑的,密集的; [v]把..压紧;变得坚实; [n]带镜小粉盒;合约,条约; [or]yshx;
compare: [a]/kəmˈper/; [v]比较,比作; [n]比较;对照; [or]yshx;
compass: [a]/ˈkʌmpəs/; [n]罗盘,指南针;圆规; [v]达到;围绕;图谋; [or]yshx;
compatible: [a]/kəmˈpætəbl/; [adj]可和谐共存的;兼容的; [or]yshx;
compel: [a]/kəmˈpel/; [v]强迫;迫使屈服;(使)不得已; [or]yshx;
compensate: [a]/ˈkɑːmpenseɪt/; [v]补偿,赔偿,给..报酬; [or]yshx;
competition: [a]/ˌkɑːmpəˈtɪʃn/; [n]比赛;竞争;竞争者; [or]yshx;
compile: [a]/kəmˈpaɪl/; [v]收集,汇编; [or]yshx;
complement: [a]/ˈkɑːmplɪment/; [v]补充;与.相配; [n]补充;互为补充的东西;补语; [or]yshx;
complex: [a]/ˈkɑːmpleks/; [adj]复杂的,难解的;复合的; [n]情结;建筑群;综合体,集合体; [or]yshx;
compliance: [a]/kəmˈplaɪəns/; [n]遵守,依从;承诺,答应; [or]yshx;
complicated: [a]/ˈkɑːmplɪkeɪtɪd/; [adj]复杂的;难解的; [v]使复杂; [or]yshx;
compliment: [a]/ˈkɑːmplɪmənt/; [n]恭维,问候; [v]赞美,祝贺; [or]yshx;
component: [a]/kəmˈpoʊnənt/; [n]零件; [adj]组成的; [or]yshx;
compose: [a]/kəmˈpoʊz/; [v]创作,作曲,形成,构成; [or]yshx;
composite: [a]/kəmˈpɑːzət/; [adj]合成的,复合的; [n]合成物,复合材料; [v]使合成,使混合; [or]yshx;
compound: [a]/ˈkɑːmpaʊnd/; [n]复合物;<化学>化合物; [adj]合成的;复合的;多功能的; [vi]妥协;和解; [vt]混合;调和;调停;使恶化; [or]yshx;
compress: [a]/kəmˈpres/; [v]压紧,压缩,压榨; [or]yshx;
comprise: [a]/kəmˈpraɪz/; [v]包含,包括;构成; [or]yshx;
compromise: [a]/ˈkɑːmprəmaɪz/; [n]妥协;折中; [v]妥协;使遭受危害; [or]yshx;
compulsory: [a]/kəmˈpʌlsəri/; [adj]强制的,必修的; [or]yshx;
compute: [a]/kəmˈpjuːt/; [v]计算,估计; [or]yshx;
conceal: [a]/kənˈsiːl/; [v]隐藏,隐瞒,掩盖; [or]yshx;
concede: [a]/kənˈsiːd/; [v]承认;承认失败;让给,让与;让步; [or]yshx;
conceive: [a]/kənˈsiːv/; [v]怀孕;设想,想出; [or]yshx;
concentrate: [a]/ˈkɑːnsntreɪt/; [v]全神贯注于,集中于;浓缩; [n]浓缩物; [or]yshx;
concern: [a]/kənˈsɜːrn/; [n]关心,担忧; [v]感兴趣,涉及,关心,(使)担忧; [or]yshx;
concerted: [a]/kənˈsɜːrtɪd/; [adj]一致的,商定的; [or]yshx;
concise: [a]/kənˈsaɪs/; [adj]简明的,简要的;简洁的,简要的; [or]yshx;
concoct: [a]/kənˈkɑːkt/; [v]调合;编造(故事等); [or]yshx;
concrete: [a]/ˈkɑːŋkriːt/; [n]混凝土; [adj]具体的,实质性的; [v]给 (道路等) 浇混凝土; [or]yshx;
condemn: [a]/kənˈdem/; [v]谴责,责备;判(某人某罪); [or]yshx;
condense: [a]/kənˈdens/; [v]压缩;精炼;冷凝; [or]yshx;
condolence: [a]/kənˈdoʊləns/; [n]吊唁;哀悼; [or]yshx;
conducive: [a]/kənˈduːsɪv/; [adj]有益的,有助于.的; [or]yshx;
confer: [a]/kənˈfɜːr/; [v]授予(奖项,学位,荣誉或权利);商讨,协商; [or]yshx;
confident: [a]/ˈkɑːnfɪdənt/; [adj]自信的;确信的,深信的; [or]yshx;
configuration: [a]/kənˌfɪɡjəˈreɪʃn/; [n]配置,布局,构造; [or]yshx;
confine: [a]/kənˈfaɪn/; [v]限制;监禁; [n]范围,界限,约束,限制; [or]yshx;
confirm: [a]/kənˈfɜːrm/; [v]确认;证实;批准; [or]yshx;
conflict: [a]/ˈkɑːnflɪkt/; [n]冲突,(意见)分歧,战斗,斗争; [v]冲突,抵触,争执; [or]yshx;
conform: [a]/kənˈfɔːrm/; [vi]一致;遵照,顺从;符合; [vt]使一致;使遵照; [adj]一致的; [or]yshx;
confront: [a]/kənˈfrʌnt/; [v]与某人对峙;与..对抗;正视; [or]yshx;
confuse: [a]/kənˈfjuːz/; [v]混淆;使混乱,使迷糊; [or]yshx;
congestion: [a]/kənˈdʒestʃən/; [n]拥挤,充血; [or]yshx;
congress: [a]/ˈkɑːŋɡrəs/; [n]国会(美);代表大会;议会;立法机关; [or]yshx;
conjunction: [a]/kənˈdʒʌŋkʃn/; [n]连接;联合,结合;连接词; [or]yshx;
conquer: [a]/ˈkɑːŋkər/; [v]征服,攻克;破除; [or]yshx;
conscience: [a]/ˈkɑːnʃəns/; [n]良心,良知; [or]yshx;
conscious: [a]/ˈkɑːnʃəs/; [adj]神志清醒的;自觉的;意识到的;有意的; [n]意识; [or]yshx;
consecutive: [a]/kənˈsekjətɪv/; [adj]连续的,连贯的; [or]yshx;
consent: [a]/kənˈsent/; [n]同意,准许;赞成; [v]同意; [or]yshx;
consequent: [a]/ˈkɑːnsəkwənt/; [adj]作为结果(或后果)的,随之发生的; [n]结果,随后的事; [or]yshx;
conservative: [a]/kənˈsɜːrvətɪv/; [adj]保守的;保守估计的;保守党的; [n]保守主义者;保守党党员; [or]yshx;
conserve: [a]/kənˈsɜːrv/; [v]保藏,保存;节约; [n]蜜饯,果酱; [or]yshx;
considerable: [a]/kənˈsɪdərəbl/; [adj]相当大的;重要的;可观的; [or]yshx;
consign: [a]/kənˈsaɪn/; [v]托运,托卖,寄存; [or]yshx;
consist of: [a]/kənˈsɪst ɑv/; [phr]由..组成; [or]yshx;
consist: [a]/kənˈsɪst/; [v]由..组成;在于; [or]yshx;
console: [a]/kənˈsoʊl/; [v]安慰,慰问; [n]控制台,仪表板;落地柜; [or]yshx;
consolidate: [a]/kənˈsɑːlɪdeɪt/; [v]巩固,加强;把.合为一体; [or]yshx;
conspicuous: [a]/kənˈspɪkjuəs/; [adj]显眼的;显著的;显而易见的; [or]yshx;
conspiracy: [a]/kənˈspɪrəsi/; [n]密谋,阴谋; [or]yshx;
constant: [a]/ˈkɑːnstənt/; [adj]不变的,始终如一的;持续不断的; [n]常数,恒量; [or]yshx;
constituent: [a]/kənˈstɪtʃuənt/; [adj]组成的;有选举权的; [n]选民;成分; [or]yshx;
constrain: [a]/kənˈstreɪn/; [v]约束;限制;强迫; [or]yshx;
constrict: [a]/kənˈstrɪkt/; [v]约束,收缩,妨碍; [or]yshx;
consult: [a]/kənˈsʌlt/; [v]请教,咨询;查阅;商量; [or]yshx;
consumption: [a]/kənˈsʌmpʃn/; [n]消耗,消费,耗尽;肺痨; [or]yshx;
contact: [a]/ˈkɑːntækt/; [v]接触;联系; [n]接触;联系; [adj]保持接触的;由接触引起的;<航>可看见地面景物的; [adv]<航>以目力观察(飞行); [int]开动; [or]yshx;
contaminate: [a]/kənˈtæmɪneɪt/; [v]弄脏,污染; [or]yshx;
contemplate: [a]/ˈkɑːntəmpleɪt/; [v]沉思;对..周密考虑;注视; [or]yshx;
contemporary: [a]/kənˈtempəreri/; [adj]同时代的;当代的,现代的; [n]同龄人,同时代的人; [or]yshx;
contempt: [a]/kənˈtempt/; [n]轻视,鄙视; [or]yshx;
contend: [a]/kənˈtend/; [v]争辩;坚决主张;搏斗; [or]yshx;
content: [a]/ˈkɑːntent/; [n]内容,目录;满足; [adj]满足的; [v]使满意; [or]yshx;
contest: [a]/ˈkɑːntest/; [n]比赛,竞争; [v]争夺,争论; [or]yshx;
context: [a]/ˈkɑːntekst/; [n]上下文,语境;背景; [or]yshx;
continuity: [a]/ˌkɑːntəˈnuːəti/; [n]连续性;(电影或电视节目中)镜头的连接,衔接; [or]yshx;
contract: [a]/ˈkɑːntrækt/; [n]合同,契约; [v]感染(疾病);招致;订合同;订立(婚约);缩减; [or]yshx;
contradict: [a]/ˌkɑːntrəˈdɪkt/; [v]与..发生矛盾,与..抵触,与..对立; [or]yshx;
contrast: [a]/ˈkɑːntræst/; [n]差异,对照,对比;对照;对比; [v](with)使与..对比; [or]yshx;
contribute: [a]/kənˈtrɪbjuːt/; [v]增进,起促成作用;捐献,捐助;..的原因之一;投稿; [or]yshx;
contrive: [a]/kənˈtraɪv/; [v]发明;设计出;设法做到;谋划;策划; [or]yshx;
controversial: [a]/ˌkɑːntrəˈvɜːrʃl/; [adj]引起争论的,有争议的; [or]yshx;
convene: [a]/kənˈviːn/; [v]集合,召集,召唤; [or]yshx;
convenience: [a]/kənˈviːniəns/; [n]方便;便利设施; [or]yshx;
convention: [a]/kənˈvenʃn/; [n]会议;习俗;惯例; [or]yshx;
converge: [a]/kənˈvɜːrdʒ/; [v](向某一点)相交,会合;汇集,聚集,集中; [or]yshx;
conversely: [a]/kənˈvɜːrsli/; [adv]相反地,反过来; [or]yshx;
convert: [a]/kənˈvɜːrt/; [v]可转变为,可变换成;改变,转变,转化;使改变信仰; [n]皈依者;改变宗教信仰者; [or]yshx;
convey: [a]/kənˈveɪ/; [v]传送,运送;表达,传达; [or]yshx;
convict: [a]/ˈkɑːnvɪkt/; [n]犯人; [v](经审讯)证明..有罪,使..知罪; [or]yshx;
convince: [a]/kənˈvɪns/; [v]使确信;使信服; [or]yshx;
cooperate: [a]/koʊˈɑːpəreɪt/; [v]协作,合作; [or]yshx;
coordinate: [a]/koʊˈɔːrdɪneɪt/; [v]使协调,使一致,调整; [n]坐标,同等的人物,配套服装; [adj]并列的;同等的; [or]yshx;
cordial: [a]/ˈkɔːrdʒəl/; [adj]热情友好的,衷心的; [or]yshx;
cork: [a]/kɔːrk/; [n]软木; [v]塞住,抑制; [or]yshx;
corporate: [a]/ˈkɔːrpərət/; [adj]公司的;全体的;共同的;(法人)团体的; [or]yshx;
corps: [a]/kɔːr/; [n](由两个或以上师组成的)军,兵团;一群人;特别小组; [or]yshx;
corpse: [a]/kɔːrps/; [n]尸体,被废弃的东西; [or]yshx;
correspond: [a]/ˌkɔːrəˈspɑːnd/; [v]符合;相符,一致;通信; [or]yshx;
corrode: [a]/kəˈroʊd/; [v]受腐蚀;腐蚀,侵蚀; [or]yshx;
corrupt: [a]/kəˈrʌpt/; [v]变腐败,堕落;贿赂,使腐败; [adj]腐败的;堕落的; [or]yshx;
cosmic: [a]/ˈkɑːzmɪk/; [adj]宇宙的;广大无边的; [or]yshx;
cosmopolitan: [a]/ˌkɑːzməˈpɑːlɪtən/; [n]游历四方的人; [adj]见多识广的;多元的;广泛分布的; [or]yshx;
costume: [a]/ˈkɑːstuːm/; [n]服装,剧装; [vt]提供服装;为 ... 设计服装; [adj]服装打扮的; [or]yshx;
couch: [a]/kaʊtʃ/; [n]长沙发;长椅;长榻; [v]表达; [or]yshx;
council: [a]/ˈkaʊnsl/; [n]议会;理事会;委员会; [or]yshx;
counsel: [a]/ˈkaʊnsl/; [n]忠告;律师,法律顾问; [v]劝告,提议; [or]yshx;
counter: [a]/ˈkaʊntər/; [n]柜台;回击,反击; [v]抵消,抗衡; [adv]相反地; [or]yshx;
counterbalance: [a]/ˌkaʊntərˈbæləns/; [n]平衡力;抵销; [v]使平衡;抵消; [or]yshx;
counterfeit: [a]/ˈkaʊntərfɪt/; [n]仿制品,伪造物; [adj]仿造的.假冒的; [v]伪造,仿造; [or]yshx;
counterpart: [a]/ˈkaʊntərpɑːrt/; [n]对应的人(物);副本;对手; [or]yshx;
coupon: [a]/ˈkuːpɑːn/; [n](债券等)息券;赠券;配给券;折扣券; [or]yshx;
courier: [a]/ˈkʊriər/; [n]快递员,通讯员,导游; [or]yshx;
courtesy: [a]/ˈkɜːrtəsi/; [n]礼貌; [or]yshx;
coverage: [a]/ˈkʌvərɪdʒ/; [n]新闻报道;可达范围;覆盖范围; [or]yshx;
coward: [a]/ˈkaʊərd/; [n]懦夫,胆小鬼; [adj]懦弱的,胆怯的; [or]yshx;
cozy: [a]/ˈkoʊzi/; [adj]温暖舒适的,安逸的; [v]取悦; [or]yshx;
crack: [a]/kræk/; [v]敲出裂痕,敲破;垮掉;断裂,折断;说(笑话); [n]裂缝;破裂声;挖苦话;强效纯可卡因; [adj]最好的,一流的; [adv]尖锐地; [vi]断裂,折断; [or]yshx;
cradle: [a]/ˈkreɪdl/; [n]摇篮;策源地,发源地; [v]轻轻地抱,捧; [or]yshx;
craft: [a]/kræft/; [n]手工艺,手工制品,船,航天器; [v]手工制作,精心制作; [or]yshx;
crash: [a]/kræʃ/; [n]碰撞,坠落,轰隆声; [v]碰撞,坠落,崩溃; [adj]紧急的; [or]yshx;
crater: [a]/ˈkreɪtər/; [n]火山口;弹坑; [v]在.上形成坑;毁坏; [or]yshx;
crawl: [a]/krɔːl/; [v]爬,爬行;缓慢行进; [n]缓慢行进;自由式游泳; [or]yshx;
creation: [a]/kriˈeɪʃn/; [n]创造,创作;创造物,作品; [or]yshx;
credit: [a]/ˈkredɪt/; [n]信用;荣誉;学分;信贷;称赞;债权; [v]信赖;归因于;记学分; [or]yshx;
creep: [a]/kriːp/; [vi]爬行;潜入;蔓延;变形;毛发直竖; [n]卑鄙小人;爬行;变形;毛骨悚然的感觉; [or]yshx;
crevice: [a]/ˈkrevɪs/; [n]缺口,裂缝; [or]yshx;
cricket: [a]/ˈkrɪkɪt/; [n]板球,板球运动;蟋蟀; [or]yshx;
criminal: [a]/ˈkrɪmɪnl/; [n]罪犯; [adj]犯罪的,违法的,刑法的;可耻的; [or]yshx;
cripple: [a]/ˈkrɪpl/; [n]跛子,伤残人(或动物); [v]使跛;使受伤致残;严重削弱; [or]yshx;
crisis: [a]/ˈkraɪsɪs/; [n]危机;存亡之际; [or]yshx;
crisp: [a]/krɪsp/; [adj]脆的,易碎的,霜冻的,干脆的; [n]油炸马铃薯片; [v](使)发脆; [or]yshx;
criterion: [a]/kraɪˈtɪriən/; [n]标准,准则; [or]yshx;
critical: [a]/ˈkrɪtɪkl/; [adj]批评的;文艺评论的;爱挑剔的;危急的;关键的,重要的; [or]yshx;
crooked: [a]/ˈkrʊkɪd/; [adj]弯曲的;歪的;不正当的;不正直的; [or]yshx;
crouch: [a]/kraʊtʃ/; [v]蹲;弯腰; [or]yshx;
crown: [a]/kraʊn/; [n]王冠,冕;王权;花冠; [v]加冕; [or]yshx;
crucial: [a]/ˈkruːʃl/; [adj]关键的;决定性的; [or]yshx;
crude: [a]/kruːd/; [adj]天然的;粗糙的;粗鲁的;简陋的; [n]原油; [or]yshx;
cruise: [a]/kruːz/; [n]巡航;漫游;旅行; [v]航游;巡航;(出租车,船等)缓慢巡行; [or]yshx;
crumble: [a]/ˈkrʌmbl/; [v]弄碎;使破碎;崩溃;破灭; [n]碎屑;面包屑; [or]yshx;
crumple: [a]/ˈkrʌmpl/; [v]把.揉作一团,弄皱;压碎; [or]yshx;
crush: [a]/krʌʃ/; [vt]压坏;压扁;弄皱;弄碎,压碎;榨出;紧抱;挤入;镇压;欺压; [n]压扁;极度拥挤; [vi]被压坏;被揉皱;蜂拥而来; [or]yshx;
crust: [a]/krʌst/; [n]外壳,面包皮,硬外皮; [or]yshx;
crystal: [a]/ˈkrɪstl/; [n]水晶,晶体;结晶;水晶做成的东西; [or]yshx;
cube: [a]/kjuːb/; [n]立方体,立方; [or]yshx;
cucumber: [a]/ˈkjuːkʌmbər/; [n]黄瓜; [or]yshx;
cue: [a]/kjuː/; [n]提示;暗号;球杆; [v]给.提示; [or]yshx;
culminate: [a]/ˈkʌlmɪneɪt/; [v]使达高潮,使结束; [or]yshx;
cultivate: [a]/ˈkʌltɪveɪt/; [v]耕作,养植,栽培;培养,陶冶,发展; [or]yshx;
cumbersome: [a]/ˈkʌmbərsəm/; [adj]笨重的;麻烦的; [or]yshx;
cumulative: [a]/ˈkjuːmjəleɪtɪv/; [adj]渐增的;累积的; [or]yshx;
cunning: [a]/ˈkʌnɪŋ/; [n]狡猾,精巧; [adj]狡猾的,精巧的; [or]yshx;
cupboard: [a]/ˈkʌbərd/; [n]碗橱,衣柜,壁橱; [or]yshx;
curb: [a]/kɜːrb/; [v]勒住;抑制;控制;约束; [n]路缘;控制;约束; [or]yshx;
cure: [a]/kjʊr/; [n]对策,措施;治疗,医治; [v]治愈,治疗; [or]yshx;
curl: [a]/kɜːrl/; [n]卷毛,卷发; [v]使卷曲; [or]yshx;
currency: [a]/ˈkɜːrənsi/; [n]货币;流通;流行; [or]yshx;
curriculum vitae: [a]/kəˌrɪkjələm ˈviːtaɪ/; [phr]简短的履历书; [or]yshx;
curriculum: [a]/kəˈrɪkjələm/; [n]课程,(学校或专业的)全部课程; [or]yshx;
curse: [a]/kɜːrs/; [n]诅咒;咒骂;祸因; [v]诅咒;咒骂;使受罪; [or]yshx;
curtail: [a]/kɜːrˈteɪl/; [vt]截短;削减;剥夺.特权; [or]yshx;
curve: [a]/kɜːrv/; [v]使弯曲; [n]曲线,弯曲; [adj]弯曲的;曲线形的; [or]yshx;
cushion: [a]/ˈkʊʃn/; [n]坐垫; [v]减轻,缓和; [or]yshx;
custodian: [a]/kʌˈstoʊdiən/; [n]监护人,保管人,看守人; [or]yshx;
custom: [a]/ˈkʌstəm/; [n]习惯;风俗; [adj]定制的; [or]yshx;
cut across: [a]/kʌt əˈkrɔs/; [v]抄近路通过; quant. 与...相抵触;与...相反; [or]yshx;
cut sth. (sb.) down: [a]/kʌt ˈsʌmθɪŋ ˈsʌmbədi daʊn/; [phr]砍倒;削减;说服某人降价; [or]yshx;
cute: [a]/kjuːt/; [adj]可爱的;讨人喜爱的;聪明的; [or]yshx;
cylinder: [a]/ˈsɪlɪndər/; [n]圆柱体,圆筒;汽缸,泵(或桶)体; [or]yshx;
cynical: [a]/ˈsɪnɪkl/; [adj]愤世嫉俗的;恶意的;悲观的; [or]yshx;
dairy: [a]/ˈderi/; [n]牛奶场;乳制品; [adj]牛奶的,奶制的; [or]yshx;
dam: [a]/dæm/; [n]水坝;母兽; [v]用水坝阻止;阻塞,抑制; [or]yshx;
damp: [a]/dæmp/; [adj]潮湿的,有湿气的; [or]yshx;
dart: [a]/dɑːrt/; [n]飞镖;猛冲;标枪; [v]快速投掷;突然移动; [or]yshx;
dash: [a]/dæʃ/; [vi]猛冲,突进; [v]猛掷; [n]破折号;猛冲; [or]yshx;
dawn: [a]/dɔːn/; [n]黎明;开始; [v]破晓; [or]yshx;
day in and day out: [a]/deɪ ɪn ənd deɪ aʊt/; [adv]天天,一天又一天; [or]yshx;
dazzle: [a]/ˈdæzl/; [n]光辉;令人赞叹的东西; [v]使眼花;使赞叹不已; [or]yshx;
deadlock: [a]/ˈdedlɑːk/; [vt](使)相持不下; [vi]僵持; [n]僵局;不分胜负; [or]yshx;
deadly: [a]/ˈdedli/; [adj]致命的,致死的,十足的; [adv]死一般地;非常; [or]yshx;
deaf: [a]/def/; [adj]聋的;不愿听的; [n]聋子;耳聋的人; [or]yshx;
dean: [a]/diːn/; [n](大学的)学院院长;系主任;资格最老者,泰斗;牧师; [or]yshx;
debris: [a]/dəˈbriː/; [n]废墟,残骸; [or]yshx;
decade: [a]/ˈdekeɪd/; [n]十年,十年间; [or]yshx;
decay: [a]/dɪˈkeɪ/; [v]腐烂;衰退;腐朽; [n]腐烂;衰退;腐败; [or]yshx;
deceive: [a]/dɪˈsiːv/; [v]欺骗,行骗; [or]yshx;
decent: [a]/ˈdiːsnt/; [adj]体面的;像样的;合宜的;正直的; [or]yshx;
decimal: [a]/ˈdesɪml/; [n]小数; [adj]小数的;十进制的; [or]yshx;
decipher: [a]/dɪˈsaɪfər/; [n]密电译文; [vt]解释;破译; [or]yshx;
deck: [a]/dek/; [n]甲板,公共汽车一层的车厢,纸牌; [v]装饰;击倒; [or]yshx;
declare: [a]/dɪˈkler/; [vt]表明;宣布;强调;申报(收益);申报(应纳税品); [vi]板球(在击球员还未全部出局时)宣布结束赛局; [or]yshx;
decline: [a]/dɪˈklaɪn/; [n]下降;衰退; [v]<语>使发生词尾变化,使变格;下降;拒绝; [or]yshx;
decompose: [a]/ˌdiːkəmˈpoʊz/; [v](使)腐烂;分解; [or]yshx;
decorate: [a]/ˈdekəreɪt/; [v]装饰,布置;把(勋章)授给(某人); [or]yshx;
decrease: [a]/dɪˈkriːs/; [v]减少;减; [n]减;减少; [or]yshx;
decree: [a]/dɪˈkriː/; [v]命令,判决,颁布; [n]法令,政令; [or]yshx;
decrepit: [a]/dɪˈkrepɪt/; [adj]衰老的,破旧的; [or]yshx;
dedicate: [a]/ˈdedɪkeɪt/; [v]献给,致力于; [or]yshx;
deduce: [a]/dɪˈduːs/; [v]演绎;推论,推断; [or]yshx;
deduct: [a]/dɪˈdʌkt/; [v]减去; [or]yshx;
deem: [a]/diːm/; [v]认为,视为;知道,相信; [or]yshx;
default: [a]/dɪˈfɔːlt/; [n]违约;缺席;缺乏;默认; [vi]不履行义务;拖欠; [vt]不履行;不参加; [or]yshx;
defeat: [a]/dɪˈfiːt/; [n]挫败;击败,战胜; [v]打败;战胜; [or]yshx;
defect: [a]/ˈdiːfekt/; [n]缺陷,缺点,不足之处; [v]背叛,逃跑,开小差; [or]yshx;
defense: [a]/dɪ'fens/; [n]防御,防护; [or]yshx;
defer: [a]/dɪˈfɜːr/; [v]使推迟,使延期;听从,顺从; [vi]延期; [or]yshx;
defiance: [a]/dɪˈfaɪəns/; [n]蔑视;反抗;挑战; [or]yshx;
deficiency: [a]/dɪˈfɪʃnsi/; [n]缺乏,不足;缺陷; [or]yshx;
deficit: [a]/ˈdefɪsɪt/; [n]亏损;赤字;不足额; [or]yshx;
defile: [a]/dɪˈfaɪl/; [v]污损,弄脏;以纵队前进; [n]狭谷;隘路; [or]yshx;
definitive: [a]/dɪˈfɪnətɪv/; [adj]可靠的,明确的,权威的;决定性的; [or]yshx;
deflect: [a]/dɪˈflekt/; [v](使)偏斜,(使)偏转; [or]yshx;
defraud: [a]/dɪˈfrɔːd/; [v]欺诈,诈取,骗取; [or]yshx;
deft: [a]/deft/; [adj]灵巧的,敏捷的,熟练的; [or]yshx;
degenerate: [a]/dɪˈdʒenəreɪt/; [v]堕落,衰减; [adj]腐化的,颓废的,退化的;变质的; [n]堕落者; [or]yshx;
degrade: [a]/dɪˈɡreɪd/; [v]贬低;降低品格(身价,价值等);分解;降低; [or]yshx;
delectable: [a]/dɪˈlektəbl/; [adj]令人愉快的;美味的; [or]yshx;
delegate: [a]/ˈdelɪɡət/; [n]代表; [v]委派..为代表,授权; [or]yshx;
delete: [a]/dɪˈliːt/; [v]删除; [or]yshx;
deliberate: [a]/dɪˈlɪbərət/; [adj]故意的;深思熟虑的;从容不迫的; [v]仔细考虑;研讨; [or]yshx;
delicate: [a]/ˈdelɪkət/; [adj]易碎的,易坏的,脆弱的;(人)娇弱的,体弱多病的;精美的,精致的,精巧的;微妙的,需要谨慎处理的;优美的,优雅的;柔和的,清淡的,淡雅的; [or]yshx;
delinquency: [a]/dɪˈlɪŋkwənsi/; [n]失职,玩忽职守,拖欠债务,缺点,过错;<法律>少年犯罪,不法行为(青少年),行为不当; [or]yshx;
delirium: [a]/dɪˈlɪriəm/; [n]神志不清,极度兴奋; [or]yshx;
deliver: [a]/dɪˈlɪvər/; [v]递送,交付;履行;发表(演讲);分娩;投掷; [or]yshx;
deluge: [a]/ˈdeljuːdʒ/; [n]洪水;暴雨;泛滥; [v]使泛滥;压倒; [or]yshx;
democracy: [a]/dɪˈmɑːkrəsi/; [n]民主制度;民主国家;民主主义;民众; [or]yshx;
demolish: [a]/dɪˈmɑːlɪʃ/; [v]拆毁(建筑物等);毁坏,破坏(组织等);〈俚〉吃光; [or]yshx;
demonstrate: [a]/ˈdemənstreɪt/; [vt](用实例,实验)论证;演示,展示;示范; [vi]示威; [or]yshx;
denial: [a]/dɪˈnaɪəl/; [n]拒绝;否认;拒绝给予; [or]yshx;
denomination: [a]/dɪˌnɑːmɪˈneɪʃn/; [n]名称,名目;(货币的) 面额;单位;教派; [or]yshx;
denote: [a]/dɪˈnoʊt/; [v]是.的标志;指出; [vt]指示;代表(或表示); [or]yshx;
denounce: [a]/dɪˈnaʊns/; [v]谴责,斥责; [or]yshx;
dense: [a]/dens/; [adj](物质) 密度大的;稠密的,浓密的;愚钝的;难懂的,费解的; [or]yshx;
dentist: [a]/ˈdentɪst/; [n]牙医; [or]yshx;
depart: [a]/dɪˈpɑːrt/; [v]离开;起程;出发;起程;出发;离职; [or]yshx;
depict: [a]/dɪˈpɪkt/; [v]描绘,描写; [or]yshx;
deplete: [a]/dɪˈpliːt/; [v]使大大减少;耗尽,用尽; [or]yshx;
deplore: [a]/dɪˈplɔːr/; [v]谴责;对...深感遗憾;悲悼;痛惜; [or]yshx;
deposit: [a]/dɪˈpɑːzɪt/; [v]存款,存放;沉淀; [n]存款,定金;沉积物,矿床; [or]yshx;
depress: [a]/dɪˈpres/; [vt]使沮丧;使萧条;压下,压低; [or]yshx;
deprive: [a]/dɪˈpraɪv/; [v]使丧失;剥夺;免去.的职务; [or]yshx;
deputy: [a]/ˈdepjuti/; [n]副手;代表;代表,代理人; [or]yshx;
derive: [a]/dɪˈraɪv/; [v]获取;得自;起源; [or]yshx;
descend: [a]/dɪˈsend/; [vi]走下;降临; [v]下降,下来;突然访问;下移,下降; [or]yshx;
description: [a]/dɪˈskrɪpʃn/; [n]描写,形容,叙述;种类,类型; [or]yshx;
desert: [a]/ˈdezərt/; [n]沙漠; [v]离开; [or]yshx;
deserve: [a]/dɪˈzɜːrv/; [v]值得,应得;应受; [or]yshx;
designate: [a]/ˈdezɪɡneɪt/; [adj]已受委派而尚未上任的; [v]标出,说出;委任,任命,提名;指定; [or]yshx;
desirable: [a]/dɪˈzaɪərəbl/; [adj]有吸引力的;性感的;令人向往的;令人满意的; [or]yshx;
desolate: [a]/ˈdesələt/; [adj]荒凉的;孤单寂寞的; [or]yshx;
despair: [a]/dɪˈsper/; [n]绝望,失望; [v]失望; [or]yshx;
despatch: [a]/dɪˈspætʃ/; [v]发送;派遣;打败; [n](公文)急件;(记者发回的)新闻报道;派遣; [or]yshx;
desperate: [a]/ˈdespərət/; [adj]绝望的;孤注一掷的;极需要的,渴望的;(情况) 极严重的;极危险的;很危急的; [or]yshx;
destination: [a]/ˌdestɪˈneɪʃn/; [n]目的地,终点; [adj]目的地的; [or]yshx;
destructive: [a]/dɪˈstrʌktɪv/; [adj]破坏(性)的,毁灭(性)的; [or]yshx;
detach: [a]/dɪˈtætʃ/; [v]使分开,拆卸;派遣; [or]yshx;
detain: [a]/dɪˈteɪn/; [v]拘留,使延迟; [or]yshx;
detect: [a]/dɪˈtekt/; [v]发现,发觉;侦察,探测; [or]yshx;
deter: [a]/dɪˈtɜːr/; [v]防止,阻止,使踌躇; [or]yshx;
detergent: [a]/dɪˈtɜːrdʒənt/; [n]洗涤剂,清洁剂; [or]yshx;
deteriorate: [a]/dɪˈtɪriəreɪt/; [v]恶化;变质;衰退; [or]yshx;
determination: [a]/dɪˌtɜːrmɪˈneɪʃn/; [n]决定;确定;决心; [or]yshx;
detest: [a]/dɪˈtest/; [vt]厌恶,憎恨,痛恨; [or]yshx;
detrimental: [a]/ˌdetrɪˈmentl/; [adj]有害的,不利的; [or]yshx;
devastate: [a]/ˈdevəsteɪt/; [v]摧毁;使垮掉,使不知所措,使陷于混乱; [or]yshx;
deviate: [a]/ˈdiːvieɪt/; [v]偏离;背离; [adj]脱离常轨的; [n]脱离常轨的人; [or]yshx;
devise: [a]/dɪˈvaɪz/; [v]设计,想出;密谋;遗赠(不动产); [n]设计,发明,遗赠; [or]yshx;
devote: [a]/dɪˈvoʊt/; [vt]奉献;献身于,专心致力于; [or]yshx;
devour: [a]/dɪˈvaʊər/; [v]狼吞虎咽;毁灭;贪婪地看,贪婪地阅读; [or]yshx;
diagnose: [a]/ˌdaɪəɡˈnoʊs/; [v]诊断(疾病),对(病人)下诊断结论; [or]yshx;
diagram: [a]/ˈdaɪəɡræm/; [n]图解,图表; [or]yshx;
dial: [a]/ˈdaɪəl/; [v]拨(电话号码);打电话; [n]钟面;仪表盘;拨号盘; [or]yshx;
dialect: [a]/ˈdaɪəlekt/; [n]方言;语调; [adj]方言的; [or]yshx;
diameter: [a]/daɪˈæmɪtər/; [n]直径; [or]yshx;
dictate: [a]/ˈdɪkteɪt/; [v]规定;命令;口授;听写; [n]命令;指令; [or]yshx;
diet: [a]/ˈdaɪət/; [n]日常饮食;(病人或减肥者的)特种饮食;大量; [v]节食; [or]yshx;
differentiate: [a]/ˌdɪfəˈrenʃieɪt/; [v]使有差异;区别; [or]yshx;
diffuse: [a]/dɪˈfjuːz/; [v]传播;扩散,弥漫;漫射; [adj]四散的,散开的;不清楚的; [or]yshx;
digest: [a]/daɪˈdʒest/; [v]消化;领会,理解; [n]摘要; [or]yshx;
digital: [a]/ˈdɪdʒɪtl/; [adj]数字显示的;数字的,数码的; [n]键;数字仪表,时钟; [or]yshx;
dignity: [a]/ˈdɪɡnəti/; [n]威严,威风;端庄;尊严,高贵; [or]yshx;
dilapidated: [a]/dɪˈlæpɪdeɪtɪd/; [adj]破旧的,破烂的;倾坍的; [or]yshx;
dilemma: [a]/dɪˈlemə/; [n]进退两难的窘境; [or]yshx;
diligent: [a]/ˈdɪlɪdʒənt/; [adj]勤奋的;用功的; [or]yshx;
dilute: [a]/daɪˈluːt/; [v]使变淡,稀释;使病弱; [or]yshx;
dim: [a]/dɪm/; [adj]暗淡的;模糊的;朦胧的; [v]变暗淡; [or]yshx;
dimension: [a]/dɪˈmenʃn/; [n]维度;尺寸;尺度;方面; [or]yshx;
diminish: [a]/dɪˈmɪnɪʃ/; [v]减少;失势,削弱.的权势, 减弱.的权势; [or]yshx;
din: [a]/dɪn/; [n]喧闹声,嘈杂声; [v]喧闹,喋喋不休地说; [or]yshx;
dine: [a]/daɪn/; [v]吃饭,用餐;招待..吃饭;用正餐(晚餐); [or]yshx;
dingy: [a]/ˈdɪndʒi/; [adj]昏暗的,肮脏的;褴褛的; [n]同"dingey"; [or]yshx;
dip: [a]/dɪp/; [v]浸,蘸; [n]倾斜,下降;调味汁; [or]yshx;
diploma: [a]/dɪˈploʊmə/; [n]毕业文凭,毕业证书;文凭课程; [or]yshx;
diplomatic: [a]/ˌdɪpləˈmætɪk/; [adj]外交的,从事外交的;老练的,圆滑的; [or]yshx;
directory: [a]/dəˈrektəri/; [n]人名地址录,(电话)号码簿;目录; [or]yshx;
disarray: [a]/ˌdɪsəˈreɪ/; [n]混乱,漫无秩序; [or]yshx;
disc: [a]/dɪsk/; [n]唱片;<计> 磁盘,磁碟片;椎间盘;圆盘,盘状物; [or]yshx;
discard: [a]/dɪsˈkɑːrd/; [v]丢弃;抛弃;遗弃; [or]yshx;
discern: [a]/dɪˈsɜːrn/; [v]辨别;识别;看出; [or]yshx;
discharge: [a]/dɪsˈtʃɑːrdʒ/; [n]发射;释放;解雇;放电; [v]卸掉负担;发射;放电;卸(货);使爆炸;履行;解雇;允许.离开;排出,放出;清偿(债务); [or]yshx;
discipline: [a]/ˈdɪsəplɪn/; [n]纪律;学科;训练; [v]训练;惩罚;管制; [or]yshx;
disclose: [a]/dɪsˈkloʊz/; [v]公开,揭露,泄露; [or]yshx;
discord: [a]/ˈdɪskɔːrd/; [n]不和,争吵;(声音)不和谐; [or]yshx;
discount: [a]/ˈdɪskaʊnt/; [n](价格,债款等)折扣; [v]打折扣,不全信,怀疑地看待; [or]yshx;
discreet: [a]/dɪˈskriːt/; [adj]谨慎的;思虑周全的,小心的; [or]yshx;
discrepancy: [a]/dɪsˈkrepənsi/; [n]不一致,差异,不符; [or]yshx;
discrete: [a]/dɪˈskriːt/; [adj]分开的;不连续的; [or]yshx;
discriminate: [a]/dɪˈskrɪmɪneɪt/; [v]区别,辨别;歧视; [or]yshx;
disdain: [a]/dɪsˈdeɪn/; [n]蔑视,鄙视; [vt]鄙视;不屑; [or]yshx;
disguise: [a]/dɪsˈɡaɪz/; [v]伪装;掩饰; [n]伪装物;伪装; [or]yshx;
disgust: [a]/dɪsˈɡʌst/; [v]使作呕,使厌恶; [n]恶心; [or]yshx;
dismay: [a]/dɪsˈmeɪ/; [n]失望;沮丧;惊愕; [v]使惊恐; [or]yshx;
dismiss: [a]/dɪsˈmɪs/; [v]开除;解散;摒除,不再考虑; [or]yshx;
disorder: [a]/dɪsˈɔːrdər/; [n]混乱;紊乱;动乱; [vt]使混乱;使紊乱; [or]yshx;
dispatch: [a]/dɪˈspætʃ/; [v]派遣,调遣;发送(信件,电报等);结束,摆脱掉;匆匆办完; [vt]处决; [n]派遣,调遣;发送;快信,急件;迅速,敏捷; [or]yshx;
disperse: [a]/dɪˈspɜːrs/; [v]使散开;分散,散开; [or]yshx;
display: [a]/dɪˈspleɪ/; [v]展示;显示;陈列; [n]表现,流露,展示;显示,显示器;陈列品; [or]yshx;
dispose: [a]/dɪˈspoʊz/; [v]处理,处置,除去;使愿意; [or]yshx;
dispute: [a]/dɪˈspjuːt/; [n]争论,争端; [v]争执,驳斥; [or]yshx;
disregard: [a]/ˌdɪsrɪˈɡɑːrd/; [v]不理会;漠视; [n]忽视,漠视; [or]yshx;
disrupt: [a]/dɪsˈrʌpt/; [v]扰乱; [or]yshx;
dissertation: [a]/ˌdɪsərˈteɪʃn/; [n](博士学位)论文;学术演讲;专题; [or]yshx;
dissipate: [a]/ˈdɪsɪpeɪt/; [v]消散,消失;浪费; [or]yshx;
dissolve: [a]/dɪˈzɑːlv/; [v]使溶解;废除,使解散; [or]yshx;
distend: [a]/dɪˈstend/; [v]膨胀;胀大;扩张; [or]yshx;
distill: [a]/dɪˈstɪl/; [v]抽出..的精华;蒸馏; [or]yshx;
distinct: [a]/dɪˈstɪŋkt/; [adj]截然不同的;独特的;明显的;清晰的; [or]yshx;
distinguish: [a]/dɪˈstɪŋɡwɪʃ/; [v]区别,识别,辨别,使显著; [or]yshx;
distort: [a]/dɪˈstɔːrt/; [v]扭曲,使变形;歪曲,曲解; [or]yshx;
distress: [a]/dɪˈstres/; [n]悲伤,疼痛;痛苦,焦虑;困难,困境; [adj]受灾的;受灾造成的,焦虑的; [v]使痛苦,使焦急;因紧张而困恼;使困苦;迫使; [or]yshx;
distribute: [a]/dɪˈstrɪbjuːt/; [v]分发,分配,配送;散布; [or]yshx;
disturb: [a]/dɪˈstɜːrb/; [v]打扰,妨碍;弄乱;使烦恼; [or]yshx;
ditch: [a]/dɪtʃ/; [n]沟,沟渠; [v]迫降海上; [vt]丢弃;旷课; [or]yshx;
diverse: [a]/daɪˈvɜːrs/; [adj]不同的,差异的,多种多样的; [or]yshx;
divert: [a]/daɪˈvɜːrt/; [v]使转向,使改道(或绕道);转移,转移.的注意力;使娱乐,使消遣; [or]yshx;
dividend: [a]/ˈdɪvɪdend/; [n](股份的)红利,回报,效益,被除数; [or]yshx;
divine: [a]/dɪˈvaɪn/; [adj]神的,神圣的;极好的; [v](凭直觉)发现,猜到; [n]神学家;圣职人员;教士;上帝; [or]yshx;
dizzy: [a]/ˈdɪzi/; [adj]眩晕的,头晕目眩的,头昏眼花的; [vt]使头晕目眩;使困惑; [or]yshx;
do away with: [a]/doʊ əˈweɪ wɪθ/; [phr]废除;消灭;去掉; [or]yshx;
do sb. a favour: [a]/duːˈsʌmbədi ə ˈfeɪvər/; [v]为某人帮个忙; [or]yshx;
do sth. with a bad grace: [a]/duː ˈsʌmθɪŋ wɪð ə bæd ɡreɪs/; [phr]勉强做某事; [or]yshx;
do with: [a]/duː wɪθ/; [phr]需要; [or]yshx;
dock: [a]/dɑːk/; [n]码头;船埠;被告席; [v](船)进港;扣工资;剪短(动物的尾巴); [or]yshx;
doctrine: [a]/ˈdɑːktrɪn/; [n]教条,学说,信条,原则; [or]yshx;
dodge: [a]/dɑːdʒ/; [n]托词;躲闪,躲避; [v]回避,规避;躲避,避开; [or]yshx;
domain: [a]/doʊˈmeɪn/; [n]域名;领土;管区,势力圈; [or]yshx;
dome: [a]/doʊm/; [n]圆屋顶,穹顶; [or]yshx;
domestic: [a]/dəˈmestɪk/; [adj]国产的;国内的;家庭的;驯养的; [n]家仆;家庭纷争; [or]yshx;
dominate: [a]/ˈdɑːmɪneɪt/; [v]在.中占首要地位;支配,统治,控制;耸立于,俯视;处于支配地位,拥有优势; [or]yshx;
donate: [a]/ˈdoʊneɪt/; [v]捐献;捐赠; [vi]捐献;捐赠; [or]yshx;
doom: [a]/duːm/; [v]注定;命定; [n]毁灭;厄运;劫数; [or]yshx;
dormant: [a]/ˈdɔːrmənt/; [adj]睡眠的,休眠的;静止的,隐伏的; [or]yshx;
dose: [a]/doʊs/; [n](药)剂量,用量,一剂; [vt]给..服药; [or]yshx;
dot: [a]/dɑːt/; [n]点,圆点; [v]点缀,作小点记号; [or]yshx;
doubtful: [a]/ˈdaʊtfl/; [adj]怀疑的,疑惑的; [or]yshx;
downpour: [a]/ˈdaʊnpɔːr/; [n]倾盆大雨; [or]yshx;
downtown: [a]/ˈdaʊntaʊn/; [adj]商业区的,闹市区的; [adv]在商业区,在市中心; [n]市中心区,市中心; [or]yshx;
draft: [a]/dræft/; [n]气流;通风,通风装置;草稿;汇票;征兵; [v]起草;征兵; [or]yshx;
drain: [a]/dreɪn/; [vi]排出,排水; [v]流干,沥干;喝光,耗尽,减少,消逝; [vt]使流出,排掉水; [n]下水道,排水管;消耗,排水; [or]yshx;
dramatic: [a]/drəˈmætɪk/; [adj]戏剧的,戏剧性的;引人注目的;逼真的,刺激的; [or]yshx;
drastic: [a]/ˈdræstɪk/; [adj]极端的;猛烈的;激烈的; [or]yshx;
drawback: [a]/ˈdrɔːbæk/; [n]缺点;障碍,不利条件; [or]yshx;
dread: [a]/dred/; [v]惧怕,害怕; [n]畏惧,恐惧; [adj]恐怖的,使人敬畏的; [or]yshx;
dreary: [a]/ˈdrɪri/; [adj]沉闷的;乏味的;凄凉的; [or]yshx;
drench: [a]/drentʃ/; [v]使淋透;使湿透; [n]淋透;雨淋;浸渍液;(制革时浸泡熟皮的)脱灰水; [or]yshx;
drift: [a]/drɪft/; [v]漂流;游荡;使漂流;使堆积; [n]漂流;漂流物;趋势;主旨;漂移; [or]yshx;
drill: [a]/drɪl/; [n]训练;反复操练;钻头; [v]在..上钻孔;钻孔; [or]yshx;
drought: [a]/draʊt/; [n]干旱,旱灾; [or]yshx;
drown: [a]/draʊn/; [v]淹死;淹没; [or]yshx;
drowse: [a]/draʊz/; [v]打瞌睡;发呆;昏昏沉沉地消磨(时光); [n]瞌睡; [or]yshx;
drudgery: [a]/ˈdrʌdʒəri/; [n]苦工;苦差事;单调乏味的工作; [or]yshx;
dual: [a]/ˈduːəl/; [adj]双的;双重的; [or]yshx;
dub: [a]/dʌb/; [v]授予(称号);为(电影)配音;混录录制(音乐); [n](西印度群岛的)强节奏音乐; [or]yshx;
dubious: [a]/ˈduːbiəs/; [adj]可疑的;怀疑的;无把握的; [or]yshx;
due: [a]/duː/; [adv]直接地,确切地; [adj]拖欠的;到期的,预期的;应得的;由于;适当的; [n]会费;应有的权利,应得到的东西; [or]yshx;
dull: [a]/dʌl/; [adj]愚笨的,迟钝的;枯燥的,沉闷的;不清晰的,吵闹的; [v]缓和;减轻;使阴暗; [or]yshx;
duly: [a]/ˈduːli/; [adv]适当地;按时地; [or]yshx;
dumb: [a]/dʌm/; [adj]哑的,暂不说话的,愚笨的; [v]使沉默; [or]yshx;
dump: [a]/dʌmp/; [v]倾倒,丢弃;抛弃(某人); [n]垃圾场,废物堆;军需品临时堆放的地方; [or]yshx;
duplicate: [a]/ˈduːplɪkeɪt/; [n]复制品; [v]复制;重复; [adj]完全一样的; [or]yshx;
durable: [a]/ˈdʊrəbl/; [adj]耐用的,长久的; [n]耐用品; [or]yshx;
dwarf: [a]/dwɔːrf/; [n]侏儒; [v]变矮;发育不全; [adj]矮生动物或植物的;矮小的;发育不全的; [vt]使矮小;阻碍.的发育; [or]yshx;
dwell: [a]/dwel/; [v](尤指作为常住居民)居住; [or]yshx;
dynamic: [a]/daɪˈnæmɪk/; [adj]有活力的,有生气的;不断变化的;动态的; [n]活力,动力; [or]yshx;
earnest: [a]/ˈɜːrnɪst/; [adj]真诚的,诚挚的,认真的; [n]认真,严肃; [or]yshx;
ease: [a]/iːz/; [n]安逸;容易;不拘束; [v]解除痛苦;缓解;顺利进出; [or]yshx;
eclipse: [a]/ɪˈklɪps/; [n](日,月)食;黯然失色; [v]掩盖..的重要性;使暗淡; [or]yshx;
ecology: [a]/iˈkɑːlədʒi/; [n]生态,生态学; [or]yshx;
economic: [a]/ˌekəˈnɑːmɪk/; [adj]经济上的,经济学的;合算的;有利可图的; [or]yshx;
eddy: [a]/ˈedi/; [n]漩涡; [v]旋转;起漩涡; [or]yshx;
edible: [a]/ˈedəbl/; [adj]可食的; [or]yshx;
edit: [a]/ˈedɪt/; [v]剪辑;编辑;校订; [n]编辑<校订>工作; [or]yshx;
edition: [a]/ɪˈdɪʃn/; [n]版,版本,版次; [or]yshx;
efficient: [a]/ɪˈfɪʃnt/; [adj]效率高的;有能力的;能胜任的; [or]yshx;
ego: [a]/ˈiːɡoʊ/; [n]自我;自负;自尊心; [or]yshx;
eject: [a]/iˈdʒekt/; [v](使)弹出;喷射;放逐; [or]yshx;
eke: [a]/iːk/; [v](极小幅度地)增加;放长;(艰难地)取得; [or]yshx;
elaborate: [a]/ɪˈlæbəreɪt/; [adj]精心设计的,精巧的;复杂的; [v]详细说明,详尽阐述; [vt]变得复杂; [or]yshx;
elastic: [a]/ɪˈlæstɪk/; [adj]有弹性的;可伸缩的,(系统或计划)灵活的;弹力材料制成的; [n]松紧带,橡皮圈; [or]yshx;
elated: [a]/iˈleɪtɪd/; [adj]得意洋洋的;振奋的; [or]yshx;
elbow: [a]/ˈelboʊ/; [n]手肘;衣服肘部; [v]用肘推,挤; [or]yshx;
elderly: [a]/ˈeldərli/; [adj]年老的,年长的;上年纪的人; [or]yshx;
electrical: [a]/ɪˈlektrɪkl/; [adj]有关电的;电气科学的; [or]yshx;
elegant: [a]/ˈelɪɡənt/; [adj]优美的,文雅的,漂亮雅致的,陈设讲究的; [or]yshx;
elementary: [a]/ˌelɪˈmentri/; [adj]基本的;初级的;非常简单的; [or]yshx;
elevate: [a]/ˈelɪveɪt/; [v]上升;提高;举起;提拔; [or]yshx;
elicit: [a]/iˈlɪsɪt/; [v]引出;诱出;探出; [or]yshx;
eligible: [a]/ˈelɪdʒəbl/; [adj]适合被选的,符合条件的;(尤指婚姻等)合适的,合意的; [or]yshx;
eliminate: [a]/ɪˈlɪmɪneɪt/; [v]消灭,铲除;消除,根除;(在比赛中)淘汰; [or]yshx;
elite: [a]/ɪˈliːt/; [n]精英; [adj]高级的; [or]yshx;
eloquent: [a]/ˈeləkwənt/; [adj]有口才的;雄辩的;演说动人的; [or]yshx;
elsewhere: [a]/ˌelsˈwer/; [adv]在别处,向别处; [or]yshx;
embargo: [a]/ɪmˈbɑːrɡoʊ/; [v]禁止出入港口;禁止或限制贸易;征用或扣押; [n]禁令;禁止;封港令; [or]yshx;
embark: [a]/ɪmˈbɑːrk/; [v]上船或飞机;开始,着手,从事; [or]yshx;
embarrass: [a]/ɪmˈbærəs/; [vt]使窘迫,使尴尬(尤指在社交场合);困窘,困扰; [or]yshx;
embassy: [a]/ˈembəsi/; [n]大使馆;大使馆全体人员; [or]yshx;
embed: [a]/ɪmˈbed/; [v]把.嵌入;使嵌入; [or]yshx;
embody: [a]/ɪmˈbɑːdi/; [v]包含;体现,象征; [or]yshx;
embrace: [a]/ɪmˈbreɪs/; [v]拥抱;包含;欣然接受,乐意采纳; [n]拥抱;接受;领会; [or]yshx;
emerge: [a]/iˈmɜːrdʒ/; [v]冲出,冒出;浮现;出现; [or]yshx;
emergency: [a]/iˈmɜːrdʒənsi/; [n]紧急情况;突发事件; [or]yshx;
emigrate: [a]/ˈemɪɡreɪt/; [v]移居国外(或外地); [or]yshx;
eminent: [a]/ˈemɪnənt/; [adj]显赫的;杰出的;有名的;(品质)优良的; [or]yshx;
emit: [a]/iˈmɪt/; [v]发表;散发;发射,发出; [or]yshx;
emotion: [a]/ɪˈmoʊʃn/; [n]感情;情绪;强烈的感情;激动; [or]yshx;
emphasize: [a]/ˈemfəsaɪz/; [v]强调;着重;使突出; [or]yshx;
employment: [a]/ɪmˈplɔɪmənt/; [n]职业;雇佣;就业;运用; [or]yshx;
enclose: [a]/ɪnˈkloʊz/; [v]围住;圈起;装入信封;附有; [or]yshx;
encounter: [a]/ɪnˈkaʊntər/; [v]邂逅,遭遇,偶遇; [n]偶然碰见,遭遇; [or]yshx;
encyclopedia: [a]/ɪnˌsaɪkləˈpiːdiə/; [n]百科全书; [or]yshx;
end up: [a]/end ʌp/; [phr]以.告终; [or]yshx;
endeavour: [a]/ɪnˈdevər/; [n]尝试; [v]努力; [or]yshx;
endorse: [a]/ɪnˈdɔːrs/; [v]赞同,认可;签注(文件); [or]yshx;
endurance: [a]/ɪnˈdʊrəns/; [n]忍耐力,耐性,耐用度; [or]yshx;
energetic: [a]/ˌenərˈdʒetɪk/; [adj]精力充沛的,充满活力的;有力的,积极的; [or]yshx;
enforce: [a]/ɪnˈfɔːrs/; [v]实施;执行;强制; [or]yshx;
engage: [a]/ɪnˈɡeɪdʒ/; [vt]吸引住(注意力,兴趣);雇,聘; [vi]使加入,使融入;订婚; [v](军队)交战;啮合; [or]yshx;
engrave: [a]/ɪnˈɡreɪv/; [v]雕刻;铭记; [or]yshx;
engross: [a]/ɪnˈɡroʊs/; [v]独占;正式誊写;使全神贯注于;用大字体书写; [or]yshx;
enhance: [a]/ɪnˈhæns/; [v]提高(强度,力量,数量等);增加,加强; [or]yshx;
enlighten: [a]/ɪnˈlaɪtn/; [v]启发,开导; [or]yshx;
enormous: [a]/ɪˈnɔːrməs/; [adj]极大的,极大量的;巨大的;庞大的; [or]yshx;
enrich: [a]/ɪnˈrɪtʃ/; [v]使丰富;使富裕; [or]yshx;
enrolment: [a]/ɪnˈroʊlmənt/; [n]登记,注册;入会,入学; [or]yshx;
ensemble: [a]/ɑːnˈsɑːmbl/; [n]合唱团,表演团体;总效果;全套服装;全套家具; [or]yshx;
ensue: [a]/ɪnˈsuː/; [v]跟着发生,接踵而来;因而产生; [or]yshx;
entangle: [a]/ɪnˈtæŋɡl/; [v]使纠缠,卷入; [or]yshx;
enterprise: [a]/ˈentərpraɪz/; [n]企业(或事业)单位,公司;事业;事业心; [or]yshx;
entertainment: [a]/ˌentərˈteɪnmənt/; [n]娱乐;招待,款待; [or]yshx;
enthusiastic: [a]/ɪnˌθuːziˈæstɪk/; [adj]狂热的,极感兴趣的,热情的; [or]yshx;
entitle: [a]/ɪnˈtaɪtl/; [v]给(书)题名;给予.权利; [or]yshx;
entrepreneur: [a]/ˌɑːntrəprəˈnɜːr/; [n]企业家,演出承包人; [or]yshx;
entry: [a]/ˈentri/; [n]入口处;登记;进入; [or]yshx;
envisage: [a]/ɪnˈvɪzɪdʒ/; [v]想象,设想; [or]yshx;
envy: [a]/ˈenvi/; [n]妒忌;妒忌的对象; [v]嫉妒,羡慕; [or]yshx;
enzyme: [a]/ˈenzaɪm/; [n]<生化>酶; [or]yshx;
ephemeral: [a]/ɪˈfemərəl/; [adj]短暂的,短命的; [n]生存极短时间的事物; [or]yshx;
epidemic: [a]/ˌepɪˈdemɪk/; [adj]流行性的,传染的; [n]流行病,传染病,(犯罪等的)盛行; [or]yshx;
episode: [a]/ˈepɪsoʊd/; [n]插曲,片断;连续剧的一集;一段经历; [or]yshx;
epoch: [a]/ˈepək/; [n]时期;新时代; [or]yshx;
equal: [a]/ˈiːkwəl/; [adj]相等的;平等的; [v]等于;比得上; [n]对手; [or]yshx;
equator: [a]/ɪˈkweɪtər/; [n]赤道; [or]yshx;
equitable: [a]/ˈekwɪtəbl/; [adj]公正的,公平的; [or]yshx;
equivalent: [a]/ɪˈkwɪvələnt/; [adj]相等的;等值的; [n]同义词;等价物; [or]yshx;
erase: [a]/ɪˈreɪs/; [v](计算机)擦除;抹去;擦掉; [or]yshx;
erect: [a]/ɪˈrekt/; [v]搭建,竖起;建造,建立; [adj]直立的,垂直的; [or]yshx;
erosion: [a]/ɪˈroʊʒn/; [n]侵蚀;腐蚀;磨损;削弱;减少; [or]yshx;
errand: [a]/ˈerənd/; [n]差使;差事;使命; [or]yshx;
erratic: [a]/ɪˈrætɪk/; [adj]古怪的;反复无常的,不稳定的; [or]yshx;
erroneous: [a]/ɪˈroʊniəs/; [adj]错误的; [or]yshx;
erupt: [a]/ɪˈrʌpt/; [v]爆发;(火山,喷泉,蒸汽等)喷发;使迸发;喷射出; [or]yshx;
escalate: [a]/ˈeskəleɪt/; [v]逐步升高,逐步增强,加剧恶化; [or]yshx;
escort: [a]/ˈeskɔːrt/; [n]护送者; [v]护送; [or]yshx;
essay: [a]/ˈeseɪ/; [n]文章;论文;尝试;随笔; [v]尝试; [or]yshx;
essential: [a]/ɪˈsenʃl/; [adj]必不可少的,必要的;本质的;重要的;基本的; [n]要素;必需品; [or]yshx;
establish: [a]/ɪˈstæblɪʃ/; [v]建立;确立;使安全;使成为; [or]yshx;
estate: [a]/ɪˈsteɪt/; [n]地产,(上有大片建筑物的)土地,住宅,财产,遗产; [or]yshx;
esteem: [a]/ɪˈstiːm/; [n]尊敬;尊重; [vt]尊敬;认为;考虑;估计; [or]yshx;
estimate: [a]/ˈestɪmət/; [v]估价,估计,评价; [n]估计,评价; [or]yshx;
eternal: [a]/ɪˈtɜːrnl/; [adj]永恒的,永不改变的; [or]yshx;
ethnic: [a]/ˈeθnɪk/; [adj]种族的,少数民族的; [n]少数民族成员;人种学; [or]yshx;
etiquette: [a]/ˈetɪket/; [n]礼仪; [or]yshx;
evacuate: [a]/ɪˈvækjueɪt/; [v]撤离,疏散,排清; [or]yshx;
evade: [a]/ɪˈveɪd/; [v]躲避,回避; [or]yshx;
evaluate: [a]/ɪˈvæljueɪt/; [v]评价;评估; [or]yshx;
evaporate: [a]/ɪˈvæpəreɪt/; [v]蒸发,失去水分;消失; [or]yshx;
everlasting: [a]/ˌevərˈlæstɪŋ/; [adj]永恒的,持久的;无止境的;耐用的; [or]yshx;
evict: [a]/ɪˈvɪkt/; [v]驱逐,逐出; [or]yshx;
evoke: [a]/ɪˈvoʊk/; [v]唤起;引起;使人想起; [or]yshx;
evolution: [a]/ˌevəˈluːʃn/; [n]进化,演变;发展; [or]yshx;
exacerbate: [a]/ɪɡˈzæsərbeɪt/; [v]加重;恶化;激怒; [or]yshx;
exaggerate: [a]/ɪɡˈzædʒəreɪt/; [vi]夸张; [vt]夸大,夸张;使扩大; [or]yshx;
exasperate: [a]/ɪɡˈzæspəreɪt/; [vt]激怒;加剧; [or]yshx;
excavate: [a]/ˈekskəveɪt/; [v]挖掘,挖出;挖(空),挖(洞); [or]yshx;
exceed: [a]/ɪkˈsiːd/; [v]超过;胜过;超出; [or]yshx;
excel: [a]/ɪkˈsel/; [vi]胜出; [vt]优于; [or]yshx;
exceptional: [a]/ɪkˈsepʃənl/; [adj]优越的,杰出的;异常的; [or]yshx;
excerpt: [a]/ˈeksɜːrpt/; [n]摘录,节选; [v]摘,选;引用; [or]yshx;
excess: [a]/ɪkˈses/; [adj]额外的,过量的,过度的,附加的; [n]超越,超过,过度; [or]yshx;
exchange: [a]/ɪksˈtʃeɪndʒ/; [v]交换,互换;交流;进行易货贸易; [n]交换;交易所;(货币的)兑换; [or]yshx;
exclaim: [a]/ɪkˈskleɪm/; [v]呼叫,惊叫; [or]yshx;
excrement: [a]/ˈekskrɪmənt/; [n]排泄物,粪便; [or]yshx;
excursion: [a]/ɪkˈskɜːrʒn/; [n]远足;短途旅行; [or]yshx;
execute: [a]/ˈeksɪkjuːt/; [v]处决;完成(动作);实行;执行(计划); [or]yshx;
exemplify: [a]/ɪɡˈzemplɪfaɪ/; [v]举例说明;例示,是..的典范; [or]yshx;
exert: [a]/ɪɡˈzɜːrt/; [v]尽(力),运用,发挥; [or]yshx;
exhaust: [a]/ɪɡˈzɔːst/; [v]使筋疲力尽;耗尽;详尽论述; [n]排气装置;废气; [or]yshx;
exhilarate: [a]/ɪɡˈzɪləreɪt/; [v]使高兴;使兴奋; [adj]使人高兴的,令人兴奋的; [or]yshx;
exhort: [a]/ɪɡˈzɔːrt/; [vt]敦促,劝告; [vi]规劝,劝告; [or]yshx;
exorbitant: [a]/ɪɡˈzɔːrbɪtənt/; [adj]要价过高的,过分的; [or]yshx;
exotic: [a]/ɪɡˈzɑːtɪk/; [adj]奇异的,珍奇的,来自异国的; [or]yshx;
expand: [a]/ɪkˈspænd/; [v]膨胀;扩大; [vt]详细展开; [or]yshx;
expedient: [a]/ɪkˈspiːdiənt/; [n]权宜之计,手段; [adj]有利的,方便的;权宜之计的; [or]yshx;
expedition: [a]/ˌekspəˈdɪʃn/; [n]远征队;探险;短途旅行;迅速; [or]yshx;
expel: [a]/ɪkˈspel/; [v]罚出,开除;排出;开除;驱逐; [or]yshx;
expend: [a]/ɪkˈspend/; [v]消费,用尽; [or]yshx;
expertise: [a]/ˌekspɜːrˈtiːz/; [n]专门知识,专门技能; [or]yshx;
expire: [a]/ɪkˈspaɪər/; [v]期满,(期限)终止;断气,死亡; [or]yshx;
explicit: [a]/ɪkˈsplɪsɪt/; [adj]充分表达清楚的,明确的;直率的,直截了当的;〔描绘性或暴力的语言或画面〕清晰露骨的; [or]yshx;
explode: [a]/ɪkˈsploʊd/; [v]爆炸;激增;爆发;使爆炸;驳倒; [or]yshx;
exploit: [a]/ɪkˈsplɔɪt/; [v]剥削,利用;开发,开拓; [n]辉煌功绩; [or]yshx;
explore: [a]/ɪkˈsplɔːr/; [v]探险,探索,尝试; [or]yshx;
export: [a]/ˈekspɔːrt/; [v]出口,输出; [n]输出,出口,输出品; [or]yshx;
expose: [a]/ɪkˈspoʊz/; [v]暴露;揭露;使遭受; [or]yshx;
expulsion: [a]/ɪkˈspʌlʃn/; [n]驱逐;开除; [or]yshx;
exquisite: [a]/ɪkˈskwɪzɪt/; [adj]精致的,精选的;细腻的;强烈的; [n]过分讲究穿戴的人; [or]yshx;
extend: [a]/ɪkˈstend/; [v]伸展,展开;延伸;涉及;扩展;提供;使.竭尽全力; [or]yshx;
exterior: [a]/ɪkˈstɪriər/; [n]外表;外貌,外观; [adj]外部的;外界的;位于外边的;外交上的; [or]yshx;
exterminate: [a]/ɪkˈstɜːrmɪneɪt/; [v]消灭,灭绝;根除; [or]yshx;
external: [a]/ɪkˈstɜːrnl/; [adj]外面的,外部的;外国的; [or]yshx;
extinct: [a]/ɪkˈstɪŋkt/; [adj]灭绝的;破灭了的,消亡了的; [or]yshx;
extinguish: [a]/ɪkˈstɪŋɡwɪʃ/; [v]熄灭,扑灭;根除,消灭; [or]yshx;
extort: [a]/ɪkˈstɔːrt/; [vt]敲诈,勒索; [or]yshx;
extra: [a]/ˈekstrə/; [adj]额外的,附加的;特优的; [adv]额外地; [n]附加物品;临时演员;(报纸)号外; [or]yshx;
extract: [a]/ɪkˈstrækt/; [v]取出;提取;摘录;设法得到;索取; [n]摘录;提出物; [or]yshx;
extravagant: [a]/ɪkˈstrævəɡənt/; [adj]奢侈的,无节制的; [or]yshx;
extreme: [a]/ɪkˈstriːm/; [adj]极端的;极远的;极限的;极度的;偏激的; [n]极端;极度(状态),最大程度; [or]yshx;
exuberant: [a]/ɪɡˈzuːbərənt/; [adj](植物)茂盛的,(人)充满活力的; [or]yshx;
fabric: [a]/ˈfæbrɪk/; [n]布料,织物;质地,结构; [or]yshx;
fabulous: [a]/ˈfæbjələs/; [adj]极好的;极妙的;极为巨大的;寓言中的;传说中的; [or]yshx;
facet: [a]/ˈfæsɪt/; [n](多面体的)面,小平面;琢面,侧面; [vt]在.上琢面; [or]yshx;
facilitate: [a]/fəˈsɪlɪteɪt/; [v]为他人提供方便;使便利; [vt]促进; [or]yshx;
facility: [a]/fəˈsɪləti/; [n]设施(车间等),设备;灵巧;才能,资质; [or]yshx;
factor: [a]/ˈfæktər/; [n]因素;<数>因子,商; [or]yshx;
faculty: [a]/ˈfæklti/; [n]教职工,全体教员;系;科;能力; [or]yshx;
fade: [a]/feɪd/; [vi]褪色,褪去;失去;逐渐消失; [vt]使褪色; [n]淡入,淡出; [adj]乏味的; [or]yshx;
faint: [a]/feɪnt/; [vi]昏倒,晕厥;变得模糊; [n]晕厥,昏倒; [adj]虚弱的;微弱的;眩晕的; [or]yshx;
faith: [a]/feɪθ/; [n]信任;信心;信仰; [int]实在,确实; [or]yshx;
fake: [a]/feɪk/; [adj]假的,伪造的; [n]骗子;假货,赝品; [v]假造,杜撰;伪造;冒充,假装;假装; [or]yshx;
fall back on: [a]/fɔl bæk ɔn/; [phr]求助于; [or]yshx;
fall behind: [a]/fɔl bɪˈhaɪnd/; [v]落后; [or]yshx;
fallacy: [a]/ˈfæləsi/; [n]谬论,谬见;错误,谬误; [or]yshx;
falter: [a]/ˈfɔːltər/; [v]蹒跚,摇摆;踌躇;畏缩; [n]踌躇;支吾;颤抖; [or]yshx;
fame: [a]/feɪm/; [n]名望,名声,声誉; [vt]使有名,使著名; [or]yshx;
familiar: [a]/fəˈmɪliər/; [adj]熟悉的;不拘礼节的;亲密的;随便的; [n]密友;常客;高级官吏的家属; [or]yshx;
famine: [a]/ˈfæmɪn/; [n]饥荒;严重的缺乏; [or]yshx;
fanatic: [a]/fəˈnætɪk/; [n]狂热者,盲信者; [adj]狂热的,入迷的,盲信的; [or]yshx;
fancy: [a]/ˈfænsi/; [adj]华丽装饰的,别致的,引人注目的;昂贵的,阔气的; [n]喜爱,幻想,想像力; [vt]想象,幻想;迷恋; [or]yshx;
fantastic: [a]/fænˈtæstɪk/; [adj]极好的;极大的;不真实的;荒诞离奇的;不可思议的; [n]〈古〉古怪的人; [or]yshx;
fare: [a]/fer/; [n]交通费;票价;食物;出租车乘客; [v](事情)进行得(好或坏); [or]yshx;
farewell: [a]/ˌferˈwel/; [adj]告别的; [n]再见;告别,离别; [or]yshx;
fascinate: [a]/ˈfæsɪneɪt/; [v]使着迷;使神魂颠倒;吸引注意; [or]yshx;
fastidious: [a]/fæˈstɪdiəs/; [adj]难讨好的,爱挑剔的; [or]yshx;
fatal: [a]/ˈfeɪtl/; [adj]致命的;毁灭性的;决定性的; [or]yshx;
fatigue: [a]/fəˈtiːɡ/; [n]疲乏,劳累; [or]yshx;
fatuous: [a]/ˈfætʃuəs/; [adj]愚昧而不自知的; [or]yshx;
fault: [a]/fɔːlt/; [n]过失,过错;弱点,缺点;故障,缺陷;(地质学)断层;发球失误; [v]责备,挑错; [or]yshx;
favor: [a]/ˈfeɪvər/; [n]偏爱,帮助,特权,赞成; [vt]偏爱,支持,利于,长得像; [or]yshx;
feasible: [a]/ˈfiːzəbl/; [adj]可行的,行得通的; [or]yshx;
feast: [a]/fiːst/; [n]盛宴;筵席;节日; [v]尽情地吃; [or]yshx;
feature: [a]/ˈfiːtʃər/; [n]面貌,相貌;特征,特点;特辑; [vt]使突出,以.为特色; [vi]起重要作用,作为主要角色; [or]yshx;
federation: [a]/ˌfedəˈreɪʃn/; [n]同盟,联盟,联邦; [or]yshx;
fee: [a]/fiː/; [n]费用,酬金; [or]yshx;
feeble: [a]/ˈfiːbl/; [adj]虚弱的; [or]yshx;
feedback: [a]/ˈfiːdbæk/; [n]反馈,反馈意见; [or]yshx;
feel for: [a]/fil fɔr/; [phr]同情; [or]yshx;
feel like: [a]/fil laɪk/; [v]想要; quant. 像要.似的;觉得;摸起来像.似的; [or]yshx;
fellowship: [a]/ˈfeloʊʃɪp/; [n]友谊;伙伴关系;交情;团体;奖学金; [or]yshx;
female: [a]/ˈfiːmeɪl/; [adj]女性的;雌性的; [n]女子;雌性动物;雌性植物; [or]yshx;
fend: [a]/fend/; [v](靠自己)照顾,照料;保护;力争; [or]yshx;
ferocious: [a]/fəˈroʊʃəs/; [adj]凶猛的;强烈的,严重的; [or]yshx;
ferry: [a]/ˈferi/; [n]渡船,渡轮;渡口; [v]运送;渡运(人,车或物等); [or]yshx;
fertile: [a]/ˈfɜːrtl/; [adj]肥沃的;多产的; [or]yshx;
fervent: [a]/ˈfɜːrvənt/; [adj]热烈的,满怀热情的;狂热的; [or]yshx;
fester: [a]/ˈfestər/; [v]溃烂;化脓;使..痛苦;使..恶化; [n]溃烂;脓疮,脓疱; [or]yshx;
fetch: [a]/fetʃ/; [v]取来;接来;使发出;售得;带来;接住; [n]拿来,取来;诡计;风浪区; [or]yshx;
fetter: [a]/ˈfetər/; [n]脚镣;束缚; [vt]给.上脚镣;束缚; [or]yshx;
fickle: [a]/ˈfɪkl/; [adj](在感情等方面)反复无常的,轻浮的,善变的; [or]yshx;
fidelity: [a]/fɪˈdeləti/; [n]忠诚;逼真度,保真度; [or]yshx;
fierce: [a]/fɪrs/; [adj]凶猛的;激烈的;猛烈的; [or]yshx;
file: [a]/faɪl/; [n]文件夹,档案,文件; [vi]把文件归档,提交(申请等); [vt]把(文件等)归档; [or]yshx;
filter: [a]/ˈfɪltər/; [n]过滤器,滤纸; [v]过滤,渗透; [or]yshx;
filth: [a]/fɪlθ/; [n]污秽图片;污物;对警察的冒犯言辞; [or]yshx;
finance: [a]/ˈfaɪnæns/; [v]资金供给,筹措资金; [n]金融,财政,资金; [or]yshx;
find fault with: [a]/faɪnd fɔlt wɪθ/; [phr]埋怨,挑剔; [or]yshx;
find one's bearings: [a]/faɪnd wʌnz ˈberɪŋs/; [v]指明方向;信心十足; [or]yshx;
finite: [a]/ˈfaɪnaɪt/; [adj]有限的;限定的; [or]yshx;
first and foremost: [a]/fɜrst ənd ˈfɔrˌmoʊst/; [adv]首先; [or]yshx;
fist: [a]/fɪst/; [n]拳头;笔迹; [vt]用拳头打;握成拳;紧握; [or]yshx;
fixture: [a]/ˈfɪkstʃər/; [n]固定装置;体育项目; [or]yshx;
flabby: [a]/ˈflæbi/; [adj](肌肉)松软的,意志薄弱的; [adv]肌肉松垂地,肥胖地; [n](肌肉等)不结实,松弛; [or]yshx;
flake: [a]/fleɪk/; [n]薄片; [v]使成薄片;剥落;雪片般落下; [or]yshx;
flame: [a]/fleɪm/; [v]脸变红;燃烧; [n]火焰;热情; [or]yshx;
flank: [a]/flæŋk/; [v]位于.的侧面; [n]肋,肋腹,侧翼; [or]yshx;
flap: [a]/flæp/; [n]慌乱(状态);拍打,挥动;(一端固定,可自由掀动的布或皮的) 垂悬平片; [v]拍打,挥动; [or]yshx;
flare: [a]/fler/; [v]燃烧(摇曳着);突然发怒; [n]照明弹;摇曳的火焰;闪光信号; [or]yshx;
flash: [a]/flæʃ/; [n]闪光;刹那; [v]闪光,掠过;发火花;快速发送; [adj]炫耀的;浮夸的;一闪而过的; [or]yshx;
flask: [a]/flæsk/; [n]烧瓶;长颈瓶;扁瓶; [or]yshx;
flatter: [a]/ˈflætər/; [v]阿谀,使高兴;(肖像等)胜过(真人真物);自鸣得意,自以为是; [or]yshx;
flaunt: [a]/flɔːnt/; [n]招摇;飘扬;藐视; [vi]炫耀;飘扬; [vt]炫耀; [or]yshx;
flavor: [a]/ˈfleɪvər/; [n]味,风味;调味品; [v]给..调味; [or]yshx;
flaw: [a]/flɔː/; [n]瑕疵;缺点; [v]使有缺陷;使不完美;有瑕疵; [or]yshx;
fleeting: [a]/ˈfliːtɪŋ/; [adj]短暂的,飞逝的; [or]yshx;
flesh: [a]/fleʃ/; [n]肉,肉体;果肉; [or]yshx;
flexible: [a]/ˈfleksəbl/; [adj]易曲的,柔软的,灵活的; [or]yshx;
flicker: [a]/ˈflɪkər/; [v]闪烁,摇曳;颤动;扑动翅膀;假装昏倒; [n]闪烁,闪光; [or]yshx;
fling: [a]/flɪŋ/; [v]掷,抛;猛烈地移动;投入; [n]尽情欢乐的一阵,一时的放纵; [or]yshx;
flip: [a]/flɪp/; [v]把.往上抛;掷;抽打;用指轻弹;空翻; [adj]轻率的,无礼的; [or]yshx;
flirt: [a]/flɜːrt/; [n]急扔;调情者; [vi]卖弄风情,调情;戏弄,不认真地对待;摆动; [vt]急速摆动,挥动; [or]yshx;
float: [a]/floʊt/; [vi]漂浮,飘浮,浮现;散布;漂泊; [vt]使漂浮;散布; [n]浮标,漂浮物,漂浮; [or]yshx;
flock: [a]/flɑːk/; [n](鸟兽)群;一群人;(对牧师而言的)教徒; [v]聚集,成群而行; [or]yshx;
flour: [a]/ˈflaʊər/; [n]面粉;粉状物质; [v]撒上粉; [or]yshx;
flourish: [a]/ˈflɜːrɪʃ/; [vi]繁荣,茂盛,兴旺; [vt]挥舞;夸耀; [n]兴旺;茂盛;炫耀;挥舞; [or]yshx;
flu: [a]/fluː/; [n]流感; [or]yshx;
fluctuate: [a]/ˈflʌktʃueɪt/; [v]波动;起伏;涨落; [or]yshx;
fluent: [a]/ˈfluːənt/; [adj]流畅的,(说话)流利的;顺畅的,流畅熟练的; [or]yshx;
fluid: [a]/ˈfluːɪd/; [n]流体,液体; [adj]流动的;易变的;流畅的; [or]yshx;
flutter: [a]/ˈflʌtər/; [n]激动不安,紧张; [v]飘动,飘扬;(鸟等)振翼,拍翅而飞; [vi](心脏等)快速跳动; [or]yshx;
flux: [a]/flʌks/; [n]流动,不断的变动; [or]yshx;
foam: [a]/foʊm/; [n]泡沫;泡沫体;泡沫塑料; [vi]吐白沫,起泡沫; [or]yshx;
focus: [a]/ˈfoʊkəs/; [n]焦点,聚焦;焦距;关注; [v]使聚焦,集中注意力; [or]yshx;
foil: [a]/fɔɪl/; [n]箔;锡箔纸;衬托; [v]挫败;使受挫折; [or]yshx;
for good (and all): [a]/fɔːr ɡʊd ənd ɔːl/; [adv]永久地,一劳永逸地; [or]yshx;
for one thing: [a]/fɔr wʌn θɪŋ/; [phr]首先;一则; [or]yshx;
for the most part: [a]/fɔr ðə moʊst pɑrt/; [phr]多半;通常;在极大程度上; [or]yshx;
for the sake of: [a]/fɔr ði sek ʌv/; prep. 为.起见;为了.的利益; [or]yshx;
forecast: [a]/ˈfɔːrkæst/; [n]预测;预报; [v]预报,预测; [or]yshx;
foremost: [a]/ˈfɔːrmoʊst/; [adj](位置或时间),最先的;首要的; [adv]首先,第一; [or]yshx;
forerunner: [a]/ˈfɔːrʌnər/; [n]先驱;祖先;前兆;预兆; [or]yshx;
foresee: [a]/fɔːrˈsiː/; [v]预知,预料,预测; [or]yshx;
forge: [a]/fɔːrdʒ/; [n]熔炉;锻工车间;铁匠店; [v]锻造;经锻炼而形成;伪造;推进,加强; [or]yshx;
forgive: [a]/fərˈɡɪv/; [v]原谅,饶恕,宽恕;(国家,银行等)免除(债务); [or]yshx;
format: [a]/ˈfɔːrmæt/; [n]版式;设计;格式; [v]设计一个版式;使格式化;设计.的版面; [or]yshx;
formidable: [a]/ˈfɔːrmɪdəbl/; [adj]令人畏惧的;可怕的;难以克服的;难应付的; [or]yshx;
formulate: [a]/ˈfɔːrmjuleɪt/; [v]构想出(计划,方法等);系统地阐述; [or]yshx;
fort: [a]/fɔːrt/; [n]堡垒,要塞; [or]yshx;
forte: [a]/fɔːrt/; [n]长处,特长; [adj]强音的;响的; [adv]响亮地; [or]yshx;
forthcoming: [a]/ˌfɔːrθˈkʌmɪŋ/; [adj]即将出现的,即将到来的;唾手可得的,可用的;乐于提供信息的; [or]yshx;
fortnight: [a]/ˈfɔːrtnaɪt/; [n]两星期,十四日; [or]yshx;
forum: [a]/ˈfɔːrəm/; [n]论坛;讨论会; [or]yshx;
fossil: [a]/ˈfɑːsl/; [n]化石; [adj]从地下发掘出来的;化石的;属于旧时代的;陈腐的; [or]yshx;
foul: [a]/faʊl/; [adj]难闻的,发臭的;糟透了的;污秽的;犯规的; [n]犯规; [vi]犯规; [vt]弄脏,使污秽;使纠缠; [or]yshx;
fountain: [a]/ˈfaʊntn/; [n]泉水,喷泉;源泉;人造喷泉装置; [or]yshx;
fraction: [a]/ˈfrækʃn/; [n]部分,片断,碎片;分数; [or]yshx;
fracture: [a]/ˈfræktʃər/; [n]骨折;折断;裂口; [v]使折断;使骨折; [or]yshx;
fragment: [a]/ˈfræɡmənt/; [n]片段;碎片; [v]使成碎片; [or]yshx;
fragrance: [a]/ˈfreɪɡrəns/; [n]香水;香味;芳香; [or]yshx;
frail: [a]/freɪl/; [adj]脆弱的,不坚实的; [n]少妇;灯心草篓;灯心草篓的容量; [or]yshx;
framework: [a]/ˈfreɪmwɜːrk/; [n]构架,框架,结构;体制,体系; [or]yshx;
frantic: [a]/ˈfræntɪk/; [adj]疯狂的;狂乱的;慌乱的; [or]yshx;
freak: [a]/friːk/; [n]怪人,怪物,奇事; [adj]反常的,怪诞的; [vt]使强烈反应(震惊;畏惧); [vi]在药物影响下变得异乎寻常; [or]yshx;
freight: [a]/freɪt/; [n]货运;货物;运费; [v]运送; [or]yshx;
fret: [a]/fret/; [v]使烦恼,使焦急;使腐蚀;使磨损; [n](斑卓琴,吉他,曼陀林琴等弦乐器指板上定音的)档;侵蚀; [or]yshx;
friction: [a]/ˈfrɪkʃn/; [n]摩擦,摩擦力;争执,冲突; [or]yshx;
from the outset: [a]/frɒm ðə ˈaʊtˌset/; [adv]从一开始; [or]yshx;
frontier: [a]/frʌnˈtɪr/; [n]边境,边疆;新领域;<美>边远地区,边界地区; [adj]开拓的; [or]yshx;
frost: [a]/frɔːst/; [n]霜冻,严寒; [v]结霜,冻死; [or]yshx;
frown: [a]/fraʊn/; [n]皱眉;不悦; [v]皱眉;不赞成;使哑口无言; [or]yshx;
frugal: [a]/ˈfruːɡl/; [adj]节俭的,俭朴的;不昂贵的,廉价的,花钱少的,不充足的; [or]yshx;
fruition: [a]/fruˈɪʃn/; [n]享有;最后完成,实现,取得成果; [or]yshx;
frustrate: [a]/ˈfrʌstreɪt/; [v]使灰心;挫败;阻挠; [or]yshx;
fry: [a]/fraɪ/; [v]油煎;油炸; [n]鱼苗,鱼秧;弗赖伊(姓氏);油炸食物;(口语)烦恼,愤激; [adj]油炸的,油煎的(fried); [or]yshx;
fulfill: [a]/fʊl'fɪl/; [v]履行,实现,完成;满足(愿望,要求等),使满意; [or]yshx;
function: [a]/ˈfʌŋkʃn/; [n]功能,作用;函数;应变量;盛大聚会;职务,职责; [v]起作用;正常运转; [or]yshx;
fundamental: [a]/ˌfʌndəˈmentl/; [adj]基本的,根本的;重要的;基础的; [n]基本原理;基本原则; [or]yshx;
funeral: [a]/ˈfjuːnərəl/; [n]丧葬,葬礼; [or]yshx;
funnel: [a]/ˈfʌnl/; [n]漏斗;烟囱; [v]汇集;通过漏斗等;(使)成漏斗形; [or]yshx;
furious: [a]/ˈfjʊriəs/; [adj]狂怒的;愤怒的;猛烈的; [or]yshx;
furnace: [a]/ˈfɜːrnɪs/; [n]炉子,熔炉; [or]yshx;
furnish: [a]/ˈfɜːrnɪʃ/; [v](用家具等)布置(房间,公寓等);供应,提供; [or]yshx;
fuse: [a]/fjuːz/; [n]导火线,引信,保险丝; [v](使)因保险丝熔断而中断工作,熔合,合并; [or]yshx;
fuss: [a]/fʌs/; [n]大惊小怪,小题大做; [v](为小事)烦恼,过于忧虑; [or]yshx;
gaily: [a]/ˈɡeɪli/; [adv]快乐地,愉快地;装饰华丽地; [or]yshx;
galaxy: [a]/ˈɡæləksi/; [n]星系; [or]yshx;
gale: [a]/ɡeɪl/; [n]狂风,一阵(笑声); [or]yshx;
gallery: [a]/ˈɡæləri/; [n]美术馆,画廊;(大厅的)旁听席,边座; [or]yshx;
gamble: [a]/ˈɡæmbl/; [v]赌博;投机;打赌; [n]赌博;冒险; [vt]赌输; [or]yshx;
gang: [a]/ɡæŋ/; [n]以某种方式结合的一群人;帮派; [v]成帮结伙;使集合成一群;使成套排列; [or]yshx;
gape: [a]/ɡeɪp/; [n]裂口,张嘴,打哈欠; [v]目瞪口呆地凝视,打哈欠,张开,裂开; [or]yshx;
garbage: [a]/ˈɡɑːrbɪdʒ/; [n]垃圾桶;垃圾; [or]yshx;
garment: [a]/ˈɡɑːrmənt/; [n]服装; [vt]给 ... 披上衣服;覆上...; [or]yshx;
gasp: [a]/ɡæsp/; [v]喘气;渴望;气喘吁吁地说出; [n]喘气; [or]yshx;
gaudy: [a]/ˈɡɔːdi/; [n]华丽而俗气的廉价饰物; [adj](服饰,装饰,文风等)华丽而俗气的;浮华的;过分显眼的; [or]yshx;
gauge: [a]/ɡeɪdʒ/; [n]测量仪;尺度,标准; [v]估计,判断;计量; [or]yshx;
gaunt: [a]/ɡɔːnt/; [adj]憔悴的,瘦削的; [n]憔悴,荒凉; [or]yshx;
gear: [a]/ɡɪr/; [n]档位;齿轮;装备;衣物; [v]使适合; [or]yshx;
generate: [a]/ˈdʒenəreɪt/; [v]产生(热,电等能量),创造; [or]yshx;
generic: [a]/dʒəˈnerɪk/; [n]无注册商标产品;通名; [adj]一般的;非商标的;属的,类的; [or]yshx;
generous: [a]/ˈdʒenərəs/; [adj]慷慨的;充裕的,宽厚的;肥沃的; [or]yshx;
genetic: [a]/dʒəˈnetɪk/; [adj]遗传的,起源的; [or]yshx;
genius: [a]/ˈdʒiːniəs/; [n]天才;天资,天赋;才华; [or]yshx;
gentle: [a]/ˈdʒentl/; [adj]温和的,轻柔的,文雅的; [or]yshx;
genuine: [a]/ˈdʒenjuɪn/; [adj]真正的;真的;真诚的; [or]yshx;
geology: [a]/dʒiˈɑːlədʒi/; [n]地质学,(某一地区的)地质; [or]yshx;
geometry: [a]/dʒiˈɑːmətri/; [n]几何学;几何形状; [or]yshx;
germ: [a]/dʒɜːrm/; [n]微生物,细菌;(某事的)发端,萌芽; [v]萌芽;发生; [or]yshx;
gesture: [a]/ˈdʒestʃər/; [n]手势,表情;姿态; [v]做手势,用动作示意; [vt]用手势表达; [or]yshx;
get along: [a]/ɡet əˈlɔŋ/; [v]与.和睦相处;进展; [or]yshx;
get at sb.(sth.): [a]/ɡet æt ˈsʌmbədi ˈsʌmθɪŋ/; [v]到达,得到;接近; [or]yshx;
get away: [a]/ɡet, əˈweɪ/; [phr]离开,逃脱; [or]yshx;
get down to business: [a]/ɡet daʊn tu ˈbɪznəs/; [phr]着手干正事; [or]yshx;
get down to: [a]/ɡet daʊn tu/; [phr]开始认真对待;着手处理; [or]yshx;
get into: [a]/ɡet ˈɪntu/; [phr]穿上;陷入,染上(习惯);对.有兴趣; [or]yshx;
get nowhere: [a]/ɡet ˈnoʊˌhwer/; [phr](使)无进展;行不通; [or]yshx;
get off: [a]/ɡet ɑf/; [phr]动身;免于受罚;从..下来;把手拿开; [or]yshx;
get on: [a]/ɡet ɔːn/; [phr]上车(飞机,船),进展,使前进; [or]yshx;
get out: [a]/ɡet aʊt/; [phr]出去;逃脱;泄露; [or]yshx;
get over: [a]/ɡet ˈoʊvər/; [phr]克服;恢复;熬过;原谅; [or]yshx;
get round sth.: [a]/ɡet raʊnd ˈsʌmθɪŋ/; [v]规避(法律),避开; [or]yshx;
get round to doing sth: [a]/ɡet raʊnd tu ˈduːɪŋ ˈsʌmθɪŋ/; [phr]抽出时间做; [or]yshx;
get somewhere: [a]/ɡet ˈsʌmwer/; [v]有所成就; [or]yshx;
get sth. down: [a]/ɡet ˈsʌmθɪŋ daʊn/; [v]吞下;写下; [or]yshx;
get the better of: [a]/ɡet ðə ˈbetər ɑv/; [phr]打败; [or]yshx;
get through (sth.): [a]/ɡet θruː ˈsʌmθɪŋ/; [v]通过(考试等); [or]yshx;
get through: [a]/ɡet θru/; [v]完成;穿过;(成功)渡过(困难时期);打通(电话); [or]yshx;
ghastly: [a]/ˈɡæstli/; [adj]苍白的,可怕的,令人不快的; [adv]恐怖地,惨白地; [or]yshx;
gigantic: [a]/dʒaɪˈɡæntɪk/; [adj]巨大的; [or]yshx;
giggle: [a]/ˈɡɪɡl/; [v]咯咯地笑,傻笑; [n]咯咯地笑,傻笑; [or]yshx;
gist: [a]/dʒɪst/; [n]主旨,要点;依据; [or]yshx;
give (sth.) off: [a]/ɡɪv ˈsʌmθɪŋ ɑːf/; [v]发出(烟,气); [or]yshx;
give in (to sb.): [a]/ɡɪv ɪn tu ˈsʌmbədi/; [v]屈服,投降; [or]yshx;
give oneself (put on) airs: [a]/ɡɪv wʌnˈself pʊt ɔːn erz/; [v]装腔作势; [or]yshx;
give oneself up: [a]/ɡɪv wʌnˈself ʌp/; [phr]自首;投降; [or]yshx;
give out: [a]/ɡɪv aʊt/; [v]停止;耗尽;分发;产生;发出; [or]yshx;
give sth. up: [a]/ɡɪv ˈsʌmθɪŋ ʌp/; [v]放弃;戒烟; [or]yshx;
give way (to sb.): [a]/ɡɪv weɪ tu ˈsʌmbədi/; [v]让步,屈服; [or]yshx;
give way (to sth.): [a]/ɡɪv weɪ tuː ˈsʌmθɪŋ/; [phr]给.让路;为.所代替; [or]yshx;
glacier: [a]/ˈɡleɪʃər/; [n]冰川,冰河; [or]yshx;
glamour: [a]/ˈɡlæmər/; [n]魅力;诱惑力; [or]yshx;
glare: [a]/ɡler/; [v]怒目而视;发出强光; [n]眩目的光;瞪眼; [or]yshx;
gleam: [a]/ɡliːm/; [vi]闪烁;使发出微光; [n]闪光;微光;闪现; [or]yshx;
glide: [a]/ɡlaɪd/; [v]滑翔;滑动; [n]滑音,延音;滑行; [or]yshx;
glimmer: [a]/ˈɡlɪmər/; [n]微光;闪光;少许; [v]闪烁;发微光; [or]yshx;
glimpse: [a]/ɡlɪmps/; [n]一瞥;初步的感受; [v]一瞥,瞥见; [or]yshx;
glitter: [a]/ˈɡlɪtər/; [v]闪闪发光,闪耀; [n]灿烂的光辉,闪光; [or]yshx;
global: [a]/ˈɡloʊbl/; [adj]全球的;全面的; [or]yshx;
gloomy: [a]/ˈɡluːmi/; [adj]愁容满面的,阴暗的,没有希望的; [or]yshx;
glorious: [a]/ˈɡlɔːriəs/; [adj]辉煌的,壮丽的;光荣的,荣耀的; [or]yshx;
gloss: [a]/ɡlɑːs/; [n]光泽;假象;唇膏; [vt]使有光彩;掩盖; [or]yshx;
glossary: [a]/ˈɡlɑːsəri/; [n]词汇表,术语汇编; [or]yshx;
glow: [a]/ɡloʊ/; [n]光辉,红光,热情; [v]发光,发红光,发热; [or]yshx;
glue: [a]/ɡluː/; [n]胶水; [v]用胶粘; [or]yshx;
go (very) far: [a]/ɡoʊ ˈveri fɑːr/; [phr]成功;扬名;大有前途; [or]yshx;
go about: [a]/ɡoʊ əˈbaʊt/; [v]着手做;四处走动;传开;从事; [or]yshx;
go after sb. (sth.): [a]/ɡoʊ ˈæftər ˈsʌmbədi ˈsʌmθɪŋ/; [phr]追求,追逐; [or]yshx;
go back: [a]/ɡoʊ bæk/; [phr]回去;追溯; [or]yshx;
go by: [a]/ɡoʊ baɪ/; [phr]走过,过去;(时间)流逝; [or]yshx;
go down: [a]/ɡoʊ daʊn/; [phr]下降;平静下来;被接受; [or]yshx;
go for sb.: [a]/ɡoʊ fɔːr ˈsʌmbədi/; [v]去请(人);袭击; [or]yshx;
go into: [a]/ɡoʊ ˈɪntu/; [phr]进入;加入;变得;探究; [or]yshx;
go off: [a]/ɡoʊ ɑf/; [phr]爆炸;进行;变质; [or]yshx;
go on about sth.: [a]/ɡoʊ ɔːn əˈbaʊt ˈsʌmθɪŋ/; [v]喋喋不休; [or]yshx;
go out: [a]/ɡoʊ aʊt/; [v]外出,参加社交活动,熄灭,(衣服式样)过时,出去,交往; [or]yshx;
go over: [a]/ɡoʊ ˈoʊvər/; [v]仔细检查; [phr]复习,重温; [or]yshx;
go round: [a]/ɡoʊ raʊnd/; [v]足够分配;绕道走,到处走动; [or]yshx;
go through (sth.): [a]/ɡoʊ θruː ˈsʌmθɪŋ/; [v]仔细讨论;搜查;经受;用光(钱);穿过; [or]yshx;
go up: [a]/ɡoʊ ʌp/; [phr]上升;被建立;被炸毁; [or]yshx;
go with sb. (sth.): [a]/ɡoʊ wɪθ ˈsʌmbədi ˈsʌmθɪŋ/; [phr]陪伴.去;与.相配; [or]yshx;
go without (sth.): [a]/ɡoʊ wɪˈðaʊt ˈsʌmθɪŋ/; [v]在缺少.的情况下勉强对付; [or]yshx;
go without saying: [a]/ɡoʊ wɪðˈaʊt ˈseɪɪŋ/; [v]不言而喻,理所当然; [or]yshx;
goad: [a]/ɡoʊd/; [vt]驱赶;刺激;鼓励; [n](赶牛用的)刺棒; [or]yshx;
goal: [a]/ɡoʊl/; [n]目标;球门;(进球)得分; [or]yshx;
gorgeous: [a]/ˈɡɔːrdʒəs/; [adj]绚丽的;极好的;令人愉快的; [or]yshx;
gossip: [a]/ˈɡɑːsɪp/; [n]流言蜚语,爱传流言的人; [v]闲聊,传播流言蜚语; [or]yshx;
gown: [a]/ɡaʊn/; [n]女礼服;女裙服;长袍; [or]yshx;
grab: [a]/ɡræb/; [v]攫取,抓取,掠夺;赶紧做;吸引; [n]抓取,非法所得; [or]yshx;
gracious: [a]/ˈɡreɪʃəs/; [adj]和善的;亲切的;优美的;奢华的; [or]yshx;
gradual: [a]/ˈɡrædʒuəl/; [adj]逐渐的,逐步的,平缓的; [or]yshx;
granary: [a]/ˈɡrænəri/; [n]谷仓,粮仓;产粮区;主要来源; [or]yshx;
grand: [a]/ɡrænd/; [adj]壮丽的,宏伟的,重大的;傲慢的;极好的; [n]一千美元;大钢琴; [or]yshx;
grant: [a]/ɡrænt/; [v]给予,许可,授予;承认; [n]许可;拨款,补助金; [or]yshx;
granular: [a]/ˈɡrænjələr/; [adj]粒状的,含颗粒的; [or]yshx;
graphic: [a]/ˈɡræfɪk/; [adj]形象的;图表的; [n]图,图表; [or]yshx;
grate: [a]/ɡreɪt/; [n]壁炉;格栅; [v]磨碎,使人烦燥; [or]yshx;
gratitude: [a]/ˈɡrætɪtuːd/; [n]感激,感谢; [or]yshx;
gratuity: [a]/ɡrəˈtuːəti/; [n]赏钱,小费; [or]yshx;
grave: [a]/ɡreɪv/; [adj]严重的;严肃的,庄重的; [n]墓; [adv]沉重地,庄重地;极慢地; [vt]雕刻;铭记; [or]yshx;
gravel: [a]/ˈɡrævl/; [n]沙砾,小石,砾石; [adj]粗重而沙哑的,刺耳的; [vt]用砾石铺;使困惑; [or]yshx;
graze: [a]/ɡreɪz/; [v](牲畜)吃草;放牧;擦过; [n]擦,擦伤; [or]yshx;
grease: [a]/ɡriːs/; [n]油脂;动物脂;润滑脂; [v]抹油;使润滑; [or]yshx;
greedy: [a]/ˈɡriːdi/; [adj]贪婪的,贪心的,贪吃的; [or]yshx;
grid: [a]/ɡrɪd/; [n]格子,地图坐标; [or]yshx;
grieve: [a]/ɡriːv/; [v]伤心,悲痛; [vi]使悲伤,使伤心; [or]yshx;
grill: [a]/ɡrɪl/; [n]烤架; [v]烤;拷问; [or]yshx;
grim: [a]/ɡrɪm/; [adj]严酷的,无情的;令人沮丧的,令人失望的;讨厌的,糟糕的; [or]yshx;
grin: [a]/ɡrɪn/; [v]露齿而笑,咧嘴一笑; [n]龇牙笑; [or]yshx;
grind: [a]/ɡraɪnd/; [v]磨碎,碾碎;折磨;摩擦得吱吱作响; [n]苦差事,苦活儿;磨; [or]yshx;
grip: [a]/ɡrɪp/; [v]握紧,抓牢; [n]紧握,握力; [or]yshx;
grit: [a]/ɡrɪt/; [n]沙粒;决心,勇气; [v]研磨;在.上铺砂砾;下定决心,咬紧牙关; [or]yshx;
groan: [a]/ɡroʊn/; [v]呻吟;抱怨; [n]呻吟; [or]yshx;
grope: [a]/ɡroʊp/; [v]摸索,探索,动手动脚; [or]yshx;
gross: [a]/ɡroʊs/; [adj]总的,毛重的;恶心的;粗鲁的; [n]总量,总额; [adv]总共地; [vt]总共赚得; [or]yshx;
growl: [a]/ɡraʊl/; [v](动物)咆哮,吼叫; [n]咆哮声,怨言,打嗝声; [or]yshx;
grudge: [a]/ɡrʌdʒ/; [n]怨恨;妒嫉;恶意;忿忿不平; [v]怨恨;嫉妒;不情愿做; [or]yshx;
grumble: [a]/ˈɡrʌmbl/; [v]埋怨;发牢骚;咕哝; [n]隆隆响声;抱怨,怨言; [or]yshx;
guarantee: [a]/ˌɡærənˈtiː/; [v]保证;担保;提供保修; [n]保证;担保;保修单;保证金; [or]yshx;
guardian: [a]/ˈɡɑːrdiən/; [n]保护人;监护人; [or]yshx;
guideline: [a]/ˈɡaɪdlaɪn/; [n]指导路线,准则; [or]yshx;
gush: [a]/ɡʌʃ/; [v]涌出;滔滔不绝地说,洋洋洒洒地写; [n]迸发; [or]yshx;
gust: [a]/ɡʌst/; [n]阵风,(感情的)迸发,汹涌; [v]猛吹; [or]yshx;
gymnasium: [a]/dʒɪmˈneɪziəm/; [n]体育馆,健身房; [or]yshx;
had better: [a]/hæd ˈbetər/; [v]最好还是; [or]yshx;
hail: [a]/heɪl/; [n]冰雹;一阵; [v]下冰雹;歌颂; [or]yshx;
halt: [a]/hɔːlt/; [v]停止,止步,暂停; [n]停住,终止; [or]yshx;
hamper: [a]/ˈhæmpər/; [v]阻碍,妨碍,牵制; [n](有盖的)大篮子; [or]yshx;
hand sth. down to sb.: [a]/hænd ˈsʌmθɪŋ daʊn tu ˈsʌmbədi/; [v](作为传统)传下,传给; [or]yshx;
hand sth. out: [a]/hænd ˈsʌmθɪŋ aʊt/; [phr]分发; [or]yshx;
hand sth. over to sb.: [a]/hænd ˈsʌmθɪŋ ˈoʊvər tu ˈsʌmbədi/; [phr]移交; [or]yshx;
handbook: [a]/ˈhændbʊk/; [n]手册;指南; [or]yshx;
handicap: [a]/ˈhændikæp/; [n]障碍,阻碍,不利条件,不利因素;残疾,缺陷,生理缺陷;<高尔夫>给弱者增加的杆数(按击球次数计数,并随参赛者的进步而减少); [v]使不利,妨碍; [or]yshx;
hang on: [a]/hæŋ ɔn/; [phr]坚持下去;不挂断;稍等;握住不放; [or]yshx;
hang up: [a]/hæŋ ʌp/; [phr]挂断电话; [or]yshx;
haphazard: [a]/hæpˈhæzərd/; [adj]偶然的;随意的;凑合的;胡乱的; [or]yshx;
harass: [a]/həˈræs/; [v]使困扰,使烦恼,反复袭击; [or]yshx;
harbor: [a]/'hɑːbə/; [n]海港;港口;避风港; [v]庇护;藏匿;心怀(怨恨等); [or]yshx;
hard and fast: [a]/hɑrd ənd fæst/; [phr](规则等)严格的,不容改变的; [or]yshx;
hardware: [a]/ˈhɑːrdwer/; [n]五金器具,(总称)金属器材;硬件; [or]yshx;
harmony: [a]/ˈhɑːrməni/; [n]和谐;和声;和睦;协调; [or]yshx;
harness: [a]/ˈhɑːrnɪs/; [n]挽具,马具,降落伞背带; [v]上挽具;治理(河流等);利用; [or]yshx;
harsh: [a]/hɑːrʃ/; [adj]严厉的;刺耳的;条件艰苦的; [or]yshx;
hasty: [a]/ˈheɪsti/; [adj]匆忙的;仓促完成的;草率的; [or]yshx;
hatch: [a]/hætʃ/; [n]船舱盖; [v]孵出,孵;策划; [or]yshx;
haul: [a]/hɔːl/; [n]一次获得;拖运路程; [v]硬拖,硬拉,用力拖;拖,拉,拽;强迫(某人)去某处; [or]yshx;
haunt: [a]/hɔːnt/; [v]常去,萦绕于..;(鬼,魂)常出没于;(思想)萦绕; [n]常去的地方; [or]yshx;
have (get) the upper hand: [a]/hæv ɡet ði ˈʌpər hænd/; [v]取得优势,占上风; [or]yshx;
have one's hands full: [a]/hæv wʌnz hændz fʊl/; [phr]忙得不可开交;手头事情应接不暇;离不开手; [or]yshx;
have one's say: [a]/hæv wʌnz seɪ/; [phr]利用机会发表意见; [or]yshx;
have the makings of: [a]/həv ðə ˈmeɪkɪŋz ɑv/; [v]具有成为.所需要的素质; [or]yshx;
have to do with: [a]/hæv tə dʊ wɪð/; [v]与.有关; [or]yshx;
haven: [a]/ˈheɪvn/; [n]港湾;避难所; [vt]为.提供庇护所; [or]yshx;
havoc: [a]/ˈhævək/; [n](天灾,战争等造成的)大破坏,大毁灭; [vi]损毁; [vt]严重破坏; [or]yshx;
hawk: [a]/hɔːk/; [n]鹰;鹰派成员(以强硬态度或手段维护国家民族利益的个人,团体或势力); [v]叫卖,兜售;散播; [or]yshx;
hazardous: [a]/ˈhæzərdəs/; [adj]有危险的;碰运气的; [adv]冒险地,有危险地; [n]冒险,危险; [or]yshx;
headstrong: [a]/ˈhedstrɔːŋ/; [adj]任性的;顽固的; [or]yshx;
heal: [a]/hiːl/; [v]治愈,治疗;痊愈;恢复; [or]yshx;
heap: [a]/hiːp/; [n](一)堆;大量; [v]堆;堆积; [or]yshx;
hearing: [a]/ˈhɪrɪŋ/; [n]听觉;听距;听证会;申辩的机会; [v]听到; [or]yshx;
heave: [a]/hiːv/; [v]用力举起;掷扔;发出叹息;恶心; [n]举起,升降; [or]yshx;
hectic: [a]/ˈhektɪk/; [adj]紧张的,忙碌的;患肺病的;(因患肺病等)发烧的,有病态潮红的;脸上发红,发热的,兴奋的,狂热的,肺病的; [or]yshx;
hedge: [a]/hedʒ/; [v]防范,规避;避免直接答复,避免直接回答;围住;用树篱围起; [n]篱笆,树篱;保障; [or]yshx;
heighten: [a]/ˈhaɪtn/; [v]加强,增加,提高; [or]yshx;
heir: [a]/er/; [n]继承人;后继者; [or]yshx;
helicopter: [a]/ˈhelɪkɑːptər/; [n]直升机; [v]用直升飞机载送,乘直升机; [or]yshx;
hell: [a]/hel/; [n]地狱,阴间;苦境,极大的痛苦; [or]yshx;
hemisphere: [a]/ˈhemɪsfɪr/; [n](地球的)半球;大脑半球; [or]yshx;
herb: [a]/ɜːrb/; [n]草本植物;药草; [or]yshx;
herd: [a]/hɜːrd/; [n]兽群,牧群; [v]放牧,群集; [or]yshx;
hereditary: [a]/həˈredɪteri/; [adj]世袭的,遗传的; [or]yshx;
heritage: [a]/ˈherɪtɪdʒ/; [n]遗产;继承物;传统;文化遗产; [or]yshx;
hierarchy: [a]/ˈhaɪərɑːrki/; [n]阶层,等级制度; [or]yshx;
highlight: [a]/ˈhaɪlaɪt/; [vt]使突出,强调,高亮; [n]最精彩的部分,最重要的事件; [or]yshx;
hijack: [a]/ˈhaɪdʒæk/; [v]劫持,劫机,拦路抢劫;操纵(会议等,以推销自己的意图); [n]劫持;敲诈;威逼; [or]yshx;
hike: [a]/haɪk/; [n]远足,徒步旅行;(数量,价格等)增加,上升; [v]作长途徒步旅行;使高涨,提高(价格); [or]yshx;
hilarious: [a]/hɪˈleriəs/; [adj]有趣的;令人捧腹的;滑稽的;欢闹的; [or]yshx;
hinder: [a]/ˈhɪndər/; [v]阻碍,妨碍; [adj]后面的,后方的; [or]yshx;
hinge: [a]/hɪndʒ/; [n]铰链; [v]靠铰链转动; [or]yshx;
hint: [a]/hɪnt/; [v]作暗示;透露; [n]暗示,示意;建议; [or]yshx;
historic: [a]/hɪˈstɔːrɪk/; [adj]历史上著名的,有历史意义的;历史性的; [or]yshx;
hit it off (with sb./together): [a]/hɪt ɪt ɑːf wɪθ ˈsʌmbədi təˈɡeðər/; [v]一见如故,合得来; [or]yshx;
hit on (upon): [a]/hɪt ɔːn əˈpɔːn/; [v]碰巧打到,偶然发现; [or]yshx;
hitchhike: [a]/ˈhɪtʃhaɪk/; [v]免费搭乘他人便车; [n]搭便车(旅行); [or]yshx;
hoist: [a]/hɔɪst/; [v]升起,吊起;向上推; [n]起重机;举起; [or]yshx;
hold back: [a]/hoʊld bæk/; [phr]阻挡,抑制,控制; [v]隐瞒; [or]yshx;
hold on: [a]/həʊld ɒn/; [phr]坚持;不挂断;稍等;紧紧抓住; [or]yshx;
hold one's ground: [a]/hold wʌnz ɡraʊnd/; [phr]坚持立场; [or]yshx;
hold onto: [a]/hoʊld ˈɑntə/; [v]抓住,不放;不卖掉; [or]yshx;
hold out (against): [a]/hoʊld aʊt əˈɡeɪnst/; [phr]坚持(反抗),顶住; [or]yshx;
hold the line: [a]/hoʊld ðə laɪn/; [phr]坚持下去;不挂断电话; [or]yshx;
holocaust: [a]/ˈhɑːləkɔːst/; [n]大屠杀,浩劫; [or]yshx;
homestay: [a]/ˈhoʊmsteɪ/; [n]在当地居民家中居住的时期;寄宿家庭; [or]yshx;
horizon: [a]/həˈraɪzn/; [n]地平线;眼界,见识; [or]yshx;
horrible: [a]/ˈhɔːrəbl/; [adj]可怕的,恐怖的;讨厌的,糟糕的;粗鲁的,不友好的; [or]yshx;
horticulture: [a]/ˈhɔːrtɪkʌltʃər/; [n]园艺;园艺学; [or]yshx;
hose: [a]/hoʊz/; [n]输水软管; [v]用水管冲洗(汽车等); [or]yshx;
hospitality: [a]/ˌhɑːspɪˈtæləti/; [n]好客;款待; [or]yshx;
host: [a]/hoʊst/; [n]东道主,主持人;大量; [v]主持,主办; [or]yshx;
hostage: [a]/ˈhɑːstɪdʒ/; [n]人质; [or]yshx;
hostile: [a]/ˈhɑːstl/; [adj]敌对的,敌方的;怀敌意的; [or]yshx;
hound: [a]/haʊnd/; [n]猎犬; [v]追逼;烦扰;纠缠; [or]yshx;
hover: [a]/ˈhʌvər/; [v](鸟,直升机)盘旋,翱翔;(人)逗留在附近,徘徊; [or]yshx;
howl: [a]/haʊl/; [v](狼,狗等)嗥叫;(风等)呼啸;(因愤怒,痛苦等)吼叫,哀号; [n]嚎叫,哀号; [or]yshx;
hubbub: [a]/ˈhʌbʌb/; [n]嘈杂,喧哗; [or]yshx;
hug: [a]/hʌɡ/; [v]紧抱;拥抱; [n]拥抱; [or]yshx;
hum: [a]/hʌm/; [v]发出嗡嗡声,哼(歌曲); [n]轰鸣声,嗡嗡营营声; [or]yshx;
humanity: [a]/hjuːˈmænəti/; [n]人性;人类;人道;慈爱;(复)人文学科; [or]yshx;
humble: [a]/ˈhʌmbl/; [adj]卑微的;(级别或地位)低下的,简陋的;谦逊的; [v]使⋯谦逊,使⋯卑下;轻松打败(尤指强大的对手); [or]yshx;
humdrum: [a]/ˈhʌmdrʌm/; [adj]单调的;乏味的; [n]平凡;单调; [vi]单调乏味地进行; [or]yshx;
humidity: [a]/hjuːˈmɪdəti/; [n]潮湿;湿气;湿度; [or]yshx;
humiliate: [a]/hjuːˈmɪlieɪt/; [vt]使蒙耻;使丢脸;羞辱; [or]yshx;
hurl: [a]/hɜːrl/; [v]用力投掷; [n]猛投; [or]yshx;
hydrogen: [a]/ˈhaɪdrədʒən/; [n]氢,氢气; [or]yshx;
hygiene: [a]/ˈhaɪdʒiːn/; [n]卫生;卫生学;保健学; [or]yshx;
hypothesis: [a]/haɪˈpɑːθəsɪs/; [n]假说;假设; [or]yshx;
hysterical: [a]/hɪˈsterɪkl/; [adj]歇斯底里的,情绪激动的; [or]yshx;
ideal: [a]/aɪˈdiːəl/; [adj]理想的;完美的;空想的;观念的; [n]理想;典范;目标; [or]yshx;
identify: [a]/aɪˈdentɪfaɪ/; [v]认出,联系;识别;确定,鉴定,发现;认为.等同,认为.关系紧密;表明.的身份;认同,有共鸣,有同感; [or]yshx;
ideology: [a]/ˌaɪdiˈɑːlədʒi/; [n]意识形态,思想(体系); [or]yshx;
idiot: [a]/ˈɪdiət/; [n]愚蠢的人,白痴; [or]yshx;
idle: [a]/ˈaɪdl/; [adj]空闲的;懒散的; [v]无所事事;虚度;空转;使空转; [vt]虚度; [or]yshx;
ignite: [a]/ɪɡˈnaɪt/; [v]点燃,发光,燃烧; [or]yshx;
ignorance: [a]/ˈɪɡnərəns/; [n]不知,不懂;愚昧,无知; [or]yshx;
illiterate: [a]/ɪˈlɪtərət/; [n]文盲,目不识丁者; [adj]不识字的;缺乏(某方面)知识的;语法错误的; [or]yshx;
illuminate: [a]/ɪˈluːmɪneɪt/; [vt]照亮;阐释;说明; [or]yshx;
illusion: [a]/ɪˈluːʒn/; [n]假象,幻象;幻想;错误观念; [or]yshx;
illustrate: [a]/ˈɪləstreɪt/; [v]举例说明,阐明;图解,加插图; [or]yshx;
imaginative: [a]/ɪˈmædʒɪnətɪv/; [adj]想象的;富于想象力的;虚构的; [or]yshx;
imitate: [a]/ˈɪmɪteɪt/; [v]模仿; [or]yshx;
immense: [a]/ɪˈmens/; [adj]巨大的,广大的; [or]yshx;
immerse: [a]/ɪˈmɜːrs/; [v]沉浸,沉浸于;使陷入; [or]yshx;
immigrant: [a]/ˈɪmɪɡrənt/; [n]移民; [adj]移民的;迁入的; [or]yshx;
imminent: [a]/ˈɪmɪnənt/; [adj]迫近的,紧迫的,即将来临的; [or]yshx;
immune: [a]/ɪˈmjuːn/; [adj]免疫的,有免疫力的;不受影响的;免除的; [or]yshx;
impact: [a]/ˈɪmpækt/; [n]碰撞,冲击;冲击力;影响; [v]冲击;压紧;产生影响;塞满; [or]yshx;
impair: [a]/ɪmˈper/; [v]损害;削弱; [or]yshx;
impart: [a]/ɪmˈpɑːrt/; [v]传授,给予,将(某性质)给予或赋予某事物; [or]yshx;
impede: [a]/ɪmˈpiːd/; [v]妨碍,阻碍; [or]yshx;
imperative: [a]/ɪmˈperətɪv/; [adj]必要的;祈使的;急需的; [n]命令;必要的事;义务;驱使; [or]yshx;
impetus: [a]/ˈɪmpɪtəs/; [n]推动力;促进; [or]yshx;
implement: [a]/ˈɪmplɪment/; [n]工具;器具; [v]实施,执行;执行; [or]yshx;
impose: [a]/ɪmˈpoʊz/; [v]把.强加;强制实行,强迫接受; [or]yshx;
impressive: [a]/ɪmˈpresɪv/; [adj]给人深刻印象的;引人注目的; [or]yshx;
impromptu: [a]/ɪmˈprɑːmptuː/; [adj]一触即发的;即席的,即兴的; [adv]即席地,即兴地; [n]即兴之作; [or]yshx;
improvise: [a]/ˈɪmprəvaɪz/; [v]即席创作,临时凑成; [or]yshx;
impulse: [a]/ˈɪmpʌls/; [n]冲动,脉冲,驱使; [or]yshx;
in favour of: [a]/ɪn ˈfeɪvər ɑv/; prep. 赞成;以.为收款人; [or]yshx;
in hand: [a]/ɪn hænd/; [adv]可以动用的;在处理中;在控制中; [or]yshx;
in line for: [a]/ɪn laɪn fɔr/; [adv]即可得到;排队; [or]yshx;
in no time: [a]/ɪn noʊ taɪm/; [adv]立刻; [or]yshx;
in one's face: [a]/ɪn wʌnz feɪs/; [adv]公开地;当着某人的面; [or]yshx;
in one: [a]/ɪn wʌn/; [phr]成为一体;只试一次; [or]yshx;
in sb.'s favour: [a]/ɪn ˈsʌmbədiz ˈfeɪvər/; [phr]对某人有利;偏爱; [or]yshx;
in stock: [a]/ɪn stɒk/; [phr]有存货; [or]yshx;
in the air: [a]/ɪn ðə er/; [phr]在空中;悬而未决;在流传中; [or]yshx;
in the hands of: [a]/ɪn ðə hændz ʌv/; prep. 在.掌握中; [or]yshx;
in time: [a]/ɪn taɪm/; [adv]及时;总有一天; [or]yshx;
inaugurate: [a]/ɪˈnɔːɡjəreɪt/; [v]为..揭幕;为.举行就职典礼;开展; [or]yshx;
incidence: [a]/ˈɪnsɪdəns/; [n]发生率,入射角度; [or]yshx;
incipient: [a]/ɪnˈsɪpiənt/; [adj]初期的;刚出现的; [or]yshx;
inclination: [a]/ˌɪnklɪˈneɪʃn/; [n]点头;做.的倾向;意愿;倾斜; [or]yshx;
incline: [a]/ɪnˈklaɪn/; [n]倾斜,斜坡,斜面; [v](使)倾斜,(使)倾向于; [or]yshx;
inclusive: [a]/ɪnˈkluːsɪv/; [adj]包含..在内的,包罗广泛的; [or]yshx;
incorporate: [a]/ɪnˈkɔːrpəreɪt/; [v]包含;使并入; [or]yshx;
increment: [a]/ˈɪŋkrəmənt/; [n]增长;增值; [or]yshx;
incur: [a]/ɪnˈkɜːr/; [v]遭受;招致;引起; [or]yshx;
indemnity: [a]/ɪnˈdemnəti/; [n]赔偿物;补偿,赔偿;保障; [or]yshx;
indicative: [a]/ɪnˈdɪkətɪv/; [adj]指示的;暗示的;陈述的; [n]陈述语气; [or]yshx;
indifferent: [a]/ɪnˈdɪfrənt/; [adj]不感兴趣的,不关心的;平庸的;冷漠的; [or]yshx;
indigenous: [a]/ɪnˈdɪdʒənəs/; [adj]土生土长的,本土的; [or]yshx;
indignant: [a]/ɪnˈdɪɡnənt/; [adj]愤慨的,愤愤不平的; [or]yshx;
indispensable: [a]/ˌɪndɪˈspensəbl/; [adj]必不可少的;必需的; [or]yshx;
individual: [a]/ˌɪndɪˈvɪdʒuəl/; [adj]个别的,独特的;单独的; [n]独立的个体; [or]yshx;
induce: [a]/ɪnˈduːs/; [v]引导,劝诱,诱导; [or]yshx;
indulge: [a]/ɪnˈdʌldʒ/; [v]沉迷于;放纵;满足; [or]yshx;
inept: [a]/ɪˈnept/; [adj]无能的;不称职的;笨拙的; [or]yshx;
inert: [a]/ɪˈnɜːrt/; [adj]不动的,惰性的;行动迟钝的;无生气的; [or]yshx;
inevitable: [a]/ɪnˈevɪtəbl/; [adj]不可避免的,必然的; [n]必然发生的事; [or]yshx;
infant: [a]/ˈɪnfənt/; [n]幼儿,婴儿; [adj]婴儿的;初期的,初创的; [or]yshx;
infect: [a]/ɪnˈfekt/; [v]传染,感染;使受影响; [or]yshx;
inferior: [a]/ɪnˈfɪriər/; [adj](等级,地位等)下等的,低等的;低劣的; [n]部下,地位低的人;次品; [or]yshx;
infest: [a]/ɪnˈfest/; [v]骚扰,寄生于,大批出没; [or]yshx;
infirmary: [a]/ɪnˈfɜːrməri/; [n]医院,医务室(尤指学校等附设的病房或配药处); [or]yshx;
inflation: [a]/ɪnˈfleɪʃn/; [n]通货膨胀;(充气后)膨胀;自负; [or]yshx;
inflict: [a]/ɪnˈflɪkt/; [v]使遭受(损伤,痛苦等);使承担(负担等); [or]yshx;
influx: [a]/ˈɪnflʌks/; [n]流入,涌入;河口; [or]yshx;
infringe: [a]/ɪnˈfrɪndʒ/; [v]侵犯,违反,侵害; [or]yshx;
ingenious: [a]/ɪnˈdʒiːniəs/; [adj]聪明的;有发明天才的;有独创性的,别出心裁的; [or]yshx;
ingredient: [a]/ɪnˈɡriːdiənt/; [n](烹调的)原料;(构成的)要素,因素; [or]yshx;
inhabit: [a]/ɪnˈhæbɪt/; [v]居住于; [or]yshx;
inherent: [a]/ɪnˈhɪrənt/; [adj]内在的,固有的;生来就有的; [or]yshx;
inherit: [a]/ɪnˈherɪt/; [v]经遗传而得(特性等);接受遗产;沿袭;继任; [or]yshx;
inhibit: [a]/ɪnˈhɪbɪt/; [v]阻碍;阻止,防止;抑制,约束; [or]yshx;
initial: [a]/ɪˈnɪʃl/; [adj]第一的;最初的;开始的; [n]首字母; [or]yshx;
initiate: [a]/ɪˈnɪʃieɪt/; [v]开始,发动; [n]新加入组织的人; [or]yshx;
inject: [a]/ɪnˈdʒekt/; [v]给.注射;注入;引入;射入轨道; [or]yshx;
inland: [a]/ˈɪnlænd/; [adv]在内陆地; [adj]内陆的,国内的; [n]内陆; [or]yshx;
innocent: [a]/ˈɪnəsnt/; [adj]天真的,单纯的;无辜的,清白的;无恶意的; [n]天真无邪的人; [or]yshx;
innovation: [a]/ˌɪnəˈveɪʃn/; [n]创新,革新,新设施,新发明; [or]yshx;
innumerable: [a]/ɪˈnuːmərəbl/; [adj]数不清的;无数的; [or]yshx;
inquire: [a]/ɪn'kwaɪər/; [v]打听,询问;调查; [or]yshx;
insane: [a]/ɪnˈseɪn/; [adj]精神失常的,疯狂的;精神病患者的;荒唐的; [n]精神失常的人;精神错乱的人; [or]yshx;
insert: [a]/ɪnˈsɜːrt/; [vt]插入,嵌入; [n]插入物;插页; [or]yshx;
insight: [a]/ˈɪnsaɪt/; [n]深刻的理解,洞察力,见识; [or]yshx;
insipid: [a]/ɪnˈsɪpɪd/; [adj]淡而无味的;枯燥乏味的; [or]yshx;
insolvent: [a]/ɪnˈsɑːlvənt/; [n]无力清偿债务者,破产者; [adj]无清偿能力的,破产的; [or]yshx;
inspection: [a]/ɪnˈspekʃn/; [n]检查,细看; [or]yshx;
inspire: [a]/ɪnˈspaɪər/; [v]使生灵感;启示;激发,激励; [or]yshx;
install: [a]/ɪnˈstɔːl/; [v]安装,安置,使就职; [or]yshx;
instantaneous: [a]/ˌɪnstənˈteɪniəs/; [adj]瞬间的;即刻的;猝发的; [or]yshx;
instinct: [a]/ˈɪnstɪŋkt/; [n]天性;本能;直觉; [adj]充满的; [or]yshx;
insulate: [a]/ˈɪnsəleɪt/; [v]隔离,使隔绝(以免受到影响);使隔热; [or]yshx;
insult: [a]/ɪnˈsʌlt/; [v]侮辱,凌辱; [n]侮辱的言词或行为; [or]yshx;
insurance: [a]/ɪnˈʃʊrəns/; [n]保险;保险费;保险业;安全保证; [or]yshx;
intact: [a]/ɪnˈtækt/; [adj]原封未动的,未受损的,完整无缺的; [or]yshx;
integral: [a]/ˈɪntɪɡrəl/; [adj](用于构成整体)必需的,不可缺少的,必不可少的;基本的,作为组成部分的,内置的;整体的,完整的; [or]yshx;
integrity: [a]/ɪnˈteɡrəti/; [n]正直,真诚;完整; [or]yshx;
intellectual: [a]/ˌɪntəˈlektʃuəl/; [n]知识分子; [adj]智力的;理智的;需用智力的;聪明的; [or]yshx;
intelligible: [a]/ɪnˈtelɪdʒəbl/; [adj]可理解的,明白易懂的; [or]yshx;
intensify: [a]/ɪnˈtensɪfaɪ/; [v]增强;加剧; [or]yshx;
intent: [a]/ɪnˈtent/; [adj]全神贯注的;专心致志的; [n]意图;意向;目的; [or]yshx;
interact: [a]/ˌɪntərˈækt/; [v]交流,沟通,互动;互相作用,互相影响; [or]yshx;
intermediate: [a]/ˌɪntərˈmiːdiət/; [adj]中间的,居间的;中级的; [n]中间体,媒介物; [v]调解,干涉; [or]yshx;
interpret: [a]/ɪnˈtɜːrprɪt/; [v]口译;解释;把..理解为; [or]yshx;
interrogate: [a]/ɪnˈterəɡeɪt/; [v]审问,审讯; [or]yshx;
intersection: [a]/ˌɪntərˈsekʃn/; [n]交点,十字路口; [or]yshx;
interval: [a]/ˈɪntərvl/; [n]间隔;中场休息,幕间休息;间距; [or]yshx;
intimate: [a]/ˈɪntɪmət/; [adj]亲密的,密切的;详细的; [v]暗示;宣布,通知; [n]密友,知己; [or]yshx;
intimidate: [a]/ɪnˈtɪmɪdeɪt/; [v]恫吓,威胁; [or]yshx;
intricate: [a]/ˈɪntrɪkət/; [adj]错综复杂的; [or]yshx;
intrigue: [a]/ɪnˈtriːɡ/; [n]阴谋;诡计; [v]密谋;欺骗;引起极大兴趣; [or]yshx;
intrinsic: [a]/ɪnˈtrɪnsɪk/; [adj]固有的; [or]yshx;
intuition: [a]/ˌɪntuˈɪʃn/; [n]直觉;感觉; [or]yshx;
inundate: [a]/ˈɪnʌndeɪt/; [v]淹没,泛滥; [or]yshx;
invade: [a]/ɪnˈveɪd/; [v]侵略;侵犯;侵害;涌入;渗透;侵略,侵犯; [or]yshx;
invalid: [a]/ɪnˈvælɪd/; [adj]不能识别的;无效的;作废的,不能成立的; [n]病人,残疾人; [or]yshx;
invaluable: [a]/ɪnˈvæljuəbl/; [adj]非常宝贵的,极为贵重的,无价的; [or]yshx;
invariably: [a]/ɪnˈveriəbli/; [adv]总是;不变地,永恒地; [or]yshx;
inventory: [a]/ˈɪnvəntɔːri/; [n]详细目录;存货清单; [or]yshx;
invert: [a]/ɪnˈvɜːrt/; [v]倒置;倒转;颠倒; [or]yshx;
invest: [a]/ɪnˈvest/; [v]投资,投入;赋予,给予; [or]yshx;
investigate: [a]/ɪnˈvestɪɡeɪt/; [v]调查,研究; [or]yshx;
invigilate: [a]/ɪnˈvɪdʒɪleɪt/; [v]监考;监视; [or]yshx;
invisible: [a]/ɪnˈvɪzəbl/; [adj]看不见的,无形的; [or]yshx;
invoice: [a]/ˈɪnvɔɪs/; [n]发票; [v]开发票;记清单; [or]yshx;
involve: [a]/ɪnˈvɑːlv/; [v]牵涉,涉及;卷入,使参与;吸引;包含,需要,影响; [or]yshx;
irony: [a]/ˈaɪrəni/; [n]反语;冷嘲;具有讽刺意味的事; [or]yshx;
irrespective: [a]/ˌɪrɪˈspektɪv/; [adj]不考虑的,不顾的; [or]yshx;
irrigation: [a]/ˌɪrɪˈɡeɪʃn/; [n]灌溉; [or]yshx;
irritate: [a]/ˈɪrɪteɪt/; [v]使烦躁;激怒;使难受; [or]yshx;
isle: [a]/aɪl/; [n]岛,小岛; [or]yshx;
isolate: [a]/ˈaɪsəleɪt/; [v]使隔离;使孤立; [adj]孤立的;单独的; [or]yshx;
issue: [a]/ˈɪʃuː/; [n]问题;议题;发行物;子女; [v]发行;发布;分配,分发,给; [or]yshx;
item: [a]/ˈaɪtəm/; [n]物品;条,条款,项目; [or]yshx;
itinerary: [a]/aɪˈtɪnəreri/; [n]旅程,路线;旅行计划; [or]yshx;
ivory: [a]/ˈaɪvəri/; [n]象牙,象牙制品;乳白色; [or]yshx;
jagged: [a]/ˈdʒæɡɪd/; [adj]锯齿状的,参差不齐的;锯齿状的; [or]yshx;
jail: [a]/dʒeɪl/; [n]监狱;看守所; [v]监禁;拘留; [or]yshx;
jam: [a]/dʒæm/; [n]果酱;阻塞; [v](使)阻塞,使塞满; [or]yshx;
janitor: [a]/ˈdʒænɪtər/; [n]看门人;清洁工; [or]yshx;
jealous: [a]/ˈdʒeləs/; [adj]妒忌的,妒羡的; [or]yshx;
jeer: [a]/dʒɪr/; [n]嘲笑,戏弄,揶揄的言语; [v]嘲笑,戏弄; [or]yshx;
jeopardise: [a]/'dʒepədaɪz/; [v]使受危害,使陷险境; [or]yshx;
jog: [a]/dʒɑːɡ/; [v]慢跑;轻碰; [n]轻推,慢跑,漫步; [or]yshx;
jolt: [a]/dʒoʊlt/; [n]猛的一击,摇晃,震惊; [v](使)颠簸,摇晃;使震惊; [or]yshx;
journalist: [a]/ˈdʒɜːrnəlɪst/; [n]记者,新闻工作者; [or]yshx;
judicial: [a]/dʒuˈdɪʃl/; [adj]司法的,法庭的,法律的,审判(上)的; [or]yshx;
jumble: [a]/ˈdʒʌmbl/; [n]混杂;混乱;待义卖的一堆旧什物; [v]使混乱;搞乱; [or]yshx;
junction: [a]/ˈdʒʌŋkʃn/; [n]连接,接合;接合处;路口; [or]yshx;
jungle: [a]/ˈdʒʌŋɡl/; [n]丛林,密林;危险地带;丛林音乐; [or]yshx;
junior: [a]/ˈdʒuːniər/; [adj]年少的;下级的;低年级的; [n]年少者,晚辈;(美国四年制大学)三年级学生;职位较低者; [or]yshx;
junk: [a]/dʒʌŋk/; [n]废旧物品,垃圾,假货; [v]把.(当废物)丢弃; [or]yshx;
jury: [a]/ˈdʒʊri/; [n]陪审团;全体评审员,评判委员会; [or]yshx;
juvenile: [a]/ˈdʒuːvənl/; [n]青少年;雏鸟; [adj]青少年的;幼稚的; [or]yshx;
keen: [a]/kiːn/; [adj]敏锐的;热衷的,热心的;强烈的,渴望的; [v]恸哭; [n]〈英〉号哭,恸哭; [adv]如饥似渴地; [or]yshx;
keep an eye on: [a]/kiːp æn aɪɑːn/; [phr]密切注视; [or]yshx;
keep at: [a]/kip ət/; [v]不断地做; [or]yshx;
keep away (from): [a]/kiːp əˈweɪ frʌm/; [phr]远离,回避; [or]yshx;
keep in with sb.: [a]/kiːp ɪn wɪθ ˈsʌmbədi/; [phr]与(某人)友好相处; [or]yshx;
keep off: [a]/kip ɑf/; [phr]让开;不接近; [or]yshx;
keep on (doing sth.): [a]/kiːp ɔːn ˈduːɪŋ ˈsʌmθɪŋ/; [v]继续做某事; [or]yshx;
keep sb. (sth.) out (of): [a]/kiːp ˈsʌmbədi ˈsʌmθɪŋ aʊt ʌv/; [v]不让.入内; [or]yshx;
keep sb. down: [a]/kiːp ˈsʌmbədi daʊn/; [v]控制;为难;压制; [or]yshx;
keep sb. on: [a]/kiːp ˈsʌmbədi ɔːn/; [v]继续雇用某人; [or]yshx;
keep sb. up: [a]/kiːp ˈsʌmbədi ʌp/; [v]坚持,继续; [or]yshx;
keep sth. (back) from: [a]/kiːp ˈsʌmθɪŋ bæk frʌm/; [v]不让某事.;离开; [or]yshx;
keep sth. in mind: [a]/kiːp ˈsʌmθɪŋ ɪn maɪnd/; [v]记住; [or]yshx;
keep sth. to oneself: [a]/kiːp ˈsʌmθɪŋ tu wʌnˈself/; [v]不让他人分享,独自享用; [or]yshx;
keep to the beaten track: [a]/kip tu ðə ˈbit(ə)n træk/; [phr]循规蹈矩; [or]yshx;
keep to: [a]/kip tu/; [v]履行诺言;限制自己;坚持; [or]yshx;
kernel: [a]/ˈkɜːrnl/; [n]子粒,谷粒;核心; [or]yshx;
kidnap: [a]/ˈkɪdnæp/; [v]诱拐;绑架; [or]yshx;
kidney: [a]/ˈkɪdni/; [n]肾,腰子; [or]yshx;
kin: [a]/kɪn/; [n]亲属; [or]yshx;
kindle: [a]/ˈkɪndl/; [v]点燃,激起;着火;照亮;煽动; [or]yshx;
kit: [a]/kɪt/; [n]成套工具;工具箱;装备; [vt]装备; [or]yshx;
knit: [a]/nɪt/; [v]编结,针织; [n]编织的衣服;针织衫; [or]yshx;
knob: [a]/nɑːb/; [n]圆形把手,旋钮,圆形突出物; [v]突出;使有球形突出物;在.上生疖(长瘤);给(门等)装球形捏手; [or]yshx;
knot: [a]/nɑːt/; [n]绳结,结合,树的节; [v]打结; [or]yshx;
know better (than): [a]/noʊ ˈbetər ðən/; [v]很明白(而不至于); [or]yshx;
lace: [a]/leɪs/; [n]鞋带;花边; [v]加以修饰;结带子; [or]yshx;
laden: [a]/ˈleɪdn/; [adj]装满的;负载的;苦恼的,沉重的; [or]yshx;
lag: [a]/læɡ/; [n]落后,延迟; [v]落后;缓慢进行,减退; [or]yshx;
lame: [a]/leɪm/; [adj]跛的;瘸的;差劲的,乏味的;〔解释或借口〕无说服力的,站不住脚的,蹩脚的; [v](使)变跛; [or]yshx;
lament: [a]/ləˈment/; [v]哀悼;惋惜;悲叹; [n]悲叹;悼词; [or]yshx;
landscape: [a]/ˈlændskeɪp/; [n]风景;风景画;景观;横向打印格式; [v]美化环境; [or]yshx;
lane: [a]/leɪn/; [n]小径,巷,行车道; [or]yshx;
languid: [a]/ˈlæŋɡwɪd/; [adj]没精打采的,倦怠的; [or]yshx;
lap: [a]/læp/; [n]腰以下及大腿的前面部分;(跑道的)一圈; [v](赛跑中)比(某人)领先一圈;轻拍; [or]yshx;
lapse: [a]/læps/; [n]失误,过失;行为失检;(时间)流逝; [v]退步,倒退,衰退;失效;背弃,放弃(宗教信仰); [or]yshx;
lash: [a]/læʃ/; [v]鞭打;猛烈抨击;捆绑;摆动;猛击; [n]鞭梢;鞭打; [or]yshx;
latent: [a]/ˈleɪtnt/; [adj]潜在的,隐伏的,不易察觉的; [or]yshx;
later on: [a]/'leɪtər ɔn/; [adv]后来;稍后; [or]yshx;
lateral: [a]/ˈlætərəl/; [n]侧面部分;支线; [adj]侧面的;横向的; [or]yshx;
latitude: [a]/ˈlætɪtuːd/; [n]纬度;地区;(言论,行动的)自由; [or]yshx;
laudable: [a]/ˈlɔːdəbl/; [adj]值得称赞的; [or]yshx;
launch: [a]/lɔːntʃ/; [v]发射;出海;创办,开始从事; [n]发射,投放市场;(游艇,汽艇)下水;发行; [or]yshx;
laundry: [a]/ˈlɔːndri/; [n]洗衣;送洗的衣物;洗衣店;洗衣房; [or]yshx;
lavish: [a]/ˈlævɪʃ/; [adj]奢华的;铺张浪费的; [v]浪费;慷慨给予; [or]yshx;
lawn: [a]/lɔːn/; [n]草地;草坪;(衣服用)细麻; [or]yshx;
lax: [a]/læks/; [adj]松懈的;松弛的;<语>松弛元音的; [n]松元音;泻肚; [or]yshx;
lay (sth.) bare: [a]/leɪ ˈsʌmθɪŋ ber/; [phr]显示;揭露; [or]yshx;
lay (sth.) out: [a]/leɪ ˈsʌmθɪŋ aʊt/; [v]展示,摆开;布置,设计; [or]yshx;
lay bare: [a]/leɪ ber/; [phr]揭发;暴露;公开; [or]yshx;
lay sth. aside: [a]/leɪ ˈsʌmθɪŋ əˈsaɪd/; [phr]储蓄;放一边; [or]yshx;
layer: [a]/ler/; [n]层;层次;阶层; [v]把.分层堆放;借助压条法;将(头发)剪成不同层次; [or]yshx;
layman: [a]/ˈleɪmən/; [n]门外汉;俗人;外行; [or]yshx;
layoff: [a]/'leɪˌɔːf/; [n]活动停止期间;裁员;临时解雇;操作停止;失业期; [or]yshx;
layout: [a]/ˈleɪaʊt/; [n]布局;(版面)设计; [or]yshx;
leak: [a]/liːk/; [v]漏;泄露; [n]漏洞;泄漏,裂缝; [or]yshx;
leap: [a]/liːp/; [v]跳跃;暴涨; [n]跳跃;跳动;上涨; [or]yshx;
learn sth. the hard way: [a]/lɜːrn ˈsʌmθɪŋ ðə hɑːrd weɪ/; [phr]经过艰难困苦而学到; [or]yshx;
learn/know sth. by heart: [a]/lɜːrn noʊ ˈsʌmθɪŋ baɪ hɑːrt/; [phr]记住,背下; [or]yshx;
lease: [a]/liːs/; [v]出租,租得; [n]租约,租契; [or]yshx;
leave for: [a]/liv fɔr/; [v]动身去; [or]yshx;
leave off: [a]/liv ɑf/; [v](使)停止; [or]yshx;
leave sb. (sth.) alone: [a]/liːv ˈsʌmbədi ˈsʌmθɪŋ əˈloʊn/; [phr]不干涉某人(某事); [or]yshx;
leave sb. (sth.) behind: [a]/liːv ˈsʌmbədi ˈsʌmθɪŋ bɪˈhaɪnd/; [phr]忘带,留下; [or]yshx;
leave sth. (sb.) out: [a]/liːv ˈsʌmθɪŋ ˈsʌmbədi aʊt/; [phr]遗漏,不考虑; [or]yshx;
legal: [a]/ˈliːɡl/; [adj]合法的,法定的;法律的; [or]yshx;
legitimate: [a]/lɪˈdʒɪtɪmət/; [adj]合法的;合理的; [vt]使合法;授权;宣布..为合法; [or]yshx;
lenient: [a]/ˈliːniənt/; [adj]宽大的,宽容的,仁慈的; [or]yshx;
lens: [a]/lenz/; [n]镜头;透镜;镜片;晶状体; [or]yshx;
let alone: [a]/let əˈloʊn/; [phr]听任;不打扰;更别说; [or]yshx;
let oneself go: [a]/let wʌnˈself ɡoʊ/; [v]尽情,情不自禁; [or]yshx;
let sb. down: [a]/let ˈsʌmbədi daʊn/; [n]使失望; [or]yshx;
lethal: [a]/ˈliːθl/; [adj]致命的,致死的;杀伤性的; [n]致死因子; [or]yshx;
lever: [a]/ˈlevər/; [n]杠杆;控制杆;施加影响的手段; [v]用杠杆移动;撬开; [or]yshx;
levy: [a]/ˈlevi/; [v]征收(税等); [n]征税;税款; [or]yshx;
liable: [a]/ˈlaɪəbl/; [adj](for)有责任的;有义务的;(to)有.倾向的;易于.的,有可能.; [or]yshx;
license: [a]/ˈlaɪsns/; [n]许可;执照; [v]许可,准许;发许可证; [or]yshx;
lick: [a]/lɪk/; [v]舔;卷烧;战胜;使无法理解;轻轻拍打; [vi]舔; [n]舔;舌头一次舔的量;狠揍; [or]yshx;
likelihood: [a]/ˈlaɪklihʊd/; [n]可能;可能性; [or]yshx;
likewise: [a]/ˈlaɪkwaɪz/; [adv]同样地,此外; [or]yshx;
limb: [a]/lɪm/; [n]肢体;臂;枝干;树枝; [v]肢解; [or]yshx;
limp: [a]/lɪmp/; [n]跛行; [vi]一瘸一拐地走,跛行;慢腾腾地进行; [adj]无力的,无生气的;柔软的,软弱的; [or]yshx;
linear: [a]/ˈlɪniər/; [adj]线的,线性的;直线的;长度的; [or]yshx;
linen: [a]/ˈlɪnɪn/; [n]亚麻桌布;亚麻布; [or]yshx;
liner: [a]/ˈlaɪnər/; [n]眼线笔;班轮;班机;内衬; [or]yshx;
linger: [a]/ˈlɪŋɡər/; [v]逗留,留恋; [or]yshx;
liquor: [a]/ˈlɪkər/; [n]酒;烈性酒;液剂; [or]yshx;
literacy: [a]/ˈlɪtərəsi/; [n]读写能力;识字;有文化;教养; [or]yshx;
literature: [a]/ˈlɪtrətʃər/; [n]文学;宣传册;文献; [or]yshx;
litter: [a]/ˈlɪtər/; [n]垃圾;杂乱; [v]乱丢; [or]yshx;
live it up: [a]/lɪv ɪt ʌp/; [v]过着逍遥的日子;狂欢一场; [or]yshx;
live on: [a]/liːv ɑːn/; [phr]以.为主食;靠.生活; [or]yshx;
live through: [a]/lɪv θru/; [phr]度过; [or]yshx;
live up to: [a]/lɪv ʌp tu/; [phr]不辜负;做到; [or]yshx;
live with: [a]/lɪv wɪθ/; [phr]接受,忍受;同居; [or]yshx;
livestock: [a]/ˈlaɪvstɑːk/; [n]家畜,牲畜; [or]yshx;
loaf: [a]/loʊf/; [n](一条)面包; [v]虚度光阴; [or]yshx;
loan: [a]/loʊn/; [n]贷款;暂借; [v]借贷; [or]yshx;
loath: [a]/loʊθ/; [adj]不愿意的; [or]yshx;
locality: [a]/loʊˈkæləti/; [n]地区;地点;位置;方位; [or]yshx;
locomotive: [a]/ˌloʊkəˈmoʊtɪv/; [n]机车,火车头; [adj]运动的; [or]yshx;
lodging: [a]/ˈlɑːdʒɪŋ/; [n]住所;寄宿;(大学生的)校外宿舍; [or]yshx;
lofty: [a]/ˈlɔːfti/; [adj]极高的,巍峨的;崇高的;高傲的; [or]yshx;
log: [a]/lɔːɡ/; [n]原木;航海日志; [v]伐木;航行;记录;登录; [or]yshx;
logic: [a]/ˈlɑːdʒɪk/; [n]逻辑,推理;逻辑性;逻辑学; [or]yshx;
loll: [a]/lɑːl/; [vi]懒洋洋地倚靠;闲荡; [vt]懒洋洋地倚靠着;使悬垂; [or]yshx;
look after: [a]/lʊk ˈæftər/; [phr]照顾,照看; [or]yshx;
look at: [a]/lʊk ət/; [phr]看,浏览,检查; [or]yshx;
look back (on sth.): [a]/lʊk bæk ɒn ˈsʌmθɪŋ/; [phr]回顾; [or]yshx;
look down on: [a]/lʊk daʊn ɑːn/; [phr]轻视; [or]yshx;
look for: [a]/lʊk fɔr/; [phr]寻找;期待; [or]yshx;
look forward to: [a]/lʊk ˈfɔːrwərd tu/; [phr]盼望; [or]yshx;
look in (on sb.): [a]/lʊk ɪn ɔːn ˈsʌmbədi/; [v](顺便)看望; [or]yshx;
look into: [a]/lʊk ˈɪntu/; [v]研究;调查; [or]yshx;
look on (sb.) as: [a]/lʊk ɔːn ˈsʌmbədi æz/; [v]当作..看待; [or]yshx;
look one's best: [a]/lʊk wʌnz bɛst/; [v]表现出最好的状态; [or]yshx;
look out for sb.(sth.): [a]/lʊk aʊt fɔːrˈ sʌmbədi ˈsʌmθɪŋ/; [v]注意; [or]yshx;
look over: [a]/lʊk ˈoʊvər/; [phr]检查; [or]yshx;
look round: [a]/lʊk raʊnd/; [phr]四处看;寻找; [or]yshx;
look sth. up: [a]/lʊk ˈsʌmθɪŋ ʌp/; [phr]查字典; [or]yshx;
loom: [a]/luːm/; [n]织布机; [v]阴森地逼近;隐现;即将来临; [or]yshx;
loop: [a]/luːp/; [n](用线,绳,带等打成的)环;环状物;环线; [vi]成圈; [vt]打成环状; [or]yshx;
lose face: [a]/luz feɪs/; [phr]丢面子; [or]yshx;
lose heart: [a]/luz hɑrt/; [v]丧失信心; [or]yshx;
lose one's bearings: [a]/luːz wʌnz ˈberɪŋs/; [phr]迷失方向;不知所措; [or]yshx;
lottery: [a]/ˈlɑːtəri/; [n]彩票;碰运气的事,难算计的事;抽彩给奖法; [or]yshx;
lounge: [a]/laʊndʒ/; [n]候机室,休息室,酒吧间;沙发,躺椅;懒散的步子; [v](懒散地)倚,躺;闲逛; [or]yshx;
loyal: [a]/ˈlɔɪəl/; [adj]忠心的;忠诚的; [n]效忠(君主)的臣民; [or]yshx;
lubricate: [a]/ˈluːbrɪkeɪt/; [v]使.润滑;给.加润滑油; [or]yshx;
lucid: [a]/ˈluːsɪd/; [adj]明晰的;透明的;易懂的;头脑清楚的; [or]yshx;
lucrative: [a]/ˈluːkrətɪv/; [adj]合算的;获利的;有利可图的; [or]yshx;
ludicrous: [a]/ˈluːdɪkrəs/; [adj]荒谬的,可笑的,滑稽的; [or]yshx;
lull: [a]/lʌl/; [v]使平静,使安静,哄骗; [n]间歇,暂停,暂时平静; [or]yshx;
lump: [a]/lʌmp/; [n]团;肿块;粗笨的人;一小方块 (糖); [v]成团,成堆;使成块; [or]yshx;
lunar: [a]/ˈluːnər/; [adj]月亮的; [or]yshx;
lure: [a]/lʊr/; [v]引诱;以诱饵吸引; [n]诱惑力;诱惑物;鱼饵; [or]yshx;
lurk: [a]/lɜːrk/; [n]潜伏,潜行; [vi]潜伏;潜藏;鬼鬼祟祟地走; [or]yshx;
luxury: [a]/ˈlʌkʃəri/; [adj]奢侈的,豪华的; [n]奢侈,奢华; [or]yshx;
mackintosh: [a]/ˈmækɪntɑːʃ/; [n]雨衣,防水胶布; [or]yshx;
madden: [a]/ˈmædn/; [v]使发疯,使发狂; [or]yshx;
magistrate: [a]/ˈmædʒɪstreɪt/; [n]法官; [or]yshx;
magnanimous: [a]/mæɡˈnænɪməs/; [adj]宽宏大量的,大度的;慷慨的; [or]yshx;
magnate: [a]/ˈmæɡneɪt/; [n]大人物;大亨,巨头;权贵; [or]yshx;
magnificent: [a]/mæɡˈnɪfɪsnt/; [adj]华丽的,宏伟的,壮丽的; [or]yshx;
magnify: [a]/ˈmæɡnɪfaɪ/; [v]放大,扩大;夸大,夸张; [or]yshx;
magnitude: [a]/ˈmæɡnɪtuːd/; [n]巨大;震级;重要性;<数>量值; [or]yshx;
maiden: [a]/ˈmeɪdn/; [n](文学)少女,未嫁女子; [adj]未婚的,处女的,初次的; [or]yshx;
maim: [a]/meɪm/; [v]使残废; [or]yshx;
maintain: [a]/meɪnˈteɪn/; [v]维持,保持;断言,宣称;供养,赡养; [or]yshx;
maize: [a]/meɪz/; [n]玉米; [adj]黄色的,玉米色的; [or]yshx;
majestic: [a]/məˈdʒestɪk/; [adj]威严的;雄伟的;壮丽的; [or]yshx;
majority: [a]/məˈdʒɔːrəti/; [n]多数,大多数,多数票;法定成年年龄; [or]yshx;
make (sth. )out: [a]/meɪk ˈsʌmθɪŋ aʊt/; [v]写;辨认出;理解;歪曲; [or]yshx;
make for sb.(sth.): [a]/meɪk fɔːr ˈsʌmbədi ˈsʌmθɪŋ/; [phr]有助于;促进;走向; [or]yshx;
make light of: [a]/meɪk laɪt ɑv/; [v]轻视; [or]yshx;
make off: [a]/meɪk ɑf/; [phr]逃走;离开;匆忙离开; [or]yshx;
make one's day: [a]/meɪk wʌnz deɪ/; [phr]使某人快活; [or]yshx;
make sb. out to be: [a]/meɪk ˈsʌmbədi aʊt tu bi/; [v]把.说成; [or]yshx;
make sb. up: [a]/meɪk ˈsʌmbədi ʌp/; [v]化妆; [or]yshx;
make sth. up: [a]/meɪk ˈsʌmθɪŋ ʌp/; [phr]补足;弥补;编造;虚构;组成;准备; [or]yshx;
make the best of a bad job: [a]/meɪk ðə best ɑv ə bæd dʒɑb/; [v]尽力把损失减少到最小; [or]yshx;
make the most of: [a]/meɪk ðə moʊst ɑv/; [v]充分利用; [or]yshx;
make up for: [a]/meɪk ʌp fɔr/; [v]补偿,弥补; [or]yshx;
make up with sb.: [a]/meɪk ʌp wɪθ ˈsʌmbədi/; [v]与.和解; [or]yshx;
making: [a]/ˈmeɪkɪŋ/; [n]制作,形成,发展; [or]yshx;
malice: [a]/ˈmælɪs/; [n]恶意,怨恨; [or]yshx;
malignant: [a]/məˈlɪɡnənt/; [adj]恶性的,恶毒的,充满恨意的; [n]怀有恶意的人;保王党员; [or]yshx;
mall: [a]/mɔːl/; [n]购物商场; [or]yshx;
malleable: [a]/ˈmæliəbl/; [adj](金属)可锻的;有延展性的;(性格)可训练的;易适应的; [or]yshx;
malnutrition: [a]/ˌmælnuːˈtrɪʃn/; [n]营养不良; [or]yshx;
maltreat: [a]/ˌmælˈtriːt/; [v]虐待;滥用; [or]yshx;
mammal: [a]/ˈmæml/; [n]哺乳动物; [or]yshx;
manacle: [a]/ˈmænəkl/; [v]上手铐,束缚; [n]手铐; [or]yshx;
mandatory: [a]/ˈmændətɔːri/; [adj]命令的,强制性的; [or]yshx;
maneuver: [a]/məˈnʊvər/; [v]操纵; [n]操纵;花招;调遣;策略; [or]yshx;
mania: [a]/ˈmeɪniə/; [n]癫狂,狂热; [or]yshx;
manifest: [a]/ˈmænɪfest/; [adj]显然的,明白无误的,明了的; [v]使显现,使显露,表明; [n]货单,旅客名单; [or]yshx;
manipulate: [a]/məˈnɪpjuleɪt/; [v]操纵,影响;正骨; [or]yshx;
mannerism: [a]/ˈmænərɪzəm/; [n](说话,举止等的)习气,癖性,矫揉造作; [or]yshx;
mansion: [a]/ˈmænʃn/; [n]官邸;巨宅;大厦; [or]yshx;
manual: [a]/ˈmænjuəl/; [n]手册;指南; [adj]手的;手制的;手工的;体力的; [or]yshx;
manufacture: [a]/ˌmænjuˈfæktʃər/; [v]生产;制造; [n]制造,生产;制造业;(复)产品; [or]yshx;
manure: [a]/məˈnʊr/; [n]肥料; [v]施肥于;耕种; [or]yshx;
manuscript: [a]/ˈmænjuskrɪpt/; [n]手稿;底稿;手抄本; [or]yshx;
mar: [a]/mɑːr/; [v]毁坏,弄糟,玷污; [or]yshx;
marble: [a]/ˈmɑːrbl/; [n]大理石;(游戏用的)玻璃弹子; [or]yshx;
margin: [a]/ˈmɑːrdʒən/; [n]页边的空白,边缘;优势;利润; [or]yshx;
marine: [a]/məˈriːn/; [adj]海洋的,航海的,海产的,海军的; [n]海军士兵; [or]yshx;
marital: [a]/ˈmærɪtl/; [adj]婚姻的; [or]yshx;
maritime: [a]/ˈmærɪtaɪm/; [adj]海事的,海上的,沿海的,近海的;海员的,水手的; [or]yshx;
martial: [a]/ˈmɑːrʃl/; [adj]武术的;好战的;军事的; [or]yshx;
martyr: [a]/ˈmɑːrtər/; [n]烈士;受难者;乞怜者; [v]迫害,折磨; [or]yshx;
marvelous: [a]/ˈmɑːrvələs/; [adj]非凡的;叹为观止的,令人惊奇的; [n]怪事; [or]yshx;
masculine: [a]/ˈmæskjəlɪn/; [adj]男性的;男子气概的; [or]yshx;
mask: [a]/mæsk/; [n]面具;遮蔽物;伪装; [v]隐藏(感情);掩盖,掩饰,掩护;伪装; [or]yshx;
massacre: [a]/ˈmæsəkər/; [n]大屠杀,残杀;惨败; [v]屠杀;彻底击败; [or]yshx;
massive: [a]/ˈmæsɪv/; [adj]巨大的;大规模的;大量的; [or]yshx;
maternal: [a]/məˈtɜːrnl/; [adj]母亲的,母性的;母方的,母系的; [or]yshx;
mature: [a]/məˈtʃʊr/; [adj]成熟的;到期的; [vt]使成熟; [vi]成熟; [or]yshx;
maximum: [a]/ˈmæksɪməm/; [n]最大值;最大限度; [adj]最大的; [or]yshx;
meadow: [a]/ˈmedoʊ/; [n]草地; [or]yshx;
meagre: [a]/ˈmiːɡər/; [adj]瘦的;贫弱的;贫乏的; [or]yshx;
measure: [a]/ˈmeʒər/; [v]测量;估量; [n]措施;方法;尺寸;量度标准; [or]yshx;
mechanism: [a]/ˈmekənɪzəm/; [n]机械装置;机制,机理,原理; [or]yshx;
medal: [a]/ˈmedl/; [n]奖牌;勋章; [v]授予奖章; [or]yshx;
meddle: [a]/ˈmedl/; [vi]干预,多管闲事; [or]yshx;
mediate: [a]/ˈmiːdieɪt/; [v]调解,调停,斡旋; [or]yshx;
mediocre: [a]/ˌmiːdiˈoʊkər/; [adj]普通的;平凡的;中等的; [or]yshx;
meditate: [a]/ˈmedɪteɪt/; [v]考虑,沉思,冥想; [or]yshx;
medium: [a]/ˈmiːdiəm/; [adj]中等的;适中的; [n]手段;媒介;材料; [or]yshx;
meek: [a]/miːk/; [adj]温顺的,逆来顺受的;谦恭的; [n]温顺的人;谦恭的人; [or]yshx;
melancholy: [a]/ˈmelənkɑːli/; [n]忧郁,悲哀; [adj]忧郁的,令人伤感的; [or]yshx;
melodious: [a]/məˈloʊdiəs/; [adj]音调悦耳的;旋律优美的; [or]yshx;
memento: [a]/məˈmentoʊ/; [n]纪念品; [or]yshx;
menace: [a]/ˈmenəs/; [v]威胁,威吓; [n]威胁;具有危险性的人(或物); [or]yshx;
mentality: [a]/menˈtæləti/; [n]脑力;思想;心理; [or]yshx;
mercantile: [a]/ˈmɜːrkəntaɪl/; [adj]商人的,商业的; [or]yshx;
mercenary: [a]/ˈmɜːrsəneri/; [n]外国雇佣兵;唯利是图者; [adj]唯利是图的;雇佣的; [or]yshx;
mercy: [a]/ˈmɜːrsi/; [n]宽恕,仁慈,怜悯,恩惠; [or]yshx;
merge into: [a]/mɜrdʒ ˈɪntu/; [phr]合并;结合; [or]yshx;
merge: [a]/mɜːrdʒ/; [v]合并;融合; [or]yshx;
merit: [a]/ˈmerɪt/; [n]优点;价值;功绩; [v]值得;应得; [or]yshx;
mesh: [a]/meʃ/; [n]网,筛孔; [v]相啮合; [or]yshx;
mess: [a]/mes/; [n]凌乱状态,混乱状态;肮脏,污秽;困境;食堂;大量某物; [v]弄脏,弄乱;浪费时间,瞎闹; [or]yshx;
metabolism: [a]/məˈtæbəlɪzəm/; [n]新陈代谢; [or]yshx;
metaphor: [a]/ˈmetəfər/; [n]暗喻,隐喻; [or]yshx;
meteoric: [a]/ˌmiːtiˈɔːrɪk/; [adj]流星的,转瞬即逝的,突然的; [or]yshx;
meteorology: [a]/ˌmiːtiəˈrɑːlədʒi/; [n]气象学; [or]yshx;
meticulous: [a]/məˈtɪkjələs/; [adj]谨小慎微的;一丝不苟的; [or]yshx;
microbe: [a]/ˈmaɪkroʊb/; [n]微生物;细菌; [or]yshx;
microcosm: [a]/ˈmaɪkroʊkɑːzəm/; [n]微观世界,缩影; [or]yshx;
microfilm: [a]/ˈmaɪkroʊfɪlm/; [n]微缩胶片; [v]缩微拍摄; [or]yshx;
migrate: [a]/ˈmaɪɡreɪt/; [vi]迁徙;迁移,移往;迁移; [or]yshx;
mildew: [a]/ˈmɪlduː/; [vt]使发霉; [vi]发霉,长霉; [n]霉,霉菌; [adj]发霉的; [or]yshx;
militant: [a]/ˈmɪlɪtənt/; [adj]好战的,好暴力的; [n]激进分子,斗士; [or]yshx;
millennium: [a]/mɪˈleniəm/; [n]千禧年;太平盛世; [or]yshx;
mimic: [a]/ˈmɪmɪk/; [v]模仿,戏弄; [n]模仿者; [adj]模拟的;假的,伪装的; [or]yshx;
mind one's own business: [a]/maɪnd wʌnz oʊn ˈbɪznəs/; [v]少管闲事;各人自扫门前雪; [or]yshx;
minimal: [a]/ˈmɪnɪməl/; [adj]最低限度的; [or]yshx;
minimum: [a]/ˈmɪnɪməm/; [adj]最少的,最低程度的; [n]最低限度,最小量; [or]yshx;
minister: [a]/ˈmɪnɪstər/; [v]给予援助,救助;照料,服侍; [n]部长,大臣;公使,外交使节;牧师; [or]yshx;
minority: [a]/maɪˈnɔːrəti/; [n]少数;少数民族;未成年; [adj]构成少数的; [or]yshx;
mint: [a]/mɪnt/; [n]薄荷,薄荷糖,造币厂; [v]铸造(硬币); [or]yshx;
minus: [a]/ˈmaɪnəs/; prep. 减(去); [adj]负的; [n]减号;劣势; [or]yshx;
miracle: [a]/ˈmɪrəkl/; [n]奇迹; [or]yshx;
mire: [a]/ˈmaɪər/; [n]泥沼,困境; [or]yshx;
misappropriate: [a]/ˌmɪsəˈproʊprieɪt/; [v]滥用,误用; [adj]=inappropriate; [or]yshx;
mischance: [a]/ˌmɪsˈtʃæns/; [n]不幸,灾难; [or]yshx;
mischief: [a]/ˈmɪstʃɪf/; [n]伤害;恶作剧;顽皮; [or]yshx;
misdeed: [a]/ˌmɪsˈdiːd/; [n]不端行为,罪行; [or]yshx;
miserable: [a]/ˈmɪzrəbl/; [adj]悲惨的,痛苦的;使人难受的;不快乐的,不友善的,暴躁的(人);极少的; [or]yshx;
misfortune: [a]/ˌmɪsˈfɔːrtʃuːn/; [n]不幸,灾祸; [or]yshx;
misgiving: [a]/ˌmɪsˈɡɪvɪŋ/; [n]疑虑; [vt]担忧;使.疑虑;害怕(misgive的变形); [or]yshx;
misguided: [a]/ˌmɪsˈɡaɪdɪd/; [adj]被引入歧途的;被误导的; [v]使入歧途; [or]yshx;
mishap: [a]/ˈmɪshæp/; [n]不幸的事,灾祸;晦气; [or]yshx;
misrepresent: [a]/ˌmɪsˌreprɪˈzent/; [vi]作虚假陈述; [vt]歪曲;误传; [or]yshx;
missile: [a]/ˈmɪsl/; [n]导弹;投射出的物体或武器; [adj]导弹的;可投掷的;用以发射导弹的; [or]yshx;
mission: [a]/ˈmɪʃn/; [n]任务,使命;代表团,使团; [vi]派遣..执行任务; [or]yshx;
mist: [a]/mɪst/; [n]薄雾,朦胧; [v]使模糊,下雾; [or]yshx;
misuse: [a]/ˌmɪsˈjuːs/; [v]误用;滥用; [n]误用;滥用; [or]yshx;
mitigate: [a]/ˈmɪtɪɡeɪt/; [v]减轻,缓和; [or]yshx;
mobilize: [a]/ˈmoʊbəlaɪz/; [v]动员起来;动员;鼓动起; [or]yshx;
mock: [a]/mɑːk/; [v]嘲笑;轻蔑,蔑视; [adj]不真诚的;伪造的; [n]模拟考; [or]yshx;
mode: [a]/moʊd/; [n]模式;方式; [or]yshx;
moderate: [a]/ˈmɑːdərət/; [adj]适度的,适中的,温和的,稳健的,中等的; [v]使减轻,使缓和; [n]温和主义者;稳健的人; [or]yshx;
modest: [a]/ˈmɑːdɪst/; [adj]谦虚的,谦逊的;端庄的,羞怯的;不太大(或太贵,太重要)的,适度的; [or]yshx;
modify: [a]/ˈmɑːdɪfaɪ/; [v]改装,修改,更改;修饰,限定; [or]yshx;
module: [a]/ˈmɑːdʒuːl/; [n]组件,模件,(航天器的)舱;(组成一门课程的)独立单元; [or]yshx;
moist: [a]/mɔɪst/; [adj](表面)潮湿的,湿润的; [or]yshx;
mold: [a]/moʊld/; [vt]塑造;使形成; [v]把..塑造成; [n]霉菌;模子;气质; [or]yshx;
molecule: [a]/ˈmɑːlɪkjuːl/; [n]分子,微粒; [or]yshx;
molest: [a]/məˈlest/; [v]骚扰,干扰; [or]yshx;
momentum: [a]/moʊˈmentəm/; [n](物理)动量;势头;动力; [or]yshx;
monarchy: [a]/ˈmɑːnərki/; [n]君主,最高统治者;君主政体;君主国; [or]yshx;
monetary: [a]/ˈmɑːnɪteri/; [adj]货币的,金融的;金钱的; [or]yshx;
monitor: [a]/ˈmɑːnɪtər/; [n]显示器;监视器;班长; [v]监视;监督;监测; [or]yshx;
monologue: [a]/ˈmɑːnəlɔːɡ/; [n]独白,个人长篇演说; [or]yshx;
monopoly: [a]/məˈnɑːpəli/; [n]垄断;专卖;垄断商品;专卖商品; [or]yshx;
monotonous: [a]/məˈnɑːtənəs/; [adj]单调的,无聊的; [or]yshx;
monsoon: [a]/ˌmɑːnˈsuːn/; [n]季雨,季风,大雨; [or]yshx;
monster: [a]/ˈmɑːnstər/; [n]怪物,怪兽,妖怪;巨兽,巨大的东西,庞然大物;极其残酷的人,恶人,恶魔;小恶棍,捣蛋鬼〔幽默用法〕; [adj]巨大的;庞大的; [or]yshx;
moped: [a]/ˈmoʊped/; [n]机动脚踏车; [or]yshx;
morality: [a]/məˈræləti/; [n]道德,道德观;道德规范,伦理体系; [or]yshx;
morbid: [a]/ˈmɔːrbɪd/; [adj]疾病的;(精神等)病态的;恐怖的; [or]yshx;
moreover: [a]/mɔːrˈoʊvər/; [adv]此外,而且; [or]yshx;
mortal: [a]/ˈmɔːrtl/; [adj]必有一死的;致命的;极端的; [n]人类; [or]yshx;
mortgage: [a]/ˈmɔːrɡɪdʒ/; [n]按揭贷款,抵押贷款; [v]抵押; [or]yshx;
mosaic: [a]/moʊˈzeɪɪk/; [n]镶嵌细工,马赛克; [adj]摩西的;拼花的; [vt]镶嵌;用马赛克装饰; [or]yshx;
motif: [a]/moʊˈtiːf/; [n]基本图案;主题,中心思想,<音>乐旨; [or]yshx;
motion: [a]/ˈmoʊʃn/; [n]运动,移动;手势;提议; [v]示意; [or]yshx;
motivate: [a]/ˈmoʊtɪveɪt/; [vt]激励;使有动机;促进;促动;激发..的积极性; [or]yshx;
motto: [a]/ˈmɑːtoʊ/; [n]座右铭;格言;箴言;口号; [or]yshx;
mount: [a]/maʊnt/; [v]登上;爬上;骑上;增长;组织,安排; [n]山;峰; [or]yshx;
mourn: [a]/mɔːrn/; [v]哀悼,哀伤; [or]yshx;
mucous: [a]/ˈmjuːkəs/; [adj]黏液的,似黏液的; [or]yshx;
muddle: [a]/ˈmʌdl/; [n]混乱,杂乱,(头脑的)糊涂; [v](使)混乱,(使)迷惑,混淆; [adj]引起困惑的;使人糊涂的;难以理解的; [or]yshx;
multiply: [a]/ˈmʌltɪplaɪ/; [v]乘;繁殖;增加; [or]yshx;
multitude: [a]/ˈmʌltɪtuːd/; [n]大量;众多;大批;群众; [or]yshx;
mundane: [a]/mʌnˈdeɪn/; [adj]普通的,平凡的;单调的;现世的,世俗的; [or]yshx;
murmur: [a]/ˈmɜːrmər/; [v]低声说,低语;低声抱怨; [n]低语;喃喃说话声; [or]yshx;
muscular: [a]/ˈmʌskjələr/; [adj]肌肉的;肌肉发达的;强有力的; [or]yshx;
mushroom: [a]/ˈmʌʃrʊm/; [n]蘑菇; [vi]迅速发展;采蘑菇; [or]yshx;
mustache: [a]/ˈmʌstæʃ/; [n]髭,小胡子;触须; [or]yshx;
muster: [a]/ˈmʌstər/; [vi]集合;聚集; [vt]集合;召集; [n]集合;集合人员; [or]yshx;
mutter: [a]/ˈmʌtər/; [n]低语;小声抱怨; [v]低声说;小声抱怨; [vt]低声说;抱怨地说; [or]yshx;
mutual: [a]/ˈmjuːtʃuəl/; [adj]互相的;彼此的;共同的; [or]yshx;
myriad: [a]/ˈmɪriəd/; [n]无数;极大数量; [adj]无数的; [or]yshx;
myth: [a]/mɪθ/; [n]神话;虚构的信念(或观念,理论);杜撰出来的人(或事物); [or]yshx;
mythology: [a]/mɪˈθɑːlədʒi/; [n]神话,神话学; [or]yshx;
naive: [a]/naɪˈiːv/; [adj]天真的; [n]天真的人; [or]yshx;
naked: [a]/ˈneɪkɪd/; [adj]裸体的,无遮蔽的; [or]yshx;
narcotic: [a]/nɑːrˈkɑːtɪk/; [n]麻醉药;镇静剂;毒品; [adj]麻醉的;催眠的; [or]yshx;
narrative: [a]/ˈnærətɪv/; [n]叙述; [adj]叙述的; [or]yshx;
nasty: [a]/ˈnæsti/; [adj]令人讨厌的;严重的;恶劣的;下流的; [n](复数形式)令人不愉快或对人有害的事物; [or]yshx;
natal: [a]/ˈneɪtl/; [adj]出生的;分娩的;与生俱来的; [or]yshx;
nausea: [a]/ˈnɔːziə/; [n]作呕,恶心; [or]yshx;
nautical: [a]/ˈnɔːtɪkl/; [adj]航海的;海上的;海员的; [or]yshx;
naval: [a]/ˈneɪvl/; [adj]海军的,军舰的; [or]yshx;
navigable: [a]/ˈnævɪɡəbl/; [adj](江河,海洋)可航行的,可通航的;(船)适航的; [or]yshx;
neat: [a]/niːt/; [adj]整洁的;灵巧的;纯的;不掺水的;干净利索的 (行动); [or]yshx;
neglect: [a]/nɪˈɡlekt/; [v]忽视;忽略;疏忽; [n]疏忽;忽视; [or]yshx;
negotiable: [a]/nɪˈɡoʊʃiəbl/; [adj]可谈判的,可商议的;可兑换现金的;可通行的(道路,河流); [or]yshx;
neurosis: [a]/nʊˈroʊsɪs/; [n]<心理>神经症,神经衰弱症; [or]yshx;
neurotic: [a]/nʊˈrɑːtɪk/; [adj]神经质的;神经官能病的; [n]神经病患者; [or]yshx;
neutralize: [a]/ˈnuːtrəlaɪz/; [v]宣布中立,使中立化;使无效;中和; [or]yshx;
nevertheless: [a]/ˌnevərðəˈles/; [adv]然而,不过;尽管如此,不过,仍然; [or]yshx;
nibble: [a]/ˈnɪbl/; [v]一点点地咬,慢慢啃,吹毛求疵; [n]细咬,轻咬,啃; [or]yshx;
nicety: [a]/ˈnaɪsəti/; [n]细节,讲究; [or]yshx;
nickel: [a]/ˈnɪkl/; [n]镍;美国五分镍币;五分钱; [or]yshx;
nil: [a]/nɪl/; [n]零;无; [or]yshx;
nobility: [a]/noʊˈbɪləti/; [n]贵族;高贵;高尚;高尚的精神; [or]yshx;
nominal: [a]/ˈnɑːmɪnl/; [adj]名义上的;象征性的,很少的;名词性的; [or]yshx;
nominate sb. for: [a]/ˈnɑːmɪneɪt ˈsʌmbədi fɔːr/; [v]提名,推荐; [or]yshx;
nominate: [a]/ˈnɑːmɪneɪt/; [v]提名;任命; [adj]有特定名字的;被提名的;被指定的; [or]yshx;
norm: [a]/nɔːrm/; [n]准则;模范;规范,标准; [or]yshx;
nostalgia: [a]/nəˈstældʒə/; [n]怀旧之情,思乡病; [or]yshx;
not to say: [a]/nɑːt tə seɪ/; [phr]并不是说; [or]yshx;
notable: [a]/ˈnoʊtəbl/; [n]著名人士; [adj]值得注意的,显著的,显要的; [or]yshx;
notary: [a]/ˈnoʊtəri/; [n]公证人;公证员; [or]yshx;
notation: [a]/noʊˈteɪʃn/; [n]记号;标记法;记录; [or]yshx;
notch: [a]/nɑːtʃ/; [n]刻痕,凹口;等级;峡谷; [v]赢得;用刻痕计算;在.上刻凹痕; [or]yshx;
nothing to do with: [a]/ˈnʌθɪŋ tu doʊ wɪθ/; [v]与.无关; [or]yshx;
notify: [a]/ˈnoʊtɪfaɪ/; [v]通知,告知;报告; [or]yshx;
notion: [a]/ˈnoʊʃn/; [n]概念,观念;观点,看法;突然的念头;意图; [or]yshx;
notorious: [a]/noʊˈtɔːriəs/; [adj]臭名昭著的,声名狼藉的; [or]yshx;
nought: [a]/nɔːt/; [n]无;零; [or]yshx;
nourish: [a]/ˈnɜːrɪʃ/; [v]养育;培育(希望);增强(希望); [or]yshx;
nourishment: [a]/ˈnɜːrɪʃmənt/; [n]食物,营养品; [or]yshx;
novel: [a]/ˈnɑːvl/; [n]小说,长篇故事; [adj]新奇的,新颖的,不同的; [or]yshx;
novice: [a]/ˈnɑːvɪs/; [n]生手,新手; [or]yshx;
nowhere: [a]/ˈnoʊwer/; [adv]任何地方都不;没有任何地方,无处;找不到;在不重要的地方;突然(发生); [n]无名之地;任何地方; [or]yshx;
noxious: [a]/ˈnɑːkʃəs/; [adj]有害的,有毒的; [or]yshx;
nuance: [a]/ˈnuːɑːns/; [n]细微差别; [or]yshx;
nucleus: [a]/ˈnuːkliəs/; [n]原子核,核心,细胞核; [or]yshx;
nuisance: [a]/ˈnuːsns/; [n]讨厌的人;麻烦事;伤害; [or]yshx;
null and void: [a]/nʌl ənd vɔɪd/; [phr]无效的; [or]yshx;
null: [a]/nʌl/; [adj]无效的;不存在的; [n]零; [or]yshx;
nullify: [a]/ˈnʌlɪfaɪ/; [v]使无效,废弃,取消; [or]yshx;
numb: [a]/nʌm/; [adj]麻木的,失去知觉的; [vt]使麻木,使失去知觉; [or]yshx;
numerate: [a]/ˈnuːmərət/; [v]列举;读(数); [adj]有计算能力的,数学基础好的; [or]yshx;
numerical: [a]/nuːˈmerɪkl/; [adj]数字的,用数字表示的; [or]yshx;
numerous: [a]/ˈnuːmərəs/; [adj]为数众多的,许多的; [or]yshx;
nursery: [a]/ˈnɜːrsəri/; [n]托儿所;保育室;苗圃; [or]yshx;
nurture: [a]/ˈnɜːrtʃər/; [v]养育,培育;培植; [n]养育,培养;教养;营养物; [or]yshx;
nutrition: [a]/nuˈtrɪʃn/; [n]营养,营养学; [or]yshx;
nylon: [a]/ˈnaɪlɑːn/; [n]尼龙,尼龙长袜; [or]yshx;
oar: [a]/ɔːr/; [n]桨,橹; [or]yshx;
oasis: [a]/oʊˈeɪsɪs/; [n]绿洲;令人欣慰的事物; [or]yshx;
oath: [a]/oʊθ/; [n]誓言;誓约;咒骂;咒语; [or]yshx;
obedient: [a]/oʊˈbiːdiənt/; [adj]服从的,顺从的;孝顺的; [or]yshx;
objective: [a]/əbˈdʒektɪv/; [n]目标;目的; [adj]客观的; [or]yshx;
obligatory: [a]/əˈblɪɡətɔːri/; [adj]强制性的;义务的;必须的; [or]yshx;
oblige: [a]/əˈblaɪdʒ/; [v]迫使,使感激,施恩于,帮忙,使.成为必要; [or]yshx;
oblique: [a]/əˈbliːk/; [adj]斜的,非直角的,隐射的; [v]倾斜; [n]<解>斜肌(尤指腹部的肌肉);倾斜物;<军>倾斜航空照片; [adv]<军>以45度角; [or]yshx;
oblivious: [a]/əˈblɪviəs/; [adj]不在意的;忘却的,健忘的; [or]yshx;
oblong: [a]/ˈɑːblɔːŋ/; [n]长方形,椭圆形; [adj]椭圆形的;长方形的; [or]yshx;
obnoxious: [a]/əbˈnɑːkʃəs/; [adj]非常讨厌的;可憎的; [or]yshx;
obscene: [a]/əbˈsiːn/; [adj]下流的,淫秽的; [or]yshx;
obscure: [a]/əbˈskjʊr/; [v]隐藏,使.模糊;使变暗;遮掩; [adj]不清楚的;难以理解的; [n]某种模糊的或不清楚的东西; [or]yshx;
observance: [a]/əbˈzɜːrvəns/; [n](法律习俗等的)遵守;奉行;庆祝,礼仪,仪式; [or]yshx;
observatory: [a]/əbˈzɜːrvətɔːri/; [n]天文台,气象台,瞭望台; [or]yshx;
obsess: [a]/əbˈses/; [vt]迷住,使着迷,使烦扰; [or]yshx;
obsolete: [a]/ˌɑːbsəˈliːt/; [adj]已过时的;已废弃的; [v]使过时;使作废; [n]废词;被废弃的事物; [or]yshx;
obstacle: [a]/ˈɑːbstəkl/; [n]障碍;障碍物;妨碍; [or]yshx;
obstinate: [a]/ˈɑːbstɪnət/; [adj]顽固的;较难治愈的; [or]yshx;
obstruct: [a]/əbˈstrʌkt/; [v]阻碍,妨碍,阻塞,堵塞; [or]yshx;
obvious: [a]/ˈɑːbviəs/; [adj]明显的,显然的;了无新意的;显而易见的; [or]yshx;
occasion: [a]/əˈkeɪʒn/; [n]场合,时候;活动;时机,机会; [v]导致;引起; [or]yshx;
occupy: [a]/ˈɑːkjupaɪ/; [v]占领,占据,侵占;住在,居住,住进;担任(职务),任职;占用(时间,空间等),占有;使用(房屋,建筑); [or]yshx;
occur: [a]/əˈkɜːr/; [vi]发生;出现,存在; [or]yshx;
odd: [a]/ɑːd/; [adj]奇怪的;古怪的;奇数的;多种多样的;临时的; [n]奇特的事物;怪人;<高尔夫球>多于对方的一次击球; [adv](用于数字后)大约,左右,略多; [or]yshx;
odor: [a]/ˈoʊdər/; [n]气味; [or]yshx;
odyssey: [a]/ˈɑːdəsi/; [n]长途冒险旅行;一连串的冒险;奥德赛; [or]yshx;
off-hand: [a]/'ɔːfh'ænd/; [adj]不拘礼节的;临时的,未经准备的; [adv]当即,立即; [or]yshx;
offend: [a]/əˈfend/; [v]冒犯,得罪,伤害.的感情; [or]yshx;
offer: [a]/ˈɔːfər/; [n]提供;特价;出价;录取(用)通知书;提议; [vt]给予,奉上;表示愿意 (做某事);提供;出价; [or]yshx;
offset: [a]/ˈɔːfset/; [v]抵消; [adj]胶印的,透印版印刷的; [n]分支;抵销; [or]yshx;
offshore: [a]/ˌɔːfˈʃɔːr/; [adj]近海的,海岸的;(公司) 设在海外的; [adv]离岸地,近海地; [or]yshx;
offspring: [a]/ˈɔːfsprɪŋ/; [n]后代; [or]yshx;
omen: [a]/ˈoʊmən/; [n]征兆,预兆; [vt]预示;预告;有.的前兆; [or]yshx;
ominous: [a]/ˈɑːmɪnəs/; [adj]不祥的,不吉利的; [or]yshx;
omit: [a]/əˈmɪt/; [v]删去,省去,忽略;遗漏; [or]yshx;
on account of: [a]/ɑːn ə'kaʊnt əv/; [phr]因为; [or]yshx;
on and off: [a]/ɔn ənd ɑf/; quant. 断断续续地; [or]yshx;
on and on: [a]/ɔn ənd ɔn/; [phr]继续不停地; [or]yshx;
on behalf of: [a]/ɔn bɪˈhæf ɑv/; [phr]代表.,为了.; [or]yshx;
on end: [a]/ɔn end/; [adv]直立; [or]yshx;
on hand: [a]/ɔn hænd/; [adv]手头现有; [or]yshx;
on no account: [a]/ɔn noʊ əˈkaʊnt/; [adv]决不; [or]yshx;
on the air: [a]/ɔn ðə er/; [phr]直播中; [or]yshx;
on time: [a]/ɑːn taɪm/; [adv]准时; [or]yshx;
once (and) for all: [a]/wʌns ənd fɔːr ɔːl/; [adv]只此一次,彻底地; [or]yshx;
once more: [a]/wʌns mɔr/; [adv]再一次; [or]yshx;
one another: [a]/ˌwʌn əˈnʌðər/; [pron]彼此; [or]yshx;
ongoing: [a]/ˈɑːnɡoʊɪŋ/; [n]进行,前进,发展; [adj]进行中的,不间断的; [or]yshx;
onset: [a]/ˈɑːnset/; [n]开始;攻击,袭击; [or]yshx;
opaque: [a]/oʊˈpeɪk/; [adj]不透明的;难懂的; [or]yshx;
open one's eyes to: [a]/ˈoʊpən wʌnz aɪz tu/; [phr]使某人看清; [or]yshx;
opening: [a]/ˈoʊpnɪŋ/; [n]开口;孔;开始;开幕;职位空缺; [adj]开始的,开场的; [or]yshx;
opinion: [a]/əˈpɪnjən/; [n]意见,看法,主张; [or]yshx;
opportunity: [a]/ˌɑːpərˈtuːnəti/; [n]机会,良机; [or]yshx;
oppose: [a]/əˈpoʊz/; [v]反对;反抗; [or]yshx;
opposite: [a]/ˈɑːpəzɪt/; [adj]相反的;对立的;对面的; [adv]对立地;反面地; [n]对立物;反义词; prep. 与.相对;在.对面;与.合演;与.联袂演出; [or]yshx;
opt: [a]/ɑːpt/; [v]选择; [or]yshx;
optimism: [a]/ˈɑːptɪmɪzəm/; [n]乐观,乐观主义; [or]yshx;
optimum: [a]/ˈɑːptɪməm/; [adj]最适宜的;最佳的; [n]最适条件;最适宜; [or]yshx;
orbit: [a]/ˈɔːrbɪt/; [v]环绕..的轨道运行; [n]轨道; [vi]环绕..的轨道运行; [or]yshx;
orchestra: [a]/ˈɔːrkɪstrə/; [n]管弦乐队; [adj]管弦乐队的; [or]yshx;
ordeal: [a]/ɔːrˈdiːl/; [n]严峻考验,苦难的经历,折磨; [or]yshx;
orderly: [a]/ˈɔːrdərli/; [adj]有秩序的,整齐的,有条不紊的; [or]yshx;
ore: [a]/ɔːr/; [n]矿石;矿砂;矿,矿石; [or]yshx;
organ: [a]/ˈɔːrɡən/; [n]器官;风琴; [or]yshx;
organism: [a]/ˈɔːrɡənɪzəm/; [n]生物,有机体;有机的组织; [or]yshx;
oriental: [a]/ˌɔːriˈentl/; [adj]东方的; [n]东方人; [or]yshx;
orientate oneself: [a]/ˈɔriənˌteɪt wʌnˈself/; [v]确认方位,地址; [or]yshx;
orientate: [a]/ˈɔːriənteɪt/; [v]给.定位;使适应; [or]yshx;
original: [a]/əˈrɪdʒənl/; [adj]有独创性的,原始的,最初的,新颖的; [n]原件;怪人; [or]yshx;
originate: [a]/əˈrɪdʒɪneɪt/; [vi]起源;开始; [vt]开创; [or]yshx;
ornament: [a]/ˈɔːrnəmənt/; [n]装饰; [v]装饰; [or]yshx;
orthodox: [a]/ˈɔːrθədɑːks/; [adj]正统的;传统的;(Orthodox)东正教的; [or]yshx;
ostensible: [a]/ɑːˈstensəbl/; [adj]表面上的,伪装的; [or]yshx;
ostentation: [a]/ˌɑːstenˈteɪʃn/; [n]卖弄,炫耀; [or]yshx;
oust: [a]/aʊst/; [v]罢免,驱逐,剥夺,取代; [or]yshx;
out of line (with): [a]/aʊt ʌv laɪn wɪθ/; [phr]跟.(不)一致; [or]yshx;
out of stock: [a]/aʊt ɑv stɒk/; [v]无存货,已脱销; [or]yshx;
outbreak: [a]/ˈaʊtbreɪk/; [n](战争,叛乱,感情等的)爆发;突然发生; [vi]爆发; [or]yshx;
outcast: [a]/ˈaʊtkæst/; [n]被逐出者;流浪者; [adj]被抛弃的,被逐出的; [or]yshx;
outcome: [a]/ˈaʊtkʌm/; [n]结果,后果; [or]yshx;
outcry: [a]/ˈaʊtkraɪ/; [n]大声喊叫;强烈抗议;拍卖; [or]yshx;
outdated: [a]/ˌaʊtˈdeɪtɪd/; [adj]过时的,老式的;落伍的; [or]yshx;
outfit: [a]/ˈaʊtfɪt/; [n]装备,全部用品,(协同工作)的一组人; [v]提供装备; [or]yshx;
outlaw: [a]/ˈaʊtlɔː/; [n]歹徒,逃犯,丧失公权者; [v]将..放逐,宣布..为不合法; [or]yshx;
outlet: [a]/ˈaʊtlet/; [n]出口;插座;表现机会,发泄方法;廉价经销店; [or]yshx;
outline: [a]/ˈaʊtlaɪn/; [n]外形,轮廓;大纲,概要; [v]描绘,画出..的轮廓; [or]yshx;
outlying: [a]/ˈaʊtlaɪɪŋ/; [adj]远离中心的;边远的; [or]yshx;
output: [a]/ˈaʊtpʊt/; [n]产量,输出; [vt]生产,出产,制造;输出; [vi]生产,出产,制造;输出; [or]yshx;
outrageous: [a]/aʊtˈreɪdʒəs/; [adj]粗暴的,无礼的; [or]yshx;
outright: [a]/ˈaʊtraɪt/; [adj]完全的,彻底的,全部地;直率的; [adv]完全地;直率地,痛快地;直截了当地; [or]yshx;
outset: [a]/ˈaʊtset/; [n]开始,开端; [or]yshx;
outskirts: [a]/ˈaʊtskɜːrts/; [n](尤指城市)郊区; [or]yshx;
outspoken: [a]/aʊtˈspoʊkən/; [adj]直言的,坦率的; [or]yshx;
outweigh: [a]/ˌaʊtˈweɪ/; [v]比..重要;比..有价值;比.重; [or]yshx;
oval: [a]/ˈoʊvl/; [adj]椭圆形的; [n]椭圆形; [or]yshx;
ovation: [a]/oʊˈveɪʃn/; [n]热烈欢迎,欢呼; [or]yshx;
overall: [a]/ˌoʊvərˈɔːl/; [adj]全面的,全部的; [n]罩衫,工装裤; [adv]总的来说;总共; [or]yshx;
overcome: [a]/ˌoʊvərˈkʌm/; [v]战胜;克服;压倒;得胜,征服; [or]yshx;
overdue: [a]/ˌoʊvərˈduː/; [adj]过期的;迟到的;未兑的; [or]yshx;
overflow: [a]/ˌoʊvərˈfloʊ/; [v]满得外溢,外流,泛滥;充满,洋溢; [n]溢流口,溢流管;容纳不下的物(或人);溢出,满出;超出额; [adj]充满的; [or]yshx;
overhaul: [a]/ˌoʊvərˈhɔːl/; [n]大修;全面检查;彻底革新; [vt]解体检修,大修;彻底革新; [or]yshx;
overhear: [a]/ˌoʊvərˈhɪr/; [v]无意中听到,偷听到; [or]yshx;
overlap: [a]/ˌoʊvərˈlæp/; [n]重叠,重复; [v](部分地)重叠; [or]yshx;
overlook: [a]/ˌoʊvərˈlʊk/; [v]忽视,未注意到;眺望,俯视; [n]忽视,远眺; [or]yshx;
overrule: [a]/ˌoʊvərˈruːl/; [v]否决,驳回;统治;对...施加影响; [or]yshx;
overrun: [a]/ˈoʊvərʌn/; [v]溢出,泛滥;(侵略军)横行; [n]泛滥成灾;超出限度; [or]yshx;
oversee: [a]/ˌoʊvərˈsiː/; [v]监督;偷看到,无意中看到;审查;俯瞰; [or]yshx;
overt: [a]/oʊˈvɜːrt/; [adj]明显的;公开的;公然的; [or]yshx;
overtake: [a]/ˌoʊvərˈteɪk/; [v]超过,赶上;突然降临; [or]yshx;
overture: [a]/ˈoʊvərtʃər/; [n]主动表示,姿态;前奏曲;序言,事件的开端;提出问题; [vt]作为一种主动姿态提出;向.提出建议; [or]yshx;
overwhelm: [a]/ˌoʊvərˈwelm/; [v]压垮;不知所措;淹没;打败,压倒; [or]yshx;
overwrought: [a]/ˌoʊvərˈrɔːt/; [adj]过分紧张的,过度兴奋的; [or]yshx;
owe: [a]/oʊ/; [v]感谢;欠;把.归于;占有;欠钱; [or]yshx;
ownership: [a]/ˈoʊnərʃɪp/; [n]所有权; [or]yshx;
pace: [a]/peɪs/; [n]速度;步,步伐; [v]踱步; [or]yshx;
pad: [a]/pæd/; [n]衬垫;护具;便笺簿;(动物的)脚;浮叶; [v]填塞; [or]yshx;
paddle: [a]/ˈpædl/; [n]桨; [v]用脚(手)划水,荡桨; [or]yshx;
pageant: [a]/ˈpædʒənt/; [n]盛会,历史剧,选美; [or]yshx;
painstaking: [a]/ˈpeɪnzteɪkɪŋ/; [adj](不辞)劳苦的,辛勤的; [n]辛劳,煞费苦心; [or]yshx;
palatable: [a]/ˈpælətəbl/; [adj]美味的,合口味的,合心意的; [or]yshx;
palm: [a]/pɑːm/; [n]手掌,手心,棕榈树; [or]yshx;
palpitate: [a]/ˈpælpɪteɪt/; [v](心脏)悸动,发抖; [or]yshx;
pamper: [a]/ˈpæmpər/; [v]纵容,过分关怀,精心照料; [or]yshx;
pamphlet: [a]/ˈpæmflət/; [n]小册子; [or]yshx;
panel: [a]/ˈpænl/; [n]讨论小组;仪表板;面,板; [v]嵌镶; [or]yshx;
panic: [a]/ˈpænɪk/; [n]恐慌;惊慌;慌乱; [v](使)恐慌;使..惊慌失措; [adj]恐慌的,惊慌的; [or]yshx;
panorama: [a]/ˌpænəˈræmə/; [n]全景,概观; [or]yshx;
pant: [a]/pænt/; [v]喘息;气喘吁吁地说;喘气; [n]喘气; [or]yshx;
pants: [a]/pænts/; [n]裤子,短裤; [or]yshx;
parachute: [a]/ˈpærəʃuːt/; [n]降落伞; [v]跳伞; [or]yshx;
parade: [a]/pəˈreɪd/; [n]游行,检阅; [v]游行,(使)列队行进,炫耀; [or]yshx;
paradise: [a]/ˈpærədaɪs/; [n]天国;天堂;极乐世界; [or]yshx;
paradox: [a]/ˈpærədɑːks/; [n]矛盾;似矛盾而正确的说法; [or]yshx;
parallel: [a]/ˈpærəlel/; [adj]平行的;相似的; [n]相似物;平行线; [v]与..相似;与..匹配; [adv]并行地,平行地; [or]yshx;
paralyze: [a]/ˈperəˌlaɪz/; [vt]使瘫痪;使麻痹;使不能活动; [or]yshx;
paramount: [a]/ˈpærəmaʊnt/; [n]元首;最高; [adj]最高的,至上的,首要的; [or]yshx;
paranoia: [a]/ˌpærəˈnɔɪə/; [n](心理)偏执狂,多疑症; [or]yshx;
paraphrase: [a]/ˈpærəfreɪz/; [v]解释,释义; [n]转述,释义; [or]yshx;
parasite: [a]/ˈpærəsaɪt/; [n]寄生虫;靠他人为生的人; [or]yshx;
parliament: [a]/ˈpɑːrləmənt/; [n]议会;国会; [or]yshx;
partial: [a]/ˈpɑːrʃl/; [adj]偏爱的,特别喜欢的;偏袒的,不公平的,有偏见的;部分的;不完全的; [n]<数学>偏微商; [or]yshx;
participate: [a]/pɑːrˈtɪsɪpeɪt/; [v]参与,加入; [or]yshx;
particle: [a]/ˈpɑːrtɪkl/; [n]粒子,微粒;<语>小品词; [or]yshx;
pass away: [a]/pæs əˈweɪ/; [v]死,逝世; [or]yshx;
pass off: [a]/pæs ɑf/; [v]冒充,误导使把.当做.;发生; [or]yshx;
pass on: [a]/pæs ɔn/; [phr]传给;去世; [or]yshx;
pass over: [a]/pæs ˈoʊvər/; [v]忽略;不注意; [or]yshx;
pass sb. (sth.) by: [a]/pæs ˈsʌmbədi ˈsʌmθɪŋ baɪ/; [phr]经过,走过;打..旁边走过;忽视; [or]yshx;
pass sth. off: [a]/pæs ˈsʌmθɪŋ ɔːf/; [phr]冒充,假装;蒙混过去,敷衍过去,搪塞过去; [or]yshx;
pass sth. on to: [a]/pæs ˈsʌmθɪŋ ɔːn tu/; [v]把.交给.; [or]yshx;
pass the time of day with: [a]/pæs ðə taɪm ɑv deɪ wɪθ/; [v]交谈;共渡; [or]yshx;
passion: [a]/ˈpæʃn/; [n]激情; [or]yshx;
passive: [a]/ˈpæsɪv/; [adj]被动的;消极的; [n]被动语态; [or]yshx;
pastime: [a]/ˈpæstaɪm/; [n]消遣,娱乐; [or]yshx;
pasture: [a]/ˈpæstʃər/; [n]牧场,草地;生活状况; [v]放牧; [or]yshx;
patch: [a]/pætʃ/; [n]补丁;眼罩;斑点; [v]打补丁;修补;匆忙拼凑; [or]yshx;
patent: [a]/ˈpætnt/; [n]专利; [adj]显然的,明显的;专利的;独创的; [v]取得.的专利权; [or]yshx;
pathetic: [a]/pəˈθetɪk/; [adj]可怜的;不足的; [or]yshx;
pathos: [a]/ˈpeɪθɑːs/; [n]悲怆,哀婉;痛苦; [or]yshx;
patio: [a]/ˈpætioʊ/; [n]屋内庭院,天井;平台; [or]yshx;
patriotism: [a]/ˈpeɪtriətɪzəm/; [n]爱国主义,爱国心,爱国精神; [or]yshx;
patrol: [a]/pəˈtroʊl/; [n]巡逻兵;巡逻; [v]巡逻;巡查,巡游; [or]yshx;
patron: [a]/ˈpeɪtrən/; [n]老主顾;赞助人;支持者; [or]yshx;
pave: [a]/peɪv/; [v]铺(路),铺筑; [or]yshx;
pay for: [a]/peɪ fɔr/; [phr]付出代价,出钱;因.受处罚,为.而付钱; [or]yshx;
pay off: [a]/peɪ ɔːf/; [v]付清;取得成功,使得益;贿赂;报复; [or]yshx;
pay sb. back for sth.: [a]/peɪ ˈsʌmbədi bæk fɔːr ˈsʌmθɪŋ/; [phr]向.报复,报答; [or]yshx;
pay sb. back: [a]/peɪ ˈsʌmbədi bæk/; [v]还债;受到惩罚; [or]yshx;
pay up: [a]/peɪ ʌp/; [v]付清,结账; [or]yshx;
peculiar: [a]/pɪˈkjuːliər/; [adj]奇怪的,古怪的;特有的,特别的; [or]yshx;
pedal: [a]/ˈpedl/; [n]踏脚板; [v]踏踩板; [adj]脚踏的; [vt]踏.的踏板; [or]yshx;
peel: [a]/piːl/; [v]剥皮,削皮,去壳; [n]果皮,外皮; [or]yshx;
peer: [a]/pɪr/; [n]同龄人,同等地位的人;贵族; [v]仔细看,费力地看; [or]yshx;
penalty: [a]/ˈpenəlti/; [n]惩罚,处罚,不利,罚球; [adj]处罚的; [or]yshx;
pendulum: [a]/ˈpendʒələm/; [n]摆,钟摆;摇摆不定的事态(或局面); [or]yshx;
penetrate: [a]/ˈpenətreɪt/; [v]刺穿,穿透;进入;了解; [or]yshx;
pension: [a]/ˈpenʃn/; [n]养老金,抚恤金;廉租屋; [v]发给..养老金; [or]yshx;
perceive: [a]/pərˈsiːv/; [v]意识到,察觉,发觉;看待,理解; [or]yshx;
percussion: [a]/pərˈkʌʃn/; [n]撞击,敲击;敲打乐器; [or]yshx;
perennial: [a]/pəˈreniəl/; [adj]终年的,永久的;四季不断的;反复的; [n]多年生植物; [or]yshx;
performance: [a]/pərˈfɔːrməns/; [n]表演,演出;表现;执行;性能; [or]yshx;
perfume: [a]/pərˈfjuːm/; [n]香水;香气; [v]使充满芳香;洒香水于; [or]yshx;
peril: [a]/ˈperəl/; [n]危险; [vt]置.于危险中;危及; [or]yshx;
perimeter: [a]/pəˈrɪmɪtər/; [n]周长;周界; [or]yshx;
periodical: [a]/ˌpɪriˈɑːdɪkl/; [n]期刊;杂志; [or]yshx;
periscope: [a]/ˈperɪskoʊp/; [n]潜望镜; [or]yshx;
perish: [a]/ˈperɪʃ/; [vi]死去;毁灭,灭亡; [v]脆裂,老化,腐烂; [or]yshx;
permanent: [a]/ˈpɜːrmənənt/; [adj]永久的,持久的; [n]电烫发; [or]yshx;
permeate through (among): [a]/ˈpɜːrmieɪt θruː əˈmʌŋ/; [phr]渗透,透入; [or]yshx;
permeate: [a]/ˈpɜːrmieɪt/; [v]弥漫;普及;渗透; [or]yshx;
permissible: [a]/pərˈmɪsəbl/; [adj]容许的;许可的; [or]yshx;
perpendicular: [a]/ˌpɜːrpənˈdɪkjələr/; [adj]成直角的,垂直的;直立的; [n]垂直线; [or]yshx;
perpetual: [a]/pərˈpetʃuəl/; [adj]永远的,永恒的;不断的; [or]yshx;
perplex: [a]/pərˈpleks/; [v]使困惑; [or]yshx;
persecute: [a]/ˈpɜːrsɪkjuːt/; [v](尤指因宗教或政治信仰不同)迫害;烦扰,纠缠; [or]yshx;
persevere with: [a]/ˌpɜːrsəˈvɪr wɪð/; [v]坚持,不屈不挠; [or]yshx;
persevere: [a]/ˌpɜːrsəˈvɪr/; [v]坚持,不屈不挠; [or]yshx;
persist: [a]/pərˈsɪst/; [v]坚持,固执;继续存留; [or]yshx;
personality: [a]/ˌpɜːrsəˈnæləti/; [n]个性,性格;个性鲜明的人;(娱乐界或体育界的)名人; [or]yshx;
personnel: [a]/ˌpɜːrsəˈnel/; [n]人事部门,员工,人员; [or]yshx;
perspective: [a]/pərˈspektɪv/; [n]角度,视角,观点,想法;(对事物的)合理判断,正确认识;远景;透视图,透视法,透视效果; [adj]透视的; [or]yshx;
perspire: [a]/pərˈspaɪər/; [v]出汗,流汗; [or]yshx;
pertain: [a]/pərˈteɪn/; [vi]属于;适合;有关; [or]yshx;
pertinent: [a]/ˈpɜːrtnənt/; [adj]有关的;适当的;中肯的; [n]附属物;参考; [or]yshx;
perturb: [a]/pərˈtɜːrb/; [vt]使不安;烦扰;使紊乱; [or]yshx;
pervade: [a]/pərˈveɪd/; [vt]普及;渗透;弥漫; [vi]弥漫;渗透; [or]yshx;
perverse: [a]/pərˈvɜːrs/; [adj]邪恶的;堕落的;倔强的;违反常情的; [or]yshx;
pervert: [a]/ˈpɜːrvɜːrt/; [v]使堕落,误导,曲解; [n]变态,色狼; [or]yshx;
pessimism: [a]/ˈpesɪmɪzəm/; [n]悲观,悲观主义; [or]yshx;
pester: [a]/ˈpestər/; [v]使烦恼,纠缠; [or]yshx;
pesticide: [a]/ˈpestɪsaɪd/; [n]杀虫剂;农药; [or]yshx;
petal: [a]/ˈpetl/; [n]花瓣; [or]yshx;
petition: [a]/pəˈtɪʃn/; [n]请愿;请愿书;祈求; [v]请愿; [or]yshx;
petroleum: [a]/pəˈtroʊliəm/; [n]石油; [or]yshx;
petty: [a]/ˈpeti/; [adj]价值不大的;小的;器量小的;琐碎的; [or]yshx;
pharmaceutical: [a]/ˌfɑːrməˈsuːtɪkl/; [adj]制药的,药物的; [n]药物; [or]yshx;
phase out: [a]/feɪz aʊt/; [v]逐渐淘汰; [or]yshx;
phenomenal: [a]/fəˈnɑːmɪnl/; [adj]非凡的;现象的;显著的; [or]yshx;
phobia: [a]/ˈfoʊbiə/; [n]恐惧症; [or]yshx;
phonetic: [a]/fəˈnetɪk/; [adj]语音的; [or]yshx;
physician: [a]/fɪˈzɪʃn/; [n]内科医生; [or]yshx;
physiological: [a]/ˌfɪziəˈlɑːdʒɪkl/; [adj]生理的,生理学的; [or]yshx;
physique: [a]/fɪˈziːk/; [n]体格,体魄; [or]yshx;
pick sb. (sth.) out: [a]/pɪk ˈsʌmbədi ˈsʌmθɪŋ aʊt/; [v]选出;认出,挑选; [or]yshx;
pick sb. up: [a]/pɪk ˈsʌmbədi ʌp/; [v]结识;中途搭乘;举起; [or]yshx;
pick sth. up: [a]/pɪk ˈsʌmθɪŋ ʌp/; [v]买;得到;知道;捡起; [or]yshx;
picturesque: [a]/ˌpɪktʃəˈresk/; [adj]似画的,生动的; [or]yshx;
piecemeal: [a]/ˈpiːsmiːl/; [n]片;块; [v]粉碎; [adv]零碎地;逐个地; [adj]零碎的;逐渐的; [or]yshx;
pier: [a]/pɪr/; [n]码头;桥墩; [or]yshx;
pierce: [a]/pɪrs/; [v]穿(孔);贯穿;突破; [or]yshx;
pigment: [a]/ˈpɪɡmənt/; [n]天然色素,颜料; [or]yshx;
pilgrim: [a]/ˈpɪlɡrɪm/; [n]朝圣客;香客; [or]yshx;
pillar: [a]/ˈpɪlər/; [n]柱,台柱,栋梁; [or]yshx;
pillow: [a]/ˈpɪloʊ/; [n]枕头; [v]垫,枕着; [or]yshx;
pilot: [a]/ˈpaɪlət/; [n]领航员;飞行员; [adj]试验性的; [v]给..领航,驾驶;试验; [or]yshx;
pimple: [a]/ˈpɪmpl/; [n]丘疹,脓疱; [or]yshx;
pin: [a]/pɪn/; [v]别住,钉住,固定住; [n]别针,饰针; [or]yshx;
pinch: [a]/pɪntʃ/; [v]捏,掐,夹痛; [n]捏;少量,一撮;困苦; [or]yshx;
pine: [a]/paɪn/; [n]松树; [v](因死亡,离别等)难过,悲伤; [or]yshx;
pinnacle: [a]/ˈpɪnəkl/; [n](哥德式建筑的)小尖塔,顶峰; [v]置于尖顶上,置于高处; [or]yshx;
pinpoint: [a]/ˈpɪnpɔɪnt/; [v]准确地解释或说明; [adj]精确的; [n]针尖,极小之物,极不重要的事物; [or]yshx;
piracy: [a]/ˈpaɪrəsi/; [n]海上掠夺;剽窃;侵犯版权; [or]yshx;
piston: [a]/ˈpɪstən/; [n]活塞,瓣; [or]yshx;
pit: [a]/pɪt/; [n]大坑,矿井;(赛车道旁的) 检修加油站; [v]除去(水果的)核;使凹陷; [or]yshx;
pitch: [a]/pɪtʃ/; [v]投掷;用沥青覆盖;<音>为...定音高;扎营;搭帐篷; [n]投掷;球场;沥青;音高; [or]yshx;
pivot: [a]/ˈpɪvət/; [n]枢轴,中心; [v]以..为中心转动; [adj]枢轴的;关键的; [or]yshx;
placid: [a]/ˈplæsɪd/; [adj]安静的,平和的; [or]yshx;
plagiarize: [a]/ˈpleɪdʒəraɪz/; [v]剽窃,抄袭(别人学说,著作); [or]yshx;
plague: [a]/pleɪɡ/; [n]瘟疫;灾难;麻烦; [v]折磨;烦扰;造成麻烦; [or]yshx;
plaintive: [a]/ˈpleɪntɪv/; [adj]表示悲痛的,伤心的; [or]yshx;
planetarium: [a]/ˌplænɪˈteriəm/; [n]天文馆,行星仪; [or]yshx;
plank: [a]/plæŋk/; [n]厚木板;木板制成物;政纲条款;要点; [v]在..上铺板;砰一声放下;用菜板端出; [or]yshx;
plantation: [a]/plænˈteɪʃn/; [n]农场;种植园;栽植; [or]yshx;
plaster: [a]/ˈplæstər/; [n]灰泥,石膏; [v]抹泥; [or]yshx;
plateau: [a]/plæˈtoʊ/; [n]高原; [vi]到达平稳阶段; [or]yshx;
platform: [a]/ˈplætfɔːrm/; [n]站台;平台;讲台;舞台;论坛; [or]yshx;
platitude: [a]/ˈplætɪtuːd/; [n]陈词滥调,老生常谈;单调; [or]yshx;
plausible: [a]/ˈplɔːzəbl/; [adj]似乎有理的;巧嘴的; [or]yshx;
plea: [a]/pliː/; [n](法律)抗辩;恳求;请求,托词,口实; [or]yshx;
plead for sb.: [a]/pliːd fɔːr ˈsʌmbədi/; [v]恳求;为.辩护; [or]yshx;
plead guilty (not guilty): [a]/pliːd ˈɡɪlti nɑːt ˈɡɪlti/; [v]服罪(不服罪); [or]yshx;
pledge: [a]/pledʒ/; [v]发誓,保证,以.抵押,向.祝酒; [n]保证,誓言; [or]yshx;
pliable: [a]/ˈplaɪəbl/; [adj]易弯的;柔韧的;圆滑的; [or]yshx;
plight: [a]/plaɪt/; [n]困境; [v]宣誓,保证; [or]yshx;
plot: [a]/plɑːt/; [n]情节,阴谋,小块土地; [v]密谋,计划,为小说写情节; [or]yshx;
plow: [a]/plau/; [v]犁,耕; [n]犁; [or]yshx;
plug: [a]/plʌɡ/; [vi]堵塞;插入(插头); [vt]塞; [n]塞子;插头; [or]yshx;
plummet: [a]/ˈplʌmɪt/; [v]垂直或突然地堕下,骤然下降; [n]测锤(钓丝的)坠子;线锤;铅锤线;锤规; [or]yshx;
plunder: [a]/ˈplʌndər/; [v]抢劫,掠夺; [n]抢劫,战利品; [or]yshx;
plunge: [a]/plʌndʒ/; [v]跳进,(使)投入;使陷入;暴跌; [n]卷入,参与;暴跌,骤减; [or]yshx;
plus: [a]/plʌs/; prep. 加,加上; [n]加号;有利因素; [adj]正的,多的;有利的;阳性的; [conj]此外,而且,况且; [or]yshx;
pointed: [a]/ˈpɔɪntɪd/; [adj]尖锐的;率直的; [or]yshx;
poise: [a]/pɔɪz/; [v]使相等,使平衡; [n]泰然自若,信心; [or]yshx;
poke: [a]/poʊk/; [v]刺,戳;拨开,拨(弄);探(出),露出; [n]戳,捅; [or]yshx;
pole: [a]/poʊl/; [n]杆,竿极(点);磁极;电极; [or]yshx;
policy: [a]/ˈpɑːləsi/; [n]保险单;政策,方针;原则,策略; [or]yshx;
polish: [a]/ˈpɑːlɪʃ/; [v]磨光,擦亮;润饰,使优美; [n]擦光剂;优美,完善; [adj]波兰的;波兰人的;波兰语的; [or]yshx;
pollinate: [a]/ˈpɑːləneɪt/; [vt]传花粉给.; [or]yshx;
pompous: [a]/ˈpɑːmpəs/; [adj]傲慢的,浮华的; [or]yshx;
ponder: [a]/ˈpɑːndər/; [v]仔细考虑,沉思; [or]yshx;
ponderous: [a]/ˈpɑːndərəs/; [adj]笨重的,笨拙的,沉闷的; [or]yshx;
porcelain: [a]/ˈpɔːrsəlɪn/; [adj]瓷的;精美的;易碎的; [n]瓷,瓷器; [or]yshx;
porch: [a]/pɔːrtʃ/; [n]门廊;走廊; [or]yshx;
porous: [a]/ˈpɔːrəs/; [adj]可渗透的,多孔的,可穿越的; [or]yshx;
port: [a]/pɔːrt/; [n]舷窗;舱门;港口城市;葡萄酒;港,港口; [or]yshx;
portfolio: [a]/pɔːrtˈfoʊlioʊ/; [n]公文包,文件夹,投资组合;股份单; [or]yshx;
portion: [a]/ˈpɔːrʃn/; [n]一部分,份额,分担的责任; [v]把.分成份额,分配; [or]yshx;
pose: [a]/poʊz/; [n]姿势;装腔作势,伪装; [vi]摆造型; [vt]主张,提出;引起,导致; [or]yshx;
positive: [a]/ˈpɑːzətɪv/; [adj]积极的;肯定的,明确的;正面的;阳性的; [n]正面;肯定;优点;正数; [or]yshx;
possession: [a]/pəˈzeʃn/; [n]财产,所有物,拥有;控球; [or]yshx;
postage: [a]/ˈpoʊstɪdʒ/; [n]邮费,邮资; [or]yshx;
poster: [a]/ˈpoʊstər/; [n]海报,张贴的大幅广告;贴标语的人; [or]yshx;
postgraduate: [a]/ˌpoʊstˈɡrædʒuət/; [n]研究生; [adj]大学毕业后的,研究生的; [or]yshx;
posthumous: [a]/ˈpɑːstʃəməs/; [adj]遗腹的;著作者死后出版的;死后的; [or]yshx;
postmortem: [a]/ˌpoʊs(t)ˈmɔrtəm/; [n]验尸,尸体解剖; [adj]事后的,死后的,事后检查或详论的; [or]yshx;
postpone: [a]/poʊˈspoʊn/; [v]延迟,推迟,延缓; [or]yshx;
postscript: [a]/ˈpoʊstskrɪpt/; [n]附言;后评; [or]yshx;
potent: [a]/ˈpoʊtnt/; [adj]强有力的;有权势的;有说服力的; [or]yshx;
potential: [a]/pəˈtenʃl/; [n]潜力,潜能; [adj]潜在的,可能的; [or]yshx;
potion: [a]/ˈpoʊʃn/; [n]一剂,一服;毒药,魔药; [or]yshx;
pottery: [a]/ˈpɑːtəri/; [n]陶器;陶艺;陶艺厂; [or]yshx;
poultry: [a]/ˈpoʊltri/; [n]家禽(肉); [or]yshx;
pounce: [a]/paʊns/; [n]猛扑,飞扑; [vi]猛扑,突然袭击; [vt]扑过去抓住; [or]yshx;
pour: [a]/pɔːr/; [v]注,倒,灌;下(雨);不断地大量投入,倾注; [n]倾泻;倾盆大雨; [or]yshx;
poverty: [a]/ˈpɑːvərti/; [n]贫困;贫穷; [or]yshx;
practicable: [a]/ˈpræktɪkəbl/; [adj]能实行的,行得通的;适用的,能用的;可通行的; [or]yshx;
practical: [a]/ˈpræktɪkl/; [adj]实际的,实用的,实践的,切合实际的;〔人〕注重实际的,务实的;〔计划,方法等〕有效的,切实可行的;心灵手巧的; [n]实习课;实践课;实验考核; [or]yshx;
practitioner: [a]/prækˈtɪʃənər/; [n](医生或律师等)开业者;实践者,从事者; [or]yshx;
pragmatic: [a]/præɡˈmætɪk/; [adj]国事的,团体事务的;实际的,注重实效的; [n]爱管闲事的人;专断的人;国事诏书;实际家; [or]yshx;
preach: [a]/priːtʃ/; [v]传教,布道;说教;宣扬; [or]yshx;
precarious: [a]/prɪˈkeriəs/; [adj]不稳定的;危险的;可疑的;说不定的; [or]yshx;
precaution: [a]/prɪˈkɔːʃn/; [n]预防措施; [or]yshx;
preceding: [a]/prɪˈsiːdɪŋ/; [adj]在前的,在先的; [or]yshx;
precious: [a]/ˈpreʃəs/; [n]<口>宝贝,心爱的人; [adv]强调极少或太少; [adj]珍贵的,宝贵的; [or]yshx;
precipice: [a]/ˈpresəpɪs/; [n]危险的处境,灾难的边缘,濒危点;悬崖; [or]yshx;
precipitate: [a]/prɪˈsɪpɪteɪt/; [v]促成,使..沉淀,猛摔;<气象>凝结; [n]沉淀物,冷凝物; [adj]突如其来的,仓促的,迅猛的;感情用事的; [or]yshx;
precise: [a]/prɪˈsaɪs/; [adj]精确的;恰好的; [or]yshx;
predecessor: [a]/ˈpredəsesər/; [n]前辈;(被取代的)原有事物; [or]yshx;
predictable: [a]/prɪˈdɪktəbl/; [adj]可预料的;可预报的;可预言的; [or]yshx;
predisposition: [a]/ˌpriːdɪspəˈzɪʃn/; [n]倾向;素质;易染病体质; [or]yshx;
predominant: [a]/prɪˈdɑːmɪnənt/; [adj]占主导地位的;显著的; [or]yshx;
preface: [a]/ˈprefəs/; [n]序言,前言,开端; [or]yshx;
pregnant: [a]/ˈpreɡnənt/; [adj]怀孕的;充满的,意味深长的; [or]yshx;
prejudice: [a]/ˈpredʒudɪs/; [n]偏见;成见;损害;侵害; [vt]使抱偏见; [or]yshx;
preliminary: [a]/prɪˈlɪmɪneri/; [adj]初步的,预备的; [n]预赛;预考,初试;初步措施; [or]yshx;
prelude: [a]/ˈpreljuːd/; [n]序幕,前奏; [or]yshx;
premise: [a]/ˈpremɪs/; [n]前提;房屋地基; [v]假定; [or]yshx;
premium: [a]/ˈpriːmiəm/; [adj]高级的;高价的;(汽油)辛烷值高的; [n]额外费用,溢价;保险金; [or]yshx;
prerogative: [a]/prɪˈrɑːɡətɪv/; [n]权利;特权; [or]yshx;
prescribe: [a]/prɪˈskraɪb/; [v]给..开药;命令,指示; [or]yshx;
presence: [a]/ˈprezns/; [n]出席,到场;存在;风度,仪态; [or]yshx;
presentation: [a]/ˌpriːzenˈteɪʃn/; [n]演讲;报告;介绍;颁奖仪式; [or]yshx;
preserve: [a]/prɪˈzɜːrv/; [v]贮鲜,保鲜;保存;保护; [n]独揽之事,独占的活动; [or]yshx;
prestige: [a]/preˈstiːʒ/; [n]威望,声望; [or]yshx;
pretentious: [a]/prɪˈtenʃəs/; [adj]做作的,自命不凡的,炫耀的; [or]yshx;
pretext: [a]/ˈpriːtekst/; [n]借口,托词; [or]yshx;
prevail: [a]/prɪˈveɪl/; [v]流行,盛行;战胜,压倒; [or]yshx;
prevalent: [a]/ˈprevələnt/; [adj]普遍的,流行的; [or]yshx;
previous: [a]/ˈpriːviəs/; [adj]以前的;早先的;过早的; [or]yshx;
prime: [a]/praɪm/; [adj]首要的,主要的;最好的,第一流的; [n]青春,全盛期,青壮年时期; [v]使准备好; [or]yshx;
primitive: [a]/ˈprɪmətɪv/; [adj]原始的;简陋的; [n]原始人; [or]yshx;
principal: [a]/ˈprɪnsəpl/; [n]校长,负责人;本金,资本; [adj]主要的,首要的; [or]yshx;
prior: [a]/ˈpraɪər/; [adj]在先的;优先的; [n]上司; [or]yshx;
privacy: [a]/ˈpraɪvəsi/; [n]隐私;秘密;私生活; [or]yshx;
privilege: [a]/ˈprɪvəlɪdʒ/; [n]特权,优待;荣幸; [v]给..特权; [or]yshx;
probation: [a]/proʊˈbeɪʃn/; [n]试用;缓刑;察看; [or]yshx;
probe: [a]/proʊb/; [v]探测,探索; [n]探索,调查;探针,探测器; [or]yshx;
procedure: [a]/prəˈsiːdʒər/; [n]步骤,过程;程序;手续; [or]yshx;
proceed: [a]/proʊˈsiːd/; [v]前进(尤指停止后继续进行);继续进行,继续做; [n]收入,获利; [or]yshx;
proclaim: [a]/prəˈkleɪm/; [v]声明,声称;宣告;表明; [or]yshx;
procure: [a]/prəˈkjʊr/; [vt](努力)取得;获得;导致;完成; [vi]介绍娼妓;拉皮条; [or]yshx;
prodigious: [a]/prəˈdɪdʒəs/; [adj]异常的,奇妙的;巨大的; [or]yshx;
productive: [a]/prəˈdʌktɪv/; [adj]多产的;产生..的;富有成效的; [or]yshx;
profane: [a]/prəˈfeɪn/; [adj]亵渎神圣的,不敬的,粗俗的,污秽的; [v]亵渎,玷污(神圣),滥用; [n]未受秘传的人; [or]yshx;
professional: [a]/prəˈfeʃənl/; [adj]职业的;专业的; [n]专业人员; [or]yshx;
proficiency: [a]/prəˈfɪʃnsi/; [n]熟练;精通; [or]yshx;
profile: [a]/ˈproʊfaɪl/; [n]侧面像;外形,轮廓; [v]描绘..的轮廓,扼要描述; [or]yshx;
profit: [a]/ˈprɑːfɪt/; [n]利润,盈利;益处; [v]得益,有益于; [or]yshx;
profuse: [a]/prəˈfjuːs/; [adj]很多的,浪费的;丰富的; [or]yshx;
prohibit: [a]/prəˈhɪbɪt/; [v]禁止; [or]yshx;
project: [a]/ˈprɑːdʒekt/; [n]项目,工程;专题研究;课题方案; [v]映射,放映;计划,设计,打算,拟订方案;投掷,发射,喷射;表明..的特性,使呈现特性;阐述;突出,伸出;估计,预估; [or]yshx;
prolific: [a]/prəˈlɪfɪk/; [adj]多育的,多产的;丰富的,富饶的; [or]yshx;
promise: [a]/ˈprɑːmɪs/; [n]诺言;有成功希望的预示;允诺的事; [vt]保证,允诺; [vi]有指望;允诺,保证; [or]yshx;
promote: [a]/prəˈmoʊt/; [v]提升;促进;发扬;促销; [or]yshx;
prompt: [a]/prɑːmpt/; [v]提示;激起;促进,推动;敦促; [adj]迅速的,及时的; [n]提示; [or]yshx;
prone: [a]/proʊn/; [adj]易于.的;有.倾向的;俯卧的; [or]yshx;
propaganda: [a]/ˌprɑːpəˈɡændə/; [n]宣传;宣传方法; [or]yshx;
propagate: [a]/ˈprɑːpəɡeɪt/; [v]繁殖,增殖; [vt]传播,宣传; [or]yshx;
propel: [a]/prəˈpel/; [v]推进,推动,激励; [or]yshx;
property: [a]/ˈprɑːpərti/; [n]房产;财产;特性;性能; [or]yshx;
prophecy: [a]/ˈprɑːfəsi/; [n]预言书;预言,预言能力; [or]yshx;
proportion: [a]/prəˈpɔːrʃn/; [n]比例;部分;相称; [v]使成比例;分配; [or]yshx;
propose: [a]/prəˈpoʊz/; [v]提议;求婚; [or]yshx;
propriety: [a]/prəˈpraɪəti/; [n]正当(的行为);礼节;适当; [or]yshx;
propulsion: [a]/prəˈpʌlʃn/; [n]推进力; [or]yshx;
prosecute: [a]/ˈprɑːsɪkjuːt/; [v]起诉;做检察官;从事; [or]yshx;
prospect: [a]/ˈprɑːspekt/; [n]前景,展望;视野;景象; [v]勘察;有前途;勘探;对..进行仔细调查; [or]yshx;
prospectus: [a]/prəˈspektəs/; [n]章程,内容简介;样张;创办计划书; [or]yshx;
protein: [a]/ˈproʊtiːn/; [n]蛋白质; [adj]蛋白质的; [or]yshx;
protest: [a]/ˈproʊtest/; [v]抗议;反对; [n]声明,反对; [or]yshx;
protocol: [a]/ˈproʊtəkɔːl/; [n]外交礼节;草案;外交议定书; [vi]拟定议定书; [vt]把.写入议定书; [or]yshx;
prototype: [a]/ˈproʊtətaɪp/; [n]原型,典型,样本; [or]yshx;
protract: [a]/proʊ'trækt/; [v]绘制;延长;伸展; [or]yshx;
protrude: [a]/proʊˈtruːd/; [v]伸出,突出,凸出; [or]yshx;
provided: [a]/prəˈvaɪdɪd/; [conj]假如,如果,以..为条件; [adj]预备好的,提供的; [or]yshx;
provision: [a]/prəˈvɪʒn/; [n](法律等)条款;供应;预备,存粮;必需品; [v]为..提供必需品; [or]yshx;
provisional: [a]/prəˈvɪʒənl/; [n]临时邮票; [adj]临时的,暂时的,暂定的; [or]yshx;
provoke: [a]/prəˈvoʊk/; [v]激怒;对.挑衅;引起; [or]yshx;
proximity: [a]/prɑːkˈsɪməti/; [n]接近;邻近; [or]yshx;
proxy: [a]/ˈprɑːksi/; [n]代理权,代表权,代理人; [adj]代理的; [or]yshx;
pry: [a]/praɪ/; [v]刺探,打听,撬开; [n]窥探;杠杆;爱打探的人; [or]yshx;
psychiatry: [a]/saɪˈkaɪətri/; [n]精神病学;精神病治疗法; [or]yshx;
psychology: [a]/saɪˈkɑːlədʒi/; [n]心理学;心理状态;心理; [or]yshx;
publicity: [a]/pʌbˈlɪsəti/; [n]公开(性),公众的关注;宣传;名声; [or]yshx;
pull oneself together: [a]/pʊl wʌnˈself təˈɡeðər/; [v]振作起来;恢复镇定; [or]yshx;
pull over: [a]/pʊl ˈoʊvər/; [v]开到路边; [or]yshx;
pull sth. down: [a]/pʊl ˈsʌmθɪŋ daʊn/; [phr]摧毁;破坏;拆除; [or]yshx;
pull sth. off: [a]/pʊl ˈsʌmθɪŋ ɑːf/; [phr]努力实现; [or]yshx;
pull through: [a]/pʊl θru/; [phr]渡过难关;恢复健康; [or]yshx;
pulp: [a]/pʌlp/; [n]果肉;果肉酱;纸浆; [v]去除果肉,捣成浆状; [or]yshx;
pump: [a]/pʌmp/; [v]抽水,抽取;用泵输送;向.灌注;盘问; [n]打气筒;泵,抽水(机);胶底帆布鞋; [or]yshx;
punctual: [a]/ˈpʌŋktʃuəl/; [adj]准时的,守时的; [or]yshx;
puncture: [a]/ˈpʌŋktʃər/; [v]刺破(车胎等),扎,穿孔; [n]刺孔,刺; [or]yshx;
pungent: [a]/ˈpʌndʒənt/; [adj]刺激性的;刺鼻的;尖锐的; [or]yshx;
purity: [a]/ˈpjʊrəti/; [n]纯洁;纯净;纯正;纯粹; [or]yshx;
pursuit: [a]/pərˈsuːt/; [n]追求,寻找;追赶,跟踪;事业,消遣; [v]追踪,追击; [or]yshx;
put an end to: [a]/pʊt ən end tu/; [v]停止,消灭; [or]yshx;
puzzle: [a]/ˈpʌzl/; [n]拼图;谜;迷惑;难题; [v]使迷惑; [or]yshx;
quaint: [a]/kweɪnt/; [adj]精巧的;古雅的; [or]yshx;
qualification: [a]/ˌkwɑːlɪfɪˈkeɪʃn/; [n]资格证明;条件;合格证书;资格;限制性条件; [or]yshx;
qualitative: [a]/ˈkwɑːləteɪtɪv/; [adj](性)质的,定性的; [or]yshx;
quantitative: [a]/ˈkwɑːntəteɪtɪv/; [adj]定量的; [or]yshx;
quarry: [a]/ˈkwɔːri/; [n]采石场;猎物;来源; [v]挖出;努力挖掘; [or]yshx;
queer: [a]/kwɪr/; [adj]怪异的;〈贬〉同性恋的; [n]〈贬〉同性恋者; [v]破坏.的计划; [or]yshx;
quench: [a]/kwentʃ/; [v]扑灭(火);止渴; [or]yshx;
quest: [a]/kwest/; [n]探索,寻求; [v]寻找,搜索; [or]yshx;
questionnaire: [a]/ˌkwestʃəˈner/; [n]调查表,问卷; [or]yshx;
quit: [a]/kwɪt/; [vt]辞职;停止;离开; [adj]被释放的;自由的;摆脱了.的;了清债务的; [or]yshx;
quiver: [a]/ˈkwɪvər/; [n]颤抖;箭袋; [vi]颤抖; [or]yshx;
quota: [a]/ˈkwoʊtə/; [n]配额;限额;定额; [or]yshx;
rack: [a]/ræk/; [n]挂架,搁架; [v]使痛苦; [or]yshx;
racket: [a]/ˈrækɪt/; [n]吵闹声;球拍; [v]嚷闹,吵闹,纵情欢闹;用球拍打; [or]yshx;
radar: [a]/ˈreɪdɑːr/; [n]雷达,无线电探测器; [or]yshx;
radiate: [a]/ˈreɪdieɪt/; [v]辐射,发出(光或热);流露,显示;(使)从中心发散; [or]yshx;
radical: [a]/ˈrædɪkl/; [n]激进分子;基础;原子团;根数,根式; [adj]重大的,彻底的;激进的; [or]yshx;
radius: [a]/ˈreɪdiəs/; [n]半径;范围; [or]yshx;
raft: [a]/ræft/; [n]木筏;救生艇; [or]yshx;
rage: [a]/reɪdʒ/; [n]极怒;盛怒; [v]迅速蔓延,快速扩散;(战争等)激烈地进行; [or]yshx;
ragged: [a]/ˈræɡɪd/; [adj]破旧的;参差不齐的;未梳理的;粗糙的;精疲力竭的; [or]yshx;
raid: [a]/reɪd/; [n]突袭;袭击; [v]袭击;劫掠;攫取;突然搜捕; [or]yshx;
rail: [a]/reɪl/; [n]铁轨;扶手,栏杆; [v]咒骂; [or]yshx;
rally: [a]/ˈræli/; [n]集会;公路汽车赛; [v]集合;恢复(健康等),重新振作; [or]yshx;
ramble: [a]/ˈræmbl/; [vi]瞎扯;溜达;漫步于; [n]漫步; [or]yshx;
rampant: [a]/ˈræmpənt/; [adj]猖獗的,蔓生的; [or]yshx;
random: [a]/ˈrændəm/; [adj]随机的;任意的;胡乱的; [or]yshx;
range: [a]/reɪndʒ/; [n]排;变动范围;山脉;放牧场;射程;范围; [vi]排成一排; [vt]排列; [adj]牧场的; [or]yshx;
ransom: [a]/ˈrænsəm/; [n]赎金,赎身; [v]赎回,解救; [or]yshx;
rarely: [a]/ˈrerli/; [adv]很少,难得; [or]yshx;
ratio: [a]/ˈreɪʃioʊ/; [n]比率,比例; [or]yshx;
rational: [a]/ˈræʃnəl/; [adj]理性的;理智的;合理的; [or]yshx;
ravage: [a]/ˈrævɪdʒ/; [n]毁坏,荒废,破坏的残迹; [v]摧残,破坏; [or]yshx;
raw: [a]/rɔː/; [adj]生的,未煮过的;未加工的;(因皮肤开裂)疼痛的; [or]yshx;
readily: [a]/ˈredɪli/; [adv]容易地;乐意地;欣然地; [or]yshx;
realm: [a]/relm/; [n]王国;领域;国土; [or]yshx;
reap: [a]/riːp/; [v]收割;获得;收获; [or]yshx;
reasonable: [a]/ˈriːznəbl/; [adj]适当的;合理的;通情达理的;(价格)公道的; [or]yshx;
reassure: [a]/ˌriːəˈʃʊr/; [v]使放心,使消除疑虑; [or]yshx;
recall: [a]/rɪˈkɔːl/; [v]回想起,记起,回忆;召回; [n]召回(有问题的产品); [or]yshx;
recede: [a]/rɪˈsiːd/; [vi]退去;渐渐远去;(尤指问题,感情或品质)逐渐减弱;(头发)从前向后减少;向后倾斜; [or]yshx;
receipt: [a]/rɪˈsiːt/; [n]收据,收条;收入;收到; [or]yshx;
reception: [a]/rɪˈsepʃn/; [n]前台,接待处,接收,欢迎,招待会; [or]yshx;
recession: [a]/rɪˈseʃn/; [n](经济)衰退,不景气;后退,撤回;凹处; [or]yshx;
recipe: [a]/ˈresəpi/; [n]方法;食谱; [or]yshx;
recipient: [a]/rɪˈsɪpiənt/; [n]接受者;容器;间接宾语; [adj]接受的;善于接受的;接受能力强的; [or]yshx;
reciprocal: [a]/rɪˈsɪprəkl/; [adj]相互的,互惠的; [n]倒数;互相关联的事物; [or]yshx;
recital: [a]/rɪˈsaɪtl/; [n]独奏,吟诵,演奏会; [or]yshx;
recite: [a]/rɪˈsaɪt/; [vi]背诵;朗诵; [vt]背诵;朗诵;叙述;列举; [or]yshx;
reckless: [a]/ˈrekləs/; [adj]不顾虑的;鲁莽的,不顾后果的; [or]yshx;
reckon on: [a]/ˈrekən ɔn/; [phr]依赖;估计;计划;指望; [or]yshx;
reckon with sb.: [a]/ˈrekən wɪθ ˈsʌmbədi/; [v]清算;将.加以考虑,认真对待; [or]yshx;
reckon: [a]/ˈrekən/; [vt]计算;想,指望;把.看做; [v]认为; [vi]计算;估计; [or]yshx;
reclaim: [a]/rɪˈkleɪm/; [v]开拓,开垦;感化;取回;改造;废物回收利用; [or]yshx;
recline: [a]/rɪˈklaɪn/; [vi]躺,斜倚(常与on,upon或against连用);信赖; [vt]使后靠,使斜倚; [or]yshx;
recommendation: [a]/ˌrekəmenˈdeɪʃn/; [n]推荐,建议,介绍,推荐信; [or]yshx;
reconcile: [a]/ˈrekənsaɪl/; [v]和解;调解;调和; [or]yshx;
recover: [a]/rɪˈkʌvər/; [v]恢复;痊愈,恢复健康;收回;换回;重新获得;重新找到; [or]yshx;
recruit: [a]/rɪˈkruːt/; [v]招募(新兵),招收(新成员); [n]新兵,新成员; [or]yshx;
rectify: [a]/ˈrektɪfaɪ/; [v]纠正;修复; [or]yshx;
recycle: [a]/ˌriːˈsaɪkl/; [v]回收利用;改建; [n]再循环; [or]yshx;
redeem: [a]/rɪˈdiːm/; [vt]赎回;挽回;恢复;偿还;弥补;履行;兑换; [or]yshx;
redundant: [a]/rɪˈdʌndənt/; [adj]多余的,过剩的;被下岗的; [or]yshx;
reel: [a]/riːl/; [n]卷盘; [v]旋转;感到震惊;眩晕; [or]yshx;
reference: [a]/ˈrefrəns/; [n]参考书;提及;推荐人;参考;证明;推荐信; [v]附.以供参考;引用; [or]yshx;
referendum: [a]/ˌrefəˈrendəm/; [n]公民投票,复决权; [or]yshx;
refine: [a]/rɪˈfaɪn/; [v]精炼,改进; [or]yshx;
refrain: [a]/rɪˈfreɪn/; [v]抑制,避免; [n]歌曲的反复句,叠句; [or]yshx;
refreshing: [a]/rɪˈfreʃɪŋ/; [adj]使精神振作的,使人清爽的;清新悦目的; [or]yshx;
refugee: [a]/ˌrefjuˈdʒiː/; [n]避难者,难民; [v]避难; [adj]避难的; [or]yshx;
refusal: [a]/rɪˈfjuːzl/; [n]拒绝,回绝; [or]yshx;
regardless: [a]/rɪˈɡɑːrdləs/; [adj]不顾的,不注意的; [adv]不顾一切地; [or]yshx;
regime: [a]/reɪˈʒiːm/; [n]政权;政治制度;养生法,生活规则; [or]yshx;
registrar: [a]/ˌredʒɪˈstrɑːr/; [n]登记员,记录员; [or]yshx;
regulate: [a]/ˈreɡjuleɪt/; [v]管制,调整,控制; [or]yshx;
rehabilitate: [a]/ˌriːəˈbɪlɪteɪt/; [v]使康复,使恢复名誉,使恢复原状; [or]yshx;
reign: [a]/reɪn/; [v]占主导地位,统治,当政; [n](君主)统治时期; [or]yshx;
reimburse: [a]/ˌriːɪmˈbɜːrs/; [v]偿还;赔偿;退还(钱),付还; [or]yshx;
reinforce: [a]/ˌriːɪnˈfɔːrs/; [v]加固;加强;增援;支持; [or]yshx;
rejoice: [a]/rɪˈdʒɔɪs/; [v]欣喜,高兴; [or]yshx;
relay: [a]/ˈriːleɪ/; [n]替班;转播;接力赛跑; [v]转播;传递; [or]yshx;
release: [a]/rɪˈliːs/; [v]释放;解放;发行; [n]解除;免除;发表; [or]yshx;
relevant: [a]/ˈreləvənt/; [adj]有关的;恰当的;贴切的; [or]yshx;
reliable: [a]/rɪˈlaɪəbl/; [adj]可靠的;可信赖的;确实的; [or]yshx;
relief: [a]/rɪˈliːf/; [n]安慰;解脱;减轻;浮雕;凸显,起伏;救济金;救济物资;换班人;接替人; [or]yshx;
relinquish: [a]/rɪˈlɪŋkwɪʃ/; [v]放弃,让出(权利,财产等),撤回; [or]yshx;
reluctant: [a]/rɪˈlʌktənt/; [adj]不情愿的;勉强的; [or]yshx;
rely: [a]/rɪˈlaɪ/; [v]依赖,依靠;信赖; [or]yshx;
remedy: [a]/ˈremədi/; [v]治疗;恢复;补救; [n]治疗;补救;矫正; [or]yshx;
remind: [a]/rɪˈmaɪnd/; [v]提醒,使想起; [or]yshx;
remittance: [a]/rɪˈmɪtns/; [n]汇款,汇款额; [or]yshx;
remnant: [a]/ˈremnənt/; [n]遗迹;边角剩料; [or]yshx;
render: [a]/ˈrendər/; [v]使成为,致使,使处于(某种状态);提供,给予,以.回报;(以某种方式)表达,表现;翻译;粉刷,往(墙上)抹灰;将(脂肪)熬成油,使熔化; [n]粉刷,打底,交纳; [or]yshx;
rendezvous: [a]/ˈrɑːndɪvuː/; [n]集会,幽会,约会地点; [v]约会,幽会,(秘密)集会; [or]yshx;
renovation: [a]/ˌrenəˈveɪʃn/; [n]修理;恢复; [or]yshx;
renowned: [a]/rɪˈnaʊnd/; [adj]著名的;有名的; [or]yshx;
repel: [a]/rɪˈpel/; [v]击退,驱逐;排斥,抵制;使厌恶,使反感;使恐惧; [or]yshx;
repent: [a]/rɪˈpent/; [v](对某事或行为感到)悔恨;后悔;悔改; [adj]<植>匍匐生根的;<动>爬行的; [or]yshx;
repetition: [a]/ˌrepəˈtɪʃn/; [n]重复,反复; [or]yshx;
represent: [a]/ˌreprɪˈzent/; [v]代表;象征;表示;描述;阐明;说明;演绎; [or]yshx;
reproach: [a]/rɪˈproʊtʃ/; [v]责备,指责; [n]指责; [or]yshx;
reptile: [a]/ˈreptaɪl/; [n]爬行动物,爬虫; [adj]爬行的,爬虫类的; [or]yshx;
reputation: [a]/ˌrepjuˈteɪʃn/; [n]名声;声誉; [or]yshx;
request: [a]/rɪˈkwest/; [n]请求;要求; [v]请求;要求; [or]yshx;
rescue: [a]/ˈreskjuː/; [v]营救,援救; [n]营救,救援; [or]yshx;
resemble: [a]/rɪˈzembl/; [v]像,相像,相似; [or]yshx;
reserve: [a]/rɪˈzɜːrv/; [n]储备;保留;保护区; [v]保留;预定;储备; [or]yshx;
residence: [a]/ˈrezɪdəns/; [n]住宅,居住,居留权; [or]yshx;
resign: [a]/rɪˈzaɪn/; [v]辞职; [or]yshx;
resilience: [a]/rɪˈzɪliəns/; [n]恢复力;弹力;顺应力; [or]yshx;
resolution: [a]/ˌrezəˈluːʃn/; [n]决心,决定,解决,决议,分辨率; [or]yshx;
resonant: [a]/ˈrezənənt/; [adj]洪亮的,共振的,共鸣的; [or]yshx;
resort: [a]/rɪˈzɔːrt/; [vi]采取;求助; [n]求助;凭借;诉诸,采取;度假胜地; [or]yshx;
resource: [a]/ˈriːsɔːrs/; [n]资源,财力,办法; [v]向.提供资金(或设备); [or]yshx;
respiration: [a]/ˌrespəˈreɪʃn/; [n]呼吸; [or]yshx;
responsive: [a]/rɪˈspɑːnsɪv/; [adj]反应积极的,反应敏捷的;反应热烈的;响应的; [or]yshx;
restless: [a]/ˈrestləs/; [adj]烦躁不安的,焦虑的;得不到休息的;不安宁的; [or]yshx;
restore: [a]/rɪˈstɔːr/; [v]恢复;修补;归还; [or]yshx;
restrain: [a]/rɪˈstreɪn/; [v]制止(做);抑制(愤怒等),控制;监禁; [or]yshx;
resume: [a]/ˈrezəmeɪ/; [n]简历; [v]重新开始;继续; [vt]回到;恢复;重新开始; [or]yshx;
retail: [a]/ˈriːteɪl/; [adj]零售的; [n]零售; [v]零售,零售价是; [adv]以零售方式,以零售形式; [or]yshx;
retain: [a]/rɪˈteɪn/; [v]保持,保留,保存;聘请; [or]yshx;
reticent: [a]/ˈretɪsnt/; [adj]沉默不语的;有保留的;含蓄的; [or]yshx;
retort: [a]/rɪˈtɔːrt/; [v]反驳; [n]反驳,反击,回嘴; [or]yshx;
retreat: [a]/rɪˈtriːt/; [v]撤退,撤离,(被迫)退却,后退; [n]撤退,退却,隐退;休养所,收容所;躲藏处; [or]yshx;
retrieve: [a]/rɪˈtriːv/; [v]取回,重新得到,挽回,检索; [or]yshx;
revelation: [a]/ˌrevəˈleɪʃn/; [n]揭露;揭示;(出乎意料的)被揭示的真相; [or]yshx;
revenge: [a]/rɪˈvendʒ/; [n]报仇;报复; [v]为.报仇,报.之仇; [or]yshx;
revenue: [a]/ˈrevənuː/; [n]收入;财政收入;国家的税收; [or]yshx;
reverent: [a]/ˈrevərənt/; [adj]虔诚的,恭敬的; [or]yshx;
reverse: [a]/rɪˈvɜːrs/; [n]失败,挫折,倒退;相反,背面; [v]颠倒,翻转; [adj]相反的,反面的,颠倒的; [or]yshx;
review: [a]/rɪˈvjuː/; [v]温习,复习;评论;回顾,反思; [n]复习,回顾;检讨;评审,审查; [or]yshx;
revise: [a]/rɪˈvaɪz/; [v]修订;修改;温习(功课); [or]yshx;
revive: [a]/rɪˈvaɪv/; [v](使)苏醒;(使)复苏;再兴起;重做; [or]yshx;
revolt: [a]/rɪˈvoʊlt/; [v]反抗,叛乱,厌恶;造反;反抗;厌恶; [n]背叛;厌恶;反叛; [or]yshx;
revolve: [a]/rɪˈvɑːlv/; [v](使)旋转;(使)绕转; [or]yshx;
reward: [a]/rɪˈwɔːrd/; [n]奖品,报酬,回报;悬赏; [v]报答,酬谢; [or]yshx;
rhetoric: [a]/ˈretərɪk/; [n]修辞学,浮夸的言语;雄辩术; [or]yshx;
rhythm: [a]/ˈrɪðəm/; [n]节奏;韵律;格律; [or]yshx;
ribbon: [a]/ˈrɪbən/; [n]缎带,丝带,带状物; [or]yshx;
ridge: [a]/rɪdʒ/; [n]脊,岭,山脉,垄; [or]yshx;
ridiculous: [a]/rɪˈdɪkjələs/; [adj]可笑的,荒谬的; [or]yshx;
rig: [a]/rɪɡ/; [n]钻井架;装备;帆具;成套器械; [v]操纵;装配;欺骗; [or]yshx;
righteous: [a]/ˈraɪtʃəs/; [adj]正直的,正当的,公正的; [or]yshx;
rigid: [a]/ˈrɪdʒɪd/; [adj]坚硬的;僵硬的;死板的; [or]yshx;
riot: [a]/ˈraɪət/; [v]闹事; [n]骚乱;暴乱;骚动;放纵; [or]yshx;
rip: [a]/rɪp/; [n]裂缝,裂口; [v]撕开,扯破,裂开,敲诈; [or]yshx;
ripple: [a]/ˈrɪpl/; [n]涟漪,波纹; [v](使)泛起层层细浪; [or]yshx;
rise to the occasion: [a]/raɪz tu ði əˈkeʒən/; [v]应付自如; [or]yshx;
ritual: [a]/ˈrɪtʃuəl/; [n](宗教等的)仪式,例行公事,老规矩; [adj]作为仪式一部分的,例行的; [or]yshx;
rival: [a]/ˈraɪvl/; [n]竞争者,对手; [v]与.竞争,与.匹敌; [adj]竞争的,敌对的; [or]yshx;
rivet: [a]/ˈrɪvɪt/; [n]铆钉; [v](用铆钉)铆接,敲打(螺栓)使成铆钉头,吸引(注意力); [or]yshx;
roam: [a]/roʊm/; [v]闲逛,漫步,徘徊;眼睛或手(缓慢地)扫遍; [n]漫步,漫游; [or]yshx;
roar: [a]/rɔːr/; [n]吼叫声,怒号声,轰鸣声; [vi]吼叫;咆哮; [vt]大声呼喊; [or]yshx;
roast: [a]/roʊst/; [v]烤,炙,烘;挖苦;逗乐; [n]烤肉; [adj]烤的,烘的; [or]yshx;
robust: [a]/roʊˈbʌst/; [adj]健壮的,强壮的;精力充沛的;坚固的;粗鲁的; [or]yshx;
roll: [a]/roʊl/; [v]滚动,转动;卷;使摇摆;使平坦,压平; [n]卷;卷状物;隆隆声; [or]yshx;
rot: [a]/rɑːt/; [v](使)腐烂; [n]胡话;腐烂;腐朽,腐败; [or]yshx;
rotate: [a]/ˈroʊteɪt/; [v]以..轴转动,使旋转,使..轮流;轮换; [or]yshx;
rough: [a]/rʌf/; [adj]粗糙的;大致的,粗略的;(海)波涛汹涌的;困难的,令人不快的; [n]草稿; [adv]粗暴地; [v]艰苦生活; [or]yshx;
rouse: [a]/raʊz/; [vt]唤醒,唤起;激起; [or]yshx;
routine: [a]/ruːˈtiːn/; [n]常规,例行公事,一套固定舞步(或动作); [adj]例行的,普通的,惯例的; [or]yshx;
rub: [a]/rʌb/; [v]抚摸;摩擦;擦破; [n]蹭;障碍;磨损处; [or]yshx;
ruffle: [a]/ˈrʌfl/; [vt]弄皱;使生气,扰乱;连续地轻敲;使起波浪; [n]皱纹;生气;混乱; [vi]起皱;愤怒; [or]yshx;
ruinous: [a]/ˈruːɪnəs/; [adj]毁坏的;毁灭性的,破坏性的; [or]yshx;
rule of thumb: [a]/rul ɑv θʌm/; [n]单凭经验的做法;经验法则; [or]yshx;
rumor: [a]/'ruːmə/; [n]谣言;传闻; [or]yshx;
rupture: [a]/ˈrʌptʃər/; [n]破裂;割裂; [v]使破裂;断绝(关系); [or]yshx;
rural: [a]/ˈrʊrəl/; [adj]乡村的,农村的,田园的; [or]yshx;
rust: [a]/rʌst/; [v]生锈;氧化; [n]锈; [or]yshx;
ruthless: [a]/ˈruːθləs/; [adj]无情的;残忍的; [or]yshx;
sabotage: [a]/ˈsæbətɑːʒ/; [n]怠工,蓄意破坏,妨碍; [v]怠工,从事破坏活动,故意阻挠; [or]yshx;
sack: [a]/sæk/; [n]一袋;麻袋;开除; [v]开除;劫掠;掠夺; [or]yshx;
sacred: [a]/ˈseɪkrɪd/; [adj]神圣的,宗教(性)的;神圣不可侵犯的; [or]yshx;
sacrifice: [a]/ˈsækrɪfaɪs/; [vt]牺牲;祭献; [vi]奉献;做出牺牲; [n]祭品;牺牲; [or]yshx;
saddle: [a]/ˈsædl/; [n]鞍;鞍部; [v]给马装鞍具;装鞍具;使负重担; [or]yshx;
safeguard: [a]/ˈseɪfɡɑːrd/; [v]保护,维护; [n]防卫措施,防范措施; [or]yshx;
saline: [a]/ˈseɪliːn/; [adj]咸的,含盐的; [or]yshx;
salute: [a]/səˈluːt/; [n]致意;致敬,欢迎; [v]向..行举手礼;敬礼; [or]yshx;
salvage: [a]/ˈsælvɪdʒ/; [n]抢救;从灾难中抢救出的物资; [vt]拯救;打捞; [or]yshx;
sanction: [a]/ˈsæŋkʃn/; [n]批准;制裁,处罚; [v]批准,支持,对..实施制裁; [or]yshx;
sanitary: [a]/ˈsænəteri/; [adj]卫生的;清洁的; [or]yshx;
sanity: [a]/ˈsænəti/; [n]心智健全,神智正常;头脑清楚; [or]yshx;
sarcasm: [a]/ˈsɑːrkæzəm/; [n]讽刺,挖苦,嘲笑; [or]yshx;
saturate: [a]/ˈsætʃəreɪt/; [v]使充满,使饱和,使湿透; [or]yshx;
sauce: [a]/sɔːs/; [n]酱,调味汁;莽撞,冒失; [or]yshx;
savage: [a]/ˈsævɪdʒ/; [n]野蛮人,粗鲁的人; [adj]凶猛的,猛烈的;野蛮的;未驯化的; [v](狗等)乱咬;激烈抨击; [or]yshx;
say to oneself: [a]/seɪ tu wʌnˈself/; [phr]心中暗想;自言自语; [or]yshx;
scale up (down): [a]/skeɪl ʌp daʊn/; [phr]按比例增加(或降低); [or]yshx;
scale: [a]/skeɪl/; [n]天平,磅秤;刻度,尺度,标度;等级,级别, 等级体系;鳞片,鳞状物;规模;水垢,牙垢; [v]攀登;按比例决定;称重;刮鳞,剥落; [or]yshx;
scalpel: [a]/ˈskælpəl/; [n]外科手术刀,解剖刀; [or]yshx;
scan: [a]/skæn/; [v]细看;浏览;扫描; [n]扫描;浏览; [or]yshx;
scandal: [a]/ˈskændl/; [n]丑闻;丢脸;流言蜚语;反感;愤慨; [v]诋毁; [or]yshx;
scant: [a]/skænt/; [adj]不足的,缺乏的;勉强够的; [v]减少;节省;限制; [or]yshx;
scar: [a]/skɑːr/; [n]伤疤,伤痕;内心创伤; [v](给.)留下伤痕; [or]yshx;
scatter: [a]/ˈskætər/; [v](使)分散,撒开,散播; [or]yshx;
scenery: [a]/ˈsiːnəri/; [n]风景;布景; [or]yshx;
scent: [a]/sent/; [n]气味;香味;迹象; [v]嗅到;察觉; [or]yshx;
schedule: [a]/ˈskedʒuːl/; [n]时间表,日程,计划表;清单,节目表; [v]预定,安排; [or]yshx;
scheme: [a]/skiːm/; [n]方案,计划;阴谋,诡计; [v]图谋,密谋; [adj]计划的; [or]yshx;
scholarship: [a]/ˈskɑːlərʃɪp/; [n]学问;奖学金;学术界;学术成就; [or]yshx;
scissors: [a]/ˈsɪzərz/; [n]剪刀; [or]yshx;
scold: [a]/skoʊld/; [v]怒骂,责骂,训斥; [n]斥责;爱责骂的人; [or]yshx;
scoop: [a]/skuːp/; [n]勺,铲子,独家新闻; [v]挖,掘; [adj](女服领口)汤匙式的; [or]yshx;
scorch: [a]/skɔːrtʃ/; [v]烧焦;枯萎; [vi]高速行驶,疾驰,飞驰; [or]yshx;
score: [a]/skɔːr/; [n]得分;刻痕;二十;配乐; [vi]刻痕; [v]得分; [vt]在.上刻痕; [or]yshx;
scorn: [a]/skɔːrn/; [n]鄙视; [v]轻蔑;对.不屑一顾; [or]yshx;
scout: [a]/skaʊt/; [v]侦察;监视;嘲笑; [n]童子军,侦察员,守卫; [or]yshx;
scrap: [a]/skræp/; [n]碎片;口角,吵架;小块,小片;废金属;残羹冷炙; [v]报废;舍弃;打架; [or]yshx;
scrape: [a]/skreɪp/; [n]擦伤;刮,擦; [v]刮,擦; [or]yshx;
scratch: [a]/skrætʃ/; [n]抓痕,擦伤; [v]划破,擦伤,挠; [or]yshx;
screw: [a]/skruː/; [n]螺旋;螺丝; [v]拧紧; [vi]敲诈勒索; [vt]用螺钉固定;把.拧紧; [or]yshx;
script: [a]/skrɪpt/; [n]剧本,脚本,手稿;文字系统; [v]为电影(或戏剧等)写剧本; [or]yshx;
scrupulous: [a]/ˈskruːpjələs/; [adj]小心谨慎的;严谨的;细心的; [or]yshx;
scrutiny: [a]/ˈskruːtəni/; [n]监视,细看,详细检查,仔细观察; [or]yshx;
sculpture: [a]/ˈskʌlptʃər/; [n]雕刻艺术;雕刻,雕塑; [or]yshx;
scum: [a]/skʌm/; [n]浮沫,浮渣; [or]yshx;
seal: [a]/siːl/; [n]海豹;邮戳;封条;火漆印; [v]封(信封),密封,盖章;封锁;缄口; [or]yshx;
seam: [a]/siːm/; [n]缝;接缝;地层; [or]yshx;
seclude: [a]/sɪˈkluːd/; [v]与世隔绝,使隔绝; [or]yshx;
secondary: [a]/ˈsekənderi/; [adj]次要的,第二的;(疾病,感染等) 继发性的;中学的; [or]yshx;
secretion: [a]/sɪˈkriːʃn/; [n]分泌,分泌物;隐藏; [or]yshx;
section: [a]/ˈsekʃn/; [n]部分;区域;章节;截面;阶层;部门;路段,地段; [v]划分;切开; [or]yshx;
sector: [a]/ˈsektər/; [n](经济等)部门,部分;战区,防区;扇形,扇区; [or]yshx;
sediment: [a]/ˈsedɪmənt/; [n]沉渣,沉淀物,沉淀; [or]yshx;
see eye to eye (with): [a]/siː aɪ tu aɪ wɪθ/; [v]看法完全一致; [or]yshx;
segment: [a]/ˈseɡmənt/; [n]部分;片段;(橘子等的)瓣; [v]分割; [or]yshx;
segregate: [a]/ˈseɡrɪɡeɪt/; [v]分开,隔离,进行种族隔离; [or]yshx;
seismic: [a]/ˈsaɪzmɪk/; [adj]地震的;地震引起的;剧烈的; [or]yshx;
semblance: [a]/ˈsembləns/; [n]相似;外表,外貌; [or]yshx;
sensible: [a]/ˈsensəbl/; [adj]明智的,理智的;可觉察的;实用耐穿的; [or]yshx;
sensitive: [a]/ˈsensətɪv/; [adj]敏感的,过敏的;灵敏的;善解人意的,体恤的; [or]yshx;
sentiment: [a]/ˈsentɪmənt/; [n]感情;情绪; [or]yshx;
sequence: [a]/ˈsiːkwəns/; [n]顺序,次序;连续,继续; [or]yshx;
series: [a]/ˈsɪriːz/; [n]系列,系列节目;连续比赛;连续,接连; [or]yshx;
session: [a]/ˈseʃn/; [n]一段时间的(活动);(法庭的)开庭;(议会等的)开会;学期;讲习会; [adj]为录音的歌手或乐队伴奏的; [or]yshx;
set about sth.: [a]/siː əˈbaʊt ˈsʌmθɪŋ/; [v]着手; [or]yshx;
set in: [a]/set ɪn/; [phr]开始;到来;生效;流行;设置(戏剧,小说等的)背景;上涨;插入; [or]yshx;
set off: [a]/set ɑf/; [phr]出发; [or]yshx;
set on sb.: [a]/set ɔːn ˈsʌmbədi/; [v]攻击; [or]yshx;
set out: [a]/set aʊt/; [v]出发; [or]yshx;
set sth. back: [a]/set ˈsʌmθɪŋ bæk/; [v]把(钟,表)向回拨; [or]yshx;
set sth. off: [a]/set ˈsʌmθɪŋ ɑːf/; [v]使爆炸;平衡; [or]yshx;
setback: [a]/ˈsetbæk/; [n]挫折;失败; [or]yshx;
setting: [a]/ˈsetɪŋ/; [n]设置,调整;环境,背景; [or]yshx;
settle (sb.) in: [a]/ˈsetl ˈsʌmbədi ɪn/; [phr]迁入(新居),(使)习惯; [or]yshx;
settle down: [a]/ˈset(ə)l daʊn/; [phr]定居,安定下来; [or]yshx;
settle on (upon) sth.: [a]/ˈsetl ɑːn əˈpɔːn ˈsʌmθɪŋ/; [v]决定; [or]yshx;
severe: [a]/sɪˈvɪr/; [adj]严重的;严厉的;严酷的;剧烈的; [or]yshx;
sewer: [a]/ˈsuːər/; [n]排水沟,下水道,缝纫者; [v]用下水道排污水;铺设污水管道; [or]yshx;
shabby: [a]/ˈʃæbi/; [adj]破烂的,卑鄙的,衣衫褴褛的; [or]yshx;
shaft: [a]/ʃæft/; [n]柄;轴;杆状物; [v]苛刻地对待; [vt]给.装杆; [or]yshx;
shallow: [a]/ˈʃæloʊ/; [adj]浅的;肤浅的; [v]变浅;使变浅; [n]浅滩;浅处; [or]yshx;
shamble: [a]/ˈʃæmbl/; [v]蹒跚,拖沓; [n]蹒跚;摇晃的脚步;(pl.)混乱,废墟; [or]yshx;
shanty: [a]/ˈʃænti/; [n]简陋的小木屋;(水手唱的)劳动号子; [or]yshx;
shatter: [a]/ˈʃætər/; [v]使粉碎;砸碎;打碎;粉碎; [or]yshx;
shave: [a]/ʃeɪv/; [v]剃,刮; [n]剃须,修面,剃刀; [or]yshx;
shed: [a]/ʃed/; [v]流出(眼泪);蜕皮;脱落;使清晰;流下;去除,摆脱; [n]棚屋; [or]yshx;
sheer: [a]/ʃɪr/; [adj]陡峭的;纯粹的; [v](off)急转向,偏离; [n]透明薄纱,透明布料的衣服; [adv]完全地,全然;垂直地,陡峭地; [or]yshx;
sheet: [a]/ʃiːt/; [n]被单;纸张;薄板; [or]yshx;
shell: [a]/ʃel/; [n]炮弹;骨架;壳,外壳;贝壳; [v]剥壳;炮击; [or]yshx;
shelter: [a]/ˈʃeltər/; [n]隐蔽处,躲避处(常用来指住处);庇护; [v]遮蔽,掩护,庇护; [or]yshx;
shepherd: [a]/ˈʃepərd/; [n]牧羊人; [v]带领; [or]yshx;
shield: [a]/ʃiːld/; [n]盾牌;防护物; [v]保护; [or]yshx;
shift: [a]/ʃɪft/; [n]转移;替换;轮值; [v]移动;售卖(难卖的物品);换挡;改换,替换; [or]yshx;
shimmer: [a]/ˈʃɪmər/; [v]闪烁,微微发亮; [n]微光,闪光; [or]yshx;
shiver: [a]/ˈʃɪvər/; [v]颤抖,打战;颤动; [n]颤抖,打战; [or]yshx;
shoal: [a]/ʃoʊl/; [n]浅滩,沙洲,一群(鱼); [adj](水)浅的; [v]变成浅滩;驶入浅水的地方;(鱼)成群集聚; [or]yshx;
shock: [a]/ʃɑːk/; [v](使)震惊,(使)震动; [n]震动,震惊,冲击,休克; [or]yshx;
shovel: [a]/ˈʃʌvl/; [n]铁锨,铲; [v]铲起; [or]yshx;
shred: [a]/ʃred/; [n]碎片,少量,毁灭; [v]切成细条,撕成碎片; [or]yshx;
shrewd: [a]/ʃruːd/; [adj]精明的;机灵的; [n]精明;精明者; [or]yshx;
shrink: [a]/ʃrɪŋk/; [v]收缩;缩小;退缩; [n](非正式用法)心理医生,精神病医生; [or]yshx;
shrub: [a]/ʃrʌb/; [n]灌木; [or]yshx;
shrug: [a]/ʃrʌɡ/; [n]耸肩; [v](为表示厌恶,轻漠,冷淡,怀疑等)耸肩;以耸肩表示(厌恶,轻蔑,冷淡,怀疑等); [or]yshx;
shutter: [a]/ˈʃʌtər/; [n]百叶窗;照相机快门; [or]yshx;
shuttle: [a]/ˈʃʌtl/; [n]短程穿梭运行的车辆,接驳车;梭子;穿梭;航天飞机; [v]穿梭移动;穿梭往返;往返于两地之间; [or]yshx;
sicken: [a]/ˈsɪkən/; [vi]患病;恶心;厌倦; [vt]使生病;令.恶心;使厌恶; [or]yshx;
siege: [a]/siːdʒ/; [n]围困;包围; [or]yshx;
sieve: [a]/sɪv/; [n]筛子,粗篮; [v]筛,滤; [or]yshx;
sigh: [a]/saɪ/; [n]叹气,叹息; [v]叹息,叹气; [or]yshx;
sightseeing: [a]/ˈsaɪtsiːɪŋ/; [n]观光;游览; [adj]观光的,浏览的; [or]yshx;
sign: [a]/saɪn/; [v]签署;使眼色;做暗号;做手势; [n]记号,符号;标志,手势; [or]yshx;
signal: [a]/ˈsɪɡnəl/; [n]信号;预兆; [v]发信号;标志; [adj]显著的,优越的;暗号的,作信号用的; [or]yshx;
signature: [a]/ˈsɪɡnətʃər/; [n]签名,署名;识别标志,鲜明特色;个人特色; [or]yshx;
signify: [a]/ˈsɪɡnɪfaɪ/; [vi]具有重要性; [vt]表示; [or]yshx;
simplify: [a]/ˈsɪmplɪfaɪ/; [v]精简,使单纯; [or]yshx;
simulate: [a]/ˈsɪmjuleɪt/; [v]假装;模仿;模拟; [or]yshx;
simultaneous: [a]/ˌsaɪmlˈteɪniəs/; [adj]同时发生的; [or]yshx;
sincere: [a]/sɪnˈsɪr/; [adj]真诚的,诚恳的; [or]yshx;
single out: [a]/ˈsɪŋɡ(ə)l aʊt/; [v]挑选,选出; [or]yshx;
singular: [a]/ˈsɪŋɡjələr/; [adj]单独的,单个的;奇怪的;非凡的,卓越的,显著的; [n]单数;单数形式; [or]yshx;
sink: [a]/sɪŋk/; [n]水槽,洗碗池; [v](使)下沉,(使)降低;淹没,下落;使沉没; [adj]贫民窟的; [or]yshx;
site: [a]/saɪt/; [n]场所;地点;网站;现场; [vt]给.造址,坐落于; [or]yshx;
situated: [a]/ˈsɪtʃueɪtɪd/; [adj]坐落在.的;处于某种境地的; [or]yshx;
skeleton: [a]/ˈskelɪtn/; [n]骨骼,梗概;骨瘦如柴的人或动物; [or]yshx;
skeptical: [a]/ˈskeptɪkl/; [adj]表示怀疑的; [or]yshx;
sketch: [a]/sketʃ/; [n]梗概,素描; [v]速写,打草稿; [or]yshx;
skim: [a]/skɪm/; [v]掠过;浏览,略读;抹去; [n]撇去浮沫;脱脂乳;(为逃税)隐匿的部分收入; [adj]撇去奶油的;用脱脂乳做的; [or]yshx;
skip: [a]/skɪp/; [v]跳过;略过;遗漏; [n]跳跃;跳读;省略; [or]yshx;
slab: [a]/slæb/; [n]厚片,硬板; [v]把.分成厚片;用石板铺; [or]yshx;
slack: [a]/slæk/; [adj]松弛的;懈怠的;萧条的; [n]松弛的部分,松散; [v]变松弛,逃避工作; [or]yshx;
slag: [a]/slæɡ/; [n]炉渣,矿渣; [or]yshx;
slam: [a]/slæm/; [v]砰地关上;猛力拉,扔;砰地放下;猛烈抨击; [n]砰的一声;大满贯; [or]yshx;
slander: [a]/ˈslændər/; [n]诽谤,诋毁; [v]讲坏话,污蔑,诽谤; [or]yshx;
slap: [a]/slæp/; [v]掌掴,拍打,侮辱; [n]侮辱,掴,拍击声; [adv]猛然;径直;恰好;正好; [or]yshx;
slate: [a]/sleɪt/; [n]黑板,石板,候选人名单; [v]提名; [or]yshx;
slaughter: [a]/ˈslɔːtər/; [v]屠杀,屠宰; [n]屠宰,屠杀; [or]yshx;
slender: [a]/ˈslendər/; [adj]苗条的,修长的,纤细的; [or]yshx;
slice: [a]/slaɪs/; [v]把..切成片;大幅度削减;切开; [n]薄片;份额,部分; [or]yshx;
slide: [a]/slaɪd/; [n]滑行;下落;滑面;幻灯片; [v]使滑动;使滑入;滑动;滑倒;滑落;下跌; [or]yshx;
slim: [a]/slɪm/; [adj]细长的;苗条的; [v](用运动,节食等)减轻体重,变苗条; [or]yshx;
slip: [a]/slɪp/; [v]滑倒,跌落,溜走,疏忽;偷偷地给;被遗忘; [n]溜走;疏忽,错误;纸条; [adj]打有活结的;可拆卸的;滑动的; [or]yshx;
slit: [a]/slɪt/; [n]投币口,裂缝; [v]切开; [or]yshx;
slogan: [a]/ˈsloʊɡən/; [n]标语;口号;广告语; [or]yshx;
slope: [a]/sloʊp/; [n]山坡,斜坡,倾斜; [v]倾斜; [or]yshx;
slot: [a]/slɑːt/; [n]狭缝,狭槽,(机构的)职位; [v]把.放入狭长开口中,把.纳入; [or]yshx;
sluggish: [a]/ˈslʌɡɪʃ/; [adj]行动迟缓的,迟钝的;偷懒的; [or]yshx;
slum: [a]/slʌm/; [n]贫民窟,贫民区,陋巷; [v]去贫民窟,到贫民区去(参观,游玩等); [or]yshx;
smash: [a]/smæʃ/; [v]粉碎,猛冲,击溃; [n]破碎(声),猛撞,巨大的成功; [adj]极为成功的; [or]yshx;
smooth: [a]/smuːð/; [adj]光滑的;平稳的; [v]使光滑;使平稳; [or]yshx;
smuggle: [a]/ˈsmʌɡl/; [v]非法偷运;走私; [or]yshx;
snack: [a]/snæk/; [n]零食,小吃,快餐; [or]yshx;
snap at sb.: [a]/snæp æt ˈsʌmbədi/; [v]对人厉声说; [or]yshx;
snap at sth.: [a]/snæp æt ˈsʌmθɪŋ/; [v]咬住; [or]yshx;
snatch: [a]/snætʃ/; [v]强夺;攫取; [n]片断; [or]yshx;
soak: [a]/soʊk/; [v]浸泡,渗透,吸入; [n]浸泡; [or]yshx;
soar: [a]/sɔːr/; [v]高飞,翱翔;飞腾;猛增;高飞越过; [n]高飞;高涨; [or]yshx;
sober: [a]/ˈsoʊbər/; [vi]变得冷静; [adj]未饮醉的,清醒的;有节制的;严肃的; [v]使清醒;使冷静; [or]yshx;
sociable: [a]/ˈsoʊʃəbl/; [adj]好交际的; [or]yshx;
sociology: [a]/ˌsoʊsiˈɑːlədʒi/; [n]社会学; [or]yshx;
soil: [a]/sɔɪl/; [n]泥土,土壤;土地,国土; [v]弄脏;污损; [or]yshx;
sole: [a]/soʊl/; [n]脚底,鞋底,袜底; [adj]唯一的;独有的;单独的; [v]装鞋底; [or]yshx;
solemn: [a]/ˈsɑːləm/; [adj]严肃的;庄严的,隆重的;神圣的; [or]yshx;
solidarity: [a]/ˌsɑːlɪˈdærəti/; [n]团结一致; [or]yshx;
solitary: [a]/ˈsɑːləteri/; [adj]孤独的,单独的,隐居的; [n]独居者,隐士;单独禁闭; [or]yshx;
solo: [a]/ˈsoʊloʊ/; [n]独唱; [adj]独奏的;单独的; [adv]独奏地;单独地; [v]放单飞; [or]yshx;
soluble: [a]/ˈsɑːljəbl/; [adj]可溶解的;可解决的; [or]yshx;
solvent: [a]/ˈsɑːlvənt/; [adj]有偿付能力的;有溶解力的; [n]溶剂;解决方法; [or]yshx;
somewhat: [a]/ˈsʌmwʌt/; [adv]有点儿,稍微,有些; [pron]某物;一些; [or]yshx;
sophisticated: [a]/səˈfɪstɪkeɪtɪd/; [adj](仪器)精密的,复杂的;老于世故的,老练的,富有经验的;高雅的,精致的; [or]yshx;
sore: [a]/sɔːr/; [adj]疼痛的,酸痛的;恼火的; [n]疮; [adv]〈古,诗〉同"sorely. a sore throat"; [or]yshx;
sort sth. out: [a]/sɔːrt ˈsʌmθɪŋ aʊt/; [phr]分类,拣选,整理;解决;消除误会; [or]yshx;
sort: [a]/sɔːrt/; [v]把..分类,挑选;修理,整理; [n]种类; [or]yshx;
sour: [a]/ˈsaʊər/; [adj]酸的;(人)尖酸刻薄的,不友好的; [v](友谊,局势,态度等)变坏;使恶化; [or]yshx;
souvenir: [a]/ˈsuːvənɪr/; [n]纪念物,纪念品; [vt]把.留作纪念; [or]yshx;
sovereign: [a]/ˈsɑːvrən/; [adj]至高无上的,具有独立主权的,有最高统治权的; [n]最高统治者,君主,元首; [or]yshx;
sow: [a]/soʊ/; [v]播种;散布;煽动; [n]母猪; [or]yshx;
spacious: [a]/ˈspeɪʃəs/; [adj]宽敞的,广阔的; [or]yshx;
span: [a]/spæn/; [n]跨度;时间段;范围;持续时间; [v]持续;横跨;包括; [or]yshx;
spare: [a]/sper/; [adj]备用的;多余的,闲置的;瘦的; [n]零件,备件; [v]抽出,腾出;免去; [or]yshx;
sparkle: [a]/ˈspɑːrkl/; [vi]闪耀;焕发,活跃,才华横溢; [n]光亮;活力; [or]yshx;
sparse: [a]/spɑːrs/; [adj]稀少的;稀疏的; [or]yshx;
spatial: [a]/ˈspeɪʃl/; [adj]空间的,关于空间的; [or]yshx;
speak one's mind: [a]/spik wʌnz maɪnd/; [phr]直言不讳,吐露心声; [or]yshx;
specialize: [a]/ˈspeʃəlaɪz/; [v]专门研究,专门从事; [or]yshx;
species: [a]/ˈspiːʃiːz/; [n](单复同)物种;种类;人类; [adj]物种上的; [or]yshx;
specification: [a]/ˌspesɪfɪˈkeɪʃn/; [n]规格,载明,详述; [or]yshx;
specimen: [a]/ˈspesɪmən/; [n]标本,样本,样品; [or]yshx;
spectacular: [a]/spekˈtækjələr/; [adj]壮观的,引人入胜的; [n]壮观的场面,精彩的表演; [or]yshx;
spectator: [a]/ˈspekteɪtər/; [n]旁观者;观众;目击者; [or]yshx;
spectrum: [a]/ˈspektrəm/; [n]光谱,范围,系列; [or]yshx;
speculate: [a]/ˈspekjuleɪt/; [vi]推测,猜测;投机,做投机买卖; [vt]推测; [or]yshx;
sphere: [a]/sfɪr/; [n]球;球形;领域; [or]yshx;
spill: [a]/spɪl/; [v]使溢出;使流出;撒;浇(花等); [n]溢出,溅出;溢出量;摔下; [or]yshx;
spin: [a]/spɪn/; [v](使)旋转;纺织;疾驰;眩晕; [n]旋转;纺织;眩晕; [or]yshx;
spiral: [a]/ˈspaɪrəl/; [n]螺旋,螺线; [v]不断急剧地上升(或下降),螺旋形行进; [adj]螺旋的; [or]yshx;
spiritual: [a]/ˈspɪrɪtʃuəl/; [adj]精神(上)的;宗教(上)的; [or]yshx;
spit: [a]/spɪt/; [v]吐(唾沫); [n]唾液,唾沫,叉子; [or]yshx;
splash: [a]/splæʃ/; [v]泼洒,溅,使成斑驳状;将.置于显眼位置; [n]污点;飞溅的水;卖弄;拍打水的声音; 落入水的声音; [or]yshx;
splendid: [a]/ˈsplendɪd/; [adj]壮观的,辉煌的,华丽的;极好的,出色的; [or]yshx;
split: [a]/splɪt/; [n]劈裂;裂缝;碎片;分裂;不和; [adj]分裂的;不一致的; [v]分开;裂开;被撕破;劈开;割开;撕裂;分配;分担;使分裂; [or]yshx;
spoil: [a]/spɔɪl/; [v]溺爱;娇惯;(食物)变质;毁坏; [n]溺爱;战利品;犒劳;成功所带来的好处; [or]yshx;
spokesman: [a]/ˈspoʊksmən/; [n]发言人; [or]yshx;
sponge: [a]/spʌndʒ/; [n]海绵,多孔布丁,松蛋糕; [v]用湿海绵(或布)擦,揩; [or]yshx;
sponsor: [a]/ˈspɑːnsər/; [n]倡导者;提案人;赞助人;担保人;教父,教母; [vt]发起;倡议;做.的保人;赞助;资助; [or]yshx;
spontaneous: [a]/spɑːnˈteɪniəs/; [adj]自发的,无意识的;自然的,天真率直的; [or]yshx;
sporadic: [a]/spəˈrædɪk/; [adj]不定时发生的;零星的;分散的; [or]yshx;
spotlight: [a]/ˈspɑːtlaɪt/; [n]聚光灯; [v]聚光照明,使显著; [or]yshx;
spouse: [a]/spaʊs/; [n]配偶,夫妇;夫,妻; [v]和.结婚; [or]yshx;
sprawl: [a]/sprɔːl/; [n]四肢伸开的躺卧姿势;蔓生; [v]四肢伸开地坐(或卧);爬行;蔓生; [or]yshx;
spray: [a]/spreɪ/; [n]浪花;水雾;喷雾; [vi]飞溅,喷; [vt]喷;向..扫射;散布; [or]yshx;
sprint: [a]/sprɪnt/; [v]疾跑,冲刺; [n]全速奔跑; [or]yshx;
sprout: [a]/spraʊt/; [v]发芽,开始生长;发展; [n]苗芽; [or]yshx;
spur: [a]/spɜːr/; [v]策马,用踢马刺驱马前进;激励,鞭策;推动; [n]踢马刺,靴刺;刺激,鞭策,鼓励;尖坡; [or]yshx;
square: [a]/skwer/; [n]正方形;广场; [adj]正方形的;平方的;直角的; [v]把..弄成方形; [adv]直接地; [or]yshx;
squeeze: [a]/skwiːz/; [v](常指用手)挤压;挤进,塞进;用力挤压榨取;减少,压缩; [n]榨;压榨;挤,塞; [or]yshx;
stabilize: [a]/ˈsteɪbəlaɪz/; [v]使稳定; [or]yshx;
stack: [a]/stæk/; [n]堆,一大堆;烟囱; [v]堆积,堆放; [or]yshx;
stadium: [a]/ˈsteɪdiəm/; [n](周围有看台的)体育场,露天大型运动场; [or]yshx;
staff: [a]/stæf/; [n]全体职员,员工;参谋;拐杖;五线谱; [adj]行政工作的;参谋的;职员的;作为正式工作人员的; [v]雇用工作人员;给.配备员工; [or]yshx;
stagger: [a]/ˈstæɡər/; [v]蹒跚;(使)错开(时间),交错安排;使吃惊; [n]蹒跚; [or]yshx;
stagnant: [a]/ˈstæɡnənt/; [adj]不流动的;停滞的;萧条的; [or]yshx;
stain: [a]/steɪn/; [n]污渍,污迹;染色; [v]弄脏;玷污;染色; [or]yshx;
stake: [a]/steɪk/; [n]木桩;赌注;利害关系;股份,股本;(赛马)奖金; [v]下注,以桩来支撑; [or]yshx;
stale: [a]/steɪl/; [adj]不新鲜的;走了味的;陈腐的; [v]变得不新鲜;使陈旧; [n](猎人做掩蔽用的)假马;笑柄;受人愚弄成为笑谈的人;畜尿; [or]yshx;
stall: [a]/stɔːl/; [n]分隔栏;售货摊;厩; [v]停止(因故障); [or]yshx;
stand by sb.: [a]/stænd baɪ ˈsʌmbədi/; [v]支持某人; [or]yshx;
stand by sth.: [a]/stænd baɪ ˈsʌmθɪŋ/; [phr]信守;支持; [or]yshx;
stand for sth.: [a]/stænd fɔːr ˈsʌmθɪŋ/; [v]表示;代表; [or]yshx;
stand in (for sb.): [a]/stænd ɪn fɔːr ˈsʌmbədi/; [v]代替; [or]yshx;
stand in line: [a]/stænd ɪn laɪn/; [v]排队; [or]yshx;
stand off: [a]/stænd ɑf/; [phr]远离;疏远; [or]yshx;
stand out: [a]/stænd aut/; [phr]突出;继续抵抗; [or]yshx;
standard: [a]/ˈstændərd/; [n]标准,规格;规范; [adj]标准的; [or]yshx;
staple: [a]/ˈsteɪpl/; [v]用订书钉订; [n]订书钉;主食;主要产品; [adj]主要的;基本的;标准的; [or]yshx;
starch: [a]/stɑːrtʃ/; [n]淀粉; [v]给.上浆; [or]yshx;
starve: [a]/stɑːrv/; [v](使)饿死,挨饿; [or]yshx;
statesman: [a]/ˈsteɪtsmən/; [n]政治家; [or]yshx;
static: [a]/ˈstætɪk/; [adj]静电的,静态的,静止的; [n]静电,静电干扰; [or]yshx;
stationary: [a]/ˈsteɪʃəneri/; [adj]静止的;固定的; [n]定居者,驻军; [or]yshx;
stationery: [a]/ˈsteɪʃəneri/; [n]文具;(有配套信封的)信纸; [or]yshx;
statistics: [a]/stəˈtɪstɪks/; [n]统计;统计数字,数据;统计学; [or]yshx;
status: [a]/ˈsteɪtəs/; [n]地位;状态;身份; [or]yshx;
statute: [a]/ˈstætʃuːt/; [n]法令,法规,条例; [or]yshx;
steadfast: [a]/ˈstedfæst/; [adj]坚定的;不变的; [or]yshx;
steady: [a]/ˈstedi/; [adj]稳定的,不变的;坚定的,扎实的,镇定的; [v](使)稳固,(使)稳定;使..冷静; [or]yshx;
steak: [a]/steɪk/; [n]牛排;肉块;鱼块; [or]yshx;
steamer: [a]/ˈstiːmər/; [n]蒸汽船;蒸锅; [or]yshx;
steep: [a]/stiːp/; [v]沉浸于..; [adj]陡峭的;急剧的;过高的; [n]陡坡; [or]yshx;
steer: [a]/stɪr/; [v]操纵,驾驶,掌舵,引导; [n]公牛,食用牛; [or]yshx;
stem: [a]/stem/; [n]茎,(树)干; [v]阻止;起源于;遏制,抑制; [or]yshx;
stereo: [a]/ˈsterioʊ/; [n]立体声(装置); [adj]立体声的; [or]yshx;
stereotype: [a]/ˈsteriətaɪp/; [n]老套的模式,陈规,成见; [v]对..产生成见; [or]yshx;
sterilize: [a]/ˈsterəlaɪz/; [vt]消毒;使不孕;使(土地)不毛; [or]yshx;
sterling: [a]/ˈstɜːrlɪŋ/; [n]英国货币; [adj]高尚的;出色的,优秀的;英币的; [or]yshx;
stern: [a]/stɜːrn/; [adj]严厉的;严峻的;苛刻的;坚决的; [n]船尾; [or]yshx;
steward: [a]/ˈstuːərd/; [n]乘务员,服务员;管家; [or]yshx;
stick around: [a]/stɪk ə'raʊnd/; [v]逗留; [or]yshx;
stick sth. out: [a]/stɪk ˈsʌmθɪŋ aʊt/; [v]伸出; [or]yshx;
stick to sb. (sth.): [a]/stɪk tu ˈsʌmbədi (ˈsʌmθɪŋ)/; [phr]忠于; [or]yshx;
stick up: [a]/stɪk ʌp/; [phr]竖起; [or]yshx;
stiff: [a]/stɪf/; [adj]僵直的,酸痛的;硬的;困难的; [or]yshx;
stimulus: [a]/ˈstɪmjələs/; [n]刺激物;鼓励;促进因素; [or]yshx;
sting: [a]/stɪŋ/; [v]叮;刺疼;使苦闷;蜇; [n](因被刺而引起的)疼痛;(警方为抓捕罪犯精心设计的)圈套; [or]yshx;
stipulate: [a]/ˈstɪpjuleɪt/; [v]规定;保证;保证;要求以.为条件; [or]yshx;
stitch: [a]/stɪtʃ/; [v]缝,绣; [n]一针,线迹;缝法,编结法;(肋部的)突然剧痛;缝合(伤口); [or]yshx;
stock: [a]/stɑːk/; [n]股票;股份;存货;储备;家畜; [v]给..装满;储存; [adj]储备的; [or]yshx;
stoop: [a]/stuːp/; [v]弯腰,俯身;屈从;堕落,沦为; [n]弯腰; [or]yshx;
story: [a]/ˈstɔːri/; [n]故事,小说;叙述,描述;新闻报道;谎言,假话;楼层; [or]yshx;
straightforward: [a]/ˌstreɪtˈfɔːrwərd/; [adj]坦率的,笔直的,正直的,直接的; [or]yshx;
strain: [a]/streɪn/; [n]负担;紧张;拉力;(生物体)品种,种类; [v]拉紧;劳累;过分使用; [or]yshx;
strait: [a]/streɪt/; [n]海峡;窘迫; [or]yshx;
strap: [a]/stræp/; [v]捆扎; [n]带子; [or]yshx;
strategic: [a]/strəˈtiːdʒɪk/; [adj]战略(上)的,对全局有重要意义的,关键的; [or]yshx;
strengthen: [a]/ˈstreŋθn/; [v]加强,变坚固,变强大; [or]yshx;
strenuous: [a]/ˈstrenjuəs/; [adj]费力的;奋发的;热心的;艰苦的;紧张的; [or]yshx;
stress: [a]/stres/; [n]强调;节拍;紧迫;压力; [vt]给.加压力;使紧张;强调; [or]yshx;
stretch: [a]/stretʃ/; [v]伸展,延伸,张开,夸大,超越; [n]伸展,张开;一段时间;一段路程; [adj]可伸缩的;弹性的; [or]yshx;
stride: [a]/straɪd/; [v]大步走;越过;跨越; [vt]大步走过;跨骑在.上; [n]大步;阔步行走的姿势;一大步;跨越;正常的进展; [or]yshx;
striking: [a]/ˈstraɪkɪŋ/; [adj]容貌出众的,吸引人的;显著的,突出的; [n]罢工; [or]yshx;
string: [a]/strɪŋ/; [n]弦,线,细绳,一系列;一行; [v]串起;悬挂;使紧张; [adj]线的,线织的;由弦乐器组成的; [or]yshx;
strip: [a]/strɪp/; [v]剥;夺去;脱衣服; [n]长条;长条形土地; [adj]脱衣舞的;被剥去外皮的; [or]yshx;
strive: [a]/straɪv/; [v]斗争;努力,奋斗; [or]yshx;
stroke: [a]/stroʊk/; [n]击打;一击,一次,一举;中风;抚摸;笔画; [v]拭去;轻抚; [or]yshx;
structural: [a]/ˈstrʌktʃərəl/; [adj]结构的,构造的,建筑的; [or]yshx;
stubborn: [a]/ˈstʌbərn/; [adj]顽固的;倔强的;难对付的; [or]yshx;
stuff: [a]/stʌf/; [n]东西;材料;原料; [v]塞满;把..装进; [adj]毛织品做的; [or]yshx;
stumble: [a]/ˈstʌmbl/; [v]绊跌,绊倒;结结巴巴说话; [n]绊倒;失足;失误;失败; [or]yshx;
sturdy: [a]/ˈstɜːrdi/; [adj]结实的;坚固的;强壮的;健壮的; [n](羊的)晕倒病; [or]yshx;
style: [a]/staɪl/; [n]风格;样式; [v]称呼;设计; [or]yshx;
subdue: [a]/səbˈduː/; [v]征服,压制,减轻; [or]yshx;
submerge: [a]/səbˈmɜːrdʒ/; [v]沉没,淹没;遮掩; [or]yshx;
submit: [a]/səbˈmɪt/; [v]提交;屈服,使...服从;建议,主张; [or]yshx;
subordinate: [a]/səˈbɔːrdɪnət/; [n]部下;下属; [adj]次要的;从属的;下级的; [v]使从属于;使处于次要地位; [or]yshx;
subscribe: [a]/səbˈskraɪb/; [vi]捐款;订阅;认购(股份); [vt]申请; [or]yshx;
subsequent: [a]/ˈsʌbsɪkwənt/; [adj]随后的; [or]yshx;
subside: [a]/səbˈsaɪd/; [vi]平息,减弱;减弱;(建筑)下陷;(尤指洪水的水位) 回落; [or]yshx;
substantiate: [a]/səbˈstænʃieɪt/; [v]证实;使实体化; [or]yshx;
substitute: [a]/ˈsʌbstɪtuːt/; [v]代替; [n]代替者,代用品,替补队员; [or]yshx;
subtle: [a]/ˈsʌtl/; [adj]微妙的;敏锐的;不明显的;精细的;狡猾的; [or]yshx;
subtract: [a]/səbˈtrækt/; [v]减少;减去;扣除; [vt]减去; [or]yshx;
succession: [a]/səkˈseʃn/; [n]连续,继续;一连串;继承权; [or]yshx;
succumb: [a]/səˈkʌm/; [v]屈从,屈服,因.死亡(to); [or]yshx;
suck: [a]/sʌk/; [v]啜,吸入,吸收;使卷入;糟糕,差劲; [n]吸吮,吸力; [or]yshx;
sue: [a]/suː/; [v]控告,提起诉讼;控告;起诉; [n]女子名(Sue); [or]yshx;
sufficient: [a]/səˈfɪʃnt/; [adj]足够的;充分的; [or]yshx;
suicide: [a]/ˈsuːɪsaɪd/; [n]自杀;自毁; [or]yshx;
suitcase: [a]/ˈsuːtkeɪs/; [n]小提箱,手提箱; [or]yshx;
summary: [a]/ˈsʌməri/; [n]摘要,总结; [adj]简略的,概要的,即决的; [or]yshx;
summit: [a]/ˈsʌmɪt/; [n]山顶,顶点;(政府间的)峰会; [or]yshx;
summon: [a]/ˈsʌmən/; [v]召唤;召集;聚集; [or]yshx;
superb: [a]/suːˈpɜːrb/; [adj]极好的;壮丽的; [or]yshx;
superficial: [a]/ˌsuːpərˈfɪʃl/; [adj]肤浅的;表面的;微不足道的; [n]表面文章; [or]yshx;
superfluous: [a]/suːˈpɜːrfluəs/; [adj]多余的,过剩的;不必要的; [or]yshx;
superintend: [a]/ˌsuːpərɪnˈtend/; [v]监督;主管;指挥; [or]yshx;
supersede: [a]/ˌsuːpərˈsiːd/; [v]代替;紧接着而到来; [or]yshx;
superstition: [a]/ˌsuːpərˈstɪʃn/; [n]迷信,盲目恐惧; [or]yshx;
supervise: [a]/ˈsuːpərvaɪz/; [v]监督;指导;管理; [or]yshx;
suppress: [a]/səˈpres/; [v]镇压;禁止发表;抑制(感情等);阻止.的生长; [or]yshx;
supreme: [a]/suːˈpriːm/; [adj]至高的;最重要的;极度的; [or]yshx;
surcharge: [a]/ˈsɜːrtʃɑːrdʒ/; [n]额外费用,过高的要价; [v]追加罚款;使.装载过多;使.负担过重; [or]yshx;
surge: [a]/sɜːrdʒ/; [n]波涛汹涌;波动;激增; [v]波浪般汹涌奔腾;激增; [or]yshx;
surgeon: [a]/ˈsɜːrdʒən/; [n]外科医生; [or]yshx;
surgery: [a]/ˈsɜːrdʒəri/; [n]外科手术;外科; [or]yshx;
surmount: [a]/sərˈmaʊnt/; [v]克服,战胜,越过; [or]yshx;
surpass: [a]/sərˈpæs/; [v]胜过;超出; [or]yshx;
surplus: [a]/ˈsɜːrplʌs/; [adj]过剩的,多余的; [n]过剩,盈余;顺差; [or]yshx;
surrender: [a]/səˈrendər/; [v]投降;屈服;放弃;交出;自首; [n]投降;放弃;屈服;(保险的)解约; [or]yshx;
survey: [a]/ˈsɜːrveɪ/; [n]调查;测量;鉴定; [v]测量,勘测;鉴定;调查; [or]yshx;
survival: [a]/sərˈvaɪvl/; [n]存活;生存; [or]yshx;
susceptible: [a]/səˈseptəbl/; [adj]易受感染的;易受影响的;多情的; [or]yshx;
suspect: [a]/səˈspekt/; [n]嫌疑犯,可疑分子; [v]怀疑,猜疑;推测; [adj]可疑的; [or]yshx;
suspend: [a]/səˈspend/; [v]悬挂,吊;中止;推迟; [or]yshx;
suspense: [a]/səˈspens/; [n]悬疑;焦虑;悬念;悬而未决; [adj]令人挂心的,令人心焦的,产生悬念的; [or]yshx;
suspicious: [a]/səˈspɪʃəs/; [adj]可疑的,引起怀疑的;怀疑的,猜疑的; [or]yshx;
sustain: [a]/səˈsteɪn/; [v]维持;支撑,承受;供养;忍受;遭受,蒙受; [or]yshx;
sustenance: [a]/ˈsʌstənəns/; [n]生计;食物,粮食; [or]yshx;
swallow: [a]/ˈswɑːloʊ/; [n]吞咽;燕子;一次吞咽的量; [vi]做吞咽动作,咽口水; [v]咽下,吞下; [vt]相信; [or]yshx;
swamp: [a]/swɑːmp/; [n]沼泽; [v]淹没,浸没;使困惑,压倒; [or]yshx;
swarm: [a]/swɔːrm/; [n]蜂群;一群,一批人; [v]蜂拥;密集; [vt]蜂拥;挤满; [or]yshx;
sway: [a]/sweɪ/; [v]摇摆,摇曳;动摇(某人); [n]摇摆;支配,影响; [or]yshx;
swear: [a]/swer/; [v]发誓,郑重地说;咒骂; [or]yshx;
sweater: [a]/ˈswetər/; [n]毛衣,厚运动衫,羊毛衫; [or]yshx;
sweep: [a]/swiːp/; [v]打扫;快速移动; [n]清扫;一挥(手,胳膊等);范围,广度;绵延弯曲的地带; [or]yshx;
swell: [a]/swel/; [v](使)膨胀,(使)鼓起; [n]增大,膨胀,肿胀,汹涌; [adj]时髦的;一流的;很好的; [or]yshx;
swerve: [a]/swɜːrv/; [v]转弯,突然改变方向; [n]转向;滑出;逸出;背离; [or]yshx;
swift: [a]/swɪft/; [adj]敏捷的,矫健的;快速的,迅速的; [n]雨燕; [or]yshx;
swirl: [a]/swɜːrl/; [n]漩涡;打旋;涡状形; [v]盘绕;打旋;眩晕;大口喝酒; [or]yshx;
sympathetic: [a]/ˌsɪmpəˈθetɪk/; [adj]有同情心的,同情的;支持的;称心的; [or]yshx;
synchronize: [a]/ˈsɪŋkrənaɪz/; [v]校准时间;使协调;与......同步; [or]yshx;
synonym: [a]/ˈsɪnənɪm/; [n]同义词;同义密码子; [or]yshx;
synthesis: [a]/ˈsɪnθəsɪs/; [n]合成; [or]yshx;
synthetic: [a]/sɪnˈθetɪk/; [adj]合成的,人造的;<语>综合型的,综合性的,借助词尾变化表示句法关系的; [n]合成物; [or]yshx;
systematic: [a]/ˌsɪstəˈmætɪk/; [adj]有系统的,系统化的,有条理的;有计划有步骤的,有条不紊的; [or]yshx;
tablet: [a]/ˈtæblət/; [n]药片;便笺簿;碑,匾; [or]yshx;
taboo: [a]/təˈbuː/; [n]禁忌,(宗教)戒律; [adj](因不道德或危险而)讳忌的,戒律的; [or]yshx;
tacit: [a]/ˈtæsɪt/; [adj]心照不宣的,静默的; [or]yshx;
tackle: [a]/ˈtækl/; [v]对付,处理;(足球等比赛中)阻截; [n]阻截;钓具;滑轮(组); [or]yshx;
tactic: [a]/ˈtæktɪk/; [n](达到目的)手段,战术,策略; [adj]按顺序的;依次排列的; [or]yshx;
take after sb.: [a]/teɪk ˈæftər ˈsʌmbədi/; [v]像某人; [or]yshx;
take off: [a]/teɪk, ɒf/; [phr](飞机)起飞;拿掉;取消;脱衣;(事业)突然成功,突然蹿红; [or]yshx;
take one's time (over sth.): [a]/teɪk wʌnz taɪm ˈoʊvər ˈsʌmθɪŋ/; [v]慢慢做; [or]yshx;
take pains to do: [a]/teɪk peɪnz tu doʊ/; [phr]尽力去做;费劲苦心做某事; [or]yshx;
take sb. in: [a]/teɪk ˈsʌmbədi ɪn/; [phr]收留;欺骗;带到警察局; [or]yshx;
take sb. off: [a]/teɪk ˈsʌmbədi ɑːf/; [phr]带走; [or]yshx;
take sb. out: [a]/teɪk ˈsʌmbədi aʊt/; [phr]带.出去;淘汰出局; [or]yshx;
take sth. apart: [a]/teɪk ˈsʌmθɪŋ əˈpɑːrt/; [phr]拆开; [or]yshx;
take sth. back: [a]/teɪk ˈsʌmθɪŋ bæk/; [phr]收回;取回; [or]yshx;
take sth. down: [a]/teɪk ˈsʌmθɪŋ daʊn/; [v]记录下来;拆除; [or]yshx;
take sth. in: [a]/teɪk ˈsʌmθɪŋ ɪn/; [v]承接;领会;改小尺寸; [or]yshx;
take sth. into account: [a]/teɪk ˈsʌmθɪŋ ˈɪntu əˈkaʊnt/; [v]考虑到某事; [or]yshx;
take sth. off: [a]/teɪk ˈsʌmθɪŋ ɑːf/; [phr]除去;取消;脱掉; [or]yshx;
take sth. out: [a]/teɪk ˈsʌmθɪŋ aʊt/; [v]去掉;取得,取出; [or]yshx;
take sth. over: [a]/teɪk ˈsʌmθɪŋ ˈoʊvər/; [v]接管; [or]yshx;
take sth. to heart: [a]/teɪk ˈsʌmθɪŋ tu hɑːrt/; [phr]牢记;为某事耿耿于怀; [or]yshx;
take sth. upon oneself: [a]/teɪk ˈsʌmθɪŋ əˈpɔːn wʌnˈself/; [phr]承担;担任; [or]yshx;
take stock of: [a]/teɪk stɒk ɑv/; [v]估量;观察; [or]yshx;
take to sth.(sb.): [a]/teɪk tu ˈsʌmθɪŋ ˈsʌmbədi/; [phr]喜欢;养成.习惯; [or]yshx;
take-away: [a]/teɪk əˈweɪ/; [phr]外带,外卖; [or]yshx;
talented: [a]/ˈtæləntɪd/; [adj]有才能的,天资高的; [or]yshx;
tame: [a]/teɪm/; [adj]驯服的,温顺的;顺从的;枯燥的; [v]驯服; [or]yshx;
tamper: [a]/ˈtæmpər/; [v]篡改;玩弄;贿赂; [n]填塞者;捣棒; [or]yshx;
tangle: [a]/ˈtæŋɡl/; [v](使)缠结;(使)乱作一团; [n]纠缠;纠结;复杂的问题;困惑; [or]yshx;
tap: [a]/tæp/; [n]塞子;水龙头;轻敲; [v]轻叩,轻敲;监听,窃听 (电话);开发,发掘;利用; [or]yshx;
taxation: [a]/tækˈseɪʃn/; [n]税制,税项,税款; [or]yshx;
tear: [a]/ter/; [v]撕裂,撕碎; [n]眼泪; [or]yshx;
tease: [a]/tiːz/; [v]取笑;挑逗;逗弄;使..渴望;逆梳; [n]爱戏弄别人者; [or]yshx;
technician: [a]/tekˈnɪʃn/; [n]技术员,技师;技术专家; [or]yshx;
technique: [a]/tekˈniːk/; [n]技巧,技能;方法;技术; [or]yshx;
tedious: [a]/ˈtiːdiəs/; [adj]沉闷的,冗长乏味的; [or]yshx;
teem: [a]/tiːm/; [vi]充满;大量存在于; [vt]生下; [or]yshx;
telecommunication: [a]/ˌtelikəˌmjuːnɪˈkeɪʃn/; [n]远程通讯; [adj]与电信有关的; [or]yshx;
telling: [a]/ˈtelɪŋ/; [adj]明显的;生动的; [n]叙述; [or]yshx;
temporary: [a]/ˈtempəreri/; [adj]暂时的,临时的; [or]yshx;
temptation: [a]/tempˈteɪʃn/; [n]引诱,诱惑; [or]yshx;
tenable: [a]/ˈtenəbl/; [adj]站得住脚的;无懈可击的;合理的; [or]yshx;
tenacious: [a]/təˈneɪʃəs/; [adj]坚忍不拔的,固执的,顽强的; [or]yshx;
tenancy: [a]/ˈtenənsi/; [n]租赁;租期; [or]yshx;
tendency: [a]/ˈtendənsi/; [n]趋向,趋势,倾向;癖好,意向;派别; [or]yshx;
tender: [a]/ˈtendər/; [adj]温柔的;嫩的;柔弱的,脆弱的;痛的; [n]煤水车,附属船;投标; [v]提出(希望对方接受的意见等); [or]yshx;
tension: [a]/ˈtenʃn/; [n](精神上的)紧张,不安;紧张局面;拉紧;张力;电压; [v]绷紧; [or]yshx;
tentative: [a]/ˈtentətɪv/; [adj]试探性的;不确定的;暂时的;犹豫不决的; [or]yshx;
terminal: [a]/ˈtɜːrmɪnl/; [n]终点,终端;航站楼;终点站; [adj]末端的;晚期的; [or]yshx;
terminate: [a]/ˈtɜːrmɪneɪt/; [adj]终止的;可结尾的; [vi]结束;结尾; [v]使结束,终止; [or]yshx;
terrace: [a]/ˈterəs/; [n]阳台;梯田;走廊; [vi]成阶地; [adj]梯形的; [vt]使成梯田; [or]yshx;
terrestrial: [a]/təˈrestriəl/; [adj]地球的,陆地的; [n]陆地生物;地球上的人; [or]yshx;
terrific: [a]/təˈrɪfɪk/; [adj]极好的;可怕的;(尺寸或程度)极其巨大的,大的惊人的; [or]yshx;
terse: [a]/tɜːrs/; [adj]简洁的,简明的; [or]yshx;
tertiary: [a]/ˈtɜːrʃieri/; [adj]第三的,第三级的;第三品级的; [n]<地质学>第三纪;第三品级的神职人员; [or]yshx;
the accused: [a]/ði əˈkjuːzd/; [n]被告; [or]yshx;
the gist: [a]/ðə dʒɪst/; [n]要旨; [or]yshx;
the pick of: [a]/ðə pɪk ɑv/; [phr]精华,最好部分; [or]yshx;
the present day: [a]/ˌpreznt ˈdeɪ/; [phr]现代; [or]yshx;
theft: [a]/θeft/; [n]偷盗,失窃; [or]yshx;
theme: [a]/θiːm/; [n]主题;主旨;主旋律; [adj]主题的; [v]赋予.某种主题; [or]yshx;
thermal: [a]/ˈθɜːrml/; [adj]保暖的;温泉的;热的; [n]保暖内衣裤; [or]yshx;
thermometer: [a]/θərˈmɑːmɪtər/; [n]温度计; [or]yshx;
thermostat: [a]/ˈθɜːrməstæt/; [n]恒温器; [or]yshx;
thesaurus: [a]/θɪˈsɔːrəs/; [n]词典,分类词汇汇编; [or]yshx;
thesis: [a]/ˈθiːsɪs/; [n](学位)论文,论题,论点; [or]yshx;
thigh: [a]/θaɪ/; [n]大腿; [or]yshx;
think nothing of: [a]/θɪŋk ˈnʌθɪŋ ɑv/; [v]把.看作平常; [or]yshx;
thirst: [a]/θɜːrst/; [n]渴;干渴,缺水;渴求,渴望; [v]渴求; [or]yshx;
thorough: [a]/ˈθɜːroʊ/; [adj]彻底的,完全的;详尽的,细致深入的; [or]yshx;
thoughtful: [a]/ˈθɔːtfl/; [adj]体贴的;沉思的; [or]yshx;
threshold: [a]/ˈθreʃhoʊld/; [n]门槛;开端; [or]yshx;
thrill: [a]/θrɪl/; [n]兴奋,激动,引起激动的事物; [v](使)非常兴奋,(使)非常激动; [or]yshx;
thrive: [a]/θraɪv/; [v]茁壮成长;繁荣,兴旺; [or]yshx;
throat: [a]/θroʊt/; [n]咽喉,嗓子;口子; [or]yshx;
throbbing: [a]/ˈθrɑːbɪŋ/; [adj]跳动的,悸动的; [or]yshx;
throng: [a]/θrɔːŋ/; [v]群集,蜂拥; [n]一大群人; [vt]挤向; [or]yshx;
throughout: [a]/θruːˈaʊt/; prep. 在..期间,贯穿;遍及; [adv]自始至终;到处; [or]yshx;
thrust: [a]/θrʌst/; [v]猛冲,猛推;刺,戳; [n]猛冲,推进;推力;主要观点; [or]yshx;
thumb: [a]/θʌm/; [n]拇指; [vt]以拇指示意;迅速翻阅; [vi]<口语>作手势要求搭车; [or]yshx;
thunder: [a]/ˈθʌndər/; [n]雷,雷声;轰隆声; [v]打雷;大声抱怨,吼叫; [or]yshx;
tick: [a]/tɪk/; [n]勾号,(钟表)滴答声,一刹那; [v]用勾作为记号,发出滴答声; [or]yshx;
tide: [a]/taɪd/; [n]潮,潮汐;潮流; [vi]随潮漂浮; [or]yshx;
tighten: [a]/ˈtaɪtn/; [v]拉紧;使..更严格; [or]yshx;
tilt: [a]/tɪlt/; [v](使)倾斜; [n]倾斜,斜坡; [or]yshx;
timely: [a]/ˈtaɪmli/; [adj]适时的,及时的; [adv]及时地; [or]yshx;
timidity: [a]/tɪˈmɪdəti/; [n]胆怯; [or]yshx;
tinge: [a]/tɪndʒ/; [n]淡淡的(颜色,神色),轻微,少量; [v]给.染色,轻微地影响; [or]yshx;
tire: [a]/ˈtaɪər/; [v](使)疲倦,(使)厌倦; [n]轮胎,车胎; [or]yshx;
tissue: [a]/ˈtɪʃuː/; [n]面巾纸,(动植物的)组织,纱布; [or]yshx;
title: [a]/ˈtaɪtl/; [n]标题;头衔;权利; [vt]加标题于;授予.称号; [adj]标题的,题目的;称呼的; [or]yshx;
to one's face: [a]/tu wʌnz feɪs/; [phr]坦白地;当面; [or]yshx;
toast: [a]/toʊst/; [n]敬酒;烤面包,吐司; [v]为..祝酒;烤;烘; [or]yshx;
toddle: [a]/ˈtɑːdl/; [v](如小孩)蹒跚学步; [n]东倒西歪的走路;刚学走步的小孩; [or]yshx;
toil: [a]/tɔɪl/; [v]苦干;跋涉;费力地做; [n]辛苦;苦工;罗网; [or]yshx;
token: [a]/ˈtoʊkən/; [n]象征;礼券,代金券;筹码,代币; [adj]象征性的; [or]yshx;
tolerance: [a]/ˈtɑːlərəns/; [n]容忍,宽恕;忍耐力; [or]yshx;
toll: [a]/toʊl/; [n]伤亡人数;(道路等的)通行费;钟声; [v]敲钟; [or]yshx;
toneless: [a]/ˈtoʊnləs/; [adj]单调的;缺乏声调的; [adv]声调平板地; [or]yshx;
tonic: [a]/ˈtɑːnɪk/; [n]补药;主调音或基音; [adj]滋补的;声调的;使精神振作的; [or]yshx;
torch: [a]/tɔːrtʃ/; [n]手电筒;火把,火炬; [v]放火烧,纵火烧(建筑物或汽车); [or]yshx;
torrent: [a]/ˈtɔːrənt/; [n]湍流,洪流,奔流;迸发,连发,爆发;倾盆大雨; [or]yshx;
torture: [a]/ˈtɔːrtʃər/; [v]对.施以酷刑,拷问,折磨; [n]酷刑,折磨; [adj]遭受重创的;饱受煎熬的; [or]yshx;
toss: [a]/tɔːs/; [v]扔,抛,掷; [n]掷,掷钱币来决定,猛抬头; [or]yshx;
tough: [a]/tʌf/; [adj]坚韧的;健壮的;嚼不动的;棘手的;困难的; [adv]强硬地,顽强地; [n]暴徒,恶棍; [v]坚持,忍受; [or]yshx;
tourism: [a]/ˈtʊrɪzəm/; [n]旅游,旅游业; [or]yshx;
tournament: [a]/ˈtʊrnəmənt/; [n]锦标赛,联赛;比赛; [or]yshx;
towel: [a]/ˈtaʊəl/; [n]毛巾,手巾; [v]用毛巾擦; [or]yshx;
toxic: [a]/ˈtɑːksɪk/; [n]毒物; [adj]有毒的;中毒的; [or]yshx;
track: [a]/træk/; [v]跟踪追赶;用纤拉船; [n]跑道;小路;行动路线;足迹;轨道; [or]yshx;
tract: [a]/trækt/; [n]器官系统;一大片地;短文,小册子; [or]yshx;
traction: [a]/ˈtrækʃn/; [n]拽;牵引;牵引力;附着磨擦力; [or]yshx;
trail: [a]/treɪl/; [n]小径,路径;记号,痕迹,线索; [v]拽;跟;落后于;追赶;(烟等)袅袅升起; [or]yshx;
trait: [a]/treɪt/; [n]特征; [or]yshx;
traitor: [a]/ˈtreɪtər/; [n]卖国贼,叛徒; [or]yshx;
tramp: [a]/træmp/; [n]流浪汉;无业游民;沉重的脚步声;长途跋涉; [v]重步行走;踏;践踏; [or]yshx;
transaction: [a]/trænˈzækʃn/; [n]交易;办理;事务;学报; [or]yshx;
transcend: [a]/trænˈsend/; [v]超越(经验,理性,信念等)的范围,超过; [or]yshx;
transfer: [a]/trænsˈfɜːr/; [v]转移;调任;换乘;转变;改编; [n]转让;转移;调任;汇兑; [or]yshx;
transform: [a]/trænsˈfɔːrm/; [v]将..变形,改变,转换; [or]yshx;
transgress: [a]/trænzˈɡres/; [v]冒犯,违背;侵犯;越界; [or]yshx;
transistor: [a]/trænˈzɪstər/; [n]晶体管;半导体收音机; [or]yshx;
transit: [a]/ˈtrænzɪt/; [n]运输;运送; [v]运送;通过; [or]yshx;
translucent: [a]/trænsˈluːsnt/; [adj]半透明的;透亮的,有光泽的;易懂的;真实的; [or]yshx;
transmission: [a]/trænsˈmɪʃn/; [n]发射,转播,传播,变速器; [or]yshx;
transparent: [a]/trænsˈpærənt/; [adj]透明的,清澈的,明净的;易识破的,显而易见的; [or]yshx;
transplant: [a]/trænsˈplænt/; [n]移种;移植; [v]移植(器官),使移居,移种(植物等); [or]yshx;
transport: [a]/ˈtrænspɔːrt/; [v]运输;使狂喜;流放; [n]运输;运输工具;流放犯; [or]yshx;
trap: [a]/træp/; [n]陷阱;捕兽夹;圈套,诡计;双轮轻便马车;嘴; [v]诱骗;困住; [or]yshx;
trauma: [a]/ˈtraʊmə/; [n]精神创伤,外伤; [or]yshx;
traverse: [a]/trəˈvɜːrs/; [v]横越;穿过; [n]横越; [or]yshx;
treatise: [a]/ˈtriːtɪs/; [n]论述;论文;专著; [or]yshx;
treble: [a]/ˈtrebl/; [n]最高声部; [v]使成三倍; [adj]三倍的,最高声部的; [or]yshx;
trek: [a]/trek/; [n]艰苦跋涉; [v]拉(货车),搬运; [or]yshx;
tremble: [a]/ˈtrembl/; [v]发抖;哆嗦;摇动; [n]发抖;震颤; [or]yshx;
tremendous: [a]/trəˈmendəs/; [adj]巨大的;极大的;惊人的; [or]yshx;
trend: [a]/trend/; [n]趋势;倾向;时尚; [v]倾向;走向;转向;使趋向; [or]yshx;
trespass: [a]/ˈtrespæs/; [v]侵入;犯罪; [n]罪过;非法侵入; [or]yshx;
trial: [a]/ˈtraɪəl/; [n]审判,审理;试验;试用;磨炼,苦难; [adj]试验的,试验性的;考验的;审判的; [v]测试; [or]yshx;
triangle: [a]/ˈtraɪæŋɡl/; [n]三角形; [or]yshx;
trick: [a]/trɪk/; [v]哄骗;捉弄,戏弄; [n]恶作剧,诡计;技艺,戏法; [adj]虚弱的; [or]yshx;
trickle: [a]/ˈtrɪkl/; [v]一滴滴地流;徐徐地流; [n]细流;徐徐地流;稀稀疏疏缓慢来往的东西; [or]yshx;
trifle: [a]/ˈtraɪfl/; [n]蛋糕;琐事,小事,无价值的东西; [v]嘲笑,轻视; [or]yshx;
trigger: [a]/ˈtrɪɡər/; [n](枪等的)扳机,诱因; [v]触发,引起,激发,扣扳机; [or]yshx;
trim: [a]/trɪm/; [n]修剪;整齐;装饰; [v]修剪;整理;装饰; [adj](人)苗条的;整洁的; [adv]整齐<整洁>地; [or]yshx;
triumph: [a]/ˈtraɪʌmf/; [n]喜悦,狂喜;凯旋,胜利; [v]成功,获胜; [or]yshx;
tropic: [a]/ˈtrɑːpɪk/; [n]热带,回归线; [adj]热带的; [or]yshx;
trumpet: [a]/ˈtrʌmpɪt/; [n]喇叭,小号;小号声;小号手;传声筒; [v]吹喇叭;发出喇叭般的声音;用喇叭吹出;发喇叭似的声音;大声宣布;宣扬; [or]yshx;
trunk: [a]/trʌŋk/; [n]树干;象鼻;(人)躯干;大衣箱;主体;(车的)后备箱;汽车车尾的行李箱; [or]yshx;
trustworthy: [a]/ˈtrʌstwɜːrði/; [adj]可信赖的,可靠的; [or]yshx;
try one's hand at: [a]/traɪ wʌnz hænd æt/; [v]尝试着做.; [or]yshx;
tuck: [a]/tʌk/; [v]把(衬衫,餐巾等的)边塞到里面;把.夹入,把.藏入; [n](衣服等的)褶,裥; [or]yshx;
tug: [a]/tʌɡ/; [v]用力拖(或拉); [n]猛拉;牵引; [or]yshx;
tuition: [a]/tuˈɪʃn/; [n]学费,教学,讲授; [or]yshx;
tumble: [a]/ˈtʌmbl/; [v]翻滚;不由自主地卷入;(价格等)暴跌;跌倒,摔下,滚下; [n]跌倒,摔倒; [or]yshx;
tune: [a]/tuːn/; [n]曲调,旋律,协调,调动; [v]<电子><通信>调谐;协调; [or]yshx;
tunnel: [a]/ˈtʌnl/; [n]隧道; [v]挖地道; [or]yshx;
turbulent: [a]/ˈtɜːrbjələnt/; [adj]湍急的;混乱的,动荡的;骚动的; [or]yshx;
turf: [a]/tɜːrf/; [n]草地,草皮; [v]覆草皮; [or]yshx;
turmoil: [a]/ˈtɜːrmɔɪl/; [n]骚动,骚乱; [or]yshx;
turnover: [a]/ˈtɜːrnoʊvər/; [n]成交量;营业收入;人员更替率;半圆卷饼; [or]yshx;
tweezers: [a]/ˈtwiːzərz/; [n]镊子,小钳子; [or]yshx;
twilight: [a]/ˈtwaɪlaɪt/; [n]黄昏,薄暮,黎明;晚期,没落时期; [adj]微明的;界限不清的; [or]yshx;
twinkle: [a]/ˈtwɪŋkl/; [vi]闪烁;闪闪发光; [or]yshx;
twist: [a]/twɪst/; [v]捻,搓;扭;歪曲; [n]搓,扭拧;意外进展;弯曲处; [or]yshx;
typical: [a]/ˈtɪpɪkl/; [adj]典型的;代表性的; [or]yshx;
ultimatum: [a]/ˌʌltɪˈmeɪtəm/; [n]最后通牒; [or]yshx;
ultraviolet: [a]/ˌʌltrəˈvaɪələt/; [adj]紫外线;紫外线的; [or]yshx;
unanimous: [a]/juˈnænɪməs/; [adj]全体一致的;一致同意的; [or]yshx;
uncalled-for: [a]/ʌn'kɔːldˌfɔː/; [adj]没有必要的,不合适的; [or]yshx;
unconditional: [a]/ˌʌnkənˈdɪʃənl/; [adj]绝对的,无条件的; [or]yshx;
unconscious: [a]/ʌnˈkɑːnʃəs/; [adj]不省人事的;无意识的;未察觉的; [or]yshx;
undercharge: [a]/ˌʌndərˈtʃɑːrdʒ/; [n]索价低于常价;充电不足; [vi]向.少收钱; [vt]向.少收钱; [or]yshx;
underestimate: [a]/ˌʌndərˈestɪmeɪt/; [v]低估;对.估计不足; [or]yshx;
undergo: [a]/ˌʌndərˈɡoʊ/; [v]经历;遭受; [or]yshx;
underline: [a]/ˌʌndərˈlaɪn/; [v]划线于.之下;突出显示;强调; [n]下划线;下期节目预告;图下说明文字; [or]yshx;
underlying: [a]/ˌʌndərˈlaɪɪŋ/; [adj]基本的;潜在的;在下面的; [or]yshx;
undermine: [a]/ˌʌndərˈmaɪn/; [v]暗中破坏;逐渐削弱;侵蚀.的基础;在...下挖坑道,从根基处损害; [or]yshx;
underneath: [a]/ˌʌndərˈniːθ/; [adv]在.下面,在.底下; prep. 在下面; [or]yshx;
undertake: [a]/ˌʌndərˈteɪk/; [v]保证;承担,承包; [or]yshx;
underwrite: [a]/ˌʌndərˈraɪt/; [v]给.保险,承诺支付;同意赔款(海上保险); [or]yshx;
undo: [a]/ʌnˈduː/; [v]松开,解开;取消; [or]yshx;
undue: [a]/ˌʌnˈduː/; [adj]过分的,不适当的;过度的;尚未到期的; [or]yshx;
uneasy: [a]/ʌnˈiːzi/; [adj]心神不安,不稳定的,不舒服; [or]yshx;
uneven: [a]/ʌnˈiːvn/; [adj]不平坦的;不均匀的,不规则的;不公正的; [or]yshx;
unfold: [a]/ʌnˈfoʊld/; [v]展开,伸展;表露,显露; [or]yshx;
ungainly: [a]/ʌnˈɡeɪnli/; [adj]笨拙的,不雅的; [adv]笨拙地;不雅地; [or]yshx;
unify: [a]/ˈjuːnɪfaɪ/; [v]使联合,统一;使相同,使一致; [or]yshx;
unique: [a]/juˈniːk/; [adj]独特的,独一无二的;(唯一的)特有的;不同寻常的; [or]yshx;
universal: [a]/ˌjuːnɪˈvɜːrsl/; [adj]普遍存在的;全体的;通用的;宇宙的; [n]普遍原则; [or]yshx;
unrest: [a]/ʌnˈrest/; [n]不安,骚动;动荡的局面;不安的状态; [or]yshx;
untold: [a]/ˌʌnˈtoʊld/; [adj]无数的,数不清的; [or]yshx;
upbringing: [a]/ˈʌpbrɪŋɪŋ/; [n]抚育,抚养,教养; [or]yshx;
update: [a]/ˌʌpˈdeɪt/; [v]更新;为..提供最新信息; [n]更新;最新的情况; [or]yshx;
upkeep: [a]/ˈʌpkiːp/; [n]保养,维持;维修费; [or]yshx;
upright: [a]/ˈʌpraɪt/; [adj]垂直的;正直的; [adv]直立地; [n]立柱; [or]yshx;
uprising: [a]/ˈʌpraɪzɪŋ/; [n]起义;升起; [adj]升起的; [v]起义;升起; [or]yshx;
utility: [a]/juːˈtɪləti/; [n]功用,用途,公用事业,物业; [adj]实用的;通用性的; [or]yshx;
utmost: [a]/ˈʌtmoʊst/; [adj]最大的;极度的;最远的; [n]极限; [or]yshx;
vacant: [a]/ˈveɪkənt/; [adj]空的,未被占用的;闲置的;空缺的;茫然的; [or]yshx;
vacation: [a]/veɪˈkeɪʃn/; [n]休假,假期; [v]休假,度假; [or]yshx;
vacuum: [a]/ˈvækjuəm/; [n]真空吸尘器;真空;空虚,茫然若失; [v]用吸尘器打扫; [or]yshx;
vain: [a]/veɪn/; [adj]爱虚荣的;徒劳的;没有真正意义的,没有真正价值的,无关紧要的;自负的,自高自大的;无益的; [or]yshx;
valuation: [a]/ˌvæljuˈeɪʃn/; [n]估价,评价,鉴定;估定的价值,定价; [or]yshx;
valve: [a]/vælv/; [n]阀门,活门; [or]yshx;
vanish: [a]/ˈvænɪʃ/; [vi]消失;突然不见;消灭; [v]使消失;使不见; [n]<语音学>消失音,弱化音; [or]yshx;
vanity: [a]/ˈvænəti/; [n]自负;无价值的东西;(带镜子的)梳妆台; [or]yshx;
vanquish: [a]/ˈvæŋkwɪʃ/; [v]征服,击败; [or]yshx;
variable: [a]/ˈveriəbl/; [adj]易变的,可变的; [n]变量,可变物; [or]yshx;
vehicle: [a]/ˈviːəkl/; [n]交通工具,机动车;传播媒介;工具,手段; [or]yshx;
venerate: [a]/ˈvenəreɪt/; [v]崇敬,敬仰; [or]yshx;
vent: [a]/vent/; [n]发泄;通风口,排气口;(上衣背部或两侧的)开衩;(小型动物的)排泄口; [v]发泄(情绪),开孔,泄露; [or]yshx;
ventilate: [a]/ˈventɪleɪt/; [v]使.通风,透风;公开讨论; [or]yshx;
venture: [a]/ˈventʃər/; [n]企业;(商业)冒险;投机,风险投资; [vi]冒险前进; [vt]冒.的危险;以.做赌注; [or]yshx;
verbal: [a]/ˈvɜːrbl/; [adj]言语的,口头的,动词的; [or]yshx;
verdict: [a]/ˈvɜːrdɪkt/; [n](陪审团)裁决;定论;意见; [or]yshx;
verge: [a]/vɜːrdʒ/; [n]边缘;边界; [v]接近;濒临; [or]yshx;
versatile: [a]/ˈvɜːrsətl/; [adj]万能的,综合的,多才多艺的; [or]yshx;
versed: [a]/vɜːrst/; [adj]熟练的,精通的; [or]yshx;
versus: [a]/ˈvɜːrsəs/; prep. 以..为对手;与..相对,与..相比; [or]yshx;
vertical: [a]/ˈvɜːrtɪkl/; [adj]垂直的;顶点的; [n]垂直线,垂直面; [or]yshx;
vessel: [a]/ˈvesl/; [n]船,容器,血管; [or]yshx;
veto: [a]/ˈviːtoʊ/; [v]否决;投反对票; [n]否决;否决权;禁止; [or]yshx;
vex: [a]/veks/; [v]使烦恼,使苦恼,使恼怒; [or]yshx;
via: [a]/ˈvaɪə/; prep. 经过,通过; [or]yshx;
viable: [a]/ˈvaɪəbl/; [adj]可行的;能养活的;能生育的; [or]yshx;
vice: [a]/vaɪs/; [n]缺点;恶习;邪恶;罪行;生理缺陷; [adj]副的;代理的; pref. 代理的; [vt]用老虎钳夹紧;钳制; [or]yshx;
vicinity: [a]/vəˈsɪnəti/; [n]附近地区;近邻;附近; [or]yshx;
vicious: [a]/ˈvɪʃəs/; [adj]罪恶的;恶意的;凶猛的,残忍的; [or]yshx;
vigilant: [a]/ˈvɪdʒɪlənt/; [adj]警戒的,警惕的; [or]yshx;
vigorous: [a]/ˈvɪɡərəs/; [adj]精力充沛的;强有力的,有活力的;强健的; [or]yshx;
vindicate: [a]/ˈvɪndɪkeɪt/; [vt]证明.无辜;维护,辩护; [or]yshx;
violate: [a]/ˈvaɪəleɪt/; [v]违反,违背;侵犯,妨碍;亵渎; [or]yshx;
violent: [a]/ˈvaɪələnt/; [adj]强烈的,猛烈的;暴力的,粗暴的; [or]yshx;
virtually: [a]/ˈvɜːrtʃuəli/; [adv]几乎;虚拟地;整个;实际上; [or]yshx;
virtuous: [a]/ˈvɜːrtʃuəs/; [adj]善良的,有德行的,贞洁的; [or]yshx;
virus: [a]/ˈvaɪrəs/; [n]病毒;(计算机) 病毒;病毒性疾病; [or]yshx;
visible: [a]/ˈvɪzəbl/; [adj]看得见的,可见的;显然的,明显的; [or]yshx;
visualize: [a]/ˈvɪʒuəlaɪz/; [v]使形象化;想象; [or]yshx;
vital: [a]/ˈvaɪtl/; [adj]生命所必需的;必不可少的;至关重要的;有活力的;生命攸关的; [n]要害;重要部分; [or]yshx;
vivid: [a]/ˈvɪvɪd/; [adj](颜色)鲜艳的,强烈的(颜色,光);生动的,清晰的(记忆,描述); [or]yshx;
vocational: [a]/voʊˈkeɪʃənl/; [adj]职业的;业务的; [or]yshx;
vogue: [a]/voʊɡ/; [n]时髦,时尚; [adj]流行的; [or]yshx;
volatile: [a]/ˈvɑːlətl/; [adj]易气化的;爆炸性的;反复无常的;短暂的;不稳定的; [or]yshx;
volcano: [a]/vɑːlˈkeɪnoʊ/; [n]火山; [or]yshx;
voltage: [a]/ˈvoʊltɪdʒ/; [n]电压; [or]yshx;
voluntary: [a]/ˈvɑːlənteri/; [adj]自愿的;无偿的;志愿的; [n]即兴曲; [or]yshx;
vomit: [a]/ˈvɑːmɪt/; [n]呕吐物,呕吐; [v]呕吐;吐出;涌出;喷出; [or]yshx;
voucher: [a]/ˈvaʊtʃər/; [n]代金券;证明人;收据;教育补助金券; [vt]为.准备凭据;证实.的可靠性; [or]yshx;
vow: [a]/vaʊ/; [n]誓约; [v]宣誓;立誓;发誓; [or]yshx;
vulgar: [a]/ˈvʌlɡər/; [adj]粗俗的;下流的;平民的;通俗的; [n]平民;方言; [or]yshx;
vulnerable: [a]/ˈvʌlnərəbl/; [adj]易受伤的;脆弱的;易受攻击的; [or]yshx;
wage: [a]/weɪdʒ/; [n]薪水,报酬; [v]开展,进行(战争,运动); [or]yshx;
wail: [a]/weɪl/; [n]恸哭;哀诉; [vi]恸哭;悲叹; [vt]哀悼; [or]yshx;
wander: [a]/ˈwɑːndər/; [v]漫游;蜿蜒;迷路;离题; [n]游荡;闲逛;失散; [or]yshx;
wane: [a]/weɪn/; [n]衰退(期);月亏(期);减少; [v](月)缺损;(光,势力,治理等)衰落;减少; [or]yshx;
warden: [a]/ˈwɔːrdn/; [n]看守人,管理员; [or]yshx;
wardrobe: [a]/ˈwɔːrdroʊb/; [n]衣橱;全部服装;剧服; [or]yshx;
warehouse: [a]/ˈwerhaʊs/; [n]仓库; [or]yshx;
wary: [a]/ˈweri/; [adj]谨慎的,小心的,提防的;考虑周到的; [or]yshx;
weary: [a]/ˈwɪri/; [adj]疲倦的,困乏的,令人厌倦的; [v]使疲倦;使厌倦; [or]yshx;
weave: [a]/wiːv/; [v]织;编织;编进;织布; [n]织法;织物; [or]yshx;
web: [a]/web/; [n]网;蜘蛛网; [or]yshx;
wedge: [a]/wedʒ/; [v]楔入; [n]楔子; [or]yshx;
weird: [a]/wɪrd/; [adj]古怪的;荒唐的; [or]yshx;
weld: [a]/weld/; [v]焊接;使结合,使成整体; [n]焊接; [or]yshx;
welfare: [a]/ˈwelfer/; [n]福利;幸福,健康; [or]yshx;
well-to-do: [a]/ˌwel tə ˈduː/; [adj]富有的,有钱的,生活优裕的,小康的; [or]yshx;
whilst: [a]/waɪlst/; [conj]当..的时候; [n]一会儿;一段时间; [or]yshx;
whip: [a]/wɪp/; [vt]鞭打,抽打;突然拿取,猛然抓住;痛责;驱使;怂恿; [v]一下子猛地移动,急走,急冲; [n]鞭子;抽打;组织秘书;蛋奶水果甜点心; [or]yshx;
whirl: [a]/wɜːrl/; [v]回旋;使旋转; [n]回旋;一个接一个的活动; [or]yshx;
wholesale: [a]/ˈhoʊlseɪl/; [n]批发; [adv]大批大批地; [adj]大规模的;批发的; [v]批发; [or]yshx;
wholesome: [a]/ˈhoʊlsəm/; [adj]有益于健康的;有益的; [or]yshx;
wicked: [a]/ˈwɪkɪd/; [adj]邪恶的,恶毒的;淘气的,恶作剧的; [n]恶人;邪恶的人; [adv]用作加强语气用; [or]yshx;
width: [a]/wɪdθ/; [n]宽度,广度,宽阔; [or]yshx;
wield: [a]/wiːld/; [v]运用,行使;挥; [vt]使用; [or]yshx;
wilderness: [a]/ˈwɪldərnəs/; [n]荒野,荒地; [or]yshx;
wisdom: [a]/ˈwɪzdəm/; [n]智慧,学问;明智,正确判断; [or]yshx;
wit: [a]/wɪt/; [n]富有机智的人;智力,才智;机智;风趣,措辞巧妙的能力; [or]yshx;
withdraw: [a]/wɪðˈdrɔː/; [v]取款;撤退,收回,撤离; [or]yshx;
wither: [a]/ˈwɪðər/; [v]枯萎;凋谢; [vt]使枯萎,使凋谢,萎缩;使人感觉羞惭或迷惑; [or]yshx;
withhold: [a]/wɪðˈhoʊld/; [v]抑制,拒绝给某事物; [or]yshx;
withstand: [a]/wɪðˈstænd/; [v]忍受;抵挡; [or]yshx;
witness: [a]/ˈwɪtnəs/; [n]目击者,证人; [v]目击,亲眼看见;为..作证; [or]yshx;
worthwhile: [a]/ˌwɜːrθˈwaɪl/; [adj]值得(花时间,精力)的,有意义的; [or]yshx;
wrap: [a]/ræp/; [v]裹,包,捆;覆盖; [n]包裹物,覆盖物;外衣; [or]yshx;
wreck: [a]/rek/; [n]沉船,失事船;失事;(事故中)遭严重损坏的汽车(飞机等); [v]破坏,使毁灭; [or]yshx;
wrench: [a]/rentʃ/; [n]扳手;痛苦,难受;猛扭,猛拉; [v]猛拧;挣脱;使扭伤; [or]yshx;
wrestle: [a]/ˈresl/; [v]摔跤,角斗;斗争,努力; [n]摔跤,角力,扭斗; [or]yshx;
wretched: [a]/ˈretʃɪd/; [adj]可怜的;恶劣的;身心疲惫的; [or]yshx;
wrought: [a]/rɔːt/; [adj]锻造的;加工的;精细的; [or]yshx;
yacht: [a]/jɑːt/; [n]游艇;帆船; [or]yshx;
yarn: [a]/jɑːrn/; [n]纱线,故事,奇谈; [or]yshx;
yawn: [a]/jɔːn/; [v]打呵欠;裂开;打着呵欠说; [n]呵欠;乏味或枯燥的事物; [or]yshx;
yearn: [a]/jɜːrn/; [v]渴望,向往; [or]yshx;
yield: [a]/jiːld/; [v]出产;屈服;弯曲;让行; [n]收益; [or]yshx;
yoke: [a]/joʊk/; [n]牛轭;枷锁;纽带; [v]结合;连结; [or]yshx;
zeal: [a]/ziːl/; [n]热情,热心; [or]yshx;
zest: [a]/zest/; [n]兴趣,乐趣;滋味,风味; [v]给.调味; [or]yshx;
zoology: [a]/zuˈɑːlədʒi/; [n]动物学;动物区系; [or]yshx;
