# 1 地理 
insular: [adj]海岛的 [ex]Haiwaii's ~ culture; [or]tf_ibt;
island: [n]岛; [or]tf_ibt;
peninsula: [n]半岛; [or]tf_ibt;
islet: [n]小岛; [or]tf_ibt;
marine: [adj]海的 [ex]~ mammals; [or]tf_ibt;
maritime: [adj]海的 [ex]~ silk road; [or]tf_ibt;
moist: [adj]湿润的,多雨的; [or]tf_ibt;
ledge: [n]暗礁; [or]tf_ibt;
oasis: [n](沙漠中的)绿洲; [or]tf_ibt;
tide: [n]潮汐; [or]tf_ibt;
ebb: [vi]退潮; [or]tf_ibt;
continent: [n]大陆; [or]tf_ibt;
terrestrial: [adj]陆地的 [ex]~ ecosystem; [or]tf_ibt;
territorial: [adj]领土的; [or]tf_ibt;
outskirt: [n]外边,郊区 [ex]the ~s of Beijing; [or]tf_ibt;
region: [n]地区 [ex]the Asia-Pacific ~; [or]tf_ibt;
endemic: [adj]地方的 [ex]a ~ disease; [or]tf_ibt;
cosmopolitan: [adj]世界性的 [ex]a ~ city; [or]tf_ibt;
subterranean: [adj]地下的 [ex]a ~ cavern; [or]tf_ibt;
cavern: [n]大山洞; [or]tf_ibt;
flaw: [n]裂隙; [or]tf_ibt;
cleft: [n]裂缝; [or]tf_ibt;
crevice: [n]裂缝; 破口; [or]tf_ibt;
gap: [n]裂口; 分歧 [ex]generation ~; [or]tf_ibt;
zone: [n]区 [ex]time ~; [or]tf_ibt;
equator: [n]赤道; [or]tf_ibt;
longitude: [n]经度; [or]tf_ibt;
altitude: [n]海拔高度; [or]tf_ibt;
latitude: [n]纬度; [or]tf_ibt;
meridian: [n]子午线;正午 [ex]Meridian Gate(午门); [or]tf_ibt;
subsidiary: [n]支流; [or]tf_ibt;
antarctic: [adj]南极的; [or]tf_ibt;
Antarctica: [n]南极洲; [or]tf_ibt;
Arctic: [adj]北极的; [or]tf_ibt;
coastland: [n]沿海岸地区; [or]tf_ibt;
hemisphere: [n]半球; [or]tf_ibt;
contour: [n]轮廓;海岸线; [or]tf_ibt;
geography: [n]地理学; [or]tf_ibt;
horizon: [n]地平线; [or]tf_ibt;
lowland: [n]底地; [or]tf_ibt;
upland: [n]高地; [or]tf_ibt;
plain: [n]平原; [adj]平的;朴素的; [or]tf_ibt;
strait: [n](地峡,海峡等)狭长地带; [or]tf_ibt;
channel: [n]水道;频道; [or]tf_ibt;
valley: [n]山谷; [or]tf_ibt;
volcano: [n]火山; [or]tf_ibt;
plateau: [n]高原; [or]tf_ibt;
basin: [n]盆地; [or]tf_ibt;
navigation: [n]航海; [or]tf_ibt;
ranges: [n]射程表尺度; [or]tf_ibt;
salinity: [n]盐分; [or]tf_ibt;
sediment: [n]沉淀物; [or]tf_ibt;
elevation: [n]高地;正面图; [or]tf_ibt;
formation: [n]形成; [or]tf_ibt;
geothermy: [n]地热; [or]tf_ibt;
terrain: [n]地形; [or]tf_ibt;
topography: [n]地形学; [or]tf_ibt;
tropical: [adj]热带的; [or]tf_ibt;
tropics: [n]热带地区;回归线 [ex]the Tropic of Cancer(北回归线); [or]tf_ibt;
temperate: [n](气候)温和的 [ex]~ latitudes(温带地区); [or]tf_ibt;

# 2 地质 
vein: [n]矿脉;静脉; [or]tf_ibt;
pit: [n]煤矿;地坑; [or]tf_ibt;
borehole: [n]钻孔,井眼; [or]tf_ibt;
quartz: [n]石英; [or]tf_ibt;
marble: [n]大理石; [or]tf_ibt;
gem: [n]宝石; [or]tf_ibt;
fieldstone: [n](建筑用)散石;大卵石; [or]tf_ibt;
emerald: [n]绿宝石(翡翠等); [or]tf_ibt;
wiikite: [n]杂铌矿; [or]tf_ibt;
granite: [n]花岗岩; [or]tf_ibt;
lead: [n]铅; [vt]领导; [vi]导致; [or]tf_ibt;
limestone: [n]石灰石; [or]tf_ibt;
lava: [n]熔岩; [or]tf_ibt;
ruby: [n]红宝石; [or]tf_ibt;
bonanza: [n]富矿带; [or]tf_ibt;
mineral: [n]矿石; [or]tf_ibt;
ore: [n]矿石; [or]tf_ibt;
fossil: [n]化石; [or]tf_ibt;
petrify: [vt]变为化石 [ex]be ~ied with fear; [or]tf_ibt;
geology: [n]地质学; [or]tf_ibt;
aluminum: [n]铝; [or]tf_ibt;
core: [n]果核;核心; [or]tf_ibt;
crater: [n]弹坑; [or]tf_ibt;
diamond: [n]钻石;菱形; [or]tf_ibt;
glacial: [n]冰河的 [ex]glacial epoch(冰河时期); [or]tf_ibt;
glacier: [n]冰河; [or]tf_ibt;
iceberg: [n]冰山; [or]tf_ibt;
plate: [n]板块;盘子; [or]tf_ibt;
tremor: [n]颤动; [or]tf_ibt;
earthquake: [n]地震; [or]tf_ibt;
seism: [n]地震; [or]tf_ibt;
seismic: [adi]地震的 [ex]~ wave; [or]tf_ibt;
seismology: [n]地震学; [or]tf_ibt;
magnitude: [n]震级; [or]tf_ibt;
cataclysm: [n]大灾难; [or]tf_ibt;
stratum: [n]岩层;阶层 [ex]new social ~; [or]tf_ibt;
mantle: [n]地幔; [or]tf_ibt;
lithogenous: [n]岩成的; [or]tf_ibt;
lithosphere: [n]岩石圈; [or]tf_ibt;
layer: [n]层;阶层; [or]tf_ibt;
crust: [n]地壳;硬外皮 [ex]the ~ of the pie; [or]tf_ibt;
fault: [n]断层  [ex]~ plane(断层面); [or]tf_ibt;
magma: [n]岩浆;稀糊; [or]tf_ibt;
squirt: [v]喷出; [or]tf_ibt;
erupt: [vi](火山)爆发; [or]tf_ibt;
outburst: [n](火山,情感等的)爆发; [or]tf_ibt;
eruption: [n]爆发; 火山灰; [or]tf_ibt;
volcanic: [n]火山的  [ex]~ ash; [or]tf_ibt;

# 3 动物学 
gregarious: [adj](喜欢)群居的; [or]tf_ibt;
swarm: [n](蜜蜂,蚂蚁等的)群; [or]tf_ibt;
flock: [n]羊群;(家禽,野畜等的)群; [or]tf_ibt;
herd: [n]兽群;牧群; [or]tf_ibt;
mammal: [n]哺乳动物; [or]tf_ibt;
carnivore: [n]食肉动物; [or]tf_ibt;
carnivorous: [adj]食肉类的; [or]tf_ibt;
appetite: [n]食欲; [or]tf_ibt;
herbivorous: [adj]食草类的; [or]tf_ibt;
omnivorous: [adj]杂食的; [or]tf_ibt;
predator: [n]食肉动物;掠夺者; [or]tf_ibt;
predatory: [adj]食肉的;掠夺的; [or]tf_ibt;
prey: [n]被掠食者; [or]tf_ibt;
poikilotherm: [n]变温动物;冷血动物; [or]tf_ibt;
rodent: [n]啮齿动物; [or]tf_ibt;
scavenger: [n]清道夫;食腐动物; [or]tf_ibt;
microbe: [n]微生物; 细菌; [or]tf_ibt;
reptile: [n]爬行动物; [or]tf_ibt;
homotherm: [n]恒温动物; [or]tf_ibt;
primate: [n]灵长类的动物; [or]tf_ibt;
primates: [n]灵长类; [or]tf_ibt;
mollusk: [n]软体动物; [or]tf_ibt;
coelenterate: [n]腔肠动物; [or]tf_ibt;
vertebrate: [n]脊椎动物; [or]tf_ibt;
invertebrate: [n]无脊椎动物; [or]tf_ibt;
finch: [n]鸣禽; [or]tf_ibt;
bird: [n]鸟; [or]tf_ibt;
fowl: [n]鸡;家禽; [or]tf_ibt;
monster: [n]怪物; [or]tf_ibt;
hordes: [n]昆虫群; [or]tf_ibt;
insect: [n]昆虫; [or]tf_ibt;
worm: [n]蠕虫; [or]tf_ibt;
beast: [n]野兽(自然界中的);畜生(人类社会中的); [or]tf_ibt;
aquatic: [adj]水生的  [ex]~ plants; [or]tf_ibt;
amphibian: [n]两栖类的;水陆两用的; [or]tf_ibt;
migrate: [vi]迁徙  [ex]~ to; [or]tf_ibt;
graze: [vt]放养 [ex]~ cattle; [or]tf_ibt;
gasp: [v]喘气; [or]tf_ibt;
peck: [v]啄; [or]tf_ibt;
trot: [v]慢跑; [or]tf_ibt;
dormant: [adj]休眠的  [ex]a ~ volcano; [or]tf_ibt;
offspring: [n]子孙后代; [or]tf_ibt;
spawn: [v]产卵; [or]tf_ibt;
pregnant: [adj]怀孕的; [or]tf_ibt;
hatch: [n]破壳孵出;(飞机或宇宙飞船的)舱门; [or]tf_ibt;
breed: [v]饲养; [or]tf_ibt;
domesticate: [vt]驯养]]动物; [or]tf_ibt;
fertilize: [vt]使]]受精; [or]tf_ibt;
regeneration: [n]再生;重建; [or]tf_ibt;
reproduce: [v]再生;繁殖; [or]tf_ibt;
squeak: [vi](老鼠或动物)发出吱吱声; [or]tf_ibt;
chirp: [vi](虫子或鸟)发出喳喳声; [or]tf_ibt;
hibernate: [v]冬眠; [or]tf_ibt;
camouflage: [v]伪装; [or]tf_ibt;
extinction: [n]灭绝; [or]tf_ibt;
monogamous: [adj]一雌一雄的(单配的); [or]tf_ibt;
polyandrous: [n]一雌多雄的(多配的); [or]tf_ibt;
nest: [n]巢穴; [or]tf_ibt;
niche: [n]壁龛;小生态环境;商机; [or]tf_ibt;
pest: [n]害虫; [or]tf_ibt;
habitat: [n]栖息地; [or]tf_ibt;
rhinoceros: [n]犀牛; [or]tf_ibt;
chimpanzee: [n]黑猩猩; [or]tf_ibt;
baboon: [n]狒狒; [or]tf_ibt;
gorilla: [n]大猩猩; [or]tf_ibt;
lizard: [n]蜥蜴; [or]tf_ibt;
moth: [n]蛾子;蛀虫; [or]tf_ibt;
canary: [n]金丝雀;淡黄色; [or]tf_ibt;
caterpillar: [n]毛虫; [or]tf_ibt;
dinosaur: [n]恐龙; [or]tf_ibt;
chameleon: [n]变色龙; [or]tf_ibt;
larva: [n]幼虫; [or]tf_ibt;
bat: [n]蝙蝠;棒球; [or]tf_ibt;
family: [n]科; [or]tf_ibt;
class: [n]纲; [or]tf_ibt;
suborder: [n]亚目; [or]tf_ibt;
order: [n]目; [or]tf_ibt;
genus: [n]种,类; [or]tf_ibt;
antenna: [n]触须; [or]tf_ibt;
tentacle: [n](动物的)触须;(植物的)腺毛; [or]tf_ibt;
brain: [n]大脑; [or]tf_ibt;
spleen: [n]脾脏; [or]tf_ibt;
hide: [n]兽皮; [or]tf_ibt;
spine: [n]脊骨;刺;图框; [or]tf_ibt;
spineless: [adj]无脊椎的; [or]tf_ibt;
toe: [n]脚趾; [or]tf_ibt;
bill: [n]账单; [or]tf_ibt;
beak: [n]鸟嘴; [or]tf_ibt;
fuzzy: [adj]有绒毛的; [or]tf_ibt;
head: [n]头; [or]tf_ibt;
hump: [n]驼峰; [or]tf_ibt;
scale: [n]鳞片; [or]tf_ibt;
wing: [n]翅膀; [or]tf_ibt;
fluffy: [adj]松软的; [or]tf_ibt;
carnal: [adj]肉体的; [or]tf_ibt;
nervous: [adj]神经的; [or]tf_ibt;
grease: [n]脂肪 [ex]~ monkey; [or]tf_ibt;
greasy: [adj]多脂的; [or]tf_ibt;
turtle: [n]海龟; [or]tf_ibt;
beaver: [n]海狸; [or]tf_ibt;
jellyfish [n]水母; [or]tf_ibt;
starfish: [n]水星; [or]tf_ibt;
whale: [n]鲸; [or]tf_ibt;
porpoise: [n]海豚,小鲸; [or]tf_ibt;
dolphin: [n]海豚; [or]tf_ibt;
prawn: [n]大虾; [or]tf_ibt;
shrimp: [n]小虾; [or]tf_ibt;
lobster: [n]龙虾; [or]tf_ibt;
sponge: [n]海绵; [or]tf_ibt;
plankton: [n]浮游生物; [or]tf_ibt;
oyster: [n]牡蛎; [or]tf_ibt;
clam: [n]蛤; [or]tf_ibt;
coral: [n]珊瑚; [or]tf_ibt;
crab: [n]螃蟹; [or]tf_ibt;

# 4 法律 
penal: [n]受刑罚的; [or]tf_ibt;
illicit: [n]违法的; [or]tf_ibt;
unruly: [n]不守法的; [or]tf_ibt;
illegitimate: [n]非法的;私生的; [or]tf_ibt;
default: [n]拖欠;不履行责任; [or]tf_ibt;
violate: [n]违犯 [ex]~ the laws of physics; [or]tf_ibt;
violation: [n]违犯; [or]tf_ibt;
infringe: [n]侵犯 [ex]Your book infringes on my copy right]; [or]tf_ibt;
bound: [n]有义务的; [or]tf_ibt;
compulsory: [n]义务的;必修的; [or]tf_ibt;
oblige: [n]强迫; [or]tf_ibt;
obligatory: [n]义务的;必须的; [or]tf_ibt;
responsible: [n]有责任的; [or]tf_ibt;
domineering: [n]专权的; [or]tf_ibt;
mandatory: [n]命令的;强制的; [or]tf_ibt;
licensed: [n]被许可的; [or]tf_ibt;
heirship: [n]继承权; [or]tf_ibt;
jurisdiction: [n]司法权; [or]tf_ibt;
arbitration: [n]调停;仲裁; [or]tf_ibt;
fine: [n]罚金; [or]tf_ibt;
confiscate: [n]没收;充公; [or]tf_ibt;
convict: [n]判罪;证明; [or]tf_ibt;
verdict: [n]判决; [or]tf_ibt;
judgment: [n]盘踞; [or]tf_ibt;
indemnity: [n]赔偿; [or]tf_ibt;
imprisonment: [n]监禁;关押; [or]tf_ibt;
invalidate: [n]使无效; [or]tf_ibt;
captivity: [n]囚禁;拘留; [or]tf_ibt;
trial: [n]审判; [or]tf_ibt;
detain: [n]拘留;阻止; [or]tf_ibt;
extenuate: [n]使(罪过等)显得轻微; [or]tf_ibt;
saddle: [n]使负担; [or]tf_ibt;
court: [n]法庭; [or]tf_ibt;
bar: [n]法院; [or]tf_ibt;
authorize: [n]授权; [or]tf_ibt;
empower: [n]授权; [or]tf_ibt;
plea: [n]恳求; [or]tf_ibt;
plead: [n]抗辩;恳求; [or]tf_ibt;
oath: [n]誓言; [or]tf_ibt;
pledge: [n]使发誓; [or]tf_ibt;
plaintiff: [n]原告; [or]tf_ibt;
flee: [n]逃跑; [or]tf_ibt;
defend: [n]辩护; [or]tf_ibt;
proscribe: [n]禁止; [or]tf_ibt;
forbid: [n]禁止; [or]tf_ibt;
abstinence: [n]禁戒;节制; [or]tf_ibt;
abstain: [n]戒绝; [or]tf_ibt;
ban: [n]禁止; [or]tf_ibt;
veto: [n]否决; [or]tf_ibt;
revise: [n]修订; [or]tf_ibt;
verify: [n]验证; [or]tf_ibt;
deserve: [n]应得; [or]tf_ibt;
stipulate: [n]约定; [or]tf_ibt;
testify: [n]证明; [or]tf_ibt;
testimony: [n]证言; [or]tf_ibt;
justify: [n]证明]]]是正当的; [or]tf_ibt;
substantiate: [n]证实; [or]tf_ibt;
confirm: [n]证实;确认; [or]tf_ibt;
affirm: [n]证实; [or]tf_ibt;
assure: [n]是]]]确信;向]]]保证; [or]tf_ibt;
evidence: [n]证据; [or]tf_ibt;
follow: [n]跟随;遵循; [or]tf_ibt;
observe: [n]遵守; [or]tf_ibt;
observance: [n]遵守; [or]tf_ibt;
abide: [n]遵守; [or]tf_ibt;
accuse: [n]控告; [or]tf_ibt;
accusation: [n]控告; [or]tf_ibt;
complaint: [n]控告; [or]tf_ibt;
impeach: [n]控告; [or]tf_ibt;
indictment: [n]起诉; [or]tf_ibt;
incriminate: [n]控告; [or]tf_ibt;
prosecute: [n]起诉; [or]tf_ibt;
denounce: [n]告发; [or]tf_ibt;
lawsuit: [n]诉讼; [or]tf_ibt;
query: [n]质问; [or]tf_ibt;
interrogate: [n]审问; [or]tf_ibt;
impunity: [n]免罚; [or]tf_ibt;
exempt: [n]免除; [or]tf_ibt;
condone: [n]赦免; [or]tf_ibt;
liberate: [n]释放; [or]tf_ibt;
remit: [n]赦免; [or]tf_ibt;
release: [n]释放; [or]tf_ibt;
absolve: [n]赦免; [or]tf_ibt;
acquit: [n]宣告无罪; [or]tf_ibt;
abolish: [n]废除; [or]tf_ibt;
term: [n]术语; [or]tf_ibt;
clause: [n]分句; [or]tf_ibt;
bill: [n]账单; [or]tf_ibt;
constitution: [n]宪法; [or]tf_ibt;
decree: [n]颁布;法令; [or]tf_ibt;
legislate: [n]立法; [or]tf_ibt;
prescribe: [n]规定;指示; [or]tf_ibt;
set: [n]规定; [or]tf_ibt;
credential: [n]凭证; [or]tf_ibt;
standard: [n]标准; [or]tf_ibt;
enact: [n]扮演; [or]tf_ibt;


# 5 化学 
hackneyed: [n]陈腐的; [or]tf_ibt;
caustic: [n](具有)腐蚀性的; [or]tf_ibt;
erosion: [n]腐蚀; [or]tf_ibt;
erode: [n]腐蚀; [or]tf_ibt;
stale: [n]陈腐的; [or]tf_ibt;
rot: [n]腐烂; [or]tf_ibt;
decay: [n]使腐败; [or]tf_ibt;
corrode: [n]腐蚀; [or]tf_ibt;
decomposition: [n]分解; [or]tf_ibt;
rust: [n]生锈; [or]tf_ibt;
silica: [n]硅土; [or]tf_ibt;
crystal: [n]晶体; [or]tf_ibt;
gasoline: [n]汽油; [or]tf_ibt;
methane: [n]甲烷; [or]tf_ibt;
hydrocarbon: [n]碳氢化合物; [or]tf_ibt;
petroleum: [n]石油; [or]tf_ibt;
plastic: [n]塑料; [or]tf_ibt;
intermediary: [n]媒介物; [or]tf_ibt;
catalysis: [n]催化作用; [or]tf_ibt;
catalyst: [n]催化剂; [or]tf_ibt;
adhesive: [n]粘合剂; [or]tf_ibt;
scorch: [n]使褪色; [or]tf_ibt;
bleach: [n]漂白; [or]tf_ibt;
tint: [n]上色; [or]tf_ibt;
dye: [n]染色; [or]tf_ibt;
chemistry: [n]化学; [or]tf_ibt;
biochemistry: [n]生物化学; [or]tf_ibt;
hydronic: [n]液体循环加热的; [or]tf_ibt;
alchemy: [n]炼金术; [or]tf_ibt;
artificial: [n]人造的; [or]tf_ibt;
ion: [n]离子; [or]tf_ibt;
molecule: [n]分子; [or]tf_ibt;
solubility: [n]溶解度; [or]tf_ibt;
solution: [n]溶剂; [or]tf_ibt;
dissolve: [n]溶解; [or]tf_ibt;
element: [n]元素; [or]tf_ibt;
impurity: [n]杂质; [or]tf_ibt;
blend: [n]混合; [or]tf_ibt;
compound: [n]化合物; [or]tf_ibt;
substance: [n]物质; [or]tf_ibt;
particle: [n]颗粒; [or]tf_ibt;
explosive: [n]爆炸的; [or]tf_ibt;
blast: [n]一阵风  [ex]a ~ of wind; [or]tf_ibt;
explode: [n]使爆炸; [or]tf_ibt;
burning: [n]燃烧的; [or]tf_ibt;
kindle: [n]燃起; [or]tf_ibt;
sear: [n]烧灼; [or]tf_ibt;
ignite: [n]使燃着; [or]tf_ibt;
action: [n]作用; [or]tf_ibt;
combination: [n]组合; [or]tf_ibt;
neutralize: [n]中和; [or]tf_ibt;
polymerization: [n]聚合; [or]tf_ibt;
functional: [n]起作用的; [or]tf_ibt;
synthetic: [n]合成的; [or]tf_ibt;
carbon: [n]碳; [or]tf_ibt;
copper: [n]铜; [or]tf_ibt;
lead: [n]引导; [or]tf_ibt;
Mercury: [n]水星; [or]tf_ibt;
nickel: [n]镍; [or]tf_ibt;
platinum: [n]铂; [or]tf_ibt;
silver: [n]银; [or]tf_ibt;
sodium: [n]钠; [or]tf_ibt;
tin: [n]锡; [or]tf_ibt;
zinc: [n]锌; [or]tf_ibt;
calcium: [n]钙; [or]tf_ibt;
helium: [n]氦; [or]tf_ibt;
silicon: [n]硅; [or]tf_ibt;
ammonia: [n]氨水; [or]tf_ibt;
sulfur: [n]硫; [or]tf_ibt;
iodine: [n]碘; [or]tf_ibt;
nitrogen: [n]氮; [or]tf_ibt;
oxygen: [n]氧; [or]tf_ibt;

# 6 环境 
noxius: [n]有害的; [or]tf_ibt;
pollute: [n]污染; [or]tf_ibt;
pollutant: [n]污染物质; [or]tf_ibt;
pollution: [n]污染; [or]tf_ibt;
contaminate: [n]污染; [or]tf_ibt;
waste: [n]废物; [or]tf_ibt;
sewage: [n]下水道; [or]tf_ibt;
fume: [n](浓烈或难闻的)烟;气体; [or]tf_ibt;
habitat: [n]栖息地; [or]tf_ibt;
balance: [n]平衡; [or]tf_ibt;
ecosystem: [n]生态系统; [or]tf_ibt;
fauna: [n]动物群; [or]tf_ibt;
decibel: [n]分贝; [or]tf_ibt;
ozonosphere: [n]臭氧层; [or]tf_ibt;

# 7 教育 
didactic: [n]说教的; [or]tf_ibt;
leading: [n]指导的; [or]tf_ibt;
sermon: [n]说教; [or]tf_ibt;
initiate: [n]启蒙; [or]tf_ibt;
instill: [n]灌输; [or]tf_ibt;
instruct: [n]教; [or]tf_ibt;
enlighten: [n]启发; [or]tf_ibt;
edify: [n]教化; [or]tf_ibt;
lead: [n]引导; [or]tf_ibt;
direct: [n]引导; [or]tf_ibt;
conduct: [n]引导; [or]tf_ibt;
curriculum: [n]课程; [or]tf_ibt;
discipline: [n]学科; [or]tf_ibt;

# 8 经济
toll: [n]鸣钟;费用; [or]tf_ibt;
precious: [n]宝贵的; [or]tf_ibt;
prosperous: [n]繁荣的; [or]tf_ibt;
prosperity: [n]繁荣; [or]tf_ibt;
rich: [n]肥沃的; [or]tf_ibt;
rare: [n]稀少的; [or]tf_ibt;
asset: [n]资产; [or]tf_ibt;
fortune: [n]财富; [or]tf_ibt;
opulence: [n]财富; [or]tf_ibt;
finance: [n]财政;资助; [or]tf_ibt;
economic: [n]经济的; [or]tf_ibt;
indigent: [n]平穷的; [or]tf_ibt;
depression: [n]萧条; [or]tf_ibt;
penury: [n]贫穷; [or]tf_ibt;
bidding: [n]投标; [or]tf_ibt;
drawback: [n]退款; [or]tf_ibt;
exponent: [n]解释者 [ex]a staunch ~ of civil rights; [or]tf_ibt;
lease: [n]出租; [or]tf_ibt;
redress: [n]补偿; [or]tf_ibt;
compensation: [n]补偿; [or]tf_ibt;
deficit: [n]赤字; [or]tf_ibt;
levy: [n]征收; [or]tf_ibt;
ration: [n]配给; [or]tf_ibt;
rebate: [n]折扣; [or]tf_ibt;
merchandise: [n]商品; [or]tf_ibt;
commerce: [n]商业; [or]tf_ibt;
enterprise: [n]事业; [or]tf_ibt;
currency: [n]货币; [or]tf_ibt;
inventory: [n]物品清单; [or]tf_ibt;
quota: [n]限额; [or]tf_ibt;
tariff: [n]关税; [or]tf_ibt;
inflation: [n]通货膨胀; [or]tf_ibt;
deal: [n]交易; [or]tf_ibt;
yen: [n]日元;渴望; [or]tf_ibt;
cause: [n]事业; [or]tf_ibt;
consume: [n]消耗; [or]tf_ibt;
disburse: [n]支付; [or]tf_ibt;
acting: [n]代理的; [or]tf_ibt;
inertia: [n]惯性; [or]tf_ibt;
discount: [n]折扣; [or]tf_ibt;
audit: [n]查账; [or]tf_ibt;
shipment: [n]出货; [or]tf_ibt;
surplus: [n]残余; [or]tf_ibt;
account: [n]账目; [or]tf_ibt;
bankruptcy: [n]破产; [or]tf_ibt;
saving: [n]储蓄; [or]tf_ibt;
collateral: [n]抵押品; [or]tf_ibt;
bill: [n]账单; [or]tf_ibt;
check: [n]检查; [or]tf_ibt;
coin: [n]创造; [or]tf_ibt;
depreciate: [n]贬值; [or]tf_ibt;
merge: [n]合并; [or]tf_ibt;
reimburse: [n]偿还; [or]tf_ibt;
garner: [n]储存; [or]tf_ibt;
underestimate: [n]低估; [or]tf_ibt;
exchange: [n]兑换; [or]tf_ibt;
assess: [n]估计; [or]tf_ibt;
consolidate: [n]合并; [or]tf_ibt;
loan: [n]贷款; [or]tf_ibt;
refund: [n]退还;偿还; [or]tf_ibt;
utility: [n]效用; [or]tf_ibt;
selection: [n]选择; [or]tf_ibt;
option: [n]选择; [or]tf_ibt;
economics: [n]经济学; [or]tf_ibt;
output: [n]产量; [or]tf_ibt;
goods: [n]货物; [or]tf_ibt;
opportunity: [n]机会; [or]tf_ibt;
benifit: [n]利益; [or]tf_ibt;
contract: [n]感染; [or]tf_ibt;
lottery: [n]抽奖; [or]tf_ibt;
transaction: [n]交易; [or]tf_ibt;
budget: [n]预算; [or]tf_ibt;
patronage: [n]资助; [or]tf_ibt;
choose: [n]选择; [or]tf_ibt;
choice: [n]选择; [or]tf_ibt;
barter: [n]易货; [or]tf_ibt;
purchase: [n]购买; [or]tf_ibt;
deposit: [n]存款; [or]tf_ibt;
commission: [n]委员会; [or]tf_ibt;
ransom: [n]赔偿金; [or]tf_ibt;
toll: [n]鸣钟;费用; [or]tf_ibt;
charge: [n]猛攻; [or]tf_ibt;
bond: [n]债券; [or]tf_ibt;
custom: [n]进口税; [or]tf_ibt;
bonus: [n]红利; [or]tf_ibt;
interest: [n]利息; [or]tf_ibt;
means: [n]钱; [or]tf_ibt;
debt: [n]债务; [or]tf_ibt;
fund: [n]基金; [or]tf_ibt;
revenue: [n]收入; [or]tf_ibt;

# 9 军事 
confidential: [n]机密的; [or]tf_ibt;
clandestine: [n]秘密的; [or]tf_ibt;
cipher: [n]暗号; [or]tf_ibt;
dissimulate: [n]掩饰; [or]tf_ibt;
disarm: [n]缴械投降; [or]tf_ibt;
disarming: [n]消除敌意的; [or]tf_ibt;
scout: [n]侦查员;童子军; [or]tf_ibt;
fort: [n]要塞; [or]tf_ibt;
fortress: [n]要塞; [or]tf_ibt;
hatchet: [n]短柄斧; [or]tf_ibt;
dagger: [n]短剑; [or]tf_ibt;
armor: [n]装甲; [or]tf_ibt;
corps: [n]军团; [or]tf_ibt;
armament: [n]兵力; [or]tf_ibt;
enlist: [n]招募; [or]tf_ibt;
recruit: [n]招募; [or]tf_ibt;
array: [n]队列; [or]tf_ibt;
squad: [n]小队i; [or]tf_ibt;
raid: [n]袭击; [or]tf_ibt;
charge: [n]猛攻; [or]tf_ibt;
encroach: [n]蚕食;侵占; [or]tf_ibt;
despoil: [n]夺取; [or]tf_ibt;
invade: [n]侵略; [or]tf_ibt;
assault: [n]袭击; [or]tf_ibt;
exterminate: [n]消灭; [or]tf_ibt;
extinguish: [n]消灭; [or]tf_ibt;
absorb: [n]吞并; [or]tf_ibt;
onset: [n]攻击; [or]tf_ibt;
repulse: [n]击退; [or]tf_ibt;
expedition: [n]远征; [or]tf_ibt;
siege: [n]围攻; [or]tf_ibt;
envelope: [n]包围; [or]tf_ibt;
beset: [n]包围; [or]tf_ibt;
besiege: [n]围; [or]tf_ibt;
morale: [n]士气; [or]tf_ibt;
mandate: [n]命令; [or]tf_ibt;
tactics: [n]战术; [or]tf_ibt;
naval: [n]海军的; [or]tf_ibt;
military: [n]军用的; [or]tf_ibt;

# 10 考古学; [or]tf_ibt;
archeology: [n]考古学; [or]tf_ibt;
invaluable: [n]无价的; [or]tf_ibt;
unearth: [n]发掘; [or]tf_ibt;
scoop: [n]挖掘; [or]tf_ibt;
exhume: [n]掘出; [or]tf_ibt;
excavate: [n]挖掘; [or]tf_ibt;
excavation: [n]出土文物; [or]tf_ibt;
Neolithic: [n]新石器时代的; [or]tf_ibt;
Mesolithic: [n]中石器时代的; [or]tf_ibt;
Paleolithic: [n]旧石器时代的; [or]tf_ibt;
origin: [n]起源; [or]tf_ibt;
chronological: [n]按年代顺序的; [or]tf_ibt;
archaic: [n]古的; [or]tf_ibt;
ascend: [n]追溯; [or]tf_ibt;
originate: [n]发源于; [or]tf_ibt;
primitive: [n]原始的;最初的; [or]tf_ibt;
remnant: [n]遗迹; [or]tf_ibt;
porcelain: [n]瓷器; [or]tf_ibt;
antique: [n]古董; [or]tf_ibt;
antiquity: [n]古老是遗物; [or]tf_ibt;
skull: [n]头骨; [or]tf_ibt;
artifact: [n]人造物品; [or]tf_ibt;


# 11 农业的
prolific: [n]多产的 [ex]the ~ author; [or]tf_ibt;
fertile: [n]肥沃的;多产的 [ex]the ~ couple; [or]tf_ibt;
harvest: [n]收获; [or]tf_ibt;
agriculture: [n]农业学; [or]tf_ibt;
agricultural: [n]农业的; [or]tf_ibt;
aquaculture: [n]水产业; [or]tf_ibt;
arable: [n]适于耕种的; [or]tf_ibt;
indigenous: [n]当地的;土产的; [or]tf_ibt;
fertilizer: [n]肥料; [or]tf_ibt;
husbandry: [n]耕种;管理; [or]tf_ibt;
cultivate: [n]耕种;培养; [or]tf_ibt;
cultivation: [n]耕种;培养; [or]tf_ibt;
manure: [n]施肥 [ex]~ the field; [or]tf_ibt;
horticulture: [n]园艺; [or]tf_ibt;
hydroponics: [n]水栽培; [or]tf_ibt;
insecticide: [n]杀虫剂; [or]tf_ibt;
irrigate: [n]灌溉; [or]tf_ibt;
pesticide: [n]杀虫剂; [or]tf_ibt;
ridge: [n]起皱;翻土做垄;岭; [or]tf_ibt;
silt: [n]泥沙; [or]tf_ibt;
tractor: [n]拖拉机; [or]tf_ibt;
squash: [n]南瓜; [or]tf_ibt;
cotton: [n]棉花; [or]tf_ibt;
garlic: [n]大蒜; [or]tf_ibt;
eggplant: [n]茄子; [or]tf_ibt;
fodder: [n]饲料; [or]tf_ibt;
hay: [n]干草; [or]tf_ibt;
haystack: [n]干草堆; [or]tf_ibt;
vegetable: [n]蔬菜; [or]tf_ibt;
weed: [n]杂草; [or]tf_ibt;
sorghum: [n]高粱; [or]tf_ibt;
livestock: [n]家畜; [or]tf_ibt;
poultry: [n]家禽; [or]tf_ibt;
buffalo: [n]水牛; [or]tf_ibt;
cattle: [n]牛; [or]tf_ibt;
sow: [n]播种;大母猪; [or]tf_ibt;
conservatory: [n]音乐学校; [or]tf_ibt;
barn: [n]谷仓;畜舍; [or]tf_ibt;
cowshed: [n]牛舍; [or]tf_ibt;
granary: [n]谷仓; [or]tf_ibt;
greenhouse: [n]温室;花房; [or]tf_ibt;
seedbed: [n]苗床; [or]tf_ibt;
sheepfold: [n]羊圈; [or]tf_ibt;
orchard: [n]果园; [or]tf_ibt;
pasture: [n]牧场; [or]tf_ibt;
pigpen: [n]猪舍; [or]tf_ibt;
pigsty: [n]猪舍; [or]tf_ibt;
plantation: [n]耕地;种植园;人造林; [or]tf_ibt;
ranch: [n]大农场; [or]tf_ibt;
trough: [n]水槽; [or]tf_ibt;


# 12 气象 
balmy: [n]温和的; [or]tf_ibt;
humid: [n]潮湿的; [or]tf_ibt;
humidity: [n]潮湿; [or]tf_ibt;
damp: [n]潮湿的; [or]tf_ibt;
dank: [n]阴湿的; [or]tf_ibt;
moisture: [n]潮湿; [or]tf_ibt;
saturate: [n]使饱和; [or]tf_ibt;
drought: [n]干旱; [or]tf_ibt;
arid: [n]干旱的; [or]tf_ibt;
chilly: [n]寒冷的; [or]tf_ibt;
chill: [n]寒冷; [or]tf_ibt;
frigid: [n]寒冷的; [or]tf_ibt;
serene: [n]晴朗的; [or]tf_ibt;
tepid: [n]微温的; [or]tf_ibt;
gale: [n]大风; [or]tf_ibt;
hurricane: [n]飓风; [or]tf_ibt;
atmosphere: [n]大气层; [or]tf_ibt;
climate: [n]气候; [or]tf_ibt;
barometer: [n]气压计; [or]tf_ibt;
breeze: [n]微风; [or]tf_ibt;
blast: [n]一阵风  [ex]a ~ of wind; [or]tf_ibt;
whirlwind: [n]旋风; [or]tf_ibt;
typhoon: [n]台风; [or]tf_ibt;
tycoon: [n]企业大亨; [or]tf_ibt;
tornado: [n]龙卷风; [or]tf_ibt;
meteorology: [n]气象学; [or]tf_ibt;
troposphere: [n]对流层; [or]tf_ibt;
current: [n](气体,液体)流; [or]tf_ibt;
funnel: [n]漏斗云; [or]tf_ibt;
smog: [n]烟雾; [or]tf_ibt;
fog: [n]烟雾; [or]tf_ibt;
precipitate: [n]向下投掷; [or]tf_ibt;
precipitation: [n]降水; [or]tf_ibt;
drizzle: [n]下毛毛细雨; [or]tf_ibt;
blizzard: [n]大风雪; [or]tf_ibt;
dew: [n]露水; [or]tf_ibt;
downpour: [n]倾盆大雨; [or]tf_ibt;
droplet: [n]小滴; [or]tf_ibt;
frost: [n]结霜; [or]tf_ibt;
vapor: [n]水蒸气; [or]tf_ibt;
tempest: [n]暴风雨; [or]tf_ibt;
shower: [n]阵雨;淋浴; [or]tf_ibt;
hail: [n]冰雹; [or]tf_ibt;
condense: [n]使浓缩; [or]tf_ibt;


# 13 人类学 
juvenile: [n]青少年的; [or]tf_ibt;
adult: [n]成人; [or]tf_ibt;
human: [n]人类的; [or]tf_ibt;
anthropology: [n]人类学; [or]tf_ibt;
tribe: [n]部落; [or]tf_ibt;
ethnic: [n]种族的; [or]tf_ibt;
ethnology: [n]人种学; [or]tf_ibt;
minority: [n]少数;少数名族; [or]tf_ibt;
descent: [n]血统; [or]tf_ibt;
hybrid: [n]杂交; [or]tf_ibt;
intelligence: [n]智力; [or]tf_ibt;
intellectual: [n]有智力的; [or]tf_ibt;
aboriginal: [n]土著; [or]tf_ibt;
ancestor: [n]祖先; [or]tf_ibt;
forerunner: [n]先驱; [or]tf_ibt;
hominid: [n]原始人类; [or]tf_ibt;
cranial: [n]头盖形的; [or]tf_ibt;

# 14 人物 
counsel: [n]律师; [or]tf_ibt;
crew: [n]船员; [or]tf_ibt;
aviator: [n]飞行家; [or]tf_ibt;
playwright: [n]剧作家; [or]tf_ibt;
operator: [n]接线员; [or]tf_ibt;
clergy: [n]神职人员; [or]tf_ibt;
auditor: [n]审计人员; [or]tf_ibt;
athlete: [n]运动员; [or]tf_ibt;
satirist: [n]讽刺作家; [or]tf_ibt;
sculpture: [n]雕塑品; [or]tf_ibt;
mathematician: [n]数学家; [or]tf_ibt;
astronaut: [n]宇航员; [or]tf_ibt;
astronomer: [n]天文学家; [or]tf_ibt;
botanist: [n]植物学家; [or]tf_ibt;
choreography: [n]舞蹈设计师; [or]tf_ibt;
scout: [n]侦查员;童子军; [or]tf_ibt;
geographer: [n]地理学者; [or]tf_ibt;
geologist: [n]地质学者; [or]tf_ibt;
educator: [n]教育学家; [or]tf_ibt;
faculty: [n]全体教员; [or]tf_ibt;
treasurer: [n]财务人员; [or]tf_ibt;
archeologist: [n]考古学家; [or]tf_ibt;
paleoanthropologist: [n]古人类学家; [or]tf_ibt;
pilot: [n]飞行员; [or]tf_ibt;
meteorologist: [n]气象学家; [or]tf_ibt;
anthropologist: [n]人类学家; [or]tf_ibt;
imagist: [n]印象派诗人; [or]tf_ibt;
inventor: [n]发明家; [or]tf_ibt;
mechanic: [n]机修工; [or]tf_ibt;
biograhper: [n]传记作者; [or]tf_ibt;
censor: [n]检查员; [or]tf_ibt;
physician: [n]医师; [or]tf_ibt;
hermit: [n]隐居者; [or]tf_ibt;
recluse: [n]隐士; [or]tf_ibt;
ecologist: [n]生态学家; [or]tf_ibt;
critic: [n]评论家; [or]tf_ibt;
philanthropist: [n]慈善家; [or]tf_ibt;
attorney: [n]辩护律师;检察官; [or]tf_ibt;
congressman: [n]国会议员; [or]tf_ibt;
connoisseur: [n]鉴赏家; [or]tf_ibt;
entrepreneur: [n]企业家; [or]tf_ibt;
principal: [n]校长; [or]tf_ibt;
staff: [n]职员; [or]tf_ibt;
commander: [n]司令官;指挥员; [or]tf_ibt;
commentator: [n]评论家; [or]tf_ibt;
attendant: [n]侍者;护理人员; [or]tf_ibt;
trapper: [n]陷阱设置者; [or]tf_ibt;
orator: [n]演讲者; [or]tf_ibt;
idiocy: [n]白痴; [or]tf_ibt;
moron: [n]白痴; [or]tf_ibt;
illiterate: [n]文盲; [or]tf_ibt;
proxy: [n]代理人; [or]tf_ibt;
deputy: [n]代理人; [or]tf_ibt;
proprietor: [n]所有者;经营者; [or]tf_ibt;
consumer: [n]消费者; [or]tf_ibt;
employer: [n]雇主;老板; [or]tf_ibt;
employee: [n]员工; [or]tf_ibt;
debtor: [n]欠债的一方;债务人; [or]tf_ibt;
arbitrator: [n]仲裁者; [or]tf_ibt;
superintendent: [n];主管; [or]tf_ibt;
apprentice: [n]学徒; [or]tf_ibt;
tenant: [n]租他人房子的人;租客; [or]tf_ibt;
miser: [n]守财奴; [or]tf_ibt;
donor: [n]捐助者; [or]tf_ibt;
personnel: [n]职员; [or]tf_ibt;
benefactor: [n]喜欢帮助他人的人;恩人; [or]tf_ibt;
mortal: [n]凡人; [or]tf_ibt;
company: [n]伙伴; [or]tf_ibt;
audience: [n]观众; [or]tf_ibt;
recipient: [n]接受者; [or]tf_ibt;
exponent: [n]解释者 [ex]a staunch ~ of civil rights; [or]tf_ibt;
resident: [n]居民; [or]tf_ibt;
inhabitant: [n]居民; [or]tf_ibt;
bachelor: [n]学士;单身汉; [or]tf_ibt;
idol: [n]偶像 [ex]American Idol; [or]tf_ibt;
novice: [n]生手;新信徒; [or]tf_ibt;
believer: [n]信徒; [or]tf_ibt;
cult: [n]崇拜;邪教 [ex]the ~ leader; [or]tf_ibt;
fanatic: [n]盲信者; [or]tf_ibt;
adherent: [n]信奉者; [or]tf_ibt;
faithful: [n]信徒; [or]tf_ibt;
disciple: [n]门徒; [or]tf_ibt;
champion: [n]冠军; [or]tf_ibt;
assassin: [n]刺客; [or]tf_ibt;
bandit: [n]强盗; [or]tf_ibt;
burglar: [n]窃贼; [or]tf_ibt;
barbarian: [n]野蛮人; [or]tf_ibt;
exile: [n]流放; [or]tf_ibt;
rebel: [n]叛徒; [or]tf_ibt;
addict: [n]瘾君子; [or]tf_ibt;
egoist: [n]自我主义者; [or]tf_ibt;
eyewitness: [n]目击者; [or]tf_ibt;
spectator: [n]旁观者; [or]tf_ibt;
spouse: [n]配偶; [or]tf_ibt;
benificiary: [n]受益者; [or]tf_ibt;
inferior: [n]下级;晚辈; [or]tf_ibt;
zealot: [n]狂热信徒;发烧友; [or]tf_ibt;
precursor: [n]先驱; [or]tf_ibt;
avant-garde: [n]先锋派;前卫; [or]tf_ibt;
alumni: [n]男校友; [or]tf_ibt;
skeptic: [n]怀疑者; [or]tf_ibt;
malcontent: [n]不满者; [or]tf_ibt;
foe: [n]敌人; [or]tf_ibt;
opponent: [n]敌人;对手; [or]tf_ibt;
rival: [n]对手; [or]tf_ibt;
celebrity: [n]名人; [or]tf_ibt;
figurehead: [n]名义领袖; [or]tf_ibt;
veteran: [n]老兵;水手; [or]tf_ibt;
traitor: [n]叛徒;卖国贼; [or]tf_ibt;
advocate: [n]拥护者; [or]tf_ibt;
feminist: [n]女权者; [or]tf_ibt;
humanitarian: [n]人道主义者; [or]tf_ibt;
throng: [n]群众; [or]tf_ibt;
civilian: [n]平民; [or]tf_ibt;
monarch: [n]君主; [or]tf_ibt;
conservative: [n]保守的人; [or]tf_ibt;
envoy: [n]使者; [or]tf_ibt;
aristocrat: [n]贵族; [or]tf_ibt;
gentry: [n]贵族; [or]tf_ibt;
autocrat: [n]独裁者; [or]tf_ibt;
delegate: [n]代表; [or]tf_ibt;
democrat: [n]民主党人; [or]tf_ibt;
independent: [n]中立派;无党派者; [or]tf_ibt;
candidate: [n]候选人; [or]tf_ibt;

# 15 社会学 
urban: [n]城市的; [or]tf_ibt;
rustic: [n]乡村的; [or]tf_ibt;
community: [n]社区; [or]tf_ibt;
metropolitan: [n]大城市的; [or]tf_ibt;
exotic: [n]外来的;有异国风味的; [or]tf_ibt;
conventional: [n]传统的; [or]tf_ibt;
convention: [n]传统; [or]tf_ibt;
patriarchal: [n]家长制的; [or]tf_ibt;
institutionalize: [n]使制度化; [or]tf_ibt;
clan: [n]部落;宗族;党派; [or]tf_ibt;
status: [n]状态;地位; [or]tf_ibt;
taboo: [n]禁忌; [or]tf_ibt;
ethics: [n]伦理学; [or]tf_ibt;
genteel: [n]上流社会的; [or]tf_ibt;
marital: [n]婚姻的; [or]tf_ibt;
polygamous: [n]一夫多妻或一妻多夫制的; [or]tf_ibt;
household: [n]一家人;家喻户晓的; [or]tf_ibt;

# 16 生物学
parasite: [n]寄生虫; [or]tf_ibt;
parasitic: [n]寄生的; [or]tf_ibt;
mimicry: [n]模仿; [or]tf_ibt;
symbiosis: [n]共生; [or]tf_ibt;
symbiotic: [n]共生的; [or]tf_ibt;
creature: [n]生物; [or]tf_ibt;
organism: [n]生物;有机物; [or]tf_ibt;
strain: [n](动物昆虫的的)种;血统; [or]tf_ibt;
species: [n]物种; [or]tf_ibt;
vital: [n]至关重要的; [or]tf_ibt;
ripe: [n]成熟的; [or]tf_ibt;
evolve: [n]使进化; [or]tf_ibt;
evolutionary: [n]进化的; [or]tf_ibt;
Darwinism: [n]达尔文学说; [or]tf_ibt;
extinct: [n]灭绝的; [or]tf_ibt;
extinction: [n]灭绝; [or]tf_ibt;
breed: [n]饲养; [or]tf_ibt;
reproduction: [n]繁殖;复制品; [or]tf_ibt;
proliferate: [n]繁衍; [or]tf_ibt;
propagate: [n]繁殖;传播; [or]tf_ibt;
subsist: [n]生存; [or]tf_ibt;
exist: [n]生存; [or]tf_ibt;
posterity: [n]后代; [or]tf_ibt;
fermentation: [n]发酵  [ex]during ~; [or]tf_ibt;
respiration: [n]呼吸; [or]tf_ibt;
stodgy: [n]难消化的; [or]tf_ibt;
secrete: [n]分泌; [or]tf_ibt;
secretion: [n]分泌物; [or]tf_ibt;
assimilate: [n]吸收; [or]tf_ibt;
immune: [n]免疫的; [or]tf_ibt;
immunity: [n]免疫性; [or]tf_ibt;
metabolism: [n]新陈代谢; [or]tf_ibt;
morphology: [n]形态学; [or]tf_ibt;
microscope: [n]显微镜; [or]tf_ibt;
calorie: [n]卡路里; [or]tf_ibt;
carbohydrate: [n]碳水化合物; [or]tf_ibt;
glucose: [n]葡萄糖; [or]tf_ibt;
protein: [n]蛋白质; [or]tf_ibt;
organ: [n]器官; [or]tf_ibt;

# 17 数学 
rank: [n]排序;等级; [or]tf_ibt;
discrete: [n]离散的; [or]tf_ibt;
symmetry: [n]对称; [or]tf_ibt;
sequence: [n]序列; [or]tf_ibt;
dual: [n]二重的; [or]tf_ibt;
induction: [n]归纳;感应; [or]tf_ibt;
inference: [n]推论; [or]tf_ibt;
circular: [n]循环的; [or]tf_ibt;
circulate: [n]使循环; [or]tf_ibt;
circulation: [n]循环; [or]tf_ibt;
probability: [n]概率;可能性; [or]tf_ibt;
qualitative: [n]定性的;性质上的; [or]tf_ibt;
dispersion: [n]离差; [or]tf_ibt;
vertical: [n]垂直的; [or]tf_ibt;
plumb: [n]垂直的; [or]tf_ibt;
upright: [n]垂直的; [or]tf_ibt;
circuitous: [n]迂回的; [or]tf_ibt;
facet: [n]平面; [or]tf_ibt;
sphere: [n]球; [or]tf_ibt;
loop: [n]环; [or]tf_ibt;
triangle: [n]三角形; [or]tf_ibt;
circumference: [n]圆周; [or]tf_ibt;
cone: [n]圆周; [or]tf_ibt;
caliber: [n]口径; [or]tf_ibt;
diameter: [n]直径; [or]tf_ibt;
figure: [n]图形; [or]tf_ibt;
circle: [n]圆周;派系; [or]tf_ibt;
cube: [n]立方体; [or]tf_ibt;
column: [n]圆柱; [or]tf_ibt;
angle: [n]角度; [or]tf_ibt;
area: [n]面积;地区; [or]tf_ibt;
ellipse: [n]椭圆; [or]tf_ibt;
diagram: [n]图标; [or]tf_ibt;
polygon: [n]多边形; [or]tf_ibt;
intersect: [n]相交; [or]tf_ibt;
radius: [n]半径; [or]tf_ibt;
rectangle: [n]长方形; [or]tf_ibt;
square: [n]正方形; [or]tf_ibt;
parallel: [n]平行的; [or]tf_ibt;
deduction: [n]演绎(推论); [or]tf_ibt;
degree: [n]度数; [or]tf_ibt;
geometry: [n]几何学; [or]tf_ibt;
mathematics: [n]数学; [or]tf_ibt;
arithmetic: [n]算数; [or]tf_ibt;
statistics: [n]统计学; [or]tf_ibt;
even: [n]偶数的;平的; [or]tf_ibt;
decimal: [n]十进制的; [or]tf_ibt;
ratio: [n]比率; [or]tf_ibt;
estimate: [n]估计; [or]tf_ibt;
calculate: [n]计算; [or]tf_ibt;
enumerate: [n]计数;枚举(列出集合中的成员); [or]tf_ibt;
evaluate: [n]评估; [or]tf_ibt;
variant: [n]变量; [or]tf_ibt;
abacus: [n]算盘; [or]tf_ibt;
aggregate: [n]合计; [or]tf_ibt;
sum: [n]和; [or]tf_ibt;
calculation: [n]计算; [or]tf_ibt;
calculator: [n]计算器; [or]tf_ibt;
calculus: [n]微积分学; [or]tf_ibt;
digit: [n]数字; [or]tf_ibt;
subtract: [n]减去; [or]tf_ibt;
minus: [n]负的;减去; [or]tf_ibt;
multiply: [n]乘;增加; [or]tf_ibt;
multiplication: [n]乘法;增加; [or]tf_ibt;
numeral: [n]数字; [or]tf_ibt;
percentage: [n]百分数; [or]tf_ibt;
equation: [n]等式; [or]tf_ibt;
quarter: [n]四分之一; [or]tf_ibt;
divide: [n]除;分割; [or]tf_ibt;


# 18 天文 
celestial: [n]天体的; [or]tf_ibt;
universal: [n]宇宙的; [or]tf_ibt;
orbit: [n]轨道; [or]tf_ibt;
comet: [n]彗星; [or]tf_ibt;
galaxy: [n]银河;星系; [or]tf_ibt;
constellation: [n]星座; [or]tf_ibt;
asteroid: [n]小行星; [or]tf_ibt;
planet: [n]行星; [or]tf_ibt;
chondrite: [n]球粒状陨石; [or]tf_ibt;
cluster: [n]丛; [or]tf_ibt;
meteor: [n]流星; [or]tf_ibt;
dwarf: [n]白矮星; [or]tf_ibt;
stellar: [n]恒星的; [or]tf_ibt;
cosmos: [n]宇宙; [or]tf_ibt;
cosmic: [n]宇宙的; [or]tf_ibt;
cosmology: [n]宇宙论; [or]tf_ibt;
nebula: [n]星云; [or]tf_ibt;
quasar: [n]类星体; [or]tf_ibt;
planeroid: [n]位面; [or]tf_ibt;
intergalactic: [n]银河间的; [or]tf_ibt;
interplanetary: [n]行星间的;太阳系内的; [or]tf_ibt;
interstellar: [n]星际的; [or]tf_ibt;
corona: [n]日冕; [or]tf_ibt;
chromosphere: [n]色球; [or]tf_ibt;
photosphere: [n]光球; [or]tf_ibt;
pseudoscience: [n]伪科学; [or]tf_ibt;
astronomy: [n]天文学; [or]tf_ibt;
astronomical: [n]天文学的(因庞大而无法估计的);天文; [or]tf_ibt;
astrology: [n]占星术; [or]tf_ibt;
astrophysics: [n]天体物理学; [or]tf_ibt;
Jupiter: [n]木星; [or]tf_ibt;
lunar: [n]月亮的; [or]tf_ibt;
solar: [n]太阳的; [or]tf_ibt;
Mars: [n]火星;战神; [or]tf_ibt;
Mercury: [n]水星; [or]tf_ibt;
Uranus: [n]天王星; [or]tf_ibt;
Venus: [n]金星; [or]tf_ibt;
Pluto: [n]冥王星; [or]tf_ibt;
Neptune: [n]海王星; [or]tf_ibt;
Saturn: [n]土星; [or]tf_ibt;
emission: [n](光,热)散发;喷射; [or]tf_ibt;
infinite: [n]无穷的; [or]tf_ibt;
interferometer: [n]干涉仪; [or]tf_ibt;
radiation: [n]辐射; [or]tf_ibt;
revolve: [n]旋转; [or]tf_ibt;
land: [n]降落; [or]tf_ibt;
spaceship: [n]太空船; [or]tf_ibt;
spacecraft: [n]太空船; [or]tf_ibt;
telescope: [n]望远镜; [or]tf_ibt;

# 19 物理 
compatible: [n]兼容的; [or]tf_ibt;
boundary: [n]边界; [or]tf_ibt;
boundless: [n]无限的; [or]tf_ibt;
endless: [n]无止境的; [or]tf_ibt;
cohesive: [n]有凝聚力的; [or]tf_ibt;
horizontal: [n]水平的; [or]tf_ibt;
bulk: [n]容积; [or]tf_ibt;
brim: [n](杯,碗)边; [or]tf_ibt;
edge: [n]边; [or]tf_ibt;
rim: [n]边缘; [or]tf_ibt;
brink: [n]边缘; [or]tf_ibt;
constituent: [n]成分; [or]tf_ibt;
dimension: [n]尺度; [or]tf_ibt;
elasticity: [n]弹性; [or]tf_ibt;
cohesion: [n]凝聚力; [or]tf_ibt;
mechanics: [n]力学,机械学;技巧;结构; [or]tf_ibt;
impetus: [n]推动力; [or]tf_ibt;
release: [n]释放; [or]tf_ibt;
decelerate: [n]减速; [or]tf_ibt;
precipitate: [n]向下投掷; [or]tf_ibt;
expedite: [n]加速; [or]tf_ibt;
quiver: [n]振动; [or]tf_ibt;
jar: [n]震动; [or]tf_ibt;
vibration: [n]震动; [or]tf_ibt;
discharge: [n]释放; [or]tf_ibt;
shrink: [n]收缩; [or]tf_ibt;
diffuse: [n]扩散;传播; [or]tf_ibt;
emit: [n]放射; [or]tf_ibt;
transpire: [n]发散; [or]tf_ibt;
constitute: [n]构成;组成; [or]tf_ibt;
eject: [n]喷出; [or]tf_ibt;
radiate: [n]射出; [or]tf_ibt;
molecule: [n]分子; [or]tf_ibt;
ion: [n]离子; [or]tf_ibt;
electron: [n]电子; [or]tf_ibt;
neutron: [n]中子; [or]tf_ibt;
nucleus: [n]核子; [or]tf_ibt;
proton: [n]质子; [or]tf_ibt;
nuclear: [n]原子的; [or]tf_ibt;
fusion: [n]熔合; [or]tf_ibt;
thermometer: [n]温度计; [or]tf_ibt;
temperature: [n]温度; [or]tf_ibt;
thaw: [n]融化; [or]tf_ibt;
centigrade: [n]摄氏的; [or]tf_ibt;
clot: [n]凝块; [or]tf_ibt;
sublimate: [n]升华; [or]tf_ibt;
distillation: [n]蒸馏; [or]tf_ibt;
clutter: [n]混乱; [or]tf_ibt;
equilibrium: [n]平衡状态; [or]tf_ibt;
dilute: [n]稀释; [or]tf_ibt;
dehydrate: [n]脱水; [or]tf_ibt;
declivity: [n]下倾的斜面; [or]tf_ibt;
foam: [n]泡沫; [or]tf_ibt;
ventilation: [n]通风; [or]tf_ibt;
evaporate: [n]蒸发; [or]tf_ibt;
friction: [n]摩擦; [or]tf_ibt;
attrition: [n]磨损; [or]tf_ibt;
chafe: [n]擦热; [or]tf_ibt;
resonance: [n]回声; [or]tf_ibt;
echo: [n]回声; [or]tf_ibt;
ultrasonics: [n]超音波学; [or]tf_ibt;
sonar: [n]声呐; [or]tf_ibt;
band: [n]乐队; [or]tf_ibt;
electricity: [n]电流;电学; [or]tf_ibt;
electromagnet: [n]电磁石; [or]tf_ibt;
electromagnetism: [n]电磁学; [or]tf_ibt;
electronics: [n]电子学; [or]tf_ibt;
amplifier: [n]扩音器;放大器; [or]tf_ibt;
chip: [n]芯片; [or]tf_ibt;
insulator: [n]绝缘体; [or]tf_ibt;
magnet: [n]磁铁; [or]tf_ibt;
magnetism: [n]磁学;磁力; [or]tf_ibt;
transistor: [n]晶体管; [or]tf_ibt;
ultraviolet: [n]紫外线的; [or]tf_ibt;
mechanics: [n]力学,机械学;技巧;结构; [or]tf_ibt;
gravitation: [n]地心引力; [or]tf_ibt;
oscillation: [n]摆动; [or]tf_ibt;
statics: [n]静电学; [or]tf_ibt;
relativity: [n]相对论;相关性; [or]tf_ibt;
velocity: [n]速率; [or]tf_ibt;
dynamics: [n]动力学; [or]tf_ibt;
force: [n]力; [or]tf_ibt;
current: [n](气体,液体)流; [or]tf_ibt;
accelerate: [n]加速; [or]tf_ibt;
transparent: [n]透明的; [or]tf_ibt;
opaque: [n]不透明的; [or]tf_ibt;
translucent: [n]半透明的; [or]tf_ibt;
optical: [n]光学的;视力的; [or]tf_ibt;
optics: [n]光学; [or]tf_ibt;
ray: [n]光线; [or]tf_ibt;
spectrum: [n]光谱; [or]tf_ibt;
wavelength: [n]波长; [or]tf_ibt;
magnifier: [n]放大镜;放大器; [or]tf_ibt;
lens: [n]透镜; [or]tf_ibt;


# 20 医学 
contagious: [n]传染的; [or]tf_ibt;
catching: [n]传染的; [or]tf_ibt;
infect: [n]感染; [or]tf_ibt;
infectious: [n]传染的; [or]tf_ibt;
contract: [n]感染; [or]tf_ibt;
acute: [n]急性的; [or]tf_ibt;
feverish: [n]发烧的; [or]tf_ibt;
invalid: [n]有病的; [or]tf_ibt;
morbid: [n]病态的; [or]tf_ibt;
numb: [n]麻木的; [or]tf_ibt;
unconscious: [n]失去知觉的; [or]tf_ibt;
fragile: [n]体质弱的; [or]tf_ibt;
susceptible: [n]易受感染的; [or]tf_ibt;
malady: [n]疾病; [or]tf_ibt;
corpse: [n]尸体; [or]tf_ibt;
gash: [n]深的切口; [or]tf_ibt;
symptom: [n]症状; [or]tf_ibt;
fracture: [n]骨折; [or]tf_ibt;
tingle: [n]刺痛; [or]tf_ibt;
recur: [n]复发; [or]tf_ibt;
relapse: [n]复发; [or]tf_ibt;
bruise: [n]打伤fester; [or]tf_ibt;
intoxicate: [n]使中毒; [or]tf_ibt;
survive: [n]幸免于难; [or]tf_ibt;
diagnose: [n]诊断; [or]tf_ibt;
diagnosis: [n]诊断; [or]tf_ibt;
inject: [n]注射; [or]tf_ibt;
heal: [n]治愈; [or]tf_ibt;
remedy: [n]治疗; [or]tf_ibt;
treatment: [n]治疗; [or]tf_ibt;
prescription: [n]药方; [or]tf_ibt;
dissect: [n]解剖; [or]tf_ibt;
sterile: [n]消过毒的; [or]tf_ibt;
clinic: [n]门诊所; [or]tf_ibt;
anatomy: [n]解剖; [or]tf_ibt;
healthful: [n]有益健康的; [or]tf_ibt;
condition: [n]健康情形; [or]tf_ibt;
hygiene: [n]卫生; [or]tf_ibt;
sanitation: [n]卫生设施; [or]tf_ibt;
physical: [n]身体的;物质的; [or]tf_ibt;
sustenance: [n]营养物; [or]tf_ibt;
malnourished: [n]营养不良的; [or]tf_ibt;
nutrition: [n]营养学; [or]tf_ibt;
mental: [n]精神的;智力的; [or]tf_ibt;
spiritual: [n]心灵的; [or]tf_ibt;


# 21 艺术 
picturesque: [n]如画般的; [or]tf_ibt;
vivid: [n]生动的; [or]tf_ibt;
sculpture: [n]雕塑品; [or]tf_ibt;
statue: [n]雕像; [or]tf_ibt;
draw: [n]画; [or]tf_ibt;
gallery: [n]画廊; [or]tf_ibt;
portrait: [n]肖像; [or]tf_ibt;
impressionism: [n]印象派; [or]tf_ibt;
portray: [n]绘制; [or]tf_ibt;
mold: [n]塑造; [or]tf_ibt;
embroider: [n]绣花; [or]tf_ibt;
tragedy: [n]悲剧; [or]tf_ibt;
opera: [n]歌剧; [or]tf_ibt;
enact: [n]扮演; [or]tf_ibt;
pose: [n]摆姿势;构成; [or]tf_ibt;
rehearse: [n]排练; [or]tf_ibt;
prelude: [n]序幕; [or]tf_ibt;
character: [n]文字; [or]tf_ibt;
role: [n]角色; [or]tf_ibt;
design: [n]设计; [or]tf_ibt;
profile: [n]外形;轮廓; [or]tf_ibt;
renaissance: [n]文艺复兴; [or]tf_ibt;
conjure: [n](用魔术)变出; [or]tf_ibt;
aesthetic: [n]美学的; [or]tf_ibt;
romantic: [n]浪漫的; [or]tf_ibt;

# 22 音乐 
euphonious: [n]悦耳的; [or]tf_ibt;
harsh: [n]刺耳的; [or]tf_ibt;
jazz: [n]爵士乐; [or]tf_ibt;
movement: [n]乐章; [or]tf_ibt;
note: [n]音符; [or]tf_ibt;
score: [n]乐谱; [or]tf_ibt;
instrument: [n]乐器; [or]tf_ibt;
lyric: [n]歌词; [or]tf_ibt;
conservatory: [n]音乐学校; [or]tf_ibt;
episode: [n]插曲; [or]tf_ibt;
orchestra: [n]管弦乐队; [or]tf_ibt;
chorus: [n]合唱团; [or]tf_ibt;
concert: [n]音乐会; [or]tf_ibt;
band: [n]乐队; [or]tf_ibt;
record: [n]档案;唱片;记录;录音; [or]tf_ibt;
percussion: [n]打击乐器; [or]tf_ibt;
string: [n]弦乐; [or]tf_ibt;
wind: [n]管乐; [or]tf_ibt;


# 23 语言学 
implicit: [n]含蓄的; [or]tf_ibt;
concise: [n]简明的; [or]tf_ibt;
succinct: [n]简洁的; [or]tf_ibt;
fluent: [n]流畅的; [or]tf_ibt;
cogent: [n]强有力的; [or]tf_ibt;
persuasive: [n]有说服力; [or]tf_ibt;
character: [n]文字; [or]tf_ibt;
glossary: [n]词汇表; [or]tf_ibt;
dialect: [n]方言; [or]tf_ibt;
clause: [n]分句; [or]tf_ibt;
linguistics: [n]语言学; [or]tf_ibt;
phonetics: [n]语音学; [or]tf_ibt;
tense: [n]时态; [or]tf_ibt;
version: [n]版本; [or]tf_ibt;
genre: [n]题材;风格; [or]tf_ibt;
tag: [n]标签; [or]tf_ibt;
slogan: [n]标语;口号; [or]tf_ibt;
lyric: [n]歌词; [or]tf_ibt;
verse: [n]韵文; [or]tf_ibt;
fiction: [n]小说; [or]tf_ibt;
byword: [n]谚语; [or]tf_ibt;
fable: [n]寓言; [or]tf_ibt;
term: [n]术语; [or]tf_ibt;
maxim: [n]格言; [or]tf_ibt;
satire: [n]讽刺文学; [or]tf_ibt;
farce: [n]闹剧; [or]tf_ibt;
adage: [n]格言; [or]tf_ibt;
synopsis: [n]大纲;梗概; [or]tf_ibt;
compile: [n]编纂;收集; [or]tf_ibt;
entitle: [n]给]]]权利; [or]tf_ibt;
emend: [n]修订; [or]tf_ibt;
paraphrase: [n](用更容易理解的文字)解释; [or]tf_ibt;
adaptable: [n]可修改的; [or]tf_ibt;
adaptation: [n]改写; [or]tf_ibt;
excerpt: [n]摘录; [or]tf_ibt;
abstract: [n]提炼; [or]tf_ibt;
abstraction: [n]摘要; [or]tf_ibt;
abridge: [n]缩短; [or]tf_ibt;
coin: [n]创造; [or]tf_ibt;


# 24 政治 
factious: [n]党派的; [or]tf_ibt;
partisan: [n]党派的;派系感强的; [or]tf_ibt;
board: [n]委员会; [or]tf_ibt;
Senate: [n]参议院; [or]tf_ibt;
congress: [n]国会; [or]tf_ibt;
diplomatic: [n]外交的; [or]tf_ibt;
diplomacy: [n]外交; [or]tf_ibt;
confederate: [n]同盟; [or]tf_ibt;
league: [n]同盟; [or]tf_ibt;
affiliate: [n]加盟; [or]tf_ibt;
unconventional: [n]自由的; [or]tf_ibt;
dictatorial: [n]独裁的; [or]tf_ibt;
domestic: [n]国内的; [or]tf_ibt;
potent: [n]强有力的; [or]tf_ibt;
authoritative: [n]权威性的; [or]tf_ibt;
influential: [n]有影响的; [or]tf_ibt;
authority: [n]权威; [or]tf_ibt;
privilege: [n]特权; [or]tf_ibt;
democracy: [n]民主; [or]tf_ibt;
petition: [n]请愿; [or]tf_ibt;
domain: [n]领土;领域; [or]tf_ibt;
territory: [n]领土;版图; [or]tf_ibt;
nationality: [n]国籍; [or]tf_ibt;
kingdom: [n]王国; [or]tf_ibt;
realm: [n]王国;领域; [or]tf_ibt;
regimen: [n]政权; [or]tf_ibt;
sovereignty: [n]主权; [or]tf_ibt;
autonomy: [n]自治权; [or]tf_ibt;
commission: [n]委员会; [or]tf_ibt;
committee: [n]委员; [or]tf_ibt;
election: [n]选举; [or]tf_ibt;
ballot: [n]选票; [or]tf_ibt;
ideology: [n]意识形态; [or]tf_ibt;
parade: [n]游行; [or]tf_ibt;
govern: [n]决定;支配;控制; [or]tf_ibt;
confer: [n]协商; [or]tf_ibt;
entitle: [n]给]]]权利; [or]tf_ibt;
exploit: [n]剥削; [or]tf_ibt;
maneuver: [n]调遣; [or]tf_ibt;
reform: [n]改革; [or]tf_ibt;
inspect: [n]检查; [or]tf_ibt;
emigrate: [n]移民; [or]tf_ibt;
immigrate: [n]移民入境; [or]tf_ibt;
exile: [n]流放; [or]tf_ibt;
enslave: [n]奴役; [or]tf_ibt;
hustle: [n]驱赶; [or]tf_ibt;
impel: [n]驱使; [or]tf_ibt;
oust: [n]驱逐; [or]tf_ibt;
banish: [n]驱逐入境; [or]tf_ibt;
deport: [n]放逐; [or]tf_ibt;
enable: [n]使能够; [or]tf_ibt;
reign: [n]统治; [or]tf_ibt;
dominate: [n]统治; [or]tf_ibt;
abdicate: [n]放弃权力; [or]tf_ibt;
administer: [n]管理; [or]tf_ibt;
administration: [n]行政; [or]tf_ibt;
institute: [n]建立; [or]tf_ibt;
amendment: [n]改善; [or]tf_ibt;
colonize: [n]殖民; [or]tf_ibt;
check: [n]检查; [or]tf_ibt;
monarchy: [n]君主制;王朝; [or]tf_ibt;
republican: [n]共和国的;共和政体的; [or]tf_ibt;
anarchism: [n]无政府主义; [or]tf_ibt;
doctrine: [n]教义; [or]tf_ibt;
immigrant: [n](从外国)移来的; [or]tf_ibt;
municipal: [n]市政的; [or]tf_ibt;
strike: [n]罢工; [or]tf_ibt;
scandal: [n]丑闻; [or]tf_ibt;
vote: [n]投票; [or]tf_ibt;
welfare: [n]福利; [or]tf_ibt;


# 25 植物学
shrub: [n]灌木丛; [or]tf_ibt;
laurel: [n]月桂树; [or]tf_ibt;
prairie: [n]牧场; [or]tf_ibt;
sequoia: [n]美洲杉树; [or]tf_ibt;
herb: [n]药草; [or]tf_ibt;
plant: [n]植物;庄稼; [or]tf_ibt;
fern: [n]蕨类植物; [or]tf_ibt;
orchid: [n]兰花; [or]tf_ibt;
rosette: [n]玫瑰型饰物; [or]tf_ibt;
germinate: [n]发芽; [or]tf_ibt;
sprout: [n]萌芽; [or]tf_ibt;
timber: [n]木材; [or]tf_ibt;
cluster: [n]丛; [or]tf_ibt;
bunch: [n]串;束; [or]tf_ibt;
bark: [n]树皮; [or]tf_ibt;
twig: [n]小树枝; [or]tf_ibt;
bough: [n]大树枝; [or]tf_ibt;
branch: [n]分枝; [or]tf_ibt;
stem: [n]径;词干; [or]tf_ibt;
stalk: [n]柄;秆; [or]tf_ibt;
trunk: [n]树干; [or]tf_ibt;
leafstalk: [n]叶柄; [or]tf_ibt;
leaflet: [n]小叶;传单; [or]tf_ibt;
bud: [n]发芽; [or]tf_ibt;
flower: [n]花; [or]tf_ibt;
foliage: [n]树叶;植物; [or]tf_ibt;
petal: [n]花瓣; [or]tf_ibt;
cell: [n]单元; [or]tf_ibt;
tissue: [n]组织; [or]tf_ibt;
husk: [n](果类或谷物)外壳;皮; [or]tf_ibt;
pollen: [n]花粉; [or]tf_ibt;
log: [n]圆木; [or]tf_ibt;
flora: [n]植物界; [or]tf_ibt;
botany: [n]植物学; [or]tf_ibt;
botanical: [n]植物学的; [or]tf_ibt;
crossbreed: [n]杂交; [or]tf_ibt;
necrosis: [n]坏疽; [or]tf_ibt;
peel: [n]皮; [or]tf_ibt;
photosynthesis: [n]光合作用; [or]tf_ibt;
pollinate: [n]对]]]授粉; [or]tf_ibt;
pollination: [n]授粉; [or]tf_ibt;
seeds: [n]中子形;雏形; [or]tf_ibt;
shell: [n 外壳; ]n 外壳; [vt]去壳; [or]tf_ibt;
shoot: [n]发芽; [or]tf_ibt;
starch: [n]淀粉; [or]tf_ibt;
vitamin: [n]维生素; [or]tf_ibt;
luxuriant: [n]繁茂的;多产的; [or]tf_ibt;


# 26 自然 
natural: [n]自然的; [or]tf_ibt;
scenic: [n]风景优美的; [or]tf_ibt;
scenery: [n]景色; [or]tf_ibt;
spectacle: [n]奇观;景象; [or]tf_ibt;
shade: [n]荫; [or]tf_ibt;
jungle: [n]丛林; [or]tf_ibt;
meadow: [n]草地; [or]tf_ibt;
shrub: [n]灌木丛; [or]tf_ibt;
lawn: [n]草场; [or]tf_ibt;
summit: [n]山顶; [or]tf_ibt;
gorge: [n]峡谷; [or]tf_ibt;
puddle: [n]小水洼; [or]tf_ibt;
creek: [n]小溪; [or]tf_ibt;
canyon: [n]峡谷; [or]tf_ibt;
spring: [n]泉水; [or]tf_ibt;
trickle: [n]滴;淌; [or]tf_ibt;
limpid: [n]清澈的; [or]tf_ibt;


# 27 宗教 
blessed: [n]受祝福的; [or]tf_ibt;
invocation: [n]祈祷; [or]tf_ibt;
pious: [n]虔诚的; [or]tf_ibt;
devout: [n]虔诚的; [or]tf_ibt;
cult: [n]崇拜;邪教 [ex]the ~ leader; [or]tf_ibt;
consecrate: [n]奉为神圣; [or]tf_ibt;
creed: [n]信仰;信条; [or]tf_ibt;
doomed: [n]命中注定的; [or]tf_ibt;
destine: [n]命中注定; [or]tf_ibt;
destiny: [n]命运; [or]tf_ibt;
fatalism: [n]宿命论; [or]tf_ibt;
sacred: [n]神圣的; [or]tf_ibt;
Christian: [n]基督教徒; [or]tf_ibt;
doctrine: [n]教义; [or]tf_ibt;
dogma: [n]教条; [or]tf_ibt;
rita: [n]宗教仪式; [or]tf_ibt;
religion: [n]宗教; [or]tf_ibt;
deity: [n]神; [or]tf_ibt;
oracle: [n]神谕; [or]tf_ibt;
atheism: [n]无神论; [or]tf_ibt;
heresy: [n]异端邪说; [or]tf_ibt;
immerse: [n]给]]]洗礼; [or]tf_ibt;
invoke: [n]恳求;祈求; [or]tf_ibt;
enchant: [n]施魔法于; [or]tf_ibt;
preach: [n]说教;鼓吹;布道; [or]tf_ibt;
exodus: [n]大批离去; [or]tf_ibt;

# 28 品质
##  卑鄙 
despicable: [adj]可鄙的; [or]tf_ibt;
contemptible: [adj]可鄙的; [or]tf_ibt;
ignominious: []adj]可耻的(不光彩的); [or]tf_ibt;
menial: [adj]卑贱的; [or]tf_ibt;
scornful: [adj]轻蔑的; [or]tf_ibt;
filthy: [adj]污秽的; [or]tf_ibt;
shameless: [adj]无耻的;美剧-无耻之徒; [or]tf_ibt;
disrespectful: [adj]无礼的; [or]tf_ibt;
discrimination: [n]歧视; [or]tf_ibt;
contemn: [vt]蔑视; [or]tf_ibt;
belittle: [vt]轻视; [or]tf_ibt;
disdain: [vt]轻视; [or]tf_ibt;
despise: [vt]轻视; [or]tf_ibt;
mean: [adj]卑鄙的; [or]tf_ibt;

## 笨拙 
awkward: [adj]笨拙的; [or]tf_ibt;
clumsy: [adj]笨拙的; [or]tf_ibt;
inert: [adj]迟钝的; [or]tf_ibt;
blunt: [adj]迟钝的; [v]使变钝; [or]tf_ibt;
torpid: [adj]迟钝的; [or]tf_ibt;
silly: [adj]傻的,糊涂的; [or]tf_ibt;
idiotic [adj]愚蠢的; [or]tf_ibt;
fatuous: [adj]愚昧的; [or]tf_ibt;
hoax: [n]恶作剧; [vt]愚弄; [or]tf_ibt;
## 草率 
curt: [adj]草率的(简短而失礼的); [or]tf_ibt;
reckless: [adj]鲁莽的; [or]tf_ibt;
impudent: [adj]鲁莽的; [or]tf_ibt;
rashly: [adj]匆忙的; [or]tf_ibt;
imprudent: [adj]轻率的(不谨慎的); [or]tf_ibt;
blunt2: [adj]直率的;粗鲁的; [or]tf_ibt;

## 聪颖 
intelligent: [adj]聪明的; [or]tf_ibt;
smart: [adj]聪明的;敏捷的; [or]tf_ibt;
versatile: [adj]多才多艺的; [or]tf_ibt;
astute: [adj]机敏的;狡猾的; [or]tf_ibt;
shrewd: [adj]精明的; [or]tf_ibt;
sensible: [adj]理智的; [or]tf_ibt;
sane: [adj]理智的;健全的; [or]tf_ibt;
flexible: [adj]灵活的; [or]tf_ibt;
exquisite: [adj]灵敏的; [or]tf_ibt;
expeditious: [adj]敏捷的; [or]tf_ibt;
nimble: [adj]轻快的;灵敏的; [or]tf_ibt;
knowledgeable: [adj]有见识的; [or]tf_ibt;
capable: [adj] 有能力的; [or]tf_ibt;
tact: [n]老练;机智; [or]tf_ibt;
sharpen: [vt]使敏锐; [or]tf_ibt;
adroit: [adj]机敏灵巧的; [or]tf_ibt;
acute: [adj]敏锐的; [or]tf_ibt;
acumen: [n]敏锐; [or]tf_ibt;

## 粗野 
gauche: [adj]粗鲁的; [or]tf_ibt;
rough: [adj]粗暴的; [or]tf_ibt;
rugged: [adj]粗俗的; [or]tf_ibt;
coarse: [adj]粗野的;粗糙的; [or]tf_ibt;
rustic: [adj]粗俗的; [or]tf_ibt;
grumpy: [adj]性情暴躁的(坏脾气的); [or]tf_ibt;
brutal: [adj]野蛮的; [or]tf_ibt;

## 胆小 
spineless: [adj]没骨气的; [or]tf_ibt;
timid: [adj]胆怯的;羞怯的; [or]tf_ibt;
bashful: [adj]害羞的;胆小的; [or]tf_ibt;
shy: 害羞的;胆小的; [or]tf_ibt;

## 和蔼 
pitiful: [adj]慈悲的; [or]tf_ibt;
genial: [adj]和蔼的; [or]tf_ibt;
modest: [adj]谦虚的;适度的; [or]tf_ibt;
benign: [adj]亲切的;良好的(良性的); [or]tf_ibt;
facile: [adj]轻而易举的;随和的; [or]tf_ibt;
merciful: [adj]仁慈的; [or]tf_ibt;
humane: [adj]仁慈的; [or]tf_ibt;
ductile: [adj]柔软的; [or]tf_ibt;
frank: [adj]坦白的,直率的; [or]tf_ibt;
outspoken: [adj]坦率直言的; [or]tf_ibt;
moderate: [adj]温和的;适度的; [or]tf_ibt;
meek: [adj]温顺的; [or]tf_ibt;
tractable: [adj]温顺的(易驾驭的); [or]tf_ibt;
facetious: [adj]幽默的;滑稽的; [or]tf_ibt;
humorous: [adj]幽默的; [or]tf_ibt;
sociable: [adj]友善的;好交际的; [or]tf_ibt;
courteous: [adj]有礼貌的; [or]tf_ibt;
gracious: [adj]有礼貌的; [or]tf_ibt;
gregarious: [adj]合群的; [or]tf_ibt;
gentility: [n]教养; [or]tf_ibt;
affable: [adj]和蔼可亲的; [or]tf_ibt;

## 狡猾 
crooked: [adj]狡诈的; [or]tf_ibt;
sly: [adj]狡猾的; [or]tf_ibt;
cunning: [adj]狡猾的; [or]tf_ibt;
designing: [adj]蓄意的; [or]tf_ibt;

## 节俭 
frugal: [adj]节约的; [or]tf_ibt;
economize: [vi]节俭; [or]tf_ibt;
economical: [adj]节约的;经济的; [or]tf_ibt;
canny: [adj]精明的;节俭的; [or]tf_ibt;
stoically: [adv]淡泊地; [or]tf_ibt;
austerity: [n]节俭; [or]tf_ibt;
thrift: [n]节俭; [or]tf_ibt;

## 谨慎 
conservative: [adj]保守的; [or]tf_ibt;
composed: [adj]沉着的; [or]tf_ibt;
composure: [n]镇静; [or]tf_ibt;
prudent: [adj]谨慎的; [or]tf_ibt;
vigilant: [adj]警惕着的; [or]tf_ibt;
hardheaded: [adj]冷静的; [or]tf_ibt;
sober: [adj]清醒的; [or]tf_ibt;
discreet: [adj]谨慎的; [or]tf_ibt;
discretion: [n]慎重; [or]tf_ibt;
circumspect: [adj]慎重的;小心的; [or]tf_ibt;
cautious: [adj]谨慎的; [or]tf_ibt;
meticulously: [adv]很仔细地; [or]tf_ibt;
sanity: [n]理智(神志清醒); [or]tf_ibt;

## 懒惰 
sluggish: [adj]怠惰的; [or]tf_ibt;
indolent: [adj]懒惰的; [or]tf_ibt;
inertia: [n]惯性;惰性; [or]tf_ibt;
slug: [n]慢吞吞的人或物; [or]tf_ibt;
sloth: [n]懒惰; [or]tf_ibt;
slothful: [adj]偷懒的; [or]tf_ibt;

## 强壮 
stout: [adj]健壮的; [or]tf_ibt;
firm: [adj]坚挺的;结实的; [or]tf_ibt;
stocky: [adj]结实的;粗短的; [or]tf_ibt;
robust: [adj]强壮的; [or]tf_ibt;
hardy: [adj]强壮的'耐劳的; [or]tf_ibt;
lusty: [adj]强壮的;有精神的; [or]tf_ibt;
stiff: [adj]硬的;僵直的; [or]tf_ibt;

## 奢侈 
prodigal: [adj]浪费的; [or]tf_ibt;
improvident: [adj]浪费的; [or]tf_ibt;
lavish: [adj]浪费的;奢侈的; [or]tf_ibt;
luxurious: [adj]奢侈的; [or]tf_ibt;
extravagant: [adj]奢侈的;浪费的; [or]tf_ibt;
squander: [vt]浪费; [or]tf_ibt;
flamboyant: [adj]华丽的;浮夸的; [or]tf_ibt;

## 熟练 
deft: [adj]灵巧的;熟练的; [or]tf_ibt;
adept: [adj]擅长的; [or]tf_ibt;
skillful: [adj]熟练的; [or]tf_ibt;
experienced: [adj]有经验的; [or]tf_ibt;
stunt: [n]惊人的技艺; [or]tf_ibt;
craft: [n]手艺; [or]tf_ibt;
facility: [n]熟练 [ex]have ~ of language;工具(复数); [or]tf_ibt;
familiarize: [vt]熟练; [or]tf_ibt;
accomplished: [adj]熟练的; [or]tf_ibt;

## 素质 
aptitude: [n]才能; [or]tf_ibt;
vigor: [n]精力; [or]tf_ibt;
caliber: [n]品质; [or]tf_ibt;
quality: [n]品质; [or]tf_ibt;
temperament: [n]气质;性情; [or]tf_ibt;
stamina: [n]体力;精力; [or]tf_ibt;
talent: [n]才能;人才; [or]tf_ibt;
confidence: [n]信心; [or]tf_ibt;
disposition: [n]性情; [or]tf_ibt;
mass: [n]质量; [or]tf_ibt;
ability: [n]能力; [or]tf_ibt;
versatile: [adj]通用的(万能的);多才多艺的; [or]tf_ibt;
power: [n]能力;力量; [or]tf_ibt;

## 贪婪 
avid: [adj]贪婪的; [or]tf_ibt;
ravenous: [adj]贪婪的; [or]tf_ibt;
rapacious: [adj]贪婪的; [or]tf_ibt;
greedy: [adj]贪婪的; [or]tf_ibt;
covetous: [adj]贪心的; [or]tf_ibt;
avarice: [n]贪婪; [or]tf_ibt;
avaricious: [adj]贪婪的; [or]tf_ibt;
acquisitive: [adj]贪得无厌的; [or]tf_ibt;

## 严酷 
exacting: [adj]费力的;严格的; [or]tf_ibt;
ascetic: [adj]苦行的; [or]tf_ibt;
grim: [adj]冷酷的; [or]tf_ibt;
relentless: [adj]无情的; [or]tf_ibt;
ruthless: [adj]无情的;冷酷的; [or]tf_ibt;
rigid: [adj]严格的;僵化的; [or]tf_ibt;
stern: [adj]严格的;僵化的; [or]tf_ibt;
stringent: [adj]严格的;迫切的; [or]tf_ibt;
scrupulous: [adj]严谨的,讲究的; [or]tf_ibt;
drastic: [adj]严厉的; [or]tf_ibt;
harsh: [adj]严厉的; [or]tf_ibt;
rigor: [n]严格; [or]tf_ibt;
rigorous: [adj]严厉的;严峻的; [or]tf_ibt;
serious: [adj]严肃的; [or]tf_ibt;
severe: [adj]严重的;严肃的; [or]tf_ibt;
austerity: [n]严峻; [or]tf_ibt;
ordeal: [n]严酷的考研; [or]tf_ibt;

## 勇敢 
bold: [adj]大胆的; [or]tf_ibt;
daring: [adj]大胆的;勇敢的; [or]tf_ibt;
undaunted: [adj]无畏的,勇敢的; [or]tf_ibt;
dauntless: [adj]无畏的; [or]tf_ibt;
valiant: [adj]应用的; [or]tf_ibt;
gallant: [adj]英勇的; [or]tf_ibt;
intrepid: [adj]勇敢的; [or]tf_ibt;
valor: [n]勇气; [or]tf_ibt;

## 自私 
flighty: [adj]不负责任的;轻浮的; [or]tf_ibt;
skimpy: [adj]吝啬的; [or]tf_ibt;
stingy: [adj]吝啬的; [or]tf_ibt;
miserly: [adj]吝啬的; [or]tf_ibt;
snobbish: [adj]势力的; [or]tf_ibt;
selfish: [adj]自私的; [or]tf_ibt;

# 29 事物; [or]tf_ibt;
## 食品 
cabbage: [n]卷心菜(甘蓝); [or]tf_ibt;
carrot: [n]胡萝卜; [or]tf_ibt;
celery: [n]芹菜; [or]tf_ibt;
cereal: [n]谷类食品; [or]tf_ibt;
corn: [n]玉米; [or]tf_ibt;
cucumber: [n]黄瓜; [or]tf_ibt;
grain: [n]谷粒; [or]tf_ibt;
leek: [n]韭菜; [or]tf_ibt;
lettuce: [n]莴苣;生菜; [or]tf_ibt;
millet: [n]谷子(小米); [or]tf_ibt;
mustard: [n]芥末; [or]tf_ibt;
oats: [n]燕麦(片); [or]tf_ibt;
onion: [n]洋葱; [or]tf_ibt;
pea: [n]豌豆; [or]tf_ibt;
peanut: [n]花生; [or]tf_ibt;
pepper: [n]胡椒粉; [or]tf_ibt;
potato: [n]马铃薯; [or]tf_ibt;
pumpkin: [n]南瓜; [or]tf_ibt;
radish: [n]萝卜; [or]tf_ibt;
rice: [n]稻米; [or]tf_ibt;
rye: [n]黑麦; [or]tf_ibt;
sesame: [n]芝麻; [or]tf_ibt;
soybean: [n]大豆; [or]tf_ibt;
spinach: [n]菠菜; [or]tf_ibt;
tomato: [n]番茄; [or]tf_ibt;
wheat: [n]小麦; [or]tf_ibt;
edible: [n]可食用的 [ex]~ decorations/可食用的装饰(蛋糕上); [or]tf_ibt;
bland: [n](食物等)无刺激性的; [or]tf_ibt;
seasoning: [n]作料; [or]tf_ibt;
condiment: [n]调味品; [or]tf_ibt;
butter: [n]奶油; [or]tf_ibt;
chop: [n]排骨; [or]tf_ibt;
cuisine: [n]亨调; [or]tf_ibt;
dessert: [n]甜点; [or]tf_ibt;
beverage: [n]饮料; [or]tf_ibt;
diet: [n]饮食; [or]tf_ibt;
nutriment: [n]营养品; [or]tf_ibt;
nibble: [vt]细食; [or]tf_ibt;
imbibe: [vt]饮; [or]tf_ibt;
scoop: [n]勺子; [v]舀; [or]tf_ibt;
barley: [n]大麦; [or]tf_ibt;
beet: [n]甜菜; [or]tf_ibt;
broccoli: [n]花椰菜; [or]tf_ibt;

## 本质 
indigenous: [adj]固有的; [or]tf_ibt;
intrinsic: [adj]本质的; [or]tf_ibt;
radical: [adj]根本的; [or]tf_ibt;
radically: [adv]; [or]tf_ibt;
rudimentary: [adj]根本的;低级的; [or]tf_ibt;
inherent: [adj]固有的; [or]tf_ibt;
inherently: [adj]固有地;天性地; [or]tf_ibt;
objective: [adj]客观的; [or]tf_ibt;
internal: [adj]内在的; [or]tf_ibt;
incisive: [adj]深刻的; [or]tf_ibt;
substantive: [adj]实质性的; [or]tf_ibt;
innate: [adj]天生的; [or]tf_ibt;
inborn: [adj]天生的; [or]tf_ibt;
instinctive: [adj]天生的;本能的; [or]tf_ibt;
crude: [adj]未提炼的;生的; [or]tf_ibt;
spontaneous: [adj]自发的;本能的; [or]tf_ibt;
interior: [n]内部; [or]tf_ibt;
attribute: [n]性质; [or]tf_ibt;
abstruse: [adj]深奥的; [or]tf_ibt;

## 比较 
comparative [adj]比较的; [or]tf_ibt;
comparable: [adj]可比的;类似的; [or]tf_ibt;
similar: [adj]类似的; [or]tf_ibt;
dissimilar: [adj]不相似的(不同的); [or]tf_ibt;
subordinate: [adj]次要的;附属的; [or]tf_ibt;
monotonous: [adj]单调的; [or]tf_ibt;
typical: [adj]典型的; [or]tf_ibt;
invert: [vt]倒转; [or]tf_ibt;
inverse: [adj]反的; [or]tf_ibt;
preferable: [adj]更好的; [or]tf_ibt;
approximate: [adj]近似的; [or]tf_ibt;
coordinate: [adj]同等的,并列的; [or]tf_ibt;
homogeneous: [adj]同类的;相似的; [or]tf_ibt;
identical: [adj]同一的; [or]tf_ibt;
peerless: [adj]无与伦比的; [or]tf_ibt;
equal: [adj]相等的,同样的; [or]tf_ibt;
equivalent: [adj]相等的; [n]等同品; [or]tf_ibt;
intermediate: [adj]中级的; [or]tf_ibt;
neutral: [adj]中立的;中性的; [or]tf_ibt;
backward: [adj]退步的;相反的;[adv]退步地;相反地; [or]tf_ibt;
relatively: [adv]相关地;相对地; [or]tf_ibt;
shade: [n]差别; [or]tf_ibt;
reproduction: [n]复制品; [or]tf_ibt;
inferior: [n]次品; [adj]自卑的;劣等的; [or]tf_ibt;
sample: [n]样本; [or]tf_ibt;
medium: [n]媒介;中间; [adj]中等的; [or]tf_ibt;
counterpart: [n]相对物;极其相似之物; [or]tf_ibt;
midst: [n]中间; [prep]在]]之间; [or]tf_ibt;
contrast: [n]对比(着重于相异处); [or]tf_ibt;
compare: [vt]比较(着重于相似处); [or]tf_ibt;
copy: [vt]复制;模仿; [or]tf_ibt;
imitate: [vt]模仿; [or]tf_ibt;
resemble: [vt]像(某人与某人长的像);类似; [or]tf_ibt;
affinity: [n]密切关系;类同; [or]tf_ibt;

## 范围 
exception: [n]例外; [or]tf_ibt;
exceptional: [adj]例外的; [or]tf_ibt;
relieved: [n]免除的; [or]tf_ibt;
extraneous: [adj]无关的; [or]tf_ibt;
irrelevant: [adj]无关的;离题的; [or]tf_ibt;
besides: [adv]除了(还有); [or]tf_ibt;
scope: [n]范围;余地; [or]tf_ibt;
span: [n]跨度; [vt]跨越; [or]tf_ibt;
content: [n]内容; [or]tf_ibt;
save: [prep]除了; [or]tf_ibt;
deviate: [v]出轨;离题; [or]tf_ibt;
digress: [vi]离开本题; [or]tf_ibt;
embrace: [vt]包含;拥抱; [or]tf_ibt;
cover: [vt]包括; [or]tf_ibt;
comprise: [vt]包括; [or]tf_ibt;
bias: [vt]使]]偏离; [or]tf_ibt;
deflect: [vt]使偏离; [or]tf_ibt;
embody: [vt]体现;包含; [or]tf_ibt;
accommodate: [vt]容纳; [or]tf_ibt;
preclude: [vt]排除;防止; [or]tf_ibt;

## 方法 
forthright: [adj]直接的; [or]tf_ibt;
shortcut: [n]捷径; [or]tf_ibt;
tip: [n]窍门; [or]tf_ibt;
means: [n]手段;方法; [or]tf_ibt;
via: [prep]经由; [or]tf_ibt;
direct: [adj]直接的; [or]tf_ibt;
access: [n]通路;入门; [or]tf_ibt;

## 光 
faint: [adj]模糊的; [or]tf_ibt;
gloom: [n]黑暗; [or]tf_ibt;
gloomy: [adj]暗的; [or]tf_ibt;
luminous: [adj]反光的;发亮的; [or]tf_ibt;
illuminate: [vt]照明;照亮; [or]tf_ibt;
dingy: [adj]昏暗的; [or]tf_ibt;
dim: [adj]昏暗的;朦胧的; [or]tf_ibt;
obscure: [adj]模糊的; [or]tf_ibt;
vague: [adj]模糊的;含糊的; [or]tf_ibt;
dusky: [adj]微暗的; [or]tf_ibt;
glaring: [adj]耀眼的; [or]tf_ibt;
dazzling: [adj]耀眼的; [or]tf_ibt;
dismal: [adj]阴暗的; [or]tf_ibt;
glossy: [adj]有光泽的; [or]tf_ibt;
luster: [n]光彩;光泽; [or]tf_ibt;
glaze: [v]使光滑; [or]tf_ibt;
flare: [v]闪耀; [or]tf_ibt;
burnish: [vt]磨光;使光滑; [or]tf_ibt;
flicker: [vt]闪烁; [or]tf_ibt;
brighten: [vt]使发光; [or]tf_ibt;
gleam: [vt]使闪光;闪烁; [or]tf_ibt;
extinguish: [vt]熄灭; [or]tf_ibt;
ablaze: [adj]闪耀的; [or]tf_ibt;
twinkle: [v]闪烁; [or]tf_ibt;

## 科学 
tentative: [adj]试验性的; [or]tf_ibt;
mechanical: [adj]机械的; [or]tf_ibt;
exact: [adj]精确的;严格的; [or]tf_ibt;
theoretical: [adj]理论的; [or]tf_ibt;
precise: [adj]精确的;周密的; [or]tf_ibt;
trial: [adj]实验性的; [or]tf_ibt;
specimen: [n]样本;样品; [or]tf_ibt;
symbol: [n]符号; [or]tf_ibt;
symbolic: [adj]象征的;符号的; [or]tf_ibt;
precision: [n]精确;精密度; [or]tf_ibt;
doctrine: [adj]学说; [or]tf_ibt;
threshold: [n]阈值;门槛; [or]tf_ibt;
expertise: [n]专门知识; [or]tf_ibt;
institute: [n](研究)所; [or]tf_ibt;
invent: [v]发明; [or]tf_ibt;
dissect: [vt]详细研究; [or]tf_ibt;
contrive: [vt]发明; [or]tf_ibt;
launch: [adj]发射;推出; [or]tf_ibt;
devise: [vt]计划;发明; [or]tf_ibt;
gauge: [vt]精确计算; [or]tf_ibt;
accurate: [adj]准确的;正确的; [or]tf_ibt;
scale: [n]规模;尺度;天平; [or]tf_ibt;

## 逻辑 
logical: [adj]合逻辑的; [or]tf_ibt;
therefore: [adv]因此; [or]tf_ibt;
hence: [adv]因此;从此; [or]tf_ibt;
framework: [n]构架;框架; [or]tf_ibt;
hypothesis: [n]假设; [or]tf_ibt;
assumption: [n]假设; [or]tf_ibt;
presume: [vt]假定;假设; [or]tf_ibt;
presumption: [n]推定;猜想; [or]tf_ibt;
clue: [n]线索; [or]tf_ibt;
generalize: [v]归纳;概括; [or]tf_ibt;
incur: [vt]承担;遭遇;招致; [or]tf_ibt;
suppose: [vt]假想;推测; [or]tf_ibt;
premise: [vt]提出前提; [n]前提; [or]tf_ibt;
infer: [vt]推知; [or]tf_ibt;
demonstrate: [vt]演示;论证; [or]tf_ibt;

## 时间 
due: [adj]到期的;约定的,预定的; [or]tf_ibt;
cursory: [adj]仓促的; [or]tf_ibt;
perennial: [adj]长久的,永远的; [or]tf_ibt;
chronic: [adj]长期的;慢性的; [or]tf_ibt;
lasting: [adj]持久的; [or]tf_ibt;
everlasting: [adj]永恒的,持久的; [or]tf_ibt;
hasty: [adj]匆忙的; [or]tf_ibt;
transitory: [adj]短暂的; [or]tf_ibt;
transient: [adj]短暂的;过路的; [or]tf_ibt;
obsolete: [adj]过时的; [or]tf_ibt;
extemporaneous: [adj]即席的; [or]tf_ibt;
urgent: [adj]紧急的,迫切的; [or]tf_ibt;
pressing: [adj]紧迫的; [or]tf_ibt;
immediate: [adj]立即的; [or]tf_ibt;
forthright: [adj]立即的; [or]tf_ibt;
offhand: [adj]临时的; [or]tf_ibt;
temporal: [adj]一时的;暂时的; [or]tf_ibt;
temporary: [adj]临时的; [or]tf_ibt;
contemporary: [adj]当代的;同时代的; [or]tf_ibt;
impromptu: [adj]临时的;即兴的; [or]tf_ibt;
occasional: [adj]临时的;偶然的; [or]tf_ibt;
punctual: [adj]守时的; [or]tf_ibt;
instantaneous: [adj]瞬间的; [or]tf_ibt;
subsequent: [adj]随后的,后来的; [or]tf_ibt;
current: [adj]现今的; [or]tf_ibt;
concurrent: [adj]同时发生的; [or]tf_ibt;
extant: [adj]现存的; [or]tf_ibt;
nocturnal: [adj]夜间的; [or]tf_ibt;
former: [adj]以前的; [or]tf_ibt;
formerly: [adv]从前;原来; [or]tf_ibt;
previous: [adj]以前的; [or]tf_ibt;
previously: [adv]先前,以前; [or]tf_ibt;
eternal: [adj]永恒的; [or]tf_ibt;
permanent: [adj]永久的; [or]tf_ibt;
abiding: [adj]永久的,永恒的; [or]tf_ibt;
dated: [adj]有年头的,陈旧的; [or]tf_ibt;
overdue: [adj]逾期的; [or]tf_ibt;
tentative: [adj]暂时的; [or]tf_ibt;
beforehand: [adv]事先地; [or]tf_ibt;
simultaneously: [adv]同时的; [or]tf_ibt;
recently: [adv]最近地; [or]tf_ibt;
lately: [adv]最近; [or]tf_ibt;
duration: [n]持续时间;为期; [or]tf_ibt;
epoch: [n]纪元;时代; [or]tf_ibt;
interlude: [n]间隔;插曲; [or]tf_ibt;
era: [n]时代;时期; [or]tf_ibt;
schedule: [n]时间表;计划表; [or]tf_ibt;
juncture: [n]时刻; [or]tf_ibt;
session: [n]一段时间;一次; [or]tf_ibt;
elapse: [vi](时间)消逝; [or]tf_ibt;
concur: [vi]同时发生; [or]tf_ibt;
improvise: [vt]即席而作; [or]tf_ibt;
synchronize: [vt]同时发生; [or]tf_ibt;
abruptly: [adv]突然地;唐突地; [or]tf_ibt;

## 水相关动作 
itinerant: [adj]巡回的;流动的; [or]tf_ibt;
flow: [n]流程;流动; [v]流动; [or]tf_ibt;
influx: [n]流入;灌输; [or]tf_ibt;
spray: [v]喷洒; [n]喷洒出来的雾气; [or]tf_ibt;
drift: [n]漂流 [v]漂流; [or]tf_ibt;
fluctuate: [v]波动; [or]tf_ibt;
splash: [v]溅;泼; [or]tf_ibt;
dip: [v]浸;蘸; [or]tf_ibt;
spurt: [vt]喷出;涌出; [or]tf_ibt;
spout: [v]喷出;涌出; [or]tf_ibt;
meander: [v]蜿蜒而流; [or]tf_ibt;
gush: [vi]涌出; [or]tf_ibt;
immerse: [vt]沉浸; [or]tf_ibt;
overflow: [vt]从]]中溢出; [or]tf_ibt;
infuse: [vt]灌输;浸渍; [or]tf_ibt;
submerge: [vt]淹没; [vi]潜水; [or]tf_ibt;
imbue: [vt]浸染;灌输; [or]tf_ibt;
saturate: [vt]浸透; [or]tf_ibt;
exude: [vt]渗出;流出; [or]tf_ibt;
permeate: [vt]渗透;透过; [or]tf_ibt;
dampen: [vt]使]]发潮;给]]泼冷水; [or]tf_ibt;
moisten: [vt]使]]湿润; [or]tf_ibt;

## 物体 
article: [n]物品; [or]tf_ibt;
craft: [n]船(单复数相同); [or]tf_ibt;
vessel: [n]器皿;导管;船; [or]tf_ibt;
girdle: [n]腰带;带状物; [or]tf_ibt;
canvas: [n]帆布; [or]tf_ibt;
stick: [n]棍,棒; [or]tf_ibt;
souvenir: [n]纪念品; [or]tf_ibt;
board: [n]木板; [or]tf_ibt;
screen: [n]屏幕; [or]tf_ibt;
container: [n]容器;集装箱; [or]tf_ibt;
entity: [n]实体; [or]tf_ibt;
spur: [n]剔马刺; [or]tf_ibt;
leash: [n]牵狗的皮带;控制; [or]tf_ibt;
strip: [n]条,带; [or]tf_ibt;
band: [n]条,带; [or]tf_ibt;
hinge: [n]铰链; [or]tf_ibt;
ledge: [n]突出物;壁架; [or]tf_ibt;
bulk: [n]物体; [or]tf_ibt;
varnish: [n]油漆; [or]tf_ibt;
tug: [n]拖船; [or]tf_ibt;

## 效果 
null: [adj]无效的; [or]tf_ibt;
valid: [adj]有效的; [or]tf_ibt;
invalid: [adj]无效的; [or]tf_ibt;
effect: [adj]效果;印象; [or]tf_ibt;
effective: [adj]有效的;有影响的; [or]tf_ibt;
efficient: [adj]有效率的; [or]tf_ibt;
outcome: [adj]结果;成果; [or]tf_ibt;
impotence: [adj]无效; [or]tf_ibt;

## 原因 
gratuitous: [adj]无理由的; [or]tf_ibt;
source: [n]来源;源头; [or]tf_ibt;
account: [n]原因; [or]tf_ibt;
reason: [adj]原因; [or]tf_ibt;
sake: [n]缘由,缘故; [or]tf_ibt;
cause: [vt]导致 [n]原因; [or]tf_ibt;
impute: [vt]归咎于; [or]tf_ibt;
attribute: [vt]归因于; [or]tf_ibt;

## 局部与整体 
superficial: [adj]表面的;肤浅的; [or]tf_ibt;
partial: [adj]部分的; [or]tf_ibt;
partially: [adv]部分地; [or]tf_ibt;
overall: [adj]全部的;全面的; [or]tf_ibt;
integral: [adj]组成的;整的; [or]tf_ibt;
integrate: [vt]使结合,使并入; [or]tf_ibt;
integrity: [n]完整性; [or]tf_ibt;
seemingly: [adv]表面上;似乎; [or]tf_ibt;
portion: [n]一部分; [or]tf_ibt;
proportion: [n]比例;部分; [or]tf_ibt;
segment: [n]部分;片段; [or]tf_ibt;
facet: [n]方面; [or]tf_ibt;
aspect: [n]方面的; [or]tf_ibt;
juncture: [n]结合点; [or]tf_ibt;
junction: [n]汇合处; [or]tf_ibt;
fraction: [n]片段; [or]tf_ibt;
respect: [n]转眼点;方面; [or]tf_ibt;
component: [n]组成部分; [or]tf_ibt;
system: [n]系统,体系; [or]tf_ibt;


# 30 现实; [or]tf_ibt;
## 犯罪 
deceit: [n]欺骗,欺诈; [or]tf_ibt;
deceitful: [adj]欺骗的; [or]tf_ibt;
deceive: [vt]欺骗; [or]tf_ibt;
deceptive: [adj]虚伪的;骗人的; [or]tf_ibt;
gangster: [n]歹徒,暴徒; [or]tf_ibt;
fraud: [n]欺骗; [or]tf_ibt;
fraudulent: [adj]欺诈的,不诚实的; [or]tf_ibt;
homicide: [n]杀人; [or]tf_ibt;
theft: [n]偷窃; [or]tf_ibt;
pilferage: [n]偷窃; [or]tf_ibt;
counterfeit: [n]赝品; [adj]伪造的,假冒的; [or]tf_ibt;
conspire: [vi]密谋; [or]tf_ibt;
conspiracy: [n]阴谋; [or]tf_ibt;
sin: [n]罪过;过失; [or]tf_ibt;
brew: [v]酿造;图谋; [or]tf_ibt;
beguile: [vi]欺骗; [or]tf_ibt;
despoil: [vt]抢劫; [or]tf_ibt;
forge: [vt]伪造; [or]tf_ibt;
assassinate: [vt]暗杀,行刺; [or]tf_ibt;
kidnap: [vt]绑架; [or]tf_ibt;
embezzle: [vt]盗用(公款,公物); [or]tf_ibt;
extort: [vt]勒索; [or]tf_ibt;
blackmail: [vt]勒索; [or]tf_ibt;
delude: [vt]欺骗,迷惑; [or]tf_ibt;
defraud: [vt]欺诈; [or]tf_ibt;
fabricate: [vt]伪造; [or]tf_ibt;
purge: [vt]洗涤(罪等); [or]tf_ibt;
belie: [vt]掩饰; [or]tf_ibt;
trap: [vt]诱捕;陷害 [n]陷阱; [or]tf_ibt;
accomplice: [n]从犯; [or]tf_ibt;
abduct: [vt]绑架,诱拐; [or]tf_ibt;

## 福气 
convenient: [adj]便利的,方便的; [or]tf_ibt;
grateful: [adj]感谢的; [or]tf_ibt;
gratitude: [n]感谢; [or]tf_ibt;
auspicious: [adj]吉兆的;幸运的; [or]tf_ibt;
cozy: [adj]舒适的; [or]tf_ibt;
fortunate: [adj]幸运的; [or]tf_ibt;
readily: [adv]容易地; [or]tf_ibt;
boon: [n]恩惠; [or]tf_ibt;
bonanza: [n]幸运; [or]tf_ibt;
blessing: [n]祝福; [or]tf_ibt;
thrive: [vi]繁荣,旺盛; [or]tf_ibt;

## 工具使用 
furrow: [vt]犁,耕;弄皱; [or]tf_ibt;
instrument: [n]工具; [or]tf_ibt;
implement: [n]工具; [or]tf_ibt;
tool: [n]工具; [or]tf_ibt;
shaft: [n]轴;柄; [or]tf_ibt;
pump: [n]水泵; [v]抽水,吸; [or]tf_ibt;
snap: [v]使猛然断裂; [or]tf_ibt;
squeeze: [v]挤; [or]tf_ibt;
prune: [v]修剪; [or]tf_ibt;
glaze: [v]上釉; [n]釉; [or]tf_ibt;
tug: [v]拖,牵引; [or]tf_ibt;
fix: [v]修理; [or]tf_ibt;
maintain: [vt]维修; [or]tf_ibt;
extract: [vt]提取(榨取);拔出; [or]tf_ibt;
flay: [vt]剥]]的皮; [or]tf_ibt;
flush: [vt]冲洗; [or]tf_ibt;
clinch: [vt]钉劳;揪住; [or]tf_ibt;
gild: [vt]镀金; [or]tf_ibt;
scratch: [vt]刮擦; [n]划痕; [or]tf_ibt;
clip: [vt]夹住;修剪 [n]夹子;钳子; [or]tf_ibt;
clamp: [vt]夹; [or]tf_ibt;
hew: [vt]砍,伐;削; [or]tf_ibt;
rap: [vt]敲击; [or]tf_ibt;
cleanse: [vt]使清洁; [or]tf_ibt;
rend: [vt]撕开;揪扯; [or]tf_ibt;
cram: [vt]填塞; [or]tf_ibt;
smear: [vt]涂; [or]tf_ibt;
efface: [vt]涂抹; [or]tf_ibt;
remove: [vt]移除;搬开;脱掉; [or]tf_ibt;
forge2: [vt]铸造; [or]tf_ibt;
tow: [vt]拖拉,牵引; [or]tf_ibt;
incise: [vt]切割,切开; [or]tf_ibt;
chop: [vt]砍; [or]tf_ibt;
harrow: [vt]耙掘; [or]tf_ibt;
pick: [v]摘;掘;凿;挖;挑选; [or]tf_ibt;
shovel: [n]铁铲 [v]铲; [or]tf_ibt;
sickle: [n]镰刀; [or]tf_ibt;
spade: [n]铁铲 [v]铲; [or]tf_ibt;
bore: [v]钻孔; [or]tf_ibt;

## 工作 
hectic: [adj]忙碌的; [or]tf_ibt;
officially: [adv]官方地;正式地; [or]tf_ibt;
entry: [n]登记;入口; [or]tf_ibt;
role: [n]任务; [or]tf_ibt;
log: [n]日志; [or]tf_ibt;
draft: [n]草案; [v]起草;设计; [or]tf_ibt;
sketch: [n]草图; [v]勾画; [or]tf_ibt;
assumption: [n]就职; [or]tf_ibt;
drudgery: [n]苦差事; [or]tf_ibt;
chore: [n]零工,杂务; [or]tf_ibt;
undertaking: [n]任务,工作; [or]tf_ibt;
task: [n]任务,作业; [or]tf_ibt;
career: [n]职业,生涯; [or]tf_ibt;
audition: [n]试听;面试; [or]tf_ibt;
vocation: [n]职业,行业; [or]tf_ibt;
charge: [n]职责; [or]tf_ibt;
major: [n]专业; [or]tf_ibt;
resign: [n]辞职; [v]辞职; [or]tf_ibt;
solicit: [v]拉客; [or]tf_ibt;
register: [vt]登记; [or]tf_ibt;
inaugurate: [vt]开始;使就职; [or]tf_ibt;
promote: [vt]升职;促进; [or]tf_ibt;
officeholding: [n]任职; [or]tf_ibt;

## 供给 
provide: [vt]提供; [or]tf_ibt;
provision: [n]供应; [or]tf_ibt;
accommodate: [vt]供给住宿; [or]tf_ibt;
furnish: [vt]供应,供给; [or]tf_ibt;
render: [vt]提供; [or]tf_ibt;

## 关系 
incompatible: [adj]不兼容的; [or]tf_ibt;
congruity: [n]一致,协调; [or]tf_ibt;
incongruity: [n]不和谐(之物); [or]tf_ibt;
respective: [adj]分别的,各自的; [or]tf_ibt;
close: [adj]亲密的 [adv]紧密的; [or]tf_ibt;
mutual: [adj]相互的,共同的; [or]tf_ibt;
concerted: [adj]协定的;协调的; [or]tf_ibt;
fraternal: [adj]兄弟般的,友爱的; [or]tf_ibt;
dependent: [adj]依靠的,依赖的; [or]tf_ibt;
congenial: [adj]意气相投的; [or]tf_ibt;
relevant: [adj]有关的;贴切的; [or]tf_ibt;
bond: [n]联结,联系; [or]tf_ibt;
complement: [n]补足物; [vt]补足; [or]tf_ibt;
complementary: [adj]补充的; [or]tf_ibt;
discord: [n]不和谐; [or]tf_ibt;
association: [n]关联; [or]tf_ibt;
associate: [v]联合; [n]伙伴; [or]tf_ibt;
cooperation: [n]合作; [or]tf_ibt;
fusion: [n]联合; [or]tf_ibt;
intimate: [adj]亲密的; [vt]暗示; [or]tf_ibt;
intimacy: [n]熟悉;亲近; [or]tf_ibt;
substitute: [n]替代品 [v]替代; [or]tf_ibt;
consensus: [n]一致; [or]tf_ibt;
concurrence: [n]一致; [or]tf_ibt;
impact: [n]影响,作用; [v]对]]发生影响; [or]tf_ibt;
link: [n]链接; [v]链接; [or]tf_ibt;
proximity: [n]接近,邻近; [or]tf_ibt;
band: [v]联合,结合; [or]tf_ibt;
collaborate: [vi]合作; [or]tf_ibt;
hinge: [vi]依]]而定; [or]tf_ibt;
replenish: [vt]补充; [or]tf_ibt;
supplant: [vt]排挤;取代; [or]tf_ibt;
implicate: [vt]牵连; [or]tf_ibt;
displace: [vt]取代; [or]tf_ibt;
supersede: [vt]替代; [or]tf_ibt;
correlate: [vt]使关联; [or]tf_ibt;
grant: [vt]赠予; [or]tf_ibt;
subsidiary: [adj]辅助的;附属的; [or]tf_ibt;
affinity: [n]密切关系; [or]tf_ibt;
fitting: [adj]适合的,相称的; [or]tf_ibt;
sway: [v]影响; [or]tf_ibt;
affect: [vt]影响,感动; [or]tf_ibt;
derivative: [n]派生的事物; [or]tf_ibt;
patronage: [n]保护人的身份;保护;赞助;光顾; [or]tf_ibt;
unionization: [n]联合,结合; [or]tf_ibt;

## 建筑: 
haven [n]港口;避难所; [or]tf_ibt;
refuge: [n]避难所; [or]tf_ibt;
depot: [n]仓库 [vt]把]]存放在仓库里; [or]tf_ibt;
auditorium: [n]大礼堂; [or]tf_ibt;
vault: [n]地窖;拱形圆顶屋; [or]tf_ibt;
block: [n]街区; [or]tf_ibt;
stall: [n]摊位;厩; [or]tf_ibt;
dormitory: [n]宿舍; [or]tf_ibt;
tower: [n]塔; [v]屹立,高耸; [or]tf_ibt;
dwelling: [n]住所; [or]tf_ibt;
forge: [n]铁匠铺; [or]tf_ibt;
canopy: [n]天篷,遮篷子; [or]tf_ibt;

## 困难 
laborious: [adj]费力的,困难的; [or]tf_ibt;
precipitous: [adj]陡峭的;急躁的; [or]tf_ibt;
devious: [adj]曲折的; [or]tf_ibt;
arduous: [adj]险峻的;困难的; [or]tf_ibt;
strenuous: [adj]辛苦的; [or]tf_ibt;
plight: [n]恶劣的情势,困境; [or]tf_ibt;
strait: [n]困难; [or]tf_ibt;
painstaking: [n]辛劳 [adj]辛劳的; [or]tf_ibt;
dilemma: [n]左右为难的困境; [or]tf_ibt;
flounder: [vi]挣扎; [or]tf_ibt;
embarrass: [vt]使困窘; [or]tf_ibt;

## 流行 
fashionable: [adj]流行的,时髦的; [or]tf_ibt;
prevail: [vi]流行,盛行; [or]tf_ibt;
prevalent: [adj]普遍的,流行的; [or]tf_ibt;
tide: [n]潮流; [or]tf_ibt;
vogue: [n]流行; [or]tf_ibt;
novelty: [n]新颖,新奇的事物; [or]tf_ibt;

## 名誉 
gorgeous: [adj]极好的; [or]tf_ibt;
outstanding: [adj]杰出的; [or]tf_ibt;
obscure: [adj]无名气的; [or]tf_ibt;
immortal: [adj]不朽的; [or]tf_ibt;
notorious: [adj]臭名昭著的; [or]tf_ibt;
infamous: [adj]臭名昭著的; [or]tf_ibt;
legendary: [adj]传奇的; [or]tf_ibt;
glorious: [adj]光荣的; [or]tf_ibt;
illustrious: [adj]辉煌的;著名的; [or]tf_ibt;
eminent: [adj]杰出的; [or]tf_ibt;
deferential: [adj]充满敌意的; [or]tf_ibt;
exemplary: [adj]模范的,典范的; [or]tf_ibt;
matchless: [adj]无与伦比的; [or]tf_ibt;
excel: [v]胜过他人; [or]tf_ibt;
excellent: [adj]优秀的,杰出的; [or]tf_ibt;
compliment: [vt]赞美,祝贺; [or]tf_ibt;
complimentary: [adj]赞美的; [or]tf_ibt;
renowned: [adj]知名的; [or]tf_ibt;
laudable: [adj]值得赞美的; [or]tf_ibt;
supreme: [adj]至高无上的; [or]tf_ibt;
celebrate: [vt]赞扬,表扬; [or]tf_ibt;
notable: [adj]著名的,显要的; [or]tf_ibt;
noted: [adj]著名的,知名的; [or]tf_ibt;
exceptional: [adj]卓越的; [or]tf_ibt;
preeminent: [adj]卓越的; [or]tf_ibt;
dignify: [vt]使尊荣,使显贵; [or]tf_ibt;
dignified: [adj]尊贵的; [or]tf_ibt;
dignity: [n]尊严; [or]tf_ibt;
lofty: [adj]高尚的; [or]tf_ibt;
odor: [n]名声; [or]tf_ibt;
credit: [n]信誉; [or]tf_ibt;
feat: [n]功绩,壮举; [or]tf_ibt;
homage: [n]敬意; [or]tf_ibt;
deference: [n]敬意; [or]tf_ibt;
virtue: [n]美德; [or]tf_ibt;
prestige: [n]威望,声望; [or]tf_ibt;
grandeur: [n]庄严,伟大; [or]tf_ibt;
reverence: [n]尊敬; [or]tf_ibt;
awe: [n]敬畏 [v]敬畏; [or]tf_ibt;
esteem: [n]尊敬 [vt]尊敬; [or]tf_ibt;
commend: [v]赞扬; [or]tf_ibt;
exalt: [n]称赞;提升; [or]tf_ibt;
exalted: [adj]尊贵的; [or]tf_ibt;
venerate: [vt]敬拜,崇拜; [or]tf_ibt;
embalm: [vt]使不朽; [or]tf_ibt;
tarnish: [vt]使晦暗,败坏(名誉); [or]tf_ibt;
extol: [vt]颂扬; [or]tf_ibt;
laud: [vt]赞美; [or]tf_ibt;
revere: [vt]尊敬; [or]tf_ibt;
admirable: [adj]可敬的,极好的; [or]tf_ibt;
disreputable: [adj]声名狼藉的; [or]tf_ibt;
classic: [adj]第一流的; [or]tf_ibt;
respect: [vt]尊敬 [n]尊敬; [or]tf_ibt;
adore: [vt]敬爱;极喜爱; [or]tf_ibt;
admire: [vt]钦佩;赞美,夸奖; [or]tf_ibt;
advocate: [vt]拥护; [or]tf_ibt;

## 气氛 
hilarious: [adj]热闹的; [or]tf_ibt;
sullen: [adj]阴沉的; [or]tf_ibt;
hilarity: [n]欢闹; [or]tf_ibt;
aura: [adj]气氛; [or]tf_ibt;

## 社会活动 
formal: [adj]正式的;礼仪上的; [or]tf_ibt;
session: [n]会议; [or]tf_ibt;
conference: [n]会议; [or]tf_ibt;
reception: [n]接待;招待会; [or]tf_ibt;
etiquette: [n]礼节; [or]tf_ibt;
decorum: [n]礼仪; [or]tf_ibt;
banquet: [n]宴会,盛会; [or]tf_ibt;
bidding: [n]邀请; [or]tf_ibt;
ceremony: [n]礼仪; [or]tf_ibt;
ceremonial: [adj]正式的 [n]仪式; [or]tf_ibt;
ceremonious: [adj]隆重的;正式的;恭敬的; [or]tf_ibt;
unveil: [v]开幕; [or]tf_ibt;
celebrate: [vi]庆祝; [or]tf_ibt;
entertain: [vt]招待;娱乐; [or]tf_ibt;

## 身体动作 
glaring: [adj]瞪眼的; [or]tf_ibt;
grip: [n]紧握; [or]tf_ibt;
posture: [n]人体的姿势; [or]tf_ibt;
grasp: [n]抓紧; [v]抓紧 ; [or]tf_ibt;
jerk: [n]抽搐; [v]抽搐 ; [or]tf_ibt;
chuckle: [n]咯咯地笑; [v]咯咯地笑 ; [or]tf_ibt;
flip: [v]翻滚;(用手指)弹,投 ; [or]tf_ibt;
stagger: [v]使蹒跚 ; [or]tf_ibt;
trudge: [v]跋涉,吃力的走 ; [or]tf_ibt;
fasten: [v]扣劳,抓住 ; [or]tf_ibt;
hurl: [v]猛投;梦冲 ; [or]tf_ibt;
face: [v]面对 ; [or]tf_ibt;
leap: [v]跳跃 ; [or]tf_ibt;
bow: [v]弯腰;屈服 ; [or]tf_ibt;
blink: [v]眨眼 ; [or]tf_ibt;
erect: [v]直立 ; [or]tf_ibt;
trample: [v] 践踏,蹂躏; [or]tf_ibt;
tremble: [vi]发抖;摇晃; [or]tf_ibt;
glide: [vi]滑动;溜走; [or]tf_ibt;
depart: [vi]离开,出发; [or]tf_ibt;
slump: [vi]猛然落下; [or]tf_ibt;
gaze: [vi]凝视; [or]tf_ibt;
creep: [vt]爬,蹑手蹑脚; [or]tf_ibt;
limp: [vt]蹒跚,瘸着走; [or]tf_ibt;
sigh: [vi]叹息; [n]叹息; [or]tf_ibt;
recoil: [vi]后退,退缩; [n]退缩; [or]tf_ibt;
uphold: [vt]举起;支撑; [or]tf_ibt;
grab: [vt]攫取;抓住; [or]tf_ibt;
stride: [vt]跨越; [or]tf_ibt;
thrust: [vt]力推; [or]tf_ibt;
gnaw: [vt]啮; [or]tf_ibt;
spew: [vt]呕吐; [or]tf_ibt;
dab: [vt]轻拍; [or]tf_ibt;
plunge: [v]投入; [or]tf_ibt;
dart: [vt]投掷; [or]tf_ibt;
shove: [vt]推挤; [or]tf_ibt;
grag: [vt]拖动; [or]tf_ibt;
haul: [vt]拖拽,拖运; [or]tf_ibt;
shake: [vt]摇;震动; [or]tf_ibt;
jolt: [vt]摇动; [or]tf_ibt;
embrace: [vt]拥抱; [or]tf_ibt;
heave: [vt]用力举起;拖; [or]tf_ibt;
slap: [vt]掌击,拍; [or]tf_ibt;
clutch: [vt]抓住; [vi]掌握; [or]tf_ibt;
sprawl: [v]伸开手脚; [or]tf_ibt;
sway: [v]摇摆; [or]tf_ibt;
spring: [v]跳跃; [or]tf_ibt;
footbeat: [n]跺脚; [or]tf_ibt;

## 生产 
industrial: [adj]工业的; [or]tf_ibt;
practical: [adj]实践的;实用的; [or]tf_ibt;
instrument: [n]仪器; [or]tf_ibt;
instrumental: [adj]仪器的,器械的; [or]tf_ibt;
textile: [adj]纺织的; [n]纺织品; [or]tf_ibt;
outfit: [n]装备;用具; [or]tf_ibt;
mine: [n/v]采矿; [or]tf_ibt;
gear: [n]齿轮; [or]tf_ibt;
fixture: [n]固定装置; [or]tf_ibt;
monitor: [v]监视,监听; [or]tf_ibt;
device: [n]器械,装置;设计; [or]tf_ibt;
equipment: [n]设备; [or]tf_ibt;
cement: [n]水泥,粘合物; [vt]接合; [or]tf_ibt;
pivot: [n]轴; [or]tf_ibt;
axis: [n]轴; [or]tf_ibt;
release: [n/vt]发行; [or]tf_ibt;
load: [n]负荷; [v]装载; [or]tf_ibt;
behave: [v]运转; [or]tf_ibt;
erect: [v]建设; [or]tf_ibt;
raise: [vt]养殖; [or]tf_ibt;
manipulate: [vt]操作;操纵; [or]tf_ibt;
construct: [vt]建造,构造; [or]tf_ibt;
convey: [vt]运输; [or]tf_ibt;
fabricate: [vt]制造; [or]tf_ibt;
manufacture: [vt]制造; [or]tf_ibt;
conserve: [vt]贮藏; [or]tf_ibt;
hoist: [n]吊车; [v]升起,提起; [or]tf_ibt;
concrete: [n]水泥; [or]tf_ibt;
mill: [vt]压榨机;磨粉机(磨坊); [or]tf_ibt;

## 生活 
domestic: [adj]家内的; [or]tf_ibt;
idyllic: [adj]田园诗的; [or]tf_ibt;
scale: [n]秤; [or]tf_ibt;
furniture: [n]家具; [or]tf_ibt;
rubbish: [n]垃圾; [or]tf_ibt;
trash: [n]垃圾; [or]tf_ibt;
hurdle: [n]篱笆; [or]tf_ibt;
sustenance: [n]生计; [or]tf_ibt;
nostalgia: [n]思乡;怀旧; [or]tf_ibt;
singe: [n]烧焦; [or]tf_ibt;
baggage: [n]行李; [or]tf_ibt;
outing: [n]郊游,远足; [or]tf_ibt;
regimen: [n]养生法; [or]tf_ibt;
slag: [n]渣仔; [or]tf_ibt;
sojourn: [vi]逗留;寄居; [or]tf_ibt;
dwell: [vi]居住; [or]tf_ibt;
baby-sit: [vi]看管婴儿; [or]tf_ibt;
tease: [vt]戏弄; [or]tf_ibt;
inhabit: [vt]居住于;栖息于; [or]tf_ibt;
scorch: [vt]烤焦; [or]tf_ibt;
nurture: [vt]养育; [or]tf_ibt;
reside: [vi]居住; [or]tf_ibt;
resident: [adj]常驻的,居住的; [or]tf_ibt;

## 土地 
deserted: [adj]荒废的; [or]tf_ibt;
desolate: [adj]荒凉的; [or]tf_ibt;
bleak: [adj]荒凉的; [or]tf_ibt;
sterile: [adj]贫瘠的;不育的; [or]tf_ibt;
barren: [adj]贫瘠的;不育的 [n]荒地; [or]tf_ibt;
agrarian: [adj]耕地的;有关土地的; [or]tf_ibt;
clay: [n]黏土; [or]tf_ibt;
clod: [n]土块; [or]tf_ibt;

## 外表 
stodgy: [adj]躯体笨重的; [or]tf_ibt;
stout: [adj]矮胖的; [or]tf_ibt;
obese: [adj]肥胖的;硕大的; [or]tf_ibt;
corpulent: [adj]肥胖的; [or]tf_ibt;
shabby: [adj]衣衫褴褛的;破旧的; [or]tf_ibt;
ragged: [adj]衣衫褴褛的;破烂的; [or]tf_ibt;
bald: [adj]秃头的,光头的; [or]tf_ibt;
aspect: [n]样子,外表; [or]tf_ibt;
costume: [n]服装; [or]tf_ibt;
attire: [n]服装; [or]tf_ibt;
outfit: [n]服装; [or]tf_ibt;
garb: [n]服装,装束; [or]tf_ibt;
strap: [n]皮带; [or]tf_ibt;
guise: [n]外观;装束; [or]tf_ibt;
clothing: [n]衣服; [or]tf_ibt;
array: [vt]装扮; [or]tf_ibt;
cosmetics: [n]化妆品; [or]tf_ibt;
suit: [n]套装; [or]tf_ibt;
sole: [n]鞋底; [or]tf_ibt;

## 休息 
drowsy: [adj]昏昏欲睡的; [or]tf_ibt;
nap: [n/v]小憩; [or]tf_ibt;
recreation: [n]消遣; [or]tf_ibt;
lull: [n]歇息; [or]tf_ibt;
beguile: [vi]消遣; [or]tf_ibt;
doze: [vi]瞌睡; [or]tf_ibt;
bask: [vt]取暖;曝日; [or]tf_ibt;

##预知 
fateful: [adj]预言性的; [or]tf_ibt;
estimable: [adj]可估计的; [or]tf_ibt;
apt: [adj]有]]倾向的; [or]tf_ibt;
promising: [adj]有前途的,有希望的; [or]tf_ibt;
provident: [adj]有远见的; [or]tf_ibt;
prospect: [n]前景;期望; [or]tf_ibt;
prospective: [adj]预期的; [or]tf_ibt;
perspective: [n]远景; [or]tf_ibt;
auspices: [n]征兆; [or]tf_ibt;
precursor: [n]趋势; [or]tf_ibt;
prediction: [adj]预言;预报; [or]tf_ibt;
surmise: [vt]臆测; [or]tf_ibt;
foretell: [vt]预言; [or]tf_ibt;
foresee: [vt]预知; [or]tf_ibt;
foresight: [n]远见; [or]tf_ibt;
current: [n]趋势; [or]tf_ibt;
forecast: [n]先见;预测; [or]tf_ibt;

## 灾难与不幸 
disaster: [n]灾难; [or]tf_ibt;
helpless: [adj]无助的; [or]tf_ibt;
disastrous: [adj]灾难性的;悲惨的; [or]tf_ibt;
unfortunately: [adv]不幸地; [or]tf_ibt;
calamity: [n]不幸之事;灾难; [or]tf_ibt;
holocaust: [n]大屠杀; [or]tf_ibt;
carnage: [n]大屠杀,残杀; [or]tf_ibt;
cataclysm: [n]大灾难;大洪水; [or]tf_ibt;
avalanche: [n]雪崩; [or]tf_ibt;
catastrophe: [n]异常的灾难; [使得灾祸]; [or]tf_ibt;
plague: [n]疫病;灾祸 [v]折磨,使苦恼; [or]tf_ibt;
casualty: [n]意外伤亡;事故; [or]tf_ibt;
mishap: [n]灾祸;不幸; [or]tf_ibt;
adversity: [n]不幸;逆境; [or]tf_ibt;
afflict: [vt]使痛苦;使折磨; [or]tf_ibt;

## 致命 
defunct: [adj]死的; [or]tf_ibt;
lethal: [adj]致命的; [or]tf_ibt;
deadly: [adj]致命的; [or]tf_ibt;
demise: [n]死亡; [or]tf_ibt;
choke: [n]窒息 [v]使窒息; [or]tf_ibt;
smother: [v]使窒息;闷死; [or]tf_ibt;
expire: [vi]断气; [or]tf_ibt;
mortal: [adj]终有一死的; [n]凡人; [or]tf_ibt;

# 31 心理; [or]tf_ibt;
## 傲慢 
partial: [adj]偏袒的; [or]tf_ibt;
overbearing: [adj]傲慢的; [or]tf_ibt;
arrogant: [adj]傲慢的; [or]tf_ibt;
haughty: [adj]傲慢的; [or]tf_ibt;
insolent: [adj]傲慢的;无礼的; [or]tf_ibt;
fussy: [adj]过分挑剔的; [or]tf_ibt;
contemptuous: [adj]蔑视的;傲慢的; [or]tf_ibt;
domineering: [adj]盛气凌人的; [or]tf_ibt;
presumptuous: [adj]专横的; [or]tf_ibt;
arrogance: [n]傲慢; [or]tf_ibt;
preference: [n]偏爱; [or]tf_ibt;
bias: [n]偏见; [or]tf_ibt;

## 悲伤 
doleful: [adj]悲哀的; [or]tf_ibt;
upset: [adj]难过的; [or]tf_ibt;
trying: [adj]难堪的;痛苦的; [or]tf_ibt;
sentimental: [adj]多愁善感的; [or]tf_ibt;
grieve : [vi]悲伤; [or]tf_ibt;
grieved: [adj]伤心的; [or]tf_ibt;
gloom: [adj]忧愁; [or]tf_ibt;
torturous: [adj]痛苦的 [v]折磨; [or]tf_ibt;
misery: [n]痛苦,苦恼; [or]tf_ibt;
miserable: [adj]痛苦的;可怜的; [or]tf_ibt;
pensive: [adj]忧愁的;哀思的; [or]tf_ibt;
lament: [n]悲伤; [vt]痛惜; [or]tf_ibt;
torment: [n]痛苦 [v]折磨; [or]tf_ibt;
deplore: [vt]悲痛;深悔; [or]tf_ibt;

## 吃惊 
inconceivable: [adj]不可思议的; [or]tf_ibt;
uncanny: [adj]不可思议的;离奇的; [or]tf_ibt;
marvelous: [adj]不可思议的;了不起的; [or]tf_ibt;
breathtaking: [adj]惊人的,惊险的; [or]tf_ibt;
astound: [vt]使惊异; [or]tf_ibt;
astonishing: [vt]使惊讶; [or]tf_ibt;
astonished: [adj]惊讶的; [or]tf_ibt;
incredible: [adj]难以相信的; [or]tf_ibt;
striking: [adj]显著的,惊人的; [or]tf_ibt;
tremor: [n]颤抖,颤栗; [or]tf_ibt;
trepidation: [n]惊恐,颤栗; [or]tf_ibt;
petrify: [vt]使发呆; [or]tf_ibt;
acare: [vt]惊吓,使受惊; [or]tf_ibt;
startle: [vt]使大吃一惊 [n]吃惊; [or]tf_ibt;
stun: [vt]使昏晕,使目瞪口呆; [or]tf_ibt;
dismay: [vt]使惊愕;使沮丧; [or]tf_ibt;

## 动机 
impetuous: [adj]冲动的; [or]tf_ibt;
impulse: [n]冲动,刺激; [or]tf_ibt;
impulsive: []易冲动的; [or]tf_ibt;
urge: [n]冲动; [or]tf_ibt;
incentive: [n]刺激;动机; [or]tf_ibt;
motivation: [n]动机; [or]tf_ibt;
objective: [n]目标; [or]tf_ibt;

## 恶意 
grim: [adj]不吉祥的; [or]tf_ibt;
sinister: [adj]不祥的;邪恶的; [or]tf_ibt;
cruel: [adj]残忍的; [or]tf_ibt;
malevolent: [adj]恶意的; [or]tf_ibt;
malice: [n]恶意; [or]tf_ibt;
malicious: [adj]怀恶意的;心毒的; [or]tf_ibt;
ferocious: [adj]凶猛的; [or]tf_ibt;

## 烦躁 
gloomy: [adj]忧闷得; [or]tf_ibt;
impatient: [adj]不耐烦的; [or]tf_ibt;
stodgy: [adj]鼓噪乏味的; [or]tf_ibt;
boring: [adj]令人厌烦的; [or]tf_ibt;
bothersome: [adj]令人厌烦的; [or]tf_ibt;
boredom: [n]烦恼,无聊; [or]tf_ibt;
tedious: [adj]冗长乏味的; [or]tf_ibt;
sicken: [vt]使厌倦,使作呕; [or]tf_ibt;
uproar: [n]扰乱,喧嚣; [or]tf_ibt;
intrude: [v]侵扰; [or]tf_ibt;
chafe: [vt]烦扰; [or]tf_ibt;
distract: [vt]分散,打扰; [or]tf_ibt;
harass: [vt]扰乱; [or]tf_ibt;
disarrange: [vt]扰乱; [or]tf_ibt;
derange: [vt]扰乱; [or]tf_ibt;
vex: [vt]使烦恼; [or]tf_ibt;

## 愤怒 
grouchy: [adj]不悦的; [or]tf_ibt;
indignant: [adj]义愤的; [or]tf_ibt;
furious: [adj]狂怒的; [or]tf_ibt;
nervous: [adj]易激动的; [or]tf_ibt;
passionate: [adj]易怒的; [or]tf_ibt;
touchy: [adj]易怒的;棘手的; [or]tf_ibt;
fury: [adj]勃然大怒; [or]tf_ibt;
rage: [n]愤怒; [or]tf_ibt;
enrage: [vt]激怒; [or]tf_ibt;
outrage: [vt]激怒;侵犯; [or]tf_ibt;
exasperate: [vt]激怒; [or]tf_ibt;
fret: [vt]激怒; [or]tf_ibt;
provoke: [vt]激怒; [or]tf_ibt;
incense: [vt]激怒; [or]tf_ibt;

## 感觉 
indefatigable: [adj]不疲倦的; [or]tf_ibt;
sensuous: [adj]美感的,感觉的; [or]tf_ibt;
faint: [adj] 昏晕的; [or]tf_ibt;
ravenous: [adj]饥饿的; [or]tf_ibt;
listless: [adj]没精打采的; [or]tf_ibt;
beat: [adj]疲倦的; [or]tf_ibt;
downhearted: [adj]无精打采的; [or]tf_ibt;
daze: [vt]使发昏,茫然; [n]昏晕; [or]tf_ibt;
intuition: [n]直觉; [or]tf_ibt;
starve: [v]挨饿; [or]tf_ibt;
hunger: [n/v]饥饿; [or]tf_ibt;
famish: [vt]使挨饿; [or]tf_ibt;
exhaust: [vt]使疲倦; [or]tf_ibt;
gorge: [vt]赛饱; [or]tf_ibt;

## 高兴 
hilarious: [adj]高兴的; [or]tf_ibt;
exultant: [adj]欢腾的;狂欢的; [or]tf_ibt;
brisk: [adj]活泼的,轻快的; [or]tf_ibt;
gleeful: [adj]极高兴的,兴奋的; [or]tf_ibt;
joyous: [adj]快乐的,高兴的; [or]tf_ibt;
exalted: [adj]兴奋的; [or]tf_ibt;
blessed: [adj]愉快的; [or]tf_ibt;
pleasing: [adj]愉快的; [or]tf_ibt;
pleasure: [n]快乐; [or]tf_ibt;
elation: [n]得意洋洋; [or]tf_ibt;
ecstasy: [n]恍惚;狂喜;灵魂出窍; [or]tf_ibt;
excitement: [n]激动,兴奋;刺激; [or]tf_ibt;
bliss: [n]狂喜; [or]tf_ibt;
rapture: [n]狂喜; [or]tf_ibt;
tingle: [vi](因兴奋)激动; [or]tf_ibt;
brighten: [vt]使快活; [or]tf_ibt;
enrapture: [vt]使狂喜; [or]tf_ibt;
ravish: [vt]使陶醉,使狂喜; [or]tf_ibt;

## 好奇 
curious: [adj]好奇的; [or]tf_ibt;
curiosity: [n]好奇心; [or]tf_ibt;
inquisitive: [adj]好奇的; [or]tf_ibt;

## 焦急 
concerned: [adj]焦虑的; [or]tf_ibt;
intense: [adj]紧张的; [or]tf_ibt;
suspense: [n]焦虑; [or]tf_ibt;
strain: [n]紧张; [or]tf_ibt;
fluster: [vt]使慌乱; [or]tf_ibt;
tense: [adj]紧张的; [or]tf_ibt;
abashed: [adj]羞愧的,局促不安的; [or]tf_ibt;

## 沮丧 
languid: [adj]精神不振的; [or]tf_ibt;
downcast: [adj]沮丧的; [or]tf_ibt;
dismal: [adj]沮丧的; [or]tf_ibt;
dejected: [adj]失望的,沮丧的; [or]tf_ibt;
depress: [vt]使沮丧; [or]tf_ibt;
depression: [n]沮丧; [or]tf_ibt;
dampen: [vt]使沮丧; [or]tf_ibt;
cheerless: [adj]不愉快的;阴郁的; [or]tf_ibt;

## 恐惧 
formidable: [adj]可怕的; [or]tf_ibt;
fright: [n]惊吓; [or]tf_ibt;
terror: [n]恐怖; [or]tf_ibt;
terrify: [vt]使惊吓; [or]tf_ibt;
panic: [n]恐慌; [or]tf_ibt;
horror: [n]恐惧; [or]tf_ibt;
dread: [n]畏惧 [v]畏惧; [or]tf_ibt;
cower: [vi]畏缩; [or]tf_ibt;
intimidate: [vt]恐吓; [or]tf_ibt;
menace: [vt]威吓;胁迫; [or]tf_ibt;

## 狂热 
insane: [adj]精神错乱的; [or]tf_ibt;
crazy: [adj]狂热的; [or]tf_ibt;
radical: [adj]激进的; [or]tf_ibt;
radically: [adv]激进地; [or]tf_ibt;
mania: [n]癫狂,狂热; [or]tf_ibt;
frenzy: [n]狂热; [or]tf_ibt;
fanatic: [adj]狂热的; [or]tf_ibt;
fanaticism: [adj]狂热;盲从; [or]tf_ibt;

## 满意 
relieved: [adj]放心的; [or]tf_ibt;
satisfactory: [adj]令人满意的; [or]tf_ibt;
content: [adj]满足的; [or]tf_ibt;
satiate: [vt]使满足,使饱享; [or]tf_ibt;
gratify: [vt]使满足; [or]tf_ibt;

## 梦想 
solicitous: [adj]渴望的;焦虑的; [or]tf_ibt;
desire: [vt]想要; [n]欲望; [or]tf_ibt;
desirous: [adj]渴望的; [or]tf_ibt;
desirable: [adj]理想的,如意的; [or]tf_ibt;
aspire: [vi]热望; [or]tf_ibt;
aspiration: [n]热望,渴望; [or]tf_ibt;
hunger: [n/v]渴望; [or]tf_ibt;
long: [vi]渴望; [or]tf_ibt;
crave: [vt]渴求; [or]tf_ibt;
realize: [vt]实现; [or]tf_ibt;
mean: [vt]意欲; [or]tf_ibt;
yen: [n/v]渴望; [or]tf_ibt;
court: [v]追求; [or]tf_ibt;

## 情感 
touching: [adj]动人的,令人感伤的; [or]tf_ibt;
impassive: [adj]无感情的; [or]tf_ibt;
cherish: [vt]珍爱; [or]tf_ibt;
affection: [n]友爱;爱情; [or]tf_ibt;
affectionate: [adj]挚爱的,亲切的; [or]tf_ibt;
emotional: [adj]情绪的,情感的; [or]tf_ibt;
nostalgia: [n]乡愁,怀旧; [or]tf_ibt;
sentimental: [adj]感伤的; [or]tf_ibt;
emotive: [adj]使感动的,动感情的; [or]tf_ibt;
lovelorn: [adj]失恋的; [or]tf_ibt;
passionate: [adj]多情的,热情的; [or]tf_ibt;

## 热情 
vigorous: [adj]朝气蓬勃的; [or]tf_ibt;
hospitable: [adj]好客的; [or]tf_ibt;
positive: [adj]积极的; [or]tf_ibt;
energetic: [adj]精力旺盛的; [or]tf_ibt;
ardor: [n]热心; [or]tf_ibt;
ardent: [adj]热情的; [or]tf_ibt;
eager: [adj]渴望的;热心的; [or]tf_ibt;
impassioned: [adj]热烈的; [or]tf_ibt;
avid: [adj]热切的; [or]tf_ibt;
devoted: [adj]热心的; [or]tf_ibt;
reality: [adv]愿意地; [or]tf_ibt;
enthusiasm: [n]热情; [or]tf_ibt;
zeal: [n]热心,热情; [or]tf_ibt;
zealous: [adj]热心的; [or]tf_ibt;
zest: [n]浓烈的兴趣; [or]tf_ibt;
hail: [vt]欢呼,欢迎; [or]tf_ibt;

## 态度 
jealous: [adj]嫉妒的;猜疑的; [or]tf_ibt;
indifferent: [adj]冷漠的;不积极的; [or]tf_ibt;
profane: [adj]亵渎的; [vt]亵渎; [or]tf_ibt;
flatter: [vt]奉承,阿臾,谄媚; [or]tf_ibt;
begrudge: [vt]羡慕,嫉妒; [or]tf_ibt;
desperate: [adj]绝望的;不顾一切的; [or]tf_ibt;
contrite: [adj]悔悟的; [or]tf_ibt;
forlorn: [adj]绝望的;被遗弃的; [or]tf_ibt;


## 犹豫 
dubious: [adj]怀疑的; [or]tf_ibt;
skeptical: [adj]怀疑的; [or]tf_ibt;
suspicion: [n]怀疑; [or]tf_ibt;
suspicious: [adj]可疑的,猜疑的; [or]tf_ibt;
fishy: [adj]值得怀疑的; [or]tf_ibt;
incredulity: [n]怀疑; [or]tf_ibt;
misgiving: [n]疑虑; [or]tf_ibt;
poise: [n]犹豫迟疑; [or]tf_ibt;
halt: [v]踌躇;停止; [or]tf_ibt;
scruple: [n/v]踌躇;顾忌; [or]tf_ibt;
flounder: [vi]踌躇; [or]tf_ibt;
demur: [vi]踌躇; [or]tf_ibt;
hesitate: [vi]犹豫;含糊; [or]tf_ibt;
doubt: [n/vt]怀疑; [or]tf_ibt;
suspect: [vt]怀疑; [or]tf_ibt;

## 憎恨 
loath: [adj]不喜欢的,不情愿的; [or]tf_ibt;
loathe: [vt]厌恶; [or]tf_ibt;
hideous: [adj]骇人听闻的;丑恶的; [or]tf_ibt;
sick: [adj]厌恶的; [or]tf_ibt;
complaint: [n]抱怨,怨言; [or]tf_ibt;
grievance: [n]不满; [or]tf_ibt;
aversion: [n]厌恶; [or]tf_ibt;
hatred: [n]憎恨; [or]tf_ibt;
disgust: [vt]厌恶; [or]tf_ibt;
grudge: [vt]怨恨;妒忌;勉强给予; [or]tf_ibt;
detest: [vt]憎恶; [or]tf_ibt;
resent: [vt]憎恶; [or]tf_ibt;
abhor: [vt]憎恶; [or]tf_ibt;
abhorrent: [adj]可恶的,可恨的; [or]tf_ibt;

# 32 行为; [or]tf_ibt;
## 帮助 
benevolent: [adj]; [or]tf_ibt;
munificent: [adj]; [or]tf_ibt;
charity: [adj]; [or]tf_ibt;
charitable: [adj]; [or]tf_ibt;
generous: [adj]; [or]tf_ibt;
generously: [adj]; [or]tf_ibt;
obliging: [adj]; [or]tf_ibt;
sympathetic: [adj]; [or]tf_ibt;
liberal: [adj]; [or]tf_ibt;
instrumental: [adj]; [or]tf_ibt;
gainful: [adj]; [or]tf_ibt;
benifit: [vt]; [or]tf_ibt;
beneficial: [vt]; [or]tf_ibt;
prop: [vt]; [or]tf_ibt;
redress: [vt]; [or]tf_ibt;
compassion: [vt]; [or]tf_ibt;
assist: [vt]; [or]tf_ibt;
extricate: [vt]; [or]tf_ibt;
donate: [vt]; [or]tf_ibt;
raise: [vt]; [or]tf_ibt;
bestow: [vt]; [or]tf_ibt;
rescue: [vt]; [or]tf_ibt;
champion: [vt]; [or]tf_ibt;
salvage: [vt]; [or]tf_ibt;
save: [vt]; [or]tf_ibt;
adopt: [vt]; [or]tf_ibt;

## 保护 
assert: [vt]维护; [or]tf_ibt;
preserve: [vt]保存; [or]tf_ibt;
retain: [vt]保留; [or]tf_ibt;
shield: [vt]保护; [or]tf_ibt;
defend: [vt]防护; [or]tf_ibt;
escort: [vt]护送; [or]tf_ibt;
convoy: [vt]护送; [or]tf_ibt;
safeguard: [vt]保卫,维护; [or]tf_ibt;

## 抽象行为 
behave: [v]举止端正; [or]tf_ibt;
behavior: [n]行为; [or]tf_ibt;
conduct: [v]行为; [or]tf_ibt;
deport: [vt]举止; [or]tf_ibt;
abstract: [adj]抽象的; [or]tf_ibt;
abstraction: [n]抽象概念; [or]tf_ibt;
action: [n/v]行动; [or]tf_ibt;

## 处理 
shift: [n/v]转移;替换; [or]tf_ibt;
dissipate: [vt]; [or]tf_ibt;
deal: [vt]; [or]tf_ibt;
dispose: [vt]; [or]tf_ibt;
bestow: [vt]; [or]tf_ibt;
exert: [vt]; [or]tf_ibt;
displace: [vt]; [or]tf_ibt;
tackle: [vt]; [or]tf_ibt;
transact: [vt]; [or]tf_ibt;
discard: [vt]; [or]tf_ibt;
utilize: [vt]; [or]tf_ibt;
harness: [vt]; [or]tf_ibt;
arrange: [vt]; [or]tf_ibt;
reject: [vt]; [or]tf_ibt;
cancel: [vt]取消; [or]tf_ibt;
undo: [vt]取消; [or]tf_ibt;
delete: [vt]删除; [or]tf_ibt;
contrive: [vt]设计; [or]tf_ibt;
implement: [vt]实现; [or]tf_ibt;
effectuate: [vt]使实现; [or]tf_ibt;
glean: [vt]收藏; [or]tf_ibt;
purge: [vt]消除; [or]tf_ibt;
erase: [vt]消除; [or]tf_ibt;
eradicate: [vt]根除; [or]tf_ibt;
efface: [vt]消除; [or]tf_ibt;
despatch: [vt]迅速处理; [or]tf_ibt;
forsake: [vt]抛弃,摒绝; [or]tf_ibt;
adopt: [vt]采用; [or]tf_ibt;
process: [vt]处理; [or]tf_ibt;
scrap: [vt]废弃; [or]tf_ibt;
abandon: [vt]抛弃,放弃; [or]tf_ibt;
jettison: [vt]抛弃,丢弃; [or]tf_ibt;

==kk1=====================; [or]tf_ibt;
## 促进 
impulsive: [adj]推动的; [or]tf_ibt;
hasten: [v]催促;赶紧; [or]tf_ibt;
urge: [v]推进;催促; [or]tf_ibt;
prod: [vt]刺激; [or]tf_ibt;
stimulate: [vt]刺激;激励; [or]tf_ibt;
promote: [vt]促进; [or]tf_ibt;
further: [vt]促进,增进; [or]tf_ibt;
elicit: [vt]得出,引出; [or]tf_ibt;
instigate: [vt]鼓励; [or]tf_ibt;
encourage: [vt]鼓励; [or]tf_ibt;
inspire: [vt]鼓舞,激发; [or]tf_ibt;
evoke: [vt]唤起; [or]tf_ibt;
arouse: [vt]唤起; [or]tf_ibt;
kindle: [vt]激起; [or]tf_ibt;
intensify: [vt]加强; [or]tf_ibt;
fortify: [vt]加强; [or]tf_ibt;
propel: [vt]推进,促进; [or]tf_ibt;
foment: [vt]引发; [or]tf_ibt;
incite: [vt]引起;激动;煽动; [or]tf_ibt;
impulse: [v]推动; [or]tf_ibt;
spur: [vt]刺激,鞭策; [or]tf_ibt;
prompt: [vt]鼓动; [or]tf_ibt;

## 得到 
due: [vt]应得的; [n]应得物; [or]tf_ibt;
attainment: [n] 成就; [or]tf_ibt;
gain: [v]得到; [or]tf_ibt;
obtain: [vt]得到; [or]tf_ibt;
seize: [vt]夺取,捕获; [or]tf_ibt;
redeem: [vt]取回,赎回; [or]tf_ibt;
procure: [vt]获得,取得; [or]tf_ibt;
acquire: [vt]获得; [or]tf_ibt;
acquisitive: [adj]可获得的; [or]tf_ibt;

## 躲避 
elude: [vt]躲避; [or]tf_ibt;
elusive: [adj]躲避的; [or]tf_ibt;
sly: [adj]躲躲闪闪的; [or]tf_ibt;
evade: [vt]逃避,回避; [or]tf_ibt;
evasive: [adj]逃避的,退位的; [or]tf_ibt;
evasion: [n]逃避; [or]tf_ibt;
escape: [v]避免;逃避; [or]tf_ibt;
shun: [vt]避开; [or]tf_ibt;
eschew: [vt]避开;远离; [or]tf_ibt;
avoid: [vt]避免,回避; [or]tf_ibt;
dodge: [vt]躲开;逃避责任; [or]tf_ibt;
avert: [vt]转移;避免; [or]tf_ibt;

## 反抗 
insubordinate: [adj]不服从的; [or]tf_ibt;
defiant: [adj]大胆反抗的; [or]tf_ibt;
opposed: [adj]反对的; [or]tf_ibt;
rebellion: [n]反抗; [or]tf_ibt;
resist: [v]抵抗; [or]tf_ibt;
demur: [vi]抗议; [or]tf_ibt;
traverse: [vt]反对; [or]tf_ibt;
defy: [vt]蔑视,反抗; [or]tf_ibt;

## 反叛 
outrageous: [adj]暴乱的; [or]tf_ibt;
turbulent: [n]骚动的,骚乱的; [or]tf_ibt;
riot: [n]暴乱,骚动; [or]tf_ibt;
defection: [n]背叛,缺陷; [or]tf_ibt;
uprising: [n]叛乱; [or]tf_ibt;
uproar: [n]骚动; [or]tf_ibt;
turmoil: [n]骚动,混乱; [or]tf_ibt;
treason: [n]通敌,叛国贼; [or]tf_ibt;
rebel: [vi]谋反; [or]tf_ibt;
rebellion: [n]造反,叛乱; [or]tf_ibt;
betray: [vt]背叛; [or]tf_ibt;
subvert: [vt]颠覆,推翻; [or]tf_ibt;
plot: [vt]密谋,策划; [or]tf_ibt;
overturn: [v]推翻,颠倒; [or]tf_ibt;

## 否定 
exclusion: [n]拒绝; [or]tf_ibt;
decline: [v]拒绝; [or]tf_ibt;
relinquish: [vt]放弃; [or]tf_ibt;
renounce: [vt]放弃,否认; [or]tf_ibt;
gainsay: [vt]否认; [or]tf_ibt;
deny: [vt]否认; [or]tf_ibt;
disclaim: [vt]否认; [or]tf_ibt;
reject: [vt]拒收; [or]tf_ibt;

## 服从 
submit: [vi]服从; [or]tf_ibt;
submissive: [adj]顺从的; [or]tf_ibt;
submission: [n]服从; [or]tf_ibt;
subjection: [n]服从; [or]tf_ibt;
obedience: [n]服从,顺从; [or]tf_ibt;
succumb: [vi]屈服; [or]tf_ibt;
enthrall: [vt]使服从; [or]tf_ibt;
defer: [vi]服从,屈服; [or]tf_ibt;

## 负面效果或行为  
lash: [v]鞭打; [or]tf_ibt;
sustain: [vt]遭受; [or]tf_ibt;
pervert: [vt]曲解;导入邪途; [or]tf_ibt;
coddle: [vt]娇养,溺爱; [or]tf_ibt;
entail: [vt]使负担,惹起; [or]tf_ibt;
inflict: [vt]使遭受(损伤,痛苦等); [or]tf_ibt;
distort: [vt]歪曲; [or]tf_ibt;
abuse: [vt]滥用; [or]tf_ibt;

## 改良 
correct: [vt]纠正; [adj]正确的; [or]tf_ibt;
innovation: [n]改革,革新; [or]tf_ibt;
modify: [vt]修改; [or]tf_ibt;
modification: [n]更改; [or]tf_ibt;
ornament: [n]装修,装饰; [or]tf_ibt;
coax: [vt]耐心调理; [or]tf_ibt;
gild: [vt]虚饰; [or]tf_ibt;
modulate: [vt]调整; [or]tf_ibt;
mend: [vt]改正;改进; [or]tf_ibt;
renovate: [vt]革新; [or]tf_ibt;
substantiate: [vt]加强; [or]tf_ibt;
strengthen: [v]加强,巩固; [or]tf_ibt;
reinforce: [vt]加强; [or]tf_ibt;
garnish: [vt]加装饰; [or]tf_ibt;
embellish: [vt]装饰; [or]tf_ibt;
embroider: [vt]装饰; [or]tf_ibt;
temper: [v]缓和; [or]tf_ibt;
adjust: [vt]调节; [or]tf_ibt;
refine: [vt]精炼; [or]tf_ibt;

## 干涉 
conciliatory: []善于调解的; [or]tf_ibt;
hurdle: [n]障碍; [or]tf_ibt;
barrier: [n]栅栏,屏障; [or]tf_ibt;
barricade: [n]障碍物; [or]tf_ibt;
obstacle: [n]障碍; [or]tf_ibt;
snag: [n]障碍; [or]tf_ibt;
forestall: [v]预先阻止; [or]tf_ibt;
intercede: [vi]调停,请求; [or]tf_ibt;
intercept: [vt]中途拦截;阻止; [or]tf_ibt;
intervene: [vi]干涉; [or]tf_ibt;
interface: [vi]干涉,干预;妨碍; [or]tf_ibt;
meddle: [vi]干预; [or]tf_ibt;
tamper: [vi]干预; [or]tf_ibt;
mediate: [vt]调停; [or]tf_ibt;
balk: [vt]妨碍; [or]tf_ibt;
hinder: [vt]妨碍; [or]tf_ibt;
hamper: [vt]妨碍; [or]tf_ibt;
handicap: [vt]妨碍;使不利; [or]tf_ibt;
incapacitate: [vt]使不能; [or]tf_ibt;
prevent: [vt]阻碍; [or]tf_ibt;
clog: [vt]阻碍; [or]tf_ibt;
stunt: [vt]阻碍; [or]tf_ibt;
encumber: [vt]阻碍; [or]tf_ibt;
obstruct: [vt]阻碍; [or]tf_ibt;
foil: [vt]阻止; [or]tf_ibt;
block: [vt]阻碍; [or]tf_ibt;

## 跟踪 
trace: [n]痕迹 [vt]跟踪,追溯; [or]tf_ibt;
vestige: [n]痕迹,遗迹; [or]tf_ibt;
stalk: [v]跟踪猎物; [or]tf_ibt;
entrap: [vt]以网或陷阱捕捉; [or]tf_ibt;

## 固定 
stationary: [adj]固定的; [or]tf_ibt;
immobile: [adj]固定的; [or]tf_ibt;
fix: [v]固定; [or]tf_ibt;
fixed: [adj]固定的; [or]tf_ibt;
solidly: [adv]牢固地; [or]tf_ibt;
locate: [vt]设置;使位于; [or]tf_ibt;
bear: [vt]支撑; [or]tf_ibt;
install: [vt]安装;设置; [or]tf_ibt;
set: [vt]放置 [adj]固定的; [or]tf_ibt;
sustain: [vt]支撑,维持; [or]tf_ibt;
brace: [vt]支持,使固定 [n]支撑物; [or]tf_ibt;

## 观察 
perceive: [vt]察觉到,看见; [or]tf_ibt;
perceptive: [adj]感觉敏锐的,观察入微的; [or]tf_ibt;
detect: [vt]探测,发觉; [or]tf_ibt;
detectable: [adj]可发觉的,可看穿的; [or]tf_ibt;
discernible: [adj]可觉察的; [or]tf_ibt;
inquiry: [n]调查研究; [or]tf_ibt;
onserve: [vt]看到; [or]tf_ibt;
observation: [n]观察; [or]tf_ibt;
perspective: [n]透视;观点; [or]tf_ibt;
insight: [n]洞察力,见识; [or]tf_ibt;
invesigate: [v]调查,研究; [or]tf_ibt;
pierce: [vt]洞察; [or]tf_ibt;
survey: [vt]调查;遵守; [or]tf_ibt;
scan: [vt]浏览,扫描; [or]tf_ibt;
skim: [vt]略读; [or]tf_ibt;
spot: [vt]认出; [or]tf_ibt;
identify: [vt]认出; [or]tf_ibt;
realize: [vt]认识到; [or]tf_ibt;
scrutinize: [vt]细察; [or]tf_ibt;
locate: [vt]找出; [or]tf_ibt;

## 坚持  
irreconcilable: [adj]不能妥协的; [or]tf_ibt;
indomitable: [adj]不屈不挠的; [or]tf_ibt;
sturdy: [adj]不屈的,顽强的; [or]tf_ibt;
obstinate: [adj]固执的; [or]tf_ibt;
bigoted: [adj]固执己见的; [or]tf_ibt;
persistent: [adj]坚持不懈的; [or]tf_ibt;
inflexible: [adj]坚定的; [or]tf_ibt;
steadfast: [adj]坚决的,不变的; [or]tf_ibt;
unshaken: [adj]坚决的,不动摇的; [or]tf_ibt;
durable: [adj]耐久的,耐用的; [or]tf_ibt;
tough: [adj]强硬的,坚韧的,粗暴的; [or]tf_ibt;
headstrong: [adj]顽固的; [or]tf_ibt;
stubborn: [adj]顽固的; [or]tf_ibt;
tenacious: [adj]抓住不放的,顽强的; [or]tf_ibt;
resolute: [adj]坚决的; [or]tf_ibt;
hardheaded: [adj]顽固的; [or]tf_ibt;
stoically: [adv]坚韧地; [or]tf_ibt;
fortitude: [n]坚忍,刚毅; [or]tf_ibt;
resist: [v]坚持; [or]tf_ibt;
remain: [vi]保持,逗留; [or]tf_ibt;
persevere: [vi]坚持,不屈不挠; [or]tf_ibt;
perseverance: [n]坚定不移; [or]tf_ibt;
maintain: [vt]坚持(认为); [or]tf_ibt;
insist: [vt]主张;坚持说; [or]tf_ibt;



## 揭示 
implicit: #adj.暗示的; [or]tf_ibt;
reflection: #n.反映; [or]tf_ibt;
expose: #vt.使暴露; [or]tf_ibt;
exposure: #n.曝光; [or]tf_ibt;
reveal: #vt.揭露;展现; [or]tf_ibt;
revelation: #n.显示; [or]tf_ibt;
unveil: #vt.显示; [or]tf_ibt;
show: #v.展示; [or]tf_ibt;
transpire: #vt.泄露; [or]tf_ibt;
profess: #vt.表示; [or]tf_ibt;
signify: #vt.表示,意味着; [or]tf_ibt;
bare: #vt.露出; [or]tf_ibt;
exhibit: #vt.显示; [or]tf_ibt;
leak: #vt.泄露; [or]tf_ibt;
divulge: #vt.泄露; [or]tf_ibt;
denote: #vt.指数;表示; [or]tf_ibt;
indicate: #vt.指示;表示; [or]tf_ibt;
betray: #vt.泄露; [or]tf_ibt;

## 控制 
irrepressible: #adj.不可压制的;难以征服的; [or]tf_ibt;
unruly: #adj.难控制的; [or]tf_ibt;
operate: #vt.操纵; [or]tf_ibt;
handle: #vt.操纵; [or]tf_ibt;

## 理解 
intelligible: #adj.可理解的; [or]tf_ibt;
evident: #adj.明白的; [or]tf_ibt;
explicit: #adj.明确的;清楚的; [or]tf_ibt;
elusive: #adj.难懂的; [or]tf_ibt;
mysterious: #adj.神秘的;难以理解的; [or]tf_ibt;
ignorant: #adj.无知的,不了解的; [or]tf_ibt;
ignorance: #n.无知; [or]tf_ibt;
grasp: #n/v.领会,理解; [or]tf_ibt;
comprehend: #vt.理解; [or]tf_ibt;
comprehensive: #adj.综合的;有理解力的; [or]tf_ibt;

## 掠夺 
rapacious: #adj.强夺的; [or]tf_ibt;
strip: #vt.剥,夺去; [or]tf_ibt;
bereave: #vt.剥夺; [or]tf_ibt;
loot: #vt.掠夺; [or]tf_ibt;
harry: #vt.掠夺;折磨; [or]tf_ibt;
ravage: #vt.掠夺; [or]tf_ibt;
grind: #vt.折磨;压榨; [or]tf_ibt;
torment: #vt.折磨; [or]tf_ibt;

## 迷惑 
equivocal: #adj.模棱两可的,意义不清的; [or]tf_ibt;
enigma: #n.迷; [or]tf_ibt;
enigmatic: #n.像迷般的,神秘的; [or]tf_ibt;
maze: #n.迷宫;迷惑; [or]tf_ibt;
labyrinth: #n.迷宫;错综复杂的事件; [or]tf_ibt;
riddle: #n.谜; [or]tf_ibt;
puzzle: #n.难题;谜 #v.使迷惑; [or]tf_ibt;
elude: #vt.困惑; [or]tf_ibt;
captivate: #vt.迷惑; [or]tf_ibt;
enthrall: #vt.迷惑; [or]tf_ibt;
bewilder: #vt.迷惑,把..弄糊弄; [or]tf_ibt;
perplex: #vt.迷惑,难住; [or]tf_ibt;
tangle: #vt.使纠缠,使纠结; [or]tf_ibt;
confound: #vt.使糊涂,迷惑; [or]tf_ibt;
entangle: #vt.使纠缠;使迷惑; [or]tf_ibt;
fascinate: #vt.使迷惑; [or]tf_ibt;
blur: #vt.使模糊; [or]tf_ibt;
dazzle: #vt.使目眩;使迷惑; [or]tf_ibt;

## 判断 
dogmatic: #adj.教条的;武断的; [or]tf_ibt;
illegible: #adj.难辨认的; [or]tf_ibt;
pending: #adj.未决的; [or]tf_ibt;
resolve: #vt.决定; [or]tf_ibt;
resolved: #adj.下定决心的; [or]tf_ibt;
determine: #vt.决定; [or]tf_ibt;
determination: #n.决定;决心; [or]tf_ibt;
discretion: #n.判断力; [or]tf_ibt;
decide: #v.决定; [or]tf_ibt;
deem: #v.认为; [or]tf_ibt;
vindicate: #vt.辨明; [or]tf_ibt;
discern: #vt.辨明; [or]tf_ibt;
assert: #vt.断言,宣称; [or]tf_ibt;
conclude: #vt.推断出,断定; [or]tf_ibt;
affirm: #vt.断言; [or]tf_ibt;

## 破坏 
breakdown: #n.奔溃,倒塌;失败; [or]tf_ibt;
collapse: #n/v.倒塌,崩溃; [or]tf_ibt;
breach: #n.破裂; [or]tf_ibt;
shatter: #n.碎片; #v.粉碎; [or]tf_ibt;
scrap: #n.碎片;废料; [or]tf_ibt;
fragment: #n.碎片,破片; [or]tf_ibt;
fracture: #n/v.断裂; [or]tf_ibt;
rupture: #n/v.破裂,决裂; [or]tf_ibt;
crumble: #v.粉碎,奔溃; [or]tf_ibt;
squash: #v.压碎; [or]tf_ibt;
crash: #v.撞碎; [or]tf_ibt;
ravage: #vt.破坏; [or]tf_ibt;
raze: #vt.摧毁; [or]tf_ibt;
demolish: #vt.破坏; [or]tf_ibt;
disfigure: #vt.破坏; [or]tf_ibt;
frustrate: #vt.破坏;挫败; [or]tf_ibt;
smash: #vt.破碎; [or]tf_ibt;
devastate: #vt.使荒废;破坏; [or]tf_ibt;
devastation: #n.毁坏; [or]tf_ibt;
disrupt: #vt.使中断,使分裂; [or]tf_ibt;
mangle: #vt.撕裂,毁坏; [or]tf_ibt;
spoil: #vt.宠坏;糟蹋; [or]tf_ibt;
engulf: #vt.吞没;吞食; [or]tf_ibt;
devour: #vt.吞食;毁灭; [or]tf_ibt;
crumple: #vt.压皱; [or]tf_ibt;
crush: #vt.榨,挤,压碎; [or]tf_ibt;
disintegration: #n.瓦解; [or]tf_ibt;
rift: #n.裂缝,裂口; [or]tf_ibt;
ruins: #vt.毁灭,废墟,遗迹; [or]tf_ibt;

## 强迫 
compulsive: #adj.强迫的; [or]tf_ibt;
pressure: #n.压迫; [or]tf_ibt;
tease: #vt.强求; [or]tf_ibt;
compel: #vt.强迫; [or]tf_ibt;
constrain: #vt.强迫; [or]tf_ibt;
accelerate: #vt.迫使; [or]tf_ibt;

## 勤奋 
laborious: #adj.勤劳的; [or]tf_ibt;
industrious: #adj.勤勉的; [or]tf_ibt;
assiduous: #adj.勤勉的; [or]tf_ibt;
diligent: #adj.勤勉的,勤奋的; [or]tf_ibt;
serious: #adj.认真的; [or]tf_ibt;
cordial: #adj.真诚的,诚恳的; [or]tf_ibt;
deliberate: #adj.认真的;故意的; [or]tf_ibt;
attempt: #n.努力,尝试 #v.尝试; [or]tf_ibt;
effort: #n.努力,成就; [or]tf_ibt;
endeavor: #vi.努力; [or]tf_ibt;
strive: #vi.努力,奋斗;力求; [or]tf_ibt;

## 忍受 
reluctant: #adj.不情愿的; [or]tf_ibt;
tolerate: #vt.忍受;宽恕; [or]tf_ibt;
tolerable: #adj.可容忍的; [or]tf_ibt;
insufferable: #adj.难以忍受的; [or]tf_ibt;
undergo: #vt.经历,忍受; [or]tf_ibt;
stand: #vt.忍受; [or]tf_ibt;
endure: #vt.忍受,容忍; [or]tf_ibt;
abide: #vt.忍受; [or]tf_ibt;

## 认可 
permit: #vt.允许; [or]tf_ibt;
permissible: #adj.可容许的; [or]tf_ibt;
permissive: #adj.许可的; [or]tf_ibt;
tacit: #adj.心照不宣的,默许的; [or]tf_ibt;
reception: #n.接受; [or]tf_ibt;
connive: #vi.纵容,默许; [or]tf_ibt;
conivance: #n.默许; [or]tf_ibt;
concede: #vi.让步;承认; [or]tf_ibt;
concession: #n.让步,迁就; [or]tf_ibt;
recognize: #vt.认出;承认; [or]tf_ibt;
recognition: #n.认识;承认; [or]tf_ibt;
nod: #n/v.点头,首肯; [or]tf_ibt;
confess: #v.忏悔,坦白; [or]tf_ibt;
approve: #v.赞成;批准; [or]tf_ibt;
comply: #vi.顺从,应允; [or]tf_ibt;
concur: #vi.同一; [or]tf_ibt;
avow: #vt.公开承认; [or]tf_ibt;
ratify: #vt.批准; [or]tf_ibt;
guarantee: #vt.确保; [or]tf_ibt;
endorse: #vt.确认;赞同,支持; [or]tf_ibt;
corroborate: #vt.确证; [or]tf_ibt;
grant: #vt.准予; [or]tf_ibt;
admit: #vt.承认; [or]tf_ibt;
acknowledge: #vt.承认; [or]tf_ibt;
affirm: #vt.批准; [or]tf_ibt;
pardon: #vt.原谅,宽恕; [or]tf_ibt;

## 失误 
innocent: #adj.幼稚的; [or]tf_ibt;
regardless: #adv.不管,不顾; [or]tf_ibt;
heedless: #adj.不留心的; [or]tf_ibt;
erroneous: #adj.错误的; [or]tf_ibt;
neglect: #vt.疏忽;忘记; [or]tf_ibt;
negligent: #adj.忽略的; [or]tf_ibt;
negligence: #n.过失;疏忽; [or]tf_ibt;
slovenly: #adj.马虎的; [or]tf_ibt;
credulous: #adj.轻信的; [or]tf_ibt;
useless: #adj.无效的; [or]tf_ibt;
futile: #adj.无益的;徒劳的; [or]tf_ibt;
offhand: #adj.无准备的; [or]tf_ibt;
fallible: #adj.易错的; [or]tf_ibt;
defect: #n.缺陷; [or]tf_ibt;
defective: #adj.有缺陷的; [or]tf_ibt;
drawback: #n.弊端; [or]tf_ibt;
flaw: #n.缺点;瑕疵; [or]tf_ibt;
oblivion: #n.忘却,遗忘; [or]tf_ibt;
blunder: #v.犯大错; [or]tf_ibt;
expire: #vi.失效; [or]tf_ibt;
overlook: #vt.忽略,疏忽; [or]tf_ibt;
ignore: #vt.忽视; [or]tf_ibt;
omit: #vt.省略;遗漏; [or]tf_ibt;
absurd: #adj.荒谬的; [or]tf_ibt;
abortive: #adj.失败的; [or]tf_ibt;
err: #vi.犯错; [or]tf_ibt;

## 思考 
consider: #vt.考虑; [or]tf_ibt;
considerate: #adj.考虑周到的; [or]tf_ibt;
meditative: #adj.深思的; [or]tf_ibt;
tender: #adj.细心的;考虑周到的; [or]tf_ibt;
conscious: #adj.有意识的; [or]tf_ibt;
recollection: #n.记起,回想; [or]tf_ibt;
ruminate: #v.沉思; [or]tf_ibt;
speculate: #v.推测;沉思; [or]tf_ibt;
ponder: #vt.考虑 #vi.沉思; [or]tf_ibt;
embalm: #vt.铭记; [or]tf_ibt;
contemplate: #vt.凝视;沉思; [or]tf_ibt;
elevate : #vt.提高(思想); [or]tf_ibt;
recall: #vt.忆起,记忆; [or]tf_ibt;
haunt: #vt.萦绕于心; [or]tf_ibt;

## 探索 
venture: #n/vi.冒险,冒昧; [or]tf_ibt;
risk: #n/vt.冒险; [or]tf_ibt;
probe: #v.探查; [or]tf_ibt;
explore: #v.探险,探索; [or]tf_ibt;
seek: #v.寻找,探求; [or]tf_ibt;
grope: #vi.摸索; [or]tf_ibt;
ferret: #vt.搜索; [or]tf_ibt;

## 拖延 
tardy: #adj.延迟的; [or]tf_ibt;
perpetuate: #vt.使..永恒,使..延续; [or]tf_ibt;
detain: #vt.使延迟; [or]tf_ibt;
delay: #vt.推迟,延误; [or]tf_ibt;
prolong: #vt.拖长,延长; [or]tf_ibt;
protract: #vt.延长; [or]tf_ibt;
retard: #vt.延迟; [or]tf_ibt;
postpone: #vt.延搁; [or]tf_ibt;
defer: #vt.延期; [or]tf_ibt;
adjourn: #vt.延期; [or]tf_ibt;

## 习惯 
inclined: #adj.倾向..的; [or]tf_ibt;
prone: #n.倾向于; [or]tf_ibt;
habitually: #adv.习惯地; [or]tf_ibt;
bent: #n.爱好;倾向; [or]tf_ibt;
aptitude: #n.自然倾向; [or]tf_ibt;
propensity: #n.倾向; [or]tf_ibt;
trend: #n.倾向;趋势; [or]tf_ibt;
penchant: #n.倾向;爱好; [or]tf_ibt;
custom: #n.习惯; [or]tf_ibt;
accustomed: #adj.习惯的; [or]tf_ibt;
interest: #n.兴趣; [or]tf_ibt;
tend: #vi.趋向,往往是; [or]tf_ibt;
inure: #vt.使习惯; [or]tf_ibt;

## 限制 
temperance: #n.节制,自制;戒酒; [or]tf_ibt;
bondage: #n.束缚; [or]tf_ibt;
deterrent: #n.威慑物,制止物; [or]tf_ibt;
neutralize: #v.压制; [or]tf_ibt;
check: #v.抑制; [or]tf_ibt;
circumscribe: #vt.划界限;限制; [or]tf_ibt;
shackle: #vt.加桎梏,束缚; [or]tf_ibt;
fetter: #vt.束缚,羁绊; [or]tf_ibt;
restrict: #vt.限制; [or]tf_ibt;
restrain: #vt.限制; [or]tf_ibt;
confine: #vt.限制; [or]tf_ibt;
quell: #vt.压制; [or]tf_ibt;
curb: #vt.抑制; [or]tf_ibt;
bound: #n.限制; [or]tf_ibt;
leash: #n/v.束缚; [or]tf_ibt;

## 学习 
literate: #adj.有文化的; [or]tf_ibt;
chalk: #n.粉笔,白垩 #vt.用粉笔写; [or]tf_ibt;
transcript: #n.成绩单; [or]tf_ibt;
scholarship: #n.奖学金; [or]tf_ibt;
article: #n.文章,论文; [or]tf_ibt;
ken: #n.视野,知识; [or]tf_ibt;
stationery: #n.文具; [or]tf_ibt;
brochure: #n.小册子; [or]tf_ibt;
pamphlet: #n.小册子; [or]tf_ibt;
credit: #n.学分; [or]tf_ibt;
semester: #n.学期; [or]tf_ibt;
thesis: #n.学位论文; [or]tf_ibt;
discourse: #n.演讲,论文; [or]tf_ibt;
margin: #n.页边的空白,栏外; [or]tf_ibt;
term: #n.学期;专用名词; [or]tf_ibt;
discipline: #v.训练;守纪律 #n.学科; [or]tf_ibt;
commence: #vi.获得学位; [or]tf_ibt;
cram: #vt.仓促用功; [or]tf_ibt;
academic: #adj.学院的;理论的; [or]tf_ibt;

## 遗留 
heredity: #n.遗传; [or]tf_ibt;
heritage: #n.遗产; [or]tf_ibt;
bequest: #n.遗产; [or]tf_ibt;
legacy: #n.遗产; [or]tf_ibt;
relic: #n.遗迹,废墟,纪念物; [or]tf_ibt;
remains: #n.遗迹,遗体; [or]tf_ibt;

## 运动 
stray: #adj.漂泊的;走失的; [or]tf_ibt;
roam: #n/v.漫步; [or]tf_ibt;
stalk: #v.阔步; [or]tf_ibt;
rumble: #v.隆隆行驶; [or]tf_ibt;
scale: #n/v.攀登; [or]tf_ibt;
ascend: #v.攀登,登高; [or]tf_ibt;
budge: #v.移动; [or]tf_ibt;
locomote: #vi.移动,行动; [or]tf_ibt;
traverse: #vt.走过; [or]tf_ibt;
stroll: #vt.漫步; [or]tf_ibt;
insinuate: #vt.迂回进入; [or]tf_ibt;
zigzag: #n.Z字形,锯齿形,蜿蜒曲折; [or]tf_ibt;
motion: #v.运动,动作 #v.运动; [or]tf_ibt;

## 战胜 
unquenchable: #adj.不可熄灭的,不能遏制的; [or]tf_ibt;
lag: #n/vi.落后; [or]tf_ibt;
subjection: #n.征服; [or]tf_ibt;
overcome: #v.战胜;胜过; [or]tf_ibt;
surpass: #vt.超过,超越; [or]tf_ibt;
transcend: #vt.超越; [or]tf_ibt;
surmount: #vt.克服;登上;越过; [or]tf_ibt;
precede: #vt.先于 #vi.领先; [or]tf_ibt;
vanquish: #vt.征服,克服; [or]tf_ibt;

# 33 语言; [or]tf_ibt;
## 诽谤 
injurious: [adj]侮辱,诽谤的;有害的; [or]tf_ibt;
asperse: [vt]诽谤; [or]tf_ibt;
aspersion: [n]诽谤; [or]tf_ibt;
indignity: [n]诽谤; [or]tf_ibt;
malign: [vt]诋毁,诽谤; [or]tf_ibt;
defame: [vt]诽谤,损毁名誉; [or]tf_ibt;
disparage: [vt]轻视,毁谤; [or]tf_ibt;
humiliate: [vt]使屈辱,贬抑; [or]tf_ibt;
slander: [n/vt]造谣,诽谤; [or]tf_ibt;
insult: [n/vt]侮辱,凌辱; [or]tf_ibt;

## 讽刺 
satirical: [adj]讽刺的; [or]tf_ibt;
sardonic: [adj]讽刺的,嘲笑的; [or]tf_ibt;
sarcastic: [adj]讽刺的,挖苦的; [or]tf_ibt;
sarcasm: [n]讽刺,挖苦; [or]tf_ibt;
cynical: [adj]讽刺的,冷嘲热讽的; [or]tf_ibt;
mock: [n]嘲弄 [vt]嘲弄,挖苦; [or]tf_ibt;
taunt: [n/vt]嘲笑; [or]tf_ibt;
jeer: [vi]揶揄,嘲笑; [or]tf_ibt;
flout: [vt]嘲弄; [or]tf_ibt;
sneer: [vt]嘲笑; [or]tf_ibt;
deride: [vt]嘲笑,愚弄; [or]tf_ibt;
gibe: [n/vt]讥笑; [or]tf_ibt;

## 呼喊 
clamor: [n]叫嚣; [or]tf_ibt;
exclaim: [v]呼喊;惊叫; [or]tf_ibt;
exhale: [vt]呼出;发出;散发; [or]tf_ibt;
howl: [vt]咆哮; [or]tf_ibt;
acclaim: [v]喝彩,欢呼;称赞; [or]tf_ibt;

## 建议 
counsel: [vt]劝告; [n]商议,忠告; [or]tf_ibt;
propose: [v]提出; [or]tf_ibt;
proposal: [n]提案,建议; [or]tf_ibt;
recommend: [vt]劝告;推荐; [or]tf_ibt;
remind: [vt]提醒; [or]tf_ibt;
suggest: [vt]提议;暗示; [or]tf_ibt;
mention: [vt]主张;提及; [or]tf_ibt;
advice: [n]建议,忠告; [or]tf_ibt;
advise: [vt]告知;劝告; [or]tf_ibt;
advance: [vt]提出; [or]tf_ibt;
submit: [vt]提交; [or]tf_ibt;

## 交流 
reciprocal: [adj]相互的;交往的; [or]tf_ibt;
correspondence: [n]通信; [or]tf_ibt;
liaison: [n]联络; [or]tf_ibt;
propagate: [vt]宣传; [or]tf_ibt;
communicate: [vt]传达; [vi]通信;交流; [or]tf_ibt;
impart: [vt]给予;传递;告诉; [or]tf_ibt;
remit: [vt]汇寄; [or]tf_ibt;
consort: [vt]结交; [or]tf_ibt;
disseminate: [vt]散布,传播; [or]tf_ibt;
tip: [vt]接触; [or]tf_ibt;

## 夸大 
bombastic: [adj]夸大的; [or]tf_ibt;
pretentious: [adj]装腔作势的; [or]tf_ibt;
boast: [vt]吹嘘; [vi]自夸; [or]tf_ibt;
boastful: [adj]自夸的; [or]tf_ibt;
vanity: [n]虚荣心; [or]tf_ibt;
conceit: [n]自负,自高自大; [or]tf_ibt;
exaggerate: [v]夸大,夸张; [or]tf_ibt;
brag: [vt]夸张; [or]tf_ibt;

## 命令 
imperative: [adj]命令的; [or]tf_ibt;
bidding: [n]命令; [or]tf_ibt;
prescription: [n]指示; [or]tf_ibt;
rally: [n/v]召集; [or]tf_ibt;
disband: [v]解散; [or]tf_ibt;
distribute: [vt]分发; [or]tf_ibt;
assign: [vt]分配,指派; [or]tf_ibt;
instruct: [vt]命令; [or]tf_ibt;
expedite: [vt]派出; [or]tf_ibt;
dispatch: [vt]派遣;分配; [or]tf_ibt;
nominate: [vt]任命; [or]tf_ibt;
evacuate: [vt]疏散; [or]tf_ibt;
summon: [vt]召唤; [or]tf_ibt;
destine: [vt]指定; [or]tf_ibt;
designate: [vt]指定;指派; [or]tf_ibt;
monitor: [v]监控; [or]tf_ibt;
accredit: [v]委任;任命; [or]tf_ibt;

## 批评 
culpable: [adj]该受谴责的; [or]tf_ibt;
critical: [adj]评论的,批评的; [or]tf_ibt;
censure: [n/vt]责难; [or]tf_ibt;
reproach: [v]责备; [or]tf_ibt;
chide: [vt]斥责; [or]tf_ibt;
decry: [vt]非难,谴责; [or]tf_ibt;
deprecate: [vt]抗议,抨击; [or]tf_ibt;
castigate: [vt]谴责; [or]tf_ibt;
denounce: [vt]谴责,声讨; [or]tf_ibt;
condemn: [vt]谴责; [or]tf_ibt;
berate: [vt]痛骂; [or]tf_ibt;
rap: [vt]责难; [or]tf_ibt;
rebuke: [n/vt]斥责; [or]tf_ibt;
blame: [n/vt]谴责; [or]tf_ibt;
repudiate: [vt]批判; [or]tf_ibt;

## 说话 
hoarse: [adj]声音嘶哑的; [or]tf_ibt;
colloquial: [adj]会话的,口语的; [or]tf_ibt;
dumb: [adj]哑的,无言的; [or]tf_ibt;
hubbub: [n]嘈杂; [or]tf_ibt;
dialogue: [n]对话; [or]tf_ibt;
nonsense: [n]胡说; [or]tf_ibt;
excuse: [n]借口; [or]tf_ibt;
compliment: [n]问候; [or]tf_ibt;
gossip: [n]闲话; [or]tf_ibt;
oration: [n]演说; [or]tf_ibt;
hearsay: [n]谣传; [or]tf_ibt;
rumble: [v]低沉地说; [or]tf_ibt;
gabble: [v]急促而不清楚的说; [or]tf_ibt;
solicit: [v]恳求; [or]tf_ibt;
declaim: [v]朗诵;演讲; [or]tf_ibt;
confide: [v]倾诉; [or]tf_ibt;
refre: [v]提到; [or]tf_ibt;
chat: [n/v]闲谈; [or]tf_ibt;
grumble: [vi]喃喃诉苦; [or]tf_ibt;
equivocate: [vi]支支吾吾,说模棱两可的话; [or]tf_ibt;
coax: [vt]哄; [or]tf_ibt;
outwit: [vt]哄骗; [or]tf_ibt;
effuse: [vt]流出;散步; [or]tf_ibt;
accost: [vt]向人搭话; [or]tf_ibt;

## 说明 
account: [n]描述; [or]tf_ibt;
exposition: [n]展览;说明,阐明; [or]tf_ibt;
enunciate: [v]阐明;清晰发音; [or]tf_ibt;
narrate: [v]叙述; [or]tf_ibt;
insinuate: [vt]暗示; [or]tf_ibt;
cover: [vt]报道; [or]tf_ibt;
convey: [vt]表达; [or]tf_ibt;
illuminate: [vt]说明; [or]tf_ibt;
render: [vt]表达; [or]tf_ibt;
elucidate: [vt]阐明,说明; [or]tf_ibt;
clarify: [vt]澄清,阐明; [or]tf_ibt;
expound: [vt]解释; [or]tf_ibt;
construe: [vt]解释;翻译; [or]tf_ibt;
delineate: [vt]刻画;记述; [or]tf_ibt;
exemplify: [vt]例证; [or]tf_ibt;
depict: [vt]描写,叙述; [or]tf_ibt;
emphasize: [vt]强调,着重; [or]tf_ibt;
illustrate: [vt]说明; [or]tf_ibt;
highlight: [vt]突出显示;强调; [or]tf_ibt;
specify: [vt]详述; [or]tf_ibt;
elaborate: [vt]详细阐述; [or]tf_ibt;
divulge: [vt]宣布; [or]tf_ibt;
proclaim: [vt]宣布,声明; [or]tf_ibt;
cite: [vt]引用;举例; [or]tf_ibt;
reiterate: [vt]重述; [or]tf_ibt;
accentuate: [vt]重读;强调; [or]tf_ibt;

## 协商 
uniform: [adj]统一的,一致的; [or]tf_ibt;
unanimity: [n]全体一致; [or]tf_ibt;
reconcile: [vt]和解; [or]tf_ibt;
reconciliation: [n]和解; [or]tf_ibt;
convention: [n]协定;会议; [or]tf_ibt;
pact: [n]协定; [or]tf_ibt;
consult: [v]商量;请教; [or]tf_ibt;
negotiate: [v]谈判,交涉; [or]tf_ibt;
confer: [v]协商; [or]tf_ibt;
placate: [vt]安抚; [or]tf_ibt;

## 争论 
eloquent: [adj]雄辩的,有口才的; [or]tf_ibt;
eloquence: [n]雄辩; [or]tf_ibt;
debate: [n/vi]争论,辩论; [or]tf_ibt;
debatable: [adj]争论中的,未决定的; [or]tf_ibt;
squabble: [n]口角,争论; [or]tf_ibt;
dispute: [n/vi]争论,辩论; [or]tf_ibt;
retort: [v]反驳; [or]tf_ibt;
brawl: [n/vi]争吵; [or]tf_ibt;
bicker: [vi]争论; [or]tf_ibt;
haggle: [v]争论; [or]tf_ibt;
gainsay: [vt]反驳; [or]tf_ibt;
refute: [vt]反驳,驳倒; [or]tf_ibt;
disprove: [vt]反驳,证明]]有误; [or]tf_ibt;
controvert: [vt]反驳;辩论; [or]tf_ibt;
controversy: [n]争论; [or]tf_ibt;
controversial: [adj]引起争论的; [or]tf_ibt;
contradict: [vt]反驳;抵触; [or]tf_ibt;
contradictory: [adj]矛盾的,反驳的; [or]tf_ibt;
contravene: [vt]反对;违反; [or]tf_ibt;


# 34 属性; [or]tf_ibt;
## 安静 
sedate: [adj]安静的; [or]tf_ibt;
tranquil: [adj]安静的; [or]tf_ibt;
placid: [adj]安静的; [or]tf_ibt;
static: [adj]静的; [or]tf_ibt;
serene: [adj]平静的;沉静的; [or]tf_ibt;
serenity: [n]安静;从容; [or]tf_ibt;
still: [adj]静止的; [or]tf_ibt;
lull: [vt]使平静; [or]tf_ibt;

## 肮脏 
disgraced: [adj]不光彩的;丢人的; [or]tf_ibt;
dingy: [adj]肮脏的; [or]tf_ibt;
messy: [adj]凌乱的; [or]tf_ibt;
slovenly: [adj]不洁的; [or]tf_ibt;
frowzy: [adj]不整洁的;臭的; [or]tf_ibt;
obscene: [adj]猥亵的; [or]tf_ibt;
indecent: [adj]淫猥的; [or]tf_ibt;
impure: [vt]脏的,不纯洁的; [or]tf_ibt;
blemish: [n/vt]玷污; [or]tf_ibt;
smear: [vt]弄脏; [or]tf_ibt;
defile: [vt]弄污; [or]tf_ibt;
spot: [vt]玷污 [n]污点; [or]tf_ibt;

## 不合适 
incompetent: [adj]不称职的; [or]tf_ibt;
unbecoming: [adj]不配的,不适当的; [or]tf_ibt;
inept: [adj]不适宜的; [or]tf_ibt;
unseemly: [adj]不适宜的; [or]tf_ibt;
ineligible: [adj]无资格的;不适当的; [or]tf_ibt;
impropriety: [n]不适当; [or]tf_ibt;

## 程度 
fervent: [adj]自然的;强烈的; [or]tf_ibt;
rough: [adj]大致的; [or]tf_ibt;
roughly: [adv]概略地;粗糙地; [or]tf_ibt;
intensive: [adj]密集的;加强的; [or]tf_ibt;
exorbitant: [adj]过分的;过度的; [or]tf_ibt;
probable: [adj]很可能的,大概; [or]tf_ibt;
violent: [adj]激烈的; [or]tf_ibt;
drastic: [adj]激烈的; [or]tf_ibt;
dead: [adv]安全地; [or]tf_ibt;
deadly: [adj]极度的; [or]tf_ibt;
sharp: [adj]极剧的; [or]tf_ibt;
categorical: [adj]绝对的,无条件的; [or]tf_ibt;
impetuous: [adj]猛烈的; [or]tf_ibt;
vehemence: [adj]猛烈的;激烈的; [or]tf_ibt;
burning: [adj]强烈的; [or]tf_ibt;
complete: [adj]完全的 [vt]完成; [or]tf_ibt;
completely: [adv]十分,完全地; [or]tf_ibt;
inordinate: [adj]无节制的;过度的; [or]tf_ibt;
considerable: [adj]相当的; [or]tf_ibt;
substantial: [adj]相当的; [or]tf_ibt;
grossly: [adv]非常; [or]tf_ibt;
extremely: [adv]极端地,非常地; [or]tf_ibt;
nearly: [adv]几乎; [or]tf_ibt;
virtuelly: [adv]几乎; [or]tf_ibt;
hardly: [adv]几乎不; [or]tf_ibt;
barely: [adv]仅仅; [or]tf_ibt;
profoundly: [adj]; [or]tf_ibt;
clean: [adv]安全地; [or]tf_ibt;
entirely: [adv]完全地; [or]tf_ibt;
utterly: [adv]完全地;彻底地; [or]tf_ibt;
somewhat: [adv]有点; [or]tf_ibt;
fairly: [adv]相当地; [or]tf_ibt;
absolute: [adj]绝对的; [or]tf_ibt;
radical: [adj]根本的,基本的;激进的; [or]tf_ibt;

## 纯 
sheer: [adj]纯粹的;全然的; [or]tf_ibt;
pure: [adj]纯洁的; [or]tf_ibt;
unblemished: [adj]洁白的,无瑕的; [or]tf_ibt;
innocent: [adj]清白的; [or]tf_ibt;
impeccable: [adj] 无瑕的; [or]tf_ibt;
perfect: [adj]完好无损的; [or]tf_ibt;
virtuous: [adj]贞洁的; [or]tf_ibt;
chaste: [adj]贞洁的;纯正的; [or]tf_ibt;

## 大 
colossal: [adj]巨大的; [or]tf_ibt;
spacious: [adj]广大的;宽敞的; [or]tf_ibt;
expansive: [adj]广阔的;可扩张的,可膨胀的; [or]tf_ibt;
prodigious: [adj]巨大的; [or]tf_ibt;
massive: [adj]巨大的; [or]tf_ibt;
enormous: [adj]巨大的; [or]tf_ibt;
mighty: [adj]巨大的; [or]tf_ibt;
vast: [adj]巨大的,大量的; [or]tf_ibt;
tremendous: [adj]巨大的,惊人的; [or]tf_ibt;
immense: [adj]巨大的;无限的; [or]tf_ibt;
titanic: [adj]巨大有力的; [or]tf_ibt;
commodious: [adj]宽敞的; [or]tf_ibt;
broad: [adj]宽的;广泛的; [or]tf_ibt;
loose: [adj]宽松的; [or]tf_ibt;
bulky: [adj]庞大的;笨重的; [or]tf_ibt;
capacious: [adj]容量大的;宽敞的; [or]tf_ibt;

## 方位 
forth: [adv]向前; [or]tf_ibt;
entry: [n]入口;进入; [or]tf_ibt;
exit: [n]出口; [or]tf_ibt;
outlet: [n]出路,出口; [or]tf_ibt;
site: [n]地点; [or]tf_ibt;
destination: [n]目的地; [or]tf_ibt;
veer: [v]改变方向; [or]tf_ibt;
spot: [n]地点; [or]tf_ibt;
head: [vi]向某处走去; [or]tf_ibt;

## 公正 
valid: [adj]正当的; [or]tf_ibt;
upright: [adj]正直的; [or]tf_ibt;
unfair: [adj]不公平的; [or]tf_ibt;
fairly: [adj]公正的; [or]tf_ibt;
guileless: [adj]诚实的; [or]tf_ibt;
equitable: [adj]公平的; [or]tf_ibt;
detached: [adj]公正的; [or]tf_ibt;
disinterested: [adj]公正的; [or]tf_ibt;
unbiased: [adj]公正的; [or]tf_ibt;
partially: [adv]不公正地; [or]tf_ibt;
impartial: [adj]公正的; [or]tf_ibt;
conscience: [n]良心,良知; [or]tf_ibt;
conscientious: [adj]尽职的; [or]tf_ibt;
incorruptible: [adj]廉洁的; [or]tf_ibt;
descent: [adj]正派的;体面的; [or]tf_ibt;
faithful: [adj]忠诚的; [or]tf_ibt;
justly: [adv]公正地; [or]tf_ibt;
devotion: [n]献身;忠诚;专心; [or]tf_ibt;
integrity: [n]正直; [or]tf_ibt;
probity: [n]正直; [or]tf_ibt;
fidelity: [n]忠诚; [or]tf_ibt;
dedicate: [vt]奉献,致力于; [or]tf_ibt;

## 合适 
sober: [adj]适度的; [or]tf_ibt;
qualified: [adj]合格的; [or]tf_ibt;
rational: [adj]合理的; [or]tf_ibt;
becoming: [adj]合适的,相称的; [or]tf_ibt;
reliable: [adj]可靠的,可信赖的; [or]tf_ibt;
preferable: [adj]可取的; [or]tf_ibt;
available: [adj]可用的; [or]tf_ibt;
competent: [adj]能胜任的; [or]tf_ibt;
fit: [adj]适合的; [or]tf_ibt;
fitting: [adj]适当的;得体的; [or]tf_ibt;
feasible: [adj]切实可行的; [or]tf_ibt;
expedient: [adj]权宜的;方便的; [or]tf_ibt;
pertinent: [adj]适当的;切题的; [or]tf_ibt;
temperate: [adj]适度的,有节制的; [or]tf_ibt;
suitable: [adj]适合的; [or]tf_ibt;
plausible: [adj]似合理的; [or]tf_ibt;
methodical: [adj]有条理的; [or]tf_ibt;
entitled: [adj]有资格的; [or]tf_ibt;
correspondence: [n]对应;符合; [or]tf_ibt;
propriety: [n]适当; [or]tf_ibt;
tally: [vi]符合; [or]tf_ibt;
coincide: [vi]使符合,相巧合; [or]tf_ibt;
suit: [vt]适应; [or]tf_ibt;
advisable: [adj]合理的; [or]tf_ibt;
adapt: [vt]使适应; [or]tf_ibt;
adaptable: [adj]能适应的; [or]tf_ibt;
adaptation: [n]适应; [or]tf_ibt;
conformity: [n]一致;符合; [or]tf_ibt;

## 尖刻 
incisive: [adj]尖锐的; [or]tf_ibt;
caustic: [adj]刻薄的; [or]tf_ibt;
acid: [adj]尖酸的; [or]tf_ibt;
acrimonious: [adj]尖酸的; [or]tf_ibt;
acrid: [adj]辛辣的; [or]tf_ibt;
acrimony: [n]刻薄; [or]tf_ibt;

## 精巧 
cunning: [adj]可爱的; [or]tf_ibt;
elegant: [adj](举止,服饰)优雅的; [or]tf_ibt;
handy: [adj]方便的;灵巧的; [or]tf_ibt;
ingenious: [adj]机灵的;精巧制成的; [or]tf_ibt;
exquisite: [adj]精美的; [or]tf_ibt;
delicate: [adj]精巧的; [or]tf_ibt;
refined: [adj]精致的;文雅的; [or]tf_ibt;
dexterous: [adj]灵巧的; [or]tf_ibt;
crafty: [adj]灵巧的,巧妙的; [or]tf_ibt;
elaborate: [vt]精心制作(计划); [adj]精心构思的; [or]tf_ibt;

## 距离 
remote: [adj]遥远的;远程的; [or]tf_ibt;
distant: [adj]远的; [or]tf_ibt;
gap: [n]差距; [or]tf_ibt;
proximity: [n]临近; [or]tf_ibt;
distribute: [vt]分布; [or]tf_ibt;
adjacent: [adj]临近的; [or]tf_ibt;
access: [vt]接近; [or]tf_ibt;
adjoin: [vt]贴近;毗连; [or]tf_ibt;
adjoining: [adj]接近的,邻接的; [or]tf_ibt;

## 肯定 
infallible: [adj]必然的;不会错的; [or]tf_ibt;
inevitable: [adj]不可避免的,必然的; [or]tf_ibt;
definite: [adj]明确的,肯定的; [or]tf_ibt;
confident: [adj]自信的;确信的; [or]tf_ibt;
undoubtedly: [adv]毋庸置疑的,的确; [or]tf_ibt;
ascertain: [vt]确定;探知; [or]tf_ibt;

## 空 
null: [adj]空的 ; [or]tf_ibt;
empty: [adj] 空的; [or]tf_ibt;
vacant: [adj] 空的;未被占用的; [or]tf_ibt;
void: [adj] 空的; [n]空间; [or]tf_ibt;
cacuum: [n] 真空; [or]tf_ibt;
evacuate: [vt]使]]空; [or]tf_ibt;
bare: [adj]空的; [or]tf_ibt;

## 明显 
sensible: [adj]明显的,感觉得到的; [or]tf_ibt;
imposing: [adj]令人难忘的; [or]tf_ibt;
obvious: [adj]明显的; [or]tf_ibt;
pronounced: [adj]明显的; [or]tf_ibt;
sharp: [adj]明显的,清晰的; [or]tf_ibt;
outstanding: [adj]显著的; [or]tf_ibt;
emphatic: [adj]显著的;强调的;有力的; [or]tf_ibt;
remarkable: [adj]值得注意到; [or]tf_ibt;
impressively: [adv]令人难忘地; [or]tf_ibt;
markedly: [adv]显著地,明显地; [or]tf_ibt;
especially: [adv]由其; [or]tf_ibt;

## 普遍 
routine: [adj]常规的; [or]tf_ibt;
extensive: [adj]大量的;广泛的; [or]tf_ibt;
mediocre: [adj]平常的,普通的; [or]tf_ibt;
hackneyed: [adj]平凡的; [or]tf_ibt;
universal: [adj]普遍的; [or]tf_ibt;
catholic: [adj]普遍的;广泛的; [or]tf_ibt;
general: [adj]普通的; [or]tf_ibt;
generally: [adv]广泛地,一般地; [or]tf_ibt;
exhaustive: [adj]无遗漏的,彻底的,广泛的; [or]tf_ibt;
average: [adj]一般的; [or]tf_ibt;
mostly: [adv]多半地;通常; [or]tf_ibt;
usually: [adv]通常,大抵; [or]tf_ibt;
commonplace: [n]平凡事 [adj]平凡的; [or]tf_ibt;

## 事物属性 
tender: [adj]嫩的; [or]tf_ibt;
concrete: [adj]具体的; [or]tf_ibt;
portable: [adj]可携带的; [or]tf_ibt;
sloopy: [adj]泥泞的; [or]tf_ibt;
congested: [adj]拥挤的; [or]tf_ibt;

## 数量 
fraught: [adj]充满的; [or]tf_ibt;
sole: [adj]唯一的; [or]tf_ibt;
solitary: [adj]单一的; [or]tf_ibt;
quantity: [adj]量,数量; [or]tf_ibt;
quantitative: [adj]定量的; [or]tf_ibt;
excess: [adj]过度的 [n]过度; [or]tf_ibt;
excessive: [adj]过多的,极度的; [or]tf_ibt;
redundant: [adj]过多的,冗长的; [or]tf_ibt;
sporadic: [adj]零星的; [or]tf_ibt;
numerous: [adj]众多的; [or]tf_ibt;
innumerable: [adj]无数的; [or]tf_ibt;
countless: [adj]无数的; [or]tf_ibt;
sufficient: [adj]足够的,充分的; [or]tf_ibt;
skimpy: [adj]太少的; [or]tf_ibt;
sparsely: [adv]稀少地,稀疏地; [or]tf_ibt;
bulk: [adv]大批; [or]tf_ibt;
majority: [n]多数,大多数; [or]tf_ibt;
block: [n]一块(木或石头); [or]tf_ibt;
multitude: [n]众多; [or]tf_ibt;
sum: [n]总数; [or]tf_ibt;
teem: [vi]充满; [or]tf_ibt;
pervade: [vt]遍布;弥漫; [or]tf_ibt;
suffuse: [vt]充满; [or]tf_ibt;
abundant: [adj]充裕的; [or]tf_ibt;
further: [adj]更多的; [or]tf_ibt;
adequate: [adj]足够的; [or]tf_ibt;
spare: [adj]多余的,剩余的; [or]tf_ibt;
times: [adj]时期,次; [or]tf_ibt;
total: [adj]总数,合计; [or]tf_ibt;
volume: [n]量,大量; [or]tf_ibt;

## 特殊 
original: [adj]独创的; [or]tf_ibt;
unique: [adj]独一无二的; [or]tf_ibt;
extraordinary: [adj]非凡的,特别的; [or]tf_ibt;
erratic: [adj]古怪的; [or]tf_ibt;
eccentric: [adj]古怪的; [or]tf_ibt;
bizarre: [adj]古怪的; [or]tf_ibt;
queer: [adj]奇怪的,古怪的; [or]tf_ibt;
quaint: [adj]奇异的,不凡的; [or]tf_ibt;
given: [adj]特定的; [or]tf_ibt;
particularly: [adv]独特地,显著地; [or]tf_ibt;
abnormal: [adj]异常的; [or]tf_ibt;
odd: [adj]古怪的; [or]tf_ibt;
weird: [adj]怪异的,超自然的; [or]tf_ibt;
sensitive: [adj]敏感的; [or]tf_ibt;
idiosyncrasy: [adj]个人特性; [or]tf_ibt;
trait: [adj]特点,特性; [or]tf_ibt;
character: [性格]; [or]tf_ibt;
characteristic: [n]特征,特性 [adj]特有的,典型的; [or]tf_ibt;
bear: [vt]具有,带有; [or]tf_ibt;

## 危险 
destructive: [adj]破坏性的,危害的; [or]tf_ibt;
critical: [adj]危急的;临界点; [or]tf_ibt;
perilous: [adj]危险的; [or]tf_ibt;
hazard: [n]危险; [or]tf_ibt;
hazardous: [adj]危险的; [or]tf_ibt;
dangerous: [adj]危险的; [or]tf_ibt;
endanger: [vt]危害; [or]tf_ibt;
harmful: [adj]有害的; [or]tf_ibt;
deleterious: [adj]有害的; [or]tf_ibt;
detriment: [n]损害; [or]tf_ibt;
peril: [n]危机;危险的事物; [or]tf_ibt;
jeopardy: [n]危险; [or]tf_ibt;
injure: [vt]伤害,损害,损伤; [or]tf_ibt;
maim: [vt]使残废;损伤; [or]tf_ibt;
impair: [vt]损害; [or]tf_ibt;
threaten: [v]威胁; [or]tf_ibt;

## 味道 
balmy : [adj] 芳香的; [or]tf_ibt;
delicious: [adj]美味的 ; [or]tf_ibt;
palatable: [adj]味美的 ; [or]tf_ibt;
fragrant: [adj]香的,芬芳的 ; [or]tf_ibt;
pungent: [n] 辛辣的; [or]tf_ibt;
odor: [n] 臭气; [or]tf_ibt;
taste: [n]味道; [or]tf_ibt;
aura: [n]气味 ; [or]tf_ibt;
flavor: [n]风味 ; [or]tf_ibt;
aroma: [n]香气,芬芳 ; [or]tf_ibt;
smell: [v]发出气味 ; [or]tf_ibt;
stink: [vi]发出臭味 ; [or]tf_ibt;
savor: [vt]尝试 ; [or]tf_ibt;
acid: [n]酸; [adj]酸的 ; [or]tf_ibt;

## 物理属性 
hectic: [adj]发热的; [or]tf_ibt;
impervious: [adj]不能渗透的; [or]tf_ibt;
ponderous: [adj]沉重的,笨重的; [or]tf_ibt;
crisp: [adj]脆的;卷曲的; [or]tf_ibt;
lofty: [adj]高耸的; [or]tf_ibt;
slippery: [adj]滑的; [or]tf_ibt;
dense: [adj]密集的; [or]tf_ibt;
crooked: [adj]扭曲的; [or]tf_ibt;
shallow: [adj]浅的; [or]tf_ibt;
ethereal: [adj]轻的,天上的; [or]tf_ibt;
lithe: [adj]柔软的;易弯的; [or]tf_ibt;
sloppy: [adj]稀薄的; [or]tf_ibt;
slim: [adj]细长的,苗条的; [or]tf_ibt;
tenuous: [adj]细的;稀薄的; [or]tf_ibt;
compact: [adj]压缩的;密集的; [or]tf_ibt;
supple: [adj]柔软的;易曲的; [or]tf_ibt;
malleable: [adj]有延展性的;可锻造的; [or]tf_ibt;
depression: [n]凹陷; [or]tf_ibt;

## 小 
faint: [adj]微弱的; [or]tf_ibt;
ignoble: [adj]卑微的; [or]tf_ibt;
minuscule: [adj]极小的; [or]tf_ibt;
negligible: [adj]可以忽略的,不予重视的; [or]tf_ibt;
slight: [adj]轻微的,微小的; [or]tf_ibt;
trivial: [adj]微不足道的; [or]tf_ibt;
feeble: [adj]微弱的; [or]tf_ibt;
trifling: [adj]微小的; [or]tf_ibt;
minute: [adj]微小的; [or]tf_ibt;
insular: [adj]狭隘的; [or]tf_ibt;
diminutive: [adj]小的; [or]tf_ibt;
tiny: [adj]小的,极小的; [or]tf_ibt;
fine: [adj]细微的; [or]tf_ibt;

## 虚幻 
mythical: [adj]神话的,虚构的; [or]tf_ibt;
fictitious: [adj]虚构的; [or]tf_ibt;
imaginary: [adj]虚构的; [or]tf_ibt;
illusion: [n]幻觉; [or]tf_ibt;
fantasy: [n]幻想,空想;怪念头; [or]tf_ibt;
superstition: [n]迷信; [or]tf_ibt;
panacea: [n]万灵药; [or]tf_ibt;
figment: [n]虚构之事; [or]tf_ibt;
conceive: [v]想象; [or]tf_ibt;
occult: [adj]神秘的,不可思议的; [or]tf_ibt;

## 需要 
gratuitous: [adj]不需要的; [or]tf_ibt;
indispensable: [adj]不可缺少的,绝对必要的; [or]tf_ibt;
imperative: [adj]急需的; [or]tf_ibt;

## 真实 
tangible: [adj]可见的,确实的; [or]tf_ibt;
authentic: [adj]可靠,有根据的,真实的; [or]tf_ibt;
genuine: [adj]真实的,真正的; [or]tf_ibt;
truly: [adv]真实的; [or]tf_ibt;
actual: [adj]实际的,现行的,真实的; [or]tf_ibt;

## 重要 
superb: [adj]超级的; [or]tf_ibt;
pivot: [n]转折点,关键; [or]tf_ibt;
pivotal: [adj]关键的;枢纽的; [or]tf_ibt;
foremost: [adj]第一流的; [or]tf_ibt;
elementary: [adj]基本的,初级的; [or]tf_ibt;
fundamental: [adj]基础的,基本的; [or]tf_ibt;
momentous: [adj]极重要的; [or]tf_ibt;
vital: [adj]极重要的; [or]tf_ibt;
cardinal: [adj]首要的,基本的; [or]tf_ibt;
crucial: [adj]严重的;极重要的; [or]tf_ibt;
significant: [adj]有意义的;重要的; [or]tf_ibt;
dominant: [adj]占优势的,主导的; [or]tf_ibt;
predominate: [vt]占优势,支配; [or]tf_ibt;
predominantly: [adv]占主导地位地,显著地; [or]tf_ibt;
fateful: [adj]重大的; [or]tf_ibt;
primary: [adj]重要的; [or]tf_ibt;
primarily: [adv]首先,主要地; [or]tf_ibt;
essential: [adj]重要的;基本的;必需的; [or]tf_ibt;
key: [adj]主要的,关键的; [or]tf_ibt;
optimum: [adj]最优先的; [or]tf_ibt;
leading: [adj]最主要的; [or]tf_ibt;
chiefly: [adv]主要地,多半地; [or]tf_ibt;
largely: [adv]主要地,很大程度上; [or]tf_ibt;
sum: [n]要点; [or]tf_ibt;
preference: [n]优先;优先权; [or]tf_ibt;
forte: [n]长处; [or]tf_ibt;
elite: [n]精华; [or]tf_ibt;
gist: [n]要旨; [or]tf_ibt;
merit: [n]优点; [or]tf_ibt;
motif: [n]主题;主旨; [or]tf_ibt;
tenor: [adj]要旨;幺姨; [or]tf_ibt;
principal: [adj]重要的; [or]tf_ibt;
major: [adj]主要的; [or]tf_ibt;
sole: [adj]唯一的; [or]tf_ibt;

## 壮丽 
glorious: [adj]壮丽的; [or]tf_ibt;
splendid: [adj]灿烂的,辉煌的; [or]tf_ibt;
splendor: [n]光彩,壮丽; [or]tf_ibt;
grand: [adj]盛大的,壮丽的; [or]tf_ibt;
gorgeous: [adj]绚丽的; [or]tf_ibt;
radiant: [adj]绚丽的;容光焕发的; [or]tf_ibt;
spectacular: [adj]引人入胜的,壮观的; [or]tf_ibt;
solemn: [adj]庄严的;隆重的; [or]tf_ibt;
superb: [adj]壮丽的; [or]tf_ibt;
magnificent : [adj]壮丽的,华丽的; [or]tf_ibt;

# 35 状态; [or]tf_ibt;
## 变化 
diverse: [adj]不同的; [or]tf_ibt;
diversity: [vt]使多样化; [or]tf_ibt;
fickle: [adj]多变的; [or]tf_ibt;
manifold: [adj]多样的;多方面的; [or]tf_ibt;
lavish: [adj]丰富的; [or]tf_ibt;
profuse: [adj]极其丰富的; [or]tf_ibt;
vary: [vt]改变; [or]tf_ibt;
variation: [n]变化; [or]tf_ibt;
variant: [adj]不同的; [or]tf_ibt;
mutation: [n]变化; [or]tf_ibt;
transition: [n]转变;过渡; [or]tf_ibt;
transform: [vt]变换; [or]tf_ibt;
enrich: [vt]丰富; [or]tf_ibt;
convert: [vt]转换; [or]tf_ibt;
copious: [adj]丰富的; [or]tf_ibt;

## 冲突 
hostile: [adj]敌对的,不友好的; [or]tf_ibt;
diverge: [vt]分歧;差异; [or]tf_ibt;
divergent: [adj]分叉的;分歧的; [or]tf_ibt;
belligerent: [adj]好战的; [or]tf_ibt;
repulsive: [adj]排斥的; [or]tf_ibt;
offensive: [adj]无礼的;攻击性的; [or]tf_ibt;
strife: [n]冲突; [or]tf_ibt;
feud: [n]世仇 [vi]不合; [or]tf_ibt;
struggle: [n/vi]竞争;奋斗; [or]tf_ibt;
strike: [v] 打击; [or]tf_ibt;
contend: [v]奋斗; [or]tf_ibt;
compete: [vi]竞争; [or]tf_ibt;
frown: [vi]皱眉;反对; [or]tf_ibt;
parallel: [vt]匹敌; [or]tf_ibt;
tantalize: [vt]使]]着急; [or]tf_ibt;
rival: [vt]竞争;匹敌; [or]tf_ibt;
assail: [vt]猛击;决然面对; [or]tf_ibt;
fulminate: [vi]猛烈爆发; [or]tf_ibt;
baste: [vt]殴打;公开责骂; [or]tf_ibt;
repulse: [vt]排斥; [or]tf_ibt;
repel: [vt]排斥; [or]tf_ibt;
emulate: [vt]努力赶上或超过; [or]tf_ibt;
punch: [vt]重击; [or]tf_ibt;
thump: [vt]重击; [or]tf_ibt;
adverse: [adj]敌对的;不利的; [or]tf_ibt;
impact: [v]冲击; [or]tf_ibt;
admonish: [vt]警告; [or]tf_ibt;


## 穿透 
stab: [n/v]刺;戳; [or]tf_ibt;
sheathe: [vt]将刀剑入鞘; [or]tf_ibt;
insert: [vt]插入; [or]tf_ibt;
pierce: [vt]穿透; [or]tf_ibt;
transfix: [vt]刺穿; [or]tf_ibt;
impale: [vt]刺穿; [or]tf_ibt;
penetrate: [vt]刺穿;进入; [or]tf_ibt;
interject: [vt]突然插入; [or]tf_ibt;
punch: [vt]打孔; [or]tf_ibt;

## 发展 
successful: [adj]成功的; [or]tf_ibt;
incipient: [adj]初期的; [or]tf_ibt;
initiate: [vt]开始;创始; [or]tf_ibt;
initial: [adj]初始的; [or]tf_ibt;
foremost: [adj]最初的; [or]tf_ibt;
original: [adj]最初的; [or]tf_ibt;
originally: [adv]本来;最初; [or]tf_ibt;
primary: [adj]最初的; [or]tf_ibt;
eventual: [adj]最后的; [or]tf_ibt;
ultimate: [adj]最后的; [or]tf_ibt;
final: [adj]最后的; [or]tf_ibt;
progress: [n/v]前进;发展; [or]tf_ibt;
triumph: [n]成功; [or]tf_ibt;
culmination: [n]顶点; [or]tf_ibt;
peak: [n]高峰;尖端; [or]tf_ibt;
phase: [n]阶段; [or]tf_ibt;
condition: [n]条件;状况; [or]tf_ibt;
status: [n]状况; [or]tf_ibt;
result : [n]结果; [or]tf_ibt;
headway: [n]进展; [or]tf_ibt;
onset: [n]开始; [or]tf_ibt;
halt: [v]停止; [or]tf_ibt;
develop: [v]发展;产生;成长; [or]tf_ibt;
resume: [v]继续; [or]tf_ibt;
exit : [v]退出; [or]tf_ibt;
climax: [v]使达到高潮 [n]高峰;顶点; [or]tf_ibt;
emerge: [vi]出现; [or]tf_ibt;
proceed: [vi]进行; [or]tf_ibt;
commence: [vi]开始; [or]tf_ibt;
vanish: [vi]消失; [or]tf_ibt;
launch: [vt]发动; [or]tf_ibt;
engender: [vt]产生; [or]tf_ibt;
beget: [vt]引起;产生; [or]tf_ibt;
generate: [vt]造成; [or]tf_ibt;
terminate: [vt]终止; [or]tf_ibt;
accomplished: [adj]完成的; [or]tf_ibt;
conclude: [vi]结束; [or]tf_ibt;
conclusive: [adj]决定性的;最后的; [or]tf_ibt;
advance: [vt]使前进;提出; [or]tf_ibt;
achieve: [vt]完成;实现;达到; [or]tf_ibt;


## 分离 
detach: [vt]分开;离开; [or]tf_ibt;
detached: [adj]分离的; [or]tf_ibt;
solitude: [n]与外界隔绝; [or]tf_ibt;
sever: [vt]分开;断绝; [or]tf_ibt;
rend: [vt]分离; [or]tf_ibt;
segregate: [vt]隔离,分离; [or]tf_ibt;
disunite: [vt]使分离; [or]tf_ibt;
scatter: [vt]使分散; [or]tf_ibt;

## 缓和 
cushion: [vt]缓解 [n]垫子; [or]tf_ibt;
soothe: [v]安慰;缓和;减轻; [or]tf_ibt;
relax: [vt]放松;松弛; [or]tf_ibt;
placate: [vt]安抚; [or]tf_ibt;
console: [vt]安慰; [or]tf_ibt;
assuage: [vt]缓和; [or]tf_ibt;
mollify: [vt]缓和; [or]tf_ibt;
mitigate: [vt]缓和;减轻; [or]tf_ibt;
slacken: [vt]使松弛; [or]tf_ibt;
pacify: [vt]镇定;抚慰; [or]tf_ibt;


## 恢复 
rally: [n/v]恢复; [or]tf_ibt;
revive: [v]复兴;复苏; [or]tf_ibt;
revert: [v]回复; [or]tf_ibt;
retract: [v]收回;撤回; [or]tf_ibt;
retrieve: [v]重新找回; [or]tf_ibt;
energize: [vt]供能;使活跃; [or]tf_ibt;
restore: [vt]恢复; [or]tf_ibt;
rehabilitate: [vt]恢复; [or]tf_ibt;
recover: [vt]恢复; [or]tf_ibt;
revoke: [vt]取消; [or]tf_ibt;
refresh: [vt]使清新 [vi]恢复精神; [or]tf_ibt;

## 混乱 
intricate: [adj]错综复杂的;难懂的 ; [or]tf_ibt;
complex: [adj]复杂的 [n]综合体; [or]tf_ibt;
disarray: [n/vt]杂乱;混乱; [or]tf_ibt;
confuse: [vt]混淆; [or]tf_ibt;
jumble: [v]混杂; [or]tf_ibt;
shuffle: [vt]搅乱;混合; [or]tf_ibt;
complicate: [vt]使复杂;使陷入; [or]tf_ibt;
befuddle: [vt]使混乱; [or]tf_ibt;
muddle: [vt]使混乱; [or]tf_ibt;

## 聚集 
assemble: [vt]聚集; [or]tf_ibt;
assembly: [n]集会; [or]tf_ibt;
party: [n]团体;一伙; [or]tf_ibt;
association: [n]协会; [or]tf_ibt;
gather: [v]聚集;集合; [or]tf_ibt;
attend: [vt]参加; [or]tf_ibt;
convene: [vt]集合; [or]tf_ibt;
congregate: [vt]聚集; [or]tf_ibt;
accompany: [vt]伴随; [or]tf_ibt;

## 扩大 
sprawl: [v]蔓延 [n]扩展; [or]tf_ibt;
broaden: [v]放宽; [or]tf_ibt;
swell: [v]膨胀; [or]tf_ibt;
expand: [vi]扩张; [or]tf_ibt;
dilate: [vt]使膨胀;使扩大; [or]tf_ibt;
augment: [vt]增大;增加; [or]tf_ibt;


## 粘附 
stick: [vi]粘住; [or]tf_ibt;
sticky: [adj]粘连的; [or]tf_ibt;
attachment: [n]连接物,附件; [or]tf_ibt;
cohere: [vi]附着; [or]tf_ibt;
cling: [vi]粘附; [or]tf_ibt;
adhere: [vi]粘着;坚持; [or]tf_ibt;
adherent: [adj]依附的; [n]追随者;信徒; [or]tf_ibt;

## 频率 
constant: [adj]不变的;持续的; [or]tf_ibt;
incessant: [adj]不断的; [or]tf_ibt;
coherent: [adj]连贯的; [or]tf_ibt;
]incoherent: [adj]不连贯的; [or]tf_ibt;
ceaseless: [adj]不停的; [or]tf_ibt;
speedy: [adj]迅速的; [or]tf_ibt;
swift: [adj]快速的; [or]tf_ibt;
successive: [adj]连续的; [or]tf_ibt;
consecutive: [adj]连续的; [or]tf_ibt;
prompt: [adj]迅速的; [or]tf_ibt;
fitful: [adj]一阵阵的,断断续续的; [or]tf_ibt;
continually: [adv]不断地; [or]tf_ibt;
gradually: [adv]逐渐地; [or]tf_ibt;
haunt: [vt]常到; [or]tf_ibt;
frequency: [n]频率;周率;发生次数; [or]tf_ibt;

## 缺乏 
insufficient: [adj]不足的;不够的; [or]tf_ibt;
scanty: [adj]贫乏的; [or]tf_ibt;
meager: [adj]贫乏的;不足的; [or]tf_ibt;
needy: [adj]贫穷的; [or]tf_ibt;
stingy: [adj]缺乏的; [or]tf_ibt;
devoid: [adj]缺乏的; [or]tf_ibt;
scarce: [adj]缺乏的;不足的; [or]tf_ibt;
forfeit: [vt]丧失 [adj]丧失了的; [or]tf_ibt;

## 衰弱 
degenerate: [adj]堕落的 [vi]退步; [or]tf_ibt;
decadence: [n]衰落;颓废; [or]tf_ibt;
decline: [v]衰落; [or]tf_ibt;
languish: [vi]变衰弱; [or]tf_ibt;
ebb: [vi]衰退; [or]tf_ibt;
flag: [vi]衰退;减弱; [or]tf_ibt;
deplete: [vt]耗尽,使衰弱; [or]tf_ibt;
degrade: [vt]使]]降级;使堕落; [or]tf_ibt;
enervate: [vt]使衰弱; [or]tf_ibt;

## 随机 
informal: [adj]不拘礼节的;随便的; [or]tf_ibt;
indefinite: [adj]不明确的;不定的; [or]tf_ibt;
casual: [adj]非正式的;随便的; [or]tf_ibt;
potential: [adj]可能的;潜在的; [or]tf_ibt;
contingent: [adj]可能发生的; [or]tf_ibt;
dispensable: [adj]可有可无的; [or]tf_ibt;
occasional: [adj]偶然的; [or]tf_ibt;
fortuitously: [adv]偶然地;以外地; [or]tf_ibt;
haphazard: [adj]偶然的;随便的; [or]tf_ibt;
random: [adj]任意的;随便的; [or]tf_ibt;
doubtful: [adj]未确定的;不可靠的; [or]tf_ibt;
lottery: [n]碰巧之事; [or]tf_ibt;
accidental: [adj]偶然的; [or]tf_ibt;


## 缩减 
constrict: [v]使收紧;压缩; [or]tf_ibt;
dwindle: [vi]减少; [or]tf_ibt;
detract: [vi]去掉;减损; [or]tf_ibt;
contract: [vi]收缩; [or]tf_ibt;
reduce: [vt]减少;简化; [or]tf_ibt;
diminish: [vt]减少;缩小; [or]tf_ibt;
curtail: [vt]缩减; [or]tf_ibt;
indent: [vt]缩进(用于排版); [or]tf_ibt;
subtraction: [n]减少; [or]tf_ibt;

## 稳定性 
erratic: [adj]不稳定的; [or]tf_ibt;
stable: [adj]稳定的; [or]tf_ibt;
unstable: [adj]不稳定的;不牢固的; [or]tf_ibt;
steady: [adj]稳固的; [vt]使]]稳定; [or]tf_ibt;
steadily: [adv]稳定地; 有规则地; [or]tf_ibt;
poise: [n]平衡;稳定; [or]tf_ibt;

## 物理属性变化 
ascent: [n]上升; [or]tf_ibt;
descent: [n]下降; [or]tf_ibt;
extend: [v]扩充,延伸; [or]tf_ibt;
extension: [n]延伸; [or]tf_ibt;
hike: [v]上升; [or]tf_ibt;
hoist: [v]升起 [n]起重机; [or]tf_ibt;
stretch: [v]伸展,伸长; [or]tf_ibt;
transform: [vt]明显地改变]]的外观或形状; [or]tf_ibt;
deform: [vt]使变形; [or]tf_ibt;
elevate: [vt]抬高; [or]tf_ibt;
sharpen: [vt]削尖; [or]tf_ibt;
enhance: [vt]增加; [or]tf_ibt;
abate: [v]减少; [or]tf_ibt;
accumulate: [vt]积累; [or]tf_ibt;
amplify: [vt]放大;增强; [or]tf_ibt;
amplification: [n]扩大; [or]tf_ibt;

## 物理状态  
stuffy: [adj]闷热的;不通风的; [or]tf_ibt;
tilted: [adj]倾斜的; [or]tf_ibt;
regularly: [adv]有规律地;整齐地; [or]tf_ibt;
coil: [v]卷;盘绕; [n]盘绕; [or]tf_ibt;
slope: [vt]使倾斜; [n]斜面; [or]tf_ibt;
slant: [vt]使倾斜; [n]斜面; [or]tf_ibt;
protrude: [v]使]]突出; [or]tf_ibt;
rotate: [v]使]]旋转; [or]tf_ibt;
roll: [v]滚动; [or]tf_ibt;
dangle: [v]悬挂; [or]tf_ibt;
project: [v]凸出;投射; [or]tf_ibt;
encompass: [vt]包围,环绕;包含; [or]tf_ibt;
active: [adj]活跃的;活动的; [or]tf_ibt;
hump: [vi]隆起; [or]tf_ibt;
tower: [vi]屹立,高耸; [or]tf_ibt;
spin: [v]旋转; [or]tf_ibt;
concave: [adj]凹的; [n]凹,凹面; [or]tf_ibt;
convex: [adj]凸起的,表面弯曲如球的; [or]tf_ibt;
pitch: [n]程度;斜度; [or]tf_ibt;

## 吸引 
glamor: [n]; [or]tf_ibt;
glamorous: [adj]; [or]tf_ibt;
catching: [adj]; [or]tf_ibt;
engross: [vt]; [or]tf_ibt;
engrossed: [adj]全神贯注的; [or]tf_ibt;
attractive: [adj]有魅力的,吸引人的; [or]tf_ibt;
conspicuous: [adj]引人瞩目的的; [or]tf_ibt;
inviting: [adj]诱人的,引人注目的; [or]tf_ibt;
bait: [n]诱饵; [or]tf_ibt;
charisma: []魅力;感召力; [or]tf_ibt;
draw: [v]吸引,拉; [or]tf_ibt;
enrapture: [vt]使出神; [or]tf_ibt;
induce: [vt]导致,诱使; [or]tf_ibt;
intoxicate: [vt]使陶醉; [or]tf_ibt;
lure: [vt]诱使; [or]tf_ibt;
entice: [vt]诱惑; [or]tf_ibt;
tempt: [vt]诱使; [or]tf_ibt;
addict: [vt]对]]有瘾; [or]tf_ibt;
addicted: [adj]上瘾的; [or]tf_ibt;
absorb: [vt]吸收;吸引; [or]tf_ibt;
absorbing: [adj]引人入胜的; [or]tf_ibt;
 ; [or]tf_ibt;
## 虚弱 
delicate: [adj]脆弱的; [or]tf_ibt;
pitiful: [adj]可怜的; [or]tf_ibt;
fragile: [adj]脆的; [or]tf_ibt;
emaciate: [vt]使瘦弱; [or]tf_ibt;
emaciated: [adj]瘦弱的;憔悴的; [or]tf_ibt;
flimsy: [adj]脆弱的;薄弱的; [or]tf_ibt;
fragmentary: [adj]碎片的;不连续的; [or]tf_ibt;
frail: [adj]虚弱的;脆弱的; [or]tf_ibt;
brittle: [adj]易碎的; [or]tf_ibt;
slender: [adj]苗条的;微弱的; [or]tf_ibt;
impotentce: [n]无力;虚弱; [or]tf_ibt;
limp: [adj]柔软的;无力的; [or]tf_ibt;

## 隐藏 
cryptic: [adj]神秘的,隐藏的; [or]tf_ibt;
secluded: [adj]隐蔽的,隐退的; [or]tf_ibt;
seclusion: [n]归隐;隔离; [or]tf_ibt;
dissemble: [v]隐藏;伪装; [or]tf_ibt;
lurk: [vi]躲藏; [or]tf_ibt;
sneak: [vi]潜行; [or]tf_ibt;
conceal: [vt]把]]藏起来; [or]tf_ibt;
feign: [vt]假装; [or]tf_ibt;
pretend: [vt]伪装; [or]tf_ibt;
simulate: [vt]伪装;扮演; [or]tf_ibt;
hide: [v]隐藏; [or]tf_ibt;
obscure: [vt]掩盖; [or]tf_ibt;
screen: [vt]遮蔽; [or]tf_ibt;

