Armada: [a]/ɑːrˈmɑːdə/; [n](西班牙的)无敌舰队; [or]sat;
Baroque: [a]/bəˈroʊk/; [adj]巴洛克式的,结构复杂的,形式怪样的; [n]巴洛克风格,巴洛克艺术; [or]sat;
Catholic: [a]/ˈkæθlɪk/; [adj](兴趣等)广泛的,(C大写)天主教的; [n](C大写)天主教徒; [or]sat;
Spartan: [a]/ˈspɑːrtn/; [adj]斯巴达式的,简朴的,刻苦的; [n]斯巴达人;勇士; [or]sat;
Titanic: [a]/taɪˈtænɪk/; [adj]巨人的,力大无比的; [n]泰坦尼克号; [or]sat;
Utopia: [a]/juːˈtoʊpiə/; [n]乌托邦(理想中最美好的社会),理想国; [or]sat;
abase: [a]/əˈbeɪs/; [v]贬抑;使卑下;降低.的地位; [n]贬低;屈辱;贬低别人的人; [or]sat;
abash: [a]/ə'bæʃ/; [v]使局促不安;使羞愧; [adj]窘迫的,尴尬的; [adv]窘迫地,尴尬地; [n]窘迫,尴尬; [or]sat;
abbreviate: [a]/əˈbriːvieɪt/; [v]缩写,使省略,使用缩写词; [n]使用缩写词的人;缩短,缩写(词,短语,名字,名称); [or]sat;
abdicate: [a]/ˈæbdɪkeɪt/; [adj]放弃权力的;退位的; [n]放弃权力者;退位者; [vi]退位,辞职; [vt]辞;放弃; [or]sat;
aberrant: [a]/æˈberənt/; [n]离开正路的人,反常的人; [adj]偏离正轨的;异常的,畸变的; [or]sat;
abet: [a]/əˈbet/; [vt]唆使,怂恿;支持; [or]sat;
abeyance: [a]/əˈbeɪəns/; [n]中止,搁置; [or]sat;
abhor: [a]/əbˈhɔːr/; [v]痛恨;憎恶; [or]sat;
abject: [a]/ˈæbdʒekt/; [adj]糟糕透顶的;可怜的,不幸的; [or]sat;
abjure: [a]/əbˈdʒʊr/; [v]发誓放弃,公开放弃,避免; [or]sat;
ablution: [a]/əb'luːʃən/; [n](宗教的)净礼,沐浴; [or]sat;
abnegation: [a]/ˌæbnɪˈɡeɪʃn/; [n]克制,自我克制,放弃; [or]sat;
abolish: [a]/əˈbɑːlɪʃ/; [v]废除,废止;取消,革除; [or]sat;
abominable: [a]/əˈbɑːmɪnəbl/; [adj]讨厌的,令人憎恶的,糟透的; [n]讨厌,可恶; [adv]恶劣地,令人厌恶地; [or]sat;
aboriginal: [a]/ˌæbəˈrɪdʒənl/; [adj]土著的,原来的; [n]土著居民; [or]sat;
abortive: [a]/əˈbɔːrtɪv/; [adj]无结果的,失败的; [or]sat;
abrade: [a]/əˈbreɪd/; [v]磨损,擦伤; [or]sat;
abrasive: [a]/əˈbreɪsɪv/; [adj]粗糙的;有研磨作用的;伤人感情的; [n]研磨料; [or]sat;
abridge: [a]/əˈbrɪdʒ/; [v]删节;削减; [or]sat;
abrogate: [a]/ˈæbrəɡeɪt/; [v]废止,废除; [n]取消,废除; [or]sat;
abscond: [a]/əbˈskɑːnd/; [v]逃匿,潜逃;避债; [or]sat;
absolute: [a]/ˈæbsəluːt/; [adj]完全的;绝对的;纯粹的; [or]sat;
absolve: [a]/əbˈzɑːlv/; [v]赦免,宽恕;免除,解除; [or]sat;
absorb: [a]/əbˈzɔːrb/; [vt]吸收;汲取;吸引..的注意;理解,掌握;承受; [or]sat;
abstain: [a]/əbˈsteɪn/; [v]戒掉(烟\酒等);避开;弃权; [or]sat;
abstemious: [a]/əbˈstiːmiəs/; [adj](吃喝等)有节制的,节俭的; [or]sat;
abstinence: [a]/ˈæbstɪnəns/; [n]节制,禁欲; [or]sat;
abstract: [a]/ˈæbstrækt/; [adj]抽象的; [n]摘要,抽象; [v]提取; [or]sat;
abstruse: [a]/əbˈstruːs/; [adj]难懂的,深奥的; [or]sat;
abundant: [a]/əˈbʌndənt/; [adj]丰富的;大量的; [or]sat;
abusive: [a]/əˈbjuːsɪv/; [adj]辱骂的;滥用的;虐待的; [or]sat;
abut: [a]/əˈbʌt/; [v]紧靠; [or]sat;
abysmal: [a]/əˈbɪzməl/; [adj]极低的或极可怜的,(程度)很深的,极端的; [or]sat;
abyss: [a]/əˈbɪs/; [n]深渊;深不可测的事物,绝境;深海;深邃;炼狱; [or]sat;
academic: [a]/ˌækəˈdemɪk/; [adj]学术的;学院的,大学的;理论的; [n]学者; [or]sat;
accede: [a]/əkˈsiːd/; [v]同意,就任,加入; [or]sat;
accelerate: [a]/əkˈseləreɪt/; [v]加速,增长;使增速,促进; [or]sat;
accentuate: [a]/əkˈsentʃueɪt/; [v]强调;重读; [or]sat;
accessible: [a]/əkˈsesəbl/; [adj]可使用的;可到达的;可进入的;易懂的; [or]sat;
accessory: [a]/əkˈsesəri/; [n](妇女的)装饰品;附件;附属物;同谋; [adj]附属的;辅助的;同谋的; [or]sat;
acclaim: [a]/əˈkleɪm/; [n]欢呼,赞扬,称赞; [v]欢呼,喝彩,鼓掌欢迎; [vt]鼓掌欢迎,向.欢呼,为.喝彩;推选; [or]sat;
acclimate: [a]/ˈækləmeɪt/; [v]服水土,适应新环境; [or]sat;
acclivity: [a]/ə'klɪvətɪ/; [n]向上的陡坡; [or]sat;
accolade: [a]/ˈækəleɪd/; [n]同意,赞赏; [v]赞扬; [or]sat;
accommodate: [a]/əˈkɑːmədeɪt/; [v]向.提供住处(或膳宿);给.提供方便;容纳;使适应,顺应; [or]sat;
accomplice: [a]/əˈkɑːmplɪs/; [n]同谋者,帮凶; [or]sat;
accord: [a]/əˈkɔːrd/; [n]协议; [v]授予; [or]sat;
accost: [a]/əˈkɔːst/; [v]搭讪;引诱;面对;勾引; [or]sat;
accretion: [a]/əˈkriːʃn/; [n]自然的增加,增加物; [or]sat;
accrue: [a]/əˈkruː/; [v](利息等)增大,增多; [or]sat;
acerbity: [a]/əˈsɜːrbəti/; [n]苦涩,刻薄; [or]sat;
acetic: [a]/ə'siːtɪk/; [adj]酸的,醋的; [or]sat;
acidulous: [a]/əˈsɪdʒələs/; [adj]有酸味的,刻薄的; [or]sat;
acknowledge: [a]/əkˈnɑːlɪdʒ/; [v]告知收到;对(人)打招呼,招呼(某人)以示相识,致意;就..表示谢忱,鸣谢,感谢,感激,答谢,对..表示感谢;承认(属实),承认(权威,地位); [or]sat;
acme: [a]/ˈækmi/; [n]顶点,极点; [or]sat;
acoustics: [a]/əˈkuːstɪks/; [n]声学; [or]sat;
acquiesce: [a]/ˌækwiˈes/; [v]默许;勉强同意; [adj]默认的; [or]sat;
acquire: [a]/əˈkwaɪər/; [v](尤指靠自己的努力或行动或经过一个过程)获得;学到;取得; [or]sat;
acquittal: [a]/əˈkwɪtl/; [n]宣告无罪,开释; [or]sat;
acrid: [a]/ˈækrɪd/; [adj]辛辣的,(言语或语调)刻薄的; [or]sat;
acrimonious: [a]/ˌækrɪˈmoʊniəs/; [adj]严厉的;辛辣的;刻薄的; [or]sat;
acrophobia: [a]/ˌækrə'foʊbɪə/; [n]恐高症; [or]sat;
actuate: [a]/ˈæktʃueɪt/; [v]开动(机器);激励,驱使; [or]sat;
acumen: [a]/ˈækjəmən/; [n]聪明,敏锐; [or]sat;
acute: [a]/əˈkjut/; [adj](疼痛,妒忌等)剧烈的,严重的;敏锐的;急性的;尖声的; [or]sat;
adamant: [a]/ˈædəmənt/; [adj]强硬的,固执的; [n]坚硬的东西;坚石; [or]sat;
adapt: [a]/əˈdæpt/; [vi]适应不同情况; [vt]使适合;改编; [or]sat;
addendum: [a]/əˈdendəm/; [n]附录,附件;补遗;附加物; [or]sat;
addiction: [a]/əˈdɪkʃn/; [n]沉溺,上瘾; [or]sat;
addle: [a]/ˈædl/; [v]使腐坏,使昏乱; [adj]腐坏的;糊涂的,昏乱的; [or]sat;
address: [a]/əˈdres/; [n]地址;致词; [v]致函;写姓名地址;向..讲话;处理; [or]sat;
adept: [a]/əˈdept/; [n]专家,能手; [adj]熟练的;巧妙的; [or]sat;
adhere: [a]/ədˈhɪr/; [v]遵守;坚持;粘附;附着,粘在..上; [or]sat;
adherent: [a]/ədˈhɪrənt/; [n]拥护者;党徒;提倡者; [or]sat;
adjacent: [a]/əˈdʒeɪsnt/; [adj]邻接的,毗连的;邻近的; [or]sat;
adjunct: [a]/ˈædʒʌŋkt/; [n]附属物,配件,添加剂;助手,部下; [adj]附加的,辅助的,下级的; [or]sat;
admonish: [a]/ədˈmɑːnɪʃ/; [v]训诫,警告; [or]sat;
admonition: [a]/ˌædməˈnɪʃn/; [n]告诫,劝告,警告; [or]sat;
adorn: [a]/əˈdɔːrn/; [v]装饰; [or]sat;
adroit: [a]/əˈdrɔɪt/; [adj]熟练的,灵巧的; [or]sat;
adulation: [a]/ˌædʒəˈleɪʃn/; [n]奉承,恭维; [or]sat;
adulterate: [a]/əˈdʌltəreɪt/; [v]掺假; [adj]通奸的;搀杂的; [n]掺假; [or]sat;
advent: [a]/ˈædvent/; [n]来临;到来;出现; [or]sat;
adventitious: [a]/ˌædvenˈtɪʃəs/; [adj]外来的,偶然的; [or]sat;
adversary: [a]/ˈædvərseri/; [n]对手,敌手; [or]sat;
adverse: [a]/ˈædvɜːrs/; [adj]不利的;(方向上)逆的;在相反的方向上移动(或运转);相反的; [or]sat;
adversity: [a]/ədˈvɜːrsəti/; [n]逆境,不幸,灾难; [or]sat;
advocacy: [a]/ˈædvəkəsi/; [n]主张;拥护;辩护; [or]sat;
advocate: [a]/ˈædvəkeɪt/; [v]提倡;主张;为.辩护; [n]辩护者;提倡者;律师; [or]sat;
aesthetic: [a]/esˈθetɪk/; [n]美感;审美观; [adj]美学的;审美的;悦目的;雅致的; [or]sat;
affable: [a]/ˈæfəbl/; [adj]易于交谈的,和蔼的; [or]sat;
affected: [a]/əˈfektɪd/; [adj]受到影响的,受(疾病)侵袭的;假装的,做作的; [or]sat;
affidavit: [a]/ˌæfəˈdeɪvɪt/; [n]<法律>宣誓书,书面陈述; [or]sat;
affiliation: [a]/əˌfɪliˈeɪʃn/; [n]联系,从属关系; [or]sat;
affinity: [a]/əˈfɪnəti/; [n]姻亲关系;密切关系;近似,类似关系;亲近; [or]sat;
affirmation: [a]/ˌæfərˈmeɪʃn/; [n]肯定;断言;主张; [or]sat;
affix: [a]/əˈfɪks/; [v]粘上;署名;将罪责加之于; [n]词缀;附加物; [or]sat;
affliction: [a]/əˈflɪkʃn/; [n]苦恼,折磨;痛苦; [or]sat;
affluence: [a]/ˈæfluəns/; [n]丰富,富裕,流入; [or]sat;
affront: [a]/əˈfrʌnt/; [v]冒犯,有意冒犯,公开侮辱;面对; [n]轻蔑;公开侮辱; [or]sat;
aftermath: [a]/ˈæftərmæθ/; [n]不幸事件之后果,余波; [or]sat;
agenda: [a]/əˈdʒendə/; [n]议事日程; [or]sat;
agent: [a]/ˈeɪdʒənt/; [n]政府特工;代理商,代理人; [or]sat;
aggrandize: [a]/ə'grænˌdaɪz/; [v]增大;夸大;吹捧; [or]sat;
aggregate: [a]/ˈæɡrɪɡət/; [n]合计;总数;混凝料;总计; [v]集合;聚集;合计; [adj]总的,总数的;集合的; [or]sat;
aggressor: [a]/əˈɡresər/; [n]侵略者,侵略国,挑衅者; [or]sat;
aghast: [a]/əˈɡæst/; [adj]惊骇的,吓呆的; [or]sat;
agility: [a]/əˈdʒɪləti/; [n]敏捷;灵活; [or]sat;
agitate: [a]/ˈædʒɪteɪt/; [v](尤指为法律,社会状况的改变而)激烈争论,鼓动,煽动;搅动(液体);激怒; [or]sat;
agnostic: [a]/æɡˈnɑːstɪk/; [adj]不可知论的; [n]不可知论者; [or]sat;
agrarian: [a]/əˈɡreriən/; [adj]耕地的; [or]sat;
alacrity: [a]/əˈlækrəti/; [n]反应迅速,乐意; [or]sat;
alchemy: [a]/ˈælkəmi/; [n]炼金术;魔力; [or]sat;
alcove: [a]/ˈælkoʊv/; [n]凹室,壁龛; [or]sat;
alias: [a]/ˈeɪliəs/; [n]别名,化名; [adv]别名为,化名为; [or]sat;
alienate: [a]/ˈeɪliəneɪt/; [v]疏远;挑拨; [or]sat;
alimony: [a]/ˈælɪmoʊni/; [n](法)赡养费,生活费; [or]sat;
allay: [a]/əˈleɪ/; [v]减轻;使缓和;使平静; [or]sat;
allege: [a]/əˈledʒ/; [v]断言;硬说; [or]sat;
allegiance: [a]/əˈliːdʒəns/; [n]忠诚,拥护; [or]sat;
allegory: [a]/ˈæləɡɔːri/; [n]讽喻;寓意;寓言; [or]sat;
alleviate: [a]/əˈliːvieɪt/; [v]减轻;缓解;缓和; [or]sat;
alliteration: [a]/əˌlɪtəˈreɪʃn/; [n]头韵; [or]sat;
allocate: [a]/ˈæləkeɪt/; [v]分配,配给; [or]sat;
alloy: [a]/ˈælɔɪ/; [n]合金; [v]使成合金; [or]sat;
allude: [a]/əˈluːd/; [v]间接提到,暗指,暗示; [or]sat;
allure: [a]/əˈlʊr/; [v]吸引;诱使; [n]诱惑力; [or]sat;
allusion: [a]/əˈluːʒn/; [n]暗示;提及; [or]sat;
aloft: [a]/əˈlɔːft/; [adv]在空中,在高处,在上面; prep. 在 ... 上; [or]sat;
aloof: [a]/əˈluːf/; [adj]远离的;冷漠的,冷淡的; [adv]远离,避开; [or]sat;
altercation: [a]/ˌɔːltərˈkeɪʃn/; [n]争吵,争论; [or]sat;
altruistic: [a]/ˌæltruˈɪstɪk/; [adj]利他的;无私心的; [or]sat;
amalgamate: [a]/əˈmælɡəmeɪt/; [v]合并,混合; [or]sat;
amass: [a]/əˈmæs/; [vi]聚集; [vt]收集;积累,积聚; [or]sat;
ambidextrous: [a]/ˌæmbiˈdekstrəs/; [adj]双手都灵巧; [or]sat;
ambience: [a]/ˈæmbiəns/; [n]气氛,环境,氛围; [or]sat;
ambiguous: [a]/æmˈbɪɡjuəs/; [adj]含糊不清的,引起歧义的,模棱两可的; [or]sat;
ambivalence: [a]/æmˈbɪvələns/; [n]矛盾心理; [or]sat;
amble: [a]/ˈæmbl/; [v]漫步,缓行; [n]缓行,漫步; [or]sat;
ameliorate: [a]/əˈmiːliəreɪt/; [v]改善,减轻(痛苦等),改良; [or]sat;
amenable: [a]/əˈmiːnəbl/; [adj]愿意的,顺从的,服从的;经得起检验的; [or]sat;
amend: [a]/əˈmend/; [v]改进;修订;修正; [or]sat;
amiable: [a]/ˈeɪmiəbl/; [adj]和蔼的,亲切的;温和的; [or]sat;
amicable: [a]/ˈæmɪkəbl/; [adj]友善的,温和的,平心静气的; [or]sat;
amiss: [a]/əˈmɪs/; [adj]有毛病的,有缺陷的;出差错的; [adv]错误地; [or]sat;
amity: [a]/ˈæməti/; [n]友好,亲善关系,友好关系; [or]sat;
amnesia: [a]/æmˈniːʒə/; [n]<医学>遗忘症; [or]sat;
amnesty: [a]/ˈæmnəsti/; [n]赦免; [v]对.实行大赦; [or]sat;
amoral: [a]/ˌeɪˈmɔːrəl/; [adj]不知是非的; [or]sat;
amorous: [a]/ˈæmərəs/; [adj]容易动情的,情爱的; [or]sat;
amorphous: [a]/əˈmɔːrfəs/; [adj]无定形的;无组织的;<物>非晶形的; [or]sat;
amphibian: [a]/æmˈfɪbiən/; [n]两栖动物;水陆两用飞机和车辆; [adj]两栖类的;<车辆>水陆两用的;具有双重性格的; [or]sat;
amphitheater: [a]/ˈæmfɪˌθiətər/; [n]竞技场,圆形露天剧场,古罗马剧场; [or]sat;
ample: [a]/ˈæmpl/; [adj]富足的,丰满的,宽敞的; [or]sat;
amplify: [a]/ˈæmplɪfaɪ/; [v]放大(声音等);扩大;增强;详述;进一步阐述; [or]sat;
amputate: [a]/ˈæmpjuteɪt/; [v]切除;截肢;切断; [or]sat;
amulet: [a]/ˈæmjʊlət/; [n]护身符; [or]sat;
anachronistic: [a]/əˌnækrəˈnɪstɪk/; [adj]时代错误的; [or]sat;
analgesic: [a]/ˌænəlˈdʒiːzɪk/; [n]镇痛药; [adj]止痛的; [or]sat;
analogous: [a]/əˈnæləɡəs/; [adj]类似的,可比拟的;<昆>同功的; [or]sat;
analogy: [a]/əˈnælədʒi/; [n]比拟,比喻;类比;相似;类似; [or]sat;
anarchist: [a]/ˈænərkɪst/; [n]无政府主义者; [or]sat;
anarchy: [a]/ˈænərki/; [n]无政府状态,政治混乱; [or]sat;
anathema: [a]/əˈnæθəmə/; [n](基督教的)咒诅,被诅咒者,令人厌恶的人; [or]sat;
ancestry: [a]/ˈænsestri/; [n]祖先;血统; [or]sat;
anchor: [a]/ˈæŋkər/; [n]担任(广播电视新闻节目)的主持人;支柱;锚; [v]抛锚; [vt]使固定; [or]sat;
ancillary: [a]/ˈænsəleri/; [adj]辅助的,副的; [n]助手;辅助设备; [or]sat;
anecdote: [a]/ˈænɪkdoʊt/; [n]轶事,趣闻; [or]sat;
anemia: [a]/ə'niːmiːə/; [n]贫血,贫血症; [or]sat;
anesthetic: [a]/ˌænəs'θetɪk/; [n]麻醉剂,麻药; [adj]麻醉的,感觉缺失的; [or]sat;
anguish: [a]/ˈæŋɡwɪʃ/; [n]痛苦;苦恼; [v]感到极度痛苦; [or]sat;
angular: [a]/ˈæŋɡjələr/; [adj]消瘦的;有角的;笨拙的; [or]sat;
animated: [a]/ˈænɪmeɪtɪd/; [adj]有活力的,活生生的;活泼的,充满生气的;有生命的;动画(片)的; [or]sat;
animosity: [a]/ˌænɪˈmɑːsəti/; [n]憎恶,仇恨; [or]sat;
animus: [a]/ˈænɪməs/; [n]憎恨,敌意; [or]sat;
annals: [a]/ˈænlz/; [n]年报;年鉴; [or]sat;
annex: [a]/əˈneks/; [n]附加物;附属的建筑物; [vt]附加;并吞,强行占取;获得; [or]sat;
annihilate: [a]/əˈnaɪəleɪt/; [v]消灭; [or]sat;
annotate: [a]/ˈænəteɪt/; [v]注释,评注; [n]注释者; [or]sat;
annuity: [a]/əˈnuːəti/; [n]年金,养老金;年金保险;年金享受权; [or]sat;
annul: [a]/əˈnʌl/; [v]取消,废除,宣告无效; [or]sat;
anoint: [a]/əˈnɔɪnt/; [v]神圣化; [or]sat;
anomalous: [a]/əˈnɑːmələs/; [adj]反常的,不规则的,不恰当的; [or]sat;
anomaly: [a]/əˈnɑːməli/; [n]异常,不规则,反常事物; [or]sat;
anonymity: [a]/ˌænəˈnɪməti/; [n]匿名,作者不明(或不详),无名之辈; [or]sat;
anonymous: [a]/əˈnɑːnɪməs/; [adj]匿名的;无名的;不具名的;无特色的;无个性特征; [or]sat;
antagonism: [a]/ænˈtæɡənɪzəm/; [n]对抗,敌对;敌意; [or]sat;
antecede: [a]/ˌæntɪ'siːd/; [v]胜过,居前; [or]sat;
antediluvian: [a]/ˌæntidɪˈluːviən/; [adj]史前的,陈旧的; [n]大洪水以前的人;年迈的人;不合时宜的人; [or]sat;
anthem: [a]/ˈænθəm/; [n]国歌,赞美诗,圣歌; [or]sat;
anthology: [a]/ænˈθɑːlədʒi/; [n](诗,文,曲,画等的)选集; [or]sat;
anthropoid: [a]/ˈænθrəpɔɪd/; [adj]像人类的,类人猿的; [n]类人猿;灵长类动物的类人猿亚目; [or]sat;
anthropologist: [a]/ˌænθrəˈpɑːlədʒɪst/; [n]人类学家,人类学者; [or]sat;
anthropomorphic: [a]/ˌænθrəpəˈmɔːrfɪk/; [adj]拟人的,拟人化; [or]sat;
antidote: [a]/ˈæntidoʊt/; [n]<药>解毒剂,解药;矫正方法; [or]sat;
antipathy: [a]/ænˈtɪpəθi/; [n]反感,厌恶,憎恶; [or]sat;
antiquated: [a]/ˈæntɪkweɪtɪd/; [adj]陈旧的,过时的; [v]使古旧,废弃; [or]sat;
antiseptic: [a]/ˌæntiˈseptɪk/; [n]杀菌剂; [adj]防腐的,抗菌的; [or]sat;
antithesis: [a]/ænˈtɪθəsɪs/; [n]对立面,对照; [or]sat;
apathy: [a]/ˈæpəθi/; [n]冷漠,无兴趣;漠不关心,无感情; [or]sat;
ape: [a]/eɪp/; [n]无尾猿,类人猿;模仿者;粗野的大汉; [adj]〈俚〉疯狂的; [v]模仿; [or]sat;
aperture: [a]/ˈæpərtʃər/; [n]孔,穴;(照相机,望远镜等的)光圈,孔径;缝隙; [or]sat;
apex: [a]/ˈeɪpeks/; [n]顶点;尖端; [or]sat;
aphasia: [a]/əˈfeɪziə/; [n]失语症; [or]sat;
aphorism: [a]/ˈæfərɪzəm/; [n]格言,警句; [or]sat;
apiary: [a]/ˈeɪpieri/; [n]蜂房;养蜂场; [or]sat;
aplomb: [a]/əˈplɑːm/; [n]沉着,镇静; [or]sat;
apocalyptic: [a]/əˌpɑːkəˈlɪptɪk/; [adj]预示灾祸的,启示的; [or]sat;
apocryphal: [a]/əˈpɑːkrɪfl/; [adj]伪的;可疑; [or]sat;
apolitical: [a]/ˌeɪpəˈlɪtɪkl/; [adj]不问政治的; [or]sat;
apostate: [a]/əˈpɑːsteɪt/; [adj]变节的,脱党的,背教的; [n]脱党者,变节者,叛教者; [or]sat;
apotheosis: [a]/əˌpɑːθiˈoʊsɪs/; [n]神化,典范,崇拜,颂扬; [or]sat;
apparatus: [a]/ˌæpəˈrætəs/; [n]装置,仪器;设备;组织,机构; [or]sat;
apparition: [a]/ˌæpəˈrɪʃn/; [n]幽灵,神奇的现象; [or]sat;
appease: [a]/əˈpiːz/; [v]抚慰;平息; [or]sat;
appellation: [a]/ˌæpəˈleɪʃn/; [n]称呼,名称,名目; [or]sat;
application: [a]/ˌæplɪˈkeɪʃn/; [n]运用;申请(书);应用程序; [or]sat;
appraise: [a]/əˈpreɪz/; [v]评价,鉴定;估价; [or]sat;
appreciate: [a]/əˈpriːʃieɪt/; [v]赏识;为..表示感激;领会;使增值;增值; [or]sat;
apprehend: [a]/ˌæprɪˈhend/; [vt]理解,领会;逮捕;对.忧虑;把.视作; [vi]忧虑; [or]sat;
apprehension: [a]/ˌæprɪˈhenʃn/; [n]忧虑,担心,疑惧;逮捕;理解; [or]sat;
apprenticeship: [a]/əˈprentɪʃɪp/; [n]学徒期;学徒身份;学徒期;学徒身份; [or]sat;
apprise: [a]/əˈpraɪz/; [v]通知,报告; [or]sat;
approbation: [a]/ˌæprəˈbeɪʃn/; [n]称赞,认可;批准; [or]sat;
appropriate: [a]/əˈproʊpriət/; [adj]合适的;适当的; [v]挪用;拨款;私占; [or]sat;
aptitude: [a]/ˈæptɪtuːd/; [n]天资;自然倾向;适宜; [or]sat;
aquatic: [a]/əˈkwætɪk/; [adj]水生的,水栖的,水中的,水上的; [n]水生动物,水生植物;水上运动; [or]sat;
aquiline: [a]/ˈækwɪlaɪn/; [adj]鹰的,似鹰的;钩状的; [or]sat;
arable: [a]/ˈærəbl/; [adj]可耕的,适合种植的; [n]耕地; [or]sat;
arbiter: [a]/ˈɑːrbɪtər/; [n]<法>仲裁者;裁决人; [or]sat;
arbitrary: [a]/ˈɑːrbətreri/; [adj]随意的,任性的,随心所欲的;霸道的,专制的,专横的;主观的,武断的; [or]sat;
arbitrator: [a]/ˈɑːrbɪtreɪtər/; [n]公断人; [or]sat;
arboretum: [a]/ˌɑːrbəˈriːtəm/; [n]植物园; [or]sat;
arcade: [a]/ɑːrˈkeɪd/; [n]拱廊;有拱廊的街道;游乐场所,游戏厅; [or]sat;
arcane: [a]/ɑːrˈkeɪn/; [adj]神秘的;秘传的;晦涩难解的; [or]sat;
archaeology: [a]/ˌɑːrkiˈɑːlədʒi/; [n]考古学; [or]sat;
archaic: [a]/ɑːrˈkeɪɪk/; [adj]古代的;陈旧的,过时的,老式的;已不通用的; [or]sat;
archetype: [a]/ˈɑːrkitaɪp/; [n]原型,典型; [or]sat;
archipelago: [a]/ˌɑːrkɪˈpeləɡoʊ/; [n]群岛; [or]sat;
archives: [a]/ˈɑːrkaɪvz/; [n]档案室,档案; [or]sat;
ardent: [a]/ˈɑːrdnt/; [adj]热心的,热烈的; [or]sat;
arduous: [a]/ˈɑːrdʒuəs/; [adj]艰巨的;努力的;陡峭的; [or]sat;
aria: [a]/ˈɑːriə/; [n]独唱曲,咏叹调; [or]sat;
arid: [a]/ˈærɪd/; [adj](土地或气候)干燥的,干旱的,贫瘠的,荒芜的;无创见的,无新意的; [or]sat;
aristocracy: [a]/ˌærɪˈstɑːkrəsi/; [n]贵族;贵族统治;贵族政治;贵族品质; [or]sat;
aromatic: [a]/ˌærəˈmætɪk/; [adj]芳香的; [n]芳香植物;芳香族化合物; [or]sat;
arousal: [a]/əˈraʊzl/; [n]觉醒,激励,唤起; [or]sat;
arraign: [a]/əˈreɪn/; [v]指责,控告; [or]sat;
array: [a]/əˈreɪ/; [n]一系列;陈列;编队; [v]排列;部署; [or]sat;
arrears: [a]/əˈrɪrz/; [n]债,欠债; [or]sat;
arrest: [a]/əˈrest/; [v]逮捕,拘留;吸引; [n]逮捕,拘留; [or]sat;
arrogance: [a]/ˈærəɡəns/; [n]自大;傲慢态度; [or]sat;
arsenal: [a]/ˈɑːrsənl/; [n]兵工厂,军械库;储藏; [or]sat;
articulate: [a]/ɑːrˈtɪkjuleɪt/; [adj]善于表达的;发音清晰的; [v]清晰地发音;清楚地讲话;连接,接合;与.合成整体 ,使相互连贯; [or]sat;
artifact: [a]/ˈɑːrtɪfækt/; [n]人工制品;手工艺品; [or]sat;
artifice: [a]/ˈɑːrtɪfɪs/; [n]诡计;欺骗;巧妙的办法; [or]sat;
artisan: [a]/ˈɑːrtəzn/; [n]工匠,手艺人; [or]sat;
ascertain: [a]/ˌæsərˈteɪn/; [v]探知,弄清,查明(真相等); [or]sat;
ascetic: [a]/əˈsetɪk/; [adj]禁欲的;苦行的; [n]禁欲者;苦行者; [or]sat;
ascribe: [a]/əˈskraɪb/; [v]把.归因于;把.归属于; [or]sat;
aseptic: [a]/ˌeɪˈseptɪk/; [adj]无菌的,洁净的; [or]sat;
ashen: [a]/ˈæʃn/; [adj]灰色; [or]sat;
asinine: [a]/ˈæsɪnaɪn/; [adj]愚笨的;固执的; [or]sat;
askew: [a]/əˈskjuː/; [adj]歪斜的; [adv]歪斜地,斜地; [or]sat;
asperity: [a]/æˈsperəti/; [n](表面的)粗糙;(气候等的)严酷;艰苦的条件;(性格)粗暴; [or]sat;
aspirant: [a]/əˈspaɪərənt/; [n]有抱负的人,野心家; [adj]上进的,有野心的; [or]sat;
aspire: [a]/əˈspaɪər/; [vi]渴望,有志于(与to,for,after连用或后接不定式); [or]sat;
assail: [a]/əˈseɪl/; [v]攻击;质问;着手解决; [or]sat;
assay: [a]/əˈseɪ/; [n]化验,试验; [v]分析,化验,鉴定; [or]sat;
assent: [a]/əˈsent/; [v]同意,赞成; [n]同意;赞成; [or]sat;
assert: [a]/əˈsɜːrt/; [v]断言;肯定地说;坚持;维护; [or]sat;
assessment: [a]/əˈsesmənt/; [n]评估;评价;估价; [or]sat;
assiduous: [a]/əˈsɪdʒuəs/; [adj]勤勉的,刻苦的; [or]sat;
assimilate: [a]/əˈsɪməleɪt/; [v]使同化;吸收;消化; [or]sat;
assuage: [a]/əˈsweɪdʒ/; [v]缓和,减轻; [n]缓和,减轻;减轻.的人; [or]sat;
assumption: [a]/əˈsʌmpʃn/; [n]假定,设想;采取;承担; [or]sat;
assurance: [a]/əˈʃʊrəns/; [n]信心,自信;保证;保险; [or]sat;
asteroid: [a]/ˈæstərɔɪd/; [n]小行星; [adj]星状的; [or]sat;
astigmatism: [a]/əˈstɪɡmətɪzəm/; [n]散光; [or]sat;
astringent: [a]/əˈstrɪndʒənt/; [adj]止血的,收敛性的;涩的;严厉的; [n]收缩剂,止血药; [or]sat;
astronomical: [a]/ˌæstrəˈnɑːmɪkl/; [adj]天文学的; [or]sat;
astute: [a]/əˈstuːt/; [adj]机敏的,精明的,狡猾的; [or]sat;
asunder: [a]/əˈsʌndər/; [adv]分离;化为碎片; [or]sat;
asylum: [a]/əˈsaɪləm/; [n]精神病院,疯人院;避难所; [or]sat;
asymmetric: [a]/ˌeɪsɪˈmetrɪk/; [adj]不对称的,不匀称的; [or]sat;
atlas: [a]/ˈætləs/; [n]地图集; [or]sat;
atone: [a]/əˈtoʊn/; [v]赎罪,补偿; [or]sat;
atrocity: [a]/əˈtrɑːsəti/; [n]残暴,暴行; [or]sat;
atrophy: [a]/ˈætrəfi/; [v]萎缩;衰退;虚脱; [n]萎缩;衰退;萎缩症; [or]sat;
attain: [a]/əˈteɪn/; [v]获得;达到(某个年纪,水平,条件);实现; [n]成就; [or]sat;
attentive: [a]/əˈtentɪv/; [adj]留意的,注意的,肯帮忙的; [or]sat;
attenuate: [a]/əˈtenjueɪt/; [v]变薄,变弱,变纤细; [adj]稀薄的;细小的;减弱的;减少的; [or]sat;
attest: [a]/əˈtest/; [vt]证明;证实;为.作证; [vi]证明;作证; [or]sat;
audacious: [a]/ɔːˈdeɪʃəs/; [adj]大胆的,鲁莽的,大胆创新的; [or]sat;
audit: [a]/ˈɔːdɪt/; [v]审计,查账;旁听; [n]审计;查帐; [or]sat;
auditory: [a]/ˈɔːdətɔːri/; [adj]听觉的; [or]sat;
augment: [a]/ɔːɡˈment/; [v]增加;助长; [or]sat;
augury: [a]/ˈɔːɡjʊri/; [n]预言,征兆,占卜; [or]sat;
auspicious: [a]/ɔːˈspɪʃəs/; [adj]吉兆的,幸运的; [or]sat;
austere: [a]/ɔːˈstɪr/; [adj]严峻的;简朴的;苦行的;无装饰的; [or]sat;
authenticate: [a]/ɔːˈθentɪkeɪt/; [v]鉴定;证明.是真实的; [or]sat;
authoritarian: [a]/əˌθɔːrəˈteriən/; [adj]独裁主义的,权力主义的; [n]权力主义者,独裁主义者; [or]sat;
authoritative: [a]/əˈθɔːrəteɪtɪv/; [adj]权威性的;可信的;命令式的,专断的; [or]sat;
autocratic: [a]/ˌɔːtəˈkrætɪk/; [adj]独裁的,专断的; [or]sat;
automaton: [a]/ɔːˈtɑːmətən/; [n]自动机;机器人; [or]sat;
autonomous: [a]/ɔːˈtɑːnəməs/; [adj]自动驾驶的;自治的,独立自主的;自主的; [or]sat;
autopsy: [a]/ˈɔːtɑːpsi/; [n]验尸;<病理><特医>剖检; [or]sat;
auxiliary: [a]/ɔːɡˈzɪliəri/; [adj]备用的,辅助的,协助的; [or]sat;
avalanche: [a]/ˈævəlæntʃ/; [n]雪崩;大量拥至; [vi]崩塌; [or]sat;
avarice: [a]/ˈævərɪs/; [n]贪财,贪婪; [or]sat;
avenge: [a]/əˈvendʒ/; [v]报复,报仇; [or]sat;
averse: [a]/əˈvɜːrs/; [adj]不乐意的,不情愿的; [or]sat;
aversion: [a]/əˈvɜːrʒn/; [n]厌恶;讨厌的人,(或东西); [or]sat;
avert: [a]/əˈvɜːrt/; [v]转移(目光,注意力等);防止;避开; [or]sat;
aviary: [a]/ˈeɪvieri/; [n]鸟类饲养场,大型鸟舍; [or]sat;
avid: [a]/ˈævɪd/; [adj]渴望的,贪婪的;热心的; [or]sat;
avocation: [a]/ˌævoʊˈkeɪʃn/; [n]业余爱好;副业;嗜好; [or]sat;
avow: [a]/əˈvaʊ/; [vt]公开宣称,坦率承认;断言; [adj]可明言的;公开声明的,承认的; [n]公开宣布; [or]sat;
avuncular: [a]/əˈvʌŋkjələr/; [adj]伯父的;叔伯的;慈祥的; [or]sat;
awe: [a]/ɔː/; [n]敬畏;畏怯;(壮观等引起的)惊叹,惊奇; [vt]使敬畏,令人敬畏,使充满畏惧; [or]sat;
awry: [a]/əˈraɪ/; [adj]扭曲的,走样的; [adv]歪曲地;歪斜地;错误地; [or]sat;
axiom: [a]/ˈæksiəm/; [n]公理,定理; [or]sat;
azure: [a]/ˈæʒər/; [adj]天蓝色的; [n]碧空; [v]使成天蓝色; [or]sat;
babble: [a]/ˈbæbl/; [v]呀呀学语,喋喋不休,作潺潺声;泄露(秘密); [n]儿语,胡言乱语,潺潺声; [or]sat;
bacchanalian: [a]/ˌbækəˈneɪliən/; [adj]狂欢的,行为放纵的; [or]sat;
badger: [a]/ˈbædʒər/; [n]獾;獾皮毛; [v]纠缠;烦扰(反复提提出问题或要求); [or]sat;
badinage: [a]/ˌbædənˈɑːʒ/; [n]开玩笑,嘲弄,揶揄; [or]sat;
baffle: [a]/ˈbæfl/; [v]使困惑;难住;阻碍; [n]挡板; [or]sat;
bait: [a]/beɪt/; [n]饵,诱惑物; [v]装饵;辱骂,欺侮; [or]sat;
baleful: [a]/ˈbeɪlfl/; [adj]邪恶的,恶意的; [adv]凶恶地,有害地; [or]sat;
balk: [a]/bɔːk/; [v]畏缩;阻止;停止; [n]障碍;错误; [or]sat;
ballast: [a]/ˈbæləst/; [n](船等)压舱物;稳定因素;<比喻>沉着; [vt]给某物装上压舱物;给.铺道渣;使稳定;使沉着; [or]sat;
balm: [a]/bɑːm/; [n]香油,止痛膏,安慰物,香气; [or]sat;
balmy: [a]/ˈbɑːmi/; [adj](气候)温和的; [or]sat;
banal: [a]/bəˈnɑːl/; [adj]陈腐的;平庸的;老一套的; [or]sat;
bane: [a]/beɪn/; [n]祸根; [or]sat;
barb: [a]/bɑːrb/; [n]箭头鱼钩等的倒钩;伤人的话; [v]装倒钩于; [adj]具倒刺的;(话)带刺的; [or]sat;
bard: [a]/bɑːrd/; [n]吟游诗人; [or]sat;
barrage: [a]/bəˈrɑːʒ/; [n]大量;阻塞;齐射式攻击;<水利>拦河坝; [v]以密集火力阻击; [or]sat;
barren: [a]/ˈbærən/; [adj]贫瘠的,不孕的; [n]荒原,不毛之地; [or]sat;
barricade: [a]/ˌbærɪˈkeɪd/; [n]路障;障碍物;栅栏; [v]设路障;挡住; [or]sat;
bask: [a]/bæsk/; [vi]晒太阳(享受温暖),感到温暖,愉快或舒适; [n]晒太阳,取暖;沉浸于; [or]sat;
bastion: [a]/ˈbæstiən/; [n]堡垒;棱堡; [or]sat;
bauble: [a]/ˈbɔːbl/; [n]廉价珠宝;小玩意; [or]sat;
bawdy: [a]/ˈbɔːdi/; [adj]说黄色笑话的;淫猥的,下流的; [or]sat;
beam: [a]/biːm/; [n]光线;(房屋等)大梁;(横)梁; [v]发光;照射;发射,播送;微笑;用梁支撑; [or]sat;
beatific: [a]/ˌbiːəˈtɪfɪk/; [adj]祝福的,有福的; [or]sat;
beatitude: [a]/bi'ætɪtuːd/; [n]祝福;至福; [or]sat;
beget: [a]/bɪˈɡet/; [v]产生,引起; [or]sat;
begrudge: [a]/bɪˈɡrʌdʒ/; [v]嫉妒,吝惜,舍不得给; [or]sat;
beguile: [a]/bɪˈɡaɪl/; [v]欺骗,迷住,吸引; [or]sat;
behemoth: [a]/bɪˈhiːmɔːθ/; [n]怪物;怪兽; [or]sat;
belabor: [a]/bɪˈleɪbər/; [v]抨击;反复讨论,啰啰嗦嗦地说明; [or]sat;
belated: [a]/bɪˈleɪtɪd/; [adj]迟来的;误期的; [or]sat;
beleaguer: [a]/bɪ'liːgə/; [v]围攻; [or]sat;
belie: [a]/bɪˈlaɪ/; [vt]与.不符;矛盾,误解; [or]sat;
belittle: [a]/bɪˈlɪtl/; [v]轻视,贬抑; [or]sat;
bellicose: [a]/ˈbelɪkoʊs/; [adj]好战的,好斗的; [or]sat;
belligerent: [a]/bəˈlɪdʒərənt/; [adj](国家等)交战的,挑斗的; [n]交战国,交战者;参加斗殴的人或集团; [or]sat;
bemoan: [a]/bɪˈmoʊn/; [v]哀悼;为..恸哭;哀叹,对..表示惋惜; [or]sat;
bemused: [a]/bɪˈmjuːzd/; [adj]困惑的,发呆的; [or]sat;
benediction: [a]/ˌbenɪˈdɪkʃn/; [n]祝福,祈祷; [or]sat;
benefactor: [a]/ˈbenɪfæktər/; [n]恩人;捐助者;施主; [or]sat;
beneficial: [a]/ˌbenɪˈfɪʃl/; [adj]有益的,有利的; [or]sat;
beneficiary: [a]/ˌbenɪˈfɪʃieri/; [n]<金融>受益人,受惠者;封臣; [adj]拥有封地的;受圣俸的; [or]sat;
benevolent: [a]/bəˈnevələnt/; [adj]慈爱的,仁慈的;乐善好施的;慈善的; [or]sat;
benign: [a]/bɪˈnaɪn/; [adj]仁慈的;慈祥的;(病)良性的; [or]sat;
bent: [a]/bent/; [adj]弯曲的,决心的,不诚实的; [v]弯腰,弯曲(bend过去式); [n]爱好,癖好; [or]sat;
bequeath: [a]/bɪˈkwiːð/; [v]遗赠(留); [or]sat;
berate: [a]/bɪˈreɪt/; [v]猛烈责骂; [or]sat;
bereft: [a]/bɪˈreft/; [adj]丧失的;被剥夺的;失去亲人的; [or]sat;
berserk: [a]/bərˈzɜːrk/; [adj]狂暴的,疯的的; [adv]狂暴地,狂怒地; [n]同"berserker"; [or]sat;
beseech: [a]/bɪˈsiːtʃ/; [v]恳求,哀求; [adj]恳求的;哀求的;乞求的; [or]sat;
beset: [a]/bɪˈset/; [v]困扰;镶嵌;围绕; [or]sat;
besiege: [a]/bɪˈsiːdʒ/; [v]围攻,困扰; [or]sat;
besmirch: [a]/bɪˈsmɜːrtʃ/; [v]诽谤,玷污; [or]sat;
bestow: [a]/bɪˈstoʊ/; [v]给予; [or]sat;
betray: [a]/bɪˈtreɪ/; [v]背叛;失信于;泄露(秘密等);(非故意地)暴露; [or]sat;
betroth: [a]/bɪ'trɔːθ/; [v]同.订婚,许配; [or]sat;
bevy: [a]/ˈbevi/; [n]一群(少女或鸟); [or]sat;
biased: [a]/ˈbaɪəst/; [adj]有偏见的,结果偏倚的,有偏的; [or]sat;
bicameral: [a]/ˌbaɪˈkæmərəl/; [adj]两院制的; [or]sat;
bicker: [a]/ˈbɪkər/; [v]斗嘴,流动,闪动; [n]口角,流水声; [or]sat;
biennial: [a]/baɪˈeniəl/; [adj]两年一次的;二年生植物的; [n]两年生植物;两年一次的事; [or]sat;
bilious: [a]/ˈbɪliəs/; [adj]多胆汁的,坏脾气的; [or]sat;
bilk: [a]/bɪlk/; [v]骗; [or]sat;
billowing: [a]/ˈbɪloʊɪŋ/; [adj]波涛翻滚; [or]sat;
bizarre: [a]/bɪˈzɑːr/; [adj]稀奇古怪的; [or]sat;
blanch: [a]/blæntʃ/; [v]变白;漂白; [n]铅矿石; [adj]漂白的;银白色的; [or]sat;
bland: [a]/blænd/; [vi]变得平淡无奇,变得枯燥无味; [adj]温和的;(食物等)清淡的;漠不关心的; [vt]使变得淡而无味,使变得枯燥无味;除掉.的特性; [or]sat;
blandishment: [a]/ˈblændɪʃmənt/; [n]甜言蜜语,奉承;谄媚;哄诱; [or]sat;
blare: [a]/bler/; [v]高声鸣叫,发嘟嘟声; [n]嘟嘟声,号声,巨响; [or]sat;
blatant: [a]/ˈbleɪtnt/; [adj]喧哗的;露骨的;公然的;明目张胆的; [or]sat;
bleak: [a]/bliːk/; [adj]凄凉的;萧瑟的;阴郁的;无希望的; [or]sat;
blighted: [a]/ˈblaɪtɪd/; [adj]完蛋了的,生病了的; [or]sat;
blithe: [a]/blaɪð/; [adj]愉快的;快乐无忧的; [or]sat;
bloated: [a]/ˈbloʊtɪd/; [adj]浮肿的,发胀的,傲慢的; [or]sat;
bludgeon: [a]/ˈblʌdʒən/; [v]用棍棒击打;恫吓; [n]大头狼牙棒; [or]sat;
bluff: [a]/blʌf/; [adj]直率的; [v]虚张声势,吓唬; [n]虚张声势;吓唬;断崖,绝壁; [or]sat;
blunder: [a]/ˈblʌndər/; [n]愚蠢之举;大错; [vi]犯大错; [v]失策;绊倒; [or]sat;
blurt: [a]/blɜːrt/; [v]突然说出,冲动地说; [or]sat;
bluster: [a]/ˈblʌstər/; [v]咆哮;狂吹;夸口;威吓;气势汹汹地说; [n]怒号;吓唬; [or]sat;
bode: [a]/boʊd/; [v]预示,为.的兆头,停留,继续,遭到; [or]sat;
bogus: [a]/ˈboʊɡəs/; [adj]假的,假装的; [n]伪币;冒牌货; [or]sat;
boisterous: [a]/ˈbɔɪstərəs/; [adj]喧闹的,欢闹的; [or]sat;
bolster: [a]/ˈboʊlstər/; [n]枕垫; [v]支持,鼓励,增强; [or]sat;
bolt: [a]/boʊlt/; [n]门栓,螺栓;闪电;弩箭; [v]闩门;(马受惊)脱缰; [adv]突然地;像箭似地;直立地; [or]sat;
bombardment: [a]/bɑːmˈbɑːrdmənt/; [n]炮轰; [or]sat;
booming: [a]/ˈbuːmɪŋ/; [adj]快速增长的,欣欣向荣;深刻的; [or]sat;
boon: [a]/buːn/; [n]恩惠,福利,利益; [adj]愉快的; [or]sat;
boorish: [a]/ˈbʊrɪʃ/; [adj]粗野的;乡土气的;笨拙的; [or]sat;
boundless: [a]/ˈbaʊndləs/; [adj]无限的;无边无际的; [or]sat;
bountiful: [a]/ˈbaʊntɪfl/; [adj]充足的,慷慨的,丰裕的; [or]sat;
bourgeois: [a]/ˌbʊrˈʒwɑː/; [n]中产阶级;资产阶级; [adj]中产阶级的; [or]sat;
bovine: [a]/ˈboʊvaɪn/; [adj](似)牛的,迟钝的; [n]牛科动物; [or]sat;
boycott: [a]/ˈbɔɪkɑːt/; [vt]抵制; [n]抵制; [or]sat;
brandish: [a]/ˈbrændɪʃ/; [v]挥舞;炫耀的挥舞(武器); [n]挥舞; [or]sat;
bravado: [a]/brəˈvɑːdoʊ/; [n]故作勇敢,逞能; [or]sat;
brazen: [a]/ˈbreɪzn/; [adj]厚脸皮的,厚颜无耻的;黄铜(制)的; [v]厚着脸皮干,使变得无耻; [or]sat;
breach: [a]/briːtʃ/; [n]破裂;裂痕;冲击;违反; [v]使有裂口;破坏; [or]sat;
breadth: [a]/bredθ/; [n]宽度;广度; [or]sat;
brevity: [a]/ˈbrevəti/; [n]简短,短小,精炼; [or]sat;
brindled: [a]/ˈbrɪnd(ə)ld/; [adj]有斑纹的; [or]sat;
brittle: [a]/ˈbrɪtl/; [adj]易碎的;脆弱的;靠不住的; [n]薄片脆糖; [or]sat;
broach: [a]/broʊtʃ/; [v]提出;钻孔;开始讨论;给.开口; [or]sat;
brochure: [a]/broʊˈʃʊr/; [n]手册,小册子; [or]sat;
browbeat: [a]/ˈbraʊbiːt/; [v]恫吓,吓唬;欺侮; [or]sat;
browse: [a]/braʊz/; [v]浏览;随意翻阅;(牛,羊等)吃草; [or]sat;
brunt: [a]/brʌnt/; [n]冲击,主要冲力; [or]sat;
brusque: [a]/brʌsk/; [adj]唐突的,直率的,无礼的; [or]sat;
bucolic: [a]/bjuːˈkɑːlɪk/; [adj]乡村的;牧羊的; [or]sat;
buffet: [a]/bəˈfeɪ/; [n]自助餐,(火车内)餐室,冷餐桌; [v]反复敲打,打击,重击; [or]sat;
bullion: [a]/ˈbʊliən/; [n](造币用)金块;纯金,纯银;条形金属; [or]sat;
bulwark: [a]/ˈbʊlwɜːrk/; [n]堡垒,壁垒;保障;防波堤; [v]防御,保护;筑垒保卫; [or]sat;
bumptious: [a]/ˈbʌmpʃəs/; [adj]专横傲慢的,自以为是的; [or]sat;
bungalow: [a]/ˈbʌŋɡəloʊ/; [n]平房,小屋; [or]sat;
bungle: [a]/ˈbʌŋɡl/; [v]办糟,失败; [n]粗劣,失败,笨拙; [or]sat;
buoyant: [a]/ˈbɔɪənt/; [adj]有浮力的;愉快的;(股市)保持高价的; [or]sat;
bureaucracy: [a]/bjʊˈrɑːkrəsi/; [n]官僚主义;政府机构; [or]sat;
burgeon: [a]/ˈbɜːrdʒən/; [v]发芽,迅速成长; [n]嫩枝; [or]sat;
burlesque: [a]/bɜːrˈlesk/; [adj]滑稽的,可笑的; [v]讥笑; [n]脱衣舞,打油诗,滑稽戏,笑剧,杂耍,漫画; [or]sat;
burly: [a]/ˈbɜːrli/; [adj]结实的;率直的;粗鲁的; [n]〈美〉滑稽戏;〈美俚〉身材魁伟的人; [or]sat;
burnish: [a]/ˈbɜːrnɪʃ/; [v]擦亮,磨光; [or]sat;
bustle: [a]/ˈbʌsl/; [n]喧闹,熙攘;腰垫;奔走,奔忙; [v]喧闹;忙乱,奔忙; [or]sat;
buttress: [a]/ˈbʌtrəs/; [n]扶墙,拱壁; [v]支持; [or]sat;
buxom: [a]/ˈbʌksəm/; [adj]体态丰满的; [or]sat;
cache: [a]/kæʃ/; [n]隐藏处所,隐藏的粮食或物资,贮藏物; [vt]贮藏; [vi]躲藏; [or]sat;
cadaver: [a]/kəˈdævər/; [n]尸体; [or]sat;
cadaverous: [a]/kəˈdævərəs/; [adj]像尸体的,(形容)枯槁的; [or]sat;
cadence: [a]/ˈkeɪdns/; [n](声音的)抑扬顿挫;韵律; [vt]使有节奏; [or]sat;
cajole: [a]/kəˈdʒoʊl/; [v]以甜言蜜语哄骗,勾引; [or]sat;
calamity: [a]/kəˈlæməti/; [n]大灾祸,不幸之事; [or]sat;
caliber: [a]/'kæləbə/; [n]<军>口径;才干;水准(等于calibre);器量; [or]sat;
calligraphy: [a]/kəˈlɪɡrəfi/; [n]笔迹,墨宝,书法; [or]sat;
callous: [a]/ˈkæləs/; [adj]无情的,铁石心肠的,硬结的; [vt](使)变硬,(使)起茧;(使)冷酷无情; [or]sat;
callow: [a]/ˈkæloʊ/; [adj](鸟)未生羽毛的;年轻而无经验的; [or]sat;
calorific: [a]/ˌkæləˈrɪfɪk/; [adj]发热的,富含卡路里的; [or]sat;
calumny: [a]/ˈkæləmni/; [n]诽谤,中伤; [or]sat;
camaraderie: [a]/ˌkɑːməˈrɑːdəri/; [n]友情; [or]sat;
cameo: [a]/ˈkæmioʊ/; [n]石雕,贝雕;浮雕玉石;文学小品; [or]sat;
camouflage: [a]/ˈkæməflɑːʒ/; [n]伪装;掩饰; [v]使改头换面,伪装,掩饰;欺瞒; [or]sat;
candor: [a]/'kændə/; [n]坦白,直率,诚挚; [or]sat;
canine: [a]/ˈkeɪnaɪn/; [adj]犬的,似犬的,犬科的,犬齿的; [n]<解剖>犬齿; [or]sat;
canny: [a]/ˈkæni/; [adj]精明的,谨慎的,节约的; [adv]<苏格兰>仔细地; [or]sat;
cantankerous: [a]/kænˈtæŋkərəs/; [adj]脾气坏的,好争吵的; [or]sat;
cantata: [a]/kænˈtɑːtə/; [n]大合唱;清唱剧;(一种声乐套曲)康塔塔; [or]sat;
canter: [a]/ˈkæntər/; [n]慢跑(多用于马); [or]sat;
canto: [a]/ˈkæntoʊ/; [n](长诗的)分篇; [or]sat;
canvass: [a]/ˈkænvəs/; [v]仔细检查或详尽地讨论;审查,游说; [n]讨论;细查;劝诱; [or]sat;
capacious: [a]/kəˈpeɪʃəs/; [adj]宽敞的;广阔的;容积大的; [or]sat;
capacity: [a]/kəˈpæsəti/; [n]产能;容量;本领;才能;负载量;职位; [or]sat;
capitulate: [a]/kəˈpɪtʃuleɪt/; [vi]有条件投降,认输,屈服,让步,停止抵抗; [or]sat;
caprice: [a]/kəˈpriːs/; [n]任性,反复无常,随想曲; [or]sat;
capricious: [a]/kəˈprɪʃəs/; [adj]变化无常的,任性的; [or]sat;
caption: [a]/ˈkæpʃn/; [n](报刊的)标题;(插图,照片等的)说明文字; [v]给(图片,照片等)加说明文字; [or]sat;
captivate: [a]/ˈkæptɪveɪt/; [v]吸引,迷惑; [or]sat;
carat: [a]/ˈkærət/; [n]公制克拉;(金子)开; [or]sat;
cardinal: [a]/ˈkɑːrdɪnl/; [adj]主要的;基本的; [n]<天主教>枢机主教,红衣主教;基数; [or]sat;
careen: [a]/kəˈriːn/; [n](船的)倾侧; [v](船)倾斜,使倾斜; [or]sat;
caricature: [a]/ˈkærɪkətʃər/; [n]讽刺画,滑稽模仿;扭曲,夸张的描述; [or]sat;
carnage: [a]/ˈkɑːrnɪdʒ/; [n]大屠杀,残杀,大量绝灭; [or]sat;
carnal: [a]/ˈkɑːrnl/; [adj]肉体的,肉欲的,性欲的,色欲的,淫荡的; [or]sat;
carnivorous: [a]/kɑːrˈnɪvərəs/; [adj]食肉的,肉食性的; [or]sat;
cartographer: [a]/kɑːrˈtɑːɡrəfər/; [n]制图师;地图制作者; [or]sat;
cascade: [a]/kæˈskeɪd/; [n]层叠;小瀑布;喷流; [v]像瀑布般冲下或倾泻; [or]sat;
castigate: [a]/ˈkæstɪɡeɪt/; [v]严惩;苛评;矫正;修订; [or]sat;
casualty: [a]/ˈkæʒuəlti/; [n]伤亡人员,死伤者,受害人;急诊室(英); [or]sat;
cataclysm: [a]/ˈkætəklɪzəm/; [n]灾难(常指大洪水或地震),剧变; [or]sat;
catalyst: [a]/ˈkætəlɪst/; [n]催化剂;造成变化的人或事; [or]sat;
catapult: [a]/ˈkætəpʌlt/; [n]弹弓;石弩;飞机弹射器;(飞机上的)座椅弹射器; [v]用弹弓射;用弹射器发射;猛投;快速移动; [or]sat;
cataract: [a]/ˈkætərækt/; [n]<眼科>白内障,大瀑布,暴雨,洪水,奔流; [v]倾注; [or]sat;
catastrophe: [a]/kəˈtæstrəfi/; [n]大灾难; [or]sat;
categorical: [a]/ˌkætəˈɡɔːrɪkl/; [adj]绝对的;直接了当的;无条件的;属于某一范畴的; [or]sat;
catharsis: [a]/kəˈθɑːrsɪs/; [n]泻法,净化,精神发泄; [or]sat;
caucus: [a]/ˈkɔːkəs/; [n]政党高层会议,核心人物; [or]sat;
caulk: [a]/kɔːk/; [v]填隙使不渗水,捻缝,凿密; [n]捻缝材料,填料; [or]sat;
causal: [a]/ˈkɔːzl/; [adj]因果关系的,有原因的; [n]表示原因的连词; [or]sat;
caustic: [a]/ˈkɔːstɪk/; [adj]腐蚀性的;苛性的;刻薄的;焦散的; [n]腐蚀剂;苛性钠;焦散曲线; [or]sat;
cavalcade: [a]/ˌkævlˈkeɪd/; [n]行列,队伍,骑兵队; [or]sat;
cavalier: [a]/ˌkævəˈlɪr/; [n]骑士,武士; [adj]满不在乎的,无忧无虑的,漫不经心的,目中无人的; [or]sat;
cavil: [a]/ˈkævl/; [v]吹毛求疵,挑剔,无端指摘;挑毛病,无端抱怨; [n]吹毛求疵,苛责,无端的指责; [or]sat;
cede: [a]/siːd/; [v]放弃;割让(领土); [or]sat;
celebrated: [a]/ˈselɪbreɪtɪd/; [adj]著名的,有名望的; [v]庆祝; [or]sat;
celerity: [a]/sə'lerətɪ/; [n]快速,敏捷; [or]sat;
celestial: [a]/səˈlestʃl/; [adj]天体的,天上的; [n]天人,神仙;(指封建时代的)中国人,天朝之人; [or]sat;
celibate: [a]/ˈselɪbət/; [n]独身者,独身主义者; [adj]独身的,未婚的,禁欲的; [or]sat;
censor: [a]/ˈsensər/; [n]检查员; [vt]审查,检查;修改; [or]sat;
censorious: [a]/senˈsɔːriəs/; [adj]爱挑剔的,吹毛求疵的,严厉批评的; [or]sat;
censure: [a]/ˈsenʃər/; [v]责难,责备; [n]责难,责备; [or]sat;
centigrade: [a]/ˈsentɪɡreɪd/; [adj]百分度的;摄氏的; [n]摄氏度; [or]sat;
centrifugal: [a]/ˌsentrɪˈfjuːɡl/; [adj]离心的;远中的; [n]离心机; [or]sat;
centurion: [a]/senˈtʃʊriən/; [n]百夫长;百人队队长; [or]sat;
cerebral: [a]/səˈriːbrəl/; [adj]大脑的,深思的; [or]sat;
cerebration: [a]/ˌserə'breɪʃən/; [n]思考,精神活动,脑髓作用; [or]sat;
ceremonious: [a]/ˌserəˈmoʊniəs/; [adj]隆重的;讲究仪式的;正式的; [or]sat;
certitude: [a]/ˈsɜːrtɪtuːd/; [n]确实;确信;必然性; [or]sat;
cessation: [a]/seˈseɪʃn/; [n]停止,中止,中断; [or]sat;
chafe: [a]/tʃeɪf/; [v]擦破;擦热;擦痛;激怒; [n]急躁;摩擦,擦伤;(防止擦伤马的)马鞍环套皮; [or]sat;
chaff: [a]/tʃæf/; [n]谷物的皮壳,米糠;草料,干草;小玩笑; [v]开玩笑; [or]sat;
chagrin: [a]/ʃəˈɡrɪn/; [n]懊恼;委屈;气愤; [v]使.懊恼; [or]sat;
chalice: [a]/ˈtʃælɪs/; [n](高脚)酒杯;圣餐杯;［植］杯状花; [or]sat;
chameleon: [a]/kəˈmiːliən/; [n]蜥蜴;变色龙;善变的人; [or]sat;
champion: [a]/ˈtʃæmpiən/; [n]冠军;拥护者,战士; [v]拥护;保卫;为..而斗争; [adj]夺得第一名的;优胜的; [or]sat;
chaotic: [a]/keɪˈɑːtɪk/; [adj]混沌的,混乱的;混乱的;无秩序的; [or]sat;
charisma: [a]/kəˈrɪzmə/; [n]魅力; [or]sat;
charlatan: [a]/ˈʃɑːrlətən/; [n]骗子;假内行; [or]sat;
chary: [a]/ˈtʃeri/; [adj]小心的,谨慎的; [or]sat;
chasm: [a]/ˈkæzəm/; [n](地壳,冰上的)隐窟,深坑,峡谷;显著差距,巨大分歧; [or]sat;
chassis: [a]/ˈʃæsi/; [n]底盘; [or]sat;
chaste: [a]/tʃeɪst/; [adj]贞洁的;纯洁的;朴素的; [or]sat;
chastise: [a]/tʃæˈstaɪz/; [v]严厉惩罚,遣责; [or]sat;
check: [a]/tʃek/; [v]检查;阻止; [n]支票;阻止;检查;阻止物; [or]sat;
cherubic: [a]/tʃəˈruːbɪk/; [adj]可爱的;天使的;无邪的; [or]sat;
chicanery: [a]/ʃɪˈkeɪnəri/; [n]诡计,诈骗,欺骗; [or]sat;
chide: [a]/tʃaɪd/; [v]叱责,指责; [or]sat;
chimerical: [a]/kaɪ'merɪkəl/; [adj]空想的,妄想的;荒唐的; [or]sat;
chisel: [a]/ˈtʃɪzl/; [v]刻,凿; [n]凿子; [or]sat;
chivalrous: [a]/ˈʃɪvəlrəs/; [adj]像骑士的,侠义的,大侠的; [or]sat;
choleric: [a]/ˈkɑːlərɪk/; [adj]易怒的,暴躁的,胆汁质的; [or]sat;
choreography: [a]/ˌkɔːriˈɑːɡrəfi/; [n]编舞艺术;舞蹈编排;舞蹈编排; [or]sat;
chortle: [a]/ˈtʃɔːrtl/; [v]咯咯笑; [n]得意的高笑; [or]sat;
chronic: [a]/ˈkrɑːnɪk/; [adj](疾病)慢性的;长期的;(人)久病的;积习难改的;严重的; [or]sat;
chronicle: [a]/ˈkrɑːnɪkl/; [n]编年史,年代记,记录; [v]记录,把.载入编年史; [or]sat;
churlish: [a]/ˈtʃɜːrlɪʃ/; [adj]脾气暴躁的;没有礼貌的; [or]sat;
cipher: [a]/ˈsaɪfər/; [n]密码,暗号,不重要的人; [or]sat;
circuitous: [a]/sərˈkjuːɪtəs/; [adj]迂回的,绕圈子的; [or]sat;
circumlocution: [a]/ˌsɜːrkəmləˈkjuːʃn/; [n]婉转曲折的说法,累赘的陈述,遁辞; [or]sat;
circumscribe: [a]/ˈsɜːrkəmskraɪb/; [v]限制;在.周围画线;<数>使外接,使外切; [or]sat;
circumspect: [a]/ˈsɜːrkəmspekt/; [adj]慎重的,仔细的; [or]sat;
circumvent: [a]/ˌsɜːrkəmˈvent/; [v]用计避免,规避; [or]sat;
cistern: [a]/ˈsɪstərn/; [n]水箱;水池;贮水器; [or]sat;
citadel: [a]/ˈsɪtədəl/; [n]堡垒;避难所; [or]sat;
cite: [a]/saɪt/; [v]引用,引证;传唤,传讯;表彰,嘉奖; [or]sat;
civil: [a]/ˈsɪvl/; [adj]公民的,民用的;国内的;有礼貌的,客气的; [or]sat;
clairvoyant: [a]/klerˈvɔɪənt/; [n]千里眼,透视眼;有洞察力的人; [adj]千里眼的;有洞察力的;透视的;有洞察力的; [or]sat;
clamber: [a]/ˈklæmbər/; [v]攀登,爬上; [n]攀登,攀爬; [or]sat;
clamor: [a]/ˈklæmər/; [n]喧闹;强烈的要求; [v]喧嚷;强烈的要求; [or]sat;
clandestine: [a]/klænˈdestɪn/; [adj]秘密的,私下的,暗中的; [or]sat;
clapper: [a]/ˈklæpər/; [n]拍手者;铃舌;响板;唠唠叨叨的嘴巴; [or]sat;
clasp: [a]/klæsp/; [v]握紧;扣紧;扣住;抱紧; [n]扣子;钩子;紧抱;紧握; [or]sat;
claustrophobia: [a]/ˌklɔːstrəˈfoʊbiə/; [n]幽闭恐怖症; [or]sat;
cleave: [a]/kliːv/; [v]劈开,分裂; [or]sat;
cleft: [a]/kleft/; [n]裂缝; [adj]分裂的;劈开的; [or]sat;
clench: [a]/klentʃ/; [v]紧握,(拳头)牢牢地抓住;确定;敲弯;咬紧(牙关); [n]紧抓;咬紧牙关;咬牙切齿;敲弯的钉头; [or]sat;
cliche: [a]/klɪˈʃeɪ/; [n]陈腐思想,陈词滥调; [adj]陈腐的; [or]sat;
clientele: [a]/ˌklaɪənˈtel/; [n]顾客,常客; [or]sat;
clip: [a]/klɪp/; [n]回形针,夹子;(电影,广播,电视节目的)片段; [v]夹住;删剪;剪辑; [or]sat;
clique: [a]/kliːk/; [n]朋党派系,小集团; [vi]结派,结党; [or]sat;
cloister: [a]/ˈklɔɪstər/; [n]修道院; [adj]隐居的;躲开尘世纷争的; [or]sat;
cloying: [a]/ˈklɔɪɪŋ/; [adj]甜得发腻的;厌烦的;倒胃口的; [or]sat;
clump: [a]/klʌmp/; [n]土块; [v]丛生; [or]sat;
coagulate: [a]/koʊˈæɡjuleɪt/; [v]凝结,使凝结; [or]sat;
coalesce: [a]/ˌkoʊəˈles/; [v]联合,合并,结合; [or]sat;
coalition: [a]/ˌkoʊəˈlɪʃn/; [n]结合;联盟;联合; [or]sat;
coddle: [a]/ˈkɑːdl/; [v]溺爱;用文火煮; [n]〈口〉娇生惯养的人; [or]sat;
codicil: [a]/ˈkɑːdəsl/; [n]遗嘱的附录,附加条款; [or]sat;
codify: [a]/ˈkɑːdɪfaɪ/; [v]编纂;将..编成法典; [or]sat;
coercion: [a]/koʊˈɜːrʒn/; [n]胁迫,威压; [or]sat;
cogent: [a]/ˈkoʊdʒənt/; [adj]有说服力的; [or]sat;
cogitate: [a]/ˈkɑːdʒɪteɪt/; [v]慎重思考,思索; [or]sat;
cognate: [a]/ˈkɑːɡneɪt/; [adj]同词源的,同类的; [or]sat;
cognitive: [a]/ˈkɑːɡnətɪv/; [adj]认识能力的;认知的; [or]sat;
cohesion: [a]/koʊˈhiːʒn/; [n]凝聚,凝聚力;结合;<力>内聚力; [or]sat;
coincidence: [a]/koʊˈɪnsɪdəns/; [n]一致;巧合,巧事;同时发生; [or]sat;
colander: [a]/ˈkɑːləndər/; [n]滤器,漏勺; [or]sat;
collaborate: [a]/kəˈlæbəreɪt/; [v]合作; [or]sat;
collage: [a]/kəˈlɑːʒ/; [n]抽象拚贴画(用报纸,布,压平的花等碎片拼合而成的); [or]sat;
collate: [a]/kəˈleɪt/; [v]核对,校对;校勘; [or]sat;
collateral: [a]/kəˈlætərəl/; [adj]间接的,旁系的; [n]抵押品; [or]sat;
colloquial: [a]/kəˈloʊkwiəl/; [adj]口语的,白话的,通俗的,口语体; [or]sat;
collusion: [a]/kəˈluːʒn/; [n]勾结;共谋; [or]sat;
colossal: [a]/kəˈlɑːsl/; [adj]巨像(似)的;巨大的,庞大的; [or]sat;
comatose: [a]/ˈkoʊmətoʊs/; [adj]昏迷的,昏睡状态的,麻木的,怠惰的; [or]sat;
combustible: [a]/kəmˈbʌstəbl/; [adj]易燃的;易激动的; [n]可燃物;易燃物; [or]sat;
comely: [a]/ˈkʌmli/; [adj]动人的,美丽的; [or]sat;
comeuppance: [a]/kʌmˈʌpəns/; [n]应得的惩罚,因果报应; [or]sat;
commemorate: [a]/kəˈmeməreɪt/; [v]纪念,庆祝; [or]sat;
commensurate: [a]/kəˈmenʃərət/; [adj]相称的,相应的;同量的;同样大小的; [or]sat;
commiserate: [a]/kəˈmɪzəreɪt/; [v]同情,怜悯; [or]sat;
commodious: [a]/kəˈmoʊdiəs/; [adj]宽敞的; [or]sat;
communal: [a]/kəˈmjuːnl/; [adj]公社的;公共的; [or]sat;
compact: [a]/ˈkɑːmpækt/; [adj]小巧的,小型的,袖珍的,体积小的;紧密的,紧凑的,密集的; [v]把..压紧;变得坚实; [n]带镜小粉盒;合约,条约; [or]sat;
comparable: [a]/ˈkɑːmpərəbl/; [adj]类似的,比得上的,可比较的; [or]sat;
compatible: [a]/kəmˈpætəbl/; [adj]可和谐共存的;兼容的; [or]sat;
compelling: [a]/kəmˈpelɪŋ/; [adj]引人注目的;紧迫的;令人信服的; [or]sat;
compensatory: [a]/kəmˈpensətɔːri/; [adj]补偿的,赔偿的; [or]sat;
compile: [a]/kəmˈpaɪl/; [v]收集,汇编; [or]sat;
complacency: [a]/kəmˈpleɪsnsi/; [n]自满,自鸣得意;满足; [or]sat;
complaisant: [a]/kəmˈpleɪzənt/; [adj]彬彬有礼的,殷勤的,柔顺的; [or]sat;
complement: [a]/ˈkɑːmplɪment/; [v]补充;与.相配; [n]补充;互为补充的东西;补语; [or]sat;
complementary: [a]/ˌkɑːmplɪˈmentri/; [adj]补足的,补充的,互补的; [or]sat;
compliance: [a]/kəmˈplaɪəns/; [n]遵守,依从;承诺,答应; [or]sat;
compliant: [a]/kəmˈplaɪənt/; [adj]顺从的,服从的,应允的; [or]sat;
complicity: [a]/kəmˈplɪsəti/; [n]同谋关系,共犯关系; [or]sat;
component: [a]/kəmˈpoʊnənt/; [n]零件; [adj]组成的; [or]sat;
composure: [a]/kəmˈpoʊʒər/; [n]镇静,沉着; [or]sat;
compound: [a]/ˈkɑːmpaʊnd/; [n]复合物;<化学>化合物; [adj]合成的;复合的;多功能的; [vi]妥协;和解; [vt]混合;调和;调停;使恶化; [or]sat;
comprehensive: [a]/ˌkɑːmprɪˈhensɪv/; [adj]综合的;有充分理解力的,悟性好的;全面的,完整的;详尽的;广泛的,无所不包的;广义的; [n]综合测验;综合学校; [or]sat;
compress: [a]/kəmˈpres/; [v]压紧,压缩,压榨; [or]sat;
comprise: [a]/kəmˈpraɪz/; [v]包含,包括;构成; [or]sat;
compromise: [a]/ˈkɑːmprəmaɪz/; [n]妥协;折中; [v]妥协;使遭受危害; [or]sat;
compunction: [a]/kəmˈpʌŋkʃn/; [n]懊悔,良心不安; [or]sat;
compute: [a]/kəmˈpjuːt/; [v]计算,估计; [or]sat;
concave: [a]/kɑːnˈkeɪv/; [adj]凹面的; [n]凹面; [vt]使成凹形; [or]sat;
concede: [a]/kənˈsiːd/; [v]承认;承认失败;让给,让与;让步; [or]sat;
conceit: [a]/kənˈsiːt/; [n]自负;狂妄;想法,观点;构想,幻想; [or]sat;
concentric: [a]/kənˈsentrɪk/; [adj]同中心的; [adv]同一中心地;同轴地; [or]sat;
conception: [a]/kənˈsepʃn/; [n]怀孕,构想,设想,思想,观念; [or]sat;
concerted: [a]/kənˈsɜːrtɪd/; [adj]一致的,商定的; [or]sat;
concession: [a]/kənˈseʃn/; [n]让步;特许,特许权;承认; [or]sat;
concise: [a]/kənˈsaɪs/; [adj]简明的,简要的;简洁的,简要的; [or]sat;
contrived: [a]/kənˈtraɪvd/; [adj]人为的;做作的;不自然的; [or]sat;
conundrum: [a]/kəˈnʌndrəm/; [n](答案有双关意义的)谜语;机智问答;难题; [or]sat;
convene: [a]/kənˈviːn/; [v]集合,召集,召唤; [or]sat;
convention: [a]/kənˈvenʃn/; [n]会议;习俗;惯例; [or]sat;
conventional: [a]/kənˈvenʃənl/; [adj]普通的,常规的;依照惯例的,依照传统的; [or]sat;
converge: [a]/kənˈvɜːrdʒ/; [v](向某一点)相交,会合;汇集,聚集,集中; [or]sat;
conversant: [a]/kənˈvɜːrsnt/; [adj]熟悉的;精通的;亲近的; [or]sat;
converse: [a]/kənˈvɜːrs/; [v]交谈; [adj]相反的,颠倒的; [n]相反的事物; [or]sat;
convert: [a]/kənˈvɜːrt/; [v]可转变为,可变换成;改变,转变,转化;使改变信仰; [n]皈依者;改变宗教信仰者; [or]sat;
convex: [a]/ˈkɑːnveks/; [adj]中凸的;凸圆的;凸面的; [n]凸面体;凸状; [or]sat;
conveyance: [a]/kənˈveɪəns/; [n]运输;运输工具;财产让与; [or]sat;
conviction: [a]/kənˈvɪkʃn/; [n]定罪;信服;坚强信念; [or]sat;
convivial: [a]/kənˈvɪviəl/; [adj]欢乐的;欢宴的;酒宴的; [or]sat;
convoke: [a]/kənˈvoʊk/; [v]召集会议; [or]sat;
convoluted: [a]/ˈkɑːnvəluːtɪd/; [adj]旋绕的,费解的; [or]sat;
copious: [a]/ˈkoʊpiəs/; [adj]丰富的,多产的; [or]sat;
coquette: [a]/koʊˈket/; [n]调情的女子; [v]不认真对待; [or]sat;
cordial: [a]/ˈkɔːrdʒəl/; [adj]热情友好的,衷心的; [or]sat;
cordon: [a]/ˈkɔːrdn/; [n]哨兵线,警戒线;饰带; [v]布设警戒线;封锁交通; [or]sat;
cornucopia: [a]/ˌkɔːrnjuˈkoʊpiə/; [n]象征丰收的羊角;装满花果及谷穗表丰饶的羊角状物;丰饶的象征; [or]sat;
corollary: [a]/ˈkɔːrəleri/; [n]推论;必然的结果; [or]sat;
coronation: [a]/ˌkɔːrəˈneɪʃn/; [n]加冕,加冕礼; [or]sat;
corporeal: [a]/kɔːrˈpɔːriəl/; [adj]物质的,有形的,肉体的; [or]sat;
corpulent: [a]/ˈkɔːrpjələnt/; [adj]肥胖的; [or]sat;
correlation: [a]/ˌkɔːrəˈleɪʃn/; [n]相互关系,相关(性); [or]sat;
corroborate: [a]/kəˈrɑːbəreɪt/; [v]支持或证实,强化; [n]确证者,证物; [or]sat;
corrode: [a]/kəˈroʊd/; [v]受腐蚀;腐蚀,侵蚀; [or]sat;
corrosive: [a]/kəˈroʊsɪv/; [adj]腐蚀的;腐蚀性的;蚀坏的; [n]腐蚀剂; [or]sat;
corrugated: [a]/ˈkɔːrəɡeɪtɪd/; [adj]褶皱的; [or]sat;
cosmic: [a]/ˈkɑːzmɪk/; [adj]宇宙的;广大无边的; [or]sat;
cosmopolitan: [a]/ˌkɑːzməˈpɑːlɪtən/; [n]游历四方的人; [adj]见多识广的;多元的;广泛分布的; [or]sat;
countenance: [a]/ˈkaʊntənəns/; [n]面容,表情,气色; [v]支持,赞成; [or]sat;
countermand: [a]/ˈkaʊntərmænd/; [vt]撤回,取消; [or]sat;
cumbersome: [a]/ˈkʌmbərsəm/; [adj]笨重的;麻烦的; [or]sat;
cumulative: [a]/ˈkjuːmjəleɪtɪv/; [adj]渐增的;累积的; [or]sat;
cupidity: [a]/kjuːˈpɪdəti/; [n]贪婪; [or]sat;
curator: [a]/kjʊˈreɪtər/; [n]馆长;监护人;管理者; [or]sat;
curmudgeon: [a]/kɜːrˈmʌdʒən/; [n]脾气暴躁之人; [or]sat;
cursive: [a]/ˈkɜːrsɪv/; [n]草书;草书原稿; [adj]草书的;草书体的; [or]sat;
cursory: [a]/ˈkɜːrsəri/; [adj]匆忙的,不注意细节的;草率地;粗略地; [or]sat;
curtail: [a]/kɜːrˈteɪl/; [vt]截短;削减;剥夺.特权; [or]sat;
cynical: [a]/ˈsɪnɪkl/; [adj]愤世嫉俗的;恶意的;悲观的; [or]sat;
dabble: [a]/ˈdæbl/; [v]涉足;浅赏,溅湿;浸入水中; [or]sat;
dais: [a]/ˈdeɪɪs/; [n]主席台,嘉宾席; [or]sat;
dank: [a]/dæŋk/; [adj]潮湿的,阴湿的;透水的; [or]sat;
dapper: [a]/ˈdæpər/; [adj]干净利落的,衣冠楚楚的; [or]sat;
dappled: [a]/ˈdæpld/; [adj]有斑点的,斑驳的; [or]sat;
daub: [a]/dɔːb/; [v]涂抹,乱画; [n]涂抹,涂料,拙劣的画; [or]sat;
daunt: [a]/dɔːnt/; [v]使气馁,使畏缩,威吓; [or]sat;
dauntless: [a]/ˈdɔːntləs/; [adj]勇敢的,无畏的;不屈不挠的; [or]sat;
dawdle: [a]/ˈdɔːdl/; [v]闲荡,浪费时间; [or]sat;
deadlock: [a]/ˈdedlɑːk/; [vt](使)相持不下; [vi]僵持; [n]僵局;不分胜负; [or]sat;
deadpan: [a]/ˈdedpæn/; [adj]面无表情的; [adv]面无表情地; [or]sat;
dearth: [a]/dɜːrθ/; [n]缺乏,供应不足; [or]sat;
debacle: [a]/dɪˈbɑːkl/; [n]解冻,崩溃;灾害; [or]sat;
debase: [a]/dɪˈbeɪs/; [v]贬值,降低; [or]sat;
debauch: [a]/dɪ'bɔːtʃ/; [v]诱骗;使堕落; [n]放荡; [or]sat;
debilitate: [a]/dɪˈbɪlɪteɪt/; [v]使衰弱; [or]sat;
debonair: [a]/ˌdebəˈner/; [adj]温文尔雅的; [or]sat;
debris: [a]/dəˈbriː/; [n]废墟,残骸; [or]sat;
debunk: [a]/ˌdiːˈbʌŋk/; [v]揭穿真面目,证明为假; [or]sat;
decadence: [a]/ˈdekədəns/; [n]堕落,颓废;衰落; [or]sat;
decapitate: [a]/dɪˈkæpɪteɪt/; [vt]将.斩首;把.强行解雇;使无效; [n]斩首,杀头;刽子手; [or]sat;
decelerate: [a]/ˌdiːˈseləreɪt/; [v](使)减速; [or]sat;
deciduous: [a]/dɪˈsɪdʒuəs/; [adj]落叶性的,脱落性的;非永久性的; [or]sat;
decimate: [a]/ˈdesɪmeɪt/; [v]大量杀死,十中抽一,大量毁灭; [or]sat;
decipher: [a]/dɪˈsaɪfər/; [n]密电译文; [vt]解释;破译; [or]sat;
declivity: [a]/dɪ'klɪvətɪ/; [n]下坡;倾斜; [or]sat;
decomposition: [a]/ˌdiːkɑːmpəˈzɪʃn/; [n]腐败,腐烂;分解; [or]sat;
decorum: [a]/dɪˈkɔːrəm/; [n]礼节,礼貌,端庄,正派; [or]sat;
decoy: [a]/dɪˈkɔɪ/; [n]诱饵;诱骗; [v]诱骗; [or]sat;
decrepit: [a]/dɪˈkrepɪt/; [adj]衰老的,破旧的; [or]sat;
decrepitude: [a]/dɪˈkrepɪtuːd/; [n]衰老,破旧; [or]sat;
decry: [a]/dɪˈkraɪ/; [v]谴责,责难,诽谤; [or]sat;
deducible: [a]/dɪˈduːsəbl/; [adj]可推论的; [or]sat;
deface: [a]/dɪˈfeɪs/; [v]损伤外观,丑化; [or]sat;
defame: [a]/dɪˈfeɪm/; [v]诽谤,中伤; [or]sat;
default: [a]/dɪˈfɔːlt/; [n]违约;缺席;缺乏;默认; [vi]不履行义务;拖欠; [vt]不履行;不参加; [or]sat;
defer: [a]/dɪˈfɜːr/; [v]使推迟,使延期;听从,顺从; [vi]延期; [or]sat;
deference: [a]/ˈdefərəns/; [n]尊敬,尊重;顺从; [or]sat;
defiance: [a]/dɪˈfaɪəns/; [n]蔑视;反抗;挑战; [or]sat;
defile: [a]/dɪˈfaɪl/; [v]污损,弄脏;以纵队前进; [n]狭谷;隘路; [or]sat;
definitive: [a]/dɪˈfɪnətɪv/; [adj]可靠的,明确的,权威的;决定性的; [or]sat;
deflect: [a]/dɪˈflekt/; [v](使)偏斜,(使)偏转; [or]sat;
defoliate: [a]/ˌdiːˈfoʊlieɪt/; [v]落叶; [adj]〈罕〉落了叶的; [or]sat;
defray: [a]/dɪˈfreɪ/; [v]支出;支付; [or]sat;
deft: [a]/deft/; [adj]灵巧的,敏捷的,熟练的; [or]sat;
defunct: [a]/dɪˈfʌŋkt/; [adj]已故的,不复存在的;不再使用的; [or]sat;
defuse: [a]/ˌdiːˈfjuːz/; [vi]平息,变弱; [vt]拆除;使消除危险性,平息; [or]sat;
degenerate: [a]/dɪˈdʒenəreɪt/; [v]堕落,衰减; [adj]腐化的,颓废的,退化的;变质的; [n]堕落者; [or]sat;
degradation: [a]/ˌdeɡrəˈdeɪʃn/; [n]降级,降格;退化;恶化; [or]sat;
dehydrate: [a]/diːˈhaɪdreɪt/; [v]除去水份,脱水; [or]sat;
deify: [a]/ˈdeɪɪfaɪ/; [v]奉为神;崇拜; [or]sat;
deign: [a]/deɪn/; [v]屈尊,惠允(做某事); [or]sat;
delectable: [a]/dɪˈlektəbl/; [adj]令人愉快的;美味的; [or]sat;
delete: [a]/dɪˈliːt/; [v]删除; [or]sat;
deleterious: [a]/ˌdeləˈtɪriəs/; [adj]有害的;有毒的; [or]sat;
deliberate: [a]/dɪˈlɪbərət/; [adj]故意的;深思熟虑的;从容不迫的; [v]仔细考虑;研讨; [or]sat;
delineate: [a]/dɪˈlɪnieɪt/; [v]描画;画出..轮廓; [or]sat;
delirium: [a]/dɪˈlɪriəm/; [n]神志不清,极度兴奋; [or]sat;
delude: [a]/dɪˈluːd/; [v]欺骗,哄骗; [or]sat;
deluge: [a]/ˈdeljuːdʒ/; [n]洪水;暴雨;泛滥; [v]使泛滥;压倒; [or]sat;
delusion: [a]/dɪˈluːʒn/; [n]错觉; [or]sat;
delve: [a]/delv/; [v]钻研;探究;挖; [n]穴;洞; [or]sat;
demagogue: [a]/ˈdeməɡɑːɡ/; [n]煽动者; [or]sat;
demean: [a]/dɪˈmiːn/; [v]贬抑,降低; [or]sat;
demeanor: [a]/dɪ'miːnə/; [n]举止,行为,风度; [or]sat;
demented: [a]/dɪˈmentɪd/; [adj]发狂的,精神错乱的; [v]精神错乱;变得痴呆; [or]sat;
demise: [a]/dɪˈmaɪz/; [n]死亡,终结; [or]sat;
demolition: [a]/ˌdeməˈlɪʃn/; [n]拆除(等于demolishment);破坏,毁坏; [or]sat;
demoniac: [a]/dɪˈmoʊnɪæk/; [n]着魔的人; [adj]魔鬼的;着魔的; [or]sat;
demur: [a]/dɪˈmɜːr/; [n]异议; [v]异议,反对,拒绝; [or]sat;
demure: [a]/dɪˈmjʊr/; [adj]严肃的;端庄的,娴静的;假装正直的; [or]sat;
denigrate: [a]/ˈdenɪɡreɪt/; [v]抹黑,贬低; [or]sat;
denizen: [a]/ˈdenɪzn/; [n]居民,外籍居民; [or]sat;
denouement: [a]/ˌdeɪnuːˈmɑ̃ː/; [n]结局,终场; [or]sat;
denounce: [a]/dɪˈnaʊns/; [v]谴责,斥责; [or]sat;
depict: [a]/dɪˈpɪkt/; [v]描绘,描写; [or]sat;
deplete: [a]/dɪˈpliːt/; [v]使大大减少;耗尽,用尽; [or]sat;
deplore: [a]/dɪˈplɔːr/; [v]谴责;对...深感遗憾;悲悼;痛惜; [or]sat;
deploy: [a]/dɪˈplɔɪ/; [v]部署,设置;展开,散开; [or]sat;
depose: [a]/dɪˈpoʊz/; [v]免职,废黜,作证; [or]sat;
deposition: [a]/ˌdepəˈzɪʃn/; [n]证言,沉积物,矿床,革职; [or]sat;
depravity: [a]/dɪˈprævəti/; [n][n]恶劣行为;堕落,腐败,邪恶;腐败;邪恶;恶劣行为,腐化堕落的行为; [or]sat;
deprecate: [a]/ˈdeprəkeɪt/; [v]反对;轻视; [or]sat;
depreciate: [a]/dɪˈpriːʃieɪt/; [v]贬低,轻视;贬值;折旧; [or]sat;
depredation: [a]/ˌdeprəˈdeɪʃn/; [n]掠夺,破坏; [or]sat;
deranged: [a]/dɪˈreɪndʒd/; [adj]不理智;疯狂的; [or]sat;
derelict: [a]/ˈderəlɪkt/; [adj]渎职的,荒废的,被弃置的; [n]失业贫穷的无家可归者; [or]sat;
deride: [a]/dɪˈraɪd/; [v]嘲弄,愚弄; [or]sat;
derivative: [a]/dɪˈrɪvətɪv/; [n]派生物;<化学>衍生物; [adj]被引申出的,被诱导的;衍生的;第二手的; [or]sat;
dermatologist: [a]/ˌdɜːrməˈtɑːlədʒɪst/; [n]皮肤科; [or]sat;
derogatory: [a]/dɪˈrɑːɡətɔːri/; [adj]不敬的,诽谤的; [or]sat;
descry: [a]/dɪˈskraɪ/; [v]远远看到,望见; [or]sat;
desecrate: [a]/ˈdesɪkreɪt/; [v]亵渎,玷污; [or]sat;
desiccate: [a]/'desɪˌkeɪt/; [v](使)完全干涸,脱水; [or]sat;
desolate: [a]/ˈdesələt/; [adj]荒凉的;孤单寂寞的; [or]sat;
despise: [a]/dɪˈspaɪz/; [vt]轻视,蔑视,看不起; [or]sat;
despoil: [a]/dɪˈspɔɪl/; [v]掠夺,剥夺;夺取; [or]sat;
despondent: [a]/dɪˈspɑːndənt/; [adj]失望的,意气消沉的,没有精神的; [or]sat;
despot: [a]/ˈdespɑːt/; [n]专制君主,暴君;独裁者; [or]sat;
destitute: [a]/ˈdestɪtuːt/; [adj]贫穷的,缺乏的; [or]sat;
desultory: [a]/ˈdesəltɔːri/; [adj]散漫的,无目的的,断断续续的; [or]sat;
detached: [a]/dɪˈtætʃt/; [adj]孤立的,分开的,超然公平的; [or]sat;
detergent: [a]/dɪˈtɜːrdʒənt/; [n]洗涤剂,清洁剂; [or]sat;
determination: [a]/dɪˌtɜːrmɪˈneɪʃn/; [n]决定;确定;决心; [or]sat;
deterrent: [a]/dɪˈtɜːrənt/; [n]威慑物; [v]威慑的; [or]sat;
detonation: [a]/ˌdetəˈneɪʃn/; [n]爆炸;爆炸声;爆发; [or]sat;
detrimental: [a]/ˌdetrɪˈmentl/; [adj]有害的,不利的; [or]sat;
deviate: [a]/ˈdiːvieɪt/; [v]偏离;背离; [adj]脱离常轨的; [n]脱离常轨的人; [or]sat;
devious: [a]/ˈdiːviəs/; [adj]迂回弯曲的,狡猾的; [or]sat;
devise: [a]/dɪˈvaɪz/; [v]设计,想出;密谋;遗赠(不动产); [n]设计,发明,遗赠; [or]sat;
devoid: [a]/dɪˈvɔɪd/; [adj]全无的,缺乏的; [or]sat;
devotee: [a]/ˌdevəˈtiː/; [n]爱好者;信徒; [or]sat;
devout: [a]/dɪˈvaʊt/; [adj]虔诚的,真挚的,诚恳的; [n]虔诚;真挚,诚恳; [or]sat;
dexterous: [a]/ˈdekstrəs/; [adj]灵巧的,熟练的; [or]sat;
diabolical: [a]/ˌdaɪəˈbɑːlɪkl/; [adj]恶毒的,狠毒的; [or]sat;
diagnosis: [a]/ˌdaɪəɡˈnoʊsɪs/; [n]诊断; [or]sat;
discomfit: [a]/dɪsˈkʌmfɪt/; [v]挫败,扰乱,破坏,使.为难; [or]sat;
discomposure: [a]/ˌdɪskəmˈpoʊʒər/; [n]不安,心乱,狼狈; [or]sat;
disconcert: [a]/ˌdɪskənˈsɜːrt/; [v]使仓皇失措;使困惑;破坏; [or]sat;
disconsolate: [a]/dɪsˈkɑːnsələt/; [adj]郁郁不乐的,孤独的,前途黯淡的; [or]sat;
discord: [a]/ˈdɪskɔːrd/; [n]不和,争吵;(声音)不和谐; [or]sat;
discordant: [a]/dɪsˈkɔːrdənt/; [adj]不和谐的,刺耳的,不一致的; [or]sat;
discount: [a]/ˈdɪskaʊnt/; [n](价格,债款等)折扣; [v]打折扣,不全信,怀疑地看待; [or]sat;
discourse: [a]/ˈdɪskɔːrs/; [n]交谈,演讲,论述,讲道; [v]演讲,谈论; [or]sat;
discredit: [a]/dɪsˈkredɪt/; [v]使不相信,使怀疑;败坏.的名声; [n]丧失信誉,丧失名誉;败坏名声的人或事,耻辱; [or]sat;
discrepancy: [a]/dɪsˈkrepənsi/; [n]不一致,差异,不符; [or]sat;
discrete: [a]/dɪˈskriːt/; [adj]分开的;不连续的; [or]sat;
discretion: [a]/dɪˈskreʃn/; [n]自由裁量权;谨慎;判断力;判定;考虑周到; [or]sat;
discursive: [a]/dɪsˈkɜːrsɪv/; [adj](谈话内容)杂乱的,东拉西扯的,无层次的; [or]sat;
disdain: [a]/dɪsˈdeɪn/; [n]蔑视,鄙视; [vt]鄙视;不屑; [or]sat;
disembark: [a]/ˌdɪsɪmˈbɑːrk/; [vi]上岸,登陆,下车,下飞机; [vt]使上岸;使登陆; [or]sat;
disengage: [a]/ˌdɪsɪnˈɡeɪdʒ/; [v]分开; [or]sat;
disfigure: [a]/dɪsˈfɪɡjər/; [v]损伤外貌,使变丑; [or]sat;
disgorge: [a]/dɪsˈɡɔːrdʒ/; [v]涌出,流出;吐出; [or]sat;
dishearten: [a]/dɪsˈhɑːrtn/; [v]使灰心,使沮丧; [or]sat;
disheveled: [a]/dɪ'ʃevəld/; [adj]不整洁的;凌乱的; [v]使(头发等)蓬松; [or]sat;
disinclination: [a]/ˌdɪsˌɪnklɪˈneɪʃn/; [n]不感兴趣,厌恶; [or]sat;
disinter: [a]/ˌdɪsɪnˈtɜːr/; [v]掘出;发掘;显露; [or]sat;
disinterested: [a]/dɪsˈɪntrəstɪd/; [adj]公正的;不感兴趣的;无私的;廉洁的; [or]sat;
disjointed: [a]/dɪsˈdʒɔɪntɪd/; [adj]杂乱的,无逻辑的,脱节的; [or]sat;
dislodge: [a]/dɪsˈlɑːdʒ/; [v]驱逐;移去;取出; [or]sat;
dismantle: [a]/dɪsˈmæntl/; [v]拆开;拆除; [or]sat;
dismay: [a]/dɪsˈmeɪ/; [n]失望;沮丧;惊愕; [v]使惊恐; [or]sat;
dismember: [a]/dɪsˈmembər/; [v]肢解;瓜分; [or]sat;
dismiss: [a]/dɪsˈmɪs/; [v]开除;解散;摒除,不再考虑; [or]sat;
disparage: [a]/dɪˈspærɪdʒ/; [v]蔑视;贬损; [or]sat;
disparate: [a]/ˈdɪspərət/; [adj]迥然不同的; [or]sat;
disparity: [a]/dɪˈspærəti/; [n]不同,不一致,不等; [or]sat;
dispassionate: [a]/dɪsˈpæʃənət/; [adj]平心静气的,不带感情的; [or]sat;
dispatch: [a]/dɪˈspætʃ/; [v]派遣,调遣;发送(信件,电报等);结束,摆脱掉;匆匆办完; [vt]处决; [n]派遣,调遣;发送;快信,急件;迅速,敏捷; [or]sat;
dispel: [a]/dɪˈspel/; [v]驱散,驱逐;消除(烦恼等); [or]sat;
disperse: [a]/dɪˈspɜːrs/; [v]使散开;分散,散开; [or]sat;
dispirited: [a]/dɪˈspɪrɪtɪd/; [adj]沮丧的;消沉的;情绪低落的;灰心的; [or]sat;
disputatious: [a]/ˌdɪspjʊ'teɪʃəs/; [adj]好争辩的; [or]sat;
disquiet: [a]/dɪsˈkwaɪət/; [n]担心,焦虑; [v]使不安,使忧虑; [or]sat;
dissemble: [a]/dɪˈsembl/; [v]掩饰;假装;隐藏,掩饰; [or]sat;
disseminate: [a]/dɪˈsemɪneɪt/; [v]宣传,传播;散布; [or]sat;
dissent: [a]/dɪˈsent/; [v]不同意;不信奉国教; [n]异议;(大写)不信奉国教; [or]sat;
dissertation: [a]/ˌdɪsərˈteɪʃn/; [n](博士学位)论文;学术演讲;专题; [or]sat;
dissident: [a]/ˈdɪsɪdənt/; [n]唱反调者;持不同政见者,意见不同的人; [adj]持不同政见的,意见不同的; [or]sat;
dissipate: [a]/ˈdɪsɪpeɪt/; [v]消散,消失;浪费; [or]sat;
dissolute: [a]/ˈdɪsəluːt/; [adj]无节制的;放荡的; [or]sat;
dissolution: [a]/ˌdɪsəˈluːʃn/; [n](婚姻,组织,议会等的) 解散;毁灭,消失; [or]sat;
dissonance: [a]/ˈdɪsənəns/; [n]不一致;不调和;不和谐音; [or]sat;
dissuade: [a]/dɪˈsweɪd/; [v]劝阻,阻止; [or]sat;
distant: [a]/ˈdɪstənt/; [adj]遥远的;远方的;疏远的; [or]sat;
distend: [a]/dɪˈstend/; [v]膨胀;胀大;扩张; [or]sat;
distill: [a]/dɪˈstɪl/; [v]抽出..的精华;蒸馏; [or]sat;
distinction: [a]/dɪˈstɪŋkʃn/; [n]差别,区分;优秀,卓越,杰出;特性,独特,不同凡响;优等评分,荣誉分数,殊荣; [or]sat;
distort: [a]/dɪˈstɔːrt/; [v]扭曲,使变形;歪曲,曲解; [or]sat;
distraught: [a]/dɪˈstrɔːt/; [adj]发狂的;心烦意乱的; [or]sat;
diurnal: [a]/daɪˈɜːrnl/; [adj]白天的;每日的;日间活动的; [or]sat;
diva: [a]/ˈdiːvə/; [n]著名女歌唱家,歌剧女主角; [or]sat;
diverge: [a]/daɪˈvɜːrdʒ/; [v]分歧,分开; [or]sat;
divergent: [a]/daɪˈvɜːrdʒənt/; [adj]叉开的;分歧的; [or]sat;
diverse: [a]/daɪˈvɜːrs/; [adj]不同的,差异的,多种多样的; [or]sat;
diversion: [a]/daɪˈvɜːrʒn/; [n]绕行路;转移,改变方向;分心,消遣;分水渠; [or]sat;
diversity: [a]/daɪˈvɜːrsəti/; [n]多样性,差异,分集; [or]sat;
divest: [a]/daɪˈvest/; [v]剥夺;使脱去;迫使放弃; [or]sat;
divine: [a]/dɪˈvaɪn/; [adj]神的,神圣的;极好的; [v](凭直觉)发现,猜到; [n]神学家;圣职人员;教士;上帝; [or]sat;
divulge: [a]/daɪˈvʌldʒ/; [v]泄露,透露; [or]sat;
docile: [a]/ˈdɑːsl/; [adj]驯服的,温顺的; [or]sat;
doctrinaire: [a]/ˌdɑːktrəˈner/; [adj]教条主义的,空谈理论的; [n]空论家,纯理论家; [or]sat;
doctrine: [a]/ˈdɑːktrɪn/; [n]教条,学说,信条,原则; [or]sat;
document: [a]/ˈdɑːkjumənt/; [n]文件,公文;(计算机的)文档; [v]记录;证明; [or]sat;
doff: [a]/dɑːf/; [v]脱掉(外衣,帽子); [or]sat;
dogged: [a]/ˈdɔːɡɪd/; [adj]顽强的;顽固的; [vt]跟踪;尾随; [or]sat;
doggerel: [a]/ˈdɔːɡərəl/; [n]糟糕的诗歌; [or]sat;
dogmatic: [a]/dɔːɡˈmætɪk/; [adj]教条的,武断的; [or]sat;
doldrums: [a]/ˈdoʊldrəmz/; [n](海洋上的)无风带,情绪低沉; [or]sat;
doleful: [a]/ˈdoʊlfl/; [adj]寂寞的;悲哀的;阴沉的; [or]sat;
dolt: [a]/doʊlt/; [n]笨蛋,傻瓜; [or]sat;
domicile: [a]/ˈdɑːmɪsaɪl/; [n]住宅;永久居住地;期票支付场所; [v]居住;使在指定的场所支付(期票等; [adj]定居;在固定住所生活; [or]sat;
don: [a]/dɑːn/; [n]指导教师,大学教师;先生,阁下; [vt]穿上; [or]sat;
doodle: [a]/ˈduːdl/; [v](无目的地)乱画,漫无目的地打发时光; [n]涂鸦; [or]sat;
dormant: [a]/ˈdɔːrmənt/; [adj]睡眠的,休眠的;静止的,隐伏的; [or]sat;
dossier: [a]/ˈdɔːsieɪ/; [n]档案,卷宗;病历表册; [or]sat;
dote: [a]/doʊt/; [v]溺爱;昏愦; [or]sat;
douse: [a]/daʊs/; [v]把.浸入水中,用水泼; [or]sat;
dowdy: [a]/ˈdaʊdi/; [adj]懒散的,过时的,寒酸的; [n]邋遢女人; [or]sat;
downcast: [a]/ˈdaʊnkæst/; [adj]意志消沉的,垂头丧气的,朝下的; [n]没落;俯视;<地>下落;<矿>通风井; [or]sat;
drab: [a]/dræb/; [adj]枯黄色的,无聊的,单调的; [n]单调;淡褐色;[印,纺]淡褐色厚呢;邋遢女人; [or]sat;
draconian: [a]/drəˈkoʊniən/; [adj]严峻的,苛刻的; [or]sat;
dregs: [a]/dreɡz/; [n]渣滓;少量;沉淀物; [or]sat;
drivel: [a]/ˈdrɪvl/; [n]胡言乱语; [v]胡言乱语,说傻话; [or]sat;
droll: [a]/droʊl/; [adj]滑稽的;好笑的;逗趣的; [n]逗人发笑的人;滑稽演员;小丑; [v]开玩笑; [adv]古里古怪地,滑稽地; [or]sat;
drone: [a]/droʊn/; [n]无人机,无人驾驶飞机;雄蜂;单调的低音; [v]嗡嗡地响; [vi]混日子; [or]sat;
dross: [a]/drɔːs/; [n]废料,浮渣,渣滓; [vt]除去.上的浮渣; [or]sat;
drudgery: [a]/ˈdrʌdʒəri/; [n]苦工;苦差事;单调乏味的工作; [or]sat;
dubious: [a]/ˈduːbiəs/; [adj]可疑的;怀疑的;无把握的; [or]sat;
ductile: [a]/ˈdʌktaɪl/; [adj](某些金属)有延展性的;可塑的;易受影响的; [or]sat;
dulcet: [a]/ˈdʌlsɪt/; [adj]美妙的;悦耳的;怡人的; [or]sat;
dupe: [a]/duːp/; [n]受骗的人,上当者; [v]欺骗,愚弄; [or]sat;
duplicity: [a]/duːˈplɪsəti/; [n]口是心非;表里不一;不诚实; [or]sat;
duration: [a]/duˈreɪʃn/; [n]持续;持续期间;持续的时间; [or]sat;
dutiful: [a]/ˈduːtɪfl/; [adj]顺从的,尽职的;有责任心的; [or]sat;
dwarf: [a]/dwɔːrf/; [n]侏儒; [v]变矮;发育不全; [adj]矮生动物或植物的;矮小的;发育不全的; [vt]使矮小;阻碍.的发育; [or]sat;
dwindle: [a]/ˈdwɪndl/; [v]日渐减少,变小,缩小; [or]sat;
dynamic: [a]/daɪˈnæmɪk/; [adj]有活力的,有生气的;不断变化的;动态的; [n]活力,动力; [or]sat;
ebb: [a]/eb/; [n]退潮;退潮期;衰退; [v]退潮;衰退; [or]sat;
ebullient: [a]/ɪˈbʌliənt/; [adj]热情洋溢的,沸腾的; [or]sat;
eccentricity: [a]/ˌeksenˈtrɪsəti/; [n]古怪;怪癖;<数>离心率; [or]sat;
eclectic: [a]/ɪˈklektɪk/; [adj]折衷主义的;选择的; [n]折衷主义者,折衷派的人; [or]sat;
eclipse: [a]/ɪˈklɪps/; [n](日,月)食;黯然失色; [v]掩盖..的重要性;使暗淡; [or]sat;
ecologist: [a]/iˈkɑːlədʒɪst/; [n]生态学家,生态学者; [or]sat;
economy: [a]/ɪˈkɑːnəmi/; [n]经济,经济制度;节约; [or]sat;
ecstasy: [a]/ˈekstəsi/; [n]狂喜,心醉神怡; [or]sat;
eddy: [a]/ˈedi/; [n]漩涡; [v]旋转;起漩涡; [or]sat;
edict: [a]/ˈiːdɪkt/; [n]法令,布告; [or]sat;
edify: [a]/ˈedɪfaɪ/; [vt]教诲,启发,熏陶; [or]sat;
eerie: [a]/ˈɪri/; [adj]胆怯的,引起恐惧的; [or]sat;
efface: [a]/ɪˈfeɪs/; [v]擦掉,抹去;消去; [or]sat;
efficacy: [a]/ˈefɪkəsi/; [n]功效,效力; [or]sat;
effigy: [a]/ˈefɪdʒi/; [n]肖像,模拟像; [or]sat;
effrontery: [a]/ɪˈfrʌntəri/; [n]厚颜无耻; [or]sat;
effusive: [a]/ɪˈfjuːsɪv/; [adj]流出的;感情奔放的; [or]sat;
egregious: [a]/ɪˈɡriːdʒiəs/; [adj]非常恶劣的,过分的;恶名昭彰的;惊人的; [or]sat;
egress: [a]/ˈiːɡres/; [n]出去,出口; [or]sat;
elated: [a]/iˈleɪtɪd/; [adj]得意洋洋的;振奋的; [or]sat;
elegy: [a]/ˈelədʒi/; [n]挽歌,哀歌; [or]sat;
elicit: [a]/iˈlɪsɪt/; [v]引出;诱出;探出; [or]sat;
elixir: [a]/ɪˈlɪksər/; [n]不老长寿药;万能药;炼金药; [or]sat;
ellipsis: [a]/ɪˈlɪpsɪs/; [n]省略,省略符号; [or]sat;
elliptical: [a]/ɪˈlɪptɪkl/; [adj]椭圆的;省略的; [or]sat;
eloquence: [a]/ˈeləkwəns/; [n]雄辩,口才;文采; [or]sat;
elucidate: [a]/iˈluːsɪdeɪt/; [v]阐明,说明; [or]sat;
elusive: [a]/iˈluːsɪv/; [adj]难懂的;难捉摸的;难找的;难懂的;易忘的;逃避的;难捉摸的; [or]sat;
emaciated: [a]/ɪˈmeɪʃieɪtɪd/; [adj]瘦弱的;憔悴的; [or]sat;
emanate: [a]/ˈeməneɪt/; [v]发出;放射; [or]sat;
emancipate: [a]/ɪˈmænsɪpeɪt/; [v]解放;释放; [or]sat;
embargo: [a]/ɪmˈbɑːrɡoʊ/; [v]禁止出入港口;禁止或限制贸易;征用或扣押; [n]禁令;禁止;封港令; [or]sat;
embark: [a]/ɪmˈbɑːrk/; [v]上船或飞机;开始,着手,从事; [or]sat;
embed: [a]/ɪmˈbed/; [v]把.嵌入;使嵌入; [or]sat;
embellish: [a]/ɪmˈbelɪʃ/; [vt]装饰; [v]吹嘘;润色(文章); [vi]装饰起来;加以润色;添加细节,对...添枝加叶; [or]sat;
embezzlement: [a]/ɪmˈbezlmənt/; [n]贪污;侵占;挪用; [or]sat;
embody: [a]/ɪmˈbɑːdi/; [v]包含;体现,象征; [or]sat;
embrace: [a]/ɪmˈbreɪs/; [v]拥抱;包含;欣然接受,乐意采纳; [n]拥抱;接受;领会; [or]sat;
embroider: [a]/ɪmˈbrɔɪdər/; [v]刺绣,绣花;润色,渲染; [or]sat;
embroil: [a]/ɪmˈbrɔɪl/; [v]使卷入;使混乱; [or]sat;
embryonic: [a]/ˌembriˈɑːnɪk/; [adj]<生物学>胚胎的;初期的; [or]sat;
eminent: [a]/ˈemɪnənt/; [adj]显赫的;杰出的;有名的;(品质)优良的; [or]sat;
emissary: [a]/ˈemɪseri/; [n]代理,信使,使者; [or]sat;
emollient: [a]/iˈmɑːliənt/; [n]润肤剂; [or]sat;
empathy: [a]/ˈempəθi/; [n]共鸣,同感;移情作用; [or]sat;
emulate: [a]/ˈemjuleɪt/; [v]努力赶上(超过),仿效; [n]仿真; [or]sat;
enamored: [a]/ɪˈnæmə(r)d/; [adj]迷恋的;倾心的; [or]sat;
enclave: [a]/ˈenkleɪv/; [n]飞地(指在本国境内的隶属另一国的一块领土),被包围的领土,被包围物; [or]sat;
encomium: [a]/enˈkoʊmiəm/; [n]赞美; [or]sat;
encompass: [a]/ɪnˈkʌmpəs/; [vt]环绕,包围;包含;完成; [or]sat;
encumber: [a]/ɪnˈkʌmbər/; [v]阻塞,妨害,拖累; [or]sat;
endemic: [a]/enˈdemɪk/; [adj]地方性的; [n]地方病; [or]sat;
endorse: [a]/ɪnˈdɔːrs/; [v]赞同,认可;签注(文件); [or]sat;
enduring: [a]/ɪnˈdʊrɪŋ/; [adj]持久的,不朽的;能忍受的; [or]sat;
energize: [a]/ˈenərdʒaɪz/; [v]使活跃;给予精力;使兴奋; [or]sat;
enervate: [a]/ˈenərveɪt/; [v]使虚弱;使无力; [or]sat;
enfranchise: [a]/ɪnˈfræntʃaɪz/; [v]给予选举权,释放(奴隶); [or]sat;
engage: [a]/ɪnˈɡeɪdʒ/; [vt]吸引住(注意力,兴趣);雇,聘; [vi]使加入,使融入;订婚; [v](军队)交战;啮合; [or]sat;
engaging: [a]/ɪnˈɡeɪdʒɪŋ/; [adj]迷人的; [or]sat;
engender: [a]/ɪnˈdʒendər/; [v]产生; [or]sat;
engross: [a]/ɪnˈɡroʊs/; [v]独占;正式誊写;使全神贯注于;用大字体书写; [or]sat;
enhance: [a]/ɪnˈhæns/; [v]提高(强度,力量,数量等);增加,加强; [or]sat;
enigma: [a]/ɪˈnɪɡmə/; [n]谜,哑谜;闷葫芦; [or]sat;
enigmatic: [a]/ˌenɪɡˈmætɪk/; [adj]神秘的,高深莫测的,谜一般的; [or]sat;
enmity: [a]/ˈenməti/; [n]敌意,憎恨; [or]sat;
enormity: [a]/ɪˈnɔːrməti/; [n]巨大;暴行;极恶; [or]sat;
enrapture: [a]/ɪnˈræptʃər/; [v]使狂喜,使高兴; [or]sat;
ensconce: [a]/ɪnˈskɑːns/; [v]安置;安顿下来;使.隐藏; [or]sat;
ensemble: [a]/ɑːnˈsɑːmbl/; [n]合唱团,表演团体;总效果;全套服装;全套家具; [or]sat;
enterprising: [a]/ˈentərpraɪzɪŋ/; [adj]有事业心的,有进取心的,有魅力的,有胆量的;有魄力的; [or]sat;
enthrall: [a]/ɪnˈθrɔl/; [v]迷惑,迷住; [or]sat;
entice: [a]/ɪnˈtaɪs/; [v]怂恿,引诱; [or]sat;
entitlement: [a]/ɪnˈtaɪtlmənt/; [n]权利,津贴; [or]sat;
entomology: [a]/ˌentəˈmɑːlədʒi/; [n]昆虫学; [or]sat;
entourage: [a]/ˈɑːnturɑːʒ/; [n]随从,周围,环境; [or]sat;
entrance: [a]/ˈentrəns/; [n]入口,通道,大门口;出场,登场;进入权; [v]使出神,使入迷; [or]sat;
entreat: [a]/ɪnˈtriːt/; [v]恳求,请求; [or]sat;
entrepreneur: [a]/ˌɑːntrəprəˈnɜːr/; [n]企业家,演出承包人; [or]sat;
enumerate: [a]/ɪˈnuːməreɪt/; [v]列举; [or]sat;
enunciate: [a]/əˈnʌnsieɪt/; [v]发音,阐明,宣布; [or]sat;
ephemeral: [a]/ɪˈfemərəl/; [adj]短暂的,短命的; [n]生存极短时间的事物; [or]sat;
epic: [a]/ˈepɪk/; [adj]史诗的,叙事诗的;壮丽的,宏大的; [n]史诗;叙事诗;史诗般的作品; [or]sat;
epicure: [a]/ˈepɪkjʊr/; [n]美食家;享乐主义者; [or]sat;
epigram: [a]/ˈepɪɡræm/; [n]机智的言语; [or]sat;
epilogue: [a]/ˈepɪlɔːɡ/; [n]收场白;尾声; [or]sat;
epitaph: [a]/ˈepɪtæf/; [n]碑文,墓志铭; [or]sat;
epithet: [a]/ˈepɪθet/; [n]外号,绰号; [or]sat;
epitome: [a]/ɪˈpɪtəmi/; [n]摘要,缩影; [or]sat;
epoch: [a]/ˈepək/; [n]时期;新时代; [or]sat;
equable: [a]/ˈekwəbl/; [adj]温和,平均,稳定的,不变的,(脾气)温和的; [or]sat;
equanimity: [a]/ˌekwəˈnɪməti/; [n]平静,镇定,沉着; [or]sat;
equestrian: [a]/ɪˈkwestriən/; [adj]骑马的;骑术的; [n]骑手,马术家; [or]sat;
equilibrium: [a]/ˌiːkwɪˈlɪbriəm/; [n](心态情感等)平静;平衡; [or]sat;
equine: [a]/ˈiːkwaɪn/; [adj]马的;似马的;马科的; [n]马;马科动物; [or]sat;
equinox: [a]/ˈiːkwɪnɑːks/; [n]春分;秋分;昼夜平分点; [or]sat;
equitable: [a]/ˈekwɪtəbl/; [adj]公正的,公平的; [or]sat;
equity: [a]/ˈekwəti/; [n]公平,公正;衡平法;普通股;抵押资产的净值; [or]sat;
equivocal: [a]/ɪˈkwɪvəkl/; [adj]模棱两可的,不明确的,可疑的; [or]sat;
equivocate: [a]/ɪˈkwɪvəkeɪt/; [v]模棱两可地说,支吾其词; [or]sat;
erode: [a]/ɪˈroʊd/; [v]腐蚀;遭侵蚀,腐蚀,侵蚀;削弱; [vt]损害; [or]sat;
erotic: [a]/ɪˈrɑːtɪk/; [adj]性爱的,性欲的,色情的; [n]好色之徒; [adv]引起性欲地; [or]sat;
erratic: [a]/ɪˈrætɪk/; [adj]古怪的;反复无常的,不稳定的; [or]sat;
erroneous: [a]/ɪˈroʊniəs/; [adj]错误的; [or]sat;
erudite: [a]/ˈerudaɪt/; [adj]博学的,有学问的; [n]饱学之士,有学问的人; [or]sat;
escapade: [a]/ˌeskəˈpeɪd/; [n]越轨行为,恶作剧; [or]sat;
eschew: [a]/ɪsˈtʃuː/; [v]避开;戒绝; [or]sat;
esoteric: [a]/ˌesəˈterɪk/; [adj]秘传的,神秘的,限于少数人的; [n]受秘传的人; [or]sat;
espionage: [a]/ˈespiənɑːʒ/; [n]间谍活动,侦查,监视; [or]sat;
espouse: [a]/ɪˈspaʊz/; [v]支持,拥护; [or]sat;
esteem: [a]/ɪˈstiːm/; [n]尊敬;尊重; [vt]尊敬;认为;考虑;估计; [or]sat;
ethereal: [a]/iˈθɪriəl/; [adj]太空的,轻巧的,像空气的; [or]sat;
ethnic: [a]/ˈeθnɪk/; [adj]种族的,少数民族的; [n]少数民族成员;人种学; [or]sat;
ethos: [a]/ˈiːθɑːs/; [n]民族精神,气质,社会思潮; [or]sat;
etymology: [a]/ˌetɪˈmɑːlədʒi/; [n]语源,语源学; [or]sat;
eulogy: [a]/ˈjuːlədʒi/; [n]颂词,赞美词; [or]sat;
euphemism: [a]/ˈjuːfəmɪzəm/; [n]婉言,委婉的说法; [or]sat;
euphonious: [a]/juːˈfoʊniəs/; [adj]悦耳的;好听的;声音和谐的; [or]sat;
euphoria: [a]/juːˈfɔːriə/; [n]幸福愉快感; [or]sat;
evanescent: [a]/ˌevəˈnesnt/; [adj]短暂的,容易消散的,(印象等)逐渐消失的,会凋零的; [or]sat;
evasive: [a]/ɪˈveɪsɪv/; [adj]逃避的;托辞的,推托的; [or]sat;
evince: [a]/ɪˈvɪns/; [v]表明,表示,引起; [or]sat;
evocative: [a]/ɪˈvɑːkətɪv/; [adj]唤起的;唤出的; [or]sat;
ewe: [a]/juː/; [n]<畜牧>母羊; [or]sat;
exacerbate: [a]/ɪɡˈzæsərbeɪt/; [v]加重;恶化;激怒; [or]sat;
exacting: [a]/ɪɡˈzæktɪŋ/; [adj]苛求的,要求严格的,强索的; [or]sat;
exalt: [a]/ɪɡˈzɔːlt/; [v]提升,提拔,赞扬,使得意; [or]sat;
exasperate: [a]/ɪɡˈzæspəreɪt/; [vt]激怒;加剧; [or]sat;
exceptionable: [a]/ɪk'sepʃənəbəl/; [adj]引起反感的,可反对的,会引起抗议的; [or]sat;
excerpt: [a]/ˈeksɜːrpt/; [n]摘录,节选; [v]摘,选;引用; [or]sat;
excise: [a]/ˈeksaɪz/; [v]切除,删去; [n]消费税,货物税,国产税; [or]sat;
exclaim: [a]/ɪkˈskleɪm/; [v]呼叫,惊叫; [or]sat;
excoriate: [a]/ˌeksˈkɔːrieɪt/; [v]严厉批评,擦伤(皮肤等); [or]sat;
exculpate: [a]/ˈekskʌlpeɪt/; [v]声明无罪,开脱,使无罪; [or]sat;
execrable: [a]/ˈeksɪkrəbl/; [adj]极坏的; [or]sat;
execute: [a]/ˈeksɪkjuːt/; [v]处决;完成(动作);实行;执行(计划); [or]sat;
exemplary: [a]/ɪɡˈzempləri/; [adj]模范的,可仿效的; [or]sat;
exemplify: [a]/ɪɡˈzemplɪfaɪ/; [v]举例说明;例示,是..的典范; [or]sat;
exertion: [a]/ɪɡˈzɜːrʃn/; [n]用力;运用; [or]sat;
exhaustive: [a]/ɪɡˈzɔːstɪv/; [adj]详尽的;彻底的;消耗的; [or]sat;
exhilarating: [a]/ɪɡˈzɪləreɪtɪŋ/; [adj]令人高兴的; [v]使高兴;使兴奋; [or]sat;
exhort: [a]/ɪɡˈzɔːrt/; [vt]敦促,劝告; [vi]规劝,劝告; [or]sat;
exhume: [a]/ɪɡˈzuːm/; [v]发掘,出土; [or]sat;
exigency: [a]/ˈeksɪdʒənsi/; [n]紧急(状态);危急(关头);事变; [or]sat;
exodus: [a]/ˈeksədəs/; [n]大批离去,成群外出; [or]sat;
exonerate: [a]/ɪɡˈzɑːnəreɪt/; [v]使免罪; [or]sat;
exorbitant: [a]/ɪɡˈzɔːrbɪtənt/; [adj]要价过高的,过分的; [or]sat;
exorcise: [a]/ˈeksɔːrsaɪz/; [v]驱邪;除怪; [or]sat;
exotic: [a]/ɪɡˈzɑːtɪk/; [adj]奇异的,珍奇的,来自异国的; [or]sat;
expansive: [a]/ɪkˈspænsɪv/; [adj]广阔的,扩张的,豪爽的; [or]sat;
expatriate: [a]/ˌeksˈpeɪtriət/; [v](使)移居国外;(使)放弃国籍;流放,放逐; [n]被流放者;移居国外者; [adj]移居国外的;被流放的; [or]sat;
expedient: [a]/ɪkˈspiːdiənt/; [n]权宜之计,手段; [adj]有利的,方便的;权宜之计的; [or]sat;
expedite: [a]/ˈekspədaɪt/; [v]加快;促进;发出; [adj]畅通的;迅速的;方便的; [or]sat;
expenditure: [a]/ɪkˈspendɪtʃər/; [n](时间,金钱等的)花费,支出,消耗; [or]sat;
expertise: [a]/ˌekspɜːrˈtiːz/; [n]专门知识,专门技能; [or]sat;
expiate: [a]/ˈekspieɪt/; [v]赎罪,补偿; [or]sat;
expletive: [a]/ˈeksplətɪv/; [n]填补物;咒骂语; [adj]附加的;填补的; [or]sat;
explicate: [a]/ˈeksplɪkeɪt/; [v]详细解说; [or]sat;
explicit: [a]/ɪkˈsplɪsɪt/; [adj]充分表达清楚的,明确的;直率的,直截了当的;〔描绘性或暴力的语言或画面〕清晰露骨的; [or]sat;
exploit: [a]/ɪkˈsplɔɪt/; [v]剥削,利用;开发,开拓; [n]辉煌功绩; [or]sat;
exposure: [a]/ɪkˈspoʊʒər/; [n]暴露,受寒;揭露,揭发;亮相,报道;曝光,曝光时间; [or]sat;
expunge: [a]/ɪkˈspʌndʒ/; [v]删除; [or]sat;
expurgate: [a]/ˈekspərɡeɪt/; [v]净化,删去; [or]sat;
extant: [a]/ekˈstænt/; [adj]现存的;显著的; [or]sat;
extent: [a]/ɪkˈstent/; [n]范围;程度;宽度;长度; [or]sat;
extenuate: [a]/ɪk'stenjʊˌeɪt/; [v]减轻,低估,为.找借口,使人原谅; [or]sat;
extol: [a]/ɪkˈstoʊl/; [v]赞美,称赞,颂扬; [or]sat;
extort: [a]/ɪkˈstɔːrt/; [vt]敲诈,勒索; [or]sat;
extricate: [a]/ˈekstrɪkeɪt/; [v]拯救,救出; [n]解脱;解脱者; [or]sat;
extrinsic: [a]/eksˈtrɪnzɪk/; [adj]外在的,外部的; [or]sat;
extrovert: [a]/ˈekstrəvɜːrt/; [v]变成外向性格;使成外向性格; [n]性格外向者; [adj]性格外向的; [or]sat;
extrude: [a]/ɪkˈstruːd/; [v]挤压出;伸出;逐出; [or]sat;
exude: [a]/ɪɡˈzuːd/; [v]慢慢流出,四溢,渗出,散发; [or]sat;
exult: [a]/ɪɡˈzʌlt/; [v]狂喜,欢欣鼓舞; [or]sat;
fabricate: [a]/ˈfæbrɪkeɪt/; [v]建造,制造,伪造(文件等),捏造,编造(谎言,借口等); [or]sat;
facade: [a]/fəˈsɑːd/; [n]建筑物的正面,外表; [or]sat;
facet: [a]/ˈfæsɪt/; [n](多面体的)面,小平面;琢面,侧面; [vt]在.上琢面; [or]sat;
facetious: [a]/fəˈsiːʃəs/; [adj]滑稽的,诙谐的,开玩笑的; [or]sat;
facilitate: [a]/fəˈsɪlɪteɪt/; [v]为他人提供方便;使便利; [vt]促进; [or]sat;
facsimile: [a]/fækˈsɪməli/; [n]复制本,摹本; [adj]复制的; [v]传真;临摹; [or]sat;
faction: [a]/ˈfækʃn/; [n]派别,小集团,小派系;派系斗争,内讧; [or]sat;
faculty: [a]/ˈfæklti/; [n]教职工,全体教员;系;科;能力; [or]sat;
fallacious: [a]/fəˈleɪʃəs/; [adj]谬误的,易误解的,虚妄的; [or]sat;
fallible: [a]/ˈfæləbl/; [adj]会犯错的,易犯错的; [or]sat;
fallow: [a]/ˈfæloʊ/; [adj]休耕的;不活跃的;休闲地,休闲的; [n]休耕地;休耕; [v]使(翻耕后的土地)休闲; [or]sat;
falter: [a]/ˈfɔːltər/; [v]蹒跚,摇摆;踌躇;畏缩; [n]踌躇;支吾;颤抖; [or]sat;
fanaticism: [a]/fəˈnætɪsɪzəm/; [n]狂热,盲信; [or]sat;
fancy: [a]/ˈfænsi/; [adj]华丽装饰的,别致的,引人注目的;昂贵的,阔气的; [n]喜爱,幻想,想像力; [vt]想象,幻想;迷恋; [or]sat;
fanfare: [a]/ˈfænfer/; [n]夸耀,嘹亮的喇叭声; [v]热闹地介绍<宣布>; [or]sat;
farce: [a]/fɑːrs/; [n]闹剧;胡闹;笑剧; [or]sat;
fastidious: [a]/fæˈstɪdiəs/; [adj]难讨好的,爱挑剔的; [or]sat;
fatalism: [a]/ˈfeɪtəlɪzəm/; [n]宿命论; [or]sat;
fathom: [a]/ˈfæðəm/; [n]英寻(=6英尺); [vi]测量深度; [vt]彻底了解,测深; [or]sat;
fatuous: [a]/ˈfætʃuəs/; [adj]愚昧而不自知的; [or]sat;
fauna: [a]/ˈfɔːnə/; [n]动物区系,动物群; [or]sat;
faze: [a]/feɪz/; [v]打扰,折磨,使狼狈,使担忧; [or]sat;
feasible: [a]/ˈfiːzəbl/; [adj]可行的,行得通的; [or]sat;
feign: [a]/feɪn/; [v]假装,装作; [or]sat;
feint: [a]/feɪnt/; [v]佯攻,虚击; [n]佯攻; [adj]虚假的; [or]sat;
felicity: [a]/fəˈlɪsəti/; [n]幸福,快乐,幸运; [or]sat;
felon: [a]/ˈfelən/; [n]重罪犯; [or]sat;
feral: [a]/ˈferəl/; [adj]未驯服的,野生的;凶猛的; [or]sat;
ferret: [a]/ˈferɪt/; [n]雪貂;白鼬;侦探; [v]搜寻;查获;驱出;用雪貂猎取; [adj]雪貂似的;搜索者般的;爱窥探的; [or]sat;
fervent: [a]/ˈfɜːrvənt/; [adj]热烈的,满怀热情的;狂热的; [or]sat;
fervid: [a]/ˈfɜːrvɪd/; [adj]热的;热心的; [or]sat;
fervor: [a]/ˈfɜrvər/; [n]强烈感情,激情,热情; [or]sat;
fester: [a]/ˈfestər/; [v]溃烂;化脓;使..痛苦;使..恶化; [n]溃烂;脓疮,脓疱; [or]sat;
festive: [a]/ˈfestɪv/; [adj]庆祝的,喜庆的,欢乐的,节日似的; [or]sat;
fetid: [a]/ˈfetɪd/; [adj]有恶臭的; [or]sat;
fetter: [a]/ˈfetər/; [n]脚镣;束缚; [vt]给.上脚镣;束缚; [or]sat;
fiasco: [a]/fiˈæskoʊ/; [n]大失败,惨败; [or]sat;
fickle: [a]/ˈfɪkl/; [adj](在感情等方面)反复无常的,轻浮的,善变的; [or]sat;
fictitious: [a]/fɪkˈtɪʃəs/; [adj]虚构的; [or]sat;
fidelity: [a]/fɪˈdeləti/; [n]忠诚;逼真度,保真度; [or]sat;
figment: [a]/ˈfɪɡmənt/; [n]空想;虚构的理论,故事等; [or]sat;
figurative: [a]/ˈfɪɡərətɪv/; [adj]比喻的,修饰丰富的,形容多的; [or]sat;
figurine: [a]/ˌfɪɡjəˈriːn/; [n]小塑像,小雕像; [or]sat;
filament: [a]/ˈfɪləmənt/; [n]灯丝,细丝; [or]sat;
filch: [a]/fɪltʃ/; [vt]偷窃; [or]sat;
filial: [a]/ˈfɪliəl/; [adj]子女的,孝顺的;<生物>子代的,后代的; [adv]子女地; [or]sat;
filibuster: [a]/ˈfɪlɪbʌstər/; [n]冗长演说; [v]拖延议事; [or]sat;
finesse: [a]/fɪˈnes/; [n]技巧,计谋,策略; [v]以技巧取胜; [or]sat;
finicky: [a]/ˈfɪnɪki/; [adj]苛求的,过份讲究的; [or]sat;
fissure: [a]/ˈfɪʃər/; [v]裂开,龟裂; [n]裂缝,裂隙; [or]sat;
fitful: [a]/ˈfɪtfl/; [adj]发作的,间歇的,不定的; [or]sat;
flaccid: [a]/ˈflæsɪd/; [adj]软弱的,无活力的,没气力的,松弛的; [or]sat;
flagrant: [a]/ˈfleɪɡrənt/; [adj]罪恶昭彰的,残暴的,丑恶可耻的,明目张胆的; [or]sat;
flair: [a]/fler/; [n]天资,特别的本领;敏锐的洞察力;嗜好;格调; [or]sat;
flamboyant: [a]/flæmˈbɔɪənt/; [adj]辉耀的;华丽的,艳丽的;火焰似的; [or]sat;
flaunt: [a]/flɔːnt/; [n]招摇;飘扬;藐视; [vi]炫耀;飘扬; [vt]炫耀; [or]sat;
fleck: [a]/flek/; [n]斑点,斑纹;雀斑;微粒,小片; [v]使起斑点;使有斑纹; [or]sat;
fledgling: [a]/ˈfledʒlɪŋ/; [n]刚学飞的幼鸟,无经验的人; [adj]刚开始的;无经验的; [or]sat;
fleece: [a]/fliːs/; [n]羊毛,羊毛状物; [v]剪羊毛,诈取; [or]sat;
flick: [a]/flɪk/; [n]轻弹,轻打;轻弹声; [v]轻弹;轻轻拂去;(翅)拍动;(旗)飘扬; [or]sat;
flinch: [a]/flɪntʃ/; [v]畏缩,退缩; [n]退缩,畏惧; [or]sat;
flippant: [a]/ˈflɪpənt/; [adj]无礼的,轻率的,随意的; [or]sat;
flit: [a]/flɪt/; [n]轻快的飞行;迁移; [vi]掠过;轻快地飞过;偷偷溜走;去世; [or]sat;
flora: [a]/ˈflɔːrə/; [n]植物群; [or]sat;
florid: [a]/ˈflɔːrɪd/; [adj]涨红的,华丽的,红润的; [or]sat;
flounder: [a]/ˈflaʊndər/; [n]比目鱼;踉跄前进; [v]踉跄前行;(在水或泥浆中)挣扎,陷入困境; [or]sat;
flourish: [a]/ˈflɜːrɪʃ/; [vi]繁荣,茂盛,兴旺; [vt]挥舞;夸耀; [n]兴旺;茂盛;炫耀;挥舞; [or]sat;
flout: [a]/flaʊt/; [n]表示轻蔑的言行;嘲弄;嘲笑; [vi]藐视;嘲弄;嘲笑; [vt]嘲弄;嘲笑;藐视; [or]sat;
fluctuate: [a]/ˈflʌktʃueɪt/; [v]波动;起伏;涨落; [or]sat;
fluency: [a]/ˈfluːənsi/; [n]流畅,流利; [or]sat;
fluke: [a]/fluːk/; [n]侥幸成功;意外的挫折; [v]侥幸做成;意外受挫; [or]sat;
fluster: [a]/ˈflʌstər/; [n]慌乱,狼狈,混乱; [v]使困惑,慌乱; [or]sat;
flux: [a]/flʌks/; [n]流动,不断的变动; [or]sat;
fodder: [a]/ˈfɑːdər/; [n]饲料,草料;(创作的)素材;弹药; [v]喂; [or]sat;
foible: [a]/ˈfɔɪbl/; [n]弱点,小缺点,癖好; [or]sat;
foil: [a]/fɔɪl/; [n]箔;锡箔纸;衬托; [v]挫败;使受挫折; [or]sat;
foliage: [a]/ˈfoʊliɪdʒ/; [n]叶子(总称); [or]sat;
foment: [a]/foʊˈment/; [v]煽动,助长(坏事); [or]sat;
foolhardy: [a]/ˈfuːlhɑːrdi/; [adj]莽撞的,有勇无谋的; [or]sat;
fop: [a]/fɑːp/; [n]花花公子,纨绔子弟; [or]sat;
forbearance: [a]/fɔːrˈberəns/; [n]自制,忍耐;宽容; [or]sat;
ford: [a]/fɔːrd/; [v]涉水,渡河; [n]浅滩; [or]sat;
foreboding: [a]/fɔːrˈboʊdɪŋ/; [n]预感,预兆; [adj]预感的,不祥之兆的; [or]sat;
forensic: [a]/fəˈrensɪk/; [adj]科学手段的,法庭的,辩论的; [n]辩论练习;辩论学,辩论术; [or]sat;
foreshadow: [a]/fɔːrˈʃædoʊ/; [v]预示; [n]预兆; [or]sat;
foresight: [a]/ˈfɔːrsaɪt/; [n]先见,预见;远见,深谋远虑; [or]sat;
forestall: [a]/fɔːrˈstɔːl/; [v]领先;占先一步;先发制人,阻止,妨碍;垄断;占先一步; [or]sat;
forgo: [a]/fɔːrˈɡoʊ/; [v]放弃;停止;对.断念; [or]sat;
forlorn: [a]/fərˈlɔːrn/; [adj]被遗弃的; [or]sat;
formality: [a]/fɔːrˈmæləti/; [n]得体;程序;拘谨;礼节;一丝不苟;单纯为形式而做的事; [or]sat;
formidable: [a]/ˈfɔːrmɪdəbl/; [adj]令人畏惧的;可怕的;难以克服的;难应付的; [or]sat;
forsake: [a]/fərˈseɪk/; [v]放弃;抛弃,离开; [or]sat;
forswear: [a]/fɔːrˈswer/; [v]誓绝,放弃; [or]sat;
forte: [a]/fɔːrt/; [n]长处,特长; [adj]强音的;响的; [adv]响亮地; [or]sat;
forthright: [a]/ˈfɔːrθraɪt/; [adj]直接的,直率的,坦白的,豪爽的; [adv]马上,立即; [n]直路; [or]sat;
fortitude: [a]/ˈfɔːrtətuːd/; [n]坚强意志(精神),坚忍,刚毅; [or]sat;
fortuitous: [a]/fɔːrˈtuːɪtəs/; [adj]偶然的;幸运的; [or]sat;
forum: [a]/ˈfɔːrəm/; [n]论坛;讨论会; [or]sat;
foster: [a]/ˈfɔːstər/; [adj]收养的; [vt]养育;培养,促进; [or]sat;
founder: [a]/ˈfaʊndər/; [n]奠基者;创始人; [v](船)沉没,浸水而沉没;(计划等)失败,受挫折; [or]sat;
fracas: [a]/ˈfreɪkəs/; [n]喧嚷,吵闹,争论,论战; [or]sat;
fractious: [a]/ˈfrækʃəs/; [adj]易怒的;难以对待的;倔强的;好争吵的; [or]sat;
frail: [a]/freɪl/; [adj]脆弱的,不坚实的; [n]少妇;灯心草篓;灯心草篓的容量; [or]sat;
franchise: [a]/ˈfræntʃaɪz/; [n]特许(经营权),公民权,选举权; [v]赋予特权,赋予公民权; [or]sat;
frantic: [a]/ˈfræntɪk/; [adj]疯狂的;狂乱的;慌乱的; [or]sat;
fraudulent: [a]/ˈfrɔːdʒələnt/; [adj]欺诈的,欺骗性的,骗得的; [or]sat;
fraught: [a]/frɔːt/; [adj]担心的,忧虑的;充满.的; [n]货物,装载物; [vt]装货于; [or]sat;
fray: [a]/freɪ/; [n]吵架,打斗,磨损处; [v]磨损,摩擦,使关系紧张; [or]sat;
frenetic: [a]/frəˈnetɪk/; [adj]狂乱的;非常激动的; [n]疯子;狂人; [or]sat;
fresco: [a]/ˈfreskoʊ/; [n]壁画;壁画法; [v]在..上做壁画;用壁画法画出; [or]sat;
fret: [a]/fret/; [v]使烦恼,使焦急;使腐蚀;使磨损; [n](斑卓琴,吉他,曼陀林琴等弦乐器指板上定音的)档;侵蚀; [or]sat;
friction: [a]/ˈfrɪkʃn/; [n]摩擦,摩擦力;争执,冲突; [or]sat;
frigid: [a]/ˈfrɪdʒɪd/; [adj]寒冷的,冷淡的,死板的,呆板的,性冷淡的; [or]sat;
frivolous: [a]/ˈfrɪvələs/; [adj]轻佻的,不重要的,缺乏基础的; [or]sat;
frolicsome: [a]/ˈfrɑːlɪksəm/; [adj]快活的;爱闹着玩的; [or]sat;
frond: [a]/frɑːnd/; [n](羊齿,棕榈等的)叶子;叶状体; [or]sat;
frugality: [a]/fruˈɡæləti/; [n]节约,节俭; [or]sat;
fruition: [a]/fruˈɪʃn/; [n]享有;最后完成,实现,取得成果; [or]sat;
frustrate: [a]/ˈfrʌstreɪt/; [v]使灰心;挫败;阻挠; [or]sat;
fugitive: [a]/ˈfjuːdʒətɪv/; [adj]逃亡的,易逝的; [n]逃犯,逃亡者; [or]sat;
fulcrum: [a]/ˈfʊlkrəm/; [n]<机>支点,(植)叶附属物; [or]sat;
fundamental: [a]/ˌfʌndəˈmentl/; [adj]基本的,根本的;重要的;基础的; [n]基本原理;基本原则; [or]sat;
furlough: [a]/ˈfɜːrloʊ/; [n](军人,官吏的)休假;暂时解雇;放假; [v]准假;暂时解雇; [or]sat;
furor: [a]/ˈfjʊˌrɔr/; [n]狂热;激怒;喧闹;感动; [or]sat;
furtive: [a]/ˈfɜːrtɪv/; [adj]偷偷的,秘密的,鬼鬼祟祟的,; [or]sat;
fusion: [a]/ˈfjuːʒn/; [n]融合,合并,核聚变; [or]sat;
futile: [a]/ˈfjuːtl/; [adj]无益的,无用的; [or]sat;
gadfly: [a]/ˈɡædflaɪ/; [n]牛虻,令人生厌的人; [or]sat;
gaffe: [a]/ɡæf/; [n](社交上令人不快的)失言,失态,失礼; [or]sat;
gainsay: [a]/ˌɡeɪnˈseɪ/; [v]否认,否定,反驳; [n]否认,反驳; [or]sat;
gait: [a]/ɡeɪt/; [n]步态,步法,速度; [or]sat;
galaxy: [a]/ˈɡæləksi/; [n]星系; [or]sat;
gale: [a]/ɡeɪl/; [n]狂风,一阵(笑声); [or]sat;
gall: [a]/ɡɔːl/; [n]粗鲁,无礼; [v]使恼怒; [or]sat;
galvanize: [a]/ˈɡælvənaɪz/; [v]镀锌,通电,刺激; [or]sat;
gambit: [a]/ˈɡæmbɪt/; [n](常指带风险的)策略,弃兵局(指国际象棋开局弃一卒以取得优势),话题,开始,开场白; [or]sat;
gamut: [a]/'ɡæmət/; [n]全音阶,长音域,整个领域,全体; [or]sat;
gape: [a]/ɡeɪp/; [n]裂口,张嘴,打哈欠; [v]目瞪口呆地凝视,打哈欠,张开,裂开; [or]sat;
gargantuan: [a]/ɡɑːrˈɡæntʃuən/; [adj]巨大的,庞大的; [or]sat;
garish: [a]/ˈɡerɪʃ/; [adj]炫耀的;过分装饰的;过分鲜艳的; [or]sat;
garner: [a]/ˈɡɑːrnər/; [v]收藏,积累,储存; [n]积蓄,积累物; [or]sat;
garnish: [a]/ˈɡɑːrnɪʃ/; [v]装饰(于食品上); [n]为增加色香味而添加的配菜;装饰品; [or]sat;
garrulous: [a]/ˈɡærələs/; [adj]唠叨的,喋喋不休的;聒噪的; [or]sat;
gauche: [a]/ɡoʊʃ/; [adj]笨拙的,不会社交的,偏转的; [or]sat;
gaudy: [a]/ˈɡɔːdi/; [n]华丽而俗气的廉价饰物; [adj](服饰,装饰,文风等)华丽而俗气的;浮华的;过分显眼的; [or]sat;
gaunt: [a]/ɡɔːnt/; [adj]憔悴的,瘦削的; [n]憔悴,荒凉; [or]sat;
gavel: [a]/ˈɡævl/; [n]小木槌; [v]敲小槌(催促通过议案,要求注意等);要求(注意); [or]sat;
gawk: [a]/ɡɔːk/; [v]张着嘴呆看; [or]sat;
genealogy: [a]/ˌdʒiːniˈælədʒi/; [n]宗谱,血统,家系,系谱学; [or]sat;
generate: [a]/ˈdʒenəreɪt/; [v]产生(热,电等能量),创造; [or]sat;
generic: [a]/dʒəˈnerɪk/; [n]无注册商标产品;通名; [adj]一般的;非商标的;属的,类的; [or]sat;
genesis: [a]/ˈdʒenəsɪs/; [n](事物的)起源,发生; [or]sat;
geniality: [a]/ˌdʒiːniˈæləti/; [n]和蔼,温和,亲切; [or]sat;
genre: [a]/ˈʒɑːnrə/; [n]类型,流派; [adj]风俗画的,以日常情景为主题的; [or]sat;
genteel: [a]/dʒenˈtiːl/; [adj]有教养的,文雅的;高雅的;假斯文的,装作体面的; [or]sat;
gentility: [a]/dʒenˈtɪləti/; [n]上流阶层;文雅;有教养; [or]sat;
gentry: [a]/ˈdʒentri/; [n]人们(多用贬义),贵族们,(英)上流社会人士; [or]sat;
germane: [a]/dʒɜːrˈmeɪn/; [adj]有密切关系的;贴切的;恰当的; [or]sat;
germinate: [a]/ˈdʒɜːrmɪneɪt/; [v]发芽,发展,生长; [or]sat;
ghastly: [a]/ˈɡæstli/; [adj]苍白的,可怕的,令人不快的; [adv]恐怖地,惨白地; [or]sat;
gibberish: [a]/ˈdʒɪbərɪʃ/; [n]乱语;快速而不清楚的言语; [or]sat;
gibe: [a]/dʒaɪb/; [n]嘲弄,讥笑; [v]嘲笑; [or]sat;
giddy: [a]/ˈɡɪdi/; [adj]眼花缭乱的,头晕的,轻率的; [v](使)眼花,(使)眩晕; [or]sat;
gingerly: [a]/ˈdʒɪndʒərli/; [adv]小心翼翼地,慎重地; [adj]小心翼翼的;兢兢业业的; [or]sat;
gist: [a]/dʒɪst/; [n]主旨,要点;依据; [or]sat;
glacial: [a]/ˈɡleɪʃl/; [adj]冰的;冰冷的;冰河时代的; [or]sat;
glaze: [a]/ɡleɪz/; [n](浇在糕点上的)糖浆,蛋浆,釉;<气>雨淞; [v](眼睛)变呆滞;浇浆汁于 (食物) 表面;给.安装玻璃; [or]sat;
glib: [a]/ɡlɪb/; [adj]口齿伶俐的;油嘴滑舌的; [or]sat;
glimmer: [a]/ˈɡlɪmər/; [n]微光;闪光;少许; [v]闪烁;发微光; [or]sat;
gloat: [a]/ɡloʊt/; [v]幸灾乐祸地看,窃喜; [or]sat;
glossary: [a]/ˈɡlɑːsəri/; [n]词汇表,术语汇编; [or]sat;
glossy: [a]/ˈɡlɑːsi/; [adj]光泽的,光滑的; [or]sat;
glower: [a]/ˈɡlaʊər/; [v]怒目而视; [or]sat;
glut: [a]/ɡlʌt/; [n]供过于求,过多; [vt]使吃饱;使充斥; [vi]过量地吃; [or]sat;
glutton: [a]/ˈɡlʌtn/; [n]贪吃者,对..贪婪的人; [or]sat;
gnarled: [a]/nɑːrld/; [adj]多节的,粗糙的;多瘤的;弯曲的; [or]sat;
gnome: [a]/noʊm/; [n]地下宝藏的守护神,土地神;格言;侏儒; [or]sat;
goad: [a]/ɡoʊd/; [vt]驱赶;刺激;鼓励; [n](赶牛用的)刺棒; [or]sat;
gorge: [a]/ɡɔːrdʒ/; [n]峡谷;胃;暴食;咽喉;障碍物; [v]拼命吃;吞下,狼吞虎咽;塞满,填满; [or]sat;
gory: [a]/ˈɡɔːri/; [adj]血淋淋的,血污的,满是血的; [or]sat;
gouge: [a]/ɡaʊdʒ/; [n]半圆凿,洞; [v]挖洞,敲竹杠; [or]sat;
gourmand: [a]/ˈɡʊrmɑːnd/; [n]贪食者; [adj]贪食的; [or]sat;
gourmet: [a]/ˈɡʊrmeɪ/; [n]美食家,讲究吃喝的人; [adj]菜肴精美的; [or]sat;
graft: [a]/ɡræft/; [n]嫁接;嫁接株;移植; [vi]接枝; [vt]将.嫁接;移植(器官); [or]sat;
grandeur: [a]/ˈɡrændʒər/; [n]壮观,宏伟,庄严; [or]sat;
grandiloquent: [a]/ɡrænˈdɪləkwənt/; [adj](语言等)夸张的,夸大的; [or]sat;
grandiose: [a]/ˈɡrændioʊs/; [adj]浮夸的,夸大的,宏伟的; [or]sat;
graphic: [a]/ˈɡræfɪk/; [adj]形象的;图表的; [n]图,图表; [or]sat;
grapple: [a]/ˈɡræpl/; [v]抓住;格斗; [n]抓住;格斗; [or]sat;
grate: [a]/ɡreɪt/; [n]壁炉;格栅; [v]磨碎,使人烦燥; [or]sat;
gratify: [a]/ˈɡrætɪfaɪ/; [v]使高兴,使满足; [or]sat;
gratis: [a]/ˈɡrætɪs/; [adj]免费的; [or]sat;
gratuitous: [a]/ɡrəˈtuːɪtəs/; [adj]无根据的,无理由的,无报酬的,免费的,多余的; [or]sat;
gravity: [a]/ˈɡrævəti/; [n]重力,引力;严重性;庄重,严肃; [or]sat;
gregarious: [a]/ɡrɪˈɡeriəs/; [adj]群居的,爱社交的; [or]sat;
grievance: [a]/ˈɡriːvəns/; [n]牢骚,委屈,抱怨; [or]sat;
grill: [a]/ɡrɪl/; [n]烤架; [v]烤;拷问; [or]sat;
grimace: [a]/ˈɡrɪməs/; [v]做鬼脸,面部歪扭; [n]愁眉苦脸,怪相,鬼脸; [or]sat;
grisly: [a]/ˈɡrɪzli/; [adj]恐怖的;令人震惊的;厉害的; [or]sat;
grotesque: [a]/ɡroʊˈtesk/; [adj]奇形怪状的,奇异的; [n]奇形怪状的人(或物,图案等);奇异风格; [or]sat;
grouse: [a]/ɡraʊs/; [v]埋怨; [n]松鸡;雷鸟科的猎鸟;怨言; [or]sat;
grove: [a]/ɡroʊv/; [n]小树林;果园; [or]sat;
grovel: [a]/ˈɡrɑːvl/; [v]摇尾乞怜;奴颜婢膝;匍匐; [or]sat;
grudging: [a]/ˈɡrʌdʒɪŋ/; [adj]勉强的,吝啬的; [or]sat;
gruel: [a]/ˈɡruːəl/; [n]稀粥; [v]使极度疲劳;累垮; [or]sat;
grueling: [a]/'gruːəlɪŋ/; [n]惩罚,劳累; [adj]累垮人的,折磨人的; [or]sat;
gruesome: [a]/ˈɡruːsəm/; [adj]阴森的;可怕的; [or]sat;
gruff: [a]/ɡrʌf/; [adj]粗暴的,粗哑的,脾气坏的; [vt]粗鲁地说,生硬地说; [vi]粗鲁地说,生硬地说话; [or]sat;
guffaw: [a]/ɡəˈfɔː/; [n]哄笑;大笑; [v]哄笑;大笑; [or]sat;
guile: [a]/ɡaɪl/; [n]狡猾,诡计,欺诈; [or]sat;
guise: [a]/ɡaɪz/; [n]外观,姿态,装束,伪装; [v]伪装; [or]sat;
gullible: [a]/ˈɡʌləbl/; [adj]易受骗的;轻信的; [or]sat;
gusto: [a]/ˈɡʌstoʊ/; [n]由衷的高兴;爱好,嗜好; [or]sat;
gusty: [a]/ˈɡʌsti/; [adj]多阵风的,起大风的,迸发的; [or]sat;
hackneyed: [a]/ˈhæknid/; [adj]陈腐的,平常的; [or]sat;
haggard: [a]/ˈhæɡərd/; [adj]憔悴的,消瘦的; [n]哈格德;未驯服的鹰;悍鹰; [or]sat;
haggle: [a]/ˈhæɡl/; [n]讨价还价; [v]争论,讨价还价; [or]sat;
hallowed: [a]/ˈhæloʊd/; [adj]神圣的; [or]sat;
hallucination: [a]/həˌluːsɪˈneɪʃn/; [n]幻觉,幻想; [or]sat;
halting: [a]/ˈhɔːltɪŋ/; [adj]犹豫的,蹒跚的,迟缓的; [v]停止;蹒跚,犹豫; [or]sat;
hamper: [a]/ˈhæmpər/; [v]阻碍,妨碍,牵制; [n](有盖的)大篮子; [or]sat;
haphazard: [a]/hæpˈhæzərd/; [adj]偶然的;随意的;凑合的;胡乱的; [or]sat;
harangue: [a]/həˈræŋ/; [n]长篇大论; [v]高谈阔论;大声训斥; [or]sat;
harass: [a]/həˈræs/; [v]使困扰,使烦恼,反复袭击; [or]sat;
harbinger: [a]/ˈhɑːrbɪndʒər/; [n]先驱,先兆; [vt]预告;充做.的前驱; [or]sat;
harbor: [a]/'hɑːbə/; [n]海港;港口;避风港; [v]庇护;藏匿;心怀(怨恨等); [or]sat;
hardy: [a]/ˈhɑːrdi/; [adj](植物)耐寒的;能吃苦耐劳的;勇敢的; [n]强壮的人; [or]sat;
harrowing: [a]/ˈhæroʊɪŋ/; [adj]悲痛的,难受的; [or]sat;
haughtiness: [a]/ˈhɔːtinəs/; [n]傲慢; [or]sat;
hazardous: [a]/ˈhæzərdəs/; [adj]有危险的;碰运气的; [adv]冒险地,有危险地; [n]冒险,危险; [or]sat;
hazy: [a]/ˈheɪzi/; [adj]朦胧的,烟雾弥漫的,模糊的; [or]sat;
headstrong: [a]/ˈhedstrɔːŋ/; [adj]任性的;顽固的; [or]sat;
heckler: [a]/ˈheklər/; [n]激烈质问者; [or]sat;
hedonist: [a]/ˈhiːdənɪst/; [n]享乐主义者,［心］欢乐主义者; [adj]享乐主义者的; [or]sat;
heed: [a]/hiːd/; [vt]注意;留心; [v]注意; [vi]留心; [n]注意;留心; [or]sat;
heinous: [a]/ˈheɪnəs/; [adj]可憎的;极凶恶的; [or]sat;
herbivorous: [a]/ɜːrˈbɪvərəs/; [adj]食草的; [or]sat;
heresy: [a]/ˈherəsi/; [n]异端邪说;异教; [or]sat;
hermetic: [a]/hɜːrˈmetɪk/; [adj]密封的;与外界隔绝的;不透气的;炼金术的; [or]sat;
hermitage: [a]/ˈhɜːrmɪtɪdʒ/; [n]隐士生活;隐士住处; [or]sat;
heterogeneous: [a]/ˌhetərəˈdʒiːniəs/; [adj]多相的,异种的,不均匀的,由不同成分形成的; [or]sat;
heyday: [a]/ˈheɪdeɪ/; [n]全盛期; [int]嘿(表喜悦或惊奇等); [or]sat;
hiatus: [a]/haɪˈeɪtəs/; [n]空隙,裂缝,中断; [or]sat;
hibernate: [a]/ˈhaɪbərneɪt/; [vi]冬眠,蛰居; [or]sat;
hierarchy: [a]/ˈhaɪərɑːrki/; [n]阶层,等级制度; [or]sat;
hindrance: [a]/ˈhɪndrəns/; [n]妨碍;障碍物; [or]sat;
histrionic: [a]/ˌhɪstriˈɑːnɪk/; [adj]戏剧的,装腔作势的,作戏的; [n]演员;戏剧表演;舞台艺术;戏剧似的言行; [or]sat;
hoard: [a]/hɔːrd/; [v]贮藏,秘藏; [n]贮藏物; [or]sat;
hoary: [a]/ˈhɔːri/; [adj]年纪高迈的;(头发等)灰白的;古老的; [or]sat;
hoax: [a]/hoʊks/; [n]骗局;恶作剧; [vt]愚弄;欺骗; [or]sat;
hodgepodge: [a]/ˈhɑːdʒpɑːdʒ/; [n]大杂烩,混煮,一团糟; [or]sat;
holster: [a]/ˈhoʊlstər/; [n]手枪皮套; [or]sat;
homage: [a]/ˈhɑːmɪdʒ/; [n]敬意;尊敬;效忠; [or]sat;
homogeneous: [a]/ˌhoʊməˈdʒiːniəs/; [adj]同类的,同质的,有相同特征的; [or]sat;
hone: [a]/hoʊn/; [n]细磨刀石; [v]磨刀; [or]sat;
hoodwink: [a]/ˈhʊdwɪŋk/; [v]欺骗,遮眼,蒙蔽; [or]sat;
horde: [a]/hɔːrd/; [n]一大群,群,游牧部落; [v]成群;结成部落而居; [or]sat;
host: [a]/hoʊst/; [n]东道主,主持人;大量; [v]主持,主办; [or]sat;
hostility: [a]/hɑːˈstɪləti/; [n]虐待,敌意;不友善;敌对; [or]sat;
hovel: [a]/ˈhʌvl/; [n]茅舍,肮脏的小屋; [or]sat;
hover: [a]/ˈhʌvər/; [v](鸟,直升机)盘旋,翱翔;(人)逗留在附近,徘徊; [or]sat;
hue: [a]/hjuː/; [n]色彩;色度,颜色;叫声; [or]sat;
hulking: [a]/ˈhʌlkɪŋ/; [adj]笨重的; [or]sat;
humane: [a]/hjuːˈmeɪn/; [adj]人道的;仁慈的; [or]sat;
humdrum: [a]/ˈhʌmdrʌm/; [adj]单调的;乏味的; [n]平凡;单调; [vi]单调乏味地进行; [or]sat;
humid: [a]/ˈhjuːmɪd/; [adj]潮湿的;湿润的;多湿气的; [or]sat;
humility: [a]/hjuːˈmɪləti/; [n]谦逊,谦恭; [or]sat;
hurtle: [a]/ˈhɜːrtl/; [v]猛冲,猛烈碰撞,使冲向; [n]碰撞;碰撞声;猛冲; [or]sat;
hybrid: [a]/ˈhaɪbrɪd/; [n]杂种,混血儿,混合物; [adj]混合的;杂种的; [or]sat;
hydrophobia: [a]/ˌhaɪdrəˈfoʊbiə/; [n]狂犬病,恐水病; [or]sat;
hyperbole: [a]/haɪˈpɜːrbəli/; [n]夸张的语句;夸张法; [or]sat;
hypochondriac: [a]/ˌhaɪpəˌkɑːnˈdraɪəkl/; [n]疑病患者,忧郁症患者; [or]sat;
hypocritical: [a]/ˌhɪpəˈkrɪtɪkl/; [adj]虚伪的;伪善的; [or]sat;
hypothetical: [a]/ˌhaɪpəˈθetɪkl/; [adj]假设的,假定的; [or]sat;
icon: [a]/ˈaɪkɑːn/; [n]图标,肖像,偶像; [or]sat;
ideology: [a]/ˌaɪdiˈɑːlədʒi/; [n]意识形态,思想(体系); [or]sat;
idiom: [a]/ˈɪdiəm/; [n]习语;成语;惯用语法; [or]sat;
idiosyncrasy: [a]/ˌɪdiəˈsɪŋkrəsi/; [n]特殊癖性或行为; [or]sat;
ignite: [a]/ɪɡˈnaɪt/; [v]点燃,发光,燃烧; [or]sat;
ignominy: [a]/ˈɪɡnəmɪni/; [n]耻辱,不体面,丑行; [or]sat;
illicit: [a]/ɪˈlɪsɪt/; [adj]违法的,违禁的; [or]sat;
illuminate: [a]/ɪˈluːmɪneɪt/; [vt]照亮;阐释;说明; [or]sat;
illusion: [a]/ɪˈluːʒn/; [n]假象,幻象;幻想;错误观念; [or]sat;
illusory: [a]/ɪˈluːsəri/; [adj]错觉的,幻影的,虚假的,产生幻觉的; [or]sat;
imbalance: [a]/ɪmˈbæləns/; [n]不平衡,不均衡;失调; [or]sat;
imbibe: [a]/ɪmˈbaɪb/; [v]喝,饮;吸收,接受; [or]sat;
immaculate: [a]/ɪˈmækjələt/; [adj]完美的,无瑕疵的;洁净的; [or]sat;
imminent: [a]/ˈɪmɪnənt/; [adj]迫近的,紧迫的,即将来临的; [or]sat;
immobility: [a]/ˌɪməˈbɪləti/; [n]不动,固定; [or]sat;
immune: [a]/ɪˈmjuːn/; [adj]免疫的,有免疫力的;不受影响的;免除的; [or]sat;
immutable: [a]/ɪˈmjuːtəbl/; [adj]永远不变的,永恒的; [or]sat;
impair: [a]/ɪmˈper/; [v]损害;削弱; [or]sat;
impale: [a]/ɪmˈpeɪl/; [v]刺穿,刺住; [or]sat;
impart: [a]/ɪmˈpɑːrt/; [v]传授,给予,将(某性质)给予或赋予某事物; [or]sat;
impartial: [a]/ɪmˈpɑːrʃl/; [adj]公平的,不偏不倚的; [or]sat;
impasse: [a]/ˈɪmpæs/; [n]僵局;死路; [or]sat;
impassive: [a]/ɪmˈpæsɪv/; [adj]无动于衷的,冷漠的; [or]sat;
impeach: [a]/ɪmˈpiːtʃ/; [v]指摘,弹劾; [or]sat;
impeccable: [a]/ɪmˈpekəbl/; [adj]无瑕疵的,没有缺点的; [or]sat;
impecunious: [a]/ˌɪmpɪˈkjuːniəs/; [adj]贫困的,一文不名的; [or]sat;
impede: [a]/ɪmˈpiːd/; [v]妨碍,阻碍; [or]sat;
impediment: [a]/ɪmˈpedɪmənt/; [n]妨碍,阻碍;障碍物;(言语)障碍;口吃; [or]sat;
impel: [a]/ɪmˈpel/; [v]推进,驱使; [or]sat;
impending: [a]/ɪmˈpendɪŋ/; [adj]即将到来的;迫在眉睫的,紧急的; [or]sat;
impenetrable: [a]/ɪmˈpenɪtrəbl/; [adj]难以渗透的,坚不可摧的; [or]sat;
impenitent: [a]/ɪmˈpenɪtənt/; [adj]不悔悟的; [or]sat;
imperative: [a]/ɪmˈperətɪv/; [adj]必要的;祈使的;急需的; [n]命令;必要的事;义务;驱使; [or]sat;
imperceptible: [a]/ˌɪmpərˈseptəbl/; [adj]极细微的,觉察不到的,感觉不到的,; [or]sat;
imperial: [a]/ɪmˈpɪriəl/; [adj]帝王的,壮丽的,至尊的; [n]帝国,皇家; [or]sat;
imperious: [a]/ɪmˈpɪriəs/; [adj]傲慢的,专横的; [or]sat;
impermeable: [a]/ɪmˈpɜːrmiəbl/; [adj]不渗透的;(水等)不能渗透的; [or]sat;
impertinent: [a]/ɪmˈpɜːrtnənt/; [adj]不恰当的,粗鲁的; [or]sat;
imperturbable: [a]/ˌɪmpərˈtɜːrbəbl/; [adj]冷静的,沉着的; [or]sat;
impervious: [a]/ɪmˈpɜːrviəs/; [adj]不能渗透的,不为所动的; [or]sat;
impetuous: [a]/ɪmˈpetʃuəs/; [adj]冲动的,鲁莽的; [or]sat;
impetus: [a]/ˈɪmpɪtəs/; [n]推动力;促进; [or]sat;
impinge: [a]/ɪmˈpɪndʒ/; [v]侵犯,撞击,碰撞; [or]sat;
impious: [a]/ɪmˈpaɪəs/; [adj]不敬神的,不虔诚的,不孝的; [or]sat;
implacable: [a]/ɪmˈplækəbl/; [adj]难以满足的,难平息的; [or]sat;
implement: [a]/ˈɪmplɪment/; [n]工具;器具; [v]实施,执行;执行; [or]sat;
implicate: [a]/ˈɪmplɪkeɪt/; [vt]使牵连其中,暗示,含有.的意思; [n]包含的东西; [or]sat;
implication: [a]/ˌɪmplɪˈkeɪʃn/; [n]暗示;含意;牵连;卷入;可能的后果; [or]sat;
implicit: [a]/ɪmˈplɪsɪt/; [adj]隐含的;盲目的;完全的,绝对的;成为一部分的; [or]sat;
implore: [a]/ɪmˈplɔːr/; [v]恳求; [or]sat;
imply: [a]/ɪmˈplaɪ/; [vt]暗示;暗指;意味着; [or]sat;
importunate: [a]/ɪmˈpɔːrtʃənət/; [adj]讨厌的,急切的,缠扰不休的; [or]sat;
importune: [a]/ˌɪmpɔːrˈtuːn/; [v]强求,胡搅蛮缠; [adj]同"importunate"; [or]sat;
impostor: [a]/ɪmˈpɑːstər/; [n]骗子;冒充者; [or]sat;
impotent: [a]/ˈɪmpətənt/; [adj]无力的,无能的,阳痿的; [n]虚弱者;阳痿者; [or]sat;
impoverished: [a]/ɪmˈpɑːvərɪʃt/; [adj]穷困的,用尽了的,无创造性的; [or]sat;
impregnable: [a]/ɪmˈpreɡnəbl/; [adj]攻不破的,征服不了的; [or]sat;
impromptu: [a]/ɪmˈprɑːmptuː/; [adj]一触即发的;即席的,即兴的; [adv]即席地,即兴地; [n]即兴之作; [or]sat;
impropriety: [a]/ˌɪmprəˈpraɪəti/; [n]不当行为;不适当;不正确; [or]sat;
improvident: [a]/ɪmˈprɑːvɪdənt/; [adj]浪费的,无远见的,无先见之明的; [or]sat;
improvise: [a]/ˈɪmprəvaɪz/; [v]即席创作,临时凑成; [or]sat;
imprudent: [a]/ɪmˈpruːdnt/; [adj]轻率的,鲁莽的; [or]sat;
impugn: [a]/ɪmˈpjuːn/; [v]指责,对.表示怀疑; [or]sat;
impunity: [a]/ɪmˈpjuːnəti/; [n]不受惩罚;无患; [or]sat;
inadvertently: [a]/ˌɪnədˈvɜːrtəntli/; [adv]不经意地;不经意的; [or]sat;
inalienable: [a]/ɪnˈeɪliənəbl/; [adj]不可分割的; [or]sat;
inane: [a]/ɪˈneɪn/; [adj]无意义的,空洞的;愚蠢的; [or]sat;
inanimate: [a]/ɪnˈænɪmət/; [adj]无生命的;无生气的; [or]sat;
inaugurate: [a]/ɪˈnɔːɡjəreɪt/; [v]为..揭幕;为.举行就职典礼;开展; [or]sat;
incandescent: [a]/ˌɪnkænˈdesnt/; [adj]白热的,热烈的; [or]sat;
incantation: [a]/ˌɪnkænˈteɪʃn/; [n]咒语; [or]sat;
incapacitate: [a]/ˌɪnkəˈpæsɪteɪt/; [v]使不能;使瘫痪;使无能力;使不适合; [or]sat;
incarcerate: [a]/ɪnˈkɑːrsəreɪt/; [v]把..关进监狱,监禁,幽闭; [or]sat;
incarnation: [a]/ˌɪnkɑːrˈneɪʃn/; [n]赋与肉体,具人形,化身; [or]sat;
incendiary: [a]/ɪnˈsendieri/; [n]放火者,纵火者,燃烧弹,煽动者; [adj]放火的,纵火的,能燃烧的,煽动性的; [or]sat;
incense: [a]/ˈɪnsens/; [n]焚香时的烟,香味; [v]激怒; [or]sat;
incentive: [a]/ɪnˈsentɪv/; [n]刺激,激励;鼓励; [or]sat;
inception: [a]/ɪnˈsepʃn/; [n]起初;获得学位; [or]sat;
incessant: [a]/ɪnˈsesnt/; [adj]无间断的,连续的; [or]sat;
inchoate: [a]/ɪnˈkoʊət/; [adj]早期的;刚开始的;未充分发展的; [or]sat;
incidence: [a]/ˈɪnsɪdəns/; [n]发生率,入射角度; [or]sat;
incipient: [a]/ɪnˈsɪpiənt/; [adj]初期的;刚出现的; [or]sat;
incisive: [a]/ɪnˈsaɪsɪv/; [adj]一针见血的,敏锐的; [or]sat;
incite: [a]/ɪnˈsaɪt/; [v]刺激;煽动; [or]sat;
inclement: [a]/ɪnˈklemənt/; [adj]险恶的;气候严酷的;狂风暴雨的; [or]sat;
incline: [a]/ɪnˈklaɪn/; [n]倾斜,斜坡,斜面; [v](使)倾斜,(使)倾向于; [or]sat;
inclined: [a]/ɪnˈklaɪnd/; [adj]倾向..的,有..意向的;斜着的; [or]sat;
inclusive: [a]/ɪnˈkluːsɪv/; [adj]包含..在内的,包罗广泛的; [or]sat;
incoherent: [a]/ˌɪnkoʊˈhɪrənt/; [adj]语无伦次的;不合逻辑的;不连贯的; [or]sat;
incompatible: [a]/ˌɪnkəmˈpætəbl/; [adj]不兼容的,矛盾的,不调和的; [or]sat;
incongruous: [a]/ɪnˈkɑːŋɡruəs/; [adj]不调和的,不相称的; [or]sat;
inconsequential: [a]/ɪnˌkɑːnsɪˈkwenʃl/; [adj]不重要的,不合理的,不合逻辑的; [or]sat;
incontrovertible: [a]/ˌɪnkɑːntrəˈvɜːrtəbl/; [adj]无可争议的; [or]sat;
incorporeal: [a]/ˌɪnkɔːrˈpɔːriəl/; [adj]灵魂的,无实体的,非物质的; [or]sat;
incorrigible: [a]/ɪnˈkɔːrɪdʒəbl/; [adj]积习难改的,不可救药的; [or]sat;
incredulous: [a]/ɪnˈkredʒələs/; [adj]怀疑的,不轻信的; [or]sat;
increment: [a]/ˈɪŋkrəmənt/; [n]增长;增值; [or]sat;
incriminate: [a]/ɪnˈkrɪmɪneɪt/; [v]控告,暗示..有罪; [or]sat;
incubate: [a]/ˈɪŋkjubeɪt/; [v]孵卵; [or]sat;
inculcate: [a]/ɪnˈkʌlkeɪt/; [v]灌输,谆谆教诲; [or]sat;
incumbent: [a]/ɪnˈkʌmbənt/; [n]在职者,现任者; [adj]现任的;依靠的;负有职责的; [or]sat;
incur: [a]/ɪnˈkɜːr/; [v]遭受;招致;引起; [or]sat;
incursion: [a]/ɪnˈkɜːrʒn/; [n]入侵,侵犯; [or]sat;
indefatigable: [a]/ˌɪndɪˈfætɪɡəbl/; [adj]不知疲倦的;不屈不挠的;有耐性的; [or]sat;
indelible: [a]/ɪnˈdeləbl/; [adj](印记等)无法擦除的,无法忘怀的; [or]sat;
indentation: [a]/ˌɪndenˈteɪʃn/; [n]空格,缩进;呈锯齿形;海岸线凹入处; [or]sat;
indicative: [a]/ɪnˈdɪkətɪv/; [adj]指示的;暗示的;陈述的; [n]陈述语气; [or]sat;
indices: [a]/ˈɪndɪsiːz/; [n]目录,指数; [or]sat;
indict: [a]/ɪnˈdaɪt/; [v]控诉,起诉; [or]sat;
indifferent: [a]/ɪnˈdɪfrənt/; [adj]不感兴趣的,不关心的;平庸的;冷漠的; [or]sat;
indigenous: [a]/ɪnˈdɪdʒənəs/; [adj]土生土长的,本土的; [or]sat;
indigent: [a]/ˈɪndɪdʒənt/; [adj]贫困的,贫穷的; [or]sat;
indignation: [a]/ˌɪndɪɡˈneɪʃn/; [n]愤慨; [or]sat;
indignity: [a]/ɪnˈdɪɡnəti/; [n]侮辱,有伤尊严,无礼举动; [or]sat;
indiscretion: [a]/ˌɪndɪˈskreʃn/; [n]轻率;言行失检; [or]sat;
indiscriminate: [a]/ˌɪndɪˈskrɪmɪnət/; [adj]任意的;不加区别的,不加选择的; [or]sat;
indisputable: [a]/ˌɪndɪˈspjuːtəbl/; [adj]没有争论余地,非常清楚的; [or]sat;
indoctrinate: [a]/ɪnˈdɑːktrɪneɪt/; [v]灌输思想; [or]sat;
indolent: [a]/ˈɪndələnt/; [adj]懒惰的,懒洋洋的; [or]sat;
indomitable: [a]/ɪnˈdɑːmɪtəbl/; [adj]不屈不挠的;不服输的;不气馁的; [or]sat;
induce: [a]/ɪnˈduːs/; [v]引导,劝诱,诱导; [or]sat;
indulgent: [a]/ɪnˈdʌldʒənt/; [adj]放纵的;宽容的;任性的; [or]sat;
industrious: [a]/ɪnˈdʌstriəs/; [adj]勤劳的,勤奋的; [or]sat;
ineffable: [a]/ɪnˈefəbl/; [adj]不可言喻的,不应说出的,难以形容的; [or]sat;
inept: [a]/ɪˈnept/; [adj]无能的;不称职的;笨拙的; [or]sat;
inequity: [a]/ɪnˈekwəti/; [n]不公平; [or]sat;
inert: [a]/ɪˈnɜːrt/; [adj]不动的,惰性的;行动迟钝的;无生气的; [or]sat;
inevitable: [a]/ɪnˈevɪtəbl/; [adj]不可避免的,必然的; [n]必然发生的事; [or]sat;
inexorable: [a]/ɪnˈeksərəbl/; [adj]不为所动的,坚决不变的; [n]坚定不移的人; [or]sat;
infamous: [a]/ˈɪnfəməs/; [adj]声名狼藉的,无耻的; [or]sat;
infantile: [a]/ˈɪnfəntaɪl/; [adj]婴儿的,幼稚的,初期的; [or]sat;
infer: [a]/ɪnˈfɜːr/; [vt]做出推论,推断;推理;暗示; [vi]推断; [or]sat;
infernal: [a]/ɪnˈfɜːrnl/; [adj]地狱的;恶魔的;可憎的; [or]sat;
infidel: [a]/ˈɪnfɪdəl/; [n]不信教者,异教徒; [or]sat;
infiltrate: [a]/ˈɪnfɪltreɪt/; [v]渗入,潜入 (某地方或组织);(气,液)渗透; [n]渗透物; [or]sat;
infinitesimal: [a]/ˌɪnfɪnɪˈtesɪml/; [adj]无穷小的,无限小的,极小的; [adv]无限小地; [n]无限小;极微量;极小量; [or]sat;
infirmity: [a]/ɪnˈfɜːrməti/; [n]虚弱; [or]sat;
inflated: [a]/ɪnˈfleɪtɪd/; [adj]通货膨胀的,充了气的,价格飞涨的,(植物)肿胀的; [or]sat;
influx: [a]/ˈɪnflʌks/; [n]流入,涌入;河口; [or]sat;
informal: [a]/ɪnˈfɔːrml/; [adj]非正式的;不拘礼节的;通俗的; [or]sat;
infraction: [a]/ɪnˈfrækʃn/; [n]违法; [or]sat;
infuriate: [a]/ɪnˈfjʊrieɪt/; [v]使(人)极为愤怒; [or]sat;
infusion: [a]/ɪnˈfjuːʒn/; [n]灌输;注入物;输入; [or]sat;
ingenious: [a]/ɪnˈdʒiːniəs/; [adj]聪明的;有发明天才的;有独创性的,别出心裁的; [or]sat;
inherent: [a]/ɪnˈhɪrənt/; [adj]内在的,固有的;生来就有的; [or]sat;
inhibit: [a]/ɪnˈhɪbɪt/; [v]阻碍;阻止,防止;抑制,约束; [or]sat;
inimical: [a]/ɪˈnɪmɪkl/; [adj]敌意的,有害的; [or]sat;
inimitable: [a]/ɪˈnɪmɪtəbl/; [adj]独特的,无比的,无法仿效的; [or]sat;
iniquitous: [a]/ɪˈnɪkwɪtəs/; [adj]邪恶的;不公正的; [or]sat;
initiate: [a]/ɪˈnɪʃieɪt/; [v]开始,发动; [n]新加入组织的人; [or]sat;
injurious: [a]/ɪnˈdʒʊriəs/; [adj]有害的,造成伤害的; [or]sat;
inkling: [a]/ˈɪŋklɪŋ/; [n]轻微暗示,小提示,略知; [or]sat;
innate: [a]/ɪˈneɪt/; [adj]与生俱来的,天生的; [or]sat;
innocuous: [a]/ɪˈnɑːkjuəs/; [adj]无伤大雅的;无害的; [or]sat;
innovation: [a]/ˌɪnəˈveɪʃn/; [n]创新,革新,新设施,新发明; [or]sat;
innovative: [a]/ˈɪnəveɪtɪv/; [adj]创新的,革新的; [or]sat;
innuendo: [a]/ˌɪnjuˈendoʊ/; [n]暗讽,讽刺,影射; [vt]暗示,旁敲侧击地表达; [vi]影射,说讽刺话; [or]sat;
inordinate: [a]/ɪnˈɔːrdɪnət/; [adj]过度的,无节制的;紊乱的; [or]sat;
insatiable: [a]/ɪnˈseɪʃəbl/; [adj]不能满足的,贪得无厌的; [or]sat;
inscrutable: [a]/ɪnˈskruːtəbl/; [adj]高深莫测的,神秘的; [or]sat;
insensible: [a]/ɪnˈsensəbl/; [adj]昏迷的,无知觉的,麻木不仁的; [or]sat;
insidious: [a]/ɪnˈsɪdiəs/; [adj](暗中或逐渐)为害的; [or]sat;
insightful: [a]/ˈɪnsaɪtfʊl/; [adj]有深刻见解的,富有洞察力的; [or]sat;
insinuate: [a]/ɪnˈsɪnjueɪt/; [v]暗指,暗示; [or]sat;
insipid: [a]/ɪnˈsɪpɪd/; [adj]淡而无味的;枯燥乏味的; [or]sat;
insolvent: [a]/ɪnˈsɑːlvənt/; [n]无力清偿债务者,破产者; [adj]无清偿能力的,破产的; [or]sat;
insomnia: [a]/ɪnˈsɑːmniə/; [n]失眠; [or]sat;
instigate: [a]/ˈɪnstɪɡeɪt/; [v]发起,煽动; [or]sat;
insuperable: [a]/ɪnˈsuːpərəbl/; [adj]难以克服的,无敌的; [or]sat;
insurgent: [a]/ɪnˈsɜːrdʒənt/; [n]叛乱分子; [adj]叛乱的,起事的; [or]sat;
insurmountable: [a]/ˌɪnsərˈmaʊntəbl/; [adj]不能克服的,不能超越的,难以对付的; [or]sat;
insurrection: [a]/ˌɪnsəˈrekʃn/; [n]造反,叛乱; [or]sat;
intangible: [a]/ɪnˈtændʒəbl/; [adj]不可捉摸的,无形的; [n]无形的东西; [or]sat;
integral: [a]/ˈɪntɪɡrəl/; [adj](用于构成整体)必需的,不可缺少的,必不可少的;基本的,作为组成部分的,内置的;整体的,完整的; [or]sat;
integrity: [a]/ɪnˈteɡrəti/; [n]正直,真诚;完整; [or]sat;
intellect: [a]/ˈɪntəlekt/; [n]智力,理解力;非凡的才智;才华出众的人; [or]sat;
intemperate: [a]/ɪnˈtempərət/; [adj]放纵的;酗酒的;酷烈的; [or]sat;
inter: [a]/ɪnˈtɜːr/; [v]埋葬; prep. 在内; [or]sat;
interim: [a]/ˈɪntərɪm/; [n]中间时期,过渡时期; [adj]暂时的; [or]sat;
interminable: [a]/ɪnˈtɜːrmɪnəbl/; [adj]没完没了的,无穷无尽的,冗长的; [or]sat;
intermittent: [a]/ˌɪntərˈmɪtənt/; [adj]断断续续的,间歇的; [or]sat;
interrogate: [a]/ɪnˈterəɡeɪt/; [v]审问,审讯; [or]sat;
intervene: [a]/ˌɪntərˈviːn/; [v]干涉;介入;调停;干预,阻挠; [or]sat;
intimacy: [a]/ˈɪntɪməsi/; [n]亲密,亲近;亲昵行为;<婉>性行为;<婉辞>私通; [or]sat;
intimate: [a]/ˈɪntɪmət/; [adj]亲密的,密切的;详细的; [v]暗示;宣布,通知; [n]密友,知己; [or]sat;
intimidate: [a]/ɪnˈtɪmɪdeɪt/; [v]恫吓,威胁; [or]sat;
intractable: [a]/ɪnˈtræktəbl/; [adj]棘手的;难治的;倔强的;不听话的; [or]sat;
intrepid: [a]/ɪnˈtrepɪd/; [adj]无畏的;刚毅的,勇敢的; [or]sat;
intricate: [a]/ˈɪntrɪkət/; [adj]错综复杂的; [or]sat;
intrinsic: [a]/ɪnˈtrɪnsɪk/; [adj]固有的; [or]sat;
introspective: [a]/ˌɪntrəˈspektɪv/; [adj]内省的,反省的; [or]sat;
intrude: [a]/ɪnˈtruːd/; [vi]闯入,侵入; [vt]强挤入,把(自己的思想)强加于人; [or]sat;
intuition: [a]/ˌɪntuˈɪʃn/; [n]直觉;感觉; [or]sat;
inundate: [a]/ˈɪnʌndeɪt/; [v]淹没,泛滥; [or]sat;
invalidate: [a]/ɪnˈvælɪdeɪt/; [v]使无效;使无价值; [or]sat;
invasive: [a]/ɪnˈveɪsɪv/; [adj]扩散性的;<医>开刀的; [or]sat;
invective: [a]/ɪnˈvektɪv/; [n]猛烈抨击,恶言漫骂; [adj]谩骂的;恶言的;诽谤的; [or]sat;
inverse: [a]/ˌɪnˈvɜːrs/; [adj]相反的;反面的;倒转的; [n](the inverse)反面; [or]sat;
invert: [a]/ɪnˈvɜːrt/; [v]倒置;倒转;颠倒; [or]sat;
invidious: [a]/ɪnˈvɪdiəs/; [adj]惹人反感的,招人嫉妒的,令人厌恶的,诽谤的,不公平的; [or]sat;
invigorate: [a]/ɪnˈvɪɡəreɪt/; [v]鼓舞;提神,使精力充沛; [adj]生气勃勃的,精力充沛的,健壮的; [n]滋补;鼓舞; [or]sat;
invincible: [a]/ɪnˈvɪnsəbl/; [adj]无敌的;不能征服的; [or]sat;
inviolable: [a]/ɪnˈvaɪələbl/; [adj]神圣的;不可侵犯的,不可亵渎的;不可违背的; [or]sat;
invocation: [a]/ˌɪnvəˈkeɪʃn/; [n]祈祷;咒语;(法权的)行驶; [or]sat;
invoke: [a]/ɪnˈvoʊk/; [v]调用,祈求,恳求,引起; [or]sat;
invulnerable: [a]/ɪnˈvʌlnərəbl/; [adj]无法伤害的;无懈可击的; [or]sat;
irascible: [a]/ɪˈræsəbl/; [adj]易怒的,性情暴躁的; [or]sat;
irate: [a]/aɪˈreɪt/; [adj]发怒的,愤怒的; [or]sat;
iridescent: [a]/ˌɪrɪˈdesnt/; [adj]彩虹色的;闪光的,闪色的; [or]sat;
irksome: [a]/ˈɜːrksəm/; [adj]令人厌烦的,讨厌的; [or]sat;
ironic: [a]/aɪˈrɑːnɪk/; [adj]讽刺的; [or]sat;
irony: [a]/ˈaɪrəni/; [n]反语;冷嘲;具有讽刺意味的事; [or]sat;
irrational: [a]/ɪˈræʃənl/; [adj]无理性的,失去理性的; [or]sat;
irreconcilable: [a]/ɪˈrekənsaɪləbl/; [adj]不能妥协的,不能和解的,不能协调的; [n]不能和解的人,(政治上的)死硬派; [or]sat;
irrelevant: [a]/ɪˈreləvənt/; [adj]不相关的; [or]sat;
irremediable: [a]/ˌɪrɪˈmiːdiəbl/; [adj]不能挽回的,不能补救的; [or]sat;
irreparable: [a]/ɪˈrepərəbl/; [adj]不能修复的;不可弥补的; [or]sat;
irreproachable: [a]/ˌɪrɪˈproʊtʃəbl/; [adj]不可指责的;无过失的;无缺点的; [or]sat;
irresolute: [a]/ɪˈrezəluːt/; [adj]优柔寡断的;踌躇不定的; [or]sat;
irreverence: [a]/ɪˈrevərəns/; [n]无礼;不敬的行为; [adj]不尊敬的; [or]sat;
irrevocable: [a]/ɪˈrevəkəbl/; [adj]不可改变的;不能取消的;不能挽回的; [or]sat;
itinerant: [a]/aɪˈtɪnərənt/; [n]巡回工作者; [adj]巡回的;流动的; [or]sat;
itinerary: [a]/aɪˈtɪnəreri/; [n]旅程,路线;旅行计划; [or]sat;
jabber: [a]/ˈdʒæbər/; [v]急急忙忙地说,急促不清地说; [n]急促不清地话,无意义的话; [or]sat;
jaded: [a]/ˈdʒeɪdɪd/; [adj]疲倦的,精疲力竭的;厌倦的; [or]sat;
jargon: [a]/ˈdʒɑːrɡən/; [n]行话,术语;黄锆石; [or]sat;
jaunt: [a]/dʒɔːnt/; [v]远足;做短程游览; [n]短途游览; [or]sat;
jaunty: [a]/ˈdʒɔːnti/; [adj]愉快的,满足的;斯文的;时髦的; [adv]心满意足地,洋洋得意地; [n]心满意足;洋洋得意; [or]sat;
jeopardize: [a]/ˈdʒepərdaɪz/; [v]危及,损害(也作jeopardise); [or]sat;
jettison: [a]/ˈdʒetɪsn/; [v]向外抛弃,投弃(船舶遇难时投弃货物以为减轻负载); [n]抛弃的货物; [or]sat;
jingoist: [a]/dʒɪŋɡə'ʊɪst/; [n]沙文主义者,侵略主义者; [or]sat;
jocose: [a]/dʒoʊˈkoʊs/; [adj]开玩笑的,引人发笑的,诙谐的; [or]sat;
jocular: [a]/ˈdʒɑːkjələr/; [adj]搞笑的,欢乐的; [or]sat;
jollity: [a]/ˈdʒɑːləti/; [n]欢乐,酒宴,欢庆; [or]sat;
jovial: [a]/ˈdʒoʊviəl/; [adj]天性快活的,主神朱庇特的; [n]左威尔牌手表; [or]sat;
jubilation: [a]/ˌdʒuːbɪˈleɪʃn/; [n]喜悦,欢呼,庆祝; [or]sat;
judicious: [a]/dʒuˈdɪʃəs/; [adj]有判断力的;明智的; [or]sat;
juncture: [a]/ˈdʒʌŋktʃər/; [n]连接;交接处,交界;关键时刻;形势; [or]sat;
junta: [a]/ˈhʊntə/; [n]团体,派别; [or]sat;
jurisprudence: [a]/ˌdʒʊrɪsˈpruːdns/; [n]法律学,法学,法律体系,法学分支; [or]sat;
kaleidoscope: [a]/kəˈlaɪdəskoʊp/; [n]万花筒;千变万化; [or]sat;
kernel: [a]/ˈkɜːrnl/; [n]子粒,谷粒;核心; [or]sat;
kindle: [a]/ˈkɪndl/; [v]点燃,激起;着火;照亮;煽动; [or]sat;
kindred: [a]/ˈkɪndrəd/; [n]亲戚,家族,亲属关系,相似; [adj]有血缘关系的,同宗的,同源的,类似的; [or]sat;
kinetic: [a]/kɪˈnetɪk/; [adj]运动的; [or]sat;
knave: [a]/neɪv/; [n]不诚实的人;无赖;<古>仆人;(纸牌中的)杰克; [or]sat;
knit: [a]/nɪt/; [v]编结,针织; [n]编织的衣服;针织衫; [or]sat;
knoll: [a]/noʊl/; [n]小圆丘,小山;土墩; [or]sat;
knotty: [a]/ˈnɑːti/; [adj]有节疤的,有结的;棘手的; [or]sat;
kudos: [a]/ˈkuːdəʊs/; [n]荣誉;名望;称赞; [or]sat;
laborious: [a]/ləˈbɔːriəs/; [adj]费时费力的,辛苦的;艰苦的; [or]sat;
labyrinth: [a]/ˈlæbərɪnθ/; [n]迷宫; [or]sat;
laceration: [a]/ˌlæsəˈreɪʃn/; [n]撕裂,割破,裂口,伤口,痛苦; [or]sat;
lachrymose: [a]/ˈlækrɪmoʊs/; [adj]落泪的,好哭的;催泪的;悲哀的; [or]sat;
lackadaisical: [a]/ˌlækəˈdeɪzɪkl/; [adj]懒散的,无精打采的;无兴趣的;伤感的; [or]sat;
lackluster: [a]/ˈlækˌlʌstər/; [n]无光泽;暗淡; [adj]无光泽的;平凡的; [or]sat;
laconic: [a]/ləˈkɑːnɪk/; [adj](用词)简洁的;简明的; [adv]简短地,简洁地; [or]sat;
laggard: [a]/ˈlæɡərd/; [adj]缓慢的,落后的; [n]落后者;迟钝者; [or]sat;
lament: [a]/ləˈment/; [v]哀悼;惋惜;悲叹; [n]悲叹;悼词; [or]sat;
lampoon: [a]/læmˈpuːn/; [n]讽刺文章; [v]讽刺,写文章讽刺; [or]sat;
languid: [a]/ˈlæŋɡwɪd/; [adj]没精打采的,倦怠的; [or]sat;
languish: [a]/ˈlæŋɡwɪʃ/; [v]凋萎,衰弱,变得消瘦; [or]sat;
languor: [a]/ˈlæŋɡər/; [n]身心疲惫;柔情;呆滞; [or]sat;
lap: [a]/læp/; [n]腰以下及大腿的前面部分;(跑道的)一圈; [v](赛跑中)比(某人)领先一圈;轻拍; [or]sat;
larceny: [a]/ˈlɑːrsəni/; [n]盗窃; [or]sat;
lassitude: [a]/ˈlæsɪtuːd/; [n]困乏,厌倦,无精打采; [or]sat;
latent: [a]/ˈleɪtnt/; [adj]潜在的,隐伏的,不易察觉的; [or]sat;
lateral: [a]/ˈlætərəl/; [n]侧面部分;支线; [adj]侧面的;横向的; [or]sat;
latitude: [a]/ˈlætɪtuːd/; [n]纬度;地区;(言论,行动的)自由; [or]sat;
laud: [a]/lɔːd/; [v]赞美,称赞; [or]sat;
lavish: [a]/ˈlævɪʃ/; [adj]奢华的;铺张浪费的; [v]浪费;慷慨给予; [or]sat;
lax: [a]/læks/; [adj]松懈的;松弛的;<语>松弛元音的; [n]松元音;泻肚; [or]sat;
leaven: [a]/ˈlevn/; [n]发酵剂,影响力; [v]发酵,影响,渐变; [or]sat;
lechery: [a]/ˈletʃəri/; [n]好色,纵欲; [or]sat;
leery: [a]/ˈlɪri/; [adj]机警的,狡猾的; [or]sat;
legacy: [a]/ˈleɡəsi/; [n]遗赠(物);遗产; [or]sat;
legend: [a]/ˈledʒənd/; [n]传说,传奇人物;(奖章纪念牌等的)铭文;地图的图例,插图的说明; [or]sat;
legerdemain: [a]/ˈledʒərdəmeɪn/; [n]手法;骗术;巧妙的花招; [or]sat;
lethal: [a]/ˈliːθl/; [adj]致命的,致死的;杀伤性的; [n]致死因子; [or]sat;
lethargic: [a]/ləˈθɑːrdʒɪk/; [adj]困倦的,无力的,无兴趣的; [or]sat;
levitate: [a]/ˈlevɪteɪt/; [v](使)轻轻浮起,(使)飘浮空中; [or]sat;
levity: [a]/ˈlevəti/; [n]轻率,轻浮,多变,不稳定; [or]sat;
levy: [a]/ˈlevi/; [v]征收(税等); [n]征税;税款; [or]sat;
lewd: [a]/luːd/; [adj]好色的,淫荡的,猥亵的; [or]sat;
lexicographer: [a]/ˌleksɪˈkɑːɡrəfər/; [n]词典编纂人; [or]sat;
lexicon: [a]/ˈleksɪkən/; [n]词典,语言,文字; [or]sat;
liability: [a]/ˌlaɪəˈbɪləti/; [n]责任;债务;倾向;可能性;不利因素;惹麻烦的人(或事); [or]sat;
liaison: [a]/ˈliːəzɑːn/; [n]联系,暧昧关系; [or]sat;
libel: [a]/ˈlaɪbl/; [n]诽谤,中伤,诋毁;毁坏名誉的东西;控诉书; [v]中伤;控告;对.进行诽谤; [or]sat;
liberator: [a]/ˈlɪbəreɪtər/; [n]解放者;释放者; [or]sat;
libretto: [a]/lɪˈbretoʊ/; [n]歌词,歌剧剧本,剧本,歌词集; [or]sat;
licentious: [a]/laɪˈsenʃəs/; [adj]纵欲的,放肆的; [or]sat;
lilliputian: [a]/ˌlɪlɪˈpjuːʃn/; [adj]小人国的,气量小的; [n]侏儒,小人国居民; [or]sat;
limber: [a]/ˈlɪmbər/; [adj]松软的,柔软的;可塑的; [n](炮车的)拖车; [or]sat;
limerick: [a]/ˈlɪmərɪk/; [n]五行打油诗; [or]sat;
limpid: [a]/ˈlɪmpɪd/; [adj]清澈的,透明的,平静的; [or]sat;
lineage: [a]/ˈlɪniɪdʒ/; [n]血统,世系,门第,宗族;传承; [or]sat;
linger: [a]/ˈlɪŋɡər/; [v]逗留,留恋; [or]sat;
linguistic: [a]/lɪŋˈɡwɪstɪk/; [adj]语言的,语言上的; [or]sat;
lionize: [a]/ˈlaɪənaɪz/; [v]崇拜,把..奉为名人; [or]sat;
liquidate: [a]/ˈlɪkwɪdeɪt/; [vt]清理,清算,停业清理;清偿,清理,清算(破产的公司等),变卖,杀戮,废除; [or]sat;
listless: [a]/ˈlɪstləs/; [adj]无精打采的,倦怠的,情绪低落的;冷漠的; [or]sat;
lithe: [a]/laɪð/; [adj]轻盈的(等于lithesome);柔软的;易弯曲的; [or]sat;
litigation: [a]/ˌlɪtɪˈɡeɪʃn/; [n]诉讼;起诉; [or]sat;
livid: [a]/ˈlɪvɪd/; [adj]气急败坏的,铅色的; [or]sat;
loath: [a]/loʊθ/; [adj]不愿意的; [or]sat;
loathe: [a]/loʊð/; [v]憎恨,厌恶; [or]sat;
lofty: [a]/ˈlɔːfti/; [adj]极高的,巍峨的;崇高的;高傲的; [or]sat;
log: [a]/lɔːɡ/; [n]原木;航海日志; [v]伐木;航行;记录;登录; [or]sat;
loiter: [a]/ˈlɔɪtər/; [v]虚度,闲荡,徘徊,走走停停; [or]sat;
loll: [a]/lɑːl/; [vi]懒洋洋地倚靠;闲荡; [vt]懒洋洋地倚靠着;使悬垂; [or]sat;
longevity: [a]/lɔːnˈdʒevəti/; [n]长寿,长命;寿命; [or]sat;
loom: [a]/luːm/; [n]织布机; [v]阴森地逼近;隐现;即将来临; [or]sat;
lope: [a]/loʊp/; [n]轻快的步伐,大步慢跑; [v]轻快地迈着大步; [or]sat;
lout: [a]/laʊt/; [n]粗人,笨拙的人; [or]sat;
lucid: [a]/ˈluːsɪd/; [adj]明晰的;透明的;易懂的;头脑清楚的; [or]sat;
lucrative: [a]/ˈluːkrətɪv/; [adj]合算的;获利的;有利可图的; [or]sat;
ludicrous: [a]/ˈluːdɪkrəs/; [adj]荒谬的,可笑的,滑稽的; [or]sat;
lugubrious: [a]/ləˈɡuːbriəs/; [adj]闷闷不乐的;郁郁寡欢的,悲哀的; [or]sat;
lull: [a]/lʌl/; [v]使平静,使安静,哄骗; [n]间歇,暂停,暂时平静; [or]sat;
lumber: [a]/ˈlʌmbər/; [v]缓慢地移动;拖累,迫使担负;伐木;杂乱地堆积;隆隆地行进; [n]木材;废旧家具,不用的大件物品;无用的杂物;隆隆声; [or]sat;
luminary: [a]/ˈluːmɪneri/; [n]杰出人物,发光体; [or]sat;
luminous: [a]/ˈluːmɪnəs/; [adj]发光的;鲜艳的;明亮的;夜光的; [or]sat;
lunar: [a]/ˈluːnər/; [adj]月亮的; [or]sat;
lunge: [a]/lʌndʒ/; [n]突然刺(入);突然向前冲〔扑等);套马索; [v](用剑等)刺,戳;猛向前冲,猛扑; [or]sat;
lurid: [a]/ˈlʊrɪd/; [adj](暴力,性爱等)耸人听闻的; [or]sat;
lurk: [a]/lɜːrk/; [n]潜伏,潜行; [vi]潜伏;潜藏;鬼鬼祟祟地走; [or]sat;
luscious: [a]/ˈlʌʃəs/; [adj]美味的;满足感官的; [or]sat;
luster: [a]/ˈlʌstər/; [n]光泽,光彩; [v](使)有光泽;发亮; [or]sat;
lustrous: [a]/ˈlʌstrəs/; [adj]有光泽的;光辉的; [or]sat;
luxuriant: [a]/lʌɡˈʒʊriənt/; [adj]繁茂的;多产的;绚烂的;奢华的; [or]sat;
madrigal: [a]/ˈmædrɪɡl/; [n]情歌,小曲; [or]sat;
maelstrom: [a]/ˈmeɪlstrɑːm/; [n]大漩涡;灾祸;不可抗的破坏力; [or]sat;
magnanimous: [a]/mæɡˈnænɪməs/; [adj]宽宏大量的,大度的;慷慨的; [or]sat;
magnate: [a]/ˈmæɡneɪt/; [n]大人物;大亨,巨头;权贵; [or]sat;
magnitude: [a]/ˈmæɡnɪtuːd/; [n]巨大;震级;重要性;<数>量值; [or]sat;
maim: [a]/meɪm/; [v]使残废; [or]sat;
maladroit: [a]/ˌmæləˈdrɔɪt/; [adj]笨拙的; [or]sat;
malady: [a]/ˈmælədi/; [n]疾病,弊病; [or]sat;
malaise: [a]/məˈleɪz/; [n]不舒服;心神不安; [or]sat;
malcontent: [a]/ˌmælkənˈtent/; [n]不满分子,反抗者; [adj]不满的,不服的; [or]sat;
malediction: [a]/ˌmæləˈdɪkʃən/; [n]诅咒;坏话; [or]sat;
malefactor: [a]/ˈmælɪfæktər/; [n]罪犯,犯人; [or]sat;
malevolent: [a]/məˈlevələnt/; [adj]有恶意的,恶毒的; [or]sat;
malicious: [a]/məˈlɪʃəs/; [adj]怀恶意的,恶毒的; [or]sat;
malign: [a]/məˈlaɪn/; [v]诽谤,中伤; [adj]邪恶的;有害的; [or]sat;
malignant: [a]/məˈlɪɡnənt/; [adj]恶性的,恶毒的,充满恨意的; [n]怀有恶意的人;保王党员; [or]sat;
malleable: [a]/ˈmæliəbl/; [adj](金属)可锻的;有延展性的;(性格)可训练的;易适应的; [or]sat;
malodorous: [a]/ˌmælˈoʊdərəs/; [adj]有恶臭的;令人极为反感的;不合法的; [or]sat;
mammal: [a]/ˈmæml/; [n]哺乳动物; [or]sat;
mammoth: [a]/ˈmæməθ/; [n]长毛象,猛犸象,庞然大物; [adj]巨大的,庞大的,猛犸似的; [or]sat;
mandate: [a]/ˈmændeɪt/; [n]授权;命令,指令;委托管理;受命进行的工作; [v]授权;托管; [or]sat;
mandatory: [a]/ˈmændətɔːri/; [adj]命令的,强制性的; [or]sat;
manifest: [a]/ˈmænɪfest/; [adj]显然的,明白无误的,明了的; [v]使显现,使显露,表明; [n]货单,旅客名单; [or]sat;
manifesto: [a]/ˌmænɪˈfestoʊ/; [n]宣言,声明;告示; [v]发表宣言; [or]sat;
manipulate: [a]/məˈnɪpjuleɪt/; [v]操纵,影响;正骨; [or]sat;
mannered: [a]/ˈmænərd/; [adj]装模作样的,矫揉造作的,墨守成规的,中规中矩的; [or]sat;
marital: [a]/ˈmærɪtl/; [adj]婚姻的; [or]sat;
maritime: [a]/ˈmærɪtaɪm/; [adj]海事的,海上的,沿海的,近海的;海员的,水手的; [or]sat;
marked: [a]/mɑːrkt/; [adj]有记号的;显著的;被监视的;引人注目的; [v]作记号; [or]sat;
marquee: [a]/mɑːrˈkiː/; [n]选取框;大天幕;华盖; [adj]〈美〉最重要的; [or]sat;
marshal: [a]/ˈmɑːrʃl/; [v]整理,排列,集结; [n]元帅;司仪,主持人; [or]sat;
marsupial: [a]/mɑːrˈsuːpiəl/; [n]有袋哺乳动物(袋鼠,袋熊,袋狼); [or]sat;
martial: [a]/ˈmɑːrʃl/; [adj]武术的;好战的;军事的; [or]sat;
martinet: [a]/ˌmɑːrtnˈet/; [n]纪律严明之人; [or]sat;
martyr: [a]/ˈmɑːrtər/; [n]烈士;受难者;乞怜者; [v]迫害,折磨; [or]sat;
material: [a]/məˈtɪriəl/; [n]材料,原料,资料; [adj]物质的,实体的; [or]sat;
materialism: [a]/məˈtɪriəlɪzəm/; [n]唯物主义,物质主义; [or]sat;
maternal: [a]/məˈtɜːrnl/; [adj]母亲的,母性的;母方的,母系的; [or]sat;
matriculate: [a]/məˈtrɪkjuleɪt/; [n]被录取者; [v]准许.入学; [or]sat;
maudlin: [a]/ˈmɔːdlɪn/; [adj]感情脆弱的;容易流泪的;酒后伤感的; [or]sat;
maverick: [a]/ˈmævərɪk/; [n]独行者,想法与众不同的人; [adj]行为不合常规的; [v]用不正当手段获取;迷路; [or]sat;
mawkish: [a]/ˈmɔːkɪʃ/; [adj]令人厌恶的,伤感的; [or]sat;
maxim: [a]/ˈmæksɪm/; [n]格言;准则;座右铭; [or]sat;
meager: [a]/ˈmiːɡər/; [adj]瘦的;贫乏的;粗劣的;少量的; [or]sat;
meander: [a]/miˈændər/; [n]蜿蜒曲折,迂回曲折的旅程;漫步; [v]迂回曲折;漫步;漫谈; [or]sat;
meddlesome: [a]/ˈmedlsəm/; [adj]爱管闲事的,好事的,好插手的; [or]sat;
mediate: [a]/ˈmiːdieɪt/; [v]调解,调停,斡旋; [or]sat;
mediocre: [a]/ˌmiːdiˈoʊkər/; [adj]普通的;平凡的;中等的; [or]sat;
meditation: [a]/ˌmedɪˈteɪʃn/; [n]沉思,冥想; [or]sat;
medley: [a]/ˈmedli/; [adj]大杂烩,混合物; [n]混合;混杂;混合物; [or]sat;
meek: [a]/miːk/; [adj]温顺的,逆来顺受的;谦恭的; [n]温顺的人;谦恭的人; [or]sat;
melancholy: [a]/ˈmelənkɑːli/; [n]忧郁,悲哀; [adj]忧郁的,令人伤感的; [or]sat;
mellifluous: [a]/meˈlɪfluəs/; [adj](曲调)优美的;流畅的;如蜜般的; [or]sat;
membrane: [a]/ˈmembreɪn/; [n]膜;薄膜;羊皮纸; [or]sat;
memento: [a]/məˈmentoʊ/; [n]纪念品; [or]sat;
menagerie: [a]/məˈnædʒəri/; [n]形形色色,动物园,野生动物(总称); [or]sat;
mendacious: [a]/menˈdeɪʃəs/; [adj]撒谎的,虚假的; [or]sat;
menial: [a]/ˈmiːniəl/; [adj]仆人的,乏味的; [n]家仆; [or]sat;
mentor: [a]/ˈmentɔːr/; [n]导师,指导; [vt]做.的良师;指导; [or]sat;
mercenary: [a]/ˈmɜːrsəneri/; [n]外国雇佣兵;唯利是图者; [adj]唯利是图的;雇佣的; [or]sat;
mercurial: [a]/mɜːrˈkjʊriəl/; [adj](情绪)善变的; [or]sat;
merger: [a]/ˈmɜːrdʒər/; [n](企业等的)合并;并购;吸收(如刑法中重罪吸收轻罪); [or]sat;
mesmerize: [a]/ˈmezməraɪz/; [v]施催眠术;吸引,使神魂颠倒; [or]sat;
metamorphosis: [a]/ˌmetəˈmɔːrfəsɪs/; [n]变形,变质,变异;<生物学>变态; [or]sat;
metaphor: [a]/ˈmetəfər/; [n]暗喻,隐喻; [or]sat;
metaphysical: [a]/ˌmetəˈfɪzɪkl/; [adj]形而上学的;超自然的;玄学派诗歌的; [or]sat;
methodical: [a]/məˈθɑːdɪkl/; [adj]有系统的,有方法的; [or]sat;
meticulous: [a]/məˈtɪkjələs/; [adj]谨小慎微的;一丝不苟的; [or]sat;
metropolis: [a]/məˈtrɑːpəlɪs/; [n]大城市; [or]sat;
mettle: [a]/ˈmetl/; [n]勇气,毅力,耐力; [or]sat;
microcosm: [a]/ˈmaɪkroʊkɑːzəm/; [n]微观世界,缩影; [or]sat;
migrant: [a]/ˈmaɪɡrənt/; [n]候鸟;移民; [or]sat;
migratory: [a]/ˈmaɪɡrətɔːri/; [adj]迁移的;流浪的; [or]sat;
milieu: [a]/mɪlˈjuː/; [n]周围环境;背景;周围;出身背景; [or]sat;
militant: [a]/ˈmɪlɪtənt/; [adj]好战的,好暴力的; [n]激进分子,斗士; [or]sat;
mimicry: [a]/ˈmɪmɪkri/; [n]模仿;拟态; [or]sat;
minuscule: [a]/ˈmɪnəskjuːl/; [adj]极小的,微型的; [or]sat;
mirage: [a]/məˈrɑːʒ/; [n]幻影,海市蜃楼; [or]sat;
mire: [a]/ˈmaɪər/; [n]泥沼,困境; [or]sat;
mirth: [a]/mɜːrθ/; [n]欢乐,欢笑; [or]sat;
misanthrope: [a]/ˈmɪsənθroʊp/; [n]愤世嫉俗者;厌世者;厌恶人类的人; [or]sat;
misapprehension: [a]/ˌmɪsæprɪˈhenʃn/; [n]错误的理解,错误的判断; [or]sat;
miscellany: [a]/ˈmɪsəleɪni/; [n]混合物,混杂; [or]sat;
mischance: [a]/ˌmɪsˈtʃæns/; [n]不幸,灾难; [or]sat;
misconception: [a]/ˌmɪskənˈsepʃn/; [n]误解;错误想法; [or]sat;
misconstrue: [a]/ˌmɪskənˈstruː/; [v]误解,曲解; [or]sat;
misdemeanor: [a]/ˌmɪsdɪ'miːnə/; [n]轻罪,品行不端; [or]sat;
miserly: [a]/ˈmaɪzərli/; [adj]贪财的,吝啬的; [or]sat;
mishap: [a]/ˈmɪshæp/; [n]不幸的事,灾祸;晦气; [or]sat;
misrepresent: [a]/ˌmɪsˌreprɪˈzent/; [vi]作虚假陈述; [vt]歪曲;误传; [or]sat;
missile: [a]/ˈmɪsl/; [n]导弹;投射出的物体或武器; [adj]导弹的;可投掷的;用以发射导弹的; [or]sat;
missive: [a]/ˈmɪsɪv/; [n]公文,公函; [adj]送出的; [or]sat;
mite: [a]/maɪt/; [n]极小量,小虫; [or]sat;
mitigate: [a]/ˈmɪtɪɡeɪt/; [v]减轻,缓和; [or]sat;
mobile: [a]/ˈmoʊbl/; [n]风铃,悬挂饰物;手机,移动电话; [adj]可移动的;行动方便的; [or]sat;
mock: [a]/mɑːk/; [v]嘲笑;轻蔑,蔑视; [adj]不真诚的;伪造的; [n]模拟考; [or]sat;
mode: [a]/moʊd/; [n]模式;方式; [or]sat;
modulate: [a]/ˈmɑːdʒəleɪt/; [v]调整(音调);变调;调节(使平衡); [or]sat;
molecule: [a]/ˈmɑːlɪkjuːl/; [n]分子,微粒; [or]sat;
mollify: [a]/ˈmɑːlɪfaɪ/; [v]安慰,安抚; [or]sat;
molt: [a]/moʊlt/; [v]脱毛,换毛; [n]换羽期,脱毛期; [or]sat;
molten: [a]/ˈmoʊltən/; [adj]熔化的; [or]sat;
momentum: [a]/moʊˈmentəm/; [n](物理)动量;势头;动力; [or]sat;
monarchy: [a]/ˈmɑːnərki/; [n]君主,最高统治者;君主政体;君主国; [or]sat;
monastic: [a]/məˈnæstɪk/; [n]僧侣; [adj]修道院的,寺院的;僧侣的;克己的; [or]sat;
monetary: [a]/ˈmɑːnɪteri/; [adj]货币的,金融的;金钱的; [or]sat;
monochromatic: [a]/ˌmɑːnəkroʊˈmætɪk/; [adj]<物>单色的; [or]sat;
monolithic: [a]/ˌmɑːnəˈlɪθɪk/; [adj]巨石的,庞大的;千篇一律的; [or]sat;
monotony: [a]/məˈnɑːtəni/; [n]单调乏味,无聊;无变化; [or]sat;
montage: [a]/ˌmɑːnˈtɑːʒ/; [n]蒙太奇(电影的基本结构手段和叙事方式),混合画,拼集的照片; [or]sat;
monumental: [a]/ˌmɑːnjuˈmentl/; [adj]纪念碑的;不朽的;非常的; [or]sat;
moratorium: [a]/ˌmɔːrəˈtɔːriəm/; [n]暂停,中止;<金融>延期偿付; [or]sat;
morbid: [a]/ˈmɔːrbɪd/; [adj]疾病的;(精神等)病态的;恐怖的; [or]sat;
mores: [a]/ˈmɔːreɪz/; [n]风俗习惯,道德观念; [or]sat;
moribund: [a]/ˈmɔːrɪbʌnd/; [adj]濒临失败的,垂死的; [n]垂死的人; [or]sat;
morose: [a]/məˈroʊs/; [adj]脾气坏的,乖戾的,不高兴的; [or]sat;
mortician: [a]/mɔːrˈtɪʃn/; [n]丧事承办人; [or]sat;
mortify: [a]/ˈmɔːrtɪfaɪ/; [v]使屈辱;抑制;苦修;约束; [or]sat;
mosaic: [a]/moʊˈzeɪɪk/; [n]镶嵌细工,马赛克; [adj]摩西的;拼花的; [vt]镶嵌;用马赛克装饰; [or]sat;
mote: [a]/moʊt/; [n]微粒,微尘; [or]sat;
motif: [a]/moʊˈtiːf/; [n]基本图案;主题,中心思想,<音>乐旨; [or]sat;
motley: [a]/ˈmɑːtli/; [adj]混杂的,杂色的; [n]混杂;杂色衣服;小丑; [or]sat;
mottled: [a]/ˈmɑːtld/; [adj]有杂色的,斑驳的; [or]sat;
muddle: [a]/ˈmʌdl/; [n]混乱,杂乱,(头脑的)糊涂; [v](使)混乱,(使)迷惑,混淆; [adj]引起困惑的;使人糊涂的;难以理解的; [or]sat;
muggy: [a]/ˈmʌɡi/; [adj](天气)闷热而潮湿的; [or]sat;
multifaceted: [a]/ˌmʌltiˈfæsɪtɪd/; [adj]多层面的; [or]sat;
multifarious: [a]/ˌmʌltɪˈferiəs/; [adj]多种的,各式各样的; [or]sat;
multilingual: [a]/ˌmʌltiˈlɪŋɡwəl/; [n]懂多种语言的人; [adj]使用多种语言的,懂几国文字的; [or]sat;
multiplicity: [a]/ˌmʌltɪˈplɪsəti/; [n]多样性;许多,大量; [or]sat;
mundane: [a]/mʌnˈdeɪn/; [adj]普通的,平凡的;单调的;现世的,世俗的; [or]sat;
munificent: [a]/mjuːˈnɪfɪsnt/; [adj]慷慨的,大方的; [or]sat;
mural: [a]/ˈmjʊrəl/; [n]壁画;壁饰; [adj]墙壁的;挂在墙壁上的; [or]sat;
murky: [a]/ˈmɜːrki/; [adj]黑暗的,朦胧的; [adv]阴暗地,混浊地,可疑地; [n]阴暗;昏暗;混浊;可疑; [or]sat;
muse: [a]/mjuːz/; [v]沉思;冥想; [n]<希神>缪斯女神,灵感; [or]sat;
mushroom: [a]/ˈmʌʃrʊm/; [n]蘑菇; [vi]迅速发展;采蘑菇; [or]sat;
muster: [a]/ˈmʌstər/; [vi]集合;聚集; [vt]集合;召集; [n]集合;集合人员; [or]sat;
mutinous: [a]/ˈmjuːtənəs/; [adj]加入叛变的,反抗的; [or]sat;
myopic: [a]/maɪˈɑːpɪk/; [n]近视; [adj]近视的;目光短浅的; [or]sat;
myriad: [a]/ˈmɪriəd/; [n]无数;极大数量; [adj]无数的; [or]sat;
mystify: [a]/ˈmɪstɪfaɪ/; [v]使神秘化,使迷惑,使困惑; [or]sat;
nadir: [a]/ˈneɪdɪr/; [n]最低点,无底; [or]sat;
narrative: [a]/ˈnærətɪv/; [n]叙述; [adj]叙述的; [or]sat;
nascent: [a]/ˈnæsnt/; [adj]初生的,萌芽的;发生中的; [or]sat;
natty: [a]/ˈnæti/; [adj]整洁的,干净的,潇洒的; [or]sat;
nauseate: [a]/ˈnɔːzieɪt/; [v]使作呕,产生恶感; [or]sat;
nautical: [a]/ˈnɔːtɪkl/; [adj]航海的;海上的;海员的; [or]sat;
navigable: [a]/ˈnævɪɡəbl/; [adj](江河,海洋)可航行的,可通航的;(船)适航的; [or]sat;
nebulous: [a]/ˈnebjələs/; [adj]朦胧的,星云的,星云状的; [or]sat;
necromancy: [a]/ˈnekroʊmænsi/; [n]巫术,通灵术; [or]sat;
nefarious: [a]/nɪˈferiəs/; [adj]违法的,邪恶的; [or]sat;
negate: [a]/nɪˈɡeɪt/; [vt]取消,使无效;否定,否认; [n]反面,对立面; [vi]否定,否认; [or]sat;
negligence: [a]/ˈneɡlɪdʒəns/; [n]疏忽; [or]sat;
negligible: [a]/ˈneɡlɪdʒəbl/; [adj]微不足道的,可忽略不计的; [or]sat;
nemesis: [a]/ˈneməsɪs/; [n]报应,天罚,主要敌人,强硬对手; [or]sat;
neologism: [a]/niˈɑːlədʒɪzəm/; [n]新生词; [or]sat;
neophyte: [a]/ˈniːəfaɪt/; [n]新信徒;新入教者;初学者; [or]sat;
nepotism: [a]/ˈnepətɪzəm/; [n]偏袒的人(亲戚); [or]sat;
nettle: [a]/ˈnetl/; [v]刺激;惹恼;用荨麻刺; [n]荨麻; [or]sat;
neutral: [a]/ˈnuːtrəl/; [adj]中立的;中性的; [n]中立国;中性色; [or]sat;
nicety: [a]/ˈnaɪsəti/; [n]细节,讲究; [or]sat;
nip: [a]/nɪp/; [v]咬;捏;剪断;冻伤;阻止; [n]夹;捏;刺骨;小饮; [or]sat;
nirvana: [a]/nɪrˈvɑːnə/; [n]涅槃,心灵的平静,极乐; [or]sat;
nocturnal: [a]/nɑːkˈtɜːrnl/; [adj]夜晚的,夜间发生的; [or]sat;
noisome: [a]/ˈnɔɪsəm/; [adj]恶臭的;令人不快的; [or]sat;
nomadic: [a]/noʊˈmædɪk/; [adj]游牧的;流浪的;游动的; [or]sat;
nomenclature: [a]/ˈnoʊmənkleɪtʃər/; [n]术语,命名系统; [or]sat;
nominal: [a]/ˈnɑːmɪnl/; [adj]名义上的;象征性的,很少的;名词性的; [or]sat;
nonchalance: [a]/ˌnɑːnʃəˈlɑːns/; [n]无动于衷,冷淡; [or]sat;
noncommittal: [a]/ˌnɒnkə'mɪtəl/; [adj]态度不明朗的;不承担义务的;无明确意义的; [or]sat;
nondescript: [a]/ˈnɑːndɪskrɪpt/; [adj]没有特征的,难以形容的,难以归类的; [n]难以名状,不属任何型类的人; [or]sat;
nonentity: [a]/nɑːˈnentəti/; [n]不存在,虚无;无能力之人,无足轻重的人; [or]sat;
nonplus: [a]/ˌnɒn'plʌs/; [v]使窘困;使迷惑;狼狈不堪; [n]迷惑,困惑; [or]sat;
nostalgia: [a]/nəˈstældʒə/; [n]怀旧之情,思乡病; [or]sat;
notable: [a]/ˈnoʊtəbl/; [n]著名人士; [adj]值得注意的,显著的,显要的; [or]sat;
novelty: [a]/ˈnɑːvlti/; [n]新奇;新奇的事物;新颖小巧而廉价的小物品; [adj]新奇的;风格独特的; [or]sat;
novice: [a]/ˈnɑːvɪs/; [n]生手,新手; [or]sat;
noxious: [a]/ˈnɑːkʃəs/; [adj]有害的,有毒的; [or]sat;
nuance: [a]/ˈnuːɑːns/; [n]细微差别; [or]sat;
nullify: [a]/ˈnʌlɪfaɪ/; [v]使无效,废弃,取消; [or]sat;
numismatist: [a]/nuːˈmɪzmətɪst/; [n]钱币学家,钱币收藏家; [or]sat;
nuptial: [a]/ˈnʌpʃl/; [adj]婚姻的,婚礼的; [n]婚礼; [or]sat;
nurture: [a]/ˈnɜːrtʃər/; [v]养育,培育;培植; [n]养育,培养;教养;营养物; [or]sat;
nutrient: [a]/ˈnuːtriənt/; [n]营养物;滋养物; [adj]营养的;滋养的; [or]sat;
oaf: [a]/oʊf/; [n]愚蠢的人; [or]sat;
obdurate: [a]/ˈɑːbdərət/; [adj]固执的,冷酷无情的; [or]sat;
obese: [a]/oʊˈbiːs/; [adj]肥胖的;过胖的; [or]sat;
obfuscate: [a]/ˈɑːbfʌskeɪt/; [v]使复杂;使迷乱,使模糊;弄暗; [or]sat;
obituary: [a]/oʊˈbɪtʃueri/; [n]讣告; [adj]关于死者的,讣告的; [or]sat;
objective: [a]/əbˈdʒektɪv/; [n]目标;目的; [adj]客观的; [or]sat;
obligatory: [a]/əˈblɪɡətɔːri/; [adj]强制性的;义务的;必须的; [or]sat;
oblique: [a]/əˈbliːk/; [adj]斜的,非直角的,隐射的; [v]倾斜; [n]<解>斜肌(尤指腹部的肌肉);倾斜物;<军>倾斜航空照片; [adv]<军>以45度角; [or]sat;
obliterate: [a]/əˈblɪtəreɪt/; [v]消灭;涂去;冲刷;忘掉; [or]sat;
oblivious: [a]/əˈblɪviəs/; [adj]不在意的;忘却的,健忘的; [or]sat;
obnoxious: [a]/əbˈnɑːkʃəs/; [adj]非常讨厌的;可憎的; [or]sat;
obscure: [a]/əbˈskjʊr/; [v]隐藏,使.模糊;使变暗;遮掩; [adj]不清楚的;难以理解的; [n]某种模糊的或不清楚的东西; [or]sat;
obsequious: [a]/əbˈsiːkwiəs/; [adj]逢迎的,谄媚的; [or]sat;
obsessive: [a]/əbˈsesɪv/; [adj]强迫性的;着迷的;分神的; [n]强迫症患者; [or]sat;
obsolete: [a]/ˌɑːbsəˈliːt/; [adj]已过时的;已废弃的; [v]使过时;使作废; [n]废词;被废弃的事物; [or]sat;
obstetrician: [a]/ˌɑːbstəˈtrɪʃn/; [n]产科医师; [or]sat;
obstinate: [a]/ˈɑːbstɪnət/; [adj]顽固的;较难治愈的; [or]sat;
obstreperous: [a]/əbˈstrepərəs/; [adj]吵闹的,喧嚣的;难驾驭的; [or]sat;
obtuse: [a]/əbˈtuːs/; [adj]迟钝的;圆头的;不锋利的; [or]sat;
obviate: [a]/ˈɑːbvieɪt/; [v]排除,避免,消除; [or]sat;
odious: [a]/ˈoʊdiəs/; [adj]可憎的,讨厌的; [adv]令人作呕地; [n]可憎,讨厌; [or]sat;
odium: [a]/ˈoʊdiəm/; [n]憎恶,反感; [or]sat;
odyssey: [a]/ˈɑːdəsi/; [n]长途冒险旅行;一连串的冒险;奥德赛; [or]sat;
offensive: [a]/əˈfensɪv/; [adj]冒犯的,进攻的,无礼的,令人不快的,得罪人的; [n]进攻; [or]sat;
officious: [a]/əˈfɪʃəs/; [adj]多管闲事的,非官方的; [adv]过分殷勤地; [n]过分殷勤,爱管闲事; [or]sat;
ogle: [a]/ˈoʊɡl/; [v]送秋波,施媚眼; [n]秋波,媚眼; [or]sat;
olfactory: [a]/ɑːlˈfæktəri/; [adj]嗅觉的; [or]sat;
oligarchy: [a]/ˈɑːləɡɑːrki/; [n]寡头政治; [or]sat;
ominous: [a]/ˈɑːmɪnəs/; [adj]不祥的,不吉利的; [or]sat;
omnipotent: [a]/ɑːmˈnɪpətənt/; [adj]全能的,万能的; [n]全能者; [or]sat;
omnipresent: [a]/ˌɑːmnɪˈpreznt/; [adj]无所不在的; [or]sat;
omniscient: [a]/ɑːmˈnɪsiənt/; [adj]无所不知的,博识的; [n]无所不知者,上帝; [or]sat;
omnivorous: [a]/ɑːmˈnɪvərəs/; [adj]杂食的,兴趣广泛的; [or]sat;
onerous: [a]/ˈɑːnərəs/; [adj]繁重的,麻烦的;负有义务的;负有法律责任的; [or]sat;
onset: [a]/ˈɑːnset/; [n]开始;攻击,袭击; [or]sat;
onus: [a]/ˈoʊnəs/; [n]义务,责任,负担; [or]sat;
opalescent: [a]/ˌoʊpəˈlesnt/; [adj]乳白色的;发乳白光的; [or]sat;
opaque: [a]/oʊˈpeɪk/; [adj]不透明的;难懂的; [or]sat;
opiate: [a]/ˈoʊpiət/; [n]鸦片制剂,麻醉剂,镇静剂; [adj]含鸦片的,安眠的; [v]用鸦片麻醉,使缓和; [or]sat;
opportune: [a]/ˌɑːpərˈtuːn/; [adj]适当的,恰好的,合时宜的; [or]sat;
opportunist: [a]/ˌɑːpərˈtuːnɪst/; [n]机会主义者;投机取巧者; [adj]机会主义的;投机的;见风转舵的; [or]sat;
optician: [a]/ɑːpˈtɪʃn/; [n]光学仪器商,眼镜商; [or]sat;
optimist: [a]/ˈɑːptɪmɪst/; [n]乐天派,乐观者; [or]sat;
optimum: [a]/ˈɑːptɪməm/; [adj]最适宜的;最佳的; [n]最适条件;最适宜; [or]sat;
optional: [a]/ˈɑːpʃənl/; [adj]可选择的; [or]sat;
opulence: [a]/ˈɑːpjələns/; [n]富裕,丰富; [or]sat;
opus: [a]/ˈoʊpəs/; [n]作品; [or]sat;
oracular: [a]/əˈrækjələr/; [adj]神谕的,意义模糊的,玄妙深奥的; [or]sat;
orator: [a]/ˈɔːrətər/; [n]演说者,演讲者,雄辩家,原告; [or]sat;
ordain: [a]/ɔːrˈdeɪn/; [v]注定;规定;任命(牧师);颁布命令; [or]sat;
ordeal: [a]/ɔːrˈdiːl/; [n]严峻考验,苦难的经历,折磨; [or]sat;
ordinance: [a]/ˈɔːrdɪnəns/; [n]法令;条例;条例;圣餐式; [or]sat;
ordination: [a]/ˌɔːrdnˈeɪʃn/; [n]神职授任; [or]sat;
orgy: [a]/ˈɔːrdʒi/; [n]狂欢;放荡; [or]sat;
orient: [a]/ˈɔːrient/; [n][the Orient]东方; [v]定..的方位; [adj]东方的;(太阳等)上升的,新生的;闪闪发光的; [or]sat;
orientation: [a]/ˌɔːriənˈteɪʃn/; [n]信仰;倾向;<计>定向;(学生)迎新会;定向,方向;(任职,上学等之前的) 情况介绍;训练; [or]sat;
ornate: [a]/ɔːrˈneɪt/; [adj]装饰华丽的;修辞上极考究的; [or]sat;
ornithologist: [a]/ˌɔːrnɪˈθɑːlədʒɪst/; [n]鸟类学者; [or]sat;
ornithology: [a]/ˌɔːrnɪˈθɑːlədʒi/; [n]鸟类学;鸟学论文; [or]sat;
orthodox: [a]/ˈɔːrθədɑːks/; [adj]正统的;传统的;(Orthodox)东正教的; [or]sat;
oscillate: [a]/ˈɑːsɪleɪt/; [v]摆动,犹豫; [or]sat;
ossify: [a]/ˈɑːsɪfaɪ/; [v]硬化,骨化; [or]sat;
ostensible: [a]/ɑːˈstensəbl/; [adj]表面上的,伪装的; [or]sat;
ostentatious: [a]/ˌɑːstenˈteɪʃəs/; [adj]浮华的,虚饰的,外观美丽的; [or]sat;
ostracize: [a]/ˈɑːstrəsaɪz/; [v]放逐,排斥,(古希腊)按贝壳流放法放逐; [or]sat;
oust: [a]/aʊst/; [v]罢免,驱逐,剥夺,取代; [or]sat;
outlandish: [a]/aʊtˈlændɪʃ/; [adj]稀奇古怪的,奇特的;异国风情的; [or]sat;
outmoded: [a]/ˌaʊtˈmoʊdɪd/; [adj]不再流行的,过时的; [or]sat;
outskirts: [a]/ˈaʊtskɜːrts/; [n](尤指城市)郊区; [or]sat;
outspoken: [a]/aʊtˈspoʊkən/; [adj]直言的,坦率的; [or]sat;
outstrip: [a]/ˌaʊtˈstrɪp/; [v]比.优越,胜过,比.跑得快; [or]sat;
outwit: [a]/ˌaʊtˈwɪt/; [v]以机智胜过; [or]sat;
ovation: [a]/oʊˈveɪʃn/; [n]热烈欢迎,欢呼; [or]sat;
overbearing: [a]/ˌoʊvərˈberɪŋ/; [adj]专横的,独断的,傲慢的; [or]sat;
overt: [a]/oʊˈvɜːrt/; [adj]明显的;公开的;公然的; [or]sat;
overwrought: [a]/ˌoʊvərˈrɔːt/; [adj]过分紧张的,过度兴奋的; [or]sat;
pachyderm: [a]/ˈpækidɜːrm/; [n]迟钝的人;厚脸皮的人;厚皮类动物; [or]sat;
pacifist: [a]/ˈpæsɪfɪst/; [n]和平主义者; [adj]非战主义的; [or]sat;
pacify: [a]/ˈpæsɪfaɪ/; [v]使平静,安慰,抚慰; [or]sat;
pact: [a]/pækt/; [n]合同;协约; [or]sat;
paean: [a]/ˈpiːən/; [n]欢乐颂,赞美歌; [or]sat;
painstaking: [a]/ˈpeɪnzteɪkɪŋ/; [adj](不辞)劳苦的,辛勤的; [n]辛劳,煞费苦心; [or]sat;
palatable: [a]/ˈpælətəbl/; [adj]美味的,合口味的,合心意的; [or]sat;
palette: [a]/ˈpælət/; [n]调色板,一套颜料; [or]sat;
pall: [a]/pɔːl/; [n]幕;棺罩;遮盖物; [v]覆盖;使乏味;走味; [or]sat;
palliate: [a]/ˈpælieɪt/; [v]减轻,掩饰,辩解; [or]sat;
pallid: [a]/ˈpælɪd/; [adj]苍白的,病态的,无生气的; [or]sat;
palpable: [a]/ˈpælpəbl/; [adj]明显的,易觉察的,可触知的; [or]sat;
palpitate: [a]/ˈpælpɪteɪt/; [v](心脏)悸动,发抖; [or]sat;
paltry: [a]/ˈpɔːltri/; [adj]不足取的,无价值的,琐碎的,卑鄙的; [or]sat;
pan: [a]/pæn/; [n]平底锅; [v]严厉批评;淘金; [or]sat;
panacea: [a]/ˌpænəˈsiːə/; [n]灵丹妙药,万能药; [or]sat;
panache: [a]/pəˈnæʃ/; [n]羽饰,神气十足; [or]sat;
pandemic: [a]/pænˈdemɪk/; [adj]全国流行的;普遍的; [or]sat;
pandemonium: [a]/ˌpændəˈmoʊniəm/; [n]地狱,混乱; [or]sat;
panegyric: [a]/ˌpænəˈdʒɪrɪk/; [n]颂词,赞词; [or]sat;
panoramic: [a]/ˌpænəˈræmɪk/; [adj]全景的; [or]sat;
pantomime: [a]/ˈpæntəmaɪm/; [n]哑剧,〈英〉(圣诞节上演的)童话剧; [vi]打手势,演哑剧; [or]sat;
papyrus: [a]/pəˈpaɪrəs/; [n]纸莎草;纸莎草纸; [or]sat;
parable: [a]/ˈpærəbl/; [n]寓言,比喻; [or]sat;
paradigm: [a]/ˈpærədaɪm/; [n]范例,示范; [or]sat;
paradox: [a]/ˈpærədɑːks/; [n]矛盾;似矛盾而正确的说法; [or]sat;
paragon: [a]/ˈpærəɡɑːn/; [n]模范;完美之物;优秀之人; [adj]完美的; [or]sat;
paramount: [a]/ˈpærəmaʊnt/; [n]元首;最高; [adj]最高的,至上的,首要的; [or]sat;
paranoia: [a]/ˌpærəˈnɔɪə/; [n](心理)偏执狂,多疑症; [or]sat;
paraphrase: [a]/ˈpærəfreɪz/; [v]解释,释义; [n]转述,释义; [or]sat;
parasite: [a]/ˈpærəsaɪt/; [n]寄生虫;靠他人为生的人; [or]sat;
parched: [a]/pɑːrtʃt/; [adj]干旱的,干渴的; [or]sat;
pariah: [a]/pəˈraɪə/; [n]被排斥或鄙视的人; [or]sat;
parity: [a]/ˈpærəti/; [n]相等;同等;平价; [or]sat;
parochial: [a]/pəˈroʊkiəl/; [adj]教区的;地方范围的; [or]sat;
parody: [a]/ˈpærədi/; [n]嘲弄文章,拙劣的模仿; [v]拙劣模仿; [or]sat;
paroxysm: [a]/ˈpærəksɪzəm/; [n]突发,阵发; [adj]发作性的,爆发性的; [or]sat;
parry: [a]/ˈpæri/; [v]挡开,避开(武器,问题等); [or]sat;
partial: [a]/ˈpɑːrʃl/; [adj]偏爱的,特别喜欢的;偏袒的,不公平的,有偏见的;部分的;不完全的; [n]<数学>偏微商; [or]sat;
partisan: [a]/ˈpɑːrtəzn/; [adj]党派的;效忠的;偏袒的;盲目推崇的; [n]党羽;虔诚信徒;游击队; [or]sat;
partition: [a]/pɑːrˈtɪʃn/; [n]划分;隔开物,隔墙,隔板; [v]隔开; [vt]瓜分;分割; [or]sat;
passive: [a]/ˈpæsɪv/; [adj]被动的;消极的; [n]被动语态; [or]sat;
pastoral: [a]/ˈpæstərəl/; [adj]田园生活的,牧师的; [n]牧歌;田园诗;田园景色;牧师写给教区居民的公开信; [or]sat;
patent: [a]/ˈpætnt/; [n]专利; [adj]显然的,明显的;专利的;独创的; [v]取得.的专利权; [or]sat;
pathetic: [a]/pəˈθetɪk/; [adj]可怜的;不足的; [or]sat;
pathological: [a]/ˌpæθəˈlɑːdʒɪkl/; [adj]病理学的;病态的;由疾病引起的(等于pathologic); [or]sat;
pathos: [a]/ˈpeɪθɑːs/; [n]悲怆,哀婉;痛苦; [or]sat;
patina: [a]/pəˈtiːnə/; [n]绿锈,光亮的外表,神态,圣餐盘; [or]sat;
patriarch: [a]/ˈpeɪtriɑːrk/; [n]家长;族长;创办人;最年长者; [or]sat;
patrician: [a]/pəˈtrɪʃn/; [n]贵族; [adj]贵族的;显贵的;(相貌等)贵族似的; [or]sat;
patronize: [a]/ˈpeɪtrənaɪz/; [v]惠顾;赞助,资助; [or]sat;
paucity: [a]/ˈpɔːsəti/; [n]小量,缺乏; [or]sat;
pauper: [a]/ˈpɔːpər/; [n]贫民,乞丐; [or]sat;
pecuniary: [a]/pɪˈkjuːnieri/; [adj]金钱(上)的; [or]sat;
pedagogy: [a]/ˈpedəɡɑːdʒi/; [n]教育学,教学法; [or]sat;
pedant: [a]/ˈpednt/; [n]学究式人物,书呆子,卖弄学问的人; [or]sat;
pedestrian: [a]/pəˈdestriən/; [n]步行者,行人; [adj]步行的;平庸无奇的,无聊的; [or]sat;
pediatrician: [a]/ˌpiːdiəˈtrɪʃn/; [n]儿科医师(等于pediatrist); [or]sat;
peerless: [a]/ˈpɪrləs/; [adj]无与伦比的;无可匹敌的; [or]sat;
pejorative: [a]/pɪˈdʒɔːrətɪv/; [n]轻蔑语; [adj]带有轻蔑意义的,贬低的; [or]sat;
pellucid: [a]/pəˈluːsɪd/; [adj]透明的,清晰的,明了的; [or]sat;
penchant: [a]/ˈpentʃənt/; [n]倾向,爱好; [or]sat;
pendant: [a]/ˈpendənt/; [n]吊坠,下垂物; [or]sat;
penitent: [a]/ˈpenɪtənt/; [adj]后悔的,忏悔的; [n]改过迁善的人;忏悔的人;悔罪者; [or]sat;
pensive: [a]/ˈpensɪv/; [adj]沉思的,心事重重的,忧郁的; [or]sat;
penury: [a]/ˈpenjəri/; [n]贫穷; [or]sat;
perceptive: [a]/pərˈseptɪv/; [adj]感知的,知觉的;有知觉力的; [or]sat;
percussion: [a]/pərˈkʌʃn/; [n]撞击,敲击;敲打乐器; [or]sat;
peremptory: [a]/pəˈremptəri/; [adj]专横的,不容反抗的; [or]sat;
perennial: [a]/pəˈreniəl/; [adj]终年的,永久的;四季不断的;反复的; [n]多年生植物; [or]sat;
perfidious: [a]/pərˈfɪdiəs/; [adj]不忠的,背信弃义的; [or]sat;
perforate: [a]/ˈpɜːrfəreɪt/; [vt]穿孔于,打孔穿透;在.上打齿孔; [vi]穿过,贯穿;穿孔; [or]sat;
perfunctory: [a]/pərˈfʌŋktəri/; [adj]草率的,敷衍搪塞的; [or]sat;
perimeter: [a]/pəˈrɪmɪtər/; [n]周长;周界; [or]sat;
peripheral: [a]/pəˈrɪfərəl/; [adj]外围的; [n]外围设备; [or]sat;
periphery: [a]/pəˈrɪfəri/; [n]外围,不重要的部份; [or]sat;
perjury: [a]/ˈpɜːrdʒəri/; [n]伪证,假誓; [or]sat;
permeable: [a]/ˈpɜːrmiəbl/; [adj]可渗透的;可穿透的; [or]sat;
permeate: [a]/ˈpɜːrmieɪt/; [v]弥漫;普及;渗透; [or]sat;
pernicious: [a]/pərˈnɪʃəs/; [adj]有害的,恶性的,致命的; [or]sat;
perpetrate: [a]/ˈpɜːrpətreɪt/; [vt]犯罪,作恶;干坏事; [or]sat;
perpetual: [a]/pərˈpetʃuəl/; [adj]永远的,永恒的;不断的; [or]sat;
perpetuate: [a]/pərˈpetʃueɪt/; [adj]长存的; [vt]使永久存在,使不朽; [or]sat;
perquisite: [a]/ˈpɜːrkwɪzɪt/; [n]固定津贴,福利; [or]sat;
persona: [a]/pərˈsoʊnə/; [n]人物,角色; [or]sat;
personable: [a]/ˈpɜːrsənəbl/; [adj]英俊的,风度好的; [or]sat;
perspicacious: [a]/ˌpɜːrspɪˈkeɪʃəs/; [adj]独具慧眼的,聪颖的; [or]sat;
pertinacious: [a]/ˌpɜːrtnˈeɪʃəs/; [adj]顽固的,执拗的; [or]sat;
pertinent: [a]/ˈpɜːrtnənt/; [adj]有关的;适当的;中肯的; [n]附属物;参考; [or]sat;
perturb: [a]/pərˈtɜːrb/; [vt]使不安;烦扰;使紊乱; [or]sat;
peruse: [a]/pəˈruːz/; [v]详细考察;精读; [or]sat;
pervasive: [a]/pərˈveɪsɪv/; [adj]深入人心的,普遍的; [or]sat;
perverse: [a]/pərˈvɜːrs/; [adj]邪恶的;堕落的;倔强的;违反常情的; [or]sat;
pessimism: [a]/ˈpesɪmɪzəm/; [n]悲观,悲观主义; [or]sat;
petrify: [a]/ˈpetrɪfaɪ/; [v]石化,使僵化,使惊呆; [or]sat;
petty: [a]/ˈpeti/; [adj]价值不大的;小的;器量小的;琐碎的; [or]sat;
petulant: [a]/ˈpetʃələnt/; [adj]性急的,易怒的,爱闹气的; [or]sat;
phenomena: [a]/fə'nɒmɪnə/; [n]现象; [or]sat;
philology: [a]/fɪˈlɑːlədʒi/; [n]语言学; [or]sat;
phlegmatic: [a]/fleɡˈmætɪk/; [adj]冷淡的;迟钝的; [or]sat;
phobia: [a]/ˈfoʊbiə/; [n]恐惧症; [or]sat;
phoenix: [a]/ˈfiːnɪks/; [n]凤凰;死而复生的人; [or]sat;
physiological: [a]/ˌfɪziəˈlɑːdʒɪkl/; [adj]生理的,生理学的; [or]sat;
piebald: [a]/ˈpaɪbɔːld/; [adj]花斑的;杂色的; [or]sat;
piecemeal: [a]/ˈpiːsmiːl/; [n]片;块; [v]粉碎; [adv]零碎地;逐个地; [adj]零碎的;逐渐的; [or]sat;
pied: [a]/paɪd/; [adj]杂色的;斑驳的;穿花衣服的; [or]sat;
piety: [a]/ˈpaɪəti/; [n]虔诚,虔诚的行为或语言; [or]sat;
pigment: [a]/ˈpɪɡmənt/; [n]天然色素,颜料; [or]sat;
pillage: [a]/ˈpɪlɪdʒ/; [n]掠夺;掠夺物; [vt]掠夺,抢劫; [or]sat;
pine: [a]/paɪn/; [n]松树; [v](因死亡,离别等)难过,悲伤; [or]sat;
pinnacle: [a]/ˈpɪnəkl/; [n](哥德式建筑的)小尖塔,顶峰; [v]置于尖顶上,置于高处; [or]sat;
pious: [a]/ˈpaɪəs/; [adj]虔诚的;难以实现的;尽责的; [or]sat;
piquant: [a]/ˈpiːkənt/; [adj]辛辣的,开胃的;活泼有趣的; [or]sat;
pique: [a]/piːk/; [v]引起(好奇心,兴趣等),不悦,愤怒; [n]不悦,生气; [or]sat;
pitfall: [a]/ˈpɪtfɔːl/; [n]陷阱,未料到的危险或困难; [or]sat;
pithy: [a]/ˈpɪθi/; [adj]精练的,简洁有力的,多髓的; [or]sat;
pittance: [a]/ˈpɪtns/; [n]微薄的收入,小额津贴,少量; [or]sat;
pivotal: [a]/ˈpɪvətl/; [adj]关键的,枢轴的; [or]sat;
placate: [a]/ˈpleɪkeɪt/; [vt]安抚,抚慰; [or]sat;
placebo: [a]/pləˈsiːboʊ/; [n]安慰剂;为死者所诵的晚祷词; [or]sat;
placid: [a]/ˈplæsɪd/; [adj]安静的,平和的; [or]sat;
plagiarism: [a]/ˈpleɪdʒərɪzəm/; [n]剽窃,抄袭; [or]sat;
plagiarize: [a]/ˈpleɪdʒəraɪz/; [v]剽窃,抄袭(别人学说,著作); [or]sat;
plaintive: [a]/ˈpleɪntɪv/; [adj]表示悲痛的,伤心的; [or]sat;
plasticity: [a]/plæˈstɪsəti/; [n]可塑性;适应性;柔软性; [or]sat;
platitude: [a]/ˈplætɪtuːd/; [n]陈词滥调,老生常谈;单调; [or]sat;
plausible: [a]/ˈplɔːzəbl/; [adj]似乎有理的;巧嘴的; [or]sat;
plenitude: [a]/ˈplenɪtuːd/; [n]充分;丰富;大量; [or]sat;
plethora: [a]/ˈpleθərə/; [n]过多,过剩,多血症; [or]sat;
pliable: [a]/ˈplaɪəbl/; [adj]易弯的;柔韧的;圆滑的; [or]sat;
pliant: [a]/ˈplaɪənt/; [adj]易弯的,柔软的; [n]顺从; [or]sat;
plight: [a]/plaɪt/; [n]困境; [v]宣誓,保证; [or]sat;
plumage: [a]/ˈpluːmɪdʒ/; [n]全身羽毛; [or]sat;
plumb: [a]/plʌm/; [n]铅锤,测锤; [vi]垂直悬挂; [adj]垂直的; [vt]用铅锤测量; [adv]垂直地; [or]sat;
plummet: [a]/ˈplʌmɪt/; [v]垂直或突然地堕下,骤然下降; [n]测锤(钓丝的)坠子;线锤;铅锤线;锤规; [or]sat;
plutocracy: [a]/pluːˈtɑːkrəsi/; [n]富豪,财阀统治; [or]sat;
polarize: [a]/ˈpoʊləraɪz/; [v](使)极化,(使)偏振,(使)两极分化; [or]sat;
politic: [a]/ˈpɑːlətɪk/; [adj]策略性的,政治上的,国家的; [or]sat;
polygamist: [a]/pəˈlɪɡəmɪst/; [n]多配偶的人;多配偶论者; [or]sat;
polyglot: [a]/ˈpɑːliɡlɑːt/; [n]通晓数种语言的人;用通晓数种语言记载的书; [adj]通数国语言,数国语言的; [or]sat;
pomposity: [a]/pɑːmˈpɑːsəti/; [n]自大,傲慢,摆架子; [or]sat;
ponderous: [a]/ˈpɑːndərəs/; [adj]笨重的,笨拙的,沉闷的; [or]sat;
pontifical: [a]/pɑːnˈtɪfɪkl/; [adj]罗马教宗的,主教的; [or]sat;
pore: [a]/pɔːr/; [n]毛孔,细孔; [v]深思熟虑,仔细阅读,审视; [or]sat;
porous: [a]/ˈpɔːrəs/; [adj]可渗透的,多孔的,可穿越的; [or]sat;
portend: [a]/pɔːrˈtend/; [v]预兆,预示; [or]sat;
portent: [a]/ˈpɔːrtent/; [n]征兆,预兆;迹象; [or]sat;
portly: [a]/ˈpɔːrtli/; [n]肥胖的人;特大号服装; [adj]肥胖的;魁伟的; [or]sat;
poseur: [a]/poʊˈzɜːr/; [n]装模作样的人; [or]sat;
posterity: [a]/pɑːˈsterəti/; [n]子孙,后裔,后代; [or]sat;
posthumous: [a]/ˈpɑːstʃəməs/; [adj]遗腹的;著作者死后出版的;死后的; [or]sat;
postulate: [a]/ˈpɑːstʃəleɪt/; [v]假定.是真的; [n]假定; [or]sat;
potable: [a]/ˈpoʊtəbl/; [adj]适于饮用的; [n]饮料; [or]sat;
potent: [a]/ˈpoʊtnt/; [adj]强有力的;有权势的;有说服力的; [or]sat;
potentate: [a]/ˈpoʊtnteɪt/; [n]统治者,君主;有权势的人; [or]sat;
potential: [a]/pəˈtenʃl/; [n]潜力,潜能; [adj]潜在的,可能的; [or]sat;
potion: [a]/ˈpoʊʃn/; [n]一剂,一服;毒药,魔药; [or]sat;
practicable: [a]/ˈpræktɪkəbl/; [adj]能实行的,行得通的;适用的,能用的;可通行的; [or]sat;
practical: [a]/ˈpræktɪkl/; [adj]实际的,实用的,实践的,切合实际的;〔人〕注重实际的,务实的;〔计划,方法等〕有效的,切实可行的;心灵手巧的; [n]实习课;实践课;实验考核; [or]sat;
practitioner: [a]/prækˈtɪʃənər/; [n](医生或律师等)开业者;实践者,从事者; [or]sat;
pragmatic: [a]/præɡˈmætɪk/; [adj]国事的,团体事务的;实际的,注重实效的; [n]爱管闲事的人;专断的人;国事诏书;实际家; [or]sat;
prank: [a]/præŋk/; [n]恶作剧,玩笑; [or]sat;
prate: [a]/preɪt/; [v]大谈特谈,唠叨; [n]唠叨,多嘴,无聊话; [or]sat;
prattle: [a]/ˈprætl/; [v]闲聊;胡说;小孩般说话; [n]无聊话;咿咿呀呀声; [or]sat;
preamble: [a]/priˈæmbl/; [n]序文,电报报头,先兆; [v]作序言<绪论>; [or]sat;
precarious: [a]/prɪˈkeriəs/; [adj]不稳定的;危险的;可疑的;说不定的; [or]sat;
precedent: [a]/ˈpresɪdənt/; [n]先例,范例;惯例; [adj]在前的,前面的; [or]sat;
precept: [a]/ˈpriːsept/; [n]箴言,格言; [or]sat;
precinct: [a]/ˈpriːsɪŋkt/; [n]管理区,管辖区;选区;界限,范围; [or]sat;
precipice: [a]/ˈpresəpɪs/; [n]危险的处境,灾难的边缘,濒危点;悬崖; [or]sat;
precipitate: [a]/prɪˈsɪpɪteɪt/; [v]促成,使..沉淀,猛摔;<气象>凝结; [n]沉淀物,冷凝物; [adj]突如其来的,仓促的,迅猛的;感情用事的; [or]sat;
precipitous: [a]/prɪˈsɪpɪtəs/; [adj]险峻的;急躁的,鲁莽的; [or]sat;
precis: [a]/preɪˈsiː/; [n]摘要,大纲; [vt]〈法〉为.写摘要,概括.的大意; [or]sat;
precise: [a]/prɪˈsaɪs/; [adj]精确的;恰好的; [or]sat;
preclude: [a]/prɪˈkluːd/; [v]阻止;排除; [or]sat;
precocious: [a]/prɪˈkoʊʃəs/; [adj]早慧的;早熟的;过早发育的; [or]sat;
precursor: [a]/priːˈkɜːrsər/; [n]先兆,先驱,前体; [or]sat;
predator: [a]/ˈpredətər/; [n]掠夺者,食肉动物; [or]sat;
predecessor: [a]/ˈpredəsesər/; [n]前辈;(被取代的)原有事物; [or]sat;
predicament: [a]/prɪˈdɪkəmənt/; [n]困境,穷境,尴尬的处境; [or]sat;
predilection: [a]/ˌpredlˈekʃn/; [n]偏好; [or]sat;
preeminent: [a]/priˈemɪnənt/; [adj]卓越的,超群的; [adv]卓越地,杰出地; [or]sat;
preempt: [a]/priː'empt/; [v]制止,以先买权取得,取代; [n]〔经〕优先占有; [or]sat;
preen: [a]/priːn/; [v]打扮;用嘴整理;赞扬; [or]sat;
prehensile: [a]/prɪˈhensl/; [adj]适于抓握的;善于领会的; [or]sat;
prelate: [a]/ˈprelət/; [n]高级教士;高位神职者; [or]sat;
prelude: [a]/ˈpreljuːd/; [n]序幕,前奏; [or]sat;
premise: [a]/ˈpremɪs/; [n]前提;房屋地基; [v]假定; [or]sat;
premonition: [a]/ˌpriːməˈnɪʃn/; [n]预告,征兆,预感; [or]sat;
preposterous: [a]/prɪˈpɑːstərəs/; [adj]荒谬的,可笑的; [or]sat;
prerogative: [a]/prɪˈrɑːɡətɪv/; [n]权利;特权; [or]sat;
presage: [a]/ˈpresɪdʒ/; [v]预示; [n]预感,不祥感,前兆,预言; [or]sat;
prescience: [a]/ˈpresiəns/; [n]先见;预知; [or]sat;
presentiment: [a]/prɪˈzentɪmənt/; [n]不祥的预感; [or]sat;
prestige: [a]/preˈstiːʒ/; [n]威望,声望; [or]sat;
presumptuous: [a]/prɪˈzʌmptʃuəs/; [adj]专横的,自以为是的,冒昧的; [adv]自以为是地,专横地,冒失地; [n]自以为是,专横,冒失; [or]sat;
pretentious: [a]/prɪˈtenʃəs/; [adj]做作的,自命不凡的,炫耀的; [or]sat;
preternatural: [a]/ˌpriːtərˈnætʃrəl/; [adj]超自然的;不可思议的; [or]sat;
pretext: [a]/ˈpriːtekst/; [n]借口,托词; [or]sat;
prevail: [a]/prɪˈveɪl/; [v]流行,盛行;战胜,压倒; [or]sat;
prevalent: [a]/ˈprevələnt/; [adj]普遍的,流行的; [or]sat;
prevaricate: [a]/prɪˈværɪkeɪt/; [v]支吾,搪塞,说谎; [or]sat;
prey: [a]/preɪ/; [n]被掠食者,猎物;牺牲者; [v]使..苦恼; [vi]捕食;受..控制; [or]sat;
prim: [a]/prɪm/; [adj]拘谨的,呆板的;端庄的;整洁的; [adv]循规蹈矩地,整洁地; [v](使)一本正经;使整洁; [or]sat;
primordial: [a]/praɪˈmɔːrdiəl/; [adj]原始的;根本的;原生的; [or]sat;
primp: [a]/prɪmp/; [v]精心打扮;装饰; [or]sat;
pristine: [a]/ˈprɪstiːn/; [adj]原始的;古时的;纯朴的;崭新的; [or]sat;
privation: [a]/praɪˈveɪʃn/; [n]缺乏,贫困,丧失,被剥夺了某物的状态; [or]sat;
probe: [a]/proʊb/; [v]探测,探索; [n]探索,调查;探针,探测器; [or]sat;
problematic: [a]/ˌprɑːbləˈmætɪk/; [adj]问题的;有疑问的;不确定的; [or]sat;
proclivity: [a]/prəˈklɪvəti/; [n]倾向,怪癖; [or]sat;
procrastinate: [a]/proʊˈkræstɪneɪt/; [v](因不愿意做或习惯性地)耽搁,拖延; [or]sat;
prod: [a]/prɑːd/; [n]刺针;刺棒;签子; [v]刺;戳;刺激; [or]sat;
prodigal: [a]/ˈprɑːdɪɡl/; [adj]挥霍的,十分慷慨的; [n]浪子,挥霍者; [or]sat;
prodigious: [a]/prəˈdɪdʒəs/; [adj]异常的,奇妙的;巨大的; [or]sat;
prodigy: [a]/ˈprɑːdədʒi/; [n]天才; [or]sat;
profane: [a]/prəˈfeɪn/; [adj]亵渎神圣的,不敬的,粗俗的,污秽的; [v]亵渎,玷污(神圣),滥用; [n]未受秘传的人; [or]sat;
profligate: [a]/ˈprɑːflɪɡət/; [adj]放荡的;不检点的;恣意挥霍的; [n]放荡的人,浪子,肆意挥霍者; [or]sat;
profound: [a]/prəˈfaʊnd/; [adj]深刻的;知识渊博的;深奥的;极度的,完全的;深远的;渊博的; [n]深渊;深海; [or]sat;
profusion: [a]/prəˈfjuːʒn/; [n]丰富; [or]sat;
progeny: [a]/ˈprɑːdʒəni/; [n]子孙,后代,成果; [or]sat;
prognosis: [a]/prɑːɡˈnoʊsɪs/; [n]<医>预后;预知; [or]sat;
projectile: [a]/prəˈdʒektl/; [n]抛射物,发射体,火箭,导弹; [adj]发射的; [or]sat;
proliferation: [a]/prəˌlɪfəˈreɪʃn/; [n]增殖;增加; [or]sat;
prolific: [a]/prəˈlɪfɪk/; [adj]多育的,多产的;丰富的,富饶的; [or]sat;
prologue: [a]/ˈproʊlɔːɡ/; [n]开场白,序幕; [or]sat;
prolong: [a]/prəˈlɔːŋ/; [v]延长;拉长;拖延; [or]sat;
prominent: [a]/ˈprɑːmɪnənt/; [adj]突起的,显眼的;突出的,杰出的; [or]sat;
promiscuous: [a]/prəˈmɪskjuəs/; [adj]滥交的,杂乱的,混杂的; [or]sat;
promontory: [a]/ˈprɑːməntɔːri/; [n]岬,海角,隆突; [or]sat;
promote: [a]/prəˈmoʊt/; [v]提升;促进;发扬;促销; [or]sat;
prompt: [a]/prɑːmpt/; [v]提示;激起;促进,推动;敦促; [adj]迅速的,及时的; [n]提示; [or]sat;
promulgate: [a]/ˈprɑːmlɡeɪt/; [v]公布;传播;发表; [or]sat;
prone: [a]/proʊn/; [adj]易于.的;有.倾向的;俯卧的; [or]sat;
propagate: [a]/ˈprɑːpəɡeɪt/; [v]繁殖,增殖; [vt]传播,宣传; [or]sat;
propensity: [a]/prəˈpensəti/; [n]嗜好,习性;倾向; [or]sat;
prophetic: [a]/prəˈfetɪk/; [adj]预言的,预示的; [or]sat;
propinquity: [a]/prəˈpɪŋkwəti/; [n]接近,邻近,近亲关系; [or]sat;
propitiate: [a]/prəˈpɪʃieɪt/; [v]讨好,抚慰; [or]sat;
propitious: [a]/prəˈpɪʃəs/; [adj]适合的;吉利的;顺利的; [or]sat;
proponent: [a]/prəˈpoʊnənt/; [n]支持者;提议者;主张者;提出认证遗嘱者; [adj]建议的;支持的;辩护的; [or]sat;
propound: [a]/prəˈpaʊnd/; [v]提出(问题,计划)供考虑; [or]sat;
propriety: [a]/prəˈpraɪəti/; [n]正当(的行为);礼节;适当; [or]sat;
prosaic: [a]/prəˈzeɪɪk/; [adj]平凡的,乏味的,散文体的; [or]sat;
proscribe: [a]/proʊˈskraɪb/; [v]剥夺..的公权,禁止; [or]sat;
proselytize: [a]/ˈprɑːsələtaɪz/; [v]使皈依; [or]sat;
prosperity: [a]/prɑːˈsperəti/; [n]繁荣,兴旺,发达; [or]sat;
prostrate: [a]/ˈprɑːstreɪt/; [adj]降伏的,沮丧的,衰竭的,俯卧的; [v]弄倒,使屈服; [or]sat;
protean: [a]/ˈproʊtiən/; [adj]变化多端的,能够变化的; [or]sat;
protege: [a]/ˈproʊtəʒeɪ/; [n]被保护人,门徒,门生; [or]sat;
protocol: [a]/ˈproʊtəkɔːl/; [n]外交礼节;草案;外交议定书; [vi]拟定议定书; [vt]把.写入议定书; [or]sat;
prototype: [a]/ˈproʊtətaɪp/; [n]原型,典型,样本; [or]sat;
protract: [a]/proʊ'trækt/; [v]绘制;延长;伸展; [or]sat;
protrude: [a]/proʊˈtruːd/; [v]伸出,突出,凸出; [or]sat;
provident: [a]/ˈprɑːvɪdənt/; [adj]节俭的,深谋远虑的,顾及未来的; [or]sat;
provincial: [a]/prəˈvɪnʃl/; [adj]省的;地方性的;偏狭的; [n]地方人民;乡下人;外地人; [or]sat;
provisional: [a]/prəˈvɪʒənl/; [n]临时邮票; [adj]临时的,暂时的,暂定的; [or]sat;
provocative: [a]/prəˈvɑːkətɪv/; [adj]挑衅的,煽动的,刺激的;挑逗的; [or]sat;
provoke: [a]/prəˈvoʊk/; [v]激怒;对.挑衅;引起; [or]sat;
prowess: [a]/ˈpraʊəs/; [n]勇敢,不凡的能力;超凡技术; [or]sat;
proximity: [a]/prɑːkˈsɪməti/; [n]接近;邻近; [or]sat;
proxy: [a]/ˈprɑːksi/; [n]代理权,代表权,代理人; [adj]代理的; [or]sat;
prude: [a]/pruːd/; [n]过分守礼的人,故作正经的人; [or]sat;
prudent: [a]/ˈpruːdnt/; [adj]谨慎的,精明的; [or]sat;
prune: [a]/pruːn/; [n]梅干; [v]修剪;削减; [or]sat;
prurient: [a]/ˈprʊriənt/; [adj]好色的;淫乱的;渴望的; [or]sat;
pseudonym: [a]/ˈsuːdənɪm/; [n]笔名,假名; [or]sat;
psyche: [a]/ˈsaɪki/; [n]灵魂;心智; [or]sat;
puerile: [a]/ˈpjʊrəl/; [adj]幼稚的,孩子气的; [or]sat;
pugnacity: [a]/pʌɡˈnæsəti/; [n]好斗,好战; [or]sat;
pulchritude: [a]/ˈpʌlkrɪtjuːd/; [n]漂亮,标致; [or]sat;
pulverize: [a]/ˈpʌlvəraɪz/; [v]粉碎;使成粉末;彻底击败;彻底毁坏; [or]sat;
pummel: [a]/ˈpʌml/; [v]击;打;用拳头连续揍; [or]sat;
punctilious: [a]/pʌŋkˈtɪliəs/; [adj]一丝不苟的,精密细心的,拘泥形式的; [or]sat;
pundit: [a]/ˈpʌndɪt/; [n]博学者,评论家; [or]sat;
pungent: [a]/ˈpʌndʒənt/; [adj]刺激性的;刺鼻的;尖锐的; [or]sat;
punitive: [a]/ˈpjuːnətɪv/; [adj]给予惩罚,刑罚的; [or]sat;
puny: [a]/ˈpjuːni/; [adj]弱小的,微不足道的; [or]sat;
purchase: [a]/ˈpɜːrtʃəs/; [v]购买; [n]购买;所购之物; [or]sat;
purge: [a]/pɜːrdʒ/; [v]通便,净化,使(身,心)清净; [n]驱赶,泻药,净化; [or]sat;
purveyor: [a]/pərˈveɪər/; [n]承办者;供应粮食者; [or]sat;
pusillanimous: [a]/ˌpjuːsɪˈlænɪməs/; [adj]懦弱的,胆小的;优柔寡断的; [or]sat;
putrid: [a]/ˈpjuːtrɪd/; [adj]腐臭的;讨人厌的; [or]sat;
quack: [a]/kwæk/; [n]庸医;鸭叫声; [v]嘎嘎叫;吹嘘;大声闲聊; [adj]骗人的,江湖医生的; [or]sat;
quaff: [a]/kwæf/; [v]痛饮; [or]sat;
quagmire: [a]/ˈkwæɡmaɪər/; [n]沼泽地,困境; [or]sat;
quail: [a]/kweɪl/; [n]鹌鹑; [v]畏缩;感到恐惧; [or]sat;
quaint: [a]/kweɪnt/; [adj]精巧的;古雅的; [or]sat;
qualified: [a]/ˈkwɑːlɪfaɪd/; [adj]有资格的;保留的,有限度的; [vt]描述,形容;使合适;授权予;有权,达标; [vi]合格,成为合格;取得.的资格; [or]sat;
quandary: [a]/ˈkwɑːndəri/; [n]困惑;窘境;为难; [or]sat;
quarantine: [a]/ˈkwɔːrəntiːn/; [v]检疫;隔离;使隔离; [n]检疫;隔离;检疫期;封锁; [or]sat;
quarry: [a]/ˈkwɔːri/; [n]采石场;猎物;来源; [v]挖出;努力挖掘; [or]sat;
quay: [a]/kiː/; [n]码头; [or]sat;
queasy: [a]/ˈkwiːzi/; [adj]呕吐的;不稳定的; [or]sat;
quell: [a]/kwel/; [v]镇压,消除,减轻(激动,恐惧等); [n]镇压,平息,减轻; [or]sat;
quench: [a]/kwentʃ/; [v]扑灭(火);止渴; [or]sat;
querulous: [a]/ˈkwerələs/; [adj]抱怨的,挑剔的; [or]sat;
query: [a]/ˈkwɪri/; [n]质问,询问,怀疑; [v]询问,表示怀疑; [or]sat;
quibble: [a]/ˈkwɪbl/; [n]谬论;双关语;遁辞; [v]诡辩;挑剔;说模棱两可的话; [or]sat;
quiescent: [a]/kwaɪˈesnt/; [adj]静止的,沉寂的,不活动的; [or]sat;
quip: [a]/kwɪp/; [n]妙语,嘲弄,讽刺语; [v]嘲弄,讥讽; [or]sat;
quiver: [a]/ˈkwɪvər/; [n]颤抖;箭袋; [vi]颤抖; [or]sat;
quixotic: [a]/kwɪkˈsɑːtɪk/; [adj]空想的,堂吉诃德式的; [n]同"quixotism"; [or]sat;
quizzical: [a]/ˈkwɪzɪkl/; [adj]困惑的,引人发笑的,嘲弄的,探询的; [adv]疑问地,戏弄地; [or]sat;
quorum: [a]/ˈkwɔːrəm/; [n]法定人数; [or]sat;
rabid: [a]/ˈræbɪd/; [adj]激烈的;狂暴的;偏激的;患狂犬病的; [or]sat;
raconteur: [a]/ˌrækɑːnˈtɜːr/; [n]健谈者;善谈者;擅长讲故事的人; [or]sat;
rail: [a]/reɪl/; [n]铁轨;扶手,栏杆; [v]咒骂; [or]sat;
raiment: [a]/ˈreɪmənt/; [n]衣服; [or]sat;
rally: [a]/ˈræli/; [n]集会;公路汽车赛; [v]集合;恢复(健康等),重新振作; [or]sat;
ramble: [a]/ˈræmbl/; [vi]瞎扯;溜达;漫步于; [n]漫步; [or]sat;
ramification: [a]/ˌræmɪfɪˈkeɪʃn/; [n]分枝;分枝(或分叉)的结果; [or]sat;
ramp: [a]/ræmp/; [n]斜坡,坡道;倾斜装置; [v]蔓延; [or]sat;
rampant: [a]/ˈræmpənt/; [adj]猖獗的,蔓生的; [or]sat;
ramshackle: [a]/ˈræmʃækl/; [adj]摇摇欲坠的; [or]sat;
rancid: [a]/ˈrænsɪd/; [adj]腐臭的;令人作呕的,讨厌的; [or]sat;
rancor: [a]/ˈræŋkər/; [n]深仇,怨恨; [or]sat;
random: [a]/ˈrændəm/; [adj]随机的;任意的;胡乱的; [or]sat;
rankle: [a]/ˈræŋkl/; [v]怨恨,使痛苦,化脓; [or]sat;
rant: [a]/rænt/; [n]咆哮,痛骂; [v]咆哮,痛骂,大声责骂; [or]sat;
rapacious: [a]/rəˈpeɪʃəs/; [adj]贪婪的;掠夺的; [or]sat;
rapport: [a]/ræˈpɔːr/; [n]密切关系,交往;和谐一致;意见一致; [or]sat;
rapt: [a]/ræpt/; [adj]全神贯注的,着迷的;狂喜的; [or]sat;
raspy: [a]/ˈræspi/; [adj]声音沙哑的,容易生气的; [or]sat;
ratify: [a]/ˈrætɪfaɪ/; [vt]批准,认可,签署生效; [or]sat;
ratiocination: [a]/ˌreɪʃioʊsɪˈneɪʃn/; [n]推理,推论; [or]sat;
rationale: [a]/ˌræʃəˈnæl/; [n]基本原理;原理的阐述; [or]sat;
raucous: [a]/ˈrɔːkəs/; [adj](声音)沙哑的,刺耳的,吵闹的; [or]sat;
rave: [a]/reɪv/; [n]热切赞扬,喧闹的宴会;胡言乱语; [v]咆哮;胡言乱语;语无伦次地说; [adj]赞扬的; [or]sat;
ravenous: [a]/ˈrævənəs/; [adj]贪婪的;渴望的,极饿的;狼吞虎咽的; [or]sat;
raze: [a]/reɪz/; [v]夷为平地,破坏,消除;拆毁; [or]sat;
reactionary: [a]/riˈækʃəneri/; [adj]保守的,反动的; [n]反动分子; [or]sat;
realm: [a]/relm/; [n]王国;领域;国土; [or]sat;
reaper: [a]/ˈriːpər/; [n]收割者;收割机; [or]sat;
rebuff: [a]/rɪˈbʌf/; [n]断然拒绝,回绝,漠不关心; [v]断然拒绝; [or]sat;
rebuke: [a]/rɪˈbjuːk/; [v]指责; [n]谴责; [or]sat;
recalcitrant: [a]/rɪˈkælsɪtrənt/; [adj]顽抗的,不顺从的; [or]sat;
recant: [a]/rɪˈkænt/; [v]宣布放弃,公开认错; [or]sat;
recapitulate: [a]/ˌriːkəˈpɪtʃuleɪt/; [v]扼要重述; [or]sat;
recast: [a]/ˌriːˈkæst/; [v]重建; [or]sat;
receptive: [a]/rɪˈseptɪv/; [adj]善于接受的;能容纳的; [or]sat;
recession: [a]/rɪˈseʃn/; [n](经济)衰退,不景气;后退,撤回;凹处; [or]sat;
recidivism: [a]/rɪˈsɪdɪvɪzəm/; [n]再犯,累犯; [or]sat;
recipient: [a]/rɪˈsɪpiənt/; [n]接受者;容器;间接宾语; [adj]接受的;善于接受的;接受能力强的; [or]sat;
reciprocal: [a]/rɪˈsɪprəkl/; [adj]相互的,互惠的; [n]倒数;互相关联的事物; [or]sat;
reciprocate: [a]/rɪˈsɪprəkeɪt/; [v]互给;酬答;互换;报答; [or]sat;
recluse: [a]/ˈrekluːs/; [n]隐士; [adj]隐士的,隐遁的; [or]sat;
reconcile: [a]/ˈrekənsaɪl/; [v]和解;调解;调和; [or]sat;
reconnaissance: [a]/rɪˈkɑːnɪsns/; [n]侦察,勘测,搜索,事先考查; [or]sat;
recount: [a]/rɪˈkaʊnt/; [v]叙述; [n]重新计算; [or]sat;
recourse: [a]/ˈriːkɔːrs/; [n]求援(对象),求助(对象,<商><律>追索权; [or]sat;
recrimination: [a]/rɪˌkrɪmɪˈneɪʃn/; [n]反责,反控,揭丑; [or]sat;
rectify: [a]/ˈrektɪfaɪ/; [v]纠正;修复; [or]sat;
rectitude: [a]/ˈrektɪtuːd/; [n]正直,公正,正确; [or]sat;
recumbent: [a]/rɪˈkʌmbənt/; [adj]斜倚的;休息的; [n]〈口〉座位斜靠式自行车; [or]sat;
recuperate: [a]/rɪˈkuːpəreɪt/; [v]恢复(健康),重新得到,复兴; [or]sat;
recurrent: [a]/rɪˈkɜːrənt/; [adj]复发的;周期性的,经常发生的; [or]sat;
redolent: [a]/ˈredələnt/; [adj]气味强烈的,芬芳的,令人想起..的; [or]sat;
redoubtable: [a]/rɪˈdaʊtəbl/; [adj]可敬畏的,可怕的; [or]sat;
redress: [a]/rɪˈdres/; [n]纠正,革除,救济; [v]修正,救济,革除; [or]sat;
redundant: [a]/rɪˈdʌndənt/; [adj]多余的,过剩的;被下岗的; [or]sat;
reek: [a]/riːk/; [v]散发;冒烟;放出臭气; [n]恶臭;水蒸汽;雾;烟; [or]sat;
refraction: [a]/rɪˈfrækʃn/; [n]折射;折光; [or]sat;
refractory: [a]/rɪˈfræktəri/; [adj]难治的,难熔的,不听话的; [or]sat;
refrain: [a]/rɪˈfreɪn/; [v]抑制,避免; [n]歌曲的反复句,叠句; [or]sat;
refurbish: [a]/ˌriːˈfɜːrbɪʃ/; [v]刷新,再磨光; [or]sat;
regal: [a]/ˈriːɡl/; [adj]帝王的,豪华的,帝王般的; [or]sat;
regale: [a]/rɪˈɡeɪl/; [v]盛情款待,享用,享受; [n]盛宴,佳肴,款待; [or]sat;
regime: [a]/reɪˈʒiːm/; [n]政权;政治制度;养生法,生活规则; [or]sat;
regimen: [a]/ˈredʒɪmən/; [n]养生法,生活规则; [or]sat;
rehabilitate: [a]/ˌriːəˈbɪlɪteɪt/; [v]使康复,使恢复名誉,使恢复原状; [or]sat;
reimburse: [a]/ˌriːɪmˈbɜːrs/; [v]偿还;赔偿;退还(钱),付还; [or]sat;
reiterate: [a]/riˈɪtəreɪt/; [vt]反复讲,重申,反复做; [or]sat;
rejoinder: [a]/rɪˈdʒɔɪndər/; [n]回答,反驳,第二次答辩; [or]sat;
rejuvenate: [a]/rɪˈdʒuːvəneɪt/; [v]使..年轻;使..恢复精神;变年轻; [vi]返老还童,恢复活力,复原; [or]sat;
relent: [a]/rɪˈlent/; [v]变温和,变宽厚;减弱;缓和;终于答应;不再拒绝; [or]sat;
relevant: [a]/ˈreləvənt/; [adj]有关的;恰当的;贴切的; [or]sat;
relic: [a]/ˈrelɪk/; [n]遗迹;神圣的遗物;纪念物; [or]sat;
relinquish: [a]/rɪˈlɪŋkwɪʃ/; [v]放弃,让出(权利,财产等),撤回; [or]sat;
relish: [a]/ˈrelɪʃ/; [v]享受;享受.的味道;品味; [n]乐趣;调味品; [or]sat;
remediable: [a]/rɪˈmiːdiəbl/; [adj]可治疗的,可矫正的,可补救的; [or]sat;
remedial: [a]/rɪˈmiːdiəl/; [adj]治疗的;补救的;矫正的; [or]sat;
reminiscence: [a]/ˌremɪˈnɪsns/; [n]回忆,怀旧,引起联想的相似事物; [or]sat;
remiss: [a]/rɪˈmɪs/; [adj]疏忽的,怠慢的; [or]sat;
remission: [a]/rɪˈmɪʃn/; [n]缓解;宽恕;豁免; [or]sat;
remnant: [a]/ˈremnənt/; [n]遗迹;边角剩料; [or]sat;
remonstrance: [a]/rɪˈmɑːnstrəns/; [n]抗议,抱怨,谏书; [or]sat;
remorse: [a]/rɪˈmɔːrs/; [n]懊悔,自责,同情,怜悯; [or]sat;
remunerative: [a]/rɪˈmjuːnərətɪv/; [adj]有报酬的,有利可图的; [or]sat;
rend: [a]/rend/; [v]撕碎;分裂;强夺; [or]sat;
render: [a]/ˈrendər/; [v]使成为,致使,使处于(某种状态);提供,给予,以.回报;(以某种方式)表达,表现;翻译;粉刷,往(墙上)抹灰;将(脂肪)熬成油,使熔化; [n]粉刷,打底,交纳; [or]sat;
rendition: [a]/renˈdɪʃn/; [n]表演,演奏;译文;给予,提供; [or]sat;
renegade: [a]/ˈrenɪɡeɪd/; [n]叛教者,脱党者,叛徒; [v]背叛,背教,变节; [adj]叛教的,背叛的,变节的; [or]sat;
renege: [a]/rɪˈniːɡ/; [v]食言,否认; [or]sat;
renounce: [a]/rɪˈnaʊns/; [vt]宣布放弃,与...断绝关系;抛弃; [vi]垫牌; [n]垫牌; [or]sat;
renovate: [a]/ˈrenəveɪt/; [v]更新,修复; [adj]恢复的,革新的,翻新的; [or]sat;
renown: [a]/rɪˈnaʊn/; [n]声誉;名望; [vt]使有声望; [or]sat;
rent: [a]/rent/; [n]租金; [v]租用,出租; [or]sat;
reparable: [a]/'repərəbəl/; [adj]可修缮的;可挽回的; [or]sat;
repast: [a]/rɪˈpæst/; [n]宴;就餐; [vi]就餐,设宴; [or]sat;
repeal: [a]/rɪˈpiːl/; [n]撤销; [v]废除;废止; [or]sat;
repel: [a]/rɪˈpel/; [v]击退,驱逐;排斥,抵制;使厌恶,使反感;使恐惧; [or]sat;
repellent: [a]/rɪˈpelənt/; [adj]令人厌恶的; [n]消肿药,驱虫剂; [or]sat;
repercussion: [a]/ˌriːpərˈkʌʃn/; [n]反响;弹回;反射; [or]sat;
repertoire: [a]/ˈrepərtwɑːr/; [n](剧团,演员等的)全部节目;全部才能; [or]sat;
replenish: [a]/rɪˈplenɪʃ/; [v]补充,再装满;把.装满;给.添加燃料; [or]sat;
replete: [a]/rɪˈpliːt/; [adj]充满的,装满的; [n]<昆>贮蜜蚁; [or]sat;
replica: [a]/ˈreplɪkə/; [n]复制品; [or]sat;
replicate: [a]/ˈreplɪkeɪt/; [v]复制;重复,反复; [or]sat;
repository: [a]/rɪˈpɑːzətɔːri/; [n]储藏室;仓库;智囊人物;知识库; [or]sat;
reprehensible: [a]/ˌreprɪˈhensəbl/; [adj]应受谴责的; [or]sat;
repress: [a]/rɪˈpres/; [vt]抑制;镇压;约束; [or]sat;
reprieve: [a]/rɪˈpriːv/; [v]暂缓处罚,免罪,维持运行; [n]<法>死缓,缓刑,暂缓; [or]sat;
reprimand: [a]/ˈreprɪmænd/; [n](特指当权者进行的)严责,谴责,申斥; [v]申斥,谴责,惩戒; [or]sat;
reprisal: [a]/rɪˈpraɪzl/; [n]报复;报复性劫掠; [or]sat;
reproach: [a]/rɪˈproʊtʃ/; [v]责备,指责; [n]指责; [or]sat;
reprobate: [a]/ˈreprəbeɪt/; [n]混蛋,恶棍; [adj]邪恶的;堕落的; [v]谴责,指责; [or]sat;
reprove: [a]/rɪˈpruːv/; [v]责骂,申斥; [or]sat;
repudiate: [a]/rɪˈpjuːdieɪt/; [v]拒绝,否定,驳斥; [or]sat;
repugnant: [a]/rɪˈpʌɡnənt/; [adj]令人厌恶的; [or]sat;
repulsion: [a]/rɪˈpʌlʃn/; [n]排斥;厌恶;反驳; [or]sat;
reputable: [a]/ˈrepjətəbl/; [adj]声誉好的;受尊敬的;卓越的; [or]sat;
reputed: [a]/rɪˈpjuːtɪd/; [adj]名誉好的;被普遍认为.的; [or]sat;
requiem: [a]/ˈrekwiəm/; [n]安魂曲;追思弥撒; [or]sat;
requisite: [a]/ˈrekwɪzɪt/; [n]必需品; [adj]需要的,必不可少的,必备的; [or]sat;
requite: [a]/rɪˈkwaɪt/; [v]报答,酬谢,回报,补偿;报复; [or]sat;
rescind: [a]/rɪˈsɪnd/; [v]废除;取消;撤回; [or]sat;
resentment: [a]/rɪˈzentmənt/; [n]憎恨; [or]sat;
reserve: [a]/rɪˈzɜːrv/; [n]储备;保留;保护区; [v]保留;预定;储备; [or]sat;
residue: [a]/ˈrezɪduː/; [n]剩余物;残渣;渣;残数; [or]sat;
resigned: [a]/rɪˈzaɪnd/; [adj]逆来顺受的;已辞职的;已放弃的; [or]sat;
resilient: [a]/rɪˈzɪliənt/; [adj]能复原的,弹回的,有弹性的; [or]sat;
resolution: [a]/ˌrezəˈluːʃn/; [n]决心,决定,解决,决议,分辨率; [or]sat;
resolve: [a]/rɪˈzɑːlv/; [n]决心; [v]解决,决定,表决; [or]sat;
resonant: [a]/ˈrezənənt/; [adj]洪亮的,共振的,共鸣的; [or]sat;
respiration: [a]/ˌrespəˈreɪʃn/; [n]呼吸; [or]sat;
respite: [a]/ˈrespɪt/; [n]缓解;暂缓;暂时的休息;缓期执行; [v]使缓解;使暂缓;使延期;缓期执行; [or]sat;
resplendent: [a]/rɪˈsplendənt/; [adj]华丽的,辉煌的; [or]sat;
restitution: [a]/ˌrestɪˈtuːʃn/; [n]归还,赔偿; [or]sat;
restive: [a]/ˈrestɪv/; [adj]不耐烦的,焦躁不安的,倔强的; [or]sat;
retain: [a]/rɪˈteɪn/; [v]保持,保留,保存;聘请; [or]sat;
retaliation: [a]/rɪˌtæliˈeɪʃn/; [n]反击;回敬;报复; [or]sat;
retentive: [a]/rɪˈtentɪv/; [adj]保持的;吸(水)的; [adv]有记性地,记性强地; [n]保持力;〈物〉顽磁性; [or]sat;
retinue: [a]/ˈretənuː/; [n]侍从,随员; [or]sat;
retiring: [a]/rɪˈtaɪərɪŋ/; [adj]退休的,不善社交的,过隐居生活的; [v]退休; [or]sat;
retort: [a]/rɪˈtɔːrt/; [v]反驳; [n]反驳,反击,回嘴; [or]sat;
retract: [a]/rɪˈtrækt/; [v]缩回;收回;取消; [n]收缩核; [or]sat;
retrench: [a]/rɪˈtrentʃ/; [v]节省,削减;紧缩; [or]sat;
retribution: [a]/ˌretrɪˈbjuːʃn/; [n]报应,惩罚,报答,报偿; [or]sat;
retrieve: [a]/rɪˈtriːv/; [v]取回,重新得到,挽回,检索; [or]sat;
retroactive: [a]/ˌretroʊˈæktɪv/; [adj]追溯的;有追溯效力的;反动的; [or]sat;
retrograde: [a]/ˈretrəɡreɪd/; [vi]倒退,退步; [adj]后退的,退步的,退化的; [vt]使倒退; [or]sat;
retrospective: [a]/ˌretrəˈspektɪv/; [adj]回顾的;怀旧的;可追溯的; [n]作品回顾展出; [or]sat;
revelry: [a]/ˈrevlri/; [n]狂欢;欢宴; [or]sat;
reverent: [a]/ˈrevərənt/; [adj]虔诚的,恭敬的; [or]sat;
reverie: [a]/ˈrevəri/; [n]幻想,沉思,幻想曲; [or]sat;
revile: [a]/rɪˈvaɪl/; [v]辱骂,诽谤,批判; [or]sat;
revoke: [a]/rɪˈvoʊk/; [v]撤回,取消;废除; [n]有牌不跟; [or]sat;
revulsion: [a]/rɪˈvʌlʃn/; [n]剧变,厌恶,强烈反感; [or]sat;
rhetoric: [a]/ˈretərɪk/; [n]修辞学,浮夸的言语;雄辩术; [or]sat;
rhetorical: [a]/rɪˈtɔːrɪkl/; [adj]语言上的,文字上的,言辞华丽(却往往无内涵的); [or]sat;
riddle: [a]/ˈrɪdl/; [n]谜,谜语; [v]解谜,出谜题,满是弹孔; [or]sat;
rider: [a]/ˈraɪdər/; [n]骑士;附件,附文;扶手; [or]sat;
rife: [a]/raɪf/; [adj]普遍的;流行的; [or]sat;
rift: [a]/rɪft/; [n]裂缝,裂口; [or]sat;
rig: [a]/rɪɡ/; [n]钻井架;装备;帆具;成套器械; [v]操纵;装配;欺骗; [or]sat;
rigid: [a]/ˈrɪdʒɪd/; [adj]坚硬的;僵硬的;死板的; [or]sat;
rigor: [a]/'rɪgə/; [n]严厉;精确;困难境地; [or]sat;
rigorous: [a]/ˈrɪɡərəs/; [adj]严厉的,严格的; [or]sat;
rile: [a]/raɪl/; [v]刺激,惹怒; [or]sat;
riveting: [a]/ˈrɪvɪtɪŋ/; [adj]非常精彩的; [n]铆接(法; [or]sat;
rivulet: [a]/ˈrɪvjələt/; [n]小溪,小河; [or]sat;
robust: [a]/roʊˈbʌst/; [adj]健壮的,强壮的;精力充沛的;坚固的;粗鲁的; [or]sat;
roil: [a]/rɔɪl/; [v]搅浑,惹怒,动荡,喧闹; [n]小股汹涌的急流; [or]sat;
roster: [a]/ˈrɑːstər/; [n]值勤表,花名册; [v]将(姓名)列入值勤名单; [or]sat;
rostrum: [a]/ˈrɑːstrəm/; [n]讲坛,讲台; [or]sat;
rote: [a]/roʊt/; [n]死记硬背,机械的做法,生搬硬套; [or]sat;
rout: [a]/raʊt/; [v]击溃;搜寻; [n]溃败;暴动; [or]sat;
rubble: [a]/ˈrʌbl/; [n]碎石,瓦砾; [or]sat;
ruddy: [a]/ˈrʌdi/; [adj]红的,红润的; [adv]极度,非常; [vt]使变红; [or]sat;
rudimentary: [a]/ˌruːdɪˈmentri/; [adj]基本的,初期的;发育不完全的;退化的; [or]sat;
rue: [a]/ruː/; [v]后悔,遗憾; [or]sat;
ruffian: [a]/ˈrʌfiən/; [n]流氓,无赖,恶棍; [adj]凶狠的,残暴的,无法无天的; [or]sat;
ruminate: [a]/ˈruːmɪneɪt/; [v]反刍,再嚼,深思; [or]sat;
rummage: [a]/ˈrʌmɪdʒ/; [n]杂物,翻寻; [v]彻底搜查,翻箱倒柜; [or]sat;
ruse: [a]/ruːz/; [n]诡计; [or]sat;
rustic: [a]/ˈrʌstɪk/; [n]乡巴佬,庄稼汉,粗人; [adj]乡村的;质朴的;不精致的; [or]sat;
ruthless: [a]/ˈruːθləs/; [adj]无情的;残忍的; [or]sat;
saccharine: [a]/ˈsækəriːn/; [adj]像糖一样的,有甜味的,做作的,矫情的; [or]sat;
sacrilegious: [a]/ˌsækrəˈlɪdʒəs/; [adj]该受天谴的,亵渎神明的; [or]sat;
sacrosanct: [a]/ˈsækroʊsæŋkt/; [adj](因十分重要,神圣)不可改变,批判的; [or]sat;
sadistic: [a]/səˈdɪstɪk/; [adj]虐待狂的;残忍成性的; [or]sat;
saga: [a]/ˈsɑːɡə/; [n]传奇故事;冒险故事;一连串的事件(或经历); [or]sat;
sagacious: [a]/səˈɡeɪʃəs/; [adj]有洞察力的,有远见的,精明的,敏锐的; [or]sat;
sage: [a]/seɪdʒ/; [adj]贤明的,审慎的; [n]圣人,年高望重的人; [or]sat;
salient: [a]/ˈseɪliənt/; [adj]显著的;突出的;跳跃的; [n]凸角;突出部分; [or]sat;
salubrious: [a]/səˈluːbriəs/; [adj]清爽的;气候有益健康的; [or]sat;
salutary: [a]/ˈsæljəteri/; [adj]有益的,有益健康的; [or]sat;
salvage: [a]/ˈsælvɪdʒ/; [n]抢救;从灾难中抢救出的物资; [vt]拯救;打捞; [or]sat;
salvo: [a]/ˈsælvoʊ/; [n]齐射,齐鸣,齐声欢呼喝彩,保留条款,遁辞; [v]齐鸣; [or]sat;
sanctimonious: [a]/ˌsæŋktɪˈmoʊniəs/; [adj]伪装虔诚的;道貌岸然的; [or]sat;
sanction: [a]/ˈsæŋkʃn/; [n]批准;制裁,处罚; [v]批准,支持,对..实施制裁; [or]sat;
sanctuary: [a]/ˈsæŋktʃueri/; [n]圣堂,避难所; [or]sat;
sanguine: [a]/ˈsæŋɡwɪn/; [adj]乐观的,(脸色等)有血色的,多血质的; [n]血红色,乐观; [or]sat;
sap: [a]/sæp/; [n]树液,汁液;易上当的人; [v]削弱;逐渐耗竭; [vt]使伤元气; [vi]挖坑道进攻; [or]sat;
sarcasm: [a]/ˈsɑːrkæzəm/; [n]讽刺,挖苦,嘲笑; [or]sat;
sardonic: [a]/sɑːrˈdɑːnɪk/; [adj]讽刺的,嘲笑的; [or]sat;
sartorial: [a]/sɑːrˈtɔːriəl/; [adj]裁缝匠的,裁缝的;缝纫的; [or]sat;
sate: [a]/seɪt/; [v]使心满意足,使厌足; [or]sat;
satellite: [a]/ˈsætəlaɪt/; [n]卫星;人造卫星;随体; [adj]卫视的; [or]sat;
satiate: [a]/ˈseɪʃieɪt/; [v]使饱足,生腻; [adj]饱足的;厌腻的; [or]sat;
satire: [a]/ˈsætaɪər/; [n]讽刺(作品); [or]sat;
satirical: [a]/səˈtɪrɪkl/; [adj]讽刺性的,讥讽的,爱挖苦人的; [or]sat;
saturate: [a]/ˈsætʃəreɪt/; [v]使充满,使饱和,使湿透; [or]sat;
saturnine: [a]/ˈsætərnaɪn/; [adj]忧郁的,阴沉的,讥讽的; [or]sat;
saunter: [a]/ˈsɔːntər/; [n]漫步,闲逛; [v]闲逛,漫步; [or]sat;
savant: [a]/sæˈvɑːnt/; [n]博学之士,大学士; [or]sat;
savor: [a]/ˈseɪvər/; [n]味道,气味,特点,趣味; [v]调味,品尝,欣赏,玩味; [or]sat;
savory: [a]/ˈseɪvəri/; [adj]口感好的,味道好的,令人愉悦的; [or]sat;
scabbard: [a]/ˈskæbərd/; [n](刀,剑)鞘,枪套; [v]把.插入鞘中; [or]sat;
scaffold: [a]/ˈskæfoʊld/; [n]支架;断头台;脚手架;脚手架材料; [vt]给.搭脚手架; [or]sat;
scale: [a]/skeɪl/; [n]天平,磅秤;刻度,尺度,标度;等级,级别, 等级体系;鳞片,鳞状物;规模;水垢,牙垢; [v]攀登;按比例决定;称重;刮鳞,剥落; [or]sat;
scanty: [a]/ˈskænti/; [adj]少的,小的,缺乏的; [or]sat;
scapegoat: [a]/ˈskeɪpɡoʊt/; [n]替罪羊; [or]sat;
scavenge: [a]/ˈskævɪndʒ/; [v](在废物中)寻觅;(动物)食腐肉;打扫;排除废气; [or]sat;
scenario: [a]/səˈnærioʊ/; [n]剧情梗概;情况,情节;设想; [or]sat;
schematic: [a]/skiːˈmætɪk/; [adj]图示的,扼要的; [n]简图; [or]sat;
schism: [a]/ˈsɪzəm/; [n]分裂,(教派或政党的)分裂; [or]sat;
scintillate: [a]/'sɪntlˌeɪt/; [v]闪烁,(淡吐)流露机智; [or]sat;
scoff: [a]/skɔːf/; [vi]讥笑; [v]嘲笑; [n]愚弄; [or]sat;
scourge: [a]/skɜːrdʒ/; [n]鞭笞,磨难,带来灾难的事物或人(祸害); [v]鞭笞,折磨,使苦恼; [or]sat;
scruple: [a]/ˈskruːpl/; [n]顾虑,不安; [vi]有顾虑,良心上感到不安; [or]sat;
scrupulous: [a]/ˈskruːpjələs/; [adj]小心谨慎的;严谨的;细心的; [or]sat;
scrutinize: [a]/ˈskruːtənaɪz/; [v]仔细检查,细看; [or]sat;
scuffle: [a]/ˈskʌfl/; [v]混战,扭打,拖着脚步快速行走; [n]混战,扭打; [or]sat;
scurry: [a]/ˈskɜːri/; [v]快速疾走,急跑,急躁不安地来回走动; [n]快步急跑;疾走;仓皇奔跑声;骤雨; [or]sat;
scurvy: [a]/ˈskɜːrvi/; [n]坏血病; [adj]卑鄙的,下流的; [or]sat;
seamy: [a]/ˈsiːmi/; [adj]丑恶的,露出线缝的; [or]sat;
secession: [a]/sɪˈseʃn/; [n]脱离,退出; [or]sat;
seclusion: [a]/sɪˈkluːʒn/; [n]隐遁,隐蔽的地方; [or]sat;
secrete: [a]/sɪˈkriːt/; [v]藏匿;私下侵吞;分泌; [or]sat;
sedate: [a]/sɪˈdeɪt/; [adj]沉着的,镇定的,平和的; [v]使服镇静剂而安静下来; [or]sat;
sedentary: [a]/ˈsednteri/; [adj]久坐不动的;静止的;坐惯的,定栖的; [or]sat;
sedulous: [a]/ˈsedʒələs/; [adj]聚精会神的,勤勉的; [or]sat;
seedy: [a]/ˈsiːdi/; [adj]多种子的,结籽的,破旧的,褴褛的; [or]sat;
seemly: [a]/ˈsiːmli/; [adj]适当的,有礼的,好看的; [adv]适当地; [or]sat;
seep: [a]/siːp/; [v](液体等)渗漏,(观念等)渗入,(疾病恐惧等)扩散; [n]小泉,水陆两用的吉普车; [or]sat;
seethe: [a]/siːð/; [v]沸腾;汹涌;激动; [or]sat;
seismic: [a]/ˈsaɪzmɪk/; [adj]地震的;地震引起的;剧烈的; [or]sat;
seminary: [a]/ˈsemɪneri/; [n]神学院,学校,发源地,高级中学; [or]sat;
sensual: [a]/ˈsenʃuəl/; [adj]感官的;色情的,肉欲的; [or]sat;
sententious: [a]/senˈtenʃəs/; [adj]好说教的,简要的,警句的; [or]sat;
sentinel: [a]/ˈsentɪnl/; [n]哨兵,看守; [v]守卫,放哨; [or]sat;
sequester: [a]/sɪˈkwestər/; [v]使隔离,隔绝,使隐退,没收,扣押; [or]sat;
serendipity: [a]/ˌserənˈdɪpəti/; [n]机缘巧合; [or]sat;
serenity: [a]/səˈrenəti/; [n]平静; [or]sat;
serrated: [a]/səˈreɪtɪd/; [adj]呈锯齿状的; [or]sat;
servile: [a]/ˈsɜːrvl/; [adj]奴颜婢膝的,卑屈的,隶属的; [n]奴隶; [or]sat;
servitude: [a]/ˈsɜːrvətuːd/; [n]劳役,奴役; [or]sat;
sever: [a]/ˈsevər/; [vt]割断,断绝;分开;使分离; [vi]断;裂开;分离; [or]sat;
severity: [a]/sɪˈverəti/; [n]严格,严肃; [or]sat;
shackle: [a]/ˈʃækl/; [n]枷锁,羁绊(物); [v]给..上手铐(脚镣),用钩链连结,束缚; [or]sat;
sham: [a]/ʃæm/; [n]假货;虚假;欺诈; [v]假装; [adj]虚假的,假装的; [or]sat;
shambles: [a]/ˈʃæmblz/; [n]混乱,废墟,屠宰场; [v]蹒跚而行,拖着脚走,踉跄地走; [or]sat;
shard: [a]/ʃɑːrd/; [n](陶器等)碎片,破片; [or]sat;
sheaf: [a]/ʃiːf/; [n]一捆,一束; [v]捆,束; [or]sat;
shear: [a]/ʃɪr/; [vt]剪羊毛;剪头发; [n](复数)大剪刀; [or]sat;
sheer: [a]/ʃɪr/; [adj]陡峭的;纯粹的; [v](off)急转向,偏离; [n]透明薄纱,透明布料的衣服; [adv]完全地,全然;垂直地,陡峭地; [or]sat;
shimmer: [a]/ˈʃɪmər/; [v]闪烁,微微发亮; [n]微光,闪光; [or]sat;
shirk: [a]/ʃɜːrk/; [v]逃避;规避(义务,责任等); [n]偷懒者; [or]sat;
shoddy: [a]/ˈʃɑːdi/; [adj]劣等的;假的;冒充的;虚有其表的; [n]赝品,不值钱的东西; [or]sat;
shrewd: [a]/ʃruːd/; [adj]精明的;机灵的; [n]精明;精明者; [or]sat;
shroud: [a]/ʃraʊd/; [n]寿衣,覆盖物; [v]覆盖,包以尸衣; [or]sat;
shun: [a]/ʃʌn/; [v](有意或习惯性地)避开,躲开; [or]sat;
shyster: [a]/ˈʃaɪstər/; [n]奸诈的人(尤指政客),讼棍; [or]sat;
sibling: [a]/ˈsɪblɪŋ/; [n]兄弟姊妹;同胞;(生物)同科,同属; [or]sat;
simian: [a]/ˈsɪmiən/; [n]类人猴,猴子; [adj]猿的,猴的; [or]sat;
simile: [a]/ˈsɪməli/; [n]直喻,明喻; [or]sat;
simulate: [a]/ˈsɪmjuleɪt/; [v]假装;模仿;模拟; [or]sat;
sinecure: [a]/ˈsaɪnɪkjʊr/; [n]闲职,挂名职务; [or]sat;
sinewy: [a]/ˈsɪnjuːi/; [adj]多腱的,强壮有力的; [or]sat;
singular: [a]/ˈsɪŋɡjələr/; [adj]单独的,单个的;奇怪的;非凡的,卓越的,显著的; [n]单数;单数形式; [or]sat;
sinister: [a]/ˈsɪnɪstər/; [adj]不吉祥的,险恶的; [or]sat;
sinuous: [a]/ˈsɪnjuəs/; [adj]弯曲的,蜿蜒的; [or]sat;
skeptic: [a]/ˈskeptɪk/; [n]怀疑论者;怀疑者;无神论者; [or]sat;
skiff: [a]/skɪf/; [n]小艇;小型帆船;轻舟; [or]sat;
skimp: [a]/skɪmp/; [vt]少给,克扣,不足量地供给;对.草率从事; [vi]克俭,节省; [adj]少的,不足的; [or]sat;
skinflint: [a]/ˈskɪnflɪnt/; [n]吝啬鬼; [or]sat;
skirmish: [a]/ˈskɜːrmɪʃ/; [n]小战役,小争吵; [v]卷入战役(争论),搜索; [or]sat;
slacken: [a]/ˈslækən/; [v](使)慢下来,放松,松懈; [or]sat;
slag: [a]/slæɡ/; [n]炉渣,矿渣; [or]sat;
slake: [a]/sleɪk/; [v]解渴,消渴; [or]sat;
slander: [a]/ˈslændər/; [n]诽谤,诋毁; [v]讲坏话,污蔑,诽谤; [or]sat;
sleeper: [a]/ˈsliːpər/; [n]睡眠者;卧车,卧铺;枕木; [or]sat;
sleight: [a]/slaɪt/; [n]巧妙手法,巧计,灵巧; [or]sat;
slight: [a]/slaɪt/; [adj]轻微的,微小的;纤细的,瘦弱的;少量的; [n]轻视,蔑视; [vt]轻视,忽略; [or]sat;
slither: [a]/ˈslɪðər/; [v](蛇)滑动,滑行; [n]滑动;滑行; [or]sat;
slothful: [a]/ˈsloʊθfl/; [adj]偷懒的,懒惰的; [or]sat;
slough: [a]/slʌf/; [n](蛇等)蜕皮,要脱落或抛弃的东西,绝境; [v](蛇等)蜕皮,陷入泥沼,顽强地前进; [or]sat;
slovenly: [a]/ˈslʌvnli/; [adj]不整洁的,马虎的; [or]sat;
sluggard: [a]/ˈslʌɡərd/; [n]懒鬼;游手好闲的人; [or]sat;
sluggish: [a]/ˈslʌɡɪʃ/; [adj]行动迟缓的,迟钝的;偷懒的; [or]sat;
slur: [a]/slɜːr/; [n]含糊的发音,藐视,污点,连线符; [vi]含糊地说; [vt]对.忽略,含糊不清地说出,贬低; [or]sat;
smelt: [a]/smelt/; [v]熔解,熔炼; [n]香鱼;胡瓜鱼; [or]sat;
smirk: [a]/smɜːrk/; [n]傻笑;假笑;得意的笑; [vi]傻笑;假笑; [vt]以假笑表示;以傻笑表示; [or]sat;
smolder: [a]/ˈsmoʊldər/; [v]无火焰地闷烧,(仇恨,嫉妒,愤怒等)在心里郁积; [n]焖烧,文火,冒烟; [or]sat;
snicker: [a]/ˈsnɪkər/; [vi]偷笑,窃笑; [vt]窃笑着说; [n]窃笑; [or]sat;
snivel: [a]/ˈsnɪvl/; [v]流鼻涕;啜泣; [or]sat;
sodden: [a]/ˈsɑːdn/; [adj]浑身湿透的;浸透的;浸过酒的; [or]sat;
sojourn: [a]/ˈsoʊdʒɜːrn/; [n]逗留,旅居; [vi]逗留,旅居; [or]sat;
solace: [a]/ˈsɑːləs/; [n]慰藉,给予安慰的人或事物; [v]安慰,缓和,使开心; [or]sat;
solder: [a]/ˈsɑːdər/; [v]焊接;使联接在一起; [n]焊接;接合物; [or]sat;
solemnity: [a]/səˈlemnəti/; [n]庄严,肃穆,庄严的仪式; [or]sat;
solicit: [a]/səˈlɪsɪt/; [v]乞求,恳求给予(帮助,金钱); [or]sat;
solicitous: [a]/səˈlɪsɪtəs/; [adj]热切期望的;热心的;挂念的; [or]sat;
soliloquy: [a]/səˈlɪləkwi/; [n]自言自语,独白; [or]sat;
solitude: [a]/ˈsɑːlətuːd/; [n]孤独; [or]sat;
soluble: [a]/ˈsɑːljəbl/; [adj]可溶解的;可解决的; [or]sat;
solvent: [a]/ˈsɑːlvənt/; [adj]有偿付能力的;有溶解力的; [n]溶剂;解决方法; [or]sat;
somber: [a]/'sɒmbə/; [adj]忧郁的;昏暗的,阴天的; [or]sat;
somnambulist: [a]/sɑːmˈnæmbjəlɪst/; [n]梦游症患者; [or]sat;
somnolent: [a]/ˈsɑːmnələnt/; [adj]思睡的,催眠的; [adv]瞌睡地;昏昏欲睡地;使人瞌睡地;催眠地; [or]sat;
sonorous: [a]/ˈsɑːnərəs/; [adj]响亮的,作响的,能发出响亮声音的; [adv]圆润低沉地;感人地,堂皇地; [n]感人,堂皇; [or]sat;
sophisticated: [a]/səˈfɪstɪkeɪtɪd/; [adj](仪器)精密的,复杂的;老于世故的,老练的,富有经验的;高雅的,精致的; [or]sat;
soporific: [a]/ˌsɑːpəˈrɪfɪk/; [adj]催眠的; [n]安眠药; [or]sat;
sordid: [a]/ˈsɔːrdɪd/; [adj]卑鄙的,肮脏的,色彩死气沉沉暗淡的; [or]sat;
sovereign: [a]/ˈsɑːvrən/; [adj]至高无上的,具有独立主权的,有最高统治权的; [n]最高统治者,君主,元首; [or]sat;
spangle: [a]/ˈspæŋɡl/; [n](缝在衣服上的)金属亮片;闪光装饰; [v]是闪烁发光;用闪光饰物装饰; [or]sat;
sparse: [a]/spɑːrs/; [adj]稀少的;稀疏的; [or]sat;
spat: [a]/spæt/; [n]口角,小争论; [v]轻轻拍打;发生小争吵; [or]sat;
spate: [a]/speɪt/; [n]洪水;一阵;大雨;突然迸发; [or]sat;
spatial: [a]/ˈspeɪʃl/; [adj]空间的,关于空间的; [or]sat;
spatula: [a]/ˈspætʃələ/; [n](调和,涂抹用)抹刀,小铲;<医>压舌板; [or]sat;
spawn: [a]/spɔːn/; [n]卵;菌丝;产物; [v]产卵;酿成,造成;大量生产; [or]sat;
specious: [a]/ˈspiːʃəs/; [adj]外表美观,华而不实的,徒有其表的; [or]sat;
spectrum: [a]/ˈspektrəm/; [n]光谱,范围,系列; [or]sat;
spendthrift: [a]/ˈspendθrɪft/; [adj]挥霍无度的;浪费的; [n]挥霍无度的人;浪费的人; [or]sat;
splice: [a]/splaɪs/; [n]接合,衔接处; [v]接头,捻接(线头等); [or]sat;
spontaneity: [a]/ˌspɑːntəˈneɪəti/; [n]自发性,自然行为;自然发生; [or]sat;
sporadic: [a]/spəˈrædɪk/; [adj]不定时发生的;零星的;分散的; [or]sat;
sportive: [a]/'spɔːtɪv/; [adj]运动的;嬉戏的;适合运动穿戴的; [or]sat;
spurious: [a]/ˈspjʊriəs/; [adj]假的,伪造的,欺骗的; [or]sat;
spurn: [a]/spɜːrn/; [v]轻蔑地拒绝,摒弃,唾弃,一脚踢开; [or]sat;
squabble: [a]/ˈskwɑːbl/; [v]发生口角,大声争吵; [n]争吵,口角; [or]sat;
squalor: [a]/ˈskwɑːlər/; [n]肮脏,邋遢,(道德品质等的)卑劣; [or]sat;
squander: [a]/ˈskwɑːndər/; [n]浪费,挥霍; [v]浪费,挥霍; [or]sat;
squat: [a]/skwɑːt/; [adj]蹲着的; [v]蹲坐,蹲伏; [n]蹲坐; [or]sat;
staccato: [a]/stəˈkɑːtoʊ/; [adj](音乐)断音的,不连贯的; [n]断奏;断续的一段音乐;不连贯的东西(如说话,发动机的声音等); [adv]断音地;不连接地; [or]sat;
stagnant: [a]/ˈstæɡnənt/; [adj]不流动的;停滞的;萧条的; [or]sat;
stalemate: [a]/ˈsteɪlmeɪt/; [n]和棋局面,僵局; [v]使陷入僵局; [or]sat;
stalwart: [a]/ˈstɔːlwərt/; [n]坚定的成员;健壮的人; [adj]强壮的,坚定的,忠诚的; [or]sat;
stamina: [a]/ˈstæmɪnə/; [n]耐力,持久力; [or]sat;
stanch: [a]/stɔːntʃ/; [v]制止(血液),止住; [adj]坚固的;坚定的;可靠的;不漏水的; [or]sat;
stanza: [a]/ˈstænzə/; [n]诗节; [or]sat;
static: [a]/ˈstætɪk/; [adj]静电的,静态的,静止的; [n]静电,静电干扰; [or]sat;
statute: [a]/ˈstætʃuːt/; [n]法令,法规,条例; [or]sat;
steadfast: [a]/ˈstedfæst/; [adj]坚定的;不变的; [or]sat;
stealth: [a]/stelθ/; [n]隐秘,秘密; [or]sat;
steep: [a]/stiːp/; [v]沉浸于..; [adj]陡峭的;急剧的;过高的; [n]陡坡; [or]sat;
stellar: [a]/ˈstelər/; [adj]星的,星球的,主要的; [or]sat;
stem: [a]/stem/; [n]茎,(树)干; [v]阻止;起源于;遏制,抑制; [or]sat;
stereotype: [a]/ˈsteriətaɪp/; [n]老套的模式,陈规,成见; [v]对..产生成见; [or]sat;
stifle: [a]/ˈstaɪfl/; [v]抑制,压制,使窒息; [or]sat;
stigma: [a]/ˈstɪɡmə/; [n]<植>柱头,耻辱,污名,烙印,特征; [or]sat;
stigmatize: [a]/ˈstɪɡmətaɪz/; [v]诬蔑,玷污; [or]sat;
stint: [a]/stɪnt/; [n]节约;从事某工作的时间;固定; [v]节省;限制; [or]sat;
stipend: [a]/ˈstaɪpend/; [n]奖学金;固定薪金;定期津贴;养老金; [or]sat;
stipulate: [a]/ˈstɪpjuleɪt/; [v]规定;保证;保证;要求以.为条件; [or]sat;
stodgy: [a]/ˈstɑːdʒi/; [adj]平凡的;塞满的;庸俗的; [or]sat;
stoic: [a]/ˈstoʊɪkl/; [n]斯多葛学派哲学家;禁欲主义者;坚守克己之人; [adj]斯多葛派的;禁欲主义的; [or]sat;
stoke: [a]/stoʊk/; [v]添加燃料,把(火)拨旺,狼吞虎咽吃; [n]斯托克;<物>沲; [or]sat;
stolid: [a]/ˈstɑːlɪd/; [adj]无动于衷的,感情麻木的; [or]sat;
stratagem: [a]/ˈstrætədʒəm/; [n]谋略,策略; [or]sat;
stratify: [a]/ˈstrætɪfaɪ/; [v]分层,成层,阶层化; [or]sat;
stratum: [a]/ˈstreɪtəm/; [n]层次;薄层;地层;阶层; [or]sat;
strew: [a]/struː/; [vt]撒;把.撒在.上;散播,点缀; [or]sat;
stricture: [a]/ˈstrɪktʃər/; [n]谴责;严厉;束缚; [or]sat;
strident: [a]/ˈstraɪdnt/; [adj]尖声的,刺耳的; [or]sat;
stringent: [a]/ˈstrɪndʒənt/; [adj]严厉的;迫切的;银根紧的; [or]sat;
strut: [a]/strʌt/; [n]高视阔步,抗压装置; [v]昂首阔步地走,趾高气昂地走; [or]sat;
stultify: [a]/ˈstʌltɪfaɪ/; [v]使显得愚蠢,愚弄,使无效,使无价值; [or]sat;
stupefy: [a]/ˈstuːpɪfaɪ/; [v](使)茫然,吓呆; [or]sat;
stupor: [a]/ˈstuːpər/; [n]恍惚,昏迷,不醒人事; [or]sat;
stymie: [a]/ˈstaɪmi/; [v]从中作梗,阻挠;妨碍; [n]妨碍球; [or]sat;
subdued: [a]/səbˈduːd/; [adj]减弱的;被制服的;被抑制的; [or]sat;
subjective: [a]/səbˈdʒektɪv/; [adj]主观(上)的,个人的; [or]sat;
subjugate: [a]/ˈsʌbdʒuɡeɪt/; [v]征服,使服从; [or]sat;
sublime: [a]/səˈblaɪm/; [adj]雄伟的,崇高的,极端的,超群的;(行为,态度)极端的,漠不关心的; [n]顶峰,崇高; [v]使.纯化,使.升华,变高尚; [or]sat;
subliminal: [a]/ˌsʌbˈlɪmɪnl/; [adj]潜意识的,下意识的; [or]sat;
submissive: [a]/səbˈmɪsɪv/; [adj]顺从的,惟命是从的,谦恭的; [or]sat;
subordinate: [a]/səˈbɔːrdɪnət/; [n]部下;下属; [adj]次要的;从属的;下级的; [v]使从属于;使处于次要地位; [or]sat;
subpoena: [a]/səˈpiːnə/; [n](法律)传票; [v]传讯;传审; [or]sat;
subsequent: [a]/ˈsʌbsɪkwənt/; [adj]随后的; [or]sat;
subservient: [a]/səbˈsɜːrviənt/; [adj]屈从的;奉承的;有用的,有帮助的; [or]sat;
subside: [a]/səbˈsaɪd/; [vi]平息,减弱;减弱;(建筑)下陷;(尤指洪水的水位) 回落; [or]sat;
subsidiary: [a]/səbˈsɪdieri/; [adj]辅助的,次要的,附属的; [n]子公司,附属机构; [or]sat;
subsidy: [a]/ˈsʌbsədi/; [n]补助金,津贴; [or]sat;
subsistence: [a]/səbˈsɪstəns/; [n]存在,生存;生活; [adj]收成仅够自身口粮的; [or]sat;
substantiate: [a]/səbˈstænʃieɪt/; [v]证实;使实体化; [or]sat;
substantive: [a]/səbˈstæntɪv/; [adj]有实质的;大量的;真实的;独立存在的; [n]实词,名词,名词性词组; [or]sat;
subterfuge: [a]/ˈsʌbtərfjuːdʒ/; [n]托词,借口,诡计; [or]sat;
subversive: [a]/səbˈvɜːrsɪv/; [n]颠覆分子,破坏分子; [adj]颠覆性的,破坏性的; [or]sat;
succinct: [a]/səkˈsɪŋkt/; [adj]简明的,简洁的,没有废话的; [or]sat;
succor: [a]/ˈsʌkər/; [n]救援,援助者,救援人员; [v]援助,救援; [or]sat;
succulent: [a]/ˈsʌkjələnt/; [n]肉质植物; [adj]多汁鲜美的;丰富多彩的; [or]sat;
succumb: [a]/səˈkʌm/; [v]屈从,屈服,因.死亡(to); [or]sat;
sully: [a]/ˈsʌli/; [v]玷污,污染; [or]sat;
sultry: [a]/ˈsʌltri/; [adj]闷热的,狂暴的,淫荡的; [or]sat;
summit: [a]/ˈsʌmɪt/; [n]山顶,顶点;(政府间的)峰会; [or]sat;
sumptuous: [a]/ˈsʌmptʃuəs/; [adj]奢侈的;华丽的; [or]sat;
sunder: [a]/ˈsʌndər/; [v]切开;分裂,分离; [or]sat;
supercilious: [a]/ˌsuːpərˈsɪliəs/; [adj]目中无人的,高傲的; [or]sat;
superficial: [a]/ˌsuːpərˈfɪʃl/; [adj]肤浅的;表面的;微不足道的; [n]表面文章; [or]sat;
superfluous: [a]/suːˈpɜːrfluəs/; [adj]多余的,过剩的;不必要的; [or]sat;
superimpose: [a]/ˌsuːpərɪmˈpoʊz/; [v]添加;重叠;附加;安装; [or]sat;
supersede: [a]/ˌsuːpərˈsiːd/; [v]代替;紧接着而到来; [or]sat;
supplant: [a]/səˈplænt/; [v]代替;排挤掉; [or]sat;
supple: [a]/ˈsʌpl/; [adj]柔软的;柔顺的; [or]sat;
supplicate: [a]/'sʌplɪˌkeɪt/; [v]恳求,乞求; [or]sat;
suppress: [a]/səˈpres/; [v]镇压;禁止发表;抑制(感情等);阻止.的生长; [or]sat;
surfeit: [a]/ˈsɜːrfɪt/; [n]饮食过度,过量; [or]sat;
surly: [a]/ˈsɜːrli/; [adj]乖戾的;无礼的;阴沉的; [or]sat;
surmise: [a]/sərˈmaɪz/; [v]猜测,推测,认为; [n]推测,猜度; [or]sat;
surmount: [a]/sərˈmaʊnt/; [v]克服,战胜,越过; [or]sat;
surpass: [a]/sərˈpæs/; [v]胜过;超出; [or]sat;
surreptitious: [a]/ˌsɜːrəpˈtɪʃəs/; [adj]鬼鬼祟祟的,暗中的,秘密的; [or]sat;
surrogate: [a]/ˈsɜːrəɡət/; [n]代替品,代理人,代孕妈妈; [adj]代理的,替代的; [v]代替,代理;指定为自己的代理人,接替; [or]sat;
surveillance: [a]/sɜːrˈveɪləns/; [n]监视;检查; [or]sat;
susceptible: [a]/səˈseptəbl/; [adj]易受感染的;易受影响的;多情的; [or]sat;
sustain: [a]/səˈsteɪn/; [v]维持;支撑,承受;供养;忍受;遭受,蒙受; [or]sat;
sustenance: [a]/ˈsʌstənəns/; [n]生计;食物,粮食; [or]sat;
suture: [a]/ˈsuːtʃər/; [n]缝合; [v]缝合; [or]sat;
swagger: [a]/ˈswæɡər/; [n]傲慢的态度,大摇大摆; [v]大摇大摆地走,吹牛,傲慢; [adj]豪华时髦的; [or]sat;
swarm: [a]/swɔːrm/; [n]蜂群;一群,一批人; [v]蜂拥;密集; [vt]蜂拥;挤满; [or]sat;
swarthy: [a]/ˈswɔːrði/; [adj](皮肤等)黝黑的; [or]sat;
swathe: [a]/sweɪð/; [n]带子,绷带;包装品; [vt]包围;紧绑;裹; [or]sat;
swerve: [a]/swɜːrv/; [v]转弯,突然改变方向; [n]转向;滑出;逸出;背离; [or]sat;
swill: [a]/swɪl/; [n]泔水;冲洗;痛饮; [v]冲洗,痛饮; [or]sat;
swindler: [a]/ˈswɪndlər/; [n]骗子; [or]sat;
sybarite: [a]/'sɪbəˌraɪt/; [n]沉于奢侈逸乐者,酒色之徒; [or]sat;
sycophant: [a]/ˈsɪkəfænt/; [n]马屁精; [or]sat;
symbiosis: [a]/ˌsɪmbɪˈoʊsɪs/; [n]共生,共栖; [or]sat;
symmetry: [a]/ˈsɪmətri/; [n]对称;均衡; [or]sat;
synoptic: [a]/sɪˈnɑːptɪk/; [adj]天气的,概要的,一览无余的; [or]sat;
synthesis: [a]/ˈsɪnθəsɪs/; [n]合成; [or]sat;
tacit: [a]/ˈtæsɪt/; [adj]心照不宣的,静默的; [or]sat;
taciturn: [a]/ˈtæsɪtɜːrn/; [adj]沉默寡言的; [or]sat;
tactile: [a]/ˈtæktl/; [adj]有触觉的;能触知的; [or]sat;
taint: [a]/teɪnt/; [n]污点;感染;异味; [vi]腐败,腐烂; [vt]污染;玷污,使受不良影响; [or]sat;
talisman: [a]/ˈtælɪzmən/; [n]护身符,避邪物; [or]sat;
talon: [a]/ˈtælən/; [n]猛禽的锐爪; [or]sat;
tanner: [a]/ˈtænər/; [n]制革工人,六便士; [or]sat;
tantalize: [a]/ˈtæntəlaɪz/; [v]逗弄,挑逗,使(看到拿不到而)焦急; [or]sat;
tantamount: [a]/ˈtæntəmaʊnt/; [adj]与.相等的; [or]sat;
tantrum: [a]/ˈtæntrəm/; [n](孩子气的)脾气发作; [or]sat;
tarry: [a]/ˈtæri/; [n]逗留,短期滞在; [v]耽搁,踌躇(等待),拖延; [adj]柏油的,涂柏油的; [or]sat;
taut: [a]/tɔːt/; [adj]拉紧的;紧张的;整洁的; [or]sat;
tawdry: [a]/ˈtɔːdri/; [adj]非常华丽的,廉价而俗丽的; [n]俗丽的东西,廉价而俗丽之物; [adv]俗丽地,华而不实地; [or]sat;
tedious: [a]/ˈtiːdiəs/; [adj]沉闷的,冗长乏味的; [or]sat;
temerity: [a]/təˈmerəti/; [n]鲁莽,大胆,蛮勇; [or]sat;
temper: [a]/ˈtempər/; [n]脾气,性情;调和剂; [v]锻炼,缓和; [or]sat;
temperament: [a]/ˈtemprəmənt/; [n]气质,性格,喜怒无常; [or]sat;
temperate: [a]/ˈtempərət/; [adj]温和的;适度的,有节制的; [or]sat;
tempestuous: [a]/temˈpestʃuəs/; [adj]有暴风雨的,暴乱的,剧烈的; [or]sat;
tempo: [a]/ˈtempoʊ/; [n]<音>节奏,拍子;行进速度; [or]sat;
temporal: [a]/ˈtempərəl/; [adj]现世的,世俗的;当时的,暂时的;<解>颞的;时间的; [n]世间万物;教会财产; [or]sat;
temporize: [a]/ˈtempəraɪz/; [v]拖延,妥协,顺应时势,迎合潮流; [or]sat;
tenacious: [a]/təˈneɪʃəs/; [adj]坚忍不拔的,固执的,顽强的; [or]sat;
tenacity: [a]/təˈnæsəti/; [n]坚韧不拔,顽强精神; [or]sat;
tendentious: [a]/tenˈdenʃəs/; [adj]有偏见的,有倾向的;宣传性的; [adv]宣传性地,不公平地,有倾向性地; [n]倾向性小说; [or]sat;
tender: [a]/ˈtendər/; [adj]温柔的;嫩的;柔弱的,脆弱的;痛的; [n]煤水车,附属船;投标; [v]提出(希望对方接受的意见等); [or]sat;
tenet: [a]/ˈtenɪt/; [n]信念,原则,教条; [or]sat;
tensile: [a]/ˈtensl/; [adj]可拉长的,可伸长的,<物>张力的,拉力的; [or]sat;
tenuous: [a]/ˈtenjuəs/; [adj]纤细的;稀薄的;贫乏的;脆弱的; [or]sat;
tenure: [a]/ˈtenjər/; [n]任期;终身职位; [or]sat;
tepid: [a]/ˈtepɪd/; [adj]微温的,不热烈的; [or]sat;
termination: [a]/ˌtɜːrmɪˈneɪʃn/; [n]终端;结果;结束,终止; [or]sat;
terminology: [a]/ˌtɜːrməˈnɑːlədʒi/; [n]术语,术语学; [or]sat;
terrestrial: [a]/təˈrestriəl/; [adj]地球的,陆地的; [n]陆地生物;地球上的人; [or]sat;
terse: [a]/tɜːrs/; [adj]简洁的,简明的; [or]sat;
testy: [a]/ˈtesti/; [adj]性急的,暴躁的; [or]sat;
tether: [a]/ˈteðər/; [n]范围,系链,拴绳; [v]用绳或链拴住; [or]sat;
theocracy: [a]/θiˈɑːkrəsi/; [n]神权政治; [or]sat;
theoretical: [a]/ˌθiːəˈretɪkl/; [adj]理论(上)的; [or]sat;
therapeutic: [a]/ˌθerəˈpjuːtɪk/; [adj]治疗的;治疗学的;有益于健康的; [n]治疗剂;治疗学家; [or]sat;
thermal: [a]/ˈθɜːrml/; [adj]保暖的;温泉的;热的; [n]保暖内衣裤; [or]sat;
thespian: [a]/ˈθespiən/; [adj]悲剧的;戏剧的; [n]演员;悲剧演员; [or]sat;
threadbare: [a]/ˈθredber/; [adj]磨破的,衣衫褴褛的,乏味的,俗套的; [or]sat;
thrifty: [a]/ˈθrɪfti/; [adj]节省的,节俭的; [or]sat;
thrive: [a]/θraɪv/; [v]茁壮成长;繁荣,兴旺; [or]sat;
throng: [a]/θrɔːŋ/; [v]群集,蜂拥; [n]一大群人; [vt]挤向; [or]sat;
thwart: [a]/θwɔːrt/; [n]<船>横坐板; [v]阻挠,阻碍,横过; [adj]横放的; [adv]横过; prep. 〈古〉横跨,横过; [or]sat;
timidity: [a]/tɪˈmɪdəti/; [n]胆怯; [or]sat;
timorous: [a]/ˈtɪmərəs/; [adj]胆小的,胆怯的,羞怯的; [or]sat;
tirade: [a]/ˈtaɪreɪd/; [n]长篇的攻击性演说; [or]sat;
title: [a]/ˈtaɪtl/; [n]标题;头衔;权利; [vt]加标题于;授予.称号; [adj]标题的,题目的;称呼的; [or]sat;
toady: [a]/ˈtoʊdi/; [n]谄媚者,拍马屁的人; [v]谄媚,拍马屁; [or]sat;
tome: [a]/toʊm/; [n]册,卷,本,大本书; [or]sat;
tonic: [a]/ˈtɑːnɪk/; [n]补药;主调音或基音; [adj]滋补的;声调的;使精神振作的; [or]sat;
topography: [a]/təˈpɑːɡrəfi/; [n]地形学;地形,地貌;局部解剖学;地形图,地势图; [or]sat;
torpor: [a]/ˈtɔːrpər/; [n]麻木;无感觉;不活泼; [or]sat;
torrent: [a]/ˈtɔːrənt/; [n]湍流,洪流,奔流;迸发,连发,爆发;倾盆大雨; [or]sat;
torrid: [a]/ˈtɔːrɪd/; [adj]酷热的,热烈; [or]sat;
torso: [a]/ˈtɔːrsoʊ/; [n](人体的)躯干,躯干像; [or]sat;
tortuous: [a]/ˈtɔːrtʃuəs/; [adj]弯弯曲曲的,蜿蜒的; [or]sat;
totter: [a]/ˈtɑːtər/; [n]蹒跚,踉跄; [vi]蹒跚,踉跄,动摇,摇摇欲坠; [or]sat;
touchy: [a]/ˈtʌtʃi/; [adj](人或话题)敏感的,易发脾气的; [adv]易动气地,过分敏感地,小心眼地; [n]易动气,过分敏感; [or]sat;
tout: [a]/taʊt/; [v]招徕顾客,极力赞扬; [or]sat;
toxic: [a]/ˈtɑːksɪk/; [n]毒物; [adj]有毒的;中毒的; [or]sat;
tract: [a]/trækt/; [n]器官系统;一大片地;短文,小册子; [or]sat;
tractable: [a]/ˈtræktəbl/; [adj]易于管教的,易驾驭的,易处理的,驯良的; [or]sat;
trajectory: [a]/trəˈdʒektəri/; [n]弹道,航线;轨线; [or]sat;
transcribe: [a]/trænˈskraɪb/; [v]抄写,转录; [or]sat;
transient: [a]/ˈtrænʃnt/; [adj]短暂的,路过的;转瞬即逝的; [n]过客; [or]sat;
transition: [a]/trænˈzɪʃn/; [n]转变,过渡时期; [v](从某一状态或活动)转变,过渡(到另一状态或活动); [or]sat;
transitory: [a]/ˈtrænsətɔːri/; [adj]短暂的,暂时的,瞬息的; [or]sat;
translucent: [a]/trænsˈluːsnt/; [adj]半透明的;透亮的,有光泽的;易懂的;真实的; [or]sat;
transmute: [a]/trænzˈmjuːt/; [v]使改变,使变形; [or]sat;
transparent: [a]/trænsˈpærənt/; [adj]透明的,清澈的,明净的;易识破的,显而易见的; [or]sat;
transport: [a]/ˈtrænspɔːrt/; [v]运输;使狂喜;流放; [n]运输;运输工具;流放犯; [or]sat;
trappings: [a]/ˈtræpɪŋz/; [n]服饰,礼服,外部标志,马饰; [or]sat;
traumatic: [a]/traʊˈmætɪk/; [adj](精神)受创伤的,外伤的; [or]sat;
travail: [a]/trəˈveɪl/; [n]分娩的痛苦,艰苦劳动; [v]辛勤努力,经受分娩的阵痛; [or]sat;
traverse: [a]/trəˈvɜːrs/; [v]横越;穿过; [n]横越; [or]sat;
travesty: [a]/ˈtrævəsti/; [n]滑稽模仿;拙劣的模仿作品;歪曲; [vt]滑稽地模仿;歪曲; [or]sat;
treatise: [a]/ˈtriːtɪs/; [n]论述;论文;专著; [or]sat;
trek: [a]/trek/; [n]艰苦跋涉; [v]拉(货车),搬运; [or]sat;
tremor: [a]/ˈtremər/; [n](小)地震;<医>震颤,战栗,发抖; [or]sat;
tremulous: [a]/ˈtremjələs/; [adj]胆小的,颤动的,不安的; [or]sat;
trenchant: [a]/ˈtrentʃənt/; [adj]犀利的,锐利的,有力的,清晰的,一针见血的; [or]sat;
trepidation: [a]/ˌtrepɪˈdeɪʃn/; [n]恐惧,惶恐; [or]sat;
trespass: [a]/ˈtrespæs/; [v]侵入;犯罪; [n]罪过;非法侵入; [or]sat;
tribute: [a]/ˈtrɪbjuːt/; [n]致敬;悼念;贡品;称赞; [or]sat;
trifling: [a]/ˈtraɪflɪŋ/; [adj]细微的,不重要的; [or]sat;
trigger: [a]/ˈtrɪɡər/; [n](枪等的)扳机,诱因; [v]触发,引起,激发,扣扳机; [or]sat;
trinket: [a]/ˈtrɪŋkɪt/; [n]小装饰品,不值钱的珠宝; [or]sat;
trite: [a]/traɪt/; [adj]陈腐的;平庸的;老一套的; [or]sat;
trough: [a]/trɔːf/; [n]水槽,水槽;低谷期;饲料槽;低气压; [or]sat;
truism: [a]/ˈtruːɪzəm/; [n]自明之理,真理,不言而喻的道理; [or]sat;
truncate: [a]/ˈtrʌŋkeɪt/; [adj]截短的;被删节的; [v]把(某物)截短,去尾; [or]sat;
tumult: [a]/ˈtuːmʌlt/; [n]骚动;骚乱;吵闹;激动; [or]sat;
tundra: [a]/ˈtʌndrə/; [n]冻土地带; [or]sat;
turbid: [a]/ˈtɜːrbɪd/; [adj]混浊的,紊乱的; [or]sat;
turbulence: [a]/ˈtɜːrbjələns/; [n]骚乱,动荡;狂暴;(空气或水的)乱流; [or]sat;
turgid: [a]/ˈtɜːrdʒɪd/; [adj]肿胀的;浮夸的;浮肿的; [or]sat;
turmoil: [a]/ˈtɜːrmɔɪl/; [n]骚动,骚乱; [or]sat;
turncoat: [a]/ˈtɜːrnkoʊt/; [n]叛徒; [or]sat;
turpitude: [a]/ˈtɜːrpətuːd/; [n]邪恶,卑鄙(行为); [or]sat;
tutelage: [a]/ˈtuːtəlɪdʒ/; [n]监护,指导; [or]sat;
tycoon: [a]/taɪˈkuːn/; [n]有钱有势的企业家,大亨; [or]sat;
typhoon: [a]/taɪˈfuːn/; [n]台风,强热带风暴; [or]sat;
tyranny: [a]/ˈtɪrəni/; [n]暴政,苛政,虐待; [or]sat;
tyro: [a]/ˈtaɪroʊ/; [n]新手; [or]sat;
ubiquitous: [a]/juːˈbɪkwɪtəs/; [adj]普遍存在的;无所不在的; [or]sat;
ultimate: [a]/ˈʌltɪmət/; [adj]根本的;最后的,最终的; [or]sat;
unanimity: [a]/ˌjuːnəˈnɪməti/; [n]一致同意; [or]sat;
unassailable: [a]/ˌʌnəˈseɪləbl/; [adj]无可争辩的,无懈可击的,不可亵渎的; [or]sat;
unassuming: [a]/ˌʌnəˈsuːmɪŋ/; [adj]谦逊的,不装腔作势的; [or]sat;
unbridled: [a]/ʌnˈbraɪdld/; [adj]无拘束的;激烈的;放纵的;放纵的,无约束的; [or]sat;
uncanny: [a]/ʌnˈkæni/; [adj]神秘的,不可思议的; [or]sat;
uncouth: [a]/ʌnˈkuːθ/; [adj]笨拙的;粗野的;不舒适的;陌生的; [or]sat;
unctuous: [a]/ˈʌŋktʃuəs/; [adj]油腔滑调的,虚情假意的; [or]sat;
underlying: [a]/ˌʌndərˈlaɪɪŋ/; [adj]基本的;潜在的;在下面的; [or]sat;
undermine: [a]/ˌʌndərˈmaɪn/; [v]暗中破坏;逐渐削弱;侵蚀.的基础;在...下挖坑道,从根基处损害; [or]sat;
underscore: [a]/ˌʌndərˈskɔːr/; [v]强调,加强,划线于.下; [n]底线; [or]sat;
unearth: [a]/ʌnˈɜːrθ/; [vt]发掘,掘出,揭露,发现;揭发; [or]sat;
unequivocal: [a]/ˌʌnɪˈkwɪvəkl/; [adj]明确的,不含糊的; [or]sat;
ungainly: [a]/ʌnˈɡeɪnli/; [adj]笨拙的,不雅的; [adv]笨拙地;不雅地; [or]sat;
uniformity: [a]/ˌjuːnɪˈfɔːrməti/; [n]均匀性;一致,一致性;同样; [or]sat;
unimpeachable: [a]/ˌʌnɪmˈpiːtʃəbl/; [adj]可信的,无可挑剔的; [or]sat;
unique: [a]/juˈniːk/; [adj]独特的,独一无二的;(唯一的)特有的;不同寻常的; [or]sat;
universal: [a]/ˌjuːnɪˈvɜːrsl/; [adj]普遍存在的;全体的;通用的;宇宙的; [n]普遍原则; [or]sat;
unkempt: [a]/ˌʌnˈkempt/; [adj](衣服,头发)不整洁的;蓬乱的; [or]sat;
unobtrusive: [a]/ˌʌnəbˈtruːsɪv/; [adj]不唐突的,谦虚的,不引人注目的; [or]sat;
unpalatable: [a]/ʌnˈpælətəbl/; [adj]不可口的,不好吃的;令人不愉快的; 使人难以接受的; [or]sat;
unprecedented: [a]/ʌnˈpresɪdentɪd/; [adj]前所未有的,空前的,无前例的; [or]sat;
unravel: [a]/ʌnˈrævl/; [v]解开;拆开;阐明;解释; [or]sat;
unrequited: [a]/ˌʌnrɪˈkwaɪtɪd/; [adj]无回报的;无报酬的; [or]sat;
unruly: [a]/ʌnˈruːli/; [adj]不守规矩的;任性的;难驾驭的; [or]sat;
unscathed: [a]/ʌnˈskeɪðd/; [adj]未受损伤的;未遭伤害的; [or]sat;
unseemly: [a]/ʌnˈsiːmli/; [adj]不适宜的;不得体的; [adv]不适当地; [or]sat;
unsightly: [a]/ʌnˈsaɪtli/; [adj]难看的; [or]sat;
untenable: [a]/ʌnˈtenəbl/; [adj]防守不住的,站不住脚的; [or]sat;
unwarranted: [a]/ʌnˈwɔːrəntɪd/; [adj]未经保证的,无根据的,不合适的; [or]sat;
unwieldy: [a]/ʌnˈwiːldi/; [adj]使用不便的,不灵巧的,难处理的;笨重的; [or]sat;
unwitting: [a]/ʌnˈwɪtɪŋ/; [adj]不知情的;无意的; [or]sat;
upbraid: [a]/ʌpˈbreɪd/; [v]斥责,责骂; [or]sat;
upshot: [a]/'ʌpʃɑːt/; [n]结果,结局;要点; [or]sat;
urbane: [a]/ɜːrˈbeɪn/; [adj]温文尔雅的,懂礼的;都<城>市气派的; [or]sat;
usurp: [a]/juːˈzɜːrp/; [vi]篡夺,篡位; [vt]篡夺,强夺; [or]sat;
vacuous: [a]/ˈvækjuəs/; [adj]空的,空虚的,空洞的,无意义的; [or]sat;
vagabond: [a]/ˈvæɡəbɑːnd/; [n]流浪者; [v]漂泊,流浪; [adj]流浪的,流浪者的,漂泊的; [or]sat;
vagrant: [a]/ˈveɪɡrənt/; [n]游民; [adj]漂泊的; [or]sat;
valedictory: [a]/ˌvælɪˈdɪktəri/; [n]告别辞; [adj]告别的; [or]sat;
valid: [a]/ˈvælɪd/; [adj]有效的,正式认可的;合理的,有根据的; [or]sat;
validate: [a]/ˈvælɪdeɪt/; [v]使.生效,使合法化;证明正确; [or]sat;
valor: [a]/'vælə/; [n]勇猛,英勇; [or]sat;
vampire: [a]/ˈvæmpaɪər/; [n]吸血鬼; [or]sat;
vanguard: [a]/ˈvænɡɑːrd/; [n]先锋,前锋;先驱;领导者; [or]sat;
vantage: [a]/'vɑːntɪdʒ/; [n]优势;有利情况; [or]sat;
vapid: [a]/ˈvæpɪd/; [adj]索然无味的;无生气的; [adv]乏味地;无滋味地;无趣味地;无生气地; [or]sat;
vaporize: [a]/ˈveɪpəraɪz/; [v](使)蒸发;使.蒸发; [or]sat;
variegated: [a]/ˈverɪɡeɪtɪd/; [n]使富有变化,使成为杂色; [adj]斑驳的,多色的,富于变化的; [or]sat;
veer: [a]/vɪr/; [n]方向的转变; [v]转向,改变(话题等),放松(绳,缆等); [or]sat;
vehement: [a]/ˈviːəmənt/; [adj]猛烈的,强烈的; [or]sat;
velocity: [a]/vəˈlɑːsəti/; [n]速度;迅速,快速; [or]sat;
venal: [a]/ˈviːnl/; [adj]唯利是图的;贪赃枉法; [or]sat;
vendor: [a]/ˈvendər/; [n]小贩,卖主,供应商; [or]sat;
veneer: [a]/vəˈnɪr/; [n](镶于劣质东西上的)镶面板;掩饰; [v]虚饰;给.镶以饰片; [or]sat;
venerable: [a]/ˈvenərəbl/; [adj]令人尊敬的;(因历史悠久而) 神圣庄严的; [or]sat;
venerate: [a]/ˈvenəreɪt/; [v]崇敬,敬仰; [or]sat;
venial: [a]/ˈviːniəl/; [adj]可原谅的,(罪过)轻微的,可宽恕的; [or]sat;
venom: [a]/ˈvenəm/; [n]毒液;恶意;怨恨; [vt]使有毒;放毒; [or]sat;
vent: [a]/vent/; [n]发泄;通风口,排气口;(上衣背部或两侧的)开衩;(小型动物的)排泄口; [v]发泄(情绪),开孔,泄露; [or]sat;
ventriloquist: [a]/venˈtrɪləkwɪst/; [n]口技表演者; [or]sat;
venturesome: [a]/ˈventʃərsəm/; [adj]好冒险的,大胆的;危险的; [or]sat;
verbalize: [a]/ˈvɜːrbəlaɪz/; [v]唠叨;以言语表述;使.变成动词; [or]sat;
verbatim: [a]/vɜːrˈbeɪtɪm/; [adj]逐字的; [adv]逐字地; [or]sat;
verbiage: [a]/ˈvɜːrbiɪdʒ/; [n]罗嗦,冗长,措辞方式; [or]sat;
verbose: [a]/vɜːrˈboʊs/; [adj]冗长的,啰嗦的; [or]sat;
verdant: [a]/ˈvɜːrdnt/; [adj]青葱的,翠绿的; [or]sat;
verge: [a]/vɜːrdʒ/; [n]边缘;边界; [v]接近;濒临; [or]sat;
verisimilitude: [a]/ˌverɪsɪˈmɪlɪtuːd/; [n]逼真,真实性; [or]sat;
vernacular: [a]/vərˈnækjələr/; [adj]本国的,地方的,用本地语写成的; [n]方言;土语;(建筑的)民间风格; [or]sat;
versatile: [a]/ˈvɜːrsətl/; [adj]万能的,综合的,多才多艺的; [or]sat;
vertigo: [a]/ˈvɜːrtɪɡoʊ/; [n]晕头转向;眩晕; [or]sat;
verve: [a]/vɜːrv/; [n]热情,神韵,活力,气魄; [or]sat;
vestige: [a]/ˈvestɪdʒ/; [n]遗迹,(生)退化的器官,残余,微量(一般用于否定句); [or]sat;
vex: [a]/veks/; [v]使烦恼,使苦恼,使恼怒; [or]sat;
viable: [a]/ˈvaɪəbl/; [adj]可行的;能养活的;能生育的; [or]sat;
vicarious: [a]/vaɪˈkeriəs/; [adj]代替别人做的;代理的,代替的;发同感的; [or]sat;
vicissitude: [a]/vɪˈsɪsɪtuːd/; [n]变迁,沧桑,兴衰; [or]sat;
vie: [a]/vaɪ/; [v]竞争;使针锋相对;以..作较量; [or]sat;
vigilance: [a]/ˈvɪdʒɪləns/; [n]警戒;警惕;警戒; [or]sat;
vignette: [a]/vɪnˈjet/; [n]装饰图案;小插图; [v]把..印放为虚光照,晕映; [or]sat;
vigor: [a]/ˈvɪɡər/; [n]生命力,活力; [or]sat;
vilify: [a]/ˈvɪlɪfaɪ/; [v]辱骂,诽谤; [or]sat;
vindicate: [a]/ˈvɪndɪkeɪt/; [vt]证明.无辜;维护,辩护; [or]sat;
vindictive: [a]/vɪnˈdɪktɪv/; [adj]报复性的,怀恨的,惩罚的; [or]sat;
virile: [a]/ˈvɪrəl/; [adj]成年男子的,有男子气概的,强壮的; [or]sat;
virtual: [a]/ˈvɜːrtʃuəl/; [adj](计算机)虚拟的;十分接近的;实质上的; [or]sat;
virtue: [a]/ˈvɜːrtʃuː/; [n]正直,善良;美德,德行;好处,优点; [or]sat;
virtuoso: [a]/ˌvɜːrtʃuˈoʊsoʊ/; [n]艺术品鉴赏家,古董收藏家,艺术大师; [adj]行家里手的,艺术爱好者的; [or]sat;
virulent: [a]/ˈvɪrələnt/; [adj]剧毒的;恶性的;有恶意的; [or]sat;
virus: [a]/ˈvaɪrəs/; [n]病毒;(计算机) 病毒;病毒性疾病; [or]sat;
viscid: [a]/ˈvɪsɪd/; [adj]黏的,黏质的; [or]sat;
viscous: [a]/ˈvɪskəs/; [adj]黏的;黏稠的;黏滞的;有黏性的; [or]sat;
visionary: [a]/ˈvɪʒəneri/; [n]有远见的人;幻想家; [adj]有远见的;爱幻想的; [or]sat;
vital: [a]/ˈvaɪtl/; [adj]生命所必需的;必不可少的;至关重要的;有活力的;生命攸关的; [n]要害;重要部分; [or]sat;
vitriolic: [a]/ˌvɪtriˈɑːlɪk/; [adj]刻薄的,强烈的,硫酸(盐)的,由硫酸制成的; [or]sat;
vituperative: [a]/vaɪˈtuːpəreɪtɪv/; [adj]责骂的,辱骂的; [or]sat;
vivacious: [a]/vɪˈveɪʃəs/; [adj]活泼的,快活的(多指女性); [or]sat;
vociferous: [a]/voʊˈsɪfərəs/; [adj](表达意见或感情等)大声的,有力的; [or]sat;
vogue: [a]/voʊɡ/; [n]时髦,时尚; [adj]流行的; [or]sat;
volatile: [a]/ˈvɑːlətl/; [adj]易气化的;爆炸性的;反复无常的;短暂的;不稳定的; [or]sat;
volition: [a]/voʊˈlɪʃn/; [n]决定;自主;意志力;下决心;意志力; [or]sat;
voluble: [a]/ˈvɑːljəbl/; [adj]健谈的,缠绕的,易旋转的; [or]sat;
voluminous: [a]/vəˈluːmɪnəs/; [adj]大量的;长篇的,多产的;庞大的; [adv]宽松地;容量大地;篇幅长地; [n]宽松;容量大,篇幅长; [or]sat;
voluptuous: [a]/vəˈlʌptʃuəs/; [adj]撩人的,沉溺酒色的,骄奢淫逸的; [or]sat;
voracious: [a]/vəˈreɪʃəs/; [adj]狼吞虎咽的,贪婪的; [adv]贪婪地; [n]贪婪,贪吃; [or]sat;
vortex: [a]/ˈvɔːrteks/; [n]旋涡,气旋;涡流; [or]sat;
voyeur: [a]/vwaɪˈɜːr/; [n]窥淫狂者,窥隐私者; [or]sat;
vulnerable: [a]/ˈvʌlnərəbl/; [adj]易受伤的;脆弱的;易受攻击的; [or]sat;
waffle: [a]/ˈwɑːfl/; [n]华夫饼干;动听而无意义的话;无聊话; [v]胡扯,含糊其辞; [or]sat;
waft: [a]/wɑːft/; [v]使飘荡;吹送; [n]飘荡;吹拂; [or]sat;
waggish: [a]/ˈwæɡɪʃ/; [adj]诙谐的,滑稽的; [or]sat;
waive: [a]/weɪv/; [v]放弃;不坚持;推迟;搁置; [vt]抑制;搁置; [or]sat;
wake: [a]/weɪk/; [v]醒来,使觉醒;激发,引起; [n]守灵,守夜;(船航过时的)尾波;年度假期; [or]sat;
wallow: [a]/ˈwɑːloʊ/; [v]打滚;沉迷,沉溺;颠簸; [n]打滚;堕落;泥坑; [or]sat;
wan: [a]/wɑːn/; [adj]虚弱的,病态的; [or]sat;
wane: [a]/weɪn/; [n]衰退(期);月亏(期);减少; [v](月)缺损;(光,势力,治理等)衰落;减少; [or]sat;
wanton: [a]/ˈwɑːntən/; [n]水性杨花的人,任性的孩子,无节制的人; [v]放肆,胡作非为,挥霍; [adj]胡作非为的,淫荡的,无节制的; [or]sat;
warble: [a]/ˈwɔːrbl/; [n]鸟啭鸣,颤声; [v]鸟鸣,用柔和的颤声唱; [or]sat;
warrant: [a]/ˈwɔːrənt/; [n]逮捕证;正当理由;凭证; [v]使正当; [or]sat;
warranty: [a]/ˈwɔːrənti/; [n]授权;根据;保证书;担保书,保单; [or]sat;
wary: [a]/ˈweri/; [adj]谨慎的,小心的,提防的;考虑周到的; [or]sat;
wastrel: [a]/ˈweɪstrəl/; [n]败家子,挥霍无度的人; [or]sat;
watershed: [a]/ˈwɔːtərʃed/; [n](美)流域;分水岭;集水区;转折点;重要关头; [adj]标志转折点的; [or]sat;
wax: [a]/wæks/; [n]蜡;蜡状物; [v]给.上蜡;给.打蜡,给.上蜡;渐渐变大;变为;(月亮)渐圆,渐盈; [adj]蜡制的; [or]sat;
waylay: [a]/weɪˈleɪ/; [v]埋伏,伏击; [or]sat;
wean: [a]/wiːn/; [v]断奶,戒掉(off/from),(从早年开始)使用; [n]〈英〉婴儿;小儿; [or]sat;
welter: [a]/ˈweltər/; [n]混乱;滚浪;翻滚;起伏; [v]翻滚;沉溺;起伏; [adj]负重赛马的; [or]sat;
wheedle: [a]/ˈwiːdl/; [v]以甜言蜜语诱惑,用甜言蜜语欺骗; [or]sat;
whet: [a]/wet/; [v]刺激;磨快;促进; [n]磨;开胃物;刺激物; [or]sat;
whiff: [a]/wɪf/; [n]一吹,一吸,一阵香气,一点点,香烟的一口; [v]轻轻地吹,喷气,<棒>三击出局; [or]sat;
whimsical: [a]/ˈwɪmzɪkl/; [adj]古怪的,异想天开的; [or]sat;
whittle: [a]/ˈwɪtl/; [v]削(木头);削减; [n]大刀,屠刀; [or]sat;
willful: [a]/ˈwɪlfl/; [adj]有意的,任性的,故意的; [or]sat;
wily: [a]/ˈwaɪli/; [adj]狡猾的; [or]sat;
wince: [a]/wɪns/; [v]避开,畏缩; [n]畏缩;脸部肌肉的抽搐; [or]sat;
windfall: [a]/ˈwɪndfɔːl/; [n]风吹落果;意外的收获,意外幸运; [or]sat;
winnow: [a]/ˈwɪnoʊ/; [v]把(谷物)的杂质吹掉;簸;精选;扬谷; [or]sat;
winsome: [a]/ˈwɪnsəm/; [adj]迷人的;可爱的;漂亮的; [or]sat;
wispy: [a]/ˈwɪspi/; [adj]象小束状的,纤细的;脆弱的; [or]sat;
wistful: [a]/ˈwɪstfl/; [adj]渴望的,向往的;深思的;留恋的; [or]sat;
withdrawn: [a]/wɪðˈdrɔːn/; [adj]孤独的,孤僻的,内向的,离群的,沉默寡言的; [or]sat;
wither: [a]/ˈwɪðər/; [v]枯萎;凋谢; [vt]使枯萎,使凋谢,萎缩;使人感觉羞惭或迷惑; [or]sat;
withhold: [a]/wɪðˈhoʊld/; [v]抑制,拒绝给某事物; [or]sat;
withstand: [a]/wɪðˈstænd/; [v]忍受;抵挡; [or]sat;
woe: [a]/woʊ/; [n]悲哀;痛苦; [int]唉(表示痛苦,悲伤或悔恨);咳; [or]sat;
worldly: [a]/ˈwɜːrldli/; [adj]世间的,尘世的;世俗的; [adv]世故地; [or]sat;
wrath: [a]/ræθ/; [n]愤怒; [or]sat;
wrench: [a]/rentʃ/; [n]扳手;痛苦,难受;猛扭,猛拉; [v]猛拧;挣脱;使扭伤; [or]sat;
writhe: [a]/raɪð/; [v]扭动(身体);扭曲变形;缠绕打结; [n]扭动;翻腾;苦恼; [or]sat;
wry: [a]/raɪ/; [adj]歪斜的,扭歪的,歪曲的; [v]歪曲,扭曲;扭转; [or]sat;
xenophobia: [a]/ˌzenəˈfoʊbiə/; [n]仇外,对外国人的恐惧或憎恨; [or]sat;
yield: [a]/jiːld/; [v]出产;屈服;弯曲;让行; [n]收益; [or]sat;
yoke: [a]/joʊk/; [n]牛轭;枷锁;纽带; [v]结合;连结; [or]sat;
zeal: [a]/ziːl/; [n]热情,热心; [or]sat;
zealot: [a]/ˈzelət/; [n]狂热份子,犹太教狂热信徒; [or]sat;
zenith: [a]/ˈziːnɪθ/; [n]顶点,顶峰;全盛; [or]sat;
zephyr: [a]/ˈzefər/; [n]和风,西风; [or]sat;
