hassle: [acc]/ˈhæsl/; [vt]找麻烦,搅扰;与.争辩;使.烦恼; [n]困难,麻烦;激战; [vi]争论,争辩; [or]bec2;
conceive: [acc]/kənˈsiːv/; [v]怀孕;设想,想出; [or]bec2;
procedure: [acc]/prəˈsiːdʒər/; [n]步骤,过程;程序;手续; [or]bec2;
username: [acc]/ˈjuːzərneɪm/; [n]用户名; [or]bec2;
original: [acc]/əˈrɪdʒənl/; [adj]有独创性的,原始的,最初的,新颖的; [n]原件;怪人; [or]bec2;
bottom: [acc]/ˈbɑːtəm/; [n]底部;尽头;末端;臀部;水底; [adj]底部的; [v]触底; [or]bec2;
impressive: [acc]/ɪmˈpresɪv/; [adj]给人深刻印象的;引人注目的; [or]bec2;
clutter: [acc]/ˈklʌtər/; [n]混乱,凌乱; [v]弄乱,搅乱; [or]bec2;
obligation: [acc]/ˌɑːblɪˈɡeɪʃn/; [n]义务,责任; [or]bec2;
interior: [acc]/ɪnˈtɪriər/; [adj]内部的; [n]内部,内心; [or]bec2;
uneconomical: [acc]/ˌʌnˌiːkəˈnɑːmɪkl/; [adj]不节俭的,浪费的; [or]bec2;
foresight: [acc]/ˈfɔːrsaɪt/; [n]先见,预见;远见,深谋远虑; [or]bec2;
delivery: [acc]/dɪˈlɪvəri/; [n]陈述,讲演;演讲的姿态;投递,交付,分娩; [or]bec2;
shareholder: [acc]/ˈʃerhoʊldər/; [n]股东,股票持有者; [or]bec2;
equity: [acc]/ˈekwəti/; [n]公平,公正;衡平法;普通股;抵押资产的净值; [or]bec2;
quota: [acc]/ˈkwoʊtə/; [n]配额;限额;定额; [or]bec2;
obscure: [acc]/əbˈskjʊr/; [v]隐藏,使.模糊;使变暗;遮掩; [adj]不清楚的;难以理解的; [n]某种模糊的或不清楚的东西; [or]bec2;
penalty: [acc]/ˈpenəlti/; [n]惩罚,处罚,不利,罚球; [adj]处罚的; [or]bec2;
photographic: [acc]/ˌfoʊtəˈɡræfɪk/; [adj]照相的; [or]bec2;
go along: [acc]/ɡoʊ əˈlɔːŋ/; [phr]赞同,支持,进行,前进; [or]bec2;
call center: [acc]/kɔl ˈsɛntɚ/; [phr]呼叫中心; [or]bec2;
coupon: [acc]/ˈkuːpɑːn/; [n](债券等)息券;赠券;配给券;折扣券; [or]bec2;
miss opportunity: [acc]/mɪs ˌɑːpərˈtuːnəti/; [phr]错失机会; [or]bec2;
franchisor: [acc]/fræntʃaɪ'zɔː(r)/; [n]授予特许者; [or]bec2;
franchisee: [acc]/ˌfræntʃaɪˈziː/; [n]加盟商,特许经营人,有代销权的人或团体; [or]bec2;
trait: [acc]/treɪt/; [n]特征; [or]bec2;
vacancy: [acc]/ˈveɪkənsi/; [n]空,空白,空房;(职位)空缺;空虚; [or]bec2;
offset: [acc]/ˈɔːfset/; [v]抵消; [adj]胶印的,透印版印刷的; [n]分支;抵销; [or]bec2;
likely: [acc]/ˈlaɪkli/; [adj]有可能;可信的;适合的; [adv]很可能; [or]bec2;
dense: [acc]/dens/; [adj](物质) 密度大的;稠密的,浓密的;愚钝的;难懂的,费解的; [or]bec2;
tweak: [acc]/twiːk/; [v]拧,扭,拉,微调; [n]拧,扭,捏,<俚>妙计; [or]bec2;
responsible: [acc]/rɪˈspɑːnsəbl/; [adj]有责任,负责的; [or]bec2;
contingency: [acc]/kənˈtɪndʒənsi/; [n]偶然性;[安全]意外事故;可能性;[审计]意外开支; [or]bec2;
plan a strategy: [acc]/plæn eɪ ˈstrætədʒi/; [phr]制定策略; [or]bec2;
modernisation: [acc]/ˌmɒdənə'zeɪʃən/; [n]现代化; [or]bec2;
vacate: [acc]/ˈveɪkeɪt/; [vi]空出,腾出; [vt]腾出;撤离,辞去; [or]bec2;
triumph: [acc]/ˈtraɪʌmf/; [n]喜悦,狂喜;凯旋,胜利; [v]成功,获胜; [or]bec2;
capacity: [acc]/kəˈpæsəti/; [n]产能;容量;本领;才能;负载量;职位; [or]bec2;
gateway: [acc]/ˈɡeɪtweɪ/; [n]门,通路; [or]bec2;
bulge: [acc]/bʌldʒ/; [n]凸出部分; [v]凸出,膨胀; [or]bec2;
doom: [acc]/duːm/; [v]注定;命定; [n]毁灭;厄运;劫数; [or]bec2;
treasurer: [acc]/ˈtreʒərər/; [n]财务主管; [or]bec2;
governor: [acc]/ˈɡʌvərnər/; [n]统治者;总督;主管负责人;限速器;州长; [or]bec2;
perceive: [acc]/pərˈsiːv/; [v]意识到,察觉,发觉;看待,理解; [or]bec2;
tempt: [acc]/tempt/; [v]诱惑;吸引;冒..的风险,不顾; [or]bec2;
tribunal: [acc]/traɪˈbjuːnl/; [n]法院;特别法庭;法官席;裁决; [or]bec2;
canteen: [acc]/kænˈtiːn/; [n]食堂,小卖部;水壶; [or]bec2;
accredited: [acc]/əˈkredɪtɪd/; [adj]被认可的,可接受的,委任的; [or]bec2;
unilateral: [acc]/ˌjuːnɪˈlætrəl/; [adj]单边的,单方面的;[植]单侧的;单边音;(父母)单系的; [or]bec2;
distinct: [acc]/dɪˈstɪŋkt/; [adj]截然不同的;独特的;明显的;清晰的; [or]bec2;
kiosk: [acc]/ˈkiːɑːsk/; [n]摊棚; [or]bec2;
increase: [acc]/ɪnˈkriːs/; [v]增加,提高; [n]增加,增强,提高; [or]bec2;
document: [acc]/ˈdɑːkjumənt/; [n]文件,公文;(计算机的)文档; [v]记录;证明; [or]bec2;
wonder: [acc]/ˈwʌndər/; [v]想知道;感到惊讶; [n]奇迹,奇观;惊奇,惊异; [or]bec2;
ease: [acc]/iːz/; [n]安逸;容易;不拘束; [v]解除痛苦;缓解;顺利进出; [or]bec2;
myth: [acc]/mɪθ/; [n]神话;虚构的信念(或观念,理论);杜撰出来的人(或事物); [or]bec2;
raw: [acc]/rɔː/; [adj]生的,未煮过的;未加工的;(因皮肤开裂)疼痛的; [or]bec2;
calculate: [acc]/ˈkælkjuleɪt/; [vt]计算;估计;计划; [vi]计算;估计; [or]bec2;
portal: [acc]/ˈpɔːrtl/; [n]大门,入口; [adj]差别的;特意的;[数]微分的;[机,物]差动的; [or]bec2;
lead: [acc]/liːd/; [v]带领;领导;导致; [n]带领;引导;铅; [or]bec2;
efficiency: [acc]/ɪˈfɪʃnsi/; [n]效率;功效;功率;性能; [or]bec2;
debit: [acc]/ˈdebɪt/; [vt]记入借方,登入借方; [n]借方; [or]bec2;
lend: [acc]/lend/; [v]把.借给,贷(款); [or]bec2;
rise: [acc]/raɪz/; [n]上升,上涨,增加; [v]上升,上涨,升起,起身,增长; [or]bec2;
interview: [acc]/ˈɪntərvjuː/; [n]面谈,面试,采访; [v]面试,采访; [or]bec2;
promissory: [acc]/'prɒməˌsoʊrɪ/; [adj][商]约定支付的,约好的; [or]bec2;
sufficient: [acc]/səˈfɪʃnt/; [adj]足够的;充分的; [or]bec2;
delay: [acc]/dɪˈleɪ/; [v]耽搁;延迟; [n]耽搁,延期,推迟; [or]bec2;
blacklist: [acc]/ˈblæklɪst/; [n]黑名单; [v]把.列入黑名单; [or]bec2;
distributor: [acc]/dɪˈstrɪbjətər/; [n]经销商,[电]分配器,分配者; [or]bec2;
skip: [acc]/skɪp/; [v]跳过;略过;遗漏; [n]跳跃;跳读;省略; [or]bec2;
optimistic: [acc]/ˌɑːptɪˈmɪstɪk/; [adj]乐观的,乐观主义的; [or]bec2;
welfare: [acc]/ˈwelfer/; [n]福利;幸福,健康; [or]bec2;
release: [acc]/rɪˈliːs/; [v]释放;解放;发行; [n]解除;免除;发表; [or]bec2;
audacious: [acc]/ɔːˈdeɪʃəs/; [adj]大胆的,鲁莽的,大胆创新的; [or]bec2;
broker: [acc]/ˈbroʊkər/; [n]经纪人,掮客; [v]作为经纪人进行谈判,以中间人等身份安排; [or]bec2;
file: [acc]/faɪl/; [n]文件夹,档案,文件; [vi]把文件归档,提交(申请等); [vt]把(文件等)归档; [or]bec2;
harm: [acc]/hɑːrm/; [n]伤害,损害; [v]伤害; [or]bec2;
frozen: [acc]/ˈfroʊzn/; [adj]冷冻的;冻僵的; [v]使.冻住; [or]bec2;
lose: [acc]/luːz/; [vt]失去;丧失;遗失;浪费;亏损; [vi](在竞争或比赛中)输掉; [or]bec2;
consensus: [acc]/kənˈsensəs/; [n]一致同意,合意; [or]bec2;
spiral: [acc]/ˈspaɪrəl/; [n]螺旋,螺线; [v]不断急剧地上升(或下降),螺旋形行进; [adj]螺旋的; [or]bec2;
consume: [acc]/kənˈsuːm/; [v]消耗,耗尽; [vt]吃光,喝光;毁灭; [or]bec2;
consumer: [acc]/kənˈsuːmər/; [n]消费者;用户;消耗者; [or]bec2;
sudden: [acc]/ˈsʌdn/; [adj]突然的,意外的; [or]bec2;
passionate: [acc]/ˈpæʃənət/; [adj]充满热情的; [or]bec2;
reply: [acc]/rɪˈplaɪ/; [v]答复,回答;回应; [n]回答,答复; [or]bec2;
acquire: [acc]/əˈkwaɪər/; [v](尤指靠自己的努力或行动或经过一个过程)获得;学到;取得; [or]bec2;
transaction: [acc]/trænˈzækʃn/; [n]交易;办理;事务;学报; [or]bec2;
alliance: [acc]/əˈlaɪəns/; [n]联盟,同盟;盟约;盟国,同盟者;类同; [or]bec2;
violate: [acc]/ˈvaɪəleɪt/; [v]违反,违背;侵犯,妨碍;亵渎; [or]bec2;
argument: [acc]/ˈɑːrɡjumənt/; [n]争吵,争论,辩论;论据,论点; [or]bec2;
abundant: [acc]/əˈbʌndənt/; [adj]丰富的;大量的; [or]bec2;
forum: [acc]/ˈfɔːrəm/; [n]论坛;讨论会; [or]bec2;
envisage: [acc]/ɪnˈvɪzɪdʒ/; [v]想象,设想; [or]bec2;
comparison: [acc]/kəmˈpærɪsn/; [n]比较;对照;比较等级;比喻; [or]bec2;
exuberance: [acc]/ɪɡˈzuːbərəns/; [n]充沛,茂盛,茂密; [or]bec2;
board: [acc]/bɔːrd/; [n]木板;董事会;甲板;膳食; [v]乘船,登机;用板铺;供膳食;寄宿; [or]bec2;
quarterly: [acc]/ˈkwɔːrtərli/; [adj]季度的,每季一次的; [n]季刊; [adv]按季度,季度地; [or]bec2;
panel: [acc]/ˈpænl/; [n]讨论小组;仪表板;面,板; [v]嵌镶; [or]bec2;
tilt: [acc]/tɪlt/; [v](使)倾斜; [n]倾斜,斜坡; [or]bec2;
confidence: [acc]/ˈkɑːnfɪdəns/; [n]自信,信心;信任;有把握; [or]bec2;
post: [acc]/poʊst/; [n]柱;邮政,邮寄;邮件;职位,岗位;哨所; [vt]贴出;公告;邮寄; [or]bec2;
evidence: [acc]/ˈevɪdəns/; [v]证明; [n]证据,证明;证物,证词; [or]bec2;
divest: [acc]/daɪˈvest/; [v]剥夺;使脱去;迫使放弃; [or]bec2;
menu: [acc]/ˈmenjuː/; [n]菜单,菜谱,菜; [or]bec2;
concise: [acc]/kənˈsaɪs/; [adj]简明的,简要的;简洁的,简要的; [or]bec2;
global: [acc]/ˈɡloʊbl/; [adj]全球的;全面的; [or]bec2;
substantial: [acc]/səbˈstænʃl/; [adj]大量的;本质的;实质的;牢固的; [n]本质;重要部份; [or]bec2;
spokesman: [acc]/ˈspoʊksmən/; [n]发言人; [or]bec2;
hostile: [acc]/ˈhɑːstl/; [adj]敌对的,敌方的;怀敌意的; [or]bec2;
withdraw: [acc]/wɪðˈdrɔː/; [v]取款;撤退,收回,撤离; [or]bec2;
comment: [acc]/ˈkɑːment/; [n]评论,议论;批评,意见;注解; [vt]评论; [vi]进行评论;为.作评语; [or]bec2;
casualty: [acc]/ˈkæʒuəlti/; [n]伤亡人员,死伤者,受害人;急诊室(英); [or]bec2;
perception: [acc]/pərˈsepʃn/; [n]洞察力,理解力;洞察力,理解力,认识,观念,看法; [or]bec2;
disclosure: [acc]/dɪsˈkloʊʒər/; [n][审计]披露;揭发;被揭发出来的事情; [or]bec2;
cutback: [acc]/ˈkʌtbæk/; [n]削减,减少; [or]bec2;
expand: [acc]/ɪkˈspænd/; [v]膨胀;扩大; [vt]详细展开; [or]bec2;
scarce: [acc]/skers/; [adj]缺乏的,不足的;稀少的,罕见的; [adv]仅仅,几乎不; [or]bec2;
company: [acc]/ˈkʌmpəni/; [n]公司;交往;陪伴; [v]陪伴; [or]bec2;
anonymous: [acc]/əˈnɑːnɪməs/; [adj]匿名的;无名的;不具名的;无特色的;无个性特征; [or]bec2;
exact: [acc]/ɪɡˈzækt/; [adj]确切的,精密严谨的; [v]强求; [or]bec2;
waste: [acc]/weɪst/; [n]浪费;废物; [v]浪费;消耗;未充分利用; [adj]无用的;废弃的; [or]bec2;
retain: [acc]/rɪˈteɪn/; [v]保持,保留,保存;聘请; [or]bec2;
paper: [acc]/ˈpeɪpər/; [n]纸;试卷,论文,报纸; [v]裱糊; [adj]纸制的,似纸的,有名无实的; [or]bec2;
auction: [acc]/ˈɔːkʃn/; [n]拍卖; [v]拍卖; [or]bec2;
leverage: [acc]/ˈlevərɪdʒ/; [n]杠杆作用;杠杆效率; [v]举债经营;借贷收购;利用; [or]bec2;
propagate: [acc]/ˈprɑːpəɡeɪt/; [v]繁殖,增殖; [vt]传播,宣传; [or]bec2;
implication: [acc]/ˌɪmplɪˈkeɪʃn/; [n]暗示;含意;牵连;卷入;可能的后果; [or]bec2;
enterprise: [acc]/ˈentərpraɪz/; [n]企业(或事业)单位,公司;事业;事业心; [or]bec2;
clear: [acc]/klɪr/; [adj]清澈的;显然的;容易看见的,清楚的,清晰的;没有的; [vi]变明朗;变清澈; [vt]扫净;清除;消除; [n]空隙;空间; [adv]清晰地;整整;完全; [or]bec2;
oppose: [acc]/əˈpoʊz/; [v]反对;反抗; [or]bec2;
take seriously: [acc]/tek ˈsɪriəsli/; [phr]认真对待.; [or]bec2;
stick: [acc]/stɪk/; [v]坚持;粘贴,刺,戳,扎; [n]棍,棒,手杖; [or]bec2;
awareness: [acc]/əˈwernəs/; [n]意识,明白,知道; [or]bec2;
predominant: [acc]/prɪˈdɑːmɪnənt/; [adj]占主导地位的;显著的; [or]bec2;
phrase: [acc]/freɪz/; [n]简短的警句;短语,习语;措辞,乐句; [v]措辞,将(乐曲)分成乐句; [or]bec2;
fiscal: [acc]/ˈfɪskl/; [adj]会计的;财政的;国库的; [or]bec2;
backlog: [acc]/ˈbæklɔːɡ/; [n]积压待办事项,存货,垫底大木头; [v]积压; [or]bec2;
integral: [acc]/ˈɪntɪɡrəl/; [adj](用于构成整体)必需的,不可缺少的,必不可少的;基本的,作为组成部分的,内置的;整体的,完整的; [or]bec2;
abbreviation: [acc]/əˌbriːviˈeɪʃn/; [n]缩短;缩写词;省略号; [or]bec2;
deflate: [acc]/dɪˈfleɪt/; [v]放气;使缩小;紧缩通货;打击;使泄气;物价下降; [or]bec2;
run: [acc]/rʌn/; [v]跑步,奔跑;组织,掌管,管理,运营(公司等);运转,运作; [n]跑步,赛跑,跑的距离,跑的时间;(某产品一次性生产出的)数量;一连串,一系列; [or]bec2;
loophole: [acc]/ˈluːphoʊl/; [n]漏洞;枪眼;换气孔;射弹孔; [vt]钻空子;开孔; [or]bec2;
content: [acc]/ˈkɑːntent/; [n]内容,目录;满足; [adj]满足的; [v]使满意; [or]bec2;
defer: [acc]/dɪˈfɜːr/; [v]使推迟,使延期;听从,顺从; [vi]延期; [or]bec2;
swallow: [acc]/ˈswɑːloʊ/; [n]吞咽;燕子;一次吞咽的量; [vi]做吞咽动作,咽口水; [v]咽下,吞下; [vt]相信; [or]bec2;
label: [acc]/ˈleɪbl/; [n]标签;称号;唱片公司; [v]把..称为,贴标签于..; [or]bec2;
headquarters: [acc]/ˈhedkwɔːrtərz/; [n]司令部,指挥部;总部,总局; [or]bec2;
peer: [acc]/pɪr/; [n]同龄人,同等地位的人;贵族; [v]仔细看,费力地看; [or]bec2;
underinsured: [acc]/ˌʌndərɪnˈʃʊrd/; [adj]保险(额)不足的; [or]bec2;
catalogue: [acc]/ˈkætəlɔːɡ/; [n]目录; [vt]编入目录;编制目录; [vi]编制目录;在目录里列出价格; [or]bec2;
delinquent: [acc]/dɪˈlɪŋkwənt/; [n]少年罪犯,违犯者; [adj]不尽责的;怠工的;〈美〉拖欠(税款)的; [or]bec2;
finding: [acc]/ˈfaɪndɪŋ/; [n]发现,调查的结果; [or]bec2;
input: [acc]/ˈɪnpʊt/; [n]投入;[电学,计算机]输入; [vt]输入; [or]bec2;
subsequent: [acc]/ˈsʌbsɪkwənt/; [adj]随后的; [or]bec2;
remind: [acc]/rɪˈmaɪnd/; [v]提醒,使想起; [or]bec2;
mill: [acc]/mɪl/; [n]磨坊,碾磨机,制造厂; [v]碾,磨,(毫无目的地)乱转; [or]bec2;
dampen: [acc]/ˈdæmpən/; [v]变潮湿; [vi]沮丧; [vt]使潮湿;抑制,使扫兴; [or]bec2;
pact: [acc]/pækt/; [n]合同;协约; [or]bec2;
prohibitive: [acc]/prəˈhɪbətɪv/; [adj]禁止性的,阻止的;(费用,价格等)过高的;类同禁止的; [or]bec2;
positive: [acc]/ˈpɑːzətɪv/; [adj]积极的;肯定的,明确的;正面的;阳性的; [n]正面;肯定;优点;正数; [or]bec2;
advertise: [acc]/ˈædvərtaɪz/; [v]为..做广告;公告;公布; [or]bec2;
departure: [acc]/dɪˈpɑːrtʃər/; [n]离去,离开,起程;背离;离职;开端; [or]bec2;
communication: [acc]/kəˌmjuːnɪˈkeɪʃn/; [n]沟通方式;交流,通讯;信息; [or]bec2;
deposit: [acc]/dɪˈpɑːzɪt/; [v]存款,存放;沉淀; [n]存款,定金;沉积物,矿床; [or]bec2;
lease: [acc]/liːs/; [v]出租,租得; [n]租约,租契; [or]bec2;
powerpoint: [acc]/'pauəpɔint/; [n]微软公司生产的制作幻灯片和简报的软件; [or]bec2;
situate: [acc]/ˈsɪtʃueɪt/; [v]使位于; [or]bec2;
despite: [acc]/dɪˈspaɪt/; [prep]尽管,不顾; [n]侮辱;憎恨;怨恨;轻蔑的拒绝;不承认; [or]bec2;
subcontract: [acc]/ˌsʌbˈkɑːntrækt/; [n]转包合同,分包合同; [v]承作,转包; [or]bec2;
cash bonus: [acc]/kæʃ ˈboʊnəs/; [phr]现金分红; [or]bec2;
differential: [acc]/ˌdɪfəˈrenʃl/; [n]差别,差距; [adj]差别的;特定的;微分的; [or]bec2;
hoist: [acc]/hɔɪst/; [v]升起,吊起;向上推; [n]起重机;举起; [or]bec2;
wealth: [acc]/welθ/; [n]财富;财产;大量; [or]bec2;
discourage: [acc]/dɪsˈkɜːrɪdʒ/; [v]阻止;使泄气,使失去信心; [or]bec2;
scapegoat: [acc]/ˈskeɪpɡoʊt/; [n]替罪羊; [or]bec2;
joint: [acc]/dʒɔɪnt/; [n]骨关节,接合处,廉价酒馆; [adj]连接的,共同的,联合的; [v]结合,联合;为.装上接头,使.有接缝; [or]bec2;
whim: [acc]/wɪm/; [n]一时的兴致,心血来潮,奇想,幻想; [or]bec2;
outperform: [acc]/ˌaʊtpərˈfɔːrm/; [v]优于,超额完成,过度执行; [or]bec2;
representative: [acc]/ˌreprɪˈzentətɪv/; [n]代表;代理; [adj]典型的,有代表性的; [or]bec2;
disappear: [acc]/ˌdɪsəˈpɪr/; [v]消失,失踪;灭绝,消亡; [or]bec2;
revenue: [acc]/ˈrevənuː/; [n]收入;财政收入;国家的税收; [or]bec2;
perform: [acc]/pərˈfɔːrm/; [v]表演;执行;表现; [vi]运行;(驯兽)玩把戏; [or]bec2;
workfare: [acc]/ˈwɜːrkfer/; [n]工作福利制度; [or]bec2;
budget: [acc]/ˈbʌdʒɪt/; [n]预算; [v]预算,安排; [adj]廉价的; [or]bec2;
custom: [acc]/ˈkʌstəm/; [n]习惯;风俗; [adj]定制的; [or]bec2;
term: [acc]/tɜːrm/; [n]措辞;期限;学期,任期;(pl.)条款;(pl.)关系; [vt]把.称为,把.叫作; [or]bec2;
injury: [acc]/ˈɪndʒəri/; [n]损害,伤害;受伤; [or]bec2;
judgement: [acc]/ˈdʒʌdʒmənt/; [n]审判,判决,判断力,识别力,看法,意见; [or]bec2;
stainless: [acc]/ˌsteɪnləs/; [adj]不生锈的,不锈钢的; [or]bec2;
coverage: [acc]/ˈkʌvərɪdʒ/; [n]新闻报道;可达范围;覆盖范围; [or]bec2;
allowance: [acc]/əˈlaʊəns/; [v]定量供应(食物,饮料等物品);配给; [n]零用钱;津贴,补贴;限额;免税额;允许,容忍,让步;考虑; [or]bec2;
exhibit: [acc]/ɪɡˈzɪbɪt/; [n]展览会,陈列品; [v]展览,陈列; [or]bec2;
brand: [acc]/brænd/; [n]商标,品牌;烙印; [v]给..打上烙印;归为 (不好的事物); [or]bec2;
export: [acc]/ˈekspɔːrt/; [v]出口,输出; [n]输出,出口,输出品; [or]bec2;
voluntary: [acc]/ˈvɑːlənteri/; [adj]自愿的;无偿的;志愿的; [n]即兴曲; [or]bec2;
hard: [acc]/hɑːrd/; [adj]坚硬的,困难的,严厉的; [adv]努力地,艰难地,费力地;猛烈地,重重地; [or]bec2;
marketing: [acc]/ˈmɑːrkɪtɪŋ/; [n]市场营销; [vt]出售;为出售提供; [vi]卖;买; [or]bec2;
lift: [acc]/lɪft/; [v](使)升起,举起;偷窃;运送;解除,终止;抄袭,偷窃; [n]<英>电梯;举起;免费搭车;情绪激昂,精神振奋; [or]bec2;
provable: [acc]/ˈpruːvəbl/; [adj]可证明的,可查明的; [or]bec2;
creditworthy: [acc]/ˈkredɪtwɜːrði/; [adj]有信誉的; [or]bec2;
exposure: [acc]/ɪkˈspoʊʒər/; [n]暴露,受寒;揭露,揭发;亮相,报道;曝光,曝光时间; [or]bec2;
arise: [acc]/əˈraɪz/; [v]起床;出现;升起;由.引起,发生; [or]bec2;
partnership: [acc]/ˈpɑːrtnərʃɪp/; [n]合伙人身份,合股,合伙经营; [or]bec2;
validate: [acc]/ˈvælɪdeɪt/; [v]使.生效,使合法化;证明正确; [or]bec2;
account: [acc]/əˈkaʊnt/; [n]账户;原因,理由;叙述; [v]报账,做出说明(或解释),为.负责,受罚;认为,考虑; [or]bec2;
obedient: [acc]/oʊˈbiːdiənt/; [adj]服从的,顺从的;孝顺的; [or]bec2;
keep: [acc]/kiːp/; [v]保持,坚持,保留,继续,贮藏,经营,遵守,供给,照管; [n]保持,保养;城堡主楼;生活,生计;饲料;牧草; [or]bec2;
operation: [acc]/ˌɑːpəˈreɪʃn/; [n]运转;操作;手术; [or]bec2;
jurisdiction: [acc]/ˌdʒʊrɪsˈdɪkʃn/; [n]司法权,审判权;管辖权;权限,权力; [or]bec2;
solution: [acc]/səˈluːʃn/; [n]解决办法;解答;溶液;溶解; [or]bec2;
critical: [acc]/ˈkrɪtɪkl/; [adj]批评的;文艺评论的;爱挑剔的;危急的;关键的,重要的; [or]bec2;
candidate: [acc]/ˈkændɪdət/; [n](官职,获奖资格等的)候选人;投考人;申请求职者; [or]bec2;
emerge: [acc]/iˈmɜːrdʒ/; [v]冲出,冒出;浮现;出现; [or]bec2;
element: [acc]/ˈelɪmənt/; [n]元素;成分;要素;电炉,热水器等的电热元件,电热丝; [or]bec2;
landlord: [acc]/ˈlændlɔːrd/; [n]房东,地主,老板; [or]bec2;
import: [acc]/ɪmˈpɔːrt/; [v]进口;输入; [n]进口,进口货;含义,意义;重要性; [or]bec2;
response: [acc]/rɪˈspɑːns/; [n]回应;作答;响应,回答; [or]bec2;
stationery: [acc]/ˈsteɪʃəneri/; [n]文具;(有配套信封的)信纸; [or]bec2;
resolve: [acc]/rɪˈzɑːlv/; [n]决心; [v]解决,决定,表决; [or]bec2;
precaution: [acc]/prɪˈkɔːʃn/; [n]预防措施; [or]bec2;
domestic: [acc]/dəˈmestɪk/; [adj]国产的;国内的;家庭的;驯养的; [n]家仆;家庭纷争; [or]bec2;
imbue: [acc]/ɪmˈbjuː/; [v]使充满,灌输,使感染; [or]bec2;
net: [acc]/net/; [n]网,网状物; [adj]纯利的,净值的,净的; [v]用网捕;捕获;净赚;踢入球门; [or]bec2;
intimidate: [acc]/ɪnˈtɪmɪdeɪt/; [v]恫吓,威胁; [or]bec2;
gain: [acc]/ɡeɪn/; [v]获得;增加;从中受益;增值; [n]获得;增加(财富,重量);利益; [or]bec2;
haunt: [acc]/hɔːnt/; [v]常去,萦绕于..;(鬼,魂)常出没于;(思想)萦绕; [n]常去的地方; [or]bec2;
perk: [acc]/pɜːrk/; [v]昂首,意气洋洋,振作; [n]好处;福利; [adj]〈罕〉同"perky"; [or]bec2;
in time: [acc]/ɪn taɪm/; [adv]及时;总有一天; [or]bec2;
receiver: [acc]/rɪˈsiːvər/; [n]听筒;收受人,接待者,尤指收款员;接收器;收件人,收款人;〔破产企业或公司的〕管理人,接管人;买卖赃物者; [or]bec2;
profile: [acc]/ˈproʊfaɪl/; [n]侧面像;外形,轮廓; [v]描绘..的轮廓,扼要描述; [or]bec2;
plug: [acc]/plʌɡ/; [vi]堵塞;插入(插头); [vt]塞; [n]塞子;插头; [or]bec2;
attract: [acc]/əˈtrækt/; [v]吸引,引诱; [or]bec2;
secretary: [acc]/ˈsekrəteri/; [n]秘书;干事,文书;部长,大臣; [or]bec2;
premise: [acc]/ˈpremɪs/; [n]前提;房屋地基; [v]假定; [or]bec2;
pharmacy: [acc]/ˈfɑːrməsi/; [n]药房,药剂学,配药业,制药业,一批备用药品; [or]bec2;
reliable: [acc]/rɪˈlaɪəbl/; [adj]可靠的;可信赖的;确实的; [or]bec2;
swathe: [acc]/sweɪð/; [n]带子,绷带;包装品; [vt]包围;紧绑;裹; [or]bec2;
preoccupy: [acc]/priˈɑːkjupaɪ/; [v]使专注于,先占,迷住; [or]bec2;
deadline: [acc]/ˈdedlaɪn/; [n]截止期限,最后期限; [vt]通过设定一时间期限来统治; [or]bec2;
powerhouse: [acc]/ˈpaʊərhaʊs/; [n]强大的集团,动力室,发电站,精力充沛的人; [or]bec2;
separate: [acc]/ˈsepəreɪt/; [adj]独立的;分开的;单独的; [v]使分开,分离,分割,划分; [or]bec2;
bout: [acc]/baʊt/; [n]一回合,较量,一阵; [or]bec2;
refresh: [acc]/rɪˈfreʃ/; [v](使)恢复精神,提神;刷新; [or]bec2;
peak: [acc]/piːk/; [n]顶峰;山顶;尖端; [v]达到最高点; [adj]最高度的;高峰时期的;巅峰状态的; [or]bec2;
deadlock: [acc]/ˈdedlɑːk/; [vt](使)相持不下; [vi]僵持; [n]僵局;不分胜负; [or]bec2;
make redundant: [acc]/meɪk rɪˈdʌndənt/; [phr]裁员; [or]bec2;
thrive: [acc]/θraɪv/; [v]茁壮成长;繁荣,兴旺; [or]bec2;
take part in: [acc]/tek pɑrt ɪn/; [phr]参加; [or]bec2;
solicitor: [acc]/səˈlɪsɪtər/; [n](英)初级律师; [or]bec2;
promotion: [acc]/prəˈmoʊʃn/; [n]晋升;提升;促销;促进; [or]bec2;
view: [acc]/vjuː/; [n]风景;视野;见解; [v]观看,看,望;查看,察看,视察,检查;看待,将..看成是,把..视为,认为; [or]bec2;
redundancy: [acc]/rɪˈdʌndənsi/; [n]裁员,[计][数]冗余(等于redundance),人浮于事; [or]bec2;
depreciation: [acc]/dɪˌpriːʃiˈeɪʃn/; [n](货币的)贬值;减价;折旧;蔑视; [or]bec2;
liaison: [acc]/ˈliːəzɑːn/; [n]联系,暧昧关系; [or]bec2;
manufacture: [acc]/ˌmænjuˈfæktʃər/; [v]生产;制造; [n]制造,生产;制造业;(复)产品; [or]bec2;
random: [acc]/ˈrændəm/; [adj]随机的;任意的;胡乱的; [or]bec2;
apply: [acc]/əˈplaɪ/; [v]涂,敷;应用;申请; [or]bec2;
dull: [acc]/dʌl/; [adj]愚笨的,迟钝的;枯燥的,沉闷的;不清晰的,吵闹的; [v]缓和;减轻;使阴暗; [or]bec2;
onset: [acc]/ˈɑːnset/; [n]开始;攻击,袭击; [or]bec2;
shave: [acc]/ʃeɪv/; [v]剃,刮; [n]剃须,修面,剃刀; [or]bec2;
economy: [acc]/ɪˈkɑːnəmi/; [n]经济,经济制度;节约; [or]bec2;
circular: [acc]/ˈsɜːrkjələr/; [adj]圆形的;环形的; [n]通知; [or]bec2;
hierarchy: [acc]/ˈhaɪərɑːrki/; [n]阶层,等级制度; [or]bec2;
outlay: [acc]/ˈaʊtleɪ/; [v]花费; [n][会计]费用;支出;经费; [or]bec2;
billboard: [acc]/ˈbɪlbɔːrd/; [n]告示牌,广告牌; [vt]宣传; [or]bec2;
ramp: [acc]/ræmp/; [n]斜坡,坡道;倾斜装置; [v]蔓延; [or]bec2;
delighted: [acc]/dɪˈlaɪtɪd/; [adj]欣喜的,快乐的; [or]bec2;
outdated: [acc]/ˌaʊtˈdeɪtɪd/; [adj]过时的,老式的;落伍的; [or]bec2;
word of mouth: [acc]/wɚd ʌv maʊθ/; [phr]口头语,口碑; [or]bec2;
reference: [acc]/ˈrefrəns/; [n]参考书;提及;推荐人;参考;证明;推荐信; [v]附.以供参考;引用; [or]bec2;
sympathy: [acc]/ˈsɪmpəθi/; [n]同情;同感; [or]bec2;
navigation: [acc]/ˌnævɪˈɡeɪʃn/; [n]导航,航行,航海; [or]bec2;
product: [acc]/ˈprɑːdʌkt/; [n]产品,产物;(乘)积; [or]bec2;
track: [acc]/træk/; [v]跟踪追赶;用纤拉船; [n]跑道;小路;行动路线;足迹;轨道; [or]bec2;
bearer: [acc]/ˈberər/; [n]承担人,搬运工,持票者,带信人,脚夫,能开花结果的植物,柩夫; [or]bec2;
rationalize: [acc]/ˈræʃnəlaɪz/; [vt]合理地说明,使合理化,[数]给.消根; [or]bec2;
entertain: [acc]/ˌentərˈteɪn/; [v]招待,款待;使娱乐;使欢乐;考虑,准备考虑;心存; [or]bec2;
participate: [acc]/pɑːrˈtɪsɪpeɪt/; [v]参与,加入; [or]bec2;
demonstrate: [acc]/ˈdemənstreɪt/; [vt](用实例,实验)论证;演示,展示;示范; [vi]示威; [or]bec2;
abstract: [acc]/ˈæbstrækt/; [adj]抽象的; [n]摘要,抽象; [v]提取; [or]bec2;
determine: [acc]/dɪˈtɜːrmɪn/; [v]确定,决定; [or]bec2;
branch out: [acc]/bræntʃ aʊt/; [phr]拓展业务,扩展范围; [or]bec2;
overheads: [acc]/ˈoʊvərhedz/; [n]企业运营的一般费用(如房租,电费等); [or]bec2;
adequate: [acc]/ˈædɪkwət/; [adj]充足的,充分的,足够的;尚可的,过得去的; [or]bec2;
working: [acc]/ˈwɜːrkɪŋ/; [adj]工作的;操作的;可行的; [n]工作;活动;制作;操纵; [v]工作;影响;受雇用; [or]bec2;
converge: [acc]/kənˈvɜːrdʒ/; [v](向某一点)相交,会合;汇集,聚集,集中; [or]bec2;
statutory: [acc]/ˈstætʃətɔːri/; [adj]法定的;法令的;可依法惩处的; [or]bec2;
ultimate: [acc]/ˈʌltɪmət/; [adj]根本的;最后的,最终的; [or]bec2;
reciprocal: [acc]/rɪˈsɪprəkl/; [adj]相互的,互惠的; [n]倒数;互相关联的事物; [or]bec2;
disparity: [acc]/dɪˈspærəti/; [n]不同,不一致,不等; [or]bec2;
expertise: [acc]/ˌekspɜːrˈtiːz/; [n]专门知识,专门技能; [or]bec2;
absence: [acc]/ˈæbsəns/; [n]缺席;缺勤;缺乏;缺席,心不在焉; [or]bec2;
airmail: [acc]/ˈermeɪl/; [n]航空邮件; [vt]航空邮寄;<谑>投;掷;抛; [adj]航空邮件的;航空邮递(用)的; [adv]通过航空邮寄; [or]bec2;
geographical: [acc]/ˌdʒiːəˈɡræfɪkl/; [adj]地理的,地理学的; [or]bec2;
take with a pinch of salt: [acc]/teɪk wɪð eɪ pɪntʃ əv sɔːlt/; [phr]部分相信(将信将疑); [or]bec2;
staff: [acc]/stæf/; [n]全体职员,员工;参谋;拐杖;五线谱; [adj]行政工作的;参谋的;职员的;作为正式工作人员的; [v]雇用工作人员;给.配备员工; [or]bec2;
predict: [acc]/prɪˈdɪkt/; [v]预言,预告,预测; [or]bec2;
synergy: [acc]/ˈsɪnərdʒi/; [n]协同作用,增效作用; [or]bec2;
consequence: [acc]/ˈkɑːnsɪkwens/; [n]结果,后果;重要性; [or]bec2;
indent: [acc]/ɪnˈdent/; [v]切割成锯齿状;(书写)缩排,印刷;定货;印凹痕; [n]缩进;契约;订货单;凹痕; [or]bec2;
complement: [acc]/ˈkɑːmplɪment/; [v]补充;与.相配; [n]补充;互为补充的东西;补语; [or]bec2;
recycle: [acc]/ˌriːˈsaɪkl/; [v]回收利用;改建; [n]再循环; [or]bec2;
lounge: [acc]/laʊndʒ/; [n]候机室,休息室,酒吧间;沙发,躺椅;懒散的步子; [v](懒散地)倚,躺;闲逛; [or]bec2;
apprehension: [acc]/ˌæprɪˈhenʃn/; [n]忧虑,担心,疑惧;逮捕;理解; [or]bec2;
remark: [acc]/rɪˈmɑːrk/; [n]评论;谈论;话语,话;备注; [v]议论;评论; [or]bec2;
audit: [acc]/ˈɔːdɪt/; [v]审计,查账;旁听; [n]审计;查帐; [or]bec2;
punctual: [acc]/ˈpʌŋktʃuəl/; [adj]准时的,守时的; [or]bec2;
council: [acc]/ˈkaʊnsl/; [n]议会;理事会;委员会; [or]bec2;
thorough: [acc]/ˈθɜːroʊ/; [adj]彻底的,完全的;详尽的,细致深入的; [or]bec2;
enter: [acc]/ˈentər/; [v]走进,参加,加入; [n]输入,[计]回车; [or]bec2;
sample: [acc]/ˈsæmpl/; [n]样品,样本;(用于检验,分析的) 试样; [adj]样品的,作为例子的; [vi]抽样检查; [vt]抽取.的试样; [v]品尝;体验,尝试; [or]bec2;
outspoken: [acc]/aʊtˈspoʊkən/; [adj]直言的,坦率的; [or]bec2;
exude: [acc]/ɪɡˈzuːd/; [v]慢慢流出,四溢,渗出,散发; [or]bec2;
practise: [acc]/ˈpræktɪs/; [vt]实践;练习;从事;实行;遵循; [or]bec2;
acceptance: [acc]/əkˈseptəns/; [n]接纳,赞同,容忍; [or]bec2;
appointee: [acc]/əˌpɔɪnˈtiː/; [n]被指定人,被任命人; [or]bec2;
seasonal: [acc]/ˈsiːzənl/; [adj]季节性的; [or]bec2;
launder: [acc]/ˈlɔːndər/; [v]洗黑钱(把来路可疑的钱弄得貌似合法); [or]bec2;
coup: [acc]/kuː/; [n]政变;出乎意料的行动或胜利; [or]bec2;
description: [acc]/dɪˈskrɪpʃn/; [n]描写,形容,叙述;种类,类型; [or]bec2;
vague: [acc]/veɪɡ/; [adj]含糊的,模糊的,不明确的,茫然的; [n]模糊不定状态; [or]bec2;
propose: [acc]/prəˈpoʊz/; [v]提议;求婚; [or]bec2;
community: [acc]/kəˈmjuːnəti/; [n]社区;团体;(生)群落;人群,很多个体的集合体; [or]bec2;
training: [acc]/ˈtreɪnɪŋ/; [n]训练,培养;培训; [or]bec2;
compensate: [acc]/ˈkɑːmpenseɪt/; [v]补偿,赔偿,给..报酬; [or]bec2;
independent: [acc]/ˌɪndɪˈpendənt/; [adj]独立自主的,独自的,无偏见的; [n]无党派者,独立派人士; [or]bec2;
tie: [acc]/taɪ/; [n]领带;关系;束缚; [v]系;打结;打成平局;绑,捆;打,打结; [or]bec2;
autopay: [acc]/'ɔːtəʊpeɪ/; [n]自动转帐; [or]bec2;
apology: [acc]/əˈpɑːlədʒi/; [n]道歉,(表达)歉意; [or]bec2;
email: [acc]/ˈiːmeɪl/; [n]电子信函; [or]bec2;
colleague: [acc]/ˈkɑːliːɡ/; [n]同事;同行; [or]bec2;
anticipated: [acc]/ænˈtɪsɪpeɪtɪd/; [v]预料,盼望; [adj]预期的,期望的; [or]bec2;
manoeuvre: [acc]/məˈnuːvər/; [n]谨慎或熟练的动作;花招,巧计;(军队)调遣,演习; [or]bec2;
summit: [acc]/ˈsʌmɪt/; [n]山顶,顶点;(政府间的)峰会; [or]bec2;
key factor: [acc]/ki ˈfæktɚ/; [phr]关键因素; [or]bec2;
reinvent: [acc]/ˌriːɪnˈvent/; [v]改造,再发明,重新使用; [or]bec2;
dues: [acc]/duːs/; [n]会费;手续费;税捐; [or]bec2;
eventual: [acc]/ɪˈventʃuəl/; [adj]最后的,终于的; [or]bec2;
arrival: [acc]/əˈraɪvl/; [n]到来,到达;到达者; [or]bec2;
perspective: [acc]/pərˈspektɪv/; [n]角度,视角,观点,想法;(对事物的)合理判断,正确认识;远景;透视图,透视法,透视效果; [adj]透视的; [or]bec2;
condition: [acc]/kənˈdɪʃn/; [n]状况,状态;疾病,症状;环境,形势,条件; [v]使适应,使处于良好状态; [or]bec2;
container: [acc]/kənˈteɪnər/; [n]容器;集装箱; [or]bec2;
scramble: [acc]/ˈskræmbl/; [v]争夺,攀登; [or]bec2;
estimate: [acc]/ˈestɪmət/; [v]估价,估计,评价; [n]估计,评价; [or]bec2;
corporation: [acc]/ˌkɔːrpəˈreɪʃn/; [n]企业,公司;法人(团体); [or]bec2;
assess: [acc]/əˈses/; [v]评估;估值; [or]bec2;
reputation: [acc]/ˌrepjuˈteɪʃn/; [n]名声;声誉; [or]bec2;
explore: [acc]/ɪkˈsplɔːr/; [v]探险,探索,尝试; [or]bec2;
goods: [acc]/ɡʊdz/; [n]货物,商品; [or]bec2;
boycott: [acc]/ˈbɔɪkɑːt/; [vt]抵制; [n]抵制; [or]bec2;
resent: [acc]/rɪˈzent/; [v]愤恨; [or]bec2;
area: [acc]/ˈeriə/; [n]范围,面积,区域,空地; [or]bec2;
rally: [acc]/ˈræli/; [n]集会;公路汽车赛; [v]集合;恢复(健康等),重新振作; [or]bec2;
duration: [acc]/duˈreɪʃn/; [n]持续;持续期间;持续的时间; [or]bec2;
relevant: [acc]/ˈreləvənt/; [adj]有关的;恰当的;贴切的; [or]bec2;
appropriate: [acc]/əˈproʊpriət/; [adj]合适的;适当的; [v]挪用;拨款;私占; [or]bec2;
click on: [acc]/klɪk ɑn/; [phr]点击,打开,启动; [or]bec2;
lure: [acc]/lʊr/; [v]引诱;以诱饵吸引; [n]诱惑力;诱惑物;鱼饵; [or]bec2;
feedback: [acc]/ˈfiːdbæk/; [n]反馈,反馈意见; [or]bec2;
offend: [acc]/əˈfend/; [v]冒犯,得罪,伤害.的感情; [or]bec2;
sociable: [acc]/ˈsoʊʃəbl/; [adj]好交际的; [or]bec2;
offer: [acc]/ˈɔːfər/; [n]提供;特价;出价;录取(用)通知书;提议; [vt]给予,奉上;表示愿意 (做某事);提供;出价; [or]bec2;
speculate: [acc]/ˈspekjuleɪt/; [vi]推测,猜测;投机,做投机买卖; [vt]推测; [or]bec2;
insistence: [acc]/ɪnˈsɪstəns/; [n]坚持,强调,坚决要求; [or]bec2;
reception: [acc]/rɪˈsepʃn/; [n]前台,接待处,接收,欢迎,招待会; [or]bec2;
job-sharing: [acc]/ˈdʒɑːb ʃerɪŋ/; [n]轮班制; [or]bec2;
sleek: [acc]/sliːk/; [adj](毛发等)柔滑的;性格油滑的,嘴甜的,圆滑的; [v]使光滑,使有光泽;(口语)滑动(口语)打扮整洁; [or]bec2;
recover: [acc]/rɪˈkʌvər/; [v]恢复;痊愈,恢复健康;收回;换回;重新获得;重新找到; [or]bec2;
grievance: [acc]/ˈɡriːvəns/; [n]牢骚,委屈,抱怨; [or]bec2;
leasehold: [acc]/ˈliːshoʊld/; [adj]租赁的; [n]租赁;租约;租赁期;租赁权; [or]bec2;
currency: [acc]/ˈkɜːrənsi/; [n]货币;流通;流行; [or]bec2;
responsibility: [acc]/rɪˌspɑːnsəˈbɪləti/; [n]责任,负担; [or]bec2;
painkiller: [acc]/ˈpeɪnkɪlər/; [n]止痛药; [or]bec2;
federal: [acc]/ˈfedərəl/; [adj]联邦制的;联邦政府的; [or]bec2;
periodical: [acc]/ˌpɪriˈɑːdɪkl/; [n]期刊;杂志; [or]bec2;
drain: [acc]/dreɪn/; [vi]排出,排水; [v]流干,沥干;喝光,耗尽,减少,消逝; [vt]使流出,排掉水; [n]下水道,排水管;消耗,排水; [or]bec2;
bust: [acc]/bʌst/; [n]半身塑像;胸部; [v]打碎;搜捕;降级;终止; [adj]破产的;打碎的; [or]bec2;
grapple: [acc]/ˈɡræpl/; [v]抓住;格斗; [n]抓住;格斗; [or]bec2;
dependable: [acc]/dɪˈpendəbl/; [adj]可靠的;可信赖的; [or]bec2;
measure: [acc]/ˈmeʒər/; [v]测量;估量; [n]措施;方法;尺寸;量度标准; [or]bec2;
crucial: [acc]/ˈkruːʃl/; [adj]关键的;决定性的; [or]bec2;
annual: [acc]/ˈænjuəl/; [adj]一年一次的,年度的; [n]年鉴,一年生植物,一年一度的事件; [or]bec2;
negative: [acc]/ˈneɡətɪv/; [adj]消极的,负面的;否定的; [n]否定,否定词;底片; [or]bec2;
absorb: [acc]/əbˈzɔːrb/; [vt]吸收;汲取;吸引..的注意;理解,掌握;承受; [or]bec2;
check: [acc]/tʃek/; [v]检查;阻止; [n]支票;阻止;检查;阻止物; [or]bec2;
regulator: [acc]/ˈreɡjuleɪtər/; [n]监管机构,调整者,调整器; [or]bec2;
diplomatic: [acc]/ˌdɪpləˈmætɪk/; [adj]外交的,从事外交的;老练的,圆滑的; [or]bec2;
monopoly: [acc]/məˈnɑːpəli/; [n]垄断;专卖;垄断商品;专卖商品; [or]bec2;
terminal: [acc]/ˈtɜːrmɪnl/; [n]终点,终端;航站楼;终点站; [adj]末端的;晚期的; [or]bec2;
accumulate: [acc]/əˈkjuːmjəleɪt/; [vi]聚积,堆积; [vt]积攒,积累; [or]bec2;
plant: [acc]/plænt/; [n]植物;工厂;设备;发电厂; [v]种植;安置; [or]bec2;
gush: [acc]/ɡʌʃ/; [v]涌出;滔滔不绝地说,洋洋洒洒地写; [n]迸发; [or]bec2;
market: [acc]/ˈmɑːrkɪt/; [n]市场;行情;销路; [v]销售;出售; [or]bec2;
stall: [acc]/stɔːl/; [n]分隔栏;售货摊;厩; [v]停止(因故障); [or]bec2;
obsession: [acc]/əbˈseʃn/; [n]着迷;着魔; [or]bec2;
personal: [acc]/ˈpɜːrsənl/; [adj]个人的,私人的; [n]个人;人身攻击;[法]动产;[语]人称代名词; [or]bec2;
downmarket: [acc]/ˌdaʊnˈmɑːrkɪt/; [adj]低档的,面向低收入的; [adv]面向低收入阶层; [or]bec2;
reserve: [acc]/rɪˈzɜːrv/; [n]储备;保留;保护区; [v]保留;预定;储备; [or]bec2;
rebrand: [acc]/ˌriːˈbrænd/; [v]给..一个新名称,采用新名称; [or]bec2;
statistics: [acc]/stəˈtɪstɪks/; [n]统计;统计数字,数据;统计学; [or]bec2;
relatively: [acc]/ˈrelətɪvli/; [adv]比较地,相对地; [or]bec2;
accelerate: [acc]/əkˈseləreɪt/; [v]加速,增长;使增速,促进; [or]bec2;
retention: [acc]/rɪˈtenʃn/; [n]保留,保持; [or]bec2;
vocation: [acc]/voʊˈkeɪʃn/; [n]职业;行业;天职;使命; [or]bec2;
repetitive: [acc]/rɪˈpetətɪv/; [adj]重复的,反复的; [or]bec2;
structure: [acc]/ˈstrʌktʃər/; [n]结构,构造;建筑物; [v]建筑,组织; [or]bec2;
overall: [acc]/ˌoʊvərˈɔːl/; [adj]全面的,全部的; [n]罩衫,工装裤; [adv]总的来说;总共; [or]bec2;
region: [acc]/ˈriːdʒən/; [n]地区,区域;范围;行政区;身体部位; [or]bec2;
influence: [acc]/ˈɪnfluəns/; [n]影响,势力;有影响的人或事; [v]影响; [or]bec2;
boost: [acc]/buːst/; [v]增加;偷盗; [n]提高;激励;后推;助推发动机; [or]bec2;
accommodation: [acc]/əˌkɑːməˈdeɪʃn/; [n]住宿,食宿;调解;住处; [or]bec2;
consumable: [acc]/kənˈsuːməbl/; [adj]可消费的,可消耗的; [n]消费品; [or]bec2;
vigorous: [acc]/ˈvɪɡərəs/; [adj]精力充沛的;强有力的,有活力的;强健的; [or]bec2;
online: [acc]/ˌɑːnˈlaɪn/; [adj](活动,服务)在线的,网上的,受电脑控制的,联机的; [adv]联机地,在运行,开始运行; [n]在线;联机; [or]bec2;
memo: [acc]/ˈmemoʊ/; [n]备忘录; [or]bec2;
transform: [acc]/trænsˈfɔːrm/; [v]将..变形,改变,转换; [or]bec2;
revise: [acc]/rɪˈvaɪz/; [v]修订;修改;温习(功课); [or]bec2;
meet objective: [acc]/miːt əbˈdʒektɪv/; [phr]满足目标; [or]bec2;
purpose: [acc]/ˈpɜːrpəs/; [n]目的,意图;用途,效果;决心; [v]企图;打算; [or]bec2;
workshop: [acc]/ˈwɜːrkʃɑːp/; [n]车间,工场,工作室;研讨会; [or]bec2;
parity: [acc]/ˈpærəti/; [n]相等;同等;平价; [or]bec2;
possible: [acc]/ˈpɑːsəbl/; [adj]可能的; [n]可能性,潜在性,可能的人物,可能有的事,最高分; [or]bec2;
abreast: [acc]/əˈbrest/; [adv]并肩地,并列; [adj]并排的;并肩的; [or]bec2;
terminology: [acc]/ˌtɜːrməˈnɑːlədʒi/; [n]术语,术语学; [or]bec2;
fragrance: [acc]/ˈfreɪɡrəns/; [n]香水;香味;芳香; [or]bec2;
audience: [acc]/ˈɔːdiəns/; [n](演讲,音乐会等的)听众,观众;正式会见;拥护者; [or]bec2;
prohibit: [acc]/prəˈhɪbɪt/; [v]禁止; [or]bec2;
compatible: [acc]/kəmˈpætəbl/; [adj]可和谐共存的;兼容的; [or]bec2;
isolate: [acc]/ˈaɪsəleɪt/; [v]使隔离;使孤立; [adj]孤立的;单独的; [or]bec2;
magical: [acc]/ˈmædʒɪkl/; [adj]不可思议的;有魔力的;魔术的,魔法的; [or]bec2;
indicate: [acc]/ˈɪndɪkeɪt/; [vt]指出,指示,标示;表明,表示,显示; [or]bec2;
convey: [acc]/kənˈveɪ/; [v]传送,运送;表达,传达; [or]bec2;
law: [acc]/lɔː/; [n]法律,法令,法则; [or]bec2;
move on: [acc]/mʊv ɑːn/; [phr]继续前进,更换工作(话题等),离开; [or]bec2;
retrain: [acc]/ˌriːˈtreɪn/; [v]重新培训; [or]bec2;
significantly: [acc]/sɪɡˈnɪfɪkəntli/; [adv]意味深长地,值得注目地; [or]bec2;
overtake: [acc]/ˌoʊvərˈteɪk/; [v]超过,赶上;突然降临; [or]bec2;
escape: [acc]/ɪˈskeɪp/; [v]逃跑,避开,避免;泄露; [n]逃跑,逃脱; [or]bec2;
standard: [acc]/ˈstændərd/; [n]标准,规格;规范; [adj]标准的; [or]bec2;
backdate: [acc]/ˌbækˈdeɪt/; [v]将日期追溯到过去某时,回溯; [or]bec2;
propel: [acc]/prəˈpel/; [v]推进,推动,激励; [or]bec2;
attach: [acc]/əˈtætʃ/; [v]系;贴;附上;附加;缚; [or]bec2;
transit: [acc]/ˈtrænzɪt/; [n]运输;运送; [v]运送;通过; [or]bec2;
dedicate: [acc]/ˈdedɪkeɪt/; [v]献给,致力于; [or]bec2;
defy: [acc]/dɪˈfaɪ/; [v]违抗,藐视;使不可能 (理解或解释);违背;赌.也不能; [n]挑战;对抗; [or]bec2;
red: [acc]/red/; [adj]红色的; [n]红色; [or]bec2;
load: [acc]/loʊd/; [v]使担负;装载;加载;填装; [vi]装货; [n]负载;负荷;工作量;装载量; [or]bec2;
subtract: [acc]/səbˈtrækt/; [v]减少;减去;扣除; [vt]减去; [or]bec2;
go down: [acc]/ɡoʊ daʊn/; [phr]下降;平静下来;被接受; [or]bec2;
headcount: [acc]/ˈhedkaʊnt/; [n]职员总数,点人头数; [or]bec2;
engage: [acc]/ɪnˈɡeɪdʒ/; [vt]吸引住(注意力,兴趣);雇,聘; [vi]使加入,使融入;订婚; [v](军队)交战;啮合; [or]bec2;
appreciate: [acc]/əˈpriːʃieɪt/; [v]赏识;为..表示感激;领会;使增值;增值; [or]bec2;
case: [acc]/keɪs/; [n]箱子,盒;案例,例子,情况; [v]装箱,踩点,仔细检查; [or]bec2;
premium: [acc]/ˈpriːmiəm/; [adj]高级的;高价的;(汽油)辛烷值高的; [n]额外费用,溢价;保险金; [or]bec2;
hire: [acc]/ˈhaɪər/; [v]雇用,出租; [n]租金,雇用,租用; [or]bec2;
underwrite: [acc]/ˌʌndərˈraɪt/; [v]给.保险,承诺支付;同意赔款(海上保险); [or]bec2;
telesale: [acc]/'telɪseɪl/; [n]电话销售,电话售货; [or]bec2;
proposal: [acc]/prəˈpoʊzl/; [n]建议;提议;求婚; [or]bec2;
cut: [acc]/kʌt/; [v]切,割,剪;减少; [n]伤口;划口;(锋利物留下的)开口;缩减; [or]bec2;
sales pitch: [acc]/ˈseɪlz pɪtʃ/; [phr]兜揽生意的话,推销词; [or]bec2;
oversupply: [acc]/'oʊvəsə'plaɪ/; [n]供给过多; [vt]过多供给; [or]bec2;
broke: [acc]/broʊk/; [adj]一文不名的,破产的; [vt]打破,弄破;(使)破,裂,碎;中断;违犯;背弃;把...换成零钱;找开; [vi]破晓;(风暴)开始; [or]bec2;
search engine: [acc]/ˈsɜːrtʃ endʒɪn/; [phr]搜索引擎; [or]bec2;
deputy: [acc]/ˈdepjuti/; [n]副手;代表;代表,代理人; [or]bec2;
bubble: [acc]/ˈbʌbl/; [v]起泡;兴奋,欢闹;充满生气,情绪高涨; [n]气泡,水泡;虚幻之事;靠不住的计划;泡影;幻想,妄想; [or]bec2;
membership: [acc]/ˈmembərʃɪp/; [n]会员资格;成员资格; [or]bec2;
committee: [acc]/kəˈmɪti/; [n]委员会;全体委员; [or]bec2;
duplicate: [acc]/ˈduːplɪkeɪt/; [n]复制品; [v]复制;重复; [adj]完全一样的; [or]bec2;
instance: [acc]/ˈɪnstəns/; [n]例子;提议; [vt]举.为例; [or]bec2;
laptop: [acc]/ˈlæptɑːp/; [n]笔记本电脑; [adj]膝上型的; [or]bec2;
amortize: [acc]/ˈæmərtaɪz/; [v]分期偿还,摊还; [or]bec2;
settle: [acc]/ˈsetl/; [v]安顿;定居;解决;调停;(目光)停留;结算,算清; [n]背长椅,座位;定居,安顿; [or]bec2;
visual: [acc]/ˈvɪʒuəl/; [adj]看的,视觉的; [n]视觉资料(指说明性的图片,影片等); [or]bec2;
degree: [acc]/dɪˈɡriː/; [n]程度,等级;学位;度;阶层; [or]bec2;
adventure: [acc]/ədˈventʃər/; [n]冒险,冒险活动;冒险精神; [or]bec2;
affiliate: [acc]/əˈfɪlieɪt/; [n]分公司,附属机构; [vt]使隶属于,接纳,追溯; [vi]发生联系; [adj]隶属的; [or]bec2;
canvass: [acc]/ˈkænvəs/; [v]仔细检查或详尽地讨论;审查,游说; [n]讨论;细查;劝诱; [or]bec2;
appraise: [acc]/əˈpreɪz/; [v]评价,鉴定;估价; [or]bec2;
close the sale: [acc]/kloʊz ðə seɪl/; [phr]完成销售,成交; [or]bec2;
team: [acc]/tiːm/; [n]队,组; [v]结成一队,使结成一队; [or]bec2;
preserve: [acc]/prɪˈzɜːrv/; [v]贮鲜,保鲜;保存;保护; [n]独揽之事,独占的活动; [or]bec2;
difficulty: [acc]/ˈdɪfɪkəlti/; [n]困难;难事,难点;经济拮据;障碍;麻烦; [or]bec2;
lifestyle: [acc]/ˈlaɪfstaɪl/; [n]生活方式; [adj]关于时尚生活的 (杂志,电视节目,产品等); [or]bec2;
behave: [acc]/bɪˈheɪv/; [v]举动;举止端正(或良好,适当); [or]bec2;
trolley: [acc]/ˈtrɑːli/; [n]电车;有轨电车;无轨电车;触轮;手推车; [vt]搭乘; [vi]搭乘; [or]bec2;
album: [acc]/ˈælbəm/; [n]相册;唱片集,专辑;集邮册; [or]bec2;
leaflet: [acc]/ˈliːflət/; [n]传单,散页的印刷品; [or]bec2;
forbearance: [acc]/fɔːrˈberəns/; [n]自制,忍耐;宽容; [or]bec2;
attend: [acc]/əˈtend/; [vi]护理;照顾; [vt]出席;参加; [v]上(学); [or]bec2;
individual: [acc]/ˌɪndɪˈvɪdʒuəl/; [adj]个别的,独特的;单独的; [n]独立的个体; [or]bec2;
sentiment: [acc]/ˈsentɪmənt/; [n]感情;情绪; [or]bec2;
groundbreaking: [acc]/ˈɡraʊndbreɪkɪŋ/; [adj]创新的; [n]动工; [or]bec2;
confer: [acc]/kənˈfɜːr/; [v]授予(奖项,学位,荣誉或权利);商讨,协商; [or]bec2;
delete: [acc]/dɪˈliːt/; [v]删除; [or]bec2;
liquid: [acc]/ˈlɪkwɪd/; [n]液体; [adj]液体的;清脆的; [or]bec2;
freight: [acc]/freɪt/; [n]货运;货物;运费; [v]运送; [or]bec2;
inflow: [acc]/ˈɪnfloʊ/; [n]流入,流入量; [or]bec2;
sightseeing: [acc]/ˈsaɪtsiːɪŋ/; [n]观光;游览; [adj]观光的,浏览的; [or]bec2;
buoyant: [acc]/ˈbɔɪənt/; [adj]有浮力的;愉快的;(股市)保持高价的; [or]bec2;
wander: [acc]/ˈwɑːndər/; [v]漫游;蜿蜒;迷路;离题; [n]游荡;闲逛;失散; [or]bec2;
bear: [acc]/ber/; [n]熊;(股市)看跌的人; [v]容忍,忍受;承担;带有;生育;开花结果,结(果实); [or]bec2;
notably: [acc]/ˈnoʊtəbli/; [adv]显著地;尤其; [or]bec2;
skill: [acc]/skɪl/; [n]技能;技巧,技艺;巧妙; [or]bec2;
excess: [acc]/ɪkˈses/; [adj]额外的,过量的,过度的,附加的; [n]超越,超过,过度; [or]bec2;
disinclined: [acc]/ˌdɪsɪnˈklaɪnd/; [adj]不愿的,不想的; [or]bec2;
policy: [acc]/ˈpɑːləsi/; [n]保险单;政策,方针;原则,策略; [or]bec2;
quote: [acc]/kwoʊt/; [v]报价;引用,援引; [n]引用; [or]bec2;
management: [acc]/ˈmænɪdʒmənt/; [n]经营,管理,处理;管理者; [or]bec2;
orient: [acc]/ˈɔːrient/; [n][the Orient]东方; [v]定..的方位; [adj]东方的;(太阳等)上升的,新生的;闪闪发光的; [or]bec2;
dominant: [acc]/ˈdɑːmɪnənt/; [adj]主要的,占优势的,支配的,统治的;显性基因的; [or]bec2;
embezzle: [acc]/ɪmˈbezl/; [v]盗用,挪用,贪污; [or]bec2;
director: [acc]/dəˈrektər/; [n]导演;指导者;主管;董事; [or]bec2;
section: [acc]/ˈsekʃn/; [n]部分;区域;章节;截面;阶层;部门;路段,地段; [v]划分;切开; [or]bec2;
hide: [acc]/haɪd/; [vt]躲藏,把.藏起来;隐瞒; [n]藏身处;隐密场所,隐蔽处;(尤指买卖或用作皮革的)皮;兽皮;人身安全; [or]bec2;
disaster: [acc]/dɪˈzæstər/; [n]灾难,天灾; [or]bec2;
benefit: [acc]/ˈbenɪfɪt/; [v]受益,有助于,使受益; [n]好处,益处;救济金; [or]bec2;
dear: [acc]/dɪr/; [adj]亲爱的;昂贵的; [n]亲爱的人;  excl. 啊; [or]bec2;
pitch: [acc]/pɪtʃ/; [v]投掷;用沥青覆盖;[音]为...定音高;扎营;搭帐篷; [n]投掷;球场;沥青;音高; [or]bec2;
fashionable: [acc]/ˈfæʃnəbl/; [adj]流行的,时髦的; [n]时髦的人; [or]bec2;
breakthrough: [acc]/ˈbreɪkθruː/; [n]突破,突破性进展,重要的新发现; [adj]突破性的; [or]bec2;
mortgage: [acc]/ˈmɔːrɡɪdʒ/; [n]按揭贷款,抵押贷款; [v]抵押; [or]bec2;
previous: [acc]/ˈpriːviəs/; [adj]以前的;早先的;过早的; [or]bec2;
maximize: [acc]/ˈmæksɪmaɪz/; [vt]取..最大值,最佳化; [vi]尽可能广义地解释;达到最大值; [or]bec2;
insurance: [acc]/ɪnˈʃʊrəns/; [n]保险;保险费;保险业;安全保证; [or]bec2;
approximate: [acc]/əˈprɑːksɪmət/; [adj]近似的,约略的; [v]接近,近似; [or]bec2;
smell: [acc]/smel/; [n]气味,臭味,嗅觉; [v]嗅,闻到; [or]bec2;
prospective: [acc]/prəˈspektɪv/; [adj]未来的;预期的; [n]预期; [or]bec2;
barrier: [acc]/ˈbæriər/; [n]障碍;屏障;隔阂;壁垒; [v]用栅栏围住; [or]bec2;
distribution centre: [acc]/ˌdɪstrəˈbjuʃən ˈsɛntɚ/; [phr]配送中心,分销中心; [or]bec2;
achieve: [acc]/əˈtʃiːv/; [v]完成,达到,获得,实现; [or]bec2;
digest: [acc]/daɪˈdʒest/; [v]消化;领会,理解; [n]摘要; [or]bec2;
prompt: [acc]/prɑːmpt/; [v]提示;激起;促进,推动;敦促; [adj]迅速的,及时的; [n]提示; [or]bec2;
obey: [acc]/oʊˈbeɪ/; [v]服从,听从,遵从;顺从,听从摆布; [or]bec2;
publicize: [acc]/ˈpʌblɪsaɪz/; [v]宣传;公布; [or]bec2;
disruptive: [acc]/dɪsˈrʌptɪv/; [adj]制造混乱的,破坏性的,分裂的; [or]bec2;
pay: [acc]/peɪ/; [v]支付,偿还;获利,受益; [n]工资,薪金; [or]bec2;
harmony: [acc]/ˈhɑːrməni/; [n]和谐;和声;和睦;协调; [or]bec2;
underestimate: [acc]/ˌʌndərˈestɪmeɪt/; [v]低估;对.估计不足; [or]bec2;
break: [acc]/breɪk/; [n]中断;破裂处;休息; [vt]打破,弄破;(使)破,裂,碎;中断;违犯;背弃;把...换成零钱;找开; [vi]破晓;(风暴)开始; [or]bec2;
virtual: [acc]/ˈvɜːrtʃuəl/; [adj](计算机)虚拟的;十分接近的;实质上的; [or]bec2;
honour: [acc]/ˈɑːnər/; [n]荣誉;光荣;面子;尊敬;敬意; [vt]尊敬;授予荣誉;兑现承诺; [or]bec2;
competitive: [acc]/kəmˈpetətɪv/; [adj]竞争的;好胜的;有竞争力的; [or]bec2;
venture: [acc]/ˈventʃər/; [n]企业;(商业)冒险;投机,风险投资; [vi]冒险前进; [vt]冒.的危险;以.做赌注; [or]bec2;
dismiss: [acc]/dɪsˈmɪs/; [v]开除;解散;摒除,不再考虑; [or]bec2;
dog: [acc]/dɔːɡ/; [n]狗,犬,犬科动物; [v](灾难等)缠住;跟踪;尾随; [or]bec2;
pursue: [acc]/pərˈsuː/; [v]进行,从事;追求,追赶; [or]bec2;
simulation: [acc]/ˌsɪmjuˈleɪʃn/; [n]模拟,仿真; [or]bec2;
slump: [acc]/slʌmp/; [v]突然倒下;暴跌; [n]下降;经济萧条时期; [or]bec2;
avoid interruption: [acc]/əˈvɔɪd ˌɪntəˈrʌpʃn/; [phr]避免中断; [or]bec2;
attempt: [acc]/əˈtempt/; [n]尝试;企图; [vt]努力去做;试图,尝试; [or]bec2;
inbox: [acc]/ˈɪnbɑːks/; [n]收件箱; [or]bec2;
hammer: [acc]/ˈhæmər/; [n]锤; [v]锤击; [or]bec2;
media: [acc]/ˈmiːdiə/; [n]媒体;传播媒介; [or]bec2;
commitment: [acc]/kəˈmɪtmənt/; [n]承诺;许诺;委任;承担的义务;献身;赞助;委托;犯罪;罪行;信奉; [or]bec2;
reject: [acc]/rɪˈdʒekt/; [v]拒绝;抵制; [n]废品;次品;不合格者;被剔除者; [or]bec2;
coordinate: [acc]/koʊˈɔːrdɪneɪt/; [v]使协调,使一致,调整; [n]坐标,同等的人物,配套服装; [adj]并列的;同等的; [or]bec2;
authoritative: [acc]/əˈθɔːrəteɪtɪv/; [adj]权威性的;可信的;命令式的,专断的; [or]bec2;
sense: [acc]/sens/; [n]感官,官能;感觉;判断力;见识; [v]觉得,意识到; [or]bec2;
source: [acc]/sɔːrs/; [n]源(泉),发源地,来源;原始资料,出处; [v]获得; [or]bec2;
liaise: [acc]/liˈeɪz/; [v]保持连络; [or]bec2;
incur: [acc]/ɪnˈkɜːr/; [v]遭受;招致;引起; [or]bec2;
varied: [acc]/ˈverid/; [adj]多变的,各种各样的; [or]bec2;
prospect: [acc]/ˈprɑːspekt/; [n]前景,展望;视野;景象; [v]勘察;有前途;勘探;对..进行仔细调查; [or]bec2;
litigate: [acc]/ˈlɪtɪɡeɪt/; [v]对簿法庭,在法庭相争,诉讼; [or]bec2;
qualified: [acc]/ˈkwɑːlɪfaɪd/; [adj]有资格的;保留的,有限度的; [vt]描述,形容;使合适;授权予;有权,达标; [vi]合格,成为合格;取得.的资格; [or]bec2;
campaign: [acc]/kæmˈpeɪn/; [n](社会性,政治性)活动,运动;战役; [v]从事活动,参加运动; [or]bec2;
beforehand: [acc]/bɪˈfɔːrhænd/; [adv]预先; [adj]提前的;预先准备好的; [or]bec2;
accountancy: [acc]/əˈkaʊntənsi/; [n]会计工作,会计学,会计职业; [or]bec2;
precisely: [acc]/prɪˈsaɪsli/; [adv]精确地,恰恰; [or]bec2;
scare: [acc]/sker/; [n]惊恐,恐慌; [vt]惊吓,使害怕; [v]受惊吓,感到害怕; [or]bec2;
advance: [acc]/ədˈvæns/; [n]预先,超前;前进;增长;进展; [v]提升;提前;提议;前进; [adj]预先的;先遣队;事先的;先头部队;预先; [or]bec2;
draw: [acc]/drɔː/; [v]画;拉;吸引; [n]平局; [or]bec2;
obsolete: [acc]/ˌɑːbsəˈliːt/; [adj]已过时的;已废弃的; [v]使过时;使作废; [n]废词;被废弃的事物; [or]bec2;
motto: [acc]/ˈmɑːtoʊ/; [n]座右铭;格言;箴言;口号; [or]bec2;
passive: [acc]/ˈpæsɪv/; [adj]被动的;消极的; [n]被动语态; [or]bec2;
odour: [acc]/ˈoʊdər/; [n]气味,臭气; [or]bec2;
display: [acc]/dɪˈspleɪ/; [v]展示;显示;陈列; [n]表现,流露,展示;显示,显示器;陈列品; [or]bec2;
appreciation: [acc]/əˌpriːʃiˈeɪʃn/; [n]感激;欣赏,鉴识,评价;增值;理解,了解; [or]bec2;
forward: [acc]/ˈfɔːrwərd/; [adv]向前,前进; [adj]向前的,前部的;进步的;冒失的; [v]转交,转递; [n]前锋; [or]bec2;
middleman: [acc]/ˈmɪdlmæn/; [n]中间人,经纪人,调解人; [or]bec2;
drawback: [acc]/ˈdrɔːbæk/; [n]缺点;障碍,不利条件; [or]bec2;
mount: [acc]/maʊnt/; [v]登上;爬上;骑上;增长;组织,安排; [n]山;峰; [or]bec2;
nominate: [acc]/ˈnɑːmɪneɪt/; [v]提名;任命; [adj]有特定名字的;被提名的;被指定的; [or]bec2;
deliberate: [acc]/dɪˈlɪbərət/; [adj]故意的;深思熟虑的;从容不迫的; [v]仔细考虑;研讨; [or]bec2;
menswear: [acc]/ˈmenzwer/; [n]男装; [or]bec2;
territory: [acc]/ˈterətɔːri/; [n]地区,领土;版图;领域;范围;属地; [or]bec2;
quit: [acc]/kwɪt/; [vt]辞职;停止;离开; [adj]被释放的;自由的;摆脱了.的;了清债务的; [or]bec2;
initial: [acc]/ɪˈnɪʃl/; [adj]第一的;最初的;开始的; [n]首字母; [or]bec2;
shortlist: [acc]/ˈʃɔːrtlɪst/; [n](英)供最后挑选用的候选人名单; [vt]把 ... 列入(供最后挑选的)候选人名单; [or]bec2;
satisfaction: [acc]/ˌsætɪsˈfækʃn/; [n]满足,满意;乐事;补偿; [or]bec2;
income: [acc]/ˈɪnkʌm/; [n]收入; [or]bec2;
stock: [acc]/stɑːk/; [n]股票;股份;存货;储备;家畜; [v]给..装满;储存; [adj]储备的; [or]bec2;
dictate: [acc]/ˈdɪkteɪt/; [v]规定;命令;口授;听写; [n]命令;指令; [or]bec2;
book: [acc]/bʊk/; [n]书,书籍; [v]预订;预约; [or]bec2;
refine: [acc]/rɪˈfaɪn/; [v]精炼,改进; [or]bec2;
irrelevant: [acc]/ɪˈreləvənt/; [adj]不相关的; [or]bec2;
slide: [acc]/slaɪd/; [n]滑行;下落;滑面;幻灯片; [v]使滑动;使滑入;滑动;滑倒;滑落;下跌; [or]bec2;
screen: [acc]/skriːn/; [n]屏幕,荧光屏;纱窗; [v]遮蔽;放映;检查; [or]bec2;
excellent: [acc]/ˈeksələnt/; [adj]优秀的;卓越的;极好的; [or]bec2;
verge: [acc]/vɜːrdʒ/; [n]边缘;边界; [v]接近;濒临; [or]bec2;
black: [acc]/blæk/; [adj]黑色的;黑暗的; [n]黑人,黑色; [v](使)变黑;把(眼睛)打得发青;拒绝; [or]bec2;
nullify: [acc]/ˈnʌlɪfaɪ/; [v]使无效,废弃,取消; [or]bec2;
conscious: [acc]/ˈkɑːnʃəs/; [adj]神志清醒的;自觉的;意识到的;有意的; [n]意识; [or]bec2;
output: [acc]/ˈaʊtpʊt/; [n]产量,输出; [vt]生产,出产,制造;输出; [vi]生产,出产,制造;输出; [or]bec2;
milestone: [acc]/ˈmaɪlstoʊn/; [n]里程碑,划时代的事件; [or]bec2;
batter: [acc]/ˈbætər/; [n](用鸡蛋,牛奶等调制的)面糊; [v]连续猛击; [or]bec2;
consignment: [acc]/kənˈsaɪnmənt/; [n]委托;运送;托付物; [or]bec2;
flow: [acc]/floʊ/; [v]流动;飘垂;涨潮;来自..的结果;流畅; [n]流动;流畅; [or]bec2;
suit: [acc]/suːt/; [n]服装;诉讼;套装; [v]合适;适宜于;使穿上套服; [or]bec2;
limited: [acc]/ˈlɪmɪtɪd/; [adj]有限的;被限制的; [or]bec2;
payment: [acc]/ˈpeɪmənt/; [n]付钱;报酬; [or]bec2;
strength: [acc]/streŋθ/; [n]体力,力气,力量;意志力;长处;兵力;实力;人手;浓度,效力;力度,速度; [or]bec2;
hardware: [acc]/ˈhɑːrdwer/; [n]五金器具,(总称)金属器材;硬件; [or]bec2;
valid: [acc]/ˈvælɪd/; [adj]有效的,正式认可的;合理的,有根据的; [or]bec2;
brand identity: [acc]/brænd aɪˈdentəti/; [phr]品牌特色,品牌识别,品牌标识; [or]bec2;
startling: [acc]/ˈstɑːrtlɪŋ/; [adj]令人吃惊的;颜色极鲜亮的; [or]bec2;
aftermath: [acc]/ˈæftərmæθ/; [n]不幸事件之后果,余波; [or]bec2;
catastrophe: [acc]/kəˈtæstrəfi/; [n]大灾难; [or]bec2;
invest: [acc]/ɪnˈvest/; [v]投资,投入;赋予,给予; [or]bec2;
base: [acc]/beɪs/; [n]地基,基础;底座;[化]碱; [adj]卑鄙的,无耻的; [vt]以..作基础; [or]bec2;
turnover: [acc]/ˈtɜːrnoʊvər/; [n]成交量;营业收入;人员更替率;半圆卷饼; [or]bec2;
block: [acc]/blɑːk/; [v]阻挡;妨碍;阻塞; [n]街区;块状物;积木;阻碍;大厦; [or]bec2;
grant: [acc]/ɡrænt/; [v]给予,许可,授予;承认; [n]许可;拨款,补助金; [or]bec2;
wage: [acc]/weɪdʒ/; [n]薪水,报酬; [v]开展,进行(战争,运动); [or]bec2;
passbook: [acc]/ˈpæsbʊk/; [n]存折; [or]bec2;
mature: [acc]/məˈtʃʊr/; [adj]成熟的;到期的; [vt]使成熟; [vi]成熟; [or]bec2;
merge: [acc]/mɜːrdʒ/; [v]合并;融合; [or]bec2;
establish: [acc]/ɪˈstæblɪʃ/; [v]建立;确立;使安全;使成为; [or]bec2;
agreement: [acc]/əˈɡriːmənt/; [n]协议,协定;一致,相合; [or]bec2;
resident: [acc]/ˈrezɪdənt/; [n]居民;住客;住院实习医师; [adj]居住的;住校的;固有的; [or]bec2;
talent: [acc]/ˈtælənt/; [n]天赋,才能;天才,人才; [or]bec2;
exit: [acc]/ˈeksɪt/; [n]出口;退场; [v]退出; [or]bec2;
cast: [acc]/kæst/; [v]投;抛下,投射(光线和阴影);瞥,飞快看(一眼),扫视;掷;放钓;投票;选定演员; [n]投掷物;铸件;演员表,演员阵容; [or]bec2;
actual: [acc]/ˈæktʃuəl/; [adj]实际的,真实的; [or]bec2;
beverage: [acc]/ˈbevərɪdʒ/; [n](水,酒等之外的)饮料; [or]bec2;
upmarket: [acc]/ˌʌpˈmɑːrkɪt/; [adj]质优价高的;高级的; [adv]在高档之列; [n]高档商品; [v]使进入高消费者市场; [or]bec2;
ceiling: [acc]/ˈsiːlɪŋ/; [n]天花板;屋顶; [or]bec2;
invoice: [acc]/ˈɪnvɔɪs/; [n]发票; [v]开发票;记清单; [or]bec2;
estate: [acc]/ɪˈsteɪt/; [n]地产,(上有大片建筑物的)土地,住宅,财产,遗产; [or]bec2;
intranet: [acc]/ˈɪntrənet/; [n]内部网络,专用网; [or]bec2;
patchwork: [acc]/ˈpætʃwɜːrk/; [n]拼凑的东西,混杂物; [or]bec2;
accommodator: [acc]/ə'kɒməˌdeɪtə/; [n]提供方便者,调解人,适应者; [or]bec2;
crash: [acc]/kræʃ/; [n]碰撞,坠落,轰隆声; [v]碰撞,坠落,崩溃; [adj]紧急的; [or]bec2;
discrimination: [acc]/dɪˌskrɪmɪˈneɪʃn/; [n]歧视,偏见; [or]bec2;
honestly: [acc]/ˈɑːnɪstli/; [adv]真诚地;公正地; [or]bec2;
superior: [acc]/suːˈpɪriər/; [n]上级,高手; [adj]较高级的,上层的,出众的; [or]bec2;
prudent: [acc]/ˈpruːdnt/; [adj]谨慎的,精明的; [or]bec2;
slowdown: [acc]/ˈsloʊdaʊn/; [n]减速,减退;怠工; [or]bec2;
holding company: [acc]/ˈhoʊldɪŋ kʌmpəni/; [phr]控股公司; [or]bec2;
stimulus: [acc]/ˈstɪmjələs/; [n]刺激物;鼓励;促进因素; [or]bec2;
aptitude: [acc]/ˈæptɪtuːd/; [n]天资;自然倾向;适宜; [or]bec2;
liable: [acc]/ˈlaɪəbl/; [adj](for)有责任的;有义务的;(to)有.倾向的;易于.的,有可能.; [or]bec2;
quarter: [acc]/ˈkwɔːrtər/; [v]驻扎,扎营;把..四等分; [n]四分之一;季度;一刻钟; [or]bec2;
course: [acc]/kɔːrs/; [n]发展;进程,课程,一道菜; [v]跑过,穿过;追赶; [or]bec2;
integrate: [acc]/ˈɪntɪɡreɪt/; [v](into,with)(使)成为一体,(使)结合,(使)合并; [adj]完整的,组合的; [or]bec2;
tangible: [acc]/ˈtændʒəbl/; [adj]摸得着的; [n]有形资产;可触知的或具体的某事物; [or]bec2;
pointless: [acc]/ˈpɔɪntləs/; [adj]无意义的,不得要领的; [or]bec2;
performance: [acc]/pərˈfɔːrməns/; [n]表演,演出;表现;执行;性能; [or]bec2;
judge: [acc]/dʒʌdʒ/; [v]判决,审判,评价; [n]裁判员;法官;鉴赏者; [or]bec2;
reallocate: [acc]/ˌriːˈæləkeɪt/; [vt]再分配,再指派; [or]bec2;
piece: [acc]/piːs/; [n]块;件;篇; [v]修补;接合;凑合; [or]bec2;
legal: [acc]/ˈliːɡl/; [adj]合法的,法定的;法律的; [or]bec2;
computer: [acc]/kəmˈpjuːtər/; [n]计算机,电脑;计算者; [or]bec2;
sender: [acc]/ˈsendər/; [n]寄件人,发报机,送话器; [or]bec2;
outbreak: [acc]/ˈaʊtbreɪk/; [n](战争,叛乱,感情等的)爆发;突然发生; [vi]爆发; [or]bec2;
defence: [acc]/dɪˈfens/; [n]防御,防务,辩护; [or]bec2;
recall: [acc]/rɪˈkɔːl/; [v]回想起,记起,回忆;召回; [n]召回(有问题的产品); [or]bec2;
abnormal: [acc]/æbˈnɔːrml/; [adj]反常的;畸形的; [or]bec2;
freehold: [acc]/ˈfriːhoʊld/; [n][律]永久业权; [or]bec2;
approval: [acc]/əˈpruːvl/; [n]批准;赞同;试销; [or]bec2;
adman: [acc]/ˈædmæn/; [n]广告人; [or]bec2;
depreciate: [acc]/dɪˈpriːʃieɪt/; [v]贬低,轻视;贬值;折旧; [or]bec2;
unyielding: [acc]/ʌnˈjiːldɪŋ/; [adj]不屈的,坚强的; [or]bec2;
advisor: [acc]/ədˈvaɪzər/; [n]顾问;劝告者;指导教师; [or]bec2;
objective: [acc]/əbˈdʒektɪv/; [n]目标;目的; [adj]客观的; [or]bec2;
invincible: [acc]/ɪnˈvɪnsəbl/; [adj]无敌的;不能征服的; [or]bec2;
tap: [acc]/tæp/; [n]塞子;水龙头;轻敲; [v]轻叩,轻敲;监听,窃听 (电话);开发,发掘;利用; [or]bec2;
flawed: [acc]/flɔːd/; [adj]有瑕疵的,有裂纹的,有缺陷的; [or]bec2;
client: [acc]/ˈklaɪənt/; [n]委托人,当事人,主顾,客户;客户端; [or]bec2;
website: [acc]/ˈwebsaɪt/; [n][网]网站; [or]bec2;
formulate: [acc]/ˈfɔːrmjuleɪt/; [v]构想出(计划,方法等);系统地阐述; [or]bec2;
motive: [acc]/ˈmoʊtɪv/; [n]动机,目的; [adj]发动的,运动的,动机的; [v]引发,促进,激发; [or]bec2;
transparent: [acc]/trænsˈpærənt/; [adj]透明的,清澈的,明净的;易识破的,显而易见的; [or]bec2;
slogan: [acc]/ˈsloʊɡən/; [n]标语;口号;广告语; [or]bec2;
approve: [acc]/əˈpruːv/; [v]称许,赞成,批准; [or]bec2;
tackle: [acc]/ˈtækl/; [v]对付,处理;(足球等比赛中)阻截; [n]阻截;钓具;滑轮(组); [or]bec2;
devalue: [acc]/ˌdiːˈvæljuː/; [v]贬值,降低价值; [or]bec2;
team building: [acc]/ˈtiːm bɪldɪŋ/; [phr]团队建设; [or]bec2;
notice: [acc]/ˈnoʊtɪs/; [n]通知,告示;注意; [v]注意,察觉; [or]bec2;
pick: [acc]/pɪk/; [v]挑选;拾,捡起;摘,采摘;剔,戳; [n]选择;精品; [or]bec2;
gimmick: [acc]/ˈɡɪmɪk/; [n]吸引人的花招,噱头; [vt]用暗机关改变或影响; [or]bec2;
abandon: [acc]/əˈbændən/; [v]抛弃;放弃;放纵; [or]bec2;
division: [acc]/dɪˈvɪʒn/; [n]分,分配,除法,部门,分裂; [or]bec2;
result: [acc]/rɪˈzʌlt/; [n]结果,成效; [v]导致,..的结果; [or]bec2;
turmoil: [acc]/ˈtɜːrmɔɪl/; [n]骚动,骚乱; [or]bec2;
react: [acc]/riˈækt/; [v]起反应,有影响,对..做出反应;有不良反应;起化学反应; [or]bec2;
execute: [acc]/ˈeksɪkjuːt/; [v]处决;完成(动作);实行;执行(计划); [or]bec2;
set up: [acc]/set ʌp/; [phr]设立,创立;提议,提倡;预备;(军事)训练; [or]bec2;
consolidate: [acc]/kənˈsɑːlɪdeɪt/; [v]巩固,加强;把.合为一体; [or]bec2;
leap: [acc]/liːp/; [v]跳跃;暴涨; [n]跳跃;跳动;上涨; [or]bec2;
convince: [acc]/kənˈvɪns/; [v]使确信;使信服; [or]bec2;
date: [acc]/deɪt/; [n]日期;约会对象;约会;枣子; [v]约会;始于(某一历史时期);给..注明日期,记载日期;确定..的年代; [or]bec2;
parental leave: [acc]/pəˌrentl ˈliːv/; [phr]育婴假,亲职假; [or]bec2;
idealize: [acc]/aɪˈdiːəlaɪz/; [v]理想化地描述,(使)理想化; [or]bec2;
take the minutes: [acc]/teɪk ðə ˈmɪnɪts/; [phr]做会议记录; [or]bec2;
go up: [acc]/ɡoʊ ʌp/; [phr]上升;被建立;被炸毁; [or]bec2;
federation: [acc]/ˌfedəˈreɪʃn/; [n]同盟,联盟,联邦; [or]bec2;
worksheet: [acc]/ˈwɜːrkʃiːt/; [n]工作表;作业单; [or]bec2;
plus: [acc]/plʌs/; [prep]加,加上; [n]加号;有利因素; [adj]正的,多的;有利的;阳性的; [conj]此外,而且,况且; [or]bec2;
pretend: [acc]/prɪˈtend/; [v]假装,装扮; [adj]假装的,仿制的; [or]bec2;
remainder: [acc]/rɪˈmeɪndər/; [n]剩下的人;剩余物,残留部分; [v]减价出售,削价处理; [adj]剩余的;留存下的; [or]bec2;
facility: [acc]/fəˈsɪləti/; [n]设施(车间等),设备;灵巧;才能,资质; [or]bec2;
tailor: [acc]/ˈteɪlər/; [n]裁缝; [v]修改;使合适;调整使适应; [vt]裁制;剪裁; [or]bec2;
trade name: [acc]/ˈtreɪd neɪm/; [phr]商品名称,商号,店名; [or]bec2;
visa: [acc]/ˈviːzə/; [n]签证; [or]bec2;
aid: [acc]/eɪd/; [n]帮助;救护,援助;帮助者,助手; [v]帮助;援助,帮助,有助于; [or]bec2;
neglect: [acc]/nɪˈɡlekt/; [v]忽视;忽略;疏忽; [n]疏忽;忽视; [or]bec2;
accessory: [acc]/əkˈsesəri/; [n](妇女的)装饰品;附件;附属物;同谋; [adj]附属的;辅助的;同谋的; [or]bec2;
cross-cultural awareness: [acc]/ˌkrɔːs ˈkʌltʃərəl əˈwernəs/; [phr]跨文化意识; [or]bec2;
average: [acc]/ˈævərɪdʒ/; [n]平均数,平均水平; [adj]通常的,一般的;平均的; [v]平均为; [or]bec2;
languish: [acc]/ˈlæŋɡwɪʃ/; [v]凋萎,衰弱,变得消瘦; [or]bec2;
aspiration: [acc]/ˌæspəˈreɪʃn/; [n]抱负,志向;发 h 音; [or]bec2;
void: [acc]/vɔɪd/; [n]空间;空洞;空位;空虚感; [adj]缺乏的;空的,没有的;[律]无效的; [v]使无效,把.作废, 宣布.作废;腾出,清理; [vi]排泄; [or]bec2;
bullish: [acc]/ˈbʊlɪʃ/; [adj]看涨的,上扬的,乐观的,似牡牛的; [or]bec2;
impasse: [acc]/ˈɪmpæs/; [n]僵局;死路; [or]bec2;
order: [acc]/ˈɔːrdər/; [v]点(酒菜);订购;命令;安排,整理; [n]顺序,条理,状况,规程;体制;治安,秩序;订单,订货;指令,命令;等级,阶层; [or]bec2;
unit: [acc]/ˈjuːnɪt/; [n]整体,单位;部门;课本单元;(机器)一部分的装置,设备,部件; [or]bec2;
owe: [acc]/oʊ/; [v]感谢;欠;把.归于;占有;欠钱; [or]bec2;
amazing: [acc]/əˈmeɪzɪŋ/; [adj]令人吃惊的,非凡的; [or]bec2;
refill: [acc]/ˌriːˈfɪl/; [v]被再注满,再装满; [n]续杯,再注满; [or]bec2;
manufacturing: [acc]/ˌmænjuˈfæktʃərɪŋ/; [n]制造业; [adj]制造业的; [or]bec2;
strategic: [acc]/strəˈtiːdʒɪk/; [adj]战略(上)的,对全局有重要意义的,关键的; [or]bec2;
frame: [acc]/freɪm/; [n]构架,框,结构,体格; [v]表达;制定;拟订;陷害;构成,制定,给..装框架;使..适合; [or]bec2;
door-to-door: [acc]/'dɔːrt'əd'ɔːr/; [adj]挨家挨户的,送货上门的; [adv]挨户访问地,按户送达地; [or]bec2;
current: [acc]/ˈkɜːrənt/; [adj]当前的,现在的;流动的; [n](电,水,气)流; [or]bec2;
merchandise: [acc]/ˈmɜːrtʃəndaɪs/; [n]商品,货品; [v]推销,经营; [or]bec2;
royalty: [acc]/ˈrɔɪəlti/; [n]皇家,王族,皇族;版税;专利费; [or]bec2;
recourse: [acc]/ˈriːkɔːrs/; [n]求援(对象),求助(对象,[商][律]追索权; [or]bec2;
apprentice: [acc]/əˈprentɪs/; [v]使当学徒; [n]学徒; [or]bec2;
pack: [acc]/pæk/; [v]打包;包装;塞满; [n]行李;背包;一群;一伙; [adj]包装用的;搬运用的;由驮运牲畜组成的;填满了的; [or]bec2;
confident: [acc]/ˈkɑːnfɪdənt/; [adj]自信的;确信的,深信的; [or]bec2;
associate: [acc]/əˈsoʊʃieɪt/; [v]联想;联合;联系,交往; [n]伙伴;同事; [adj]副的; [or]bec2;
justify: [acc]/ˈdʒʌstɪfaɪ/; [v]证明.正确(或正当,有理); [or]bec2;
persuade: [acc]/pərˈsweɪd/; [v]说服,劝说;使相信; [or]bec2;
beat: [acc]/biːt/; [v]敲打;打败;打;(心脏)跳动;搅拌; [n]敲打;拍子; [adj]精疲力竭的,疲惫不堪的;垮掉的,属于"垮掉的一代"的; [or]bec2;
manpower: [acc]/ˈmænpaʊər/; [n]人力;人力资源;劳动力; [or]bec2;
specialise: [acc]/'speʃəlˌaɪz/; [vi]专门从事,专攻; [vt]使专门化; [or]bec2;
negotiate: [acc]/nɪˈɡoʊʃieɪt/; [v]谈判,交涉,商议;成功越过,渡过; [or]bec2;
takeaway: [acc]/ˈteɪkəweɪ/; [n]外带食物,夺走; [adj]外卖的; [or]bec2;
press: [acc]/pres/; [v]按,压,逼迫; [n]新闻界,出版社,报刊; [or]bec2;
margin: [acc]/ˈmɑːrdʒən/; [n]页边的空白,边缘;优势;利润; [or]bec2;
synthetic: [acc]/sɪnˈθetɪk/; [adj]合成的,人造的;[语]综合型的,综合性的,借助词尾变化表示句法关系的; [n]合成物; [or]bec2;
recession: [acc]/rɪˈseʃn/; [n](经济)衰退,不景气;后退,撤回;凹处; [or]bec2;
outflow: [acc]/ˈaʊtfloʊ/; [n]流出,流出量; [vi]流出; [or]bec2;
external: [acc]/ɪkˈstɜːrnl/; [adj]外面的,外部的;外国的; [or]bec2;
recognize: [acc]/ˈrekəɡnaɪz/; [v]辨别,认出;赏识,表彰;承认;赞成; [or]bec2;
partisan: [acc]/ˈpɑːrtəzn/; [adj]党派的;效忠的;偏袒的;盲目推崇的; [n]党羽;虔诚信徒;游击队; [or]bec2;
bioinformatics: [acc]/biːəʊɪn'fɔːmətɪks/; [n]生物信息学; [or]bec2;
regain: [acc]/rɪˈɡeɪn/; [vt]恢复;重新获得;收回; [vi]上涨; [n]收复;取回; [or]bec2;
detail: [acc]/ˈdiːteɪl/; [n]细节;详情;特遣队; [vt]详述;派遣; [or]bec2;
typical: [acc]/ˈtɪpɪkl/; [adj]典型的;代表性的; [or]bec2;
public: [acc]/ˈpʌblɪk/; [adj]公共的;公众的;公开的;公然的; [n]公众,民众; [or]bec2;
handle: [acc]/ˈhændl/; [n]柄,把手; [v]处理,解决;操纵; [or]bec2;
poach: [acc]/poʊtʃ/; [v]水煮;小火煮;偷猎;窃取; [or]bec2;
research: [acc]/ˈriːsɜːrtʃ/; [v]研究,调查; [n]研究,调查; [or]bec2;
infrastructure: [acc]/ˈɪnfrəstrʌktʃər/; [n]基础设施; [or]bec2;
flop: [acc]/flɑːp/; [vt]重重地摔落; [vi]惨败;扑通落下; [n]失败; [adv]扑通一声; [or]bec2;
aversion: [acc]/əˈvɜːrʒn/; [n]厌恶;讨厌的人,(或东西); [or]bec2;
pledge: [acc]/pledʒ/; [v]发誓,保证,以.抵押,向.祝酒; [n]保证,誓言; [or]bec2;
malfunction: [acc]/ˌmælˈfʌŋkʃn/; [v]发生故障;不起作用; [n]故障;失灵;疾病; [or]bec2;
flier: [acc]/ˈflaɪər/; [n]飞行员,飞行物,飞机上的乘客,传单,投机; [or]bec2;
ploy: [acc]/plɔɪ/; [n]策略,手段; [v]横队变纵队; [or]bec2;
loyalty: [acc]/ˈlɔɪəlti/; [n]忠诚;忠心耿耿; [or]bec2;
spacious: [acc]/ˈspeɪʃəs/; [adj]宽敞的,广阔的; [or]bec2;
potential: [acc]/pəˈtenʃl/; [n]潜力,潜能; [adj]潜在的,可能的; [or]bec2;
entry: [acc]/ˈentri/; [n]入口处;登记;进入; [or]bec2;
decent: [acc]/ˈdiːsnt/; [adj]体面的;像样的;合宜的;正直的; [or]bec2;
hoover: [acc]/ˈhuːvər/; [v]用真空吸尘器把..清除掉,获得大量的(某物); [n]胡佛吸尘器(商标名); [or]bec2;
soft: [acc]/sɔːft/; [adj]软的;温柔的;细嫩的,光滑的;不含酒精的; [n]柔软的东西; [adv]柔软地,柔和地; [or]bec2;
surplus: [acc]/ˈsɜːrplʌs/; [adj]过剩的,多余的; [n]过剩,盈余;顺差; [or]bec2;
context: [acc]/ˈkɑːntekst/; [n]上下文,语境;背景; [or]bec2;
bill: [acc]/bɪl/; [n]账单;纸币,钞票;议案,法案;广告;鸟嘴; [v]给..开账单; [or]bec2;
conditional: [acc]/kənˈdɪʃənl/; [adj]有条件的,假定的; [n]条件句,条件语; [or]bec2;
claim: [acc]/kleɪm/; [v]声称;要求;断言;主张;认领;索赔; [n]索赔;主张;声称;断言;要求; [or]bec2;
trivial: [acc]/ˈtrɪviəl/; [adj]微不足道的; [or]bec2;
stag: [acc]/stæɡ/; [n]牡鹿;不带女伴的舞客;阉割过的雄鹿; [adj]全是男人的; [v]不带女伴参加晚会; [or]bec2;
pension: [acc]/ˈpenʃn/; [n]养老金,抚恤金;廉租屋; [v]发给..养老金; [or]bec2;
replacement: [acc]/rɪˈpleɪsmənt/; [n]代替物;接替者;更换; [or]bec2;
on time: [acc]/ɑːn taɪm/; [adv]准时; [or]bec2;
fire: [acc]/ˈfaɪər/; [n]火;火灾; [v]开火;解雇; [or]bec2;
mission: [acc]/ˈmɪʃn/; [n]任务,使命;代表团,使团; [vi]派遣..执行任务; [or]bec2;
land: [acc]/lænd/; [n]陆地,土地;国土,国家; [v](使)登陆;(使)着陆; [or]bec2;
carrier: [acc]/ˈkæriər/; [n]搬运工,运送人;运输公司;航空母舰; [or]bec2;
financial: [acc]/faɪˈnænʃl/; [adj]金融的;财政的;财务的; [or]bec2;
steadily: [acc]/ˈstedəli/; [adv]稳定地;持续地;有规则地; [or]bec2;
native: [acc]/ˈneɪtɪv/; [adj]本地的,本国的;与生俱来的; [n]本地人;土著;当地动植物; [or]bec2;
antitrust: [acc]/ˌæntiˈtrʌst/; [adj]反垄断的; [or]bec2;
exceed: [acc]/ɪkˈsiːd/; [v]超过;胜过;超出; [or]bec2;
factory: [acc]/ˈfæktəri/; [n]工厂,制造厂; [or]bec2;
irrevocable: [acc]/ɪˈrevəkəbl/; [adj]不可改变的;不能取消的;不能挽回的; [or]bec2;
viable: [acc]/ˈvaɪəbl/; [adj]可行的;能养活的;能生育的; [or]bec2;
license: [acc]/ˈlaɪsns/; [n]许可;执照; [v]许可,准许;发许可证; [or]bec2;
outlet: [acc]/ˈaʊtlet/; [n]出口;插座;表现机会,发泄方法;廉价经销店; [or]bec2;
resistance: [acc]/rɪˈzɪstəns/; [n]阻力;抵抗;抵制;抵抗力;电阻; [or]bec2;
assistance: [acc]/əˈsɪstəns/; [n]援助;帮助;补助; [or]bec2;
bailout: [acc]/ˈbeɪlaʊt/; [n]紧急(财政)援助,紧急融资; [adj]应付紧急状况的; [or]bec2;
cost: [acc]/kɔːst/; [n]价格,成本;花费; [vi]花费;需要付出高昂代价; [vt]估算..的费用;使付出; [or]bec2;
seasoned: [acc]/ˈsiːznd/; [adj]加佐料的,经验丰富的,晒干的; [or]bec2;
burglar: [acc]/ˈbɜːrɡlər/; [n]窃贼; [or]bec2;
emotional: [acc]/ɪˈmoʊʃənl/; [adj]感情的,情绪的;沮丧的,哀伤的;令人激动的; [or]bec2;
exchange: [acc]/ɪksˈtʃeɪndʒ/; [v]交换,互换;交流;进行易货贸易; [n]交换;交易所;(货币的)兑换; [or]bec2;
monetary: [acc]/ˈmɑːnɪteri/; [adj]货币的,金融的;金钱的; [or]bec2;
bar: [acc]/bɑːr/; [n]酒吧;(金属)棒;闩;障碍;柜台; [vt]阻挡;禁止;闩住; [prep]除.之外; [or]bec2;
roughly: [acc]/ˈrʌfli/; [adv]大约,粗略地,粗暴地,粗糙地,粗鲁地; [or]bec2;
highly: [acc]/ˈhaɪli/; [adv]高度地,很,非常,赞许地; [or]bec2;
brochure: [acc]/broʊˈʃʊr/; [n]手册,小册子; [or]bec2;
frustrating: [acc]/ˈfrʌstreɪtɪŋ/; [adj]令人沮丧的; [or]bec2;
court: [acc]/kɔːrt/; [n]法院,法庭;庭院;球场;宫廷; [v]讨好,取悦;招致危险;追求; [or]bec2;
fire off: [acc]/faɪr ɔf/; [phr]一连串提问(责难等),开炮,发射; [or]bec2;
need: [acc]/niːd/; [v]需要,必需; [n]需要,必要,缺乏; [or]bec2;
shunt: [acc]/ʃʌnt/; [n]转轨;[电]分流器; [v]使(火车)转到另一轨道,转移方向; [or]bec2;
value: [acc]/ˈvæljuː/; [v]给.定价,评价;重视,珍视,尊重; [n]价值;有用性; [or]bec2;
understaffed: [acc]/ˌʌndərˈstæft/; [adj]人员不足的; [or]bec2;
target: [acc]/ˈtɑːrɡɪt/; [n]目标;靶子; [v]瞄准; [or]bec2;
attachment: [acc]/əˈtætʃmənt/; [n]依恋;(机器的,通过邮件发送的)附件;连接物; [or]bec2;
multinational: [acc]/ˌmʌltiˈnæʃnəl/; [adj]跨国公司的,多国的; [n]跨国公司; [or]bec2;
shredder: [acc]/ˈʃredər/; [n]碎纸机; [or]bec2;
rigid: [acc]/ˈrɪdʒɪd/; [adj]坚硬的;僵硬的;死板的; [or]bec2;
regret: [acc]/rɪˈɡret/; [n]后悔,遗憾; [vt]懊悔,后悔;抱歉; [vi]感到后悔,感到抱歉; [or]bec2;
fishery: [acc]/ˈfɪʃəri/; [n]渔场;养鱼场所; [or]bec2;
indirect: [acc]/ˌɪndəˈrekt/; [adj]迂回的,间接的,不坦率的; [or]bec2;
portable: [acc]/ˈpɔːrtəbl/; [adj]轻便的,手提的,便携式的; [n]便携机;(尤指)手提电脑; [or]bec2;
retire: [acc]/rɪˈtaɪər/; [v]退休;退役; [vi]就寝; [or]bec2;
contributory: [acc]/kənˈtrɪbjətɔːri/; [adj]促成.的,有贡献的,有助的,由捐助支付的; [n]贡献者,捐助者; [or]bec2;
windfall: [acc]/ˈwɪndfɔːl/; [n]风吹落果;意外的收获,意外幸运; [or]bec2;
clientele: [acc]/ˌklaɪənˈtel/; [n]顾客,常客; [or]bec2;
commute: [acc]/kəˈmjuːt/; [n]在两地之间乘车往返; [v]经常乘车往返于两地之间; [vt]减免; [or]bec2;
spreadsheet: [acc]/ˈspredʃiːt/; [n]电子制表软件;电子数据表;试算表; [or]bec2;
crisis: [acc]/ˈkraɪsɪs/; [n]危机;存亡之际; [or]bec2;
collect: [acc]/kəˈlekt/; [v]收集;领取;聚集;募捐; [adj]接收者付费的; [adv]接收者付费地; [or]bec2;
dissipate: [acc]/ˈdɪsɪpeɪt/; [v]消散,消失;浪费; [or]bec2;
maintenance: [acc]/ˈmeɪntənəns/; [n]维护;生活费;赡养费,抚养费;维修;保持;保养; [or]bec2;
outgrow: [acc]/ˌaʊtˈɡroʊ/; [v]长得过大而不适于;长大成熟而不再;长的比..快; [or]bec2;
demand: [acc]/dɪˈmænd/; [n]要求(坚决的),需求; [v]强烈要求,需要; [or]bec2;
complaint: [acc]/kəmˈpleɪnt/; [n]抱怨,怨言;不满的缘由,痛苦根源;控诉;投诉; [or]bec2;
vindicate: [acc]/ˈvɪndɪkeɪt/; [vt]证明.无辜;维护,辩护; [or]bec2;
occupy: [acc]/ˈɑːkjupaɪ/; [v]占领,占据,侵占;住在,居住,住进;担任(职务),任职;占用(时间,空间等),占有;使用(房屋,建筑); [or]bec2;
unanimous: [acc]/juˈnænɪməs/; [adj]全体一致的;一致同意的; [or]bec2;
eurocurrency: [acc]/ˈjʊroˌkɚrənsi/; [n]欧洲货币; [or]bec2;
interest: [acc]/ˈɪntrəst/; [n]兴趣;利息;利益; [v]使感兴趣; [or]bec2;
compelling: [acc]/kəmˈpelɪŋ/; [adj]引人注目的;紧迫的;令人信服的; [or]bec2;
enlighten: [acc]/ɪnˈlaɪtn/; [v]启发,开导; [or]bec2;
fingertip: [acc]/ˈfɪŋɡərtɪp/; [n]指尖;指套; [or]bec2;
ahead of schedule: [acc]/əˈhed əv ˈskedʒuːl/; [phr]提前,超前; [or]bec2;
take care: [acc]/teɪk ker/; [phr]保重,当心,注意; [or]bec2;
fuss: [acc]/fʌs/; [n]大惊小怪,小题大做; [v](为小事)烦恼,过于忧虑; [or]bec2;
centralize: [acc]/ˈsentrəlaɪz/; [v]使集中;使成为.的中心;使集权; [or]bec2;
subsidy: [acc]/ˈsʌbsədi/; [n]补助金,津贴; [or]bec2;
position: [acc]/pəˈzɪʃn/; [n]位置;职位;姿势;观点; [v]安置; [or]bec2;
equipment: [acc]/ɪˈkwɪpmənt/; [n]设备;装备,装置; [or]bec2;
figure: [acc]/ˈfɪɡjər/; [n]体型;人物,人影;形状;数字; [v]想出,估计,计算出; [or]bec2;
branch: [acc]/bræntʃ/; [n]树枝;分支(学科);(政府等的)部门;分支机构,分部; [vi]出枝桠,分叉; [or]bec2;
change: [acc]/tʃeɪndʒ/; [n]改变,变化;零钱; [v]兑换; [vi]变化; [vt]改变; [or]bec2;
modest: [acc]/ˈmɑːdɪst/; [adj]谦虚的,谦逊的;端庄的,羞怯的;不太大(或太贵,太重要)的,适度的; [or]bec2;
enormously: [acc]/ɪˈnɔːrməsli/; [adv]巨大地,庞大地;非常地,在极大程度上; [or]bec2;
rationale: [acc]/ˌræʃəˈnæl/; [n]基本原理;原理的阐述; [or]bec2;
mention: [acc]/ˈmenʃn/; [v]提及,提名; [n]谈到,提及; [or]bec2;
explicit: [acc]/ɪkˈsplɪsɪt/; [adj]充分表达清楚的,明确的;直率的,直截了当的;〔描绘性或暴力的语言或画面〕清晰露骨的; [or]bec2;
explosion: [acc]/ɪkˈsploʊʒn/; [n]爆炸;爆发;激增; [or]bec2;
factor: [acc]/ˈfæktər/; [n]因素;[数]因子,商; [or]bec2;
mechanism: [acc]/ˈmekənɪzəm/; [n]机械装置;机制,机理,原理; [or]bec2;
compete: [acc]/kəmˈpiːt/; [v]参加比赛;竞争,对抗; [or]bec2;
promote: [acc]/prəˈmoʊt/; [v]提升;促进;发扬;促销; [or]bec2;
deli: [acc]/ˈdeli/; [n]熟食店;[食品]熟食品(等于delicatessen); [or]bec2;
aroma: [acc]/əˈroʊmə/; [n]芳香,香气; [or]bec2;
feature: [acc]/ˈfiːtʃər/; [n]面貌,相貌;特征,特点;特辑; [vt]使突出,以.为特色; [vi]起重要作用,作为主要角色; [or]bec2;
ability: [acc]/əˈbɪləti/; [n]能力,技能,本领; [or]bec2;
specific: [acc]/spəˈsɪfɪk/; [adj]具体的,明确的;特定的;特殊的;针对..的; [n]详情;特性; [or]bec2;
upgrade: [acc]/ˈʌpɡreɪd/; [v]升级;提高; [n]改善,提高;升级;升舱; [or]bec2;
domain: [acc]/doʊˈmeɪn/; [n]域名;领土;管区,势力圈; [or]bec2;
accounting: [acc]/əˈkaʊntɪŋ/; [n]会计工作,会计学;账单; [vt]记述;解释; [or]bec2;
alongside: [acc]/əˌlɔːŋˈsaɪd/; [adv]在旁边,并排地,并肩地; [prep]在.旁边,和.并排;和.一起; [or]bec2;
launch: [acc]/lɔːntʃ/; [v]发射;出海;创办,开始从事; [n]发射,投放市场;(游艇,汽艇)下水;发行; [or]bec2;
lifelong: [acc]/ˈlaɪflɔːŋ/; [adj]终身的; [or]bec2;
opportunity: [acc]/ˌɑːpərˈtuːnəti/; [n]机会,良机; [or]bec2;
downside: [acc]/ˈdaʊnsaɪd/; [n]缺点,负面,下降趋势(价格方面); [adj]下降趋势的; [or]bec2;
franchise: [acc]/ˈfræntʃaɪz/; [n]特许(经营权),公民权,选举权; [v]赋予特权,赋予公民权; [or]bec2;
dependent: [acc]/dɪˈpendənt/; [adj]依赖的;取决于..的; [n]依赖他人者; [or]bec2;
magazine: [acc]/ˈmæɡəziːn/; [n]杂志,期刊;弹夹;弹药库; [or]bec2;
bourse: [acc]/bʊrs/; [n]证券交易所; [or]bec2;
competence: [acc]/ˈkɑːmpɪtəns/; [n]能力,胜任,称职; [or]bec2;
approach: [acc]/əˈproʊtʃ/; [v]接近;靠近;着手处理; [n]接近;途径;方法; [or]bec2;
inflation: [acc]/ɪnˈfleɪʃn/; [n]通货膨胀;(充气后)膨胀;自负; [or]bec2;
subject line: [acc]/ˈsʌbdʒekt laɪn/; [phr]标题栏,主题栏; [or]bec2;
parkland: [acc]/ˈpɑːrklænd/; [n]公共绿地; [or]bec2;
chip: [acc]/tʃɪp/; [n]木屑,碎片;缺口;圆形筹码;芯片;炸薯条,炸薯片; [v]碎裂;削,凿;将.削成,凿成; [or]bec2;
liquidate: [acc]/ˈlɪkwɪdeɪt/; [vt]清理,清算,停业清理;清偿,清理,清算(破产的公司等),变卖,杀戮,废除; [or]bec2;
holder: [acc]/ˈhoʊldər/; [n]持有者,占有者,(台,架等)支持物; [or]bec2;
squeeze: [acc]/skwiːz/; [v](常指用手)挤压;挤进,塞进;用力挤压榨取;减少,压缩; [n]榨;压榨;挤,塞; [or]bec2;
range: [acc]/reɪndʒ/; [n]排;变动范围;山脉;放牧场;射程;范围; [vi]排成一排; [vt]排列; [adj]牧场的; [or]bec2;
dilemma: [acc]/dɪˈlemə/; [n]进退两难的窘境; [or]bec2;
scrap: [acc]/skræp/; [n]碎片;口角,吵架;小块,小片;废金属;残羹冷炙; [v]报废;舍弃;打架; [or]bec2;
hyperinflation: [acc]/ˌhaɪpərɪnˈfleɪʃn/; [n]恶性通货膨胀; [or]bec2;
rival: [acc]/ˈraɪvl/; [n]竞争者,对手; [v]与.竞争,与.匹敌; [adj]竞争的,敌对的; [or]bec2;
fetch: [acc]/fetʃ/; [v]取来;接来;使发出;售得;带来;接住; [n]拿来,取来;诡计;风浪区; [or]bec2;
shift work: [acc]/ʃɪft wɚk/; [phr]换班工作,倒班工作; [n]轮班; [or]bec2;
revolutionary: [acc]/ˌrevəˈluːʃəneri/; [n]革命者; [adj]革命的;革命性的; [or]bec2;
precede: [acc]/prɪˈsiːd/; [v]发生在..之前,先于; [or]bec2;
gap: [acc]/ɡæp/; [n]间隙,缺口,差距; [or]bec2;
improvement: [acc]/ɪmˈpruːvmənt/; [n]改进,改善,进步; [or]bec2;
floor: [acc]/flɔːr/; [n]地板,地面,楼层,底部; [vt]铺地板,击倒,(油门)踩到底; [or]bec2;
semi-skilled: [acc]/ˌsemi ˈskɪld/; [adj]半熟练的; [or]bec2;
gilt: [acc]/ɡɪlt/; [n]镀金层;小母猪; [adj]镀金的; [or]bec2;
switch: [acc]/swɪtʃ/; [n]开关;转变;转向;转辙器; [v]转换,转变;调换;转移;打开,关上; [vt]交换; [or]bec2;
undercut: [acc]/ˌʌndərˈkʌt/; [v]廉价出售;较便宜的工资工作;从下边削球; [n]底切;牛腰部下侧嫩肉;砍口;切球; [adj]下部被削去[切去,挖掉,凿去]的; [or]bec2;
discount: [acc]/ˈdɪskaʊnt/; [n](价格,债款等)折扣; [v]打折扣,不全信,怀疑地看待; [or]bec2;
balance: [acc]/ˈbæləns/; [n]平衡;称;平静;和谐;余额; [v]保持平衡;使平衡;补偿; [or]bec2;
doldrums: [acc]/ˈdoʊldrəmz/; [n](海洋上的)无风带,情绪低沉; [or]bec2;
anniversary: [acc]/ˌænɪˈvɜːrsəri/; [n]周年纪念日; [adj]周年的,(有关)周年纪念的; [or]bec2;
imperative: [acc]/ɪmˈperətɪv/; [adj]必要的;祈使的;急需的; [n]命令;必要的事;义务;驱使; [or]bec2;
steer: [acc]/stɪr/; [v]操纵,驾驶,掌舵,引导; [n]公牛,食用牛; [or]bec2;
charge: [acc]/tʃɑːrdʒ/; [v]充电,充值;索价;控告;向.冲去; [n]费用;主管;控告; [or]bec2;
clue: [acc]/kluː/; [n]线索;提示;暗示; [vt]为..提供线索; [or]bec2;
decline: [acc]/dɪˈklaɪn/; [n]下降;衰退; [v][语]使发生词尾变化,使变格;下降;拒绝; [or]bec2;
absent: [acc]/ˈæbsənt/; [adj]缺席的,不在的;心不在焉的,出神的; [v]缺席;使缺席; [prep]缺乏; [or]bec2;
administration: [acc]/ədˌmɪnɪˈstreɪʃn/; [n]管理;管理层,管理部门;政府;(药的)配给; [or]bec2;
disturbance: [acc]/dɪˈstɜːrbəns/; [n]骚乱,混乱;扰乱,打扰;心神不安,烦恼; [or]bec2;
warranty: [acc]/ˈwɔːrənti/; [n]授权;根据;保证书;担保书,保单; [or]bec2;
specify: [acc]/ˈspesɪfaɪ/; [v]详细说明; [or]bec2;
dealer: [acc]/ˈdiːlər/; [n]经销商,商人,(俚)毒贩; [or]bec2;
reshuffle: [acc]/ˈriːʃʌfl/; [v]再洗牌,改组,重新安排; [n]改组;重新洗牌; [or]bec2;
broadly: [acc]/ˈbrɔːdli/; [adv]概括地,大体上,宽广地,广泛地,明白地,无礼貌地; [or]bec2;
deviation: [acc]/ˌdiːviˈeɪʃn/; [n]偏离,背离; [or]bec2;
indulge: [acc]/ɪnˈdʌldʒ/; [v]沉迷于;放纵;满足; [or]bec2;
model: [acc]/ˈmɑːdl/; [n]模型;模特; [v]模仿;当模特;(用黏土,木头等)做..的造型,塑造;当模特展示服装; [adj]模范的;典型的; [or]bec2;
finance: [acc]/ˈfaɪnæns/; [v]资金供给,筹措资金; [n]金融,财政,资金; [or]bec2;
alternate: [acc]/ˈɔːltərnət/; [adj]交替的,轮流的,间隔的; [v](使)交替,(使)轮流; [n]代替者; [or]bec2;
title: [acc]/ˈtaɪtl/; [n]标题;头衔;权利; [vt]加标题于;授予.称号; [adj]标题的,题目的;称呼的; [or]bec2;
floatation: [acc]/floʊ'teɪʃən/; [n](债券股票等的)发行,飘浮; [or]bec2;
comply: [acc]/kəmˈplaɪ/; [vi]依从,服从,遵守; [or]bec2;
entrant: [acc]/ˈentrənt/; [n]进入者,新成员,参加竞赛者; [or]bec2;
glimpse: [acc]/ɡlɪmps/; [n]一瞥;初步的感受; [v]一瞥,瞥见; [or]bec2;
compliment: [acc]/ˈkɑːmplɪmənt/; [n]恭维,问候; [v]赞美,祝贺; [or]bec2;
buck: [acc]/bʌk/; [n]雄鹿;年轻男士;美元; [v]反对;马弓背踢后腿挑起; [or]bec2;
conservative: [acc]/kənˈsɜːrvətɪv/; [adj]保守的;保守估计的;保守党的; [n]保守主义者;保守党党员; [or]bec2;
occupation: [acc]/ˌɑːkjuˈpeɪʃn/; [n]占领,占据;占用,居住;职业,工作;消遣; [or]bec2;
moratorium: [acc]/ˌmɔːrəˈtɔːriəm/; [n]暂停,中止;[金融]延期偿付; [or]bec2;
copywriter: [acc]/ˈkɑːpiraɪtər/; [n]广告文字撰写人; [or]bec2;
visionary: [acc]/ˈvɪʒəneri/; [n]有远见的人;幻想家; [adj]有远见的;爱幻想的; [or]bec2;
freebie: [acc]/ˈfriːbi/; [n]免费的东西,免费赠券; [or]bec2;
constituent: [acc]/kənˈstɪtʃuənt/; [adj]组成的;有选举权的; [n]选民;成分; [or]bec2;
accurate: [acc]/ˈækjərət/; [adj]精确的;正确的;符合标准的; [or]bec2;
cyberspace: [acc]/ˈsaɪbərspeɪs/; [n]网络空间;赛博空间; [or]bec2;
trigger: [acc]/ˈtrɪɡər/; [n](枪等的)扳机,诱因; [v]触发,引起,激发,扣扳机; [or]bec2;
minister: [acc]/ˈmɪnɪstər/; [v]给予援助,救助;照料,服侍; [n]部长,大臣;公使,外交使节;牧师; [or]bec2;
coincide: [acc]/ˌkoʊɪnˈsaɪd/; [v]巧合,一致,相符; [or]bec2;
arrangement: [acc]/əˈreɪndʒmənt/; [n]布置;排列;组合体;整齐;调解;办法;协议;计划; [or]bec2;
portion: [acc]/ˈpɔːrʃn/; [n]一部分,份额,分担的责任; [v]把.分成份额,分配; [or]bec2;
acknowledgement: [acc]/əkˈnɑːlɪdʒmənt/; [n]承认,确认,感谢; [or]bec2;
joint responsibility: [acc]/dʒɔɪnt rɪˌspɑnsəˈbɪlɪti/; [phr]连带责任; [or]bec2;
percentage: [acc]/pərˈsentɪdʒ/; [n]百分比,百分率; [or]bec2;
technician: [acc]/tekˈnɪʃn/; [n]技术员,技师;技术专家; [or]bec2;
modify: [acc]/ˈmɑːdɪfaɪ/; [v]改装,修改,更改;修饰,限定; [or]bec2;
recommend: [acc]/ˌrekəˈmend/; [v]推荐,介绍;劝告,建议; [or]bec2;
damage: [acc]/ˈdæmɪdʒ/; [v]损害;毁坏; [n]损害;赔偿费; [or]bec2;
allocate: [acc]/ˈæləkeɪt/; [v]分配,配给; [or]bec2;
consent: [acc]/kənˈsent/; [n]同意,准许;赞成; [v]同意; [or]bec2;
allotment: [acc]/əˈlɑːtmənt/; [n]分配;份额;[英]划分的土地; [or]bec2;
float: [acc]/floʊt/; [vi]漂浮,飘浮,浮现;散布;漂泊; [vt]使漂浮;散布; [n]浮标,漂浮物,漂浮; [or]bec2;
affluent: [acc]/ˈæfluənt/; [adj]富裕的,丰富的; [or]bec2;
unprecedented: [acc]/ʌnˈpresɪdentɪd/; [adj]前所未有的,空前的,无前例的; [or]bec2;
rate: [acc]/reɪt/; [n]比率,率;速率;价格;频率; [v]评估;认为; [or]bec2;
anecdote: [acc]/ˈænɪkdoʊt/; [n]轶事,趣闻; [or]bec2;
take someone on: [acc]/tek ˈsʌmˌwʌn ɑn/; [phr]聘用某人; [or]bec2;
accrue: [acc]/əˈkruː/; [v](利息等)增大,增多; [or]bec2;
review: [acc]/rɪˈvjuː/; [v]温习,复习;评论;回顾,反思; [n]复习,回顾;检讨;评审,审查; [or]bec2;
predecessor: [acc]/ˈpredəsesər/; [n]前辈;(被取代的)原有事物; [or]bec2;
insolvent: [acc]/ɪnˈsɑːlvənt/; [n]无力清偿债务者,破产者; [adj]无清偿能力的,破产的; [or]bec2;
institute: [acc]/ˈɪnstɪtuːt/; [n]学会;学院,专科学院,研究院; [vt]建立,设立,制定; [or]bec2;
opponent: [acc]/əˈpoʊnənt/; [n]对手,敌手,对抗者; [adj]对立的;敌对的; [or]bec2;
junk: [acc]/dʒʌŋk/; [n]废旧物品,垃圾,假货; [v]把.(当废物)丢弃; [or]bec2;
omission: [acc]/əˈmɪʃn/; [n]省略;遗漏,疏忽; [or]bec2;
parcel: [acc]/ˈpɑːrsl/; [n]包裹;一片,一块; [v]打包; [or]bec2;
plain: [acc]/pleɪn/; [adj]平凡的;明白的;坦率的;朴素的;不尚修饰的(尤指女人); [n]大平原; [or]bec2;
logo: [acc]/ˈloʊɡoʊ/; [n]标识,徽标,图标,标识语; [or]bec2;
appointment: [acc]/əˈpɔɪntmənt/; [n]约会,会面;委派;任命的职位;接受委派者;制定; [or]bec2;
GDP: [acc]/ˌdʒiː diː ˈpiː/; [abbr](=gross domestic product)国内生产总值; [n]国内生产总值(全写为 gross domestic product); [or]bec2;
private: [acc]/ˈpraɪvət/; [adj]私人的;私密的;私下的; [n]士兵; [or]bec2;
disposable: [acc]/dɪˈspoʊzəbl/; [adj]一次性的;可任意处理的;用完即丢的; [or]bec2;
bulwark: [acc]/ˈbʊlwɜːrk/; [n]堡垒,壁垒;保障;防波堤; [v]防御,保护;筑垒保卫; [or]bec2;
union: [acc]/ˈjuːniən/; [n]工会;联合;合并;协会;同盟;一致;融洽; [or]bec2;
strategy: [acc]/ˈstrætədʒi/; [n]谋略,策略,计谋; [or]bec2;
restart: [acc]/ˈriːstɑːrt/; [v]重新启动,重新开始; [n]重新开始,返聘; [or]bec2;
receipt: [acc]/rɪˈsiːt/; [n]收据,收条;收入;收到; [or]bec2;
composite: [acc]/kəmˈpɑːzət/; [adj]合成的,复合的; [n]合成物,复合材料; [v]使合成,使混合; [or]bec2;
prosecute: [acc]/ˈprɑːsɪkjuːt/; [v]起诉;做检察官;从事; [or]bec2;
cold calling: [acc]/kold ˈkɔlɪŋ/; [n]不请自来的推销电话; [or]bec2;
behaviour: [acc]/bɪˈheɪvjər/; [n]行为,举止;特性; [or]bec2;
uniform: [acc]/ˈjuːnɪfɔːrm/; [n]制服,军服; [adj]相同的,一致的,统一的; [or]bec2;
unpaid: [acc]/ˌʌnˈpeɪd/; [adj]未付款的;不受报酬的; [or]bec2;
bundle: [acc]/ˈbʌndl/; [n]捆,包; [vt]捆; [or]bec2;
goodwill: [acc]/ˌɡʊdˈwɪl/; [n](企业的)信誉,声誉;友好;好意; [or]bec2;
quantity: [acc]/ˈkwɑːntəti/; [n]数量,数目;大量,许多; [or]bec2;
prosperity: [acc]/prɑːˈsperəti/; [n]繁荣,兴旺,发达; [or]bec2;
principle: [acc]/ˈprɪnsəpl/; [n]原则,原理;理由,信条; [or]bec2;
recognition: [acc]/ˌrekəɡˈnɪʃn/; [n]承认,认可;认出;认识; [or]bec2;
scheme: [acc]/skiːm/; [n]方案,计划;阴谋,诡计; [v]图谋,密谋; [adj]计划的; [or]bec2;
variable: [acc]/ˈveriəbl/; [adj]易变的,可变的; [n]变量,可变物; [or]bec2;
construct: [acc]/kənˈstrʌkt/; [v]建造;作(图);构筑; [n]概念;构筑物;结构体;建造物; [or]bec2;
directory: [acc]/dəˈrektəri/; [n]人名地址录,(电话)号码簿;目录; [or]bec2;
empathy: [acc]/ˈempəθi/; [n]共鸣,同感;移情作用; [or]bec2;
ignore: [acc]/ɪɡˈnɔːr/; [v]忽视;不理; [or]bec2;
redeem: [acc]/rɪˈdiːm/; [vt]赎回;挽回;恢复;偿还;弥补;履行;兑换; [or]bec2;
qualify: [acc]/ˈkwɑːlɪfaɪ/; [v]胜任,使具有资格;描述,形容; [or]bec2;
component: [acc]/kəmˈpoʊnənt/; [n]零件; [adj]组成的; [or]bec2;
tenant: [acc]/ˈtenənt/; [n]承租人,租客,佃户; [or]bec2;
untapped: [acc]/ˌʌnˈtæpt/; [adj]未开发的;未使用的;塞子未开的; [or]bec2;
invitation: [acc]/ˌɪnvɪˈteɪʃn/; [n]请柬;邀请;招致; [or]bec2;
delightful: [acc]/dɪˈlaɪtfl/; [adj]令人愉快的,可喜的; [or]bec2;
group: [acc]/ɡruːp/; [n]群,组; [vi]聚集; [or]bec2;
warrant: [acc]/ˈwɔːrənt/; [n]逮捕证;正当理由;凭证; [v]使正当; [or]bec2;
address: [acc]/əˈdres/; [n]地址;致词; [v]致函;写姓名地址;向..讲话;处理; [or]bec2;
raise: [acc]/reɪz/; [v]养殖;养育;筹集(资金);举起;竖起,扶起;站直;提拔;唤起;和.取得联系; [n]加薪;提高; [or]bec2;
possession: [acc]/pəˈzeʃn/; [n]财产,所有物,拥有;控球; [or]bec2;
headhunt: [acc]/ˈhedhʌnt/; [v]物色人才; [n]野蛮人猎取人头的出征; [or]bec2;
subordinate: [acc]/səˈbɔːrdɪnət/; [n]部下;下属; [adj]次要的;从属的;下级的; [v]使从属于;使处于次要地位; [or]bec2;
merit: [acc]/ˈmerɪt/; [n]优点;价值;功绩; [v]值得;应得; [or]bec2;
clerical: [acc]/ˈklerɪkl/; [adj]书记的;牧师的;办事员的; [n]牧师; [or]bec2;
recline: [acc]/rɪˈklaɪn/; [vi]躺,斜倚(常与on,upon或against连用);信赖; [vt]使后靠,使斜倚; [or]bec2;
buoy: [acc]/ˈbuːi/; [n]浮标;浮筒;救生圈;航标; [v]使浮起;支撑;鼓励; [or]bec2;
workforce: [acc]/ˈwɜːrkfɔːrs/; [n]劳动力; [or]bec2;
ingredient: [acc]/ɪnˈɡriːdiənt/; [n](烹调的)原料;(构成的)要素,因素; [or]bec2;
jingle: [acc]/ˈdʒɪŋɡl/; [n](硬币,铃铛等发出的)叮当声;含有轻松而有节奏的韵律的诗篇; [v]发出叮当声; [or]bec2;
regarding: [acc]/rɪˈɡɑːrdɪŋ/; [prep]关于; [or]bec2;
hype: [acc]/haɪp/; [n]大肆宣传; [v]大肆宣传;使.兴奋; [or]bec2;
afford: [acc]/əˈfɔːrd/; [v]买得起;抽得出时间;担负得起;提供;产生;赐予; [vi]担负得起;买得起; [or]bec2;
overcapacity: [acc]/ˌoʊvərkəˈpæsəti/; [n]生产能力过剩; [or]bec2;
nominal: [acc]/ˈnɑːmɪnl/; [adj]名义上的;象征性的,很少的;名词性的; [or]bec2;
outgoing: [acc]/ˈaʊtɡoʊɪŋ/; [adj]外向的;外出的;乐于助人的;即将离职的,卸任的; [n]流出;开支; [or]bec2;
precedent: [acc]/ˈpresɪdənt/; [n]先例,范例;惯例; [adj]在前的,前面的; [or]bec2;
concept: [acc]/ˈkɑːnsept/; [n]设想;想法;概念;观念; [or]bec2;
streamline: [acc]/ˈstriːmlaɪn/; [n]流线型; [adj]流线型的; [vt]使成流线型;使.简化; [or]bec2;
index: [acc]/ˈɪndeks/; [n]索引;指标,标志;指数; [v]附以索引,编入索引; [or]bec2;
formal: [acc]/ˈfɔːrml/; [adj]正式的;正规的;规范的,合乎规矩的;形式上的;礼节上的; [n]<美>须穿礼服的社交集会;<口>夜礼服; [or]bec2;
telework: [acc]/'teliwə:k/; [n]远距离工作,远程工作; [or]bec2;
extra: [acc]/ˈekstrə/; [adj]额外的,附加的;特优的; [adv]额外地; [n]附加物品;临时演员;(报纸)号外; [or]bec2;
insure: [acc]/ɪnˈʃʊr/; [v]买保险;为..投保,保险; [or]bec2;
tax: [acc]/tæks/; [n]税,税款; [v]对..征税;使负重担; [or]bec2;
sensitive: [acc]/ˈsensətɪv/; [adj]敏感的,过敏的;灵敏的;善解人意的,体恤的; [or]bec2;
continue: [acc]/kənˈtɪnjuː/; [v]继续; [or]bec2;
replicate: [acc]/ˈreplɪkeɪt/; [v]复制;重复,反复; [or]bec2;
lie: [acc]/laɪ/; [n]谎话,假象; [vi]躺,位于;说谎,欺骗; [or]bec2;
appraiser: [acc]/əˈpreɪzər/; [n]鉴定人,估价官; [or]bec2;
feasibility: [acc]/ˌfiːzəˈbɪləti/; [n]可行性,可能性,现实性; [or]bec2;
rational: [acc]/ˈræʃnəl/; [adj]理性的;理智的;合理的; [or]bec2;
plough: [acc]/plaʊ/; [n]犁; [vt]犁,耕;开路;犁除;乘风破浪前进; [vi]开垦;艰难地前进; [or]bec2;
line: [acc]/laɪn/; [n]线,排,路线; [v]画线;排队; [or]bec2;
jeopardise: [acc]/'dʒepədaɪz/; [v]使受危害,使陷险境; [or]bec2;
deteriorate: [acc]/dɪˈtɪriəreɪt/; [v]恶化;变质;衰退; [or]bec2;
speech recognition technology: [acc]/spiːtʃ ˌrekəɡˈnɪʃn tekˈnɑːlədʒi/; [phr]语音识别技术; [or]bec2;
jargon: [acc]/ˈdʒɑːrɡən/; [n]行话,术语;黄锆石; [or]bec2;
spam: [acc]/spæm/; [v]兜售信息(邮件或广告等); [n]垃圾电子邮件; [or]bec2;
axe: [acc]/æks/; [n]斧(子); [v]用斧砍;削除,解雇;大量削减(经费),精简(机构); [or]bec2;
deliver: [acc]/dɪˈlɪvər/; [v]递送,交付;履行;发表(演讲);分娩;投掷; [or]bec2;
earnings: [acc]/ˈɜːrnɪŋz/; [n]工资;收入;收益; [or]bec2;
duty: [acc]/ˈduːti/; [n]责任,职责,义务,税; [or]bec2;
fluctuation: [acc]/ˌflʌktʃuˈeɪʃn/; [n]波动;起伏; [or]bec2;
confine: [acc]/kənˈfaɪn/; [v]限制;监禁; [n]范围,界限,约束,限制; [or]bec2;
foreign: [acc]/ˈfɔːrən/; [adj]外国的,外来的;陌生的,非自身的; [or]bec2;
split: [acc]/splɪt/; [n]劈裂;裂缝;碎片;分裂;不和; [adj]分裂的;不一致的; [v]分开;裂开;被撕破;劈开;割开;撕裂;分配;分担;使分裂; [or]bec2;
depress: [acc]/dɪˈpres/; [vt]使沮丧;使萧条;压下,压低; [or]bec2;
adverse: [acc]/ˈædvɜːrs/; [adj]不利的;(方向上)逆的;在相反的方向上移动(或运转);相反的; [or]bec2;
ratio: [acc]/ˈreɪʃioʊ/; [n]比率,比例; [or]bec2;
entity: [acc]/ˈentəti/; [n]实体,存在; [or]bec2;
remain stable: [acc]/rɪˈmeɪn ˈsteɪbl/; [phr]保持稳定; [or]bec2;
inclination: [acc]/ˌɪnklɪˈneɪʃn/; [n]点头;做.的倾向;意愿;倾斜; [or]bec2;
dismantle: [acc]/dɪsˈmæntl/; [v]拆开;拆除; [or]bec2;
dispatch: [acc]/dɪˈspætʃ/; [v]派遣,调遣;发送(信件,电报等);结束,摆脱掉;匆匆办完; [vt]处决; [n]派遣,调遣;发送;快信,急件;迅速,敏捷; [or]bec2;
bilateral: [acc]/ˌbaɪˈlætərəl/; [adj]双边的,有两面的; [or]bec2;
circumstance: [acc]/ˈsɜːrkəmstæns/; [n]条件;情况;命运;客观环境; [or]bec2;
accrual: [acc]/əˈkruːəl/; [n]自然增长,增长物; [adj]收益的; [or]bec2;
reduction: [acc]/rɪˈdʌkʃn/; [n]减少,折扣,缩减,削减; [or]bec2;
morale: [acc]/məˈræl/; [n]士气,斗志; [or]bec2;
out of time: [acc]/aʊt ʌv taɪm/; [phr]不合拍,不合时宜; [or]bec2;
clone: [acc]/kloʊn/; [n]克隆;无性繁殖系个体;复制品; [v]复制;克隆; [or]bec2;
dispute: [acc]/dɪˈspjuːt/; [n]争论,争端; [v]争执,驳斥; [or]bec2;
ramification: [acc]/ˌræmɪfɪˈkeɪʃn/; [n]分枝;分枝(或分叉)的结果; [or]bec2;
wallet: [acc]/ˈwɑːlɪt/; [n]皮夹,钱包; [or]bec2;
compact: [acc]/ˈkɑːmpækt/; [adj]小巧的,小型的,袖珍的,体积小的;紧密的,紧凑的,密集的; [v]把..压紧;变得坚实; [n]带镜小粉盒;合约,条约; [or]bec2;
rank: [acc]/ræŋk/; [v]排名;把.分等级;列队; [n]等级;军队中的官阶; [adj]繁茂的,讨厌的,难闻的; [or]bec2;
promising: [acc]/ˈprɑːmɪsɪŋ/; [adj]有前途的,有希望的;(前景)光明的; [or]bec2;
receive: [acc]/rɪˈsiːv/; [vt]收到;遭受;对.作出反应;接待,会客,接见,招待;获得;接受,容纳;[电子学] 接收; [v]接球; [or]bec2;
relief: [acc]/rɪˈliːf/; [n]安慰;解脱;减轻;浮雕;凸显,起伏;救济金;救济物资;换班人;接替人; [or]bec2;
straightforward: [acc]/ˌstreɪtˈfɔːrwərd/; [adj]坦率的,笔直的,正直的,直接的; [or]bec2;
entitle: [acc]/ɪnˈtaɪtl/; [v]给(书)题名;给予.权利; [or]bec2;
reluctant: [acc]/rɪˈlʌktənt/; [adj]不情愿的;勉强的; [or]bec2;
store: [acc]/stɔːr/; [n]商店;储存品; [v]贮藏,储存; [or]bec2;
principal: [acc]/ˈprɪnsəpl/; [n]校长,负责人;本金,资本; [adj]主要的,首要的; [or]bec2;
enrol: [acc]/ɪnˈroʊl/; [vi]参加,注册,登记,入学; [vt]登记,使加入,把..记入名册; [or]bec2;
bulletin: [acc]/ˈbʊlətɪn/; [n]公告;公报;公告牌; [or]bec2;
update: [acc]/ˌʌpˈdeɪt/; [v]更新;为..提供最新信息; [n]更新;最新的情况; [or]bec2;
transfer: [acc]/trænsˈfɜːr/; [v]转移;调任;换乘;转变;改编; [n]转让;转移;调任;汇兑; [or]bec2;
bounce: [acc]/baʊns/; [vi]弹起,蹦跳; [vt]使弹起; [v]拒付 (支票); [n]弹跳,弹力,活力; [or]bec2;
subsidiary: [acc]/səbˈsɪdieri/; [adj]辅助的,次要的,附属的; [n]子公司,附属机构; [or]bec2;
consult: [acc]/kənˈsʌlt/; [v]请教,咨询;查阅;商量; [or]bec2;
routine: [acc]/ruːˈtiːn/; [n]常规,例行公事,一套固定舞步(或动作); [adj]例行的,普通的,惯例的; [or]bec2;
smoothly: [acc]/ˈsmuːðli/; [adv]流畅地;顺畅地,流利地;平滑地;平稳地; [or]bec2;
develop an understanding: [acc]/dɪˈveləp ən ˌʌndərˈstændɪŋ/; [phr]理解; [or]bec2;
lottery: [acc]/ˈlɑːtəri/; [n]彩票;碰运气的事,难算计的事;抽彩给奖法; [or]bec2;
power: [acc]/ˈpaʊər/; [n]力量,能力,权力;电源;电力;功率; [v]提供动力;驱动; [or]bec2;
scope: [acc]/skoʊp/; [n]瞄准镜;范围;余地; [or]bec2;
unspectacular: [acc]/ˌʌnspekˈtækjələr/; [adj]不引人注意的; [or]bec2;
forfeiture: [acc]/ˈfɔːrfətʃər/; [n](财产等)没收,(名誉等)丧失; [or]bec2;
advert: [acc]/ˈædvɜːrt/; [n]广告; [v]注意,留意; [or]bec2;
universal: [acc]/ˌjuːnɪˈvɜːrsl/; [adj]普遍存在的;全体的;通用的;宇宙的; [n]普遍原则; [or]bec2;
resurgence: [acc]/rɪˈsɜːrdʒəns/; [n]复活;再现;再起; [or]bec2;
credit: [acc]/ˈkredɪt/; [n]信用;荣誉;学分;信贷;称赞;债权; [v]信赖;归因于;记学分; [or]bec2;
mailshot: [acc]/ˈmeɪlʃɑːt/; [n]邮寄广告; [or]bec2;
blueprint: [acc]/ˈbluːprɪnt/; [n]蓝图,设计图,计划; [vt]制成蓝图,计划; [or]bec2;
port: [acc]/pɔːrt/; [n]舷窗;舱门;港口城市;葡萄酒;港,港口; [or]bec2;
sequence: [acc]/ˈsiːkwəns/; [n]顺序,次序;连续,继续; [or]bec2;
rigor: [acc]/'rɪgə/; [n]严厉;精确;困难境地; [or]bec2;
ink: [acc]/ɪŋk/; [n]墨水,油墨; [or]bec2;
shut down: [acc]/ʃʌt daʊn/; [phr]关闭,(使)停工; [or]bec2;
possess: [acc]/pəˈzes/; [v]拥有,占有;缠住,迷住;支配; [or]bec2;
remain: [acc]/rɪˈmeɪn/; [v]剩余;逗留;保持不变;依然,继续; [n]剩余物;遗迹;残骸; [or]bec2;
multiply: [acc]/ˈmʌltɪplaɪ/; [v]乘;繁殖;增加; [or]bec2;
devise: [acc]/dɪˈvaɪz/; [v]设计,想出;密谋;遗赠(不动产); [n]设计,发明,遗赠; [or]bec2;
restrict: [acc]/rɪˈstrɪkt/; [v]限制;约束; [or]bec2;
copy: [acc]/ˈkɑːpi/; [v]抄写,复制,复印; [n]副本,拷贝; [or]bec2;
identify: [acc]/aɪˈdentɪfaɪ/; [v]认出,联系;识别;确定,鉴定,发现;认为.等同,认为.关系紧密;表明.的身份;认同,有共鸣,有同感; [or]bec2;
underline: [acc]/ˌʌndərˈlaɪn/; [v]划线于.之下;突出显示;强调; [n]下划线;下期节目预告;图下说明文字; [or]bec2;
background: [acc]/ˈbækɡraʊnd/; [n]图片背景,底色;出身;背景;时代背景; [or]bec2;
chronological: [acc]/ˌkrɑːnəˈlɑːdʒɪkl/; [adj]按照时间顺序排列的; [or]bec2;
overpay: [acc]/ˌoʊvərˈpeɪ/; [v]多付,多给报酬; [or]bec2;
tighten: [acc]/ˈtaɪtn/; [v]拉紧;使..更严格; [or]bec2;
postpone: [acc]/poʊˈspoʊn/; [v]延迟,推迟,延缓; [or]bec2;
presentation: [acc]/ˌpriːzenˈteɪʃn/; [n]演讲;报告;介绍;颁奖仪式; [or]bec2;
desperately: [acc]/ˈdespərətli/; [adv]拼命地;绝望地;极度地; [or]bec2;
amenity: [acc]/əˈmenəti/; [n]适意;舒适;便利设施;舒适,愉快;礼仪; [or]bec2;
initiate: [acc]/ɪˈnɪʃieɪt/; [v]开始,发动; [n]新加入组织的人; [or]bec2;
pattern: [acc]/ˈpætərn/; [n]模型,模式;典型;图案;版式;样品; [vi]形成图案; [vt]用图案装饰; [or]bec2;
alert: [acc]/əˈlɜːrt/; [adj]警惕的;充分意识到的; [n]警觉(状态),戒备(状态);警报; [v]向.报警,使警惕;使意识到; [or]bec2;
abuse: [acc]/əˈbjuːs/; [v]虐待;辱骂;(对麻醉毒品,兴奋剂等的)非法服用;滥用; [n]滥用;虐待;辱骂; [or]bec2;
sign: [acc]/saɪn/; [v]签署;使眼色;做暗号;做手势; [n]记号,符号;标志,手势; [or]bec2;
security: [acc]/sɪˈkjʊrəti/; [n]安全;防护措施;债券;抵押物; [or]bec2;
extreme: [acc]/ɪkˈstriːm/; [adj]极端的;极远的;极限的;极度的;偏激的; [n]极端;极度(状态),最大程度; [or]bec2;
shelter: [acc]/ˈʃeltər/; [n]隐蔽处,躲避处(常用来指住处);庇护; [v]遮蔽,掩护,庇护; [or]bec2;
dynamic: [acc]/daɪˈnæmɪk/; [adj]有活力的,有生气的;不断变化的;动态的; [n]活力,动力; [or]bec2;
delegate: [acc]/ˈdelɪɡət/; [n]代表; [v]委派..为代表,授权; [or]bec2;
compulsory: [acc]/kəmˈpʌlsəri/; [adj]强制的,必修的; [or]bec2;
rife: [acc]/raɪf/; [adj]普遍的;流行的; [or]bec2;
entreaty: [acc]/ɪnˈtriːti/; [n]恳求,哀求; [or]bec2;
designate: [acc]/ˈdezɪɡneɪt/; [adj]已受委派而尚未上任的; [v]标出,说出;委任,任命,提名;指定; [or]bec2;
autocratic: [acc]/ˌɔːtəˈkrætɪk/; [adj]独裁的,专断的; [or]bec2;
fiercely: [acc]/ˈfɪrsli/; [adv]猛烈地,凶猛地; [or]bec2;
expenditure: [acc]/ɪkˈspendɪtʃər/; [n](时间,金钱等的)花费,支出,消耗; [or]bec2;
overnight: [acc]/ˌoʊvərˈnaɪt/; [adv]整夜;一夜之间,突然; [adj]晚上的,通宵的;突然的; [n]头天晚上;一夜的逗留; [v]过夜; [or]bec2;
leave: [acc]/liːv/; [v]离开;留下; [n]许可,准假;告别; [or]bec2;
discipline: [acc]/ˈdɪsəplɪn/; [n]纪律;学科;训练; [v]训练;惩罚;管制; [or]bec2;
permanent: [acc]/ˈpɜːrmənənt/; [adj]永久的,持久的; [n]电烫发; [or]bec2;
regeneration: [acc]/rɪˌdʒenəˈreɪʃn/; [n]新生,更新,重建; [or]bec2;
swap: [acc]/swɑːp/; [v]交换;替换;对调; [n]交换;交换物; [or]bec2;
cushion: [acc]/ˈkʊʃn/; [n]坐垫; [v]减轻,缓和; [or]bec2;
allow: [acc]/əˈlaʊ/; [v]准许,允许;同意给;承认; [or]bec2;
terminate: [acc]/ˈtɜːrmɪneɪt/; [adj]终止的;可结尾的; [vi]结束;结尾; [v]使结束,终止; [or]bec2;
correspond: [acc]/ˌkɔːrəˈspɑːnd/; [v]符合;相符,一致;通信; [or]bec2;
hazard: [acc]/ˈhæzərd/; [n]公害;危险;危险的事物;机会; [v]使冒危险;冒险做; [or]bec2;
supervise: [acc]/ˈsuːpərvaɪz/; [v]监督;指导;管理; [or]bec2;
proceeds: [acc]/ˈproʊsiːdz/; [n]收入; [v]进行;前进;(沿特定路线)行进;(尤指打断后)继续说; [or]bec2;
giant: [acc]/ˈdʒaɪənt/; [adj]巨大的;卓越的; [n]巨人;伟人,庞然大物; [or]bec2;
quality assurance: [acc]/ˈkwɑːləti əʃʊrəns/; [phr]质量保证; [or]bec2;
reimburse: [acc]/ˌriːɪmˈbɜːrs/; [v]偿还;赔偿;退还(钱),付还; [or]bec2;
disparate: [acc]/ˈdɪspərət/; [adj]迥然不同的; [or]bec2;
ongoing: [acc]/ˈɑːnɡoʊɪŋ/; [n]进行,前进,发展; [adj]进行中的,不间断的; [or]bec2;
endorse: [acc]/ɪnˈdɔːrs/; [v]赞同,认可;签注(文件); [or]bec2;
confirm: [acc]/kənˈfɜːrm/; [v]确认;证实;批准; [or]bec2;
sheet: [acc]/ʃiːt/; [n]被单;纸张;薄板; [or]bec2;
rebate: [acc]/ˈriːbeɪt/; [vt]减少;打折扣; [vi]退还部分付款,打折扣; [n]折扣; [or]bec2;
boom: [acc]/buːm/; [n]隆隆声;繁荣;景气;激增; [v]发出低沉有回响的声音;迅速发展,蓬勃发展;以低沉有回响的声音发出; [or]bec2;
quotation: [acc]/kwoʊˈteɪʃn/; [n]引文,语录;行情,行市;报价,牌价; [or]bec2;
macroeconomic: [acc]/ˌmækroʊˌekəˈnɑːmɪk/; [adj]宏观经济的; [n]整体经济,宏观经济; [or]bec2;
prerequisite: [acc]/ˌpriːˈrekwəzɪt/; [n]先决条件,必要条件; [adj]必须先具备的,必要的; [or]bec2;
concentrate: [acc]/ˈkɑːnsntreɪt/; [v]全神贯注于,集中于;浓缩; [n]浓缩物; [or]bec2;
phenomenon: [acc]/fəˈnɑːmɪnən/; [n]现象;奇迹,奇事,奇才; [or]bec2;
descent: [acc]/dɪˈsent/; [n]下降,下倾;血统,世系;斜坡,坡道; [or]bec2;
flagship: [acc]/ˈflæɡʃɪp/; [n]旗舰,最重要产品; [or]bec2;
sophisticated: [acc]/səˈfɪstɪkeɪtɪd/; [adj](仪器)精密的,复杂的;老于世故的,老练的,富有经验的;高雅的,精致的; [or]bec2;
business: [acc]/ˈbɪznəs/; [n]商业,生意;事务; [or]bec2;
selection: [acc]/sɪˈlekʃn/; [n]挑选,选择;可供选择的东西,被选中者; [or]bec2;
vendor: [acc]/ˈvendər/; [n]小贩,卖主,供应商; [or]bec2;
subject: [acc]/ˈsʌbdʒɪkt/; [n]科目;主题;受试者;国民; [adj]易患的,服从的; [vt]使服从,使隶属,使遭遇; [or]bec2;
resignation: [acc]/ˌrezɪɡˈneɪʃn/; [n]辞职;辞职书;无奈;顺从; [or]bec2;
vision: [acc]/ˈvɪʒn/; [n]视力;视野;视觉;景象;想象;洞察; [v]幻想,设想; [or]bec2;
trade: [acc]/treɪd/; [n]贸易,商业;职业,行业; [v]经商,交易; [or]bec2;
balloon: [acc]/bəˈluːn/; [n]气球;热气球; [v]充气;膨胀; [adj]气球般的; [or]bec2;
paradigm: [acc]/ˈpærədaɪm/; [n]范例,示范; [or]bec2;
priority: [acc]/praɪˈɔːrəti/; [n]优先;优先权;优先考虑的事;重要事项; [or]bec2;
oversee: [acc]/ˌoʊvərˈsiː/; [v]监督;偷看到,无意中看到;审查;俯瞰; [or]bec2;
mislead: [acc]/ˌmɪsˈliːd/; [v]把..带错路;使误入歧途; [or]bec2;
outlook: [acc]/ˈaʊtlʊk/; [n]景色,风光;观点,看法;前景; [or]bec2;
return: [acc]/rɪˈtɜːrn/; [n]返回;回答; [adj]返回的;报答的;重现的; [v]返回;归还;回报;回答; [or]bec2;
fraud: [acc]/frɔːd/; [n]欺诈,诈骗;骗子; [or]bec2;
mighty: [acc]/ˈmaɪti/; [adj]强大的,强有力的,有势力的; [adv]很,非常; [or]bec2;
reunion: [acc]/ˌriːˈjuːniən/; [n]团聚;再联合;再结合;(亲友等的)重聚; [or]bec2;
session: [acc]/ˈseʃn/; [n]一段时间的(活动);(法庭的)开庭;(议会等的)开会;学期;讲习会; [adj]为录音的歌手或乐队伴奏的; [or]bec2;
wholesale: [acc]/ˈhoʊlseɪl/; [n]批发; [adv]大批大批地; [adj]大规模的;批发的; [v]批发; [or]bec2;
conclude: [acc]/kənˈkluːd/; [v]使结束;推断出;缔结;结束,总结,作决定,作协议; [or]bec2;
distribute: [acc]/dɪˈstrɪbjuːt/; [v]分发,分配,配送;散布; [or]bec2;
tramp: [acc]/træmp/; [n]流浪汉;无业游民;沉重的脚步声;长途跋涉; [v]重步行走;踏;践踏; [or]bec2;
descend: [acc]/dɪˈsend/; [vi]走下;降临; [v]下降,下来;突然访问;下移,下降; [or]bec2;
distrust: [acc]/dɪsˈtrʌst/; [n]不信任; [v]不信任; [or]bec2;
internet advertising: [acc]/ˈɪntərnet ˈædvərtaɪzɪŋ/; [phr]互联网广告; [or]bec2;
conference: [acc]/ˈkɑːnfərəns/; [n]会议;讨论会; [or]bec2;
request: [acc]/rɪˈkwest/; [n]请求;要求; [v]请求;要求; [or]bec2;
vital: [acc]/ˈvaɪtl/; [adj]生命所必需的;必不可少的;至关重要的;有活力的;生命攸关的; [n]要害;重要部分; [or]bec2;
scent: [acc]/sent/; [n]气味;香味;迹象; [v]嗅到;察觉; [or]bec2;
purchase: [acc]/ˈpɜːrtʃəs/; [v]购买; [n]购买;所购之物; [or]bec2;
involved in: [acc]/ɪnˈvɑːlvd ɪn/; [phr]涉及,包含在..中; [or]bec2;
poise: [acc]/pɔɪz/; [v]使相等,使平衡; [n]泰然自若,信心; [or]bec2;
interfere: [acc]/ˌɪntərˈfɪr/; [v]干涉,妨碍;妨碍;干涉; [vi]妨碍; [or]bec2;
curve: [acc]/kɜːrv/; [v]使弯曲; [n]曲线,弯曲; [adj]弯曲的;曲线形的; [or]bec2;
sanction: [acc]/ˈsæŋkʃn/; [n]批准;制裁,处罚; [v]批准,支持,对..实施制裁; [or]bec2;
programme: [acc]/ˈproʊɡræm/; [n]程序表;节目单;计划;节目; [vi]安排节目; [v]编制程序;安排节目;计划; [or]bec2;
vary: [acc]/ˈveri/; [v]相异;改变,变化;使多样化; [or]bec2;
price: [acc]/praɪs/; [n]价格,价钱;代价; [v]标价; [or]bec2;
categorize: [acc]/ˈkætəɡəraɪz/; [v]分类; [or]bec2;
outcome: [acc]/ˈaʊtkʌm/; [n]结果,后果; [or]bec2;
shortage: [acc]/ˈʃɔːrtɪdʒ/; [n]不足,缺乏,短缺; [or]bec2;
willing: [acc]/ˈwɪlɪŋ/; [adj]愿意的,心甘情愿的;乐意的; [or]bec2;
distract: [acc]/dɪˈstrækt/; [v]使分心,转移(注意力),分散(思想); [or]bec2;
generate: [acc]/ˈdʒenəreɪt/; [v]产生(热,电等能量),创造; [or]bec2;
single user: [acc]/ˈsɪŋɡl ˈjuːzər/; [phr]单用户模式,单一使用者; [or]bec2;
symbol: [acc]/ˈsɪmbl/; [n]象征;符号,图标;记号;标志; [or]bec2;
denounce: [acc]/dɪˈnaʊns/; [v]谴责,斥责; [or]bec2;
sole: [acc]/soʊl/; [n]脚底,鞋底,袜底; [adj]唯一的;独有的;单独的; [v]装鞋底; [or]bec2;
buyout: [acc]/ˈbaɪaʊt/; [n]全部买下,买断; [or]bec2;
succeed: [acc]/səkˈsiːd/; [v]成功;接替;继承; [or]bec2;
relationship: [acc]/rɪˈleɪʃnʃɪp/; [n]关系,关联; [or]bec2;
keyword: [acc]/ˈkiːwɜːrd/; [n]关键字; [or]bec2;
craft: [acc]/kræft/; [n]手工艺,手工制品,船,航天器; [v]手工制作,精心制作; [or]bec2;
strengthen: [acc]/ˈstreŋθn/; [v]加强,变坚固,变强大; [or]bec2;
hyperbole: [acc]/haɪˈpɜːrbəli/; [n]夸张的语句;夸张法; [or]bec2;
in charge of: [acc]/ɪn tʃɑrdʒ ʌv/; [phr]负责;主管; [or]bec2;
questionnaire: [acc]/ˌkwestʃəˈner/; [n]调查表,问卷; [or]bec2;
commission: [acc]/kəˈmɪʃn/; [n]委员会;任务;权限;委任;销售佣金; [v]委任; [or]bec2;
icon: [acc]/ˈaɪkɑːn/; [n]图标,肖像,偶像; [or]bec2;
bleak: [acc]/bliːk/; [adj]凄凉的;萧瑟的;阴郁的;无希望的; [or]bec2;
require: [acc]/rɪˈkwaɪər/; [v]需要;(of)要求,命令; [or]bec2;
crunch: [acc]/krʌntʃ/; [n]嘎吱嘎吱的声音; [vt]嘎吱嘎吱地咀嚼; [vi]嘎吱嘎吱地咀嚼;嘎吱嘎吱地动;发嘎吱嘎吱声; [or]bec2;
legitimate: [acc]/lɪˈdʒɪtɪmət/; [adj]合法的;合理的; [vt]使合法;授权;宣布..为合法; [or]bec2;
reassessment: [acc]/ˌriːəˈsesmənt/; [n]重新评估;[经]重新估价;重新考虑; [or]bec2;
reveal: [acc]/rɪˈviːl/; [v]揭示;透露;显示; [or]bec2;
item: [acc]/ˈaɪtəm/; [n]物品;条,条款,项目; [or]bec2;
commonplace: [acc]/ˈkɑːmənpleɪs/; [adj]平常的; [n]老生常谈; [v]把.记入备忘录;由备忘录中摘出; [or]bec2;
storage: [acc]/ˈstɔːrɪdʒ/; [n]储存,贮藏;仓库; [or]bec2;
impulse: [acc]/ˈɪmpʌls/; [n]冲动,脉冲,驱使; [or]bec2;
face: [acc]/feɪs/; [v]面对,朝向,面临; [n]表面;外表;脸,表情; [or]bec2;
racket: [acc]/ˈrækɪt/; [n]吵闹声;球拍; [v]嚷闹,吵闹,纵情欢闹;用球拍打; [or]bec2;
parallel: [acc]/ˈpærəlel/; [adj]平行的;相似的; [n]相似物;平行线; [v]与..相似;与..匹配; [adv]并行地,平行地; [or]bec2;
profit margin: [acc]/ˈprɑːfɪt mɑːrdʒən/; [phr]利润率; [or]bec2;
instrument: [acc]/ˈɪnstrəmənt/; [n]仪器;工具;乐器;手段; [or]bec2;
compromise: [acc]/ˈkɑːmprəmaɪz/; [n]妥协;折中; [v]妥协;使遭受危害; [or]bec2;
production: [acc]/prəˈdʌkʃn/; [n]生成,产生;产量;生产;(戏剧,电影等的)制作; [or]bec2;
reckon: [acc]/ˈrekən/; [vt]计算;想,指望;把.看做; [v]认为; [vi]计算;估计; [or]bec2;
ledger: [acc]/ˈledʒər/; [n]账簿;总账;(手脚架上的)横木;[会计]分类账; [or]bec2;
confuse: [acc]/kənˈfjuːz/; [v]混淆;使混乱,使迷糊; [or]bec2;
accountant: [acc]/əˈkaʊntənt/; [n]会计人员,会计师; [or]bec2;
incident: [acc]/ˈɪnsɪdənt/; [n]事件;事变,军事冲突,冲突;事故; [adj][法]附带的;[光]入射的;易发生的,伴随而来的; [or]bec2;
appeal: [acc]/əˈpiːl/; [vi]呼吁,请求;申诉;有吸引力; [n]呼吁;恳求;(为慈善或好的事业所做的) 筹款努力;(人或物的)吸引力; [or]bec2;
diverse: [acc]/daɪˈvɜːrs/; [adj]不同的,差异的,多种多样的; [or]bec2;
depot: [acc]/ˈdiːpoʊ/; [n]仓库;停车场;航空站; [v]把.存放在储藏处; [adj]药性持久的; [or]bec2;
lessee: [acc]/leˈsiː/; [n](房地产的)租户; [or]bec2;
suspicion: [acc]/səˈspɪʃn/; [n]怀疑,猜疑,疑心;少许; [or]bec2;
stir: [acc]/stɜːr/; [v]搅拌; [n]搅拌;搅动;震动;搅和; [or]bec2;
occur: [acc]/əˈkɜːr/; [vi]发生;出现,存在; [or]bec2;
amalgamate: [acc]/əˈmælɡəmeɪt/; [v]合并,混合; [or]bec2;
bargain: [acc]/ˈbɑːrɡən/; [n]交易,特价商品;便宜货;契约; [vi]讨价还价,讲价;成交; [vt]经讨价还价成交;用.交换; [adj](价格),低廉的; [or]bec2;
commercial: [acc]/kəˈmɜːrʃl/; [adj]商业性的,贸易的; [n]商业广告; [or]bec2;
flexible: [acc]/ˈfleksəbl/; [adj]易曲的,柔软的,灵活的; [or]bec2;
eclectic: [acc]/ɪˈklektɪk/; [adj]折衷主义的;选择的; [n]折衷主义者,折衷派的人; [or]bec2;
operate: [acc]/ˈɑːpəreɪt/; [v]操作;运转;施行手术;运营;(军队)在某一地区作战,执行任务; [or]bec2;
supply: [acc]/səˈplaɪ/; [n]供应(量);补给品,用品(supplies); [vt]供应,提供,补充; [or]bec2;
dramatic: [acc]/drəˈmætɪk/; [adj]戏剧的,戏剧性的;引人注目的;逼真的,刺激的; [or]bec2;
industrial: [acc]/ɪnˈdʌstriəl/; [adj]工业的;产业的; [n]产业工人;工业公司;[商]工业股票; [or]bec2;
endeavour: [acc]/ɪnˈdevər/; [n]尝试; [v]努力; [or]bec2;
strive: [acc]/straɪv/; [v]斗争;努力,奋斗; [or]bec2;
deskill: [acc]/diːˈskɪl/; [v]使(工人)技能过时; [n]为完成而降低所需技术水平;使技术过时; [or]bec2;
money: [acc]/ˈmʌni/; [n]货币;金钱,财富; [or]bec2;
treasury: [acc]/ˈtreʒəri/; [n]国库,金库;财政部;宝库; [or]bec2;
conceal: [acc]/kənˈsiːl/; [v]隐藏,隐瞒,掩盖; [or]bec2;
cement: [acc]/sɪˈment/; [n]水泥,混凝土;胶合剂; [vt]巩固,加强;用水泥涂;接合; [vi]粘牢; [or]bec2;
due: [acc]/duː/; [adv]直接地,确切地; [adj]拖欠的;到期的,预期的;应得的;由于;适当的; [n]会费;应有的权利,应得到的东西; [or]bec2;
graduate: [acc]/ˈɡrædʒuət/; [v]毕业;渐变;渐渐变为;取得资格;授予.学位; [n]大学毕业生;学位获得者; [adj]毕业的;研究生的; [or]bec2;
prototype: [acc]/ˈproʊtətaɪp/; [n]原型,典型,样本; [or]bec2;
database: [acc]/ˈdeɪtəbeɪs/; [n]数据库; [or]bec2;
revitalize: [acc]/ˌriːˈvaɪtəlaɪz/; [v]使复活,使重新充满活力,使复兴; [or]bec2;
guarantee: [acc]/ˌɡærənˈtiː/; [v]保证;担保;提供保修; [n]保证;担保;保修单;保证金; [or]bec2;
realize: [acc]/ˈriːəlaɪz/; [v]认识到,体会到;实现; [or]bec2;
package: [acc]/ˈpækɪdʒ/; [n]包裹;一揽子,一整套; [or]bec2;
copyright: [acc]/ˈkɑːpiraɪt/; [n]版权,著作权; [or]bec2;
falter: [acc]/ˈfɔːltər/; [v]蹒跚,摇摆;踌躇;畏缩; [n]踌躇;支吾;颤抖; [or]bec2;
podium: [acc]/ˈpoʊdiəm/; [n]讲台,(乐队)指挥台;建筑物的墩座;矮墙; [or]bec2;
pride: [acc]/praɪd/; [v]使得意,以.自豪; [n]自豪;骄傲; [or]bec2;
sharp: [acc]/ʃɑːrp/; [adj]锋利的;敏锐的;清晰的; [adv]急剧地;锐利地;突然地;整点; [n](音乐)升半音;磨; [or]bec2;
enrolment: [acc]/ɪnˈroʊlmənt/; [n]登记,注册;入会,入学; [or]bec2;
economical: [acc]/ˌekəˈnɑːmɪkl/; [adj]节约的;经济的;合算的; [or]bec2;
pilot: [acc]/ˈpaɪlət/; [n]领航员;飞行员; [adj]试验性的; [v]给..领航,驾驶;试验; [or]bec2;
succeed in: [acc]/səkˈsid ɪn/; [phr]取得成功; [or]bec2;
goal: [acc]/ɡoʊl/; [n]目标;球门;(进球)得分; [or]bec2;
register: [acc]/ˈredʒɪstər/; [v]登记,注册;(仪表等)显示;留意; [n]登记,注册;现金收纳机; [or]bec2;
stereotype: [acc]/ˈsteriətaɪp/; [n]老套的模式,陈规,成见; [v]对..产生成见; [or]bec2;
drill: [acc]/drɪl/; [n]训练;反复操练;钻头; [v]在..上钻孔;钻孔; [or]bec2;
rapidly: [acc]/ˈræpɪdli/; [adv]迅速地;很快地;立即; [or]bec2;
billion: [acc]/ˈbɪljən/;  num. [美]十亿,[英]万亿;万亿,一万亿;大量,无数; [adj]大量的; [or]bec2;
confront: [acc]/kənˈfrʌnt/; [v]与某人对峙;与..对抗;正视; [or]bec2;
fabulously: [acc]/ˈfæbjələsli/; [adv]难以置信地,惊人地; [or]bec2;
mint: [acc]/mɪnt/; [n]薄荷,薄荷糖,造币厂; [v]铸造(硬币); [or]bec2;
properly: [acc]/ˈprɑːpərli/; [adv]适当地;正确地;恰当地;得体地;完全; [or]bec2;
waive: [acc]/weɪv/; [v]放弃;不坚持;推迟;搁置; [vt]抑制;搁置; [or]bec2;
safety: [acc]/ˈseɪfti/; [n]安全,保险;安全设备,保险装置;安全场所; [adj]保障安全的; [or]bec2;
category: [acc]/ˈkætəɡɔːri/; [n]类别;范畴; [or]bec2;
automaker: [acc]/ˈɔːtoʊmeɪkər/; [n]汽车制造者; [or]bec2;
soar: [acc]/sɔːr/; [v]高飞,翱翔;飞腾;猛增;高飞越过; [n]高飞;高涨; [or]bec2;
consultancy: [acc]/kənˈsʌltənsi/; [n]咨询;顾问的工作;咨询公司; [or]bec2;
fluctuate: [acc]/ˈflʌktʃueɪt/; [v]波动;起伏;涨落; [or]bec2;
give notice: [acc]/ɡɪv ˈnoʊtɪs/; [phr]离职通知; [or]bec2;
workaholic: [acc]/ˌwɜːrkəˈhɔːlɪk/; [n]工作狂,工作第一的人,专心工作的人; [adj]醉心于工作的; [or]bec2;
career: [acc]/kəˈrɪr/; [n]职业,事业;生涯,经历; [vi]全速前进,猛冲; [or]bec2;
slash: [acc]/slæʃ/; [n]砍痕;砍; [v]砍,大幅度削减; [or]bec2;
hand: [acc]/hænd/; [n]手;手掌;指针;掌管; [vt]传递;交给;搀扶;支持; [or]bec2;
capital: [acc]/ˈkæpɪtl/; [n]资金,资本;首都;大写(字母); [adj]大写的;资本的;优秀的;处以死刑的;致命的; [or]bec2;
letterhead: [acc]/ˈletərhed/; [n]信笺抬头,印有抬头的信纸; [or]bec2;
destructive: [acc]/dɪˈstrʌktɪv/; [adj]破坏(性)的,毁灭(性)的; [or]bec2;
assist: [acc]/əˈsɪst/; [n]帮助;助攻; [v]帮助;促进; [or]bec2;
tension: [acc]/ˈtenʃn/; [n](精神上的)紧张,不安;紧张局面;拉紧;张力;电压; [v]绷紧; [or]bec2;
acting: [acc]/ˈæktɪŋ/; [n](影剧的)演技; [adj]演出,扮演; [or]bec2;
stable: [acc]/ˈsteɪbl/; [n]马厩; [adj]稳定的;安定的; [v]使(马)入厩; [or]bec2;
reward: [acc]/rɪˈwɔːrd/; [n]奖品,报酬,回报;悬赏; [v]报答,酬谢; [or]bec2;
fortune: [acc]/ˈfɔːrtʃən/; [n]运气;命运,时运;财产; [or]bec2;
accommodate: [acc]/əˈkɑːmədeɪt/; [v]向.提供住处(或膳宿);给.提供方便;容纳;使适应,顺应; [or]bec2;
infringe: [acc]/ɪnˈfrɪndʒ/; [v]侵犯,违反,侵害; [or]bec2;
abate: [acc]/əˈbeɪt/; [vt]减轻,减少,废除; [vi]减轻,失效; [n]减轻,折扣; [or]bec2;
head: [acc]/hed/; [n]头;上端;领导人; [v]率领;前进;出发; [or]bec2;
straight: [acc]/streɪt/; [adj]直的;正直的; [adv]直接地;不断地,一直地;立即;直地,笔直地; [n]直线;直线部分; [or]bec2;
agent: [acc]/ˈeɪdʒənt/; [n]政府特工;代理商,代理人; [or]bec2;
asset: [acc]/ˈæset/; [n]财产,资产,有价值的东西或人; [or]bec2;
reliance: [acc]/rɪˈlaɪəns/; [n]信任,信心;信赖,依靠;信赖的人,(或物); [or]bec2;
interrupt: [acc]/ˌɪntəˈrʌpt/; [v]打扰;打断,中断;插嘴;妨碍; [or]bec2;
euro: [acc]/ˈjʊroʊ/; [n]欧元(符号€); [adj][大写]欧洲的,欧盟的; [or]bec2;
euphemism: [acc]/ˈjuːfəmɪzəm/; [n]婉言,委婉的说法; [or]bec2;
employment: [acc]/ɪmˈplɔɪmənt/; [n]职业;雇佣;就业;运用; [or]bec2;
status: [acc]/ˈsteɪtəs/; [n]地位;状态;身份; [or]bec2;
report: [acc]/rɪˈpɔːrt/; [n]报告,汇报,报道; [v]报告,汇报,报道; [or]bec2;
contact: [acc]/ˈkɑːntækt/; [v]接触;联系; [n]接触;联系; [adj]保持接触的;由接触引起的;[航]可看见地面景物的; [adv][航]以目力观察(飞行);  int. 开动; [or]bec2;
takeover: [acc]/ˈteɪkoʊvər/; [n]接收,接管,接任;收买; [or]bec2;
accept: [acc]/əkˈsept/; [v]接受;接受(所提供或给予的物品); [or]bec2;
intangible: [acc]/ɪnˈtændʒəbl/; [adj]不可捉摸的,无形的; [n]无形的东西; [or]bec2;
perverse: [acc]/pərˈvɜːrs/; [adj]邪恶的;堕落的;倔强的;违反常情的; [or]bec2;
enthusiastic: [acc]/ɪnˌθuːziˈæstɪk/; [adj]狂热的,极感兴趣的,热情的; [or]bec2;
progress: [acc]/ˈprɑːɡres/; [n]进步;前进,进展; [v]进步,发展; [or]bec2;
seminar: [acc]/ˈsemɪnɑːr/; [n]研究班;研讨会; [or]bec2;
generic: [acc]/dʒəˈnerɪk/; [n]无注册商标产品;通名; [adj]一般的;非商标的;属的,类的; [or]bec2;
normal: [acc]/ˈnɔːrml/; [adj]正常的; [or]bec2;
certificate: [acc]/sərˈtɪfɪkət/; [n]合格证书,文凭;证明,证明书; [v]给..发证书; [or]bec2;
dimension: [acc]/dɪˈmenʃn/; [n]维度;尺寸;尺度;方面; [or]bec2;
burnish: [acc]/ˈbɜːrnɪʃ/; [v]擦亮,磨光; [or]bec2;
quality: [acc]/ˈkwɑːləti/; [n]特性;品性;质量; [adj]优质的; [or]bec2;
vex: [acc]/veks/; [v]使烦恼,使苦恼,使恼怒; [or]bec2;
plaintiff: [acc]/ˈpleɪntɪf/; [n]原告; [or]bec2;
resume: [acc]/ˈrezəmeɪ/; [n]简历; [v]重新开始;继续; [vt]回到;恢复;重新开始; [or]bec2;
property: [acc]/ˈprɑːpərti/; [n]房产;财产;特性;性能; [or]bec2;
satisfy: [acc]/ˈsætɪsfaɪ/; [v](使)满意,满足;符合.的标准;使确信,说服; [or]bec2;
framework: [acc]/ˈfreɪmwɜːrk/; [n]构架,框架,结构;体制,体系; [or]bec2;
throughput: [acc]/ˈθruːpʊt/; [n]吞吐量,产量; [or]bec2;
accord: [acc]/əˈkɔːrd/; [n]协议; [v]授予; [or]bec2;
tenure: [acc]/ˈtenjər/; [n]任期;终身职位; [or]bec2;
cheque: [acc]/tʃek/; [n]支票; [or]bec2;
pirate: [acc]/ˈpaɪrət/; [n]海盗;剽窃者; [v]剽窃; [or]bec2;
weight: [acc]/weɪt/; [n]重力,重量,分量,砝码,重要(性),势力,负担,重累; [v]加重量于,使变重; [or]bec2;
assignment: [acc]/əˈsaɪnmənt/; [n]任务,(课外)作业;分配,委派; [or]bec2;
restructure: [acc]/ˌriːˈstrʌktʃər/; [v]重建,重造,改组; [or]bec2;
specialise in: [acc]/ˈspeʃəlaɪz ɪn/; [v]专门从事,专门研究; [or]bec2;
respond: [acc]/rɪˈspɑːnd/; [vi]作答;对..有效果;做出反应; [v]回应; [or]bec2;
turnaround: [acc]/ˈtɜːrnəraʊnd/; [n]好转,周转时间,转身,回车场,(轮船,飞机的)终点装卸时间; [or]bec2;
prominence: [acc]/ˈprɑːmɪnəns/; [n]卓越;突出物;显著,突出; [or]bec2;
socialise: [acc]/'soʃəlaɪz/; [v]来往,交往,交际; [or]bec2;
systematize: [acc]/ˈsɪstəmətaɪz/; [v]使系统化;使组织化;将.分类; [or]bec2;
simultaneously: [acc]/ˌsaɪmlˈteɪniəsli/; [adv]同时地; [or]bec2;
durable: [acc]/ˈdʊrəbl/; [adj]耐用的,长久的; [n]耐用品; [or]bec2;
project: [acc]/ˈprɑːdʒekt/; [n]项目,工程;专题研究;课题方案; [v]映射,放映;计划,设计,打算,拟订方案;投掷,发射,喷射;表明..的特性,使呈现特性;阐述;突出,伸出;估计,预估; [or]bec2;
incentive: [acc]/ɪnˈsentɪv/; [n]刺激,激励;鼓励; [or]bec2;
investigate: [acc]/ɪnˈvestɪɡeɪt/; [v]调查,研究; [or]bec2;
opening: [acc]/ˈoʊpnɪŋ/; [n]开口;孔;开始;开幕;职位空缺; [adj]开始的,开场的; [or]bec2;
embarrass: [acc]/ɪmˈbærəs/; [vt]使窘迫,使尴尬(尤指在社交场合);困窘,困扰; [or]bec2;
sale: [acc]/seɪl/; [n]廉价出售,销售额,拍卖; [or]bec2;
abroad: [acc]/əˈbrɔːd/; [adv]到国外,在国外;在户外; [or]bec2;
stipend: [acc]/ˈstaɪpend/; [n]奖学金;固定薪金;定期津贴;养老金; [or]bec2;
inflate: [acc]/ɪnˈfleɪt/; [v]充气,膨胀,扩大; [or]bec2;
activity: [acc]/ækˈtɪvəti/; [n]活动;行动;活跃; [or]bec2;
direct: [acc]/dəˈrekt/; [adj]直达的;笔直的;直接的;率直的; [vt]指导,引导;管理;引路,当向导;导演; [vi]指导;导演;领唱; [adv]直接地,径直地; [or]bec2;
prejudice: [acc]/ˈpredʒudɪs/; [n]偏见;成见;损害;侵害; [vt]使抱偏见; [or]bec2;
printer: [acc]/ˈprɪntər/; [n]印刷机,印刷工;打印机; [or]bec2;
monitor: [acc]/ˈmɑːnɪtər/; [n]显示器;监视器;班长; [v]监视;监督;监测; [or]bec2;
hold a meeting: [acc]/hold e ˈmitɪŋ/; [phr]举行会议; [or]bec2;
plunge: [acc]/plʌndʒ/; [v]跳进,(使)投入;使陷入;暴跌; [n]卷入,参与;暴跌,骤减; [or]bec2;
convention: [acc]/kənˈvenʃn/; [n]会议;习俗;惯例; [or]bec2;
charismatic: [acc]/ˌkærɪzˈmætɪk/; [adj]超凡魅力的;神赐能力的;有魅力的; [n]有特恩的基督徒; [or]bec2;
extend: [acc]/ɪkˈstend/; [v]伸展,展开;延伸;涉及;扩展;提供;使.竭尽全力; [or]bec2;
dispose: [acc]/dɪˈspoʊz/; [v]处理,处置,除去;使愿意; [or]bec2;
oblige: [acc]/əˈblaɪdʒ/; [v]迫使,使感激,施恩于,帮忙,使.成为必要; [or]bec2;
protest: [acc]/ˈproʊtest/; [v]抗议;反对; [n]声明,反对; [or]bec2;
goad: [acc]/ɡoʊd/; [vt]驱赶;刺激;鼓励; [n](赶牛用的)刺棒; [or]bec2;
stipulate: [acc]/ˈstɪpjuleɪt/; [v]规定;保证;保证;要求以.为条件; [or]bec2;
overtrade: [acc]/ˌoʊvə'treɪd/; [vi](企业)贸易过度; [or]bec2;
reclaim: [acc]/rɪˈkleɪm/; [v]开拓,开垦;感化;取回;改造;废物回收利用; [or]bec2;
assume: [acc]/əˈsuːm/; [v]猜想;以为,假设;呈现;就职;(想当然地)认为;承担(责任); [or]bec2;
marvel: [acc]/ˈmɑːrvl/; [n]奇迹,奇景;奇才; [v]惊叹,吃惊,诧异; [or]bec2;
analyze: [acc]/ˈænəlaɪz/; [v]分析;细察; [or]bec2;
give a presentation: [acc]/ɡɪv eɪ ˌpriːzenˈteɪʃn/; [phr]做演示,做展示; [or]bec2;
utility: [acc]/juːˈtɪləti/; [n]功用,用途,公用事业,物业; [adj]实用的;通用性的; [or]bec2;
halve: [acc]/hæv/; [v]二等分;平分; [or]bec2;
automate: [acc]/ˈɔːtəmeɪt/; [v]使自动化,自动操作; [or]bec2;
gathering: [acc]/ˈɡæðərɪŋ/; [n]聚会,集会; [or]bec2;
skim: [acc]/skɪm/; [v]掠过;浏览,略读;抹去; [n]撇去浮沫;脱脂乳;(为逃税)隐匿的部分收入; [adj]撇去奶油的;用脱脂乳做的; [or]bec2;
boring: [acc]/ˈbɔːrɪŋ/; [adj]令人厌烦的;单调的;无聊的,乏味的; [or]bec2;
loss: [acc]/lɔːs/; [n]遗失;失败;失去;伤亡及被俘人员; [or]bec2;
standstill: [acc]/ˈstændstɪl/; [n]停止,停顿; [adj]停顿的,停滞的,引起停顿的,造成停滞的; [or]bec2;
regulation: [acc]/ˌreɡjuˈleɪʃn/; [n]法规,条例,规章;管理; [or]bec2;
unfair: [acc]/ˌʌnˈfer/; [adj]不公正的,不公平的; [or]bec2;
undue: [acc]/ˌʌnˈduː/; [adj]过分的,不适当的;过度的;尚未到期的; [or]bec2;
abolish: [acc]/əˈbɑːlɪʃ/; [v]废除,废止;取消,革除; [or]bec2;
take voluntary redundancy: [acc]/teɪk ˈvɑːlənteri rɪˈdʌndənsi/; [phr]自愿裁汰; [or]bec2;
comprehensive: [acc]/ˌkɑːmprɪˈhensɪv/; [adj]综合的;有充分理解力的,悟性好的;全面的,完整的;详尽的;广泛的,无所不包的;广义的; [n]综合测验;综合学校; [or]bec2;
schedule: [acc]/ˈskedʒuːl/; [n]时间表,日程,计划表;清单,节目表; [v]预定,安排; [or]bec2;
inclusive: [acc]/ɪnˈkluːsɪv/; [adj]包含..在内的,包罗广泛的; [or]bec2;
deficit: [acc]/ˈdefɪsɪt/; [n]亏损;赤字;不足额; [or]bec2;
uptight: [acc]/ˌʌpˈtaɪt/; [adj]紧张的; [or]bec2;
server: [acc]/ˈsɜːrvər/; [n]服务生; [or]bec2;
devote: [acc]/dɪˈvoʊt/; [vt]奉献;献身于,专心致力于; [or]bec2;
rapport: [acc]/ræˈpɔːr/; [n]密切关系,交往;和谐一致;意见一致; [or]bec2;
genuine: [acc]/ˈdʒenjuɪn/; [adj]真正的;真的;真诚的; [or]bec2;
publicity: [acc]/pʌbˈlɪsəti/; [n]公开(性),公众的关注;宣传;名声; [or]bec2;
liability: [acc]/ˌlaɪəˈbɪləti/; [n]责任;债务;倾向;可能性;不利因素;惹麻烦的人(或事); [or]bec2;
rating: [acc]/ˈreɪtɪŋ/; [n]评价;等级;等级评定;额定功率;评分,收视率; [or]bec2;
threaten: [acc]/ˈθretn/; [vt]威胁;危及;恐吓;预示..的恶兆; [v]恐吓; [or]bec2;
well-paid: [acc]/'wel'peɪd/; [adj]报酬优厚的,高薪的; [or]bec2;
respect: [acc]/rɪˈspekt/; [n]敬重,尊敬;方面; [v]尊敬,敬重; [or]bec2;
evolution: [acc]/ˌevəˈluːʃn/; [n]进化,演变;发展; [or]bec2;
sole trader: [acc]/sol ˈtredɚ/; [phr]独资经营;个体经营; [or]bec2;
volatile: [acc]/ˈvɑːlətl/; [adj]易气化的;爆炸性的;反复无常的;短暂的;不稳定的; [or]bec2;
slip: [acc]/slɪp/; [v]滑倒,跌落,溜走,疏忽;偷偷地给;被遗忘; [n]溜走;疏忽,错误;纸条; [adj]打有活结的;可拆卸的;滑动的; [or]bec2;
reputable: [acc]/ˈrepjətəbl/; [adj]声誉好的;受尊敬的;卓越的; [or]bec2;
gadget: [acc]/ˈɡædʒɪt/; [n]小装置,小机件,小玩意儿; [or]bec2;
afoul: [acc]/əˈfaʊl/; [adj]相纠缠的,相冲突的; [adv]相纠缠地,相冲突地; [or]bec2;
enhance: [acc]/ɪnˈhæns/; [v]提高(强度,力量,数量等);增加,加强; [or]bec2;
discretion: [acc]/dɪˈskreʃn/; [n]自由裁量权;谨慎;判断力;判定;考虑周到; [or]bec2;
follow: [acc]/ˈfɑːloʊ/; [vi]跟随;接踵而至; [v]追随;跟随;理解;力求上进,追赶;跟随,追随;追踪;继承;随后做;采用;遵循;沿着..走;能理解;追求; [or]bec2;
survive: [acc]/sərˈvaɪv/; [vi]活下来,幸存; [vt]比..活得长;幸存,存活;幸免于难; [or]bec2;
surround: [acc]/səˈraʊnd/; [v]围绕;包围; [n]围绕物,环绕物; [adj]环绕立体声的; [or]bec2;
patronize: [acc]/ˈpeɪtrənaɪz/; [v]惠顾;赞助,资助; [or]bec2;
consistent: [acc]/kənˈsɪstənt/; [adj]始终如一的,持续的,一致的; [or]bec2;
plight: [acc]/plaɪt/; [n]困境; [v]宣誓,保证; [or]bec2;
exert: [acc]/ɪɡˈzɜːrt/; [v]尽(力),运用,发挥; [or]bec2;
backhander: [acc]/ˈbækhændər/; [n]贿赂,回扣,反手一击,逆打; [or]bec2;
abatement: [acc]/əˈbeɪtmənt/; [n]减少,减轻,缓和,减少额,(尤指)减税额; [or]bec2;
focus: [acc]/ˈfoʊkəs/; [n]焦点,聚焦;焦距;关注; [v]使聚焦,集中注意力; [or]bec2;
facilitate: [acc]/fəˈsɪlɪteɪt/; [v]为他人提供方便;使便利; [vt]促进; [or]bec2;
hike: [acc]/haɪk/; [n]远足,徒步旅行;(数量,价格等)增加,上升; [v]作长途徒步旅行;使高涨,提高(价格); [or]bec2;
password: [acc]/ˈpæswɜːrd/; [n]密码,口令; [or]bec2;
fix: [acc]/fɪks/; [n]方位,定位,位置; [vt]使固定;修理;决定;凝视; [vi]固着;变硬;安定; [or]bec2;
legislation: [acc]/ˌledʒɪsˈleɪʃn/; [n]法律,法规,立法,法律的制定(或通过); [or]bec2;
retaliation: [acc]/rɪˌtæliˈeɪʃn/; [n]反击;回敬;报复; [or]bec2;
conflict: [acc]/ˈkɑːnflɪkt/; [n]冲突,(意见)分歧,战斗,斗争; [v]冲突,抵触,争执; [or]bec2;
link: [acc]/lɪŋk/; [n]链接,联系,交通路线; [v]连接,结合; [or]bec2;
behind schedule: [acc]/bɪˈhaɪnd ˈskɛdʒul/; [phr]晚点,比预定计划(时间)晚; [or]bec2;
break even: [acc]/ˈbreɪkˈiːvən/; [phr]不赔不赚,收支相抵; [or]bec2;
tumble: [acc]/ˈtʌmbl/; [v]翻滚;不由自主地卷入;(价格等)暴跌;跌倒,摔下,滚下; [n]跌倒,摔倒; [or]bec2;
inferior: [acc]/ɪnˈfɪriər/; [adj](等级,地位等)下等的,低等的;低劣的; [n]部下,地位低的人;次品; [or]bec2;
surge: [acc]/sɜːrdʒ/; [n]波涛汹涌;波动;激增; [v]波浪般汹涌奔腾;激增; [or]bec2;
undercapitalized: [acc]/ʌndər'kæpɪtəlaɪzd/; [adj]资本不足的,投资不足的; [or]bec2;
expectation: [acc]/ˌekspekˈteɪʃn/; [n]期望;预期,期待;可能性; [or]bec2;
saturate: [acc]/ˈsætʃəreɪt/; [v]使充满,使饱和,使湿透; [or]bec2;
extent: [acc]/ɪkˈstent/; [n]范围;程度;宽度;长度; [or]bec2;
considerable: [acc]/kənˈsɪdərəbl/; [adj]相当大的;重要的;可观的; [or]bec2;
contractual: [acc]/kənˈtræktʃuəl/; [adj]合同的,契约的; [or]bec2;
ambitious: [acc]/æmˈbɪʃəs/; [adj]有抱负的;雄心勃勃的;(计划,想法等)宏大的,艰巨的; [or]bec2;
protection: [acc]/prəˈtekʃn/; [n]保护,防卫,警戒; [or]bec2;
default: [acc]/dɪˈfɔːlt/; [n]违约;缺席;缺乏;默认; [vi]不履行义务;拖欠; [vt]不履行;不参加; [or]bec2;
occasion: [acc]/əˈkeɪʒn/; [n]场合,时候;活动;时机,机会; [v]导致;引起; [or]bec2;
decade: [acc]/ˈdekeɪd/; [n]十年,十年间; [or]bec2;
newspaper advert: [acc]/ˈnuːzpeɪpər ˈædvɜːrt/; [phr]报纸广告; [or]bec2;
service: [acc]/ˈsɜːrvɪs/; [n]服务,帮助;公共设施,公用事业;维修保养;服务机构;发球,发球方式; [v]保养,维修;支付(借款)利息;为..服务,提供服务; [adj](军队)服现役的,服务性的,仆人的,耐用的; [or]bec2;
threat: [acc]/θret/; [n]恐吓;威胁;凶兆; [or]bec2;
pitfall: [acc]/ˈpɪtfɔːl/; [n]陷阱,未料到的危险或困难; [or]bec2;
pare: [acc]/per/; [v]削去,剥去; [or]bec2;
bound: [acc]/baʊnd/; [adj]受约束的;有义务的;一定的; [v]束缚;跳跃着前行; [n]跳跃;范围;界限; [or]bec2;
software: [acc]/ˈsɔːftwer/; [n]软件; [or]bec2;
loan: [acc]/loʊn/; [n]贷款;暂借; [v]借贷; [or]bec2;
personnel: [acc]/ˌpɜːrsəˈnel/; [n]人事部门,员工,人员; [or]bec2;
penetrate: [acc]/ˈpenətreɪt/; [v]刺穿,穿透;进入;了解; [or]bec2;
appendix: [acc]/əˈpendɪks/; [n]附录;阑尾;附属物; [or]bec2;
environment: [acc]/ɪnˈvaɪrənmənt/; [n]环境;外界;工作平台; [or]bec2;
introduce: [acc]/ˌɪntrəˈduːs/; [v]介绍;传入,引进;提出;采用; [or]bec2;
minimize: [acc]/ˈmɪnɪmaɪz/; [v]使缩到最小;达到最低值; [or]bec2;
access: [acc]/ˈækses/; [n]进入;使用权;通道; [v]进入;访问; [or]bec2;
diversify: [acc]/daɪˈvɜːrsɪfaɪ/; [v]使多样化,作多样性的投资; [or]bec2;
style: [acc]/staɪl/; [n]风格;样式; [v]称呼;设计; [or]bec2;
restrain: [acc]/rɪˈstreɪn/; [v]制止(做);抑制(愤怒等),控制;监禁; [or]bec2;
reaction: [acc]/riˈækʃn/; [n]反应能力;反应;生理反应; [or]bec2;
layout: [acc]/ˈleɪaʊt/; [n]布局;(版面)设计; [or]bec2;
face-to-face training: [acc]/ˌfeɪs tə ˈfeɪs ˈtreɪnɪŋ/; [phr]面对面教学; [or]bec2;
motivate: [acc]/ˈmoʊtɪveɪt/; [vt]激励;使有动机;促进;促动;激发..的积极性; [or]bec2;
guideline: [acc]/ˈɡaɪdlaɪn/; [n]指导路线,准则; [or]bec2;
contribute: [acc]/kənˈtrɪbjuːt/; [v]增进,起促成作用;捐献,捐助;..的原因之一;投稿; [or]bec2;
organisation: [acc]/ˌɔːrɡənəˈzeɪʃn/; [n]团体,机构;组织体制; [or]bec2;
search: [acc]/sɜːrtʃ/; [v]搜索;搜寻;探查; [n]搜索;搜寻;探求; [or]bec2;
mutual: [acc]/ˈmjuːtʃuəl/; [adj]互相的;彼此的;共同的; [or]bec2;
debenture: [acc]/dɪˈbentʃər/; [n]信用债券; [or]bec2;
deduct: [acc]/dɪˈdʌkt/; [v]减去; [or]bec2;
distress: [acc]/dɪˈstres/; [n]悲伤,疼痛;痛苦,焦虑;困难,困境; [adj]受灾的;受灾造成的,焦虑的; [v]使痛苦,使焦急;因紧张而困恼;使困苦;迫使; [or]bec2;
diet: [acc]/ˈdaɪət/; [n]日常饮食;(病人或减肥者的)特种饮食;大量; [v]节食; [or]bec2;
mail: [acc]/meɪl/; [v]邮寄; [n]邮件; [or]bec2;
freeze: [acc]/friːz/; [v]冻结;使冻僵; [n]严寒,冻结; [or]bec2;
buzzword: [acc]/ˈbʌzwɜːrd/; [n]流行词,行话,漂亮口号; [or]bec2;
overdraw: [acc]/ˌoʊvərˈdrɔː/; [v]透支,拉过度,夸大; [or]bec2;
dump: [acc]/dʌmp/; [v]倾倒,丢弃;抛弃(某人); [n]垃圾场,废物堆;军需品临时堆放的地方; [or]bec2;
prolong: [acc]/prəˈlɔːŋ/; [v]延长;拉长;拖延; [or]bec2;
verbal: [acc]/ˈvɜːrbl/; [adj]言语的,口头的,动词的; [or]bec2;
forestry: [acc]/ˈfɔːrɪstri/; [n]林学;林业; [or]bec2;
rarely: [acc]/ˈrerli/; [adv]很少,难得; [or]bec2;
outsell: [acc]/ˌaʊtˈsel/; [v]销售量超过..,比..更会推销; [or]bec2;
cite: [acc]/saɪt/; [v]引用,引证;传唤,传讯;表彰,嘉奖; [or]bec2;
preliminary: [acc]/prɪˈlɪmɪneri/; [adj]初步的,预备的; [n]预赛;预考,初试;初步措施; [or]bec2;
voicemail: [acc]/ˈvɔɪsmeɪl/; [n]语音信箱; [or]bec2;
party: [acc]/ˈpɑːrti/; [n]派对,聚会;(共同工作的)队,组; [or]bec2;
learn a great deal: [acc]/lɜːrn eɪ ɡreɪt diːl/; [phr]学到很多; [or]bec2;
combat: [acc]/ˈkɑːmbæt/; [n]战斗,格斗; [v]与.战斗,与.斗争; [adj]战斗的; [or]bec2;
theoretical: [acc]/ˌθiːəˈretɪkl/; [adj]理论(上)的; [or]bec2;
application: [acc]/ˌæplɪˈkeɪʃn/; [n]运用;申请(书);应用程序; [or]bec2;
sustain: [acc]/səˈsteɪn/; [v]维持;支撑,承受;供养;忍受;遭受,蒙受; [or]bec2;
observe: [acc]/əbˈzɜːrv/; [v]观察;注意,遵守;说,评论;庆祝,纪念; [or]bec2;
walk out: [acc]/wɔːk aʊt/; [phr]罢工; [or]bec2;
data: [acc]/ˈdeɪtə/; [n]数据;资料; [or]bec2;
fixed: [acc]/fɪkst/; [adj]固执的;固定的;准备好的;确定的; [v]固定; [or]bec2;
keen: [acc]/kiːn/; [adj]敏锐的;热衷的,热心的;强烈的,渴望的; [v]恸哭; [n]〈英〉号哭,恸哭; [adv]如饥似渴地; [or]bec2;
temp: [acc]/temp/; [n]临时雇员; [v]临时做工; [or]bec2;
appoint: [acc]/əˈpɔɪnt/; [v]委派,任命;约定;确定,指定; [or]bec2;
lucrative: [acc]/ˈluːkrətɪv/; [adj]合算的;获利的;有利可图的; [or]bec2;
strike: [acc]/straɪk/; [v]击打;袭击;罢工; [n]罢工;打击;袭击; [or]bec2;
transcend: [acc]/trænˈsend/; [v]超越(经验,理性,信念等)的范围,超过; [or]bec2;
diligence: [acc]/ˈdɪlɪdʒəns/; [n]勤奋; [or]bec2;
skirt: [acc]/skɜːrt/; [n]裙子; [v]装边于; [or]bec2;
equivalent: [acc]/ɪˈkwɪvələnt/; [adj]相等的;等值的; [n]同义词;等价物; [or]bec2;
combine: [acc]/kəmˈbaɪn/; [v]使混合(结合,组合,联合);结合;联合;组合; [n]联合体,联合企业;联合收割机; [or]bec2;
round: [acc]/raʊnd/; [adj]圆的,球形的; [n]圆,圆形物; [adv]围绕着,循环地; [v]使成圆形; [prep]围着,绕过,在周围; [or]bec2;
downturn: [acc]/ˈdaʊntɜːrn/; [n]低迷时期; [or]bec2;
accompany: [acc]/əˈkʌmpəni/; [v]陪伴;为..伴奏(或伴唱); [or]bec2;
labour: [acc]/ˈleɪbər/; [n]劳动,劳工,分娩; [v]劳动;为.迷惑;过于详尽地阐述; [adj]工党的,支持工党的; [or]bec2;
ahead: [acc]/əˈhed/; [adv]领先;向前,在前面;提前; [adj]在前,向前,提前; [or]bec2;
grow: [acc]/ɡroʊ/; [v]生长,成长;增长;渐渐变得;种植; [or]bec2;
foundry: [acc]/ˈfaʊndri/; [n]铸造场,铸造,铸造类; [or]bec2;
breach: [acc]/briːtʃ/; [n]破裂;裂痕;冲击;违反; [v]使有裂口;破坏; [or]bec2;
perishables: [acc]/ˈperɪʃəblz/; [n]易腐烂的东西; [or]bec2;
chief: [acc]/tʃiːf/; [n]老板,头子;主管;(部落) 首领;酋长;长官; [adj]主要的;首席的; [or]bec2;
produce: [acc]/prəˈduːs/; [v]生产;创作;产生; [vi]创作;生产;产生; [n]农产品; [or]bec2;
squarely: [acc]/ˈskwerli/; [adv]坚定地,诚实地,直接地,正当地; [or]bec2;
industry: [acc]/ˈɪndəstri/; [n]工业,产业;勤劳;专题研究; [or]bec2;
expatriate: [acc]/ˌeksˈpeɪtriət/; [v](使)移居国外;(使)放弃国籍;流放,放逐; [n]被流放者;移居国外者; [adj]移居国外的;被流放的; [or]bec2;
utilize: [acc]/ˈjuːtəlaɪz/; [v]利用;使用; [or]bec2;
uncensored: [acc]/ʌnˈsensərd/; [adj]未经审查的,无保留的,不拘束的; [or]bec2;
define: [acc]/dɪˈfaɪn/; [v]给(词,短语等)下定义;使明确;规定;下定义,构成释义; [or]bec2;
formula: [acc]/ˈfɔːrmjələ/; [n]公式,方程式;配方;方案;方法;配方奶; [or]bec2;
favourable: [acc]/ˈfeɪvərəbl/; [adj]赞许的,称赞的,肯定的;有利的,顺利的,良好的;讨人喜欢的,赢得赞许的;好而不贵的; [or]bec2;
temporary: [acc]/ˈtempəreri/; [adj]暂时的,临时的; [or]bec2;
network: [acc]/ˈnetwɜːrk/; [n]广播网,电视网;网络; [vi]建立关系网; [vt]联播;使联网; [or]bec2;
caution: [acc]/ˈkɔːʃn/; [n]小心;警告;告诫; [v]劝.谨慎小心;警告; [or]bec2;
retrospect: [acc]/ˈretrəspekt/; [n]回顾,追溯; [v]回顾,回想,追溯; [adj]同"retrospective"; [or]bec2;
segment: [acc]/ˈseɡmənt/; [n]部分;片段;(橘子等的)瓣; [v]分割; [or]bec2;
setback: [acc]/ˈsetbæk/; [n]挫折;失败; [or]bec2;
debt: [acc]/det/; [n]债,债务,欠债;人情债; [or]bec2;
jolly: [acc]/ˈdʒɑːli/; [adj]愉快的,欢乐的;宜人的; [adv]很,非常; [or]bec2;
national: [acc]/ˈnæʃnəl/; [n]国民; [adj]国家的,民族的; [or]bec2;
finalize: [acc]/ˈfaɪnəlaɪz/; [v]使结束,使完结,最终确定; [or]bec2;
shift: [acc]/ʃɪft/; [n]转移;替换;轮值; [v]移动;售卖(难卖的物品);换挡;改换,替换; [or]bec2;
recompense: [acc]/ˈrekəmpens/; [v]赔偿,补偿,报酬; [n]报偿,回礼,赔偿; [or]bec2;
undergo: [acc]/ˌʌndərˈɡoʊ/; [v]经历;遭受; [or]bec2;
transnational: [acc]/ˌtrænzˈnæʃnəl/; [adj]超越国界的,跨国的; [or]bec2;
practice: [acc]/ˈpræktɪs/; [v]练习,实践; [n]练习;习惯;业务;实践,实行; [or]bec2;
yearly: [acc]/ˈjɪrli/; [adj]一年的,每年的,一年一度的; [adv]每年,一年一度; [n]年刊;年鉴; [or]bec2;
caption: [acc]/ˈkæpʃn/; [n](报刊的)标题;(插图,照片等的)说明文字; [v]给(图片,照片等)加说明文字; [or]bec2;
appraisal: [acc]/əˈpreɪzl/; [n]评估;估价;评价; [or]bec2;
unemployment: [acc]/ˌʌnɪmˈplɔɪmənt/; [n]失业;失业人数; [or]bec2;
impact: [acc]/ˈɪmpækt/; [n]碰撞,冲击;冲击力;影响; [v]冲击;压紧;产生影响;塞满; [or]bec2;
overriding: [acc]/ˌoʊvərˈraɪdɪŋ/; [adj]最主要的; [or]bec2;
subscribe: [acc]/səbˈskraɪb/; [vi]捐款;订阅;认购(股份); [vt]申请; [or]bec2;
voucher: [acc]/ˈvaʊtʃər/; [n]代金券;证明人;收据;教育补助金券; [vt]为.准备凭据;证实.的可靠性; [or]bec2;
dissent: [acc]/dɪˈsent/; [v]不同意;不信奉国教; [n]异议;(大写)不信奉国教; [or]bec2;
contract: [acc]/ˈkɑːntrækt/; [n]合同,契约; [v]感染(疾病);招致;订合同;订立(婚约);缩减; [or]bec2;
undermine: [acc]/ˌʌndərˈmaɪn/; [v]暗中破坏;逐渐削弱;侵蚀.的基础;在...下挖坑道,从根基处损害; [or]bec2;
recipe: [acc]/ˈresəpi/; [n]方法;食谱; [or]bec2;
helpline: [acc]/ˈhelplaɪn/; [n]热线服务电话; [or]bec2;
channel: [acc]/ˈtʃænl/; [n]频道;渠道,方法;海峡; [v]引导;经沟槽输送; [or]bec2;
cycle: [acc]/ˈsaɪkl/; [n]自行车;周期,循环; [v](英)骑自行车;循环; [or]bec2;
guru: [acc]/ˈɡʊruː/; [n]专家,领袖,古鲁(指印度教等宗教的宗师或领袖); [or]bec2;
economic: [acc]/ˌekəˈnɑːmɪk/; [adj]经济上的,经济学的;合算的;有利可图的; [or]bec2;
expire: [acc]/ɪkˈspaɪər/; [v]期满,(期限)终止;断气,死亡; [or]bec2;
internal: [acc]/ɪnˈtɜːrnl/; [n]内部器官; [adj]体内的,内部的; [or]bec2;
venue: [acc]/ˈvenjuː/; [n]审判地;犯罪地点;发生地点;集合地点; [or]bec2;
development: [acc]/dɪˈveləpmənt/; [n]发展,逐渐形成;开发区;开发; [or]bec2;
accustom: [acc]/əˈkʌstəm/; [v]使习惯于; [or]bec2;
repackage: [acc]/ˌriːˈpækɪdʒ/; [v]重新包装; [or]bec2;
situation: [acc]/ˌsɪtʃuˈeɪʃn/; [n]形势,局面,处境,状况;位置,场所;职位,职务; [or]bec2;
corporate: [acc]/ˈkɔːrpərət/; [adj]公司的;全体的;共同的;(法人)团体的; [or]bec2;
chain: [acc]/tʃeɪn/; [v]束缚;用链条拴住; [n]链;链条;项圈;连锁;一系列; [or]bec2;
represent: [acc]/ˌreprɪˈzent/; [v]代表;象征;表示;描述;阐明;说明;演绎; [or]bec2;
referee: [acc]/ˌrefəˈriː/; [n]裁判员,仲裁者; [v]裁判,仲裁; [or]bec2;
constant: [acc]/ˈkɑːnstənt/; [adj]不变的,始终如一的;持续不断的; [n]常数,恒量; [or]bec2;
prestigious: [acc]/preˈstɪdʒəs/; [adj]有名望的,有威信的; [or]bec2;
withhold: [acc]/wɪðˈhoʊld/; [v]抑制,拒绝给某事物; [or]bec2;
internship: [acc]/ˈɪntɜːrnʃɪp/; [n]实习; [or]bec2;
process: [acc]/ˈprɑːses/; [v]加工;处理; [n]过程,进程;工序,程序;传票; [or]bec2;
put (sb.) through: [acc]/pʊt θrʊ/; [vt]接通(电话),顺利完成; [or]bec2;
cosmetic: [acc]/kɑːzˈmetɪk/; [n]化妆品; [adj]化妆用的,美容的;装门面的 [表不满]; [or]bec2;
outsource: [acc]/ˈaʊtsɔːrs/; [v]外包,外购; [or]bec2;
eliminate: [acc]/ɪˈlɪmɪneɪt/; [v]消灭,铲除;消除,根除;(在比赛中)淘汰; [or]bec2;
chokepoint: [acc]/t'ʃəʊkpɔɪnt/; [n]阻塞点; [or]bec2;
deny: [acc]/dɪˈnaɪ/; [v]否认,拒绝承认,拒绝给予,自制; [or]bec2;
prescriptive: [acc]/prɪˈskrɪptɪv/; [adj](语言学)规范的,规定的,约定俗成的; [or]bec2;
sight: [acc]/saɪt/; [n]视力,看见,视线,景物; [v]瞄准,看见,观测; [adj]见票即付的;即席的; [or]bec2;
overwhelm: [acc]/ˌoʊvərˈwelm/; [v]压垮;不知所措;淹没;打败,压倒; [or]bec2;
amass: [acc]/əˈmæs/; [vi]聚集; [vt]收集;积累,积聚; [or]bec2;
download: [acc]/ˌdaʊnˈloʊd/; [n]下载,下载的文件; [v]下载; [or]bec2;
banner: [acc]/ˈbænər/; [n]旗帜,横幅,大标题; [or]bec2;
beleaguered: [acc]/bɪˈliːɡərd/; [adj]围困的,处于困境的,饱受批评的; [or]bec2;
certified: [acc]/ˈsɜːrtɪfaɪd/; [adj]经证明的,经认证的,有保证的,保证合格的; [or]bec2;
luxury: [acc]/ˈlʌkʃəri/; [adj]奢侈的,豪华的; [n]奢侈,奢华; [or]bec2;
bankrupt: [acc]/ˈbæŋkrʌpt/; [adj]破产的;彻底失败的;彻底缺乏的; [n]破产者; [v]使破产;使枯竭; [or]bec2;
increment: [acc]/ˈɪŋkrəmənt/; [n]增长;增值; [or]bec2;
receptive: [acc]/rɪˈseptɪv/; [adj]善于接受的;能容纳的; [or]bec2;
axis: [acc]/ˈæksɪs/; [n]轴;中心线;坐标轴;基准线; [or]bec2;
obsolescent: [acc]/ˌɑːbsəˈlesnt/; [adj]废退的,即将过时的; [or]bec2;
reassure: [acc]/ˌriːəˈʃʊr/; [v]使放心,使消除疑虑; [or]bec2;
productive: [acc]/prəˈdʌktɪv/; [adj]多产的;产生..的;富有成效的; [or]bec2;
resign: [acc]/rɪˈzaɪn/; [v]辞职; [or]bec2;
composition: [acc]/ˌkɑːmpəˈzɪʃn/; [n]构成;作文;(文章或音乐的)创作;成分; [or]bec2;
literature: [acc]/ˈlɪtrətʃər/; [n]文学;宣传册;文献; [or]bec2;
aviation: [acc]/ˌeɪviˈeɪʃn/; [n]航空,航空学;飞机制造业; [or]bec2;
devastate: [acc]/ˈdevəsteɪt/; [v]摧毁;使垮掉,使不知所措,使陷于混乱; [or]bec2;
insight: [acc]/ˈɪnsaɪt/; [n]深刻的理解,洞察力,见识; [or]bec2;
preference: [acc]/ˈprefrəns/; [n]偏爱;喜爱物; [or]bec2;
evaporate: [acc]/ɪˈvæpəreɪt/; [v]蒸发,失去水分;消失; [or]bec2;
decrease: [acc]/dɪˈkriːs/; [v]减少;减; [n]减;减少; [or]bec2;
centerpiece: [acc]/'sentəˌpiːs/; [n]中心装饰品,(餐桌)中央的摆饰; [or]bec2;
relocate: [acc]/ˌriːˈloʊkeɪt/; [v]重新安置,迁移; [or]bec2;
dispenser: [acc]/dɪˈspensər/; [n]分配者,药剂师,配药师; [or]bec2;
guilt: [acc]/ɡɪlt/; [n]内疚;罪行;罪恶感; [or]bec2;
browse: [acc]/braʊz/; [v]浏览;随意翻阅;(牛,羊等)吃草; [or]bec2;
clarify: [acc]/ˈklærəfaɪ/; [v]阐明,澄清;净化; [or]bec2;
endow: [acc]/ɪnˈdaʊ/; [vt]给予,赋予;认为.具有某种品质;资助,捐助,向.捐钱; [or]bec2;
supplement: [acc]/ˈsʌplɪmənt/; [n]增补,补充物,保健品;附录; [v]补充; [or]bec2;
adhere: [acc]/ədˈhɪr/; [v]遵守;坚持;粘附;附着,粘在..上; [or]bec2;
guide: [acc]/ɡaɪd/; [n]导游;指南; [v]引导,指导;给.领路;给.导游,带领; [or]bec2;
oversight: [acc]/ˈoʊvərsaɪt/; [n]勘漏,疏忽,失察;监督; [or]bec2;
vacant: [acc]/ˈveɪkənt/; [adj]空的,未被占用的;闲置的;空缺的;茫然的; [or]bec2;
assurance: [acc]/əˈʃʊrəns/; [n]信心,自信;保证;保险; [or]bec2;
stagnant: [acc]/ˈstæɡnənt/; [adj]不流动的;停滞的;萧条的; [or]bec2;
chart: [acc]/tʃɑːrt/; [n]图表,表格;航海图;每周排行榜; [v]制成图表;制航海图; [or]bec2;
provision: [acc]/prəˈvɪʒn/; [n](法律等)条款;供应;预备,存粮;必需品; [v]为..提供必需品; [or]bec2;
salary: [acc]/ˈsæləri/; [n]工资,薪水; [or]bec2;
valuation: [acc]/ˌvæljuˈeɪʃn/; [n]估价,评价,鉴定;估定的价值,定价; [or]bec2;
exemplify: [acc]/ɪɡˈzemplɪfaɪ/; [v]举例说明;例示,是..的典范; [or]bec2;
recoup: [acc]/rɪˈkuːp/; [v]收回;恢复;偿还;扣除; [n]获得补偿; [or]bec2;
lavish: [acc]/ˈlævɪʃ/; [adj]奢华的;铺张浪费的; [v]浪费;慷慨给予; [or]bec2;
reverse: [acc]/rɪˈvɜːrs/; [n]失败,挫折,倒退;相反,背面; [v]颠倒,翻转; [adj]相反的,反面的,颠倒的; [or]bec2;
exclusive: [acc]/ɪkˈskluːsɪv/; [adj]独有的;奢华的;排外的; [n]独家新闻; [or]bec2;
extract: [acc]/ɪkˈstrækt/; [v]取出;提取;摘录;设法得到;索取; [n]摘录;提出物; [or]bec2;
nosedive: [acc]/ˈnoʊzdaɪv/; [n]暴跌,(飞机)俯冲; [v]俯冲,暴跌; [or]bec2;
supportive: [acc]/səˈpɔːrtɪv/; [adj]支持的; [or]bec2;
chair: [acc]/tʃer/; [n]椅子;主席(职位);大学教授; [v]担任主席; [or]bec2;
trademark: [acc]/ˈtreɪdmɑːrk/; [n]商标;特征; [v]登记.作为商标; [or]bec2;
unique: [acc]/juˈniːk/; [adj]独特的,独一无二的;(唯一的)特有的;不同寻常的; [or]bec2;
retail: [acc]/ˈriːteɪl/; [adj]零售的; [n]零售; [v]零售,零售价是; [adv]以零售方式,以零售形式; [or]bec2;
nurture: [acc]/ˈnɜːrtʃər/; [v]养育,培育;培植; [n]养育,培养;教养;营养物; [or]bec2;
sack: [acc]/sæk/; [n]一袋;麻袋;开除; [v]开除;劫掠;掠夺; [or]bec2;
embrace: [acc]/ɪmˈbreɪs/; [v]拥抱;包含;欣然接受,乐意采纳; [n]拥抱;接受;领会; [or]bec2;
veteran: [acc]/ˈvetərən/; [n]老兵;退役军人; [adj]经验丰富的;老练的; [or]bec2;
arrears: [acc]/əˈrɪrz/; [n]债,欠债; [or]bec2;
subscription: [acc]/səbˈskrɪpʃn/; [n]订阅;捐款;签署;同意;会费; [adj]收费的; [or]bec2;
subprime: [acc]/ˌsʌb'praɪm/; [n]次优级抵押贷款,次贷; [or]bec2;
proprietary: [acc]/prəˈpraɪəteri/; [adj]所有的;专利的;私人拥有的; [n]所有权;所有物;所有人; [or]bec2;
glory: [acc]/ˈɡlɔːri/; [vi]因某事而喜悦,为某事而欣喜; [n]光荣,荣誉; [or]bec2;
pace: [acc]/peɪs/; [n]速度;步,步伐; [v]踱步; [or]bec2;
exploit: [acc]/ɪkˈsplɔɪt/; [v]剥削,利用;开发,开拓; [n]辉煌功绩; [or]bec2;
function: [acc]/ˈfʌŋkʃn/; [n]功能,作用;函数;应变量;盛大聚会;职务,职责; [v]起作用;正常运转; [or]bec2;
reconcile: [acc]/ˈrekənsaɪl/; [v]和解;调解;调和; [or]bec2;
anticipate: [acc]/ænˈtɪsɪpeɪt/; [v]预测;期待;提早(做); [or]bec2;
bid: [acc]/bɪd/; [n]出价;投标;努力争取; [v]出价;投标;问候;道别;吩咐; [or]bec2;
trend: [acc]/trend/; [n]趋势;倾向;时尚; [v]倾向;走向;转向;使趋向; [or]bec2;
slightly: [acc]/ˈslaɪtli/; [adv]些微地,轻微地,纤细地; [or]bec2;
recruit: [acc]/rɪˈkruːt/; [v]招募(新兵),招收(新成员); [n]新兵,新成员; [or]bec2;
role: [acc]/roʊl/; [n]角色;作用; [or]bec2;
lawyer: [acc]/ˈlɔːjər/; [n]律师; [or]bec2;
curious: [acc]/ˈkjʊriəs/; [adj]好奇的;好管闲事的;古怪的; [or]bec2;
extrovert: [acc]/ˈekstrəvɜːrt/; [v]变成外向性格;使成外向性格; [n]性格外向者; [adj]性格外向的; [or]bec2;
option: [acc]/ˈɑːpʃn/; [n]选择;选择权;选修课; [v]得到或获准进行选择;调动球员; [or]bec2;
refurbish: [acc]/ˌriːˈfɜːrbɪʃ/; [v]刷新,再磨光; [or]bec2;
type: [acc]/taɪp/; [n]类型,种类; [v]打字;[医学]测定(血型);按类型把.归类;成为.的典型;[印刷]浇铸(铅字等); [or]bec2;
upkeep: [acc]/ˈʌpkiːp/; [n]保养,维持;维修费; [or]bec2;
reduce: [acc]/rɪˈduːs/; [v]减少,减小,降低,精简; [or]bec2;
demotivate: [acc]/ˌdiːˈmoʊtɪveɪt/; [vt]使消极,使..失去动力; [or]bec2;
sterling: [acc]/ˈstɜːrlɪŋ/; [n]英国货币; [adj]高尚的;出色的,优秀的;英币的; [or]bec2;
assembly: [acc]/əˈsembli/; [n]集合;集会;装配;立法机构; [or]bec2;
maintain: [acc]/meɪnˈteɪn/; [v]维持,保持;断言,宣称;供养,赡养; [or]bec2;
inventory: [acc]/ˈɪnvəntɔːri/; [n]详细目录;存货清单; [or]bec2;
match: [acc]/mætʃ/; [n]比赛;敌手;伙伴,搭档;婚姻,配偶;火柴; [v]使相配,使对抗; [or]bec2;
niche: [acc]/nɪtʃ/; [n]壁龛;合适的职业,生活方式;(有利可图的)市场,商机; [vt]放在适当的位置; [or]bec2;
annoy: [acc]/əˈnɔɪ/; [v]使烦恼,使生气; [n]烦恼(等于annoyance); [or]bec2;
mainstream: [acc]/ˈmeɪnstriːm/; [n]主流,主要倾向; [v]使.成为主流;将(残障儿童等)纳入正规班级; [adj]主流的; [or]bec2;
desktop: [acc]/ˈdesktɑːp/; [n]桌面;台式机; [adj]台式的;桌上用的; [or]bec2;
sovereignty: [acc]/ˈsɑːvrənti/; [n]主权;主权国家;君主;独立国; [or]bec2;
office: [acc]/ˈɔːfɪs/; [n]办公室;职位;处,局,社; [or]bec2;
adjourn: [acc]/əˈdʒɜːrn/; [v]延期,休会,推迟对.采取行动; [vi]休会; [or]bec2;
reorient: [acc]/ˌriːˈɔːrient/; [v]重定..的方向(或方位); [or]bec2;
expense: [acc]/ɪkˈspens/; [n]开销,开支;花费,费用;代价; [or]bec2;
strain: [acc]/streɪn/; [n]负担;紧张;拉力;(生物体)品种,种类; [v]拉紧;劳累;过分使用; [or]bec2;
declare: [acc]/dɪˈkler/; [vt]表明;宣布;强调;申报(收益);申报(应纳税品); [vi]板球(在击球员还未全部出局时)宣布结束赛局; [or]bec2;
transpire: [acc]/trænˈspaɪər/; [v]蒸发,排出,泄露; [or]bec2;
productivity: [acc]/ˌprɑːdʌkˈtɪvəti/; [n]生产力;生产率;多产; [or]bec2;
push: [acc]/pʊʃ/; [n]推,推力,促进,推进; [v]推,逼迫,推进; [or]bec2;
future: [acc]/ˈfjuːtʃər/; [n]将来,未来;前途; [or]bec2;
intermediary: [acc]/ˌɪntərˈmiːdieri/; [adj]中间的;媒介的;中途的; [n]中间人;仲裁者;调解者;媒介物; [or]bec2;
annul: [acc]/əˈnʌl/; [v]取消,废除,宣告无效; [or]bec2;
ingenuity: [acc]/ˌɪndʒəˈnuːəti/; [n]机灵,心灵手巧,富于创造天赋; [or]bec2;
essence: [acc]/ˈesns/; [n]本质,实质;精髓,精华; [or]bec2;
repay: [acc]/rɪˈpeɪ/; [v]偿还(钱款或债务);报答;回报; [or]bec2;
radical: [acc]/ˈrædɪkl/; [n]激进分子;基础;原子团;根数,根式; [adj]重大的,彻底的;激进的; [or]bec2;
bulk: [acc]/bʌlk/; [n]大批;容量;体积;大块; [adj]大量的;散装的; [v]膨胀;显得重要; [or]bec2;
commodity: [acc]/kəˈmɑːdəti/; [n]商品,货物; [or]bec2;
correlate: [acc]/ˈkɔːrələt/; [v](使)相关联; [n]相关物; [or]bec2;
summary: [acc]/ˈsʌməri/; [n]摘要,总结; [adj]简略的,概要的,即决的; [or]bec2;
volume: [acc]/ˈvɑːljuːm/; [n]音量;数量;容量;册,卷; [or]bec2;
specification: [acc]/ˌspesɪfɪˈkeɪʃn/; [n]规格,载明,详述; [or]bec2;
customer: [acc]/ˈkʌstəmər/; [n]顾客,主顾; [or]bec2;
shrivel: [acc]/ˈʃrɪvl/; [v]枯萎,皱缩; [or]bec2;
vulnerable: [acc]/ˈvʌlnərəbl/; [adj]易受伤的;脆弱的;易受攻击的; [or]bec2;
buzz: [acc]/bʌz/; [v]发出嗡嗡声; [n]嗡嗡声;低沉嘈杂的谈话声; [or]bec2;
department: [acc]/dɪˈpɑːrtmənt/; [n]部门;系;部; [or]bec2;
ownership: [acc]/ˈoʊnərʃɪp/; [n]所有权; [or]bec2;
runaway: [acc]/ˈrʌnəweɪ/; [adj]逃跑的,失控的,迅速的; [n]逃跑者,逃亡; [or]bec2;
defect: [acc]/ˈdiːfekt/; [n]缺陷,缺点,不足之处; [v]背叛,逃跑,开小差; [or]bec2;
intellectual: [acc]/ˌɪntəˈlektʃuəl/; [n]知识分子; [adj]智力的;理智的;需用智力的;聪明的; [or]bec2;
undertake: [acc]/ˌʌndərˈteɪk/; [v]保证;承担,承包; [or]bec2;
contrast: [acc]/ˈkɑːntræst/; [n]差异,对照,对比;对照;对比; [v](with)使与..对比; [or]bec2;
qualification: [acc]/ˌkwɑːlɪfɪˈkeɪʃn/; [n]资格证明;条件;合格证书;资格;限制性条件; [or]bec2;
suspension: [acc]/səˈspenʃn/; [n]悬浮;暂停;停职; [or]bec2;
mobility: [acc]/moʊˈbɪləti/; [n]活动性,灵活性,迁移率,机动性; [or]bec2;
patent: [acc]/ˈpætnt/; [n]专利; [adj]显然的,明显的;专利的;独创的; [v]取得.的专利权; [or]bec2;
downsize: [acc]/ˈdaʊnsaɪz/; [v]缩小规模,以较小尺寸设计或制造; [or]bec2;
desire: [acc]/dɪˈzaɪər/; [n]渴望;欲望;愿望;要求; [vi]有希望,期望,愿望; [vt]希望,渴望;请求,要求; [or]bec2;
portfolio: [acc]/pɔːrtˈfoʊlioʊ/; [n]公文包,文件夹,投资组合;股份单; [or]bec2;
version: [acc]/ˈvɜːrʒn/; [n]版本;译文;(某人对于某件事不同于其他人的)描述,说法; [or]bec2;
prospectus: [acc]/prəˈspektəs/; [n]章程,内容简介;样张;创办计划书; [or]bec2;
hinder: [acc]/ˈhɪndər/; [v]阻碍,妨碍; [adj]后面的,后方的; [or]bec2;
meticulous: [acc]/məˈtɪkjələs/; [adj]谨小慎微的;一丝不苟的; [or]bec2;
harassment: [acc]/həˈræsmənt/; [n]骚扰;扰乱;烦恼事; [or]bec2;
confidential: [acc]/ˌkɑːnfɪˈdenʃl/; [adj]机密的;表示信任的;悄悄的; [or]bec2;
warehouse: [acc]/ˈwerhaʊs/; [n]仓库; [or]bec2;
conglomerate: [acc]/kənˈɡlɑːmərət/; [n]砾岩;联合大企业; [vi]聚集; [adj]混合的;联合大企业的; [vt]使聚集;使结成;结合; [or]bec2;
reflect: [acc]/rɪˈflekt/; [v]倒映;反映,反射;仔细思考;反省; [or]bec2;
whiff: [acc]/wɪf/; [n]一吹,一吸,一阵香气,一点点,香烟的一口; [v]轻轻地吹,喷气,[棒]三击出局; [or]bec2;
special: [acc]/ˈspeʃl/; [adj]特殊的,专门的;附加的,额外的; [n]特色菜;特价;特别节目;专长; [or]bec2;
memorable: [acc]/ˈmemərəbl/; [adj]显著的;难忘的;值得纪念的; [or]bec2;
deference: [acc]/ˈdefərəns/; [n]尊敬,尊重;顺从; [or]bec2;
bond: [acc]/bɑːnd/; [n]束缚物,联结物;凝聚力;债券;保释金;联系; [vi]结合;团结一致; [or]bec2;
upwards: [acc]/ˈʌpwərdz/; [adv]向上;在上部; [or]bec2;
mimic: [acc]/ˈmɪmɪk/; [v]模仿,戏弄; [n]模仿者; [adj]模拟的;假的,伪装的; [or]bec2;
plot: [acc]/plɑːt/; [n]情节,阴谋,小块土地; [v]密谋,计划,为小说写情节; [or]bec2;
liberalize: [acc]/ˈlɪbrəlaɪz/; [v]放宽限制,自由主义化; [or]bec2;
shatter: [acc]/ˈʃætər/; [v]使粉碎;砸碎;打碎;粉碎; [or]bec2;
rework: [acc]/ˌriːˈwɜːrk/; [v]改写,重做,返工; [n]重做的某物; [or]bec2;
adjust: [acc]/əˈdʒʌst/; [v]调整,调节;校正;改变.以适应; [or]bec2;
advocate: [acc]/ˈædvəkeɪt/; [v]提倡;主张;为.辩护; [n]辩护者;提倡者;律师; [or]bec2;
ascend: [acc]/əˈsend/; [v]沿着.上升,攀登; [or]bec2;
booklet: [acc]/ˈbʊklət/; [n]小册子; [or]bec2;
success: [acc]/səkˈses/; [n]成功,成就,胜利,成功的人或事; [or]bec2;
sue: [acc]/suː/; [v]控告,提起诉讼;控告;起诉; [n]女子名(Sue); [or]bec2;
restore: [acc]/rɪˈstɔːr/; [v]恢复;修补;归还; [or]bec2;
controversial: [acc]/ˌkɑːntrəˈvɜːrʃl/; [adj]引起争论的,有争议的; [or]bec2;
employ: [acc]/ɪmˈplɔɪ/; [v]雇用;雇佣;使忙于;使用;用于.; [n]受雇;职业;使用; [or]bec2;
action: [acc]/ˈækʃn/; [n]行动,行为,动作,运转; [v]对...进行处理; [or]bec2;
logistics: [acc]/ləˈdʒɪstɪks/; [n]后勤,后勤学,物流; [or]bec2;
inquiry: [acc]/ˈɪnkwəri/; [n]调查;询问;打听; [or]bec2;
travel: [acc]/ˈtrævl/; [n]旅行,旅游; [v]旅行;行进,被传播;走过,驶过; [or]bec2;
outline: [acc]/ˈaʊtlaɪn/; [n]外形,轮廓;大纲,概要; [v]描绘,画出..的轮廓; [or]bec2;
espouse: [acc]/ɪˈspaʊz/; [v]支持,拥护; [or]bec2;
stub: [acc]/stʌb/; [n]存根;烟蒂;树桩;断株; [v]踩熄;连根拔除; [or]bec2;
batch: [acc]/bætʃ/; [n]一批(人或物);一批生产量; [or]bec2;
notify: [acc]/ˈnoʊtɪfaɪ/; [v]通知,告知;报告; [or]bec2;
ecotourism: [acc]/ˈiːkoʊtʊrɪzəm/; [n]生态旅游; [or]bec2;
spare: [acc]/sper/; [adj]备用的;多余的,闲置的;瘦的; [n]零件,备件; [v]抽出,腾出;免去; [or]bec2;
covet: [acc]/ˈkʌvət/; [v]垂涎;觊觎; [or]bec2;
warning: [acc]/ˈwɔːrnɪŋ/; [n]警告;预告;通知;预兆; [adj]警告的;告诫的;引以为戒的; [v]warn的现在进行时; [or]bec2;
advantage: [acc]/ədˈvæntɪdʒ/; [v]使处于有利地位;有利于;有助于; [n]优势,利益,有利条件; [or]bec2;
stake: [acc]/steɪk/; [n]木桩;赌注;利害关系;股份,股本;(赛马)奖金; [v]下注,以桩来支撑; [or]bec2;
bottleneck: [acc]/ˈbɑːtlnek/; [n]瓶颈口,(喻)交通易阻塞的狭口;妨碍生产流程的一环; [v]阻碍;交通堵塞; [adj](街道等)狭隘的; [or]bec2;
evaluate: [acc]/ɪˈvæljueɪt/; [v]评价;评估; [or]bec2;
part-time: [acc]/ˌpɑːrt ˈtaɪm/; [adj]部分时间的;兼职的; [adv]以部分时间;作为兼职; [or]bec2;
refinance: [acc]/ˌriːˈfaɪnæns/; [v]再筹资金,重新申请贷款; [or]bec2;
probation: [acc]/proʊˈbeɪʃn/; [n]试用;缓刑;察看; [or]bec2;
strongroom: [acc]/ˈstrɔːŋruːm/; [n]保险库; [or]bec2;
circulate: [acc]/ˈsɜːrkjəleɪt/; [v](使)流通;(使)循环;(使)传播,流传; [or]bec2;
impending: [acc]/ɪmˈpendɪŋ/; [adj]即将到来的;迫在眉睫的,紧急的; [or]bec2;
fee: [acc]/fiː/; [n]费用,酬金; [or]bec2;
comprise: [acc]/kəmˈpraɪz/; [v]包含,包括;构成; [or]bec2;
sponsor: [acc]/ˈspɑːnsər/; [n]倡导者;提案人;赞助人;担保人;教父,教母; [vt]发起;倡议;做.的保人;赞助;资助; [or]bec2;
shortcoming: [acc]/ˈʃɔːrtkʌmɪŋ/; [n]短处,缺点; [or]bec2;
orientation: [acc]/ˌɔːriənˈteɪʃn/; [n]信仰;倾向;[计]定向;(学生)迎新会;定向,方向;(任职,上学等之前的) 情况介绍;训练; [or]bec2;
adopt: [acc]/əˈdɑːpt/; [v]收养;采纳,采用; [or]bec2;
upside: [acc]/ˈʌpsaɪd/; [n]好处,优势,上面的部分; [or]bec2;
series: [acc]/ˈsɪriːz/; [n]系列,系列节目;连续比赛;连续,接连; [or]bec2;
drive: [acc]/draɪv/; [v]驾车;驱使; [n]驾车旅行;驾车路程;强烈欲望;动力,干劲;驱动器; [or]bec2;
reinsurance: [acc]/ˌriːɪnˈʃʊrəns/; [n][经]再保险; [or]bec2;
matter: [acc]/ˈmætər/; [v]要紧;有关系; [n]问题,事件,物质; [or]bec2;
edge: [acc]/edʒ/; [n](悬崖,峭壁的)边缘;边缘;锋利,尖锐;刀口,刃;优势; [v]徐徐移动;给.开刃,使锐利; [or]bec2;
interface: [acc]/ˈɪntərfeɪs/; [n]界面;[地质]分界面,接触面; [v]相互作用(或影响);交流,交谈; [or]bec2;
mentality: [acc]/menˈtæləti/; [n]脑力;思想;心理; [or]bec2;
simplify: [acc]/ˈsɪmplɪfaɪ/; [v]精简,使单纯; [or]bec2;
assessment: [acc]/əˈsesmənt/; [n]评估;评价;估价; [or]bec2;
constrict: [acc]/kənˈstrɪkt/; [v]约束,收缩,妨碍; [or]bec2;
survey: [acc]/ˈsɜːrveɪ/; [n]调查;测量;鉴定; [v]测量,勘测;鉴定;调查; [or]bec2;
prowess: [acc]/ˈpraʊəs/; [n]勇敢,不凡的能力;超凡技术; [or]bec2;
fund: [acc]/fʌnd/; [n]资金,基金;存款; [v]拨款,提供基金; [or]bec2;
banking: [acc]/ˈbæŋkɪŋ/; [n]银行业,银行业务; [or]bec2;
regime: [acc]/reɪˈʒiːm/; [n]政权;政治制度;养生法,生活规则; [or]bec2;
profit: [acc]/ˈprɑːfɪt/; [n]利润,盈利;益处; [v]得益,有益于; [or]bec2;
frustrate: [acc]/ˈfrʌstreɪt/; [v]使灰心;挫败;阻挠; [or]bec2;
shipment: [acc]/ˈʃɪpmənt/; [n]装载的货物;装船;装运;装货量; [or]bec2;
leader: [acc]/ˈliːdər/; [n]领导,领袖,指挥者,领先的人; [or]bec2;
induction: [acc]/ɪnˈdʌkʃn/; [n]就职仪式,[物理]感应; [or]bec2;
indemnity: [acc]/ɪnˈdemnəti/; [n]赔偿物;补偿,赔偿;保障; [or]bec2;
fulfil: [acc]/fʊlˈfɪl/; [vt]实现,履行,实践;满足.的要求;使完整; [or]bec2;
manual: [acc]/ˈmænjuəl/; [n]手册;指南; [adj]手的;手制的;手工的;体力的; [or]bec2;
denationalize: [acc]/ˌdiːˈnæʃnəlaɪz/; [v]解除国有化,私有化; [or]bec2;
absenteeism: [acc]/ˌæbsənˈtiːɪzəm/; [n]旷工;旷课; [or]bec2;
unstable: [acc]/ʌnˈsteɪbl/; [adj]不稳定的,不稳固的;易变的;反复无常的; [or]bec2;
fringe: [acc]/frɪndʒ/; [n]刘海;一排;边缘;穗,流苏; [v]形成.的边缘; [or]bec2;
spectrum: [acc]/ˈspektrəm/; [n]光谱,范围,系列; [or]bec2;
crumble: [acc]/ˈkrʌmbl/; [v]弄碎;使破碎;崩溃;破灭; [n]碎屑;面包屑; [or]bec2;
displays: [acc]/dɪˈspleɪz/; [n]陈列品,显示器; [v]显示;陈列;张开;泄露; [or]bec2;
analysis: [acc]/əˈnæləsɪs/; [n]分析;分解;分析报告;精神分析; [or]bec2;
resource: [acc]/ˈriːsɔːrs/; [n]资源,财力,办法; [v]向.提供资金(或设备); [or]bec2;
cashier: [acc]/kæˈʃɪr/; [n]出纳员,收银员; [v]把..撤职;驱逐,革除,废除; [or]bec2;
conduct: [acc]/kənˈdʌkt/; [v]指挥;进行;实施;处理;传导(电,热等);护送; [n]行为,举止;指挥,带领; [or]bec2;
freelance: [acc]/ˈfriːlæns/; [adv]作为自由职业者地; [adj]自由投稿的; [vi]当自由职业者; [or]bec2;
multilateral: [acc]/ˌmʌltiˈlætərəl/; [adj][数学]多边的;多国之间的,多国(或多方)参加的; [or]bec2;
differentiate: [acc]/ˌdɪfəˈrenʃieɪt/; [v]使有差异;区别; [or]bec2;
underlying: [acc]/ˌʌndərˈlaɪɪŋ/; [adj]基本的;潜在的;在下面的; [or]bec2;
acknowledge: [acc]/əkˈnɑːlɪdʒ/; [v]告知收到;对(人)打招呼,招呼(某人)以示相识,致意;就..表示谢忱,鸣谢,感谢,感激,答谢,对..表示感谢;承认(属实),承认(权威,地位); [or]bec2;
luggage: [acc]/ˈlʌɡɪdʒ/; [n]行李箱,行李;衣箱;皮箱; [or]bec2;
overdraft: [acc]/ˈoʊvərdræft/; [n][金融]透支,[金融]透支额; [v][金融]透支; [or]bec2;
caterer: [acc]/ˈkeɪtərər/; [n]备办食物者,备办宴席者; [or]bec2;
markdown: [acc]/ˈmɑːrkdaʊn/; [n]减价; [or]bec2;
cumulative: [acc]/ˈkjuːmjəleɪtɪv/; [adj]渐增的;累积的; [or]bec2;
complex: [acc]/ˈkɑːmpleks/; [adj]复杂的,难解的;复合的; [n]情结;建筑群;综合体,集合体; [or]bec2;
firm: [acc]/fɜːrm/; [n]事务所; [vt]使牢固,使稳固; [vi]变稳固;变坚实; [adj]牢固的,较硬的;坚定的; [adv]稳固地; [or]bec2;
spread: [acc]/spred/; [v]伸开,伸展,散布,传播,摊开,覆盖; [n]伸开,伸展,散布,传播,摊开,范围; [adj]广大的;大幅的;(宝石)薄而无光泽的; [or]bec2;
counteroffensive: [acc]/ˈkaʊntərəfensɪv/; [n]反攻,反击,逆袭; [or]bec2;
yield: [acc]/jiːld/; [v]出产;屈服;弯曲;让行; [n]收益; [or]bec2;
install: [acc]/ɪnˈstɔːl/; [v]安装,安置,使就职; [or]bec2;
stand: [acc]/stænd/; [n]讲台;货摊;看台; [vi]站立;起立; [vt]使站立;维持原状;位于; [or]bec2;
cooperate: [acc]/koʊˈɑːpəreɪt/; [v]协作,合作; [or]bec2;
benchmark: [acc]/ˈbentʃmɑːrk/; [n]基准;标准检查程序; [v]用基准问题测试(计算机系统等); [or]bec2;
conversion: [acc]/kənˈvɜːrʒn/; [n]转变,转换;宗教,信仰上的转变;[经济学]兑换; [or]bec2;
conformity: [acc]/kənˈfɔːrməti/; [n]一致,符合,适合; [or]bec2;
platform: [acc]/ˈplætfɔːrm/; [n]站台;平台;讲台;舞台;论坛; [or]bec2;
interim: [acc]/ˈɪntərɪm/; [n]中间时期,过渡时期; [adj]暂时的; [or]bec2;
designer: [acc]/dɪˈzaɪnər/; [n]设计者,设计师; [adj]由设计师专门设计的;标明设计师姓名的;赶时髦的,流行的; [or]bec2;
atmosphere: [acc]/ˈætməsfɪr/; [n]大气层;大气;空气;气氛; [or]bec2;
revamp: [acc]/ˈriːvæmp/; [v]翻新,整修,升级; [n]改进,换新鞋面; [or]bec2;
mouse: [acc]/maʊs/; [n]鼠,耗子;鼠标; [or]bec2;
attribute: [acc]/əˈtrɪbjuːt/; [v]把.归因于..,把.归咎于; [n]属性;标志;象征;特征; [or]bec2;
challenge: [acc]/ˈtʃælɪndʒ/; [n]挑战;质疑; [v]挑战;质疑; [or]bec2;
statute: [acc]/ˈstætʃuːt/; [n]法令,法规,条例; [or]bec2;
proactive: [acc]/ˌproʊˈæktɪv/; [adj]先发制人的,积极的; [or]bec2;
livelihood: [acc]/ˈlaɪvlihʊd/; [n]生活,生计;谋生方式; [or]bec2;
contradictory: [acc]/ˌkɑːntrəˈdɪktəri/; [n]矛盾的事物,矛盾因素; [adj]反驳的,自相矛盾的;好反驳的; [or]bec2;
elevate: [acc]/ˈelɪveɪt/; [v]上升;提高;举起;提拔; [or]bec2;
reach an agreement: [acc]/ritʃ ən əˈɡrimənt/; [phr]达成一致; [or]bec2;
efficient: [acc]/ɪˈfɪʃnt/; [adj]效率高的;有能力的;能胜任的; [or]bec2;
hesitate: [acc]/ˈhezɪteɪt/; [v]犹豫,踌躇;含糊,支吾,有顾虑; [or]bec2;
bookkeeper: [acc]/ˈbʊkkiːpər/; [n]簿记员;会计员; [or]bec2;
regardless: [acc]/rɪˈɡɑːrdləs/; [adj]不顾的,不注意的; [adv]不顾一切地; [or]bec2;
see one's point: [acc]/siː wʌnz pɔɪnt/; [phr]明白某人的意思; [or]bec2;
impose: [acc]/ɪmˈpoʊz/; [v]把.强加;强制实行,强迫接受; [or]bec2;
gradual: [acc]/ˈɡrædʒuəl/; [adj]逐渐的,逐步的,平缓的; [or]bec2;
sweeping: [acc]/ˈswiːpɪŋ/; [n]扫除;垃圾; [adj]彻底的;广泛的; [v]扫除; [or]bec2;
render: [acc]/ˈrendər/; [v]使成为,致使,使处于(某种状态);提供,给予,以.回报;(以某种方式)表达,表现;翻译;粉刷,往(墙上)抹灰;将(脂肪)熬成油,使熔化; [n]粉刷,打底,交纳; [or]bec2;
hedge: [acc]/hedʒ/; [v]防范,规避;避免直接答复,避免直接回答;围住;用树篱围起; [n]篱笆,树篱;保障; [or]bec2;
adapt: [acc]/əˈdæpt/; [vi]适应不同情况; [vt]使适合;改编; [or]bec2;
settlement: [acc]/ˈsetlmənt/; [n]解决;结算;协议;定居; [or]bec2;
achievable: [acc]/əˈtʃiːvəbl/; [adj]做得成的,可完成的,可有成就的; [or]bec2;
setting: [acc]/ˈsetɪŋ/; [n]设置,调整;环境,背景; [or]bec2;
entrepreneur: [acc]/ˌɑːntrəprəˈnɜːr/; [n]企业家,演出承包人; [or]bec2;
overtime: [acc]/ˈoʊvərtaɪm/; [n]加班时间;延长时间;[体]加时赛;加班; [v]使超过时间; [adj]超时的;加班的; [or]bec2;
brief: [acc]/briːf/; [adj]简短的,扼要的,短暂的,短时间的; [n]摘要,概要,简短声明,诉讼要点;职责; [v]作.的摘要,向.通报情况; [or]bec2;
commerce: [acc]/ˈkɑːmɜːrs/; [n]商业,贸易; [or]bec2;
elite: [acc]/ɪˈliːt/; [n]精英; [adj]高级的; [or]bec2;
elasticity: [acc]/ˌiːlæˈstɪsəti/; [n]弹性,弹力;灵活性; [or]bec2;
sachet: [acc]/sæˈʃeɪ/; [n]小袋,小香袋; [or]bec2;
workload: [acc]/ˈwɜːrkloʊd/; [n]工作量; [or]bec2;
charter: [acc]/ˈtʃɑːrtər/; [n]宪章;特权,豁免权;契约,证书;租赁; [v]包,租(飞机,汽车等); [adj]包租的,租用的; [or]bec2;
procure: [acc]/prəˈkjʊr/; [vt](努力)取得;获得;导致;完成; [vi]介绍娼妓;拉皮条; [or]bec2;
conquer: [acc]/ˈkɑːŋkər/; [v]征服,攻克;破除; [or]bec2;
handout: [acc]/ˈhændaʊt/; [n]宣传单;施舍物;印刷品;讲义;小册子; [or]bec2;
tough: [acc]/tʌf/; [adj]坚韧的;健壮的;嚼不动的;棘手的;困难的; [adv]强硬地,顽强地; [n]暴徒,恶棍; [v]坚持,忍受; [or]bec2;
on schedule: [acc]/ɑːn ˈskedʒʊl/; [phr]按预定时间; [or]bec2;
removal: [acc]/rɪˈmuːvl/; [n]消除,移动;开除,免职;搬运家具; [or]bec2;
reservation: [acc]/ˌrezərˈveɪʃn/; [n](住处,席位的)预订;保留态度,保留意见;(美国印第安部落的)居留地; [or]bec2;
cash: [acc]/kæʃ/; [n]现金; [v]兑现;付(或收)现款; [or]bec2;
consortium: [acc]/kənˈsɔːrtiəm/; [n]联合,财团,合伙; [or]bec2;
moment: [acc]/ˈmoʊmənt/; [n]片刻,瞬间;时刻; [or]bec2;
bureau: [acc]/ˈbjʊroʊ/; [n]局,司,处,社,所; [or]bec2;
lay sb. off: [acc]/leɪ ˈsʌmbədi ɑf/; [v]解雇;关闭;停止活动; [n](临时)解雇期; [or]bec2;
managerial: [acc]/ˌmænəˈdʒɪriəl/; [adj]管理上的,经理的; [or]bec2;
remuneration: [acc]/rɪˌmjuːnəˈreɪʃn/; [n]报酬,酬劳,赔偿; [or]bec2;
highlight: [acc]/ˈhaɪlaɪt/; [vt]使突出,强调,高亮; [n]最精彩的部分,最重要的事件; [or]bec2;
hospitality: [acc]/ˌhɑːspɪˈtæləti/; [n]好客;款待; [or]bec2;
deal with: [acc]/dil wɪθ/; [phr]处理;研究; [or]bec2;
apparent: [acc]/əˈpærənt/; [adj]显然的,明白的,清晰可见的;表面上的,貌似(真实)的; [or]bec2;
involve: [acc]/ɪnˈvɑːlv/; [v]牵涉,涉及;卷入,使参与;吸引;包含,需要,影响; [or]bec2;
vegetarian: [acc]/ˌvedʒəˈteriən/; [n]吃素的人; [adj]素食的; [or]bec2;
exaggerate: [acc]/ɪɡˈzædʒəreɪt/; [vi]夸张; [vt]夸大,夸张;使扩大; [or]bec2;
inspect: [acc]/ɪnˈspekt/; [v]检查,审查; [or]bec2;
mark-up: [acc]/'mɑːk'ʌp/; [n]加价,增高标价; [or]bec2;
interactive: [acc]/ˌɪntərˈæktɪv/; [adj]交互式的; [n]交互式视频设备; [or]bec2;
coach: [acc]/koʊtʃ/; [n]四轮大马车;教练;长途汽车; [v]训练,指导; [or]bec2;
issue: [acc]/ˈɪʃuː/; [n]问题;议题;发行物;子女; [v]发行;发布;分配,分发,给; [or]bec2;
formulate a response: [acc]/ˈfɔːrmjuleɪt eɪ rɪˈspɑːns/; [phr]制定对策,回应; [or]bec2;
dismay: [acc]/dɪsˈmeɪ/; [n]失望;沮丧;惊愕; [v]使惊恐; [or]bec2;
arbitration: [acc]/ˌɑːrbɪˈtreɪʃn/; [n]仲裁,公断; [or]bec2;
plate: [acc]/pleɪt/; [n]盘子,板,片; [v]电镀; [or]bec2;
initiative: [acc]/ɪˈnɪʃətɪv/; [n]主动权,主动性;首创精神;(重要的)法案,倡议; [or]bec2;
distinction: [acc]/dɪˈstɪŋkʃn/; [n]差别,区分;优秀,卓越,杰出;特性,独特,不同凡响;优等评分,荣誉分数,殊荣; [or]bec2;
share: [acc]/ʃer/; [v]合用;分配,均分;分享;分担; [n]一份,份额;股票,股份; [or]bec2;
additional: [acc]/əˈdɪʃənl/; [adj]增加的;附加的; [or]bec2;
whack: [acc]/wæk/; [v]重打;猛击;击败;削减; [n]重击;尝试;份儿;机会; [or]bec2;
prevent: [acc]/prɪˈvent/; [v]预防,阻止; [or]bec2;
implement: [acc]/ˈɪmplɪment/; [n]工具;器具; [v]实施,执行;执行; [or]bec2;
applicant: [acc]/ˈæplɪkənt/; [n]申请人;请求者; [or]bec2;
hindsight: [acc]/ˈhaɪndsaɪt/; [n]后见之明,事后聪明,枪的照门; [or]bec2;
solvent: [acc]/ˈsɑːlvənt/; [adj]有偿付能力的;有溶解力的; [n]溶剂;解决方法; [or]bec2;
command: [acc]/kəˈmænd/; [n]命令,指挥; [v]发布命令,指挥;掌管,控制;指挥,命令;控制,管理; [or]bec2;
forecast: [acc]/ˈfɔːrkæst/; [n]预测;预报; [v]预报,预测; [or]bec2;
sector: [acc]/ˈsektər/; [n](经济等)部门,部分;战区,防区;扇形,扇区; [or]bec2;
urgent: [acc]/ˈɜːrdʒənt/; [adj]急迫的,紧迫的; [or]bec2;
capable: [acc]/ˈkeɪpəbl/; [adj]有本领的,有能力的;有才能的,能干的; [or]bec2;
catalyst: [acc]/ˈkætəlɪst/; [n]催化剂;造成变化的人或事; [or]bec2;
scrutiny: [acc]/ˈskruːtəni/; [n]监视,细看,详细检查,仔细观察; [or]bec2;
active: [acc]/ˈæktɪv/; [adj]积极的,主动的;活跃的,好动的;起作用的,有效的;现役的; [n]积极分子;主动语态; [or]bec2;
refund: [acc]/ˈriːfʌnd/; [v]退款; [n]偿还;退款; [or]bec2;
foundation: [acc]/faʊnˈdeɪʃn/; [n]地基;基础;基金(会);建立;粉底; [or]bec2;
flat: [acc]/flæt/; [adj]平坦的;浅的;平面的;单调的; [n]平面;公寓; [adv]平直地; [or]bec2;
litigation: [acc]/ˌlɪtɪˈɡeɪʃn/; [n]诉讼;起诉; [or]bec2;
image: [acc]/ˈɪmɪdʒ/; [n]图像,形象,映像; [vt]反映;想象;描绘; [or]bec2;
wrap: [acc]/ræp/; [v]裹,包,捆;覆盖; [n]包裹物,覆盖物;外衣; [or]bec2;
capture: [acc]/ˈkæptʃər/; [v]捕获,俘获;俘虏;掌控;使迷住;捕捉,留存; [n]战利品; [or]bec2;
shrink: [acc]/ʃrɪŋk/; [v]收缩;缩小;退缩; [n](非正式用法)心理医生,精神病医生; [or]bec2;
control: [acc]/kənˈtroʊl/; [n]控制;对照实验;控制装置; [vt]控制,管理; [or]bec2;
diminish: [acc]/dɪˈmɪnɪʃ/; [v]减少;失势,削弱.的权势, 减弱.的权势; [or]bec2;
collapse: [acc]/kəˈlæps/; [v](使)倒塌,(使)崩溃,(使)瓦解; [n]倒塌,崩溃,暴跌; [or]bec2;
distinguish: [acc]/dɪˈstɪŋɡwɪʃ/; [v]区别,识别,辨别,使显著; [or]bec2;
donate: [acc]/ˈdoʊneɪt/; [v]捐献;捐赠; [vi]捐献;捐赠; [or]bec2;
statement: [acc]/ˈsteɪtmənt/; [n]声明;结算单,报表;陈述; [or]bec2;
illustrate: [acc]/ˈɪləstreɪt/; [v]举例说明,阐明;图解,加插图; [or]bec2;
relieve: [acc]/rɪˈliːv/; [v]消除,减轻;换班; [or]bec2;
dividend: [acc]/ˈdɪvɪdend/; [n](股份的)红利,回报,效益,被除数; [or]bec2;
provincial: [acc]/prəˈvɪnʃl/; [adj]省的;地方性的;偏狭的; [n]地方人民;乡下人;外地人; [or]bec2;
creative: [acc]/kriˈeɪtɪv/; [adj]创造性的,创意的,创作的; [n](非正式)创意人士; [or]bec2;
decimal: [acc]/ˈdesɪml/; [n]小数; [adj]小数的;十进制的; [or]bec2;
defend: [acc]/dɪˈfend/; [v]防卫,保卫,防守;为..辩护,为..辩解;捍卫,维护; [or]bec2;
renovation: [acc]/ˌrenəˈveɪʃn/; [n]修理;恢复; [or]bec2;
variety: [acc]/vəˈraɪəti/; [n]品种,种类;变化,多样性,多样化; [or]bec2;
pander: [acc]/ˈpændər/; [v]迎合; [n]废除;废止;拉皮条者; [or]bec2;
par: [acc]/pɑːr/; [n]同等,等位,常态,票面价值,[体]标准杆数; [adj]票面的,平常的,标准的; [or]bec2;
solve: [acc]/sɔːlv/; [v]解决;解释,解答; [or]bec2;
prime: [acc]/praɪm/; [adj]首要的,主要的;最好的,第一流的; [n]青春,全盛期,青壮年时期; [v]使准备好; [or]bec2;
merely: [acc]/ˈmɪrli/; [adv]仅仅;仅仅,只不过; [or]bec2;
miniature: [acc]/ˈmɪnətʃər/; [adj]小型的,微小的; [n]微小的模型,缩影,微型人物像; [vt]使成小型;把.画成纤细画;缩写; [or]bec2;
TV commercial: [acc]/ˌtiː ˈviː kəˈmɜːrʃl/; [phr]电视中的商业广告; [or]bec2;
rocket: [acc]/ˈrɑːkɪt/; [n]火箭;芝麻菜; [vi]飞快地移动;猛涨; [or]bec2;
acceptor: [acc]/ək'sɛptɚ/; [n]票据承兑人,受体,接受者,接受器; [or]bec2;
challenging: [acc]/ˈtʃælɪndʒɪŋ/; [adj]具有挑战性的,引起挑战性兴趣的; [v]要求;质疑;反对;向.挑战;盘问; [or]bec2;
player: [acc]/ˈpleɪər/; [n]演奏者;选手,队员;重要参与者;播放器; [or]bec2;
mould: [acc]/moʊld/; [vt]用模子制作;浇铸;塑造;使形成;把.塑造成; [n]霉菌;模子;模型;铸模;性格;气质; [or]bec2;
bribe: [acc]/braɪb/; [v]向.行贿;买通; [n]贿赂;行贿物; [or]bec2;
association: [acc]/əˌsəʊsiˈeɪʃn/; [n]结合;伙伴,关系;协会,联盟,社团;联想; [or]bec2;
trial: [acc]/ˈtraɪəl/; [n]审判,审理;试验;试用;磨炼,苦难; [adj]试验的,试验性的;考验的;审判的; [v]测试; [or]bec2;
configuration: [acc]/kənˌfɪɡjəˈreɪʃn/; [n]配置,布局,构造; [or]bec2;
aspire: [acc]/əˈspaɪər/; [vi]渴望,有志于(与to,for,after连用或后接不定式); [or]bec2;
set targets: [acc]/set ˈtɑːrɡɪts/; [phr]制定目标; [or]bec2;
delicate: [acc]/ˈdelɪkət/; [adj]易碎的,易坏的,脆弱的;(人)娇弱的,体弱多病的;精美的,精致的,精巧的;微妙的,需要谨慎处理的;优美的,优雅的;柔和的,清淡的,淡雅的; [or]bec2;
local: [acc]/ˈloʊkl/; [adj]当地的,本地的;(身体)局部的; [n]当地人; [or]bec2;
irritate: [acc]/ˈɪrɪteɪt/; [v]使烦躁;激怒;使难受; [or]bec2;
refer: [acc]/rɪˈfɜːr/; [v]参考,查看;涉及;归因于;托付;提交;介绍;提到,谈及; [or]bec2;
proportion: [acc]/prəˈpɔːrʃn/; [n]比例;部分;相称; [v]使成比例;分配; [or]bec2;
submit: [acc]/səbˈmɪt/; [v]提交;屈服,使...服从;建议,主张; [or]bec2;
immediate: [acc]/ɪˈmiːdiət/; [adj]直系的;立即的,立刻的;紧邻的; [or]bec2;
proprietor: [acc]/prəˈpraɪətər/; [n]所有人;经营者; [or]bec2;
assemble: [acc]/əˈsembl/; [v]装配(机器等);集合;召集; [or]bec2;
miscellaneous: [acc]/ˌmɪsəˈleɪniəs/; [adj]多种的,混杂的; [n]杂货;杂项; [or]bec2;
recovery: [acc]/rɪˈkʌvəri/; [n]痊愈;恢复,复苏;重获; [or]bec2;
criterion: [acc]/kraɪˈtɪriən/; [n]标准,准则; [or]bec2;
permission: [acc]/pərˈmɪʃn/; [n]允许,同意; [or]bec2;
set the agenda: [acc]/sɛt ði əˈdʒɛndə/; [phr]制定议程; [or]bec2;
intractable: [acc]/ɪnˈtræktəbl/; [adj]棘手的;难治的;倔强的;不听话的; [or]bec2;
partly: [acc]/ˈpɑːrtli/; [adv]部分地,在一定程度上; [or]bec2;
succession: [acc]/səkˈseʃn/; [n]连续,继续;一连串;继承权; [or]bec2;
professional: [acc]/prəˈfeʃənl/; [adj]职业的;专业的; [n]专业人员; [or]bec2;
moderate: [acc]/ˈmɑːdərət/; [adj]适度的,适中的,温和的,稳健的,中等的; [v]使减轻,使缓和; [n]温和主义者;稳健的人; [or]bec2;
buffer: [acc]/ˈbʌfər/; [n]缓冲,缓冲区; [v]缓冲; [or]bec2;
worry: [acc]/ˈwɜːri/; [v](使)焦虑,(使)烦恼; [n]烦恼,焦虑,担忧; [or]bec2;
haggle: [acc]/ˈhæɡl/; [n]讨价还价; [v]争论,讨价还价; [or]bec2;
complicate: [acc]/ˈkɑːmplɪkeɪt/; [v](使)变复杂; [or]bec2;
knowledge: [acc]/ˈnɑːlɪdʒ/; [n]知识,学识,知道,了解; [or]bec2;
blockbuster: [acc]/ˈblɑːkbʌstər/; [n]大片;轰动;巨型炸弹; [or]bec2;
lessor: [acc]/leˈsɔːr/; [n]出租人; [or]bec2;
installation: [acc]/ˌɪnstəˈleɪʃn/; [n]安装,装置;就职; [or]bec2;
effective: [acc]/ɪˈfektɪv/; [adj]有效的,有影响的;实际的;生效的; [or]bec2;
contemplate: [acc]/ˈkɑːntəmpleɪt/; [v]沉思;对..周密考虑;注视; [or]bec2;
solid: [acc]/ˈsɑːlɪd/; [adj]结实的;坚固的;固体的; [n]固体; [or]bec2;
optimize: [acc]/ˈɑːptɪmaɪz/; [vt]使完善,使优化; [or]bec2;
collaboration: [acc]/kəˌlæbəˈreɪʃn/; [n]合作,协作;勾结; [or]bec2;
upturn: [acc]/ˈʌptɜːrn/; [n]情况好转; [v]朝上,向上;翻转; [or]bec2;
route: [acc]/raʊt/; [n]路线;固定路线;途径;渠道; [vt]按某路线发送;给.规定路线[次序,程序]; [or]bec2;
foremost: [acc]/ˈfɔːrmoʊst/; [adj](位置或时间),最先的;首要的; [adv]首先,第一; [or]bec2;
resonate: [acc]/ˈrezəneɪt/; [v]共鸣,共振; [or]bec2;
tariff: [acc]/ˈtærɪf/; [n]关税,价目表; [vt]征收关税;定税率;定收费标准; [or]bec2;
upfront: [acc]/ˌʌpˈfrʌnt/; [adv]预先地,在前面地; [adj]在前面的;预付的;直率的; [or]bec2;
poll: [acc]/poʊl/; [n]投票,投票数;投票站;民意测验; [v]获得(票数); [adj][法]当事人一方作成的; [or]bec2;
administer: [acc]/ədˈmɪnɪstər/; [v]管理;执行;实施;给予;用(药); [or]bec2;
backing: [acc]/ˈbækɪŋ/; [n]支持,背衬,伴奏; [or]bec2;
patient: [acc]/ˈpeɪʃnt/; [n]病人,患者; [adj]有耐心的,能忍耐的; [or]bec2;
impractical: [acc]/ɪmˈpræktɪkl/; [adj]不切实际的,不能实现的; [or]bec2;
shorten: [acc]/ˈʃɔːrtn/; [v]缩短,(使)变短; [or]bec2;
available: [acc]/əˈveɪləbl/; [adj]可得到的,可利用的,有空的,有效的; [or]bec2;
clinch: [acc]/klɪntʃ/; [n]扭抱;紧紧相拥; [v]达成,取得;解决; [or]bec2;
pioneering: [acc]/ˌpaɪəˈnɪrɪŋ/; [adj]首创的;先驱的; [or]bec2;
limitation: [acc]/ˌlɪmɪˈteɪʃn/; [n]限制,局限性; [or]bec2;
folder: [acc]/ˈfoʊldər/; [n]文件夹,折叠者,折叠式印刷品; [or]bec2;
button: [acc]/ˈbʌtn/; [n]纽扣;按钮(开关); [v]扣紧;扣上纽扣; [or]bec2;
object: [acc]/ˈɑːbdʒekt/; [n]物体;宾语;目标; [v]提出..作为反对的理由;反对; [or]bec2;
encourage: [acc]/ɪnˈkɜːrɪdʒ/; [v]鼓励,支持;促使;怂恿; [or]bec2;
journal: [acc]/ˈdʒɜːrnl/; [n]定期刊物,杂志;日报;日记; [or]bec2;
abort: [acc]/əˈbɔːrt/; [v]异常中断,中途失败,流产,发育不全; [or]bec2;
scale: [acc]/skeɪl/; [n]天平,磅秤;刻度,尺度,标度;等级,级别, 等级体系;鳞片,鳞状物;规模;水垢,牙垢; [v]攀登;按比例决定;称重;刮鳞,剥落; [or]bec2;
field: [acc]/fiːld/; [n]田野,大片地方;运动场;领域;战场;全体参赛者; [v]处理,应付;选派.上场;把.投入使用; [or]bec2;
counter: [acc]/ˈkaʊntər/; [n]柜台;回击,反击; [v]抵消,抗衡; [adv]相反地; [or]bec2;
ambition: [acc]/æmˈbɪʃn/; [n]雄心,强烈欲望,抱负;(具体的)追求目标; [vt]追求;有.野心; [or]bec2;
redundant: [acc]/rɪˈdʌndənt/; [adj]多余的,过剩的;被下岗的; [or]bec2;
gross: [acc]/ɡroʊs/; [adj]总的,毛重的;恶心的;粗鲁的; [n]总量,总额; [adv]总共地; [vt]总共赚得; [or]bec2;
announce: [acc]/əˈnaʊns/; [vt]宣布,宣告;预示;播报; [vi]作播音员,宣布竞选; [or]bec2;
maritime: [acc]/ˈmærɪtaɪm/; [adj]海事的,海上的,沿海的,近海的;海员的,水手的; [or]bec2;
rumour: [acc]/ˈruːmər/; [n]谣言,传闻; [v]谣传,传闻; [or]bec2;
sheer: [acc]/ʃɪr/; [adj]陡峭的;纯粹的; [v](off)急转向,偏离; [n]透明薄纱,透明布料的衣服; [adv]完全地,全然;垂直地,陡峭地; [or]bec2;
investment: [acc]/ɪnˈvestmənt/; [n]投资,投资额;投入; [or]bec2;
tender: [acc]/ˈtendər/; [adj]温柔的;嫩的;柔弱的,脆弱的;痛的; [n]煤水车,附属船;投标; [v]提出(希望对方接受的意见等); [or]bec2;
tactic: [acc]/ˈtæktɪk/; [n](达到目的)手段,战术,策略; [adj]按顺序的;依次排列的; [or]bec2;
ensure: [acc]/ɪnˈʃʊr/; [v]确保,保证; [or]bec2;
outstanding: [acc]/aʊtˈstændɪŋ/; [adj]杰出的,突出的,显著的;尚未偿还的; [or]bec2;
photocopier: [acc]/ˈfoʊtoʊkɑːpiər/; [n]复印机; [or]bec2;
payroll: [acc]/ˈpeɪroʊl/; [n]工资单; [or]bec2;