Aerosol: [a]/ˈeərəsɒl/; [n]<物化>气溶胶;气雾剂;喷雾器;浮质; [adj]喷雾的;喷雾器的; [add]pl/aerosols; [or]unix;
Factice: [a]/'fæktis/; [n]硫化油膏;<化工>油膏,油胶; [or]unix;
Indanthrene: [a]/in'dænθri:n/; [n]<染料>阴丹士林,靛蒽醌; [or]unix;
Leatherette: [a]/ˌleðəˈret/; [n]<皮革>人造革;假皮; [or]unix;
Vitaglass: [a]/'vaɪtə'glɑs/; [n]维他玻璃;<玻璃>透紫外线玻璃; [or]unix;
Xylonite: [a]/'zaɪlə,naɪt/; [n]赛璐珞,<塑料>假象牙;电影; [or]unix;
abelite: [a]/'eibə,lait/; [n]<化工>阿贝立特炸药; [or]unix;
absorbency: [a]/əbˈzɔːbənsi; əbˈsɔːbənsi/; [n]吸收能力;吸收性;吸墨性;<物化>吸光率; [or]unix;
acidifier: [a]/ə'sɪdɪfaɪə/; [n]<助剂>酸化剂;成酸剂; [or]unix;
acidimetry: [a]/,æsə'dɪmətri/; [n]<分化>酸量滴定法; [or]unix;
acidometer: [a]/,æsi'dɔmitə/; [n]<分化>酸度计; [or]unix;
acidotic: [a]/,æsi'dɔtik/; [adj]酸中毒的;<分化>定酸量的; [or]unix;
acrometer: [a]/ə'krɔmitə/; [n]<油气>油类比重计; [or]unix;
activable: [a]/'æktivəbl/; [adj]<物化>能被活化的; [or]unix;
activator: [a]/'æktɪveɪtə/; [n]催化剂;<助剂>活化剂;<助剂>激活剂;触媒剂; [add]pl/activators; [or]unix;
adinole: [a]/'ædinəul/; [n]<岩>钠长英板岩; [or]unix;
adopter: [a]/əˈdɑːptər/; [n]养父母;<化工>接受管; [add]pl/adopters; [or]unix;
aerogel: [a]/'eərədʒel/; [n]<物化>气凝胶; [or]unix;
aerosol: [a]/ˈeərəsɒl/; [n]<物化>气溶胶;气雾剂;喷雾器;浮质; [adj]喷雾的;喷雾器的; [add]pl/aerosols; [or]unix;
agglomerant: [a]/ə'ɡlɔmərənt/; [n]<胶粘>粘结剂,<助剂>凝聚剂; [or]unix;
ailsyte: [a]/'eilsait/; [n]<岩>钠闪微岗岩; [or]unix;
akenobeite: [a]/,ækə'nəubi,ait/; [n]<岩>明延岩; [or]unix;
akerite: [a]/'ækərait/; [n]<岩>英辉正长岩;尖晶石; [or]unix;
albitite: [a]/'ælbɪtaɪt/; 钠长石岩; <岩>钠长岩; [or]unix;
albitophyre: [a]/æl'bitə,faiə/; [n]<岩>钠长斑岩; [or]unix;
alcogel: [a]/'ælkədʒel/; [n]<物化>醇凝胶; [or]unix;
alkalimetry: [a]/,ælkɜː'lɪmɪtrɪ/; [n]<分化>碱量滴定法;<分化>碱测定法; [or]unix;
allivalite: [a]/'ælivə,lait/; [n]<岩>橄长岩;橄榄钙长岩; [or]unix;
allochetite: [a]/,ælə'ketait/; [n]<岩>霞辉二长斑岩; [or]unix;
allotrope: [a]/ˈælətrəʊp/; [n]<物化>同素异形体; [or]unix;
allotropism: [a]/ə'lɑtrəpɪzəm/; [n]同素异形性,<物化>同素异形现象(等于allotropy); [or]unix;
almandite: [a]/'ælmən,dait/; [n]<宝>贵榴石; [or]unix;
alnoite: [a]/'ælnə,ait/; [n]<岩>黄长煌斑岩,橄辉煌斑岩; [or]unix;
alsbachite: [a]/'ɔ:lzbɑ:kait/; [n]<岩>榴云细斑岩; [or]unix;
alumina: [a]/əˈluːmɪnə/; [n]<无化>氧化铝;矾土; [or]unix;
aluminate: [a]/ə'ljuːmɪneɪt/; [n]<无化>铝酸盐; [or]unix;
aluminiferous: [a]/ə,ljuːmɪ'nɪfərəs/; [adj]含铝的; [n]<岩>铝铁岩; [or]unix;
aluminosilicate: [a]/ə,ljʊməno'sɪləkɪt/; [n]<无化>铝硅酸盐;铝矽酸盐; [or]unix;
amatol: [a]/'æmətɒl/; [n]<化工>阿马托炸药(一种强力炸药); [or]unix;
ambonite: [a]/'æmbənait/; [n]<岩>堇青安山岩; [or]unix;
amethyst: [a]/ˈæməθɪst/; [n]紫水晶;<宝>紫晶;紫色; [add]pl/amethysts; [or]unix;
aminoplast: [a]/ə'miːnəplæst/; 聚酰胺塑料; <塑料>氨基塑料; [or]unix;
ammonation: [a]/,æmə'neiʃən/; [n]<无化>氨合作用; [or]unix;
ammonia: [a]/əˈməʊniə/; [n]<无化>氨,阿摩尼亚; [or]unix;
ammoniacal: [a]/,æmə(ʊ)'naɪək(ə)l/; [adj]<无化>氨的;含氨的; [or]unix;
ammonification: [a]/ə,mɒnɪfɪ'keɪʃən/; [n]<无化>氨化;加氨; [or]unix;
ammonium: [a]/əˈməʊniəm/; [n]<无化>铵;氨盐基; [or]unix;
ampelite: [a]/'æmpəlait/; [n]<岩>黄铁碳质页岩; [or]unix;
amphibolite: [a]/æm'fɪbəlaɪt/; [n]<岩>闪岩,角闪岩; [or]unix;
anabohitsite: [a]/,ænəbəu'hit,sait/; [n]<岩>铁橄苏辉岩; [or]unix;
ankaramite: [a]/,æŋkə'rɑ:mait/; [n]橄榄辉玄岩;<岩>富辉橄玄岩;钭长辉石岩; [or]unix;
ankaratrite: [a]/,æŋkə'rɑ:trait/; [n]<岩>橄霞玄武岩;<岩>黄橄霞玄岩; [or]unix;
antalkali: [a]/ænt'ælkəlaɪ/; [n]<助剂>抗碱剂;碱性中和剂; [add]pl/antalkalies或antalkalis; [or]unix;
anticatalyst: [a]/,æntɪ'kætəlɪst/; [n]<物化>反催化剂;抗化剂; [or]unix;
antichlor: [a]/'æntɪklɔː/; [n]除氯剂,<助剂>去氯剂;阴氢剂; [or]unix;
anticorrosive: [a]/,æntɪkə'rəʊsɪv/; [adj]<化工>防蚀的; [n]<助剂>防腐剂; [or]unix;
antifreeze: [a]/ˈæntifriːz/; [n]<助剂>防冻剂; [or]unix;
antimonate: [a]/'æntɪmə,net/; [n]<无化>锑酸盐; [or]unix;
antimonial: [a]/,æntɪ'məʊnjəl/; [adj]锑的;含锑的; [n]<无化>含锑药剂; [or]unix;
antimonite: [a]/'æntimə,nait/; [n]<无化>亚锑酸盐;辉锑矿; [or]unix;
aphanite: [a]/'æfənaɪt/; [n]<岩>非显晶岩;<岩>隐晶岩; [or]unix;
aplite: [a]/'æplaɪt/; [n]半花岗岩;<岩>细晶岩(等于haplite); [or]unix;
apophorometer: [a]/,æpəfə'rɔmitə/; [n]<分化>升华仪; [or]unix;
appinite: [a]/'æpinait/; [n]<岩>富闪深成岩类; [or]unix;
apyrous: [a]/e'paɪrəs/; [adj]<化工>耐火的;不易燃的; [or]unix;
aquamarine: [a]/ˌækwəməˈriːn/; [n]<宝>海蓝宝石;碧绿色,浅绿色; [add]pl/aquamarines; [or]unix;
arapahite: [a]/ə'ræpəhait/; [n]磁铁玄武岩;<岩>磁玄岩; [or]unix;
argentometry: [a]/ɑ:dʒən'tɔmitri/; [n]<分化>银盐定量; [or]unix;
ariegite: [a]/,æri'edʒait/; [n]<岩>尖榴辉岩;尖馏辉岩; [or]unix;
arizonite: [a]/,æri'zəunait/; [n]红钛铁矿;<岩>正长脉岩; [or]unix;
arkose: [a]/'ɑːkəʊs; -z/; [n]<岩>长石砂岩; [or]unix;
arsenate: [a]/'ɑːs(ə)neɪt/; [n]<无化>砷酸盐;砒酸盐; [or]unix;
arsenide: [a]/'ɑːs(ə)naɪd/; [n]<无化>砷化物; [or]unix;
arsoite: [a]/'ɑ:səu,ait/; [n]<岩>辉橄粗面岩; [or]unix;
aseptic: [a]/ˌeɪˈseptɪk/; [adj]无菌的;防腐性的; [n]<助剂>防腐剂; [or]unix;
asphaltene: [a]/æs'fælti:n/; [n]<油气>沥青质;<油气>沥青烯; [or]unix;
asphaltite: [a]/æs'fæltaɪt/; [n]<岩>沥青岩;沥青矿; [adj]沥青岩的; [or]unix;
assaying: [a]/ə'seɪŋ/; [n]<分化>试金;分析矿物; [v]分析;试验;对.估价(assay的ing形式); [or]unix;
assyntite: [a]/'æsintait/; [n]<岩>钛辉方钠正长岩; [or]unix;
asteria: [a]/æ'stɪərɪə/; [n]<宝>星彩宝石;显星形之宝石; [or]unix;
atlantite: [a]/æt'læntait/; [n]霞石碱玄岩,<岩>暗霞碧玄岩; [or]unix;
atomization: [a]/,ætəʊmaɪ'zeɪʃən/; [n]雾化,<分化>原子化; [or]unix;
auganite: [a]/'ɔ:ɡənait/; [n]<岩>辉安岩; [or]unix;
augitophyre: [a]/'ɔ:dʒitəfaiə/; [n]<岩>辉斑玄武岩; [or]unix;
aurate: [a]/'ɔret/; [n]<无化>金酸盐; [or]unix;
autocatalysis: [a]/,ɔːtəʊkə'tælɪsɪs/; [n]链式反应扩大;<物化>自动催化作用; [add]pl/autocatalyses; [or]unix;
autocatalytic: [a]/,ɔtokætə'lɪtɪk/; [adj]<物化>自动催化的; [or]unix;
auxochrome: [a]/'ɔːksəkrəʊm/; [n]<染料>助色团(用以使染料固着在织物上); [or]unix;
azide: [a]/'eɪzaɪd/; [n]<无化>叠氮化物; [or]unix;
azoimide: [a]/,æzəu'imaid/; [n]三氮化氢;<无化>叠氮酸(等于hydrazoic acid); [or]unix;
azulene: [a]/'æʒə,li:n/; [n]<染料>甘菊蓝;甘菊环; [or]unix;
bahiaite: [a]/bə'hi:ə,ait/; [n]<岩>橄闪紫苏岩; [or]unix;
banatite: [a]/'bænətait/; [n]<岩>正辉英闪长岩; [or]unix;
barkevikite: [a]/'bɑ:kəvi,kait/; [n]<岩>棕闪石;铁角闪石; [or]unix;
basaltic: [a]/bə'sɔːltɪk/; [adj]<岩>玄武岩的; [or]unix;
basanite: [a]/'bæsə,naɪt/; [n]试金石;<岩>碧玄岩; [or]unix;
basifier: [a]/'beisi,faiə/; [n]<助剂>碱化剂; [or]unix;
bathochrome: [a]/'bæθəkrəʊm/; [n]<染料>向红基;<染料>向红团(有机化合物原子团);深色基团; [or]unix;
beryl: [a]/ˈberəl/; [n]<宝>绿宝石;绿玉;浅绿色; [or]unix;
beryllia: [a]/bə'riliə/; [n]<无化>氧化铍; [or]unix;
bifluoride: [a]/bai'flu:əraid/; [n]<无化>氟氢化物; [or]unix;
biolith: [a]/'baiəuliθ/; [n]<岩>生物岩; [or]unix;
bismuthate: [a]/'bɪzmə,θeɪt/; <无化>铋酸盐; [or]unix;
bisphenoid: [a]/bai'sfi:nɔid/; [n]<晶体>双榍; [or]unix;
bisque: [a]/bɪsk/; [n]<陶瓷>素瓷;浓汤;橘黄色; [or]unix;
bisulphite: [a]/,bai'sʌlfait/; [n]<无化>亚硫酸氢盐,酸式亚硫酸盐; [or]unix;
bituminization: [a]/bɪ,tjʊmɪnɪ'zeʃən/; [n]<油气>沥青固化; [or]unix;
blastophitic: [a]/,blæstəu'fitik/; [adj]变余辉绿岩的;变余辉绿状; [n]<岩>变余辉岩; [or]unix;
blistering: [a]/ˈblɪstərɪŋ/; [adj]猛烈的;极热的,极快的; [n]<涂料>起泡;发疱; [v]起水疱;起气泡;使受暴晒(blister的ing形式); [or]unix;
blowpipe: [a]/ˈbləʊpaɪp/; [n]<玻璃>吹管;吹风管; [or]unix;
boride: [a]/'bɔːraɪd/; [n]<无化>硼化物; [or]unix;
borofluoride: [a]/,bɔːrəʊ'flʊəraɪd/; <无化>氟硼酸盐; [or]unix;
bostonite: [a]/'bɔstənait/; [n]<岩>歪正细晶岩; [or]unix;
brachyaxis: [a]/,bræki'æksis/; [n]<晶体>短轴; [or]unix;
bromide: [a]/ˈbrəʊmaɪd/; [n]<无化>溴化物;庸俗的人;陈词滥调; [add]pl/bromides; [or]unix;
bromination: [a]/,brəumi'neiʃən/; [n]<无化>溴化;溴处理; [or]unix;
burette: [a]/bjuˈret/; [n]<分化>滴定管;量管; [or]unix;
bysmalith: [a]/baɪs'mælɪθ/; [n]<岩>岩栓; [or]unix;
cacholong: [a]/'kætʃəlɔŋ/; [n]<宝>美蛋白石; [or]unix;
calcimeter: [a]/kæl'simitə/; [n]钙定量器;<分化>石灰测定器; [or]unix;
calcination: [a]/,kælsɪ'neʃən/; [n]煅烧;<化工>焙烧;烧矿法; [or]unix;
calcrete: [a]/'kælkriːt/; [n]<岩>钙质结砾岩; [or]unix;
calomel: [a]/'kæləmel/; [n]<无化>甘汞;氯化亚汞; [or]unix;
camptonite: [a]/'kæmptəʊnaɪt/; [n]<岩>闪煌岩; [or]unix;
capsulation: [a]/kæpsju'leiʃən/; [n]封装;<高分子>包囊化作用; [or]unix;
carbide: [a]/'kɑːbaɪd/; <无化>碳化物; [or]unix;
catalyst: [a]/ˈkætəlɪst/; [n]<物化>催化剂;刺激因素; [add]pl/catalysts; [or]unix;
catalyzer: [a]/'kætə,laɪzɚ/; [n]<物化>催化剂;触媒剂; [or]unix;
cecilite: [a]/'si:silait/; [n]<岩>黄长白榴岩; [or]unix;
ceramography: [a]/serə'mɔgrəfi/; [n]<陶瓷>陶瓷学,陶瓷相学; [or]unix;
charnockite: [a]/'tʃɑ:nəkait/; [n]<岩>紫苏花岗岩; [or]unix;
cheddite: [a]/'tʃedaɪt/; [n]<化工>谢德炸药(最初在法国谢德制造); [or]unix;
chlorate: [a]/'klɔːreɪt/; [n]<无化>氯酸盐; [or]unix;
chlorophyllite: [a]/'klɔrəfilait/; [n]<岩>绿叶石; [or]unix;
chloroplatinate: [a]/,kləurə'plætineit/; [n]<无化>氯铂酸盐; [or]unix;
chromatogram: [a]/krə(ʊ)'mætəgræm/; [n]<分化>色谱图;<分化>色层分离谱; [or]unix;
chromometer: [a]/krə'mɔmitə/; [n]<分化>比色计;色度计; [or]unix;
chrysoidine: [a]/kri'sɔidi:n/; [n]<染料>柯衣定;橘红; [or]unix;
ciminite: [a]/'siminait/; [n]<岩>橄辉粗面岩; [or]unix;
coagulant: [a]/kəʊ'ægjʊlənt/; [n]<建><化工>促凝剂;凝血剂;凝结剂; [or]unix;
coagulator: [a]/ko'ægjə,letɚ/; [n]<助剂>凝结剂;<化工>凝结器; [or]unix;
coater: [a]/'kəʊtə/; [n]<涂料>涂料器; [or]unix;
collodion: [a]/kə'ləʊdɪən/; [n]火棉胶;<高分子>胶棉; [or]unix;
comendite: [a]/'kɔməndait/; [n]硷性疗岩;<岩>钠闪碱流岩; [or]unix;
copolymer: [a]/kəʊ'pɒlɪmə/; [n]<高分子>共聚物; [or]unix;
copperas: [a]/'kɒp(ə)rəs/; [n]<无化><中医>绿矾; [or]unix;
corsite: [a]/'kɔ:sait/; [n]<岩>球状闪长岩; [or]unix;
crystallinity: [a]/,krɪstə'lɪnətɪ/; <晶体>结晶度; [or]unix;
crystallizer: [a]/'kristəlaizə/; [n]<化工>结晶器;结晶设备; [or]unix;
crystallogeny: [a]/kristə'lɔdʒini/; [n]<晶体>晶体发生学; [or]unix;
crystallogram: [a]/'kristələu,græm/; [n]<晶体>晶体衍射图;<晶体>结晶衍射图; [or]unix;
cumberlandite: [a]/'kʌmbələn,dait/; [n]<岩>钛铁橄榄岩;<岩>钛铁长橄岩; [or]unix;
cuprous: [a]/'kjuːprəs/; [adj]<无化>亚铜的;一价铜的; [or]unix;
cyanidation: [a]/saiəni'deiʃən/; [n]<无化>氰化;<冶>氰化法; [or]unix;
cyanide: [a]/ˈsaɪənaɪd/; [n]<无化>氰化物; [add]pt/cyanided,pp/cyanided,pr/cyaniding,s3/cyanides; [or]unix;
cyclonite: [a]/'saɪklə,naɪt/; [n]黑索今炸药,<化工>旋风炸药(一种高性能的炸药); [or]unix;
cymophane: [a]/'saɪməʊ,feɪn/; <宝>金绿宝石; [or]unix;
dacite: [a]/'deɪsaɪt/; [n]<岩>英安岩;石英安山石; [or]unix;
deactivation: [a]/diː,æktɪ'veɪʃən/; [n]<物化>减活化作用;钝化作用; [or]unix;
deaeration: [a]/,di:εə'reiʃən/; [n]<油气><化工>脱气;通风; [or]unix;
decalcomania: [a]/dɪ,kælkə(ʊ)'meɪnɪə/; [n]<陶瓷>印花釉法;贴花纸转印法;贴花转印的图案; [or]unix;
decantation: [a]/,di:kæn'teiʃən/; [n]<化工>倾析;倾注; [or]unix;
deflocculation: [a]/dɪ,flɒkjʊ'leɪʃən/; [n]抗絮凝作用;解絮凝;<物化>胶溶作用; [or]unix;
deoxidant: [a]/di:'ɔkisdənt/; [n]<助剂>脱氧剂;还原剂; [or]unix;
deoxidizer: [a]/di'ɑksədaɪzɚ/; [n]还原剂,<助剂>脱氧剂; [or]unix;
dephlegmation: [a]/,di:fleɡ'meiʃən/; [n]分馏;<化工>分凝作用; [or]unix;
depolarizer: [a]/di:'pəuləraizə/; [n]<助剂>去极剂;消偏振镜; [or]unix;
depolymerization: [a]/'diː,pɒlɪməraɪ'zeɪʃən/; [n]<高分子>解聚(合)作用; [or]unix;
desiccant: [a]/'desɪk(ə)nt/; [adj]去湿的,使干燥的; [n]<助剂>干燥剂; [or]unix;
desiccative: [a]/,desi'keitiv/; [adj]使干燥的,去湿的; [n]<助剂>干燥剂; [or]unix;
dialyzate: [a]/dai'ælizeit/; [n]<分化>透析液; [or]unix;
diamine: [a]/daɪ'eɪmiːn; daɪ'æm-; 'daɪəmiːn/; [n]二元胺;<无化>联氨; [or]unix;
dibromide: [a]/daɪ'bromɪd/; [n]<无化>二溴化物; [or]unix;
dicarbonate: [a]/dai'ka:bəneit/; [n]小苏打;<无化>碳酸氢钠; [or]unix;
dichloramine: [a]/dai,klɔ:'ræmi:n/; [n]<无化>二氯胺; [or]unix;
dichloride: [a]/daɪ'klɔːraɪd/; [n]<无化>二氯化合物; [or]unix;
dichromate: [a]/daɪ'krəʊmeɪt/; [n]<无化>重铬酸盐; [or]unix;
dihalide: [a]/dai'hælaidl/; [n]<无化>二卤化物;二卤化; [or]unix;
dihydrate: [a]/dai'haidreit/; [n]<无化>二水合物;二水物; [or]unix;
dioctahedral: [a]/dai,ɔktə'hi:drəl/; [adj]<晶体>二八面体的; [or]unix;
diorite: [a]/'daɪəraɪt/; [n]<岩>闪长岩;闪绿岩; [or]unix;
dipole: [a]/ˈdaɪpəʊl/; [n]<物化>偶极;双极子; [or]unix;
disilane: [a]/dai'silein/; [n]<无化>乙硅烷; [or]unix;
disilicide: [a]/dai'silisaid/; [n]<无化>二硅化物; [or]unix;
disperser: [a]/dɪs'pɝsɚ/; [n]<助剂>分散剂;分散器;扩散器; [or]unix;
disphenoid: [a]/dai'sfi:nɔid/; [n]复正方楔;复正方榍;<晶体>双半面晶形; [or]unix;
dithionate: [a]/dai'θaiə,neit/; [n]<无化>连二硫酸盐; [or]unix;
ditroite: [a]/dai'trəuait/; [n]<岩>方钠二霞正长岩; [or]unix;
dunite: [a]/'dʌnaɪt/; [n]<岩>纯橄榄岩; [or]unix;
dyestuff: [a]/'daɪstʌf/; [n]染料,<助剂>着色剂; [or]unix;
ebulliometer: [a]/i,bʌli'ɔmitə/; [n]<分化>沸点计,<分化>沸点测定器;酒精测量器; [or]unix;
ebullioscope: [a]/ɪ'bʌlɪəskəʊp/; [n]<分化>沸点测定器; [or]unix;
ebullioscopy: [a]/i'bʌli'ɔskəpi/; [n]<分化>沸点升高测定法; [or]unix;
eclogite: [a]/'eklɒdʒaɪt/; [n]<岩>榴辉岩; [or]unix;
effervescence: [a]/ˌefəˈvesns/; [n]冒泡;<化工>泡腾;欢腾; [or]unix;
electrochemical: [a]/ɪ,lɛktro'kɛmɪkl/; [adj]<物化>电化学的;<物化>电气化学的; [or]unix;
electrochemistry: [a]/ɪ,lektrəʊ'kemɪstrɪ/; [n]<物化>电化学; [or]unix;
electrodeposition: [a]/i'lektrəu,depə'ziʃən/; [n]<化工>电沉积;电镀; [or]unix;
electrodialysis: [a]/ɪ,lektrəʊdaɪ'ælɪsɪs/; [n]<物化>电渗析; [add]pl/electrodialyses; [or]unix;
electrography: [a]/i,lek'trɔɡrəfi/; [n]传真电报术;<分化>电谱法;电描记术; [or]unix;
electrokinetics: [a]/ɪ,lektrəʊkaɪ'netɪks/; [n]<物化>动电学; [or]unix;
electroosmosis: [a]/ɪ,lɛktroɑz'mosɪs/; [n]<物化>电渗,<物化>电渗透; [or]unix;
eluate: [a]/'eljuːət; -eɪt/; [n]<分化>洗出液; [or]unix;
elution: [a]/i'lju:ʃən/; [n]<分化>洗脱;<冶>洗提; [or]unix;
elutriator: [a]/i'lju:tri,eitə/; [n]含泥量试验仪;<化工>淘析器; [or]unix;
entrainment: [a]/in'treinmənt/; [n]夹带;<化工>雾沫;带走; [or]unix;
erbia: [a]/'ɜːbɪə/; <无化>氧化铒; [or]unix;
essexite: [a]/'esik,sait/; [n]碱性辉长岩;<岩>厄塞岩; [or]unix;
eucrite: [a]/'ju:krait/; [n]<岩>倍长辉长岩;钙长辉长无粒陨石; [or]unix;
euhedral: [a]/ju:'hi:drəl/; [adj]<岩>自形的;全形的; [or]unix;
exsiccator: [a]/'eksɪ,keɪtə/; [n]除湿剂;<化工>除湿器; [or]unix;
extruder: [a]/ek'struːdə/; [n]<塑料>挤出机;挤压机; [or]unix;
felsophyric: [a]/felsə'fairik/; [adj]霏细斑岩的;<岩>隐晶基斑状的; [or]unix;
ferric: [a]/'ferɪk/; [adj]铁的;<无化>三价铁的;含铁的; [gd]un; [or]unix;
ferricyanide: [a]/,ferɪ'saɪənaɪd/; [n]<无化>铁氰化物; [or]unix;
ferrocyanide: [a]/,ferəʊ'saɪənaɪd/; [n]氰亚铁酸盐;<无化>亚铁氰化物; [or]unix;
filterability: [a]/,filtərə'biləti/; [n]过滤性;<化工>可滤性;滤过率; [or]unix;
filtering: [a]/'fɪltərɪŋ/; [v]<化工>过滤,滤除(filter的ing形式); [or]unix;
flagstone: [a]/ˈflæɡstəʊn/; [n]石板;<岩>薄层砂岩; [add]pl/flagstones; [or]unix;
flask: [a]/flɑːsk/; [n]<分化>烧瓶;长颈瓶,细颈瓶;酒瓶,携带瓶; [add]pl/flasks; [or]unix;
floatation: [a]/fləʊ'teɪʃən/; [n]<物化>浮选;漂浮性; [or]unix;
fortifier: [a]/'fɔrtə,faɪɚ/; [n]筑城者;强化物;<助剂>增强剂;加固物; [add]pl/fortifiers; [or]unix;
foyaite: [a]/fɔi'eit/; [n]良正长岩;<岩>流霞正长岩; [or]unix;
frother: [a]/'frɔðə/; [n]<助剂><矿业>起泡剂;<助剂>起沫剂;泡沫发生剂; [or]unix;
ganister: [a]/'gænɪstə/; [n]<岩>致密硅岩;硅火泥(耐火性很强用作锅炉内侧衬料); [or]unix;
gelation: [a]/dʒə'leɪʃ(ə)n/; [n]<物化>凝胶化;冻结; [or]unix;
gemmology: [a]/dʒɛ'mɑlədʒi/; [n]<宝>宝石学; [or]unix;
glassmaking: [a]/'ɡlæs,mekɪŋ/; [n]<玻璃>玻璃制造术; [or]unix;
granodiorite: [a]/,grænə(ʊ)'daɪəraɪt/; [n]<岩>花岗闪长岩; [or]unix;
granophyre: [a]/'ɡrænəʊfaɪə/; <岩>花斑岩; <岩>文象斑岩; [or]unix;
granularity: [a]/grænjʊ'lærɪtɪ/; [n]间隔尺寸,<岩>粒度; [or]unix;
granulite: [a]/'grænjʊlaɪt/; [n]<岩>麻粒岩;粒变岩; [or]unix;
graphitization: [a]/,ɡræfɪtɪ'zeʃən/; [n]<化工><冶>石墨化; [or]unix;
harzburgite: [a]/'hɑ:z,bə:ɡait/; [n]<岩>斜辉橄榄岩;<岩>方辉橄榄岩; [or]unix;
hemicrystalline: [a]/ˌhɛmɪˈkrɪstəˌlaɪn/; [adj]半结晶的,<岩>半晶质的; [or]unix;
hemiprism: [a]/,hemi'prizəm/; [n]半柱;半棱晶;<晶体>半棱柱;半棱柱体; [or]unix;
hexoctahedron: [a]/'heksəuktə,hedrɔn/; [n]<晶体>六八面体; [or]unix;
hiddenite: [a]/'hɪd(ə)naɪt/; [n]希登石;<宝>翠绿锂辉石; [or]unix;
holocrystalline: [a]/,hɔləu'kristəlain/; [adj]<岩>全晶质的,全晶的; [or]unix;
holohyaline: [a]/,hɔləu'haiəlin/; [adj]<岩>全玻质的; [or]unix;
holomorph: [a]/'hɔləmɔ:f/; [n]全型;<晶体>全形; [or]unix;
hornfels: [a]/'hɔrnfɛls/; [n]<岩>角页岩; [or]unix;
humectant: [a]/hjuːˈmektənt/; [adj]湿润的;湿润剂的; [n]<助剂>湿润剂; [or]unix;
hyacinth: [a]/ˈhaɪəsɪnθ/; [n]风信子;<宝>红锆石;紫蓝色; [add]pl/hyacinths; [or]unix;
hydrazine: [a]/'haɪdrəziːn/; [n]<无化>肼;<无化>联氨;酰肼; [or]unix;
hydride: [a]/'haɪdraɪd/; [n]<无化>氢化物; [or]unix;
hydroforming: [a]/'haɪdrəʊ,fɔːmɪŋ/; [n]<油气>加氢重整; [v]液压成形(hydroform的ing形式); [or]unix;
hydrogel: [a]/'haɪdrə(ʊ)dʒel/; [n]<物化>水凝胶; [or]unix;
hydroperoxide: [a]/,haidrəupə'rɔksaid/; [n]<无化>氢过氧化物; [or]unix;
hydrosulphide: [a]/,haidrəu'sʌlfaid/; [n]<无化>氢硫化物; [or]unix;
hydroxide: [a]/haɪˈdrɒksaɪd/; [n]<无化>氢氧化物;羟化物; [or]unix;
hypobromite: [a]/,haipəu'brəumait/; [n]<无化>次溴酸盐; [or]unix;
hypochlorite: [a]/,haɪpəʊ'klɔːraɪt/; [n]<无化>次氯酸盐;低氧化氯; [or]unix;
hypocrystalline: [a]/,haipə'kristəlain/; [adj]<岩>半晶质的; [or]unix;
hypophosphate: [a]/,haɪpəʊ'fɒsfeɪt/; [n]<无化>连二磷酸盐; [or]unix;
hypophosphite: [a]/,haɪpə'fɒsfaɪt/; [n]<无化>次磷酸盐; [or]unix;
ijolite: [a]/'ijəlait/; [n]<岩>霓霞岩; [or]unix;
indanthrene: [a]/in'dænθri:n/; [n]<染料>阴丹士林,靛蒽醌; [or]unix;
indophenol: [a]/,ɪndəʊ'fiːnɒl/; [n]<染料>靛酚;靛酚染料; [or]unix;
induline: [a]/'ɪndjʊliːn/; [n]对氮蒽蓝;<染料>引杜林染料; [or]unix;
inhibitor: [a]/ɪnˈhɪbɪtə(r)/; [n]<助剂>抑制剂,抗化剂;抑制者; [or]unix;
inorganic: [a]/ˌɪnɔːˈɡænɪk/; [adj]<无化>无机的;无生物的; [or]unix;
internuclear: [a]/,ɪntɚ'nʊkliɚ; ,ɪntɚ'njʊkliɚ/; [adj](原子)<物化>核间的;(细胞)<物化>核间的;视网膜核层间的; [or]unix;
interpolymer: [a]/'intə,pɔlimə/; [n]<高分子>互聚物; [or]unix;
iodate: [a]/'aɪədeɪt/; [n]<无化>碘酸盐; [vt]以碘处理; [add]pt/iodated,pp/iodated,pr/iodating; [or]unix;
ionizer: [a]/ˈaɪənaɪzər/; [n]<化工>电离剂;离子发生器; [add]pl/ionizers; [or]unix;
isatin: [a]/'aɪsətɪn/; [n]<染料>靛红; [or]unix;
isocyanate: [a]/aɪsə(ʊ)'saɪəneɪt/; [n]<无化>异氰酸盐; [or]unix;
isocyanide: [a]/,aisəu'saiənaid/; [n]异腈;<无化>异氰化物; [or]unix;
isomorphism: [a]/,aɪsəʊ'mɔːfɪzəm/; [n]类质同像,<物化>类质同晶;同形; [or]unix;
isothiocyanates: [a]/'aisəu,θaiəu'saiəneit/; [n]<无化>异硫氰酸盐;<无化>异硫氰酸酯; [or]unix;
isotypic: [a]/,aisə'tipik/; [adj]<晶体>同型的;代表性图表或记号的; [or]unix;
issite: [a]/'i:sait/; [n]<岩>暗闪辉长岩,<岩>辉长角闪石岩; [or]unix;
itabirite: [a]/,i:tə'birait/; [n]<岩>铁英岩; [or]unix;
itacolumite: [a]/,ɪtə'kɒljʊmaɪt/; [n]<岩>可弯砂岩; [or]unix;
jadeite: [a]/'dʒeɪdaɪt/; [n]翡翠;<宝>硬玉; [or]unix;
jasperoid: [a]/'dʒæspərɔid/; [n]<宝>碧玉;碧玉状; [or]unix;
kenyte: [a]/'ki:nait/; [n]<岩>霓橄粗面岩;霓橄响斑岩; [or]unix;
kersantite: [a]/'kə:sən,tait/; [n]<岩>云斜煌岩; [or]unix;
kimberlite: [a]/'kɪmbəlaɪt/; [n]<岩>金伯利岩;<岩>角砾云橄岩; [or]unix;
kulaite: [a]/'ku:lə,ait/; [n]<岩>闪霞粒玄岩; [or]unix;
kylite: [a]/'kailait/; [n]<岩>富橄霞斜岩;<岩>辉橄霞斜岩; [or]unix;
lamprophyre: [a]/'læmprə,faɪɚ/; [n]<岩>煌斑岩; [or]unix;
langbeinite: [a]/'læ,baɪnaɪt/; [n]<无化>无水钾镁矾; [or]unix;
lanthana: [a]/'lænθənə/; [n]<无化>氧化镧; [or]unix;
larvikite: [a]/'lɑ:vikait/; [n]<岩>歪碱正长岩; [or]unix;
latite: [a]/'leitait/; [n]<岩>安粗岩;二长安山岩; [or]unix;
laurdalite: [a]/'lɔ:dəlait, 'lɑ:-/; [n]<岩>歪霞正长岩; [or]unix;
lepidoblastic: [a]/,lepɪdəʊ'blæstɪk/; <岩>鳞片变晶状的; [or]unix;
leptite: [a]/'leptait/; [n]<岩>长英粒变岩; [or]unix;
limburgite: [a]/'limbəɡait/; [n]<岩>玻基辉橄岩;灵堡干酪; [or]unix;
limestone: [a]/ˈlaɪmstəʊn/; [n]<岩>石灰岩; [add]pl/limestones; [or]unix;
liparite: [a]/'lipərait/; [n]<岩>流纹岩;萤石;硅孔雀石; [or]unix;
lithia: [a]/'lɪθɪə/; [n]<无化>氧化锂;锂氧; [or]unix;
lixiviation: [a]/lɪk,sɪvɪ'eʃən/; [n]<化工>浸滤(作用); [or]unix;
lyddite: [a]/'lɪdaɪt/; [n]<化工>立德炸药(一种强力炸药); [or]unix;
lydite: [a]/'lidait/; [n]<岩>燧石板岩,试金石; [or]unix;
malchite: [a]/'mælkait/; [n]<岩>微闪长岩; [or]unix;
manganate: [a]/'mæŋgənət; -neɪt/; [n]<无化>锰酸盐; [or]unix;
marchite: [a]/'mɑ:tʃait/; [n]<岩>顽火透辉岩; [or]unix;
marlite: [a]/'mɑːlaɪt/; [n]<岩>泥灰岩(泥灰土的一种); [or]unix;
marmoreal: [a]/mɑːˈmɔːriəl/; [adj]冰冷的;大理石的;<岩>大理石状的; [or]unix;
menilite: [a]/'menilait/; [n]<宝>硅乳石; [or]unix;
mercuric: [a]/mɜː'kjʊərɪk/; [adj]<无化>汞的;水银的; [or]unix;
merohedral: [a]/,mɛrə'hidrəl/; <晶体>缺面的; [or]unix;
metacryst: [a]/'metəkrɪst/; [n]斑晶变晶;<岩>变晶;次生晶; [or]unix;
metaphosphate: [a]/metə'fɒsfeɪt/; [n]<无化>偏磷酸盐; [or]unix;
miarolitic: [a]/,mi:ərəu'litik/; [adj]<岩>晶洞状的; [n]洞隙; [or]unix;
microanalysis: [a]/,maɪkrəʊə'nælɪsɪs/; [n]<分化>微量分析; [add]pl/microanalyses; [or]unix;
microspherulitic: [a]/'maikrəu,sfirə'litik/; [adj]<岩>微球粒状; [or]unix;
migmatite: [a]/'miɡmətait/; [n]<岩>混合岩,复片麻岩; [or]unix;
minverite: [a]/'minvə,rait/; [n]<岩>钠长角闪辉绿岩; [or]unix;
modifiable: [a]/ˈmɒdɪfaɪə(r)/; [adj]可修饰的;可更改的; modification:; [n]<助剂>改性剂;<语>修饰语;修正的人; [add]pl/modifiers; [or]unix;
modifier: [a]/ˈmɒdɪfaɪə(r)/; [n]<助剂>改性剂;<语>修饰语;修正的人; [add]pl/modifiers; [or]unix;
monaxial: [a]/'mɔnʃikait/; [adj]单轴的; monazite:; [n]<岩>沸煌岩; [or]unix;
monchiquite: [a]/'mɔnʃikait/; [n]<岩>沸煌岩; [or]unix;
monochromic: [a]/'mɔnəkɔt/; [adj]<晶体>单斜的;<晶体>单斜晶体的; monocot:; [n]单子叶植物; [add]pl/monocles;monoclinal:; [or]unix;
monoclinic: [a]/mɒnə(ʊ)'klɪnɪk/; [adj]<晶体>单斜的;<晶体>单斜晶体的; [or]unix;
monoxide: [a]/mə'nɒksaɪd/; [n]<无化>一氧化物; [or]unix;
monzonite: [a]/'mɒnzənaɪt/; [n]<岩>二长岩; [or]unix;
moonstone: [a]/ˈmuːnstəʊn/; [n]<宝>月长石; [or]unix;
morphology: [a]/,mɔ:fəu'trɔpizəm/; [n]<晶体>变形性,准同形性; [add]pl/morphoses;morphotropism:; [or]unix;
morphotropism: [a]/,mɔ:fəu'trɔpizəm/; [n]<晶体>变形性,准同形性; [or]unix;
mugearite: [a]/mʊ'ɡiəraɪt/; [n]<岩>橄榄粗安岩; [or]unix;
mylonite: [a]/'mɪlənaɪt/; [n]<岩>糜棱岩; [or]unix;
myrmekite: [a]/'mə:mi,kait/; [n]<岩>蠕状石; [or]unix;
navigator: [a]/'neivait/; [n]<岩>蛇纹粒玄斑岩; [add]pl/navigators;navite:; [or]unix;
navite: [a]/'neivait/; [n]<岩>蛇纹粒玄斑岩; [or]unix;
nebular: [a]/'nebjulait/; [adj]星云的;星云状的; nebule:; [n]<岩>星云岩; [or]unix;
nebulite: [a]/'nebjulait/; [n]<岩>星云岩; [or]unix;
nelsonite: [a]/'nelsənait/; [n]<岩>钛铁磷灰岩; [or]unix;
nema: [a]/,nemətə'blæstik/; [adj]<岩>纤状变晶质的; [gd]un; [or]unix;
nematic: [a]/nɪ'mætɪk/; [adj](液晶)<晶体>向列的; [or]unix;
nematoblastic: [a]/,nemətə'blæstik/; [adj]<岩>纤状变晶质的; [or]unix;
neutralizer: [a]/'njʊtrəl,aɪzɚ/; [n]<助剂>中和剂;<化工>中和器; [or]unix;
nevadite: [a]/'nevə,dait/; [n]<岩>斑流岩; [or]unix;
nickeling: [a]/ˈnɪkəl/; [v]<化工>镀镍(nickel的ing形式); [or]unix;
nigrosine: [a]/'nɪɡrəsiːn/; [n]<染料>苯胺黑; [or]unix;
niklesite: [a]/'nikl,sait/; [n]<岩>三辉岩; [or]unix;
niobate: [a]/'naiəbeit/; [n]<无化>铌酸盐; [or]unix;
nitridation: [a]/,naitri'deiʃən/; [n]<无化>氮化;渗氮; [or]unix;
nitrometer: [a]/naɪ'trɒmɪtə/; [n]<分化>氮量计;<分化>测氮管; [or]unix;
novaculite: [a]/nə(ʊ)'vækjʊlaɪt/; [n]<岩>均密石英岩; [or]unix;
odinite: [a]/'əudinait/; [n]<岩>拉辉煌斑岩;钛云母; [or]unix;
orchil: [a]/'ɔːtʃɪl/; [n]红色染料;苔色素;石蕊地衣;<染料>紫色地衣染料; [or]unix;
organogel: [a]/ɔ:'gænədʒel/; [n]<物化>有机凝胶; [or]unix;
ormolu: [a]/ˈɔːməluː/; [n]<化工>镀金物;锌青钢; [or]unix;
orthophosphate: [a]/,ɔːθəʊ'fɒsfeɪt/; [n]<无化>正磷酸盐; [or]unix;
orthorhombic: [a]/,ɔːθə(ʊ)'rɒmbɪk/; [adj]<晶体>正交晶的;斜方晶系的; [or]unix;
orthovanadate: [a]/'ɔ:θəvænə,deit/; [n]<无化>原钒酸盐; [or]unix;
oscillometry: [a]/,ɔsi'lɔmitri/; [n]<电子>示波测量法;高频指示;<物化>振量法; [or]unix;
overcoating: [a]/'ovɚ,kotɪŋ/; [n]外敷层;<涂料>饰面; [or]unix;
overcured: [a]/əuvə'kjuə/; [vt]过熟化;<化工>过硫化;过硬化; [or]unix;
oxidizer: [a]/'ɑksə,daɪzɚ/; [n]<助剂>氧化剂; [or]unix;
oxybromide: [a]/ɔksi'brəumaid/; [n]<无化>溴氧化物; [or]unix;
oxysalt: [a]/'ɒksɪsɔːlt/; <无化>含氧酸盐; 含氧盐; [or]unix;
paddling: [a]/'pædlɪŋ/; [n]<皮革>划动; [v]用桨划;在水中行进(paddle的现在分词); [or]unix;
paisanite: [a]/'paisənait/; [n]<岩>钠闪微岗岩; [or]unix;
pantellerite: [a]/pæn'telərait/; [n]<岩>碱流岩; [or]unix;
paragneiss: [a]/,pærəɡ'nais/; [n]<岩>副片麻岩; [or]unix;
pedion: [a]/'pediən/; [n]单面晶;<晶体>单面; [add]pl/pedia; [or]unix;
pelite: [a]/'pi,laɪt/; [n]<岩>泥质岩; [or]unix;
pentoxide: [a]/pen'tɒksaɪd/; [n]<无化>五氧化物; [or]unix;
peptization: [a]/,peptə'zeɪʃən/; [n]<物化>胶溶作用; [or]unix;
perchlorate: [a]/pə'klɔːreɪt/; [n]<无化>高氯酸盐(或酯); [or]unix;
perchloride: [a]/pə'kləʊraɪd/; [n]<无化>高氯化物;过氯化物; [or]unix;
peridotite: [a]/'perɪdɒtaɪt/; [n]<岩>橄榄岩; [or]unix;
periodate: [a]/pɜː'raɪədeɪt/; [n]<无化>高碘酸盐;过碘酸盐; [or]unix;
perknite: [a]/'pə:knait/; [n]辉闪岩;<岩>辉闪岩类; [or]unix;
permanganate: [a]/pə'mæŋgənət; -eɪt/; [n]<无化>高锰酸盐; [or]unix;
perthosite: [a]/'pə:θəsait/; [n]淡纹长岩;<岩>淡钠二长岩; [or]unix;
petrogenesis: [a]/,petrə(ʊ)'dʒenɪsɪs/; [n]岩石发展学,<岩>岩石成因论; [or]unix;
phacolith: [a]/'fækəʊlɪθ/; [n]<岩>岩脊;岩鞍; [or]unix;
phanerite: [a]/'fænərait/; [n]<岩>显晶岩; [or]unix;
phenocryst: [a]/'fiːnə(ʊ)krɪst; 'fenə(ʊ)krɪst/; [n]<岩>斑晶;显斑晶; [or]unix;
phonolite: [a]/'fəʊnəlaɪt/; [n]<岩>响岩;响石; [or]unix;
phosgene: [a]/ˈfɒzdʒiːn/; [n]<无化>光气;<无化>碳酰氯; [or]unix;
phosphide: [a]/'fɒsfaɪd/; [n]<无化>磷化物; [or]unix;
phosphorite: [a]/'fɒsfəraɪt/; [n]磷灰石;<岩>磷钙土; [or]unix;
phyllite: [a]/'fɪlaɪt/; [n]<岩>千枚岩;硬绿泥石; [or]unix;
picrite: [a]/'pɪkraɪt/; [n]辉石;橄榄岩;<岩>苦橄岩; [or]unix;
pinacoid: [a]/'pɪnəkɔɪd/; [n]<晶体>轴面;平行双面式; [or]unix;
pisolitic: [a]/,paɪso'lɪtɪk/; [adj]<岩>豆状的; [or]unix;
plasticization: [a]/,plæstɪsɪ'zeʃən/; [n]塑化;<高分子>增塑作用; [or]unix;
plastisol: [a]/'plæstɪsɒl/; [n]<塑料>塑料溶胶; [or]unix;
pleochroism: [a]/plɪ'ɒkrəʊɪzəm/; [n]<晶体>多向色性;多色现象; [or]unix;
pleomorphic: [a]/pliːə'mɔːfɪk/; [adj]<晶体>多形的;多晶的; [or]unix;
plumbite: [a]/'plʌmbait/; [n]铅酸盐;<无化>亚铅酸盐; [or]unix;
poikiloblast: [a]/pɔɪ'kɪloblæst/; [n]异形成红细胞;<岩>变嵌晶; [or]unix;
polarogram: [a]/pəʊ'lærəɡræm/; [n]<分化>极谱图; [or]unix;
polarograph: [a]/po'lærəɡræf/; [n]<分化>极谱仪,极谱记录仪; [or]unix;
polarography: [a]/,pəʊlə'rɒgrəfɪ/; [n]<分化>极谱法; [or]unix;
policeman: [a]/pəˈliːsmən/; [n]警察,警员;<分化>淀帚(橡皮头玻璃搅棒); [add]pl/policemen; [or]unix;
polyamide: [a]/,pɒlɪ'eɪmaɪd; -'æm-/; [n]<高分子>聚酰胺(尼龙); [or]unix;
polygenetic: [a]/,pɑlidʒə'nɛtɪk/; [adj]<染料>多色的;多成因的;多时代的; [or]unix;
polymerism: [a]/pə'limərizəm, 'pɔli-/; [n]聚合性,<高分子>聚合现象; [or]unix;
polymerization: [a]/ˌpɒliməraɪˈzeɪʃn/; [n]聚合;<高分子>聚合作用; [or]unix;
polyoxymethylene: [a]/,pɔli,ɔksi'meθili:n/; [n]<高分子>聚甲醛; [or]unix;
polystyrene: [a]/ˌpɒliˈstaɪriːn/; [n]<高分子>聚苯乙烯; [or]unix;
polysulphide: [a]/pɔli'sʌlfaid/; [n]<无化>多硫化物; [or]unix;
polythene: [a]/ˈpɒlɪθiːn/; [n]<高分子>聚乙烯(等于polyethylene); [or]unix;
porphyrite: [a]/'pɔ:firait/; [n]<岩>玢岩;斜长斑岩,微闪长岩; [or]unix;
powder: [a]/ˈpaʊdə(r)/; [n]粉;粉末;<化工><军>火药;尘土; [vt]使成粉末;撒粉;搽粉于; [vi]搽粉;变成粉末; [add]pl/powders,pt/powdered,pr/powdering,s3/powders; [or]unix;
protoxide: [a]/prəʊ'tɒksaɪd/; [n]<无化>低氧化物; [or]unix;
psammite: [a]/'sæmaɪt/; [n]<岩>砂屑岩(等于arenite); [or]unix;
psephite: [a]/'siːfaɪt/; [n]<岩>砾质岩;碎砾岩; [or]unix;
pseudotachylite: [a]/sju:dəu'tækilait/; [n]<岩>假玄武玻璃; [or]unix;
pyroborate: [a]/,paɪərə'bɔːreɪt/; <无化>焦硼酸盐; [or]unix;
pyrogenic: [a]/,paɪrə(ʊ)'dʒenɪk/; [adj]<岩>火成的;高热所产生的; [or]unix;
pyrophosphate: [a]/,paɪrə(ʊ)'fɒsfeɪt/; [n]<无化>焦磷酸盐;焦磷酸酯; [or]unix;
pyroxenite: [a]/paɪ'rɒksɪnaɪt/; [n]辉石岩;<岩>辉岩; [or]unix;
raffinate: [a]/'ræfɪneɪt/; [n]<化工>萃余液;残油液;剩余液; [or]unix;
rapakivi: [a]/,rɑːpə'kiːviː/; [n]<岩>奥环斑花岗岩;奥长环斑岩;环斑花岗岩; [or]unix;
reactivation: [a]/riˌæktɪˈveɪʃn/; [n]<物化>再活化;再生;复能的情况;<核>重激活; [or]unix;
rectifiable: [a]/ˌrektɪˈfaɪəbl/; [adj]<化工>可精馏的;可矫正的;可改正的; [or]unix;
recuperability: [a]/ri,kju:pərə'biləti/; [n]<化工>可回收性;恢复力; [or]unix;
reducer: [a]/rɪ'djuːsə/; [n]<助剂>还原剂;减径管; [or]unix;
reductant: [a]/rɪ'dʌkt(ə)nt/; [n]<助剂>还原剂; [or]unix;
reductive: [a]/rɪˈdʌktɪv/; [adj]还原的;减少的; [n]<助剂>还原剂; [or]unix;
refined: [a]/rɪˈfaɪnd/; [adj]<油气><化工><冶>精炼的;精确的;微妙的;有教养的; [add]er/morerefined,est/mostrefined; [or]unix;
refinement: [a]/rɪˈfaɪnmənt/; [n]改进,改善;有教养;精制;文雅;acidimetric: [a]/,æsidi'metrik/; [adj]<分化>酸量滴定的; [or]unix;
regenerator: [a]/rɪ'dʒenəreɪtə/; [n]<化工>再生器;改革者,更新者;蓄热器; [or]unix;
resist: [a]/rɪˈzɪst/; [vi]抵抗,抗拒;忍耐; [vt]抵抗;忍耐,忍住; [n]<助剂>抗蚀剂;防染剂; [add]pt/resisted,pp/resisted,pr/resisting,s3/resists; [or]unix;
rhombohedron: [a]/,rɒmbə(ʊ)'hiːdr(ə)n; -'hed-/; [n]<晶体>菱面体; [add]pl/rhombohedrons或rhombohedra; [or]unix;
rhyodacite: [a]/rai'ɔdəsait/; [n]疗英安岩,<岩>流纹英安岩; [or]unix;
rhyolite: [a]/'raɪəlaɪt/; [n]<岩>流纹岩;表面光滑的火山岩; [or]unix;
rimrock: [a]/'rɪmrɒk/; [n](美)悬崖;<岩>顶岩; [or]unix;
roestone: [a]/'rəustəun/; [n]<岩>鲕粒岩;鱼卵石; [or]unix;
safflower: [a]/ˈsæflaʊə(r)/; [n]红花;<染料>红花染料; [or]unix;
sanidinite: [a]/'sænidinait/; [n]<岩>透长岩;透长石岩; [or]unix;
saturator: [a]/'sætʃəreitə/; [n]<化工>饱和器; [or]unix;
scandia: [a]/'skændiə/; [n]<无化>氧化钪; [or]unix;
schalstein: [a]/'ʃɑ:lstain/; [n]<岩>辉绿凝灰岩;基变凝炭岩; [or]unix;
schist: [a]/ʃɪst/; [n]<岩>片岩; [or]unix;
scrubber: [a]/ˈskrʌbə(r)/; [n]<化工>洗涤器;洗刷者;刷子; [add]pl/scrubbers; [or]unix;
scyelite: [a]/'sailait/; [n]<岩>闪云橄榄岩; [or]unix;
selenide: [a]/'selin（a）id/; [n]硒醚,<无化>硒化物; [or]unix;
selenite: [a]/'selɪnaɪt/; [n]<无化>亚硒酸盐;透明石膏; [or]unix;
shale: [a]/ʃeɪl/; [n]<岩>页岩;泥板岩; [add]pl/shales; [or]unix;
shonkinite: [a]/'ʃɔŋkinait/; [n]<岩>等色岩;暗辉正长岩; [or]unix;
siberite: [a]/'sibərait/; [n]<宝>紫碧硒,西伯电气石; [or]unix;
silane: [a]/'sɪleɪn/; [n]<无化><电子>硅烷;矽烷; [or]unix;
silcrete: [a]/'silkri:t/; [n]<岩>硅结砾岩;硅质壳层; [or]unix;
silicane: [a]/'silikein/; [n]<无化>硅烷;甲硅烷; [or]unix;
silicide: [a]/'sɪlɪsaɪd/; [n]<无化>硅化物; [or]unix;
silicification: [a]/sɪlɪ,səfɪ'keʃən/; [n]<无化>硅化;硅化作用; [or]unix;
sodamide: [a]/'sodəmaɪd/; [n]<无化>氨基钠(等于sodium amide); [or]unix;
spectrophone: [a]/'spektrəfəun/; [n]<分化>光谱测声器; [or]unix;
spilite: [a]/'spailait/; [n]<岩>细碧岩; [or]unix;
stabilizer: [a]/ˈsteɪbəlaɪzə(r)/; [n]<助剂>稳定剂;稳定器;安定装置; [add]pl/stabilizers; [or]unix;
stannane: [a]/'stænein/; [n]<无化>锡烷; [or]unix;
stannate: [a]/'stænet/; [n]<无化>锡酸盐; [or]unix;
stannite: [a]/'stænaɪt/; 黄锡矿; <无化>亚锡酸盐; [or]unix;
steatite: [a]/'stɪətaɪt/; [n]滑石;皂石;<岩>块滑石; [or]unix;
stereoisomer: [a]/,sterɪəʊ'aɪsəmə; ,stɪə-/; [n]<物化>立体异构体; [or]unix;
stibine: [a]/'stɪbiːn/; <无化>锑化氢; [or]unix;
stillage: [a]/'stɪlɪdʒ/; [n]<化工>釜馏物;酿酒厂的放桶台; [add]pt/stillaged,pp/stillaged,pr/stillaging; [or]unix;
subhedral: [a]/,sʌb'hɛdrəl/; [adj]<晶体>半形的(没有完全被晶面包住的); [or]unix;
sudburite: [a]/'sʌdbərait/; [n]<岩>倍苏玄武岩; [or]unix;
sweetening: [a]/'swiːtənɪŋ/; [n]<化工>脱硫;甜味剂;变甜; [v]使.变甜(sweeten的ing形式);加糖于.; [or]unix;
swinestone: [a]/'swain,stəun/; [n]<岩>臭灰岩,臭石灰; [or]unix;
syenite: [a]/'saɪənaɪt/; [n]<岩>正长岩; [or]unix;
syenodiorite: [a]/sainəu'daiərait/; [n]<岩>正长闪长岩; [or]unix;
syenogabbro: [a]/,saiinəu'ɡæbrəu/; [n]<岩>正长辉长岩; [or]unix;
synergist: [a]/'sɪnədʒɪst/; [n]<助剂>增效剂,配合剂;协作剂; [or]unix;
tachiol: [a]/'tækol/; [n]<无化>氟化银; [or]unix;
taconite: [a]/'tækənaɪt/; [n]角岩;<岩>铁燧岩; [or]unix;
tactite: [a]/'tæktait/; [n]<岩>接触岩;接触碳酸岩; [or]unix;
tasmanite: [a]/'tæzmənait/; [n]含硫树脂;沸黄霞辉岩;<岩>塔斯曼油页岩; [or]unix;
tautomer: [a]/'tɔːtəmə/; [n]<物化>互变异构体; [or]unix;
tautomerization: [a]/tɔ:tɔmərai'zei-ʃən, -ri'z-/; [n]<物化>互变异构化; [or]unix;
telluride: [a]/'teljʊraɪd/; [n]<无化>碲化物; [or]unix;
tephrite: [a]/'tefraɪt/; [n]<岩>碱玄岩; [or]unix;
teschenite: [a]/'teʃənait/; [n]沸方绿岩,<岩>沸绿岩;方沸煌绿石; [or]unix;
tetrahedron: [a]/ˌtetrəˈhiːdrən; ˌtetrəˈhedrən/; [n]<晶体>四面体; [add]pl/tetrahedrons或tetrahedra; [or]unix;
tetrahexahedron: [a]/'tetrə,heksə'hi:drɔn/; [n]<晶体>四六面体,二十四面体; [or]unix;
tetroxide: [a]/te'trɒksaɪd/; [n]<无化>四氧化物; [or]unix;
theralite: [a]/'θiərə,lait/; [n]霞斜岩;<岩>企猎岩; [or]unix;
thermite: [a]/'θɝmɪt/; [n]<化工>铝热剂;灼热剂; [or]unix;
thermochemistry: [a]/θɜːməʊ'kemɪstrɪ/; [n]<物化>热化学; [or]unix;
thermometamorphism: [a]/'θə:məu,metə'mɔ:fizəm/; [n]热力变质,<岩>热变质作用;热同素异形现象; [or]unix;
thermoplastic: [a]/ˌθɜːməʊˈplæstɪk/; [adj]热塑性的; [n]<塑料>热塑性塑料; [add]pl/thermoplastics; [or]unix;
thickener: [a]/ˈθɪkənə(r)/; [n]<助剂>增稠剂;浓缩机; [add]pl/thickeners; [or]unix;
thiocyanate: [a]/,θaɪə(ʊ)'saɪəneɪt/; [n]<无化>硫氰酸盐; [or]unix;
thiocyanogen: [a]/,θaɪəʊsaɪ'ænədʒən/; [n]<无化>硫化氰; [or]unix;
tholeiite: [a]/'θəʊlɪaɪt/; [n]<岩>拉斑玄武岩; [or]unix;
thoria: [a]/'θɔːrɪə/; [n]<无化>氧化钍(钍土);二氧化钍; [or]unix;
tillite: [a]/'tɪlaɪt/; [n]<岩>冰碛岩; [or]unix;
titanate: [a]/'taɪtəneɪt/; [n]<无化>钛酸盐; [or]unix;
titania: [a]/taɪ'tenɪə/; [n]<无化>二氧化钛;人造金红石; [or]unix;
titration: [a]/taɪˈtreɪʃn; tɪˈtreɪʃn/; [n]<分化>滴定;滴定法; [or]unix;
titre: [a]/'taɪtə; 'tiːtə/; [n]<分化>滴定度;最小滴定量; [or]unix;
tonalite: [a]/'təunəlait/; [n]<岩>石英闪长岩,<岩>英云闪长岩;英闪岩; [or]unix;
topazolite: [a]/tə(ʊ)'pæzəlaɪt/; [n]<宝>黄榴石; [or]unix;
trachybasalt: [a]/'treɪkɪbə'sɔːlt/; <岩>粗玄岩; 粗面玄武岩; [or]unix;
trachyte: [a]/'treɪkaɪt; 'trækaɪt/; [n]<岩>粗面岩; [or]unix;
trachytic: [a]/trə'kɪtɪk/; [adj]<岩>粗面岩状的; [or]unix;
treater: [a]/'tri:tə/; [n]<化工>处理器;精制器; [or]unix;
treating: [a]/'triːtɪŋ/; [n]<化工>处理; [v]<化工>处理(treat的ing形式);对待; [or]unix;
trimer: [a]/'traɪmə/; [n]<高分子>三聚物; [or]unix;
troctolite: [a]/'trɔktəlait/; [n]橄长石;<岩>橄长岩; [or]unix;
trondhjemite: [a]/'trɔnje,mait/; [n]<岩>奥长花岗岩; [or]unix;
tungstate: [a]/'tʌŋsteɪt/; [n]<无化>钨酸盐; [or]unix;
turbidimetry: [a]/,tə:bi'dimitri/; [n]<分化>比浊法;测浊法;<分化>浑浊度测定; [or]unix;
turbidity: [a]/tɜːˈbɪdəti/; [n]<分化>浊度;浑浊;混浊度;混乱; [or]unix;
ultrabasic: [a]/,ʌltrə'besɪk/; [adj]<岩>超基性的;超碱的; [or]unix;
ultrafilter: [a]/,ʌltrə'fɪltɚ/; [vt]以超滤器过滤; [n]<化工>超滤器; [or]unix;
unattackable: [a]/'ʌnə'tækəbl/; [adj]不可攻破;<化工>耐侵蚀的; [or]unix;
ungaite: [a]/'ʌŋgə,ait/; [n]<岩>奥长英安岩; [or]unix;
ungalvanized: [a]/ʌn'gælvənaizd/; [adj]<化工>未镀锌的; [or]unix;
unglazed: [a]/ʌn'gleɪzd/; [adj]<陶瓷>未上釉的;<纸>无光的;没有装玻璃的; [or]unix;
uranyl: [a]/'jʊər(ə)naɪl; 'jʊər(ə)nɪl/; [n]<无化>铀酰; [or]unix;
vallevarite: [a]/və'levərait/; [n]<岩>反纹二长岩; [or]unix;
vanadate: [a]/'vænədeɪt/; [n]钒酸酯;<无化>钒酸盐(等于vanadiate); [or]unix;
variolite: [a]/'vɛrɪə'laɪt/; [n]<岩>球颗玄武岩;麻点玄武岩; [or]unix;
variolitic: [a]/,vɛrɪə'lɪtɪk/; [adj]<岩>球颗玄武岩的;有斑点的; [or]unix;
varnished: [a]/'vɑrnɪʃ/; [adj]<涂料>涂漆的;浸渍过的; [v]给.上清漆;文饰(varnish的过去分词); [or]unix;
vermilion: [a]/vəˈmɪliən/; [n]<无化>朱砂;朱红色; [adj]朱红色的; [vt]涂以朱红色; [or]unix;
vesuvite: [a]/vi'su:vait/; [n]<岩>白榴碱玄岩;碧玄白榴岩; [or]unix;
villiaumite: [a]/vi'ljɔ:mait/; [n]<无化>氟盐; [or]unix;
vitriol: [a]/ˈvɪtriəl/; [n]硫酸,<无化>硫酸盐;尖刻的话; [vt]用硫酸处理;用尖刻的话伤害; [add]pt/vitrioled或vitriolled,pp/vitrioled或vitriolled,pr/vitrioling或-olling; [or]unix;
vogesite: [a]/'vɔdʒesait/; [n]<岩>闪辉正煌岩; [or]unix;
volcanite: [a]/'vɔlkənait/; [n]火山岩;<岩>歪辉熔岩;含硒硫磺; [or]unix;
volumetry: [a]/vɔ'lju:mitri/; [n]<分化>容量分析;<分化>容量测定; [or]unix;
whinstone: [a]/'hwinstəun/; [n]<岩>暗色岩;玄武岩类; [or]unix;
whisker: [a]/ˈwɪskə(r)/; [n]<晶体>晶须;胡须;腮须; [add]pl/whiskers; [or]unix;
xenocryst: [a]/'zenə(ʊ)krɪst/; [n]<晶体>捕获晶; [or]unix;
xenolith: [a]/'zenəlɪθ/; [n]捕虏岩(指火成岩中与其无成因关系的包体);<岩>捕虏体; [or]unix;
yamaskite: [a]/'ja:mə,skait/; [n]角闪钛辉岩;<岩>钙长闪辉岩; [or]unix;
ytterbia: [a]/ɪ'tɝbɪə/; [n]<无化>氧化镱; [or]unix;
yttria: [a]/'ɪtrɪə/; [n]<无化>氧化钇(等于yttrium oxide); [or]unix;
zincate: [a]/'zɪŋkeɪt/; [n]<无化>锌酸盐; [or]unix;
zincing: [a]/zɪŋk/; [v]<化工>镀锌(zince的现在分词); [or]unix;
zirconate: [a]/'zɝkən,et/; [n]<无化>锆酸盐;锆酸根; [or]unix;
semimetal: [a]/ˈsemimetl/; [n]半金属,准金属; [or]unix;
