ability: [a]/əˈbɪləti/; [n]能力,能耐;才能; [add]pl/abilities; [or]wrt;
abnormal: [a]/æbˈnɔːml/; [adj]反常的,不规则的;变态的; [or]wrt;
abnormality: [a]/ˌæbnɔːˈmæləti/; [n]异常;畸形,变态; [add]pl/abnormalities; [or]wrt;
above: [a]/əˈbʌv/; [prep]超过,多于,胜过;高于;在..上面;在..之上;(因善良或诚实正直而)不至于,不屑于(做某事);偏向于,优先于;;[adv]在(或向)上面;在(或向)较高处;超过;上文,前文;[adj]前文述及的;上述的;以上;[n]上述内容,上述人员;前文; [or]wrt;
absence: [a]/ˈæbsəns/; [n]没有;缺乏;缺席;不注意; [add]pl/absences; [or]wrt;
absent: [a]/ˈæbsənt/; [adj]缺席的;缺少的;心不在焉的;茫然的;[vt]使缺席; [or]wrt;
absolute: [a]/ˈæbsəluːt/; [adj]绝对的;完全的;专制的;[n]绝对;绝对事物; [or]wrt;
academic: [a]/ˌækəˈdemɪk/; [adj]学术的;理论的;学院的;[n]大学生,大学教师;学者; [add]pl/academics; [or]wrt;
accept: [a]/əkˈsept/; [vt]接受;承认;承担;承兑;容纳;[vi]承认;同意;承兑; [add]pt/accepted,pp/accepted,pr/accepting,s3/accepts; [or]wrt;
acceptable: [a]/əkˈseptəbl/; [adj]可接受的;合意的;可忍受的; [add]比较级/moreacceptable,最高级/mostacceptable; [or]wrt;
acceptance: [a]/əkˈseptəns/; [n]接纳;赞同;容忍; [add]pl/acceptances; [or]wrt;
access: [a]/ˈækses/; [n]通道;进入;机会;使用权;探望权;(对计算机存储器的)访问;(情感)爆发;[v]接近,使用;访问,存取(电脑文档);[adj](电视节目或时间等)对外公开的; [add]pt/accessed,pp/accessed,pr/accessing,s3/accesses; [or]wrt;
accessible: [a]/əkˈsesəbl/; [adj]易接近的;可进入的;可理解的; [or]wrt;
according: [a]/ə'kɔːdɪŋ/; [adj]相符的;相应的;一致的;[v]给予;符合,一致;正式协议(accord 的现在分词 ); [or]wrt;
accordingly: [a]/əˈkɔːdɪŋli/; [adv]因此,于是;相应地;照着; [or]wrt;
account: [a]/əˈkaʊnt/; [n]账户;解释;账目,账单;理由;描述;[vi]解释;导致;报账;[vt]认为;把.视为; [or]wrt;
accountability: [a]/əˌkaʊntəˈbɪləti/; [n]有义务;有责任;可说明性; [or]wrt;
accumulate: [a]/əˈkjuːmjəleɪt/; [vi]累积;积聚;[vt]积攒; [add]pt/accumulated,pp/accumulated,pr/accumulating,s3/accumulates; [or]wrt;
accumulation: [a]/əˌkjuːmjəˈleɪʃn/; [n]积聚,累积;堆积物; [or]wrt;
accuracy: [a]/ˈækjərəsi/; [n]<数>精确度,准确性; [add]pl/accuracies; [or]wrt;
accurate: [a]/ˈækjərət/; [adj]精确的; [add]比较级/moreaccurate,最高级/mostaccurate; [or]wrt;
accurately: [a]/ˈækjərətli/; [adv]精确地,准确地; [or]wrt;
achieve: [a]/əˈtʃiːv/; [vt]取得;获得;实现;成功;[vi]达到预期的目的,实现预期的结果,如愿以偿; [or]wrt;
achievement: [a]/əˈtʃiːvmənt/; [n]成就;完成;达到;成绩; [or]wrt;
acknowledge: [a]/əkˈnɒlɪdʒ/; [vt]承认;答谢;报偿;告知已收到; [add]pt/acknowledged,pp/acknowledged,pr/acknowledging,s3/acknowledges; [or]wrt;
acquire: [a]/əˈkwaɪə(r)/; [vt]获得;取得;学到;捕获; [add]pt/acquired,pp/acquired,pr/acquiring,s3/acquires; [or]wrt;
acquisition: [a]/ˌækwɪˈzɪʃn/; [n]获得物,获得;收购; [or]wrt;
act: [a]/ækt/; [v]行动;表现;起作用;扮演(角色);担任;假装;代理;[n]行为;假装;某种行为(或常规等);法令;判决书;会议记录;(戏剧等的)幕;表演;演出团体;[abbr]活跃的 (active);演员 (actor);实际的 (actual); [or]wrt;
action: [a]/ˈækʃn/; [n]行动;活动;功能;战斗;情节;[n](Action)人名;(英)埃克申; [add]pl/actions,pt/actioned,pr/actioning,s3/actions; [or]wrt;
active: [a]/ˈæktɪv/; [adj]积极的;活跃的;主动的;有效的;现役的;[n]主动语态;积极分子; [add]比较级/moreactive,最高级/mostactive; [or]wrt;
actively: [a]/ˈæktɪvli/; [adv]积极地;活跃地; [or]wrt;
activity: [a]/ækˈtɪvəti/; [n]活动;行动;活跃; [add]pl/activities; [or]wrt;
actual: [a]/ˈæktʃuəl/; [adj]真实的,实际的;现行的,目前的; [or]wrt;
adapt: [a]/əˈdæpt/; [vt]使适应;改编;[vi]适应; [add]pt/adapted,pp/adapted,pr/adapting,s3/adapts; [or]wrt;
adaptation: [a]/ˌædæpˈteɪʃn/; [n]适应;改编;改编本,改写本; [add]pl/adaptations; [or]wrt;
adaptive: [a]/əˈdæptɪv/; [adj]适应的,适合的; [or]wrt;
addition: [a]/əˈdɪʃn/; [n]添加;<数>加法;增加物; [add]pl/additions; [or]wrt;
additional: [a]/əˈdɪʃənl/; [adj]附加的,额外的; [or]wrt;
additionally: [a]/əˈdɪʃənəli/; [adv]此外;又,加之; [or]wrt;
address: [a]/əˈdres/; [n]地址;所在地;位置储存编码;演讲;称呼;致辞;谈吐;技巧;[v]写(收信人)姓名地址;演说;向..说话,致词;冠以(某种称呼);设法解决;就位击(球);提出; [add]pt/addressed或addrest,pp/addressed或addrest,pr/addressing,pl/addresses,s3/addresses; [or]wrt;
adequate: [a]/ˈædɪkwət/; [adj]充足的;适当的;胜任的; [or]wrt;
adequately: [a]/ˈædɪkwətli/; [adv]充分地;足够地;适当地; [or]wrt;
adjust: [a]/əˈdʒʌst/; [vt]调整,使.适合;校准;[vi]调整,校准;适应; [add]pt/adjusted,pp/adjusted,pr/adjusting,s3/adjusts; [or]wrt;
adjustment: [a]/əˈdʒʌstmənt/; [n]调整,调节;调节器; [add]pl/adjustments; [or]wrt;
administer: [a]/ədˈmɪnɪstə(r)/; [vt]管理;执行;给予;[vi]给予帮助;执行遗产管理人的职责;担当管理人; [add]pt/administered,pp/administered,pr/administering,s3/administers; [or]wrt;
administration: [a]/ədˌmɪnɪˈstreɪʃn/; [n]管理;行政;实施;行政机构; [add]pl/administrations; [or]wrt;
administrative: [a]/ədˈmɪnɪstrətɪv/; [adj]管理的,行政的; [or]wrt;
adopt: [a]/əˈdɒpt/; [vt]采取;接受;收养;正式通过;[vi]采取;过继; [add]pt/adopted,pp/adopted,pr/adopting,s3/adopts; [or]wrt;
advantage: [a]/ədˈvɑːntɪdʒ/; [n]优势;利益;有利条件;[vi]获利;[vt]有利于;使处于优势; [add]pt/advantaged,pp/advantaged,pr/advantaging,pl/advantages,s3/advantages; [or]wrt;
affect: [a]/əˈfekt/; [vt]影响;感染;感动;假装;[vi]倾向;喜欢;[n]情感;引起感情的因素; [add]pt/affected,pp/affected,pr/affecting,s3/affects; [or]wrt;
age: [a]/eɪdʒ/; [n]年龄;时代;寿命,使用年限;阶段;[vi]成熟;变老;[vt]使成熟;使变老,使上年纪;[n](Age)人名;(瑞典)阿格;(日)扬 (姓);(西,荷)阿赫; [add]pt/aged,pp/aged,pr/aging或ageing; [or]wrt;
agenda: [a]/əˈdʒendə/; [n]议程;日常工作事项;日程表; [or]wrt;
agent: [a]/ˈeɪdʒənt/; [n]代理人,代理商;药剂;特工;动因;[vt]由.作中介;由.代理;[adj]代理的;[n](Agent)人名;(罗)阿真特; [or]wrt;
agreement: [a]/əˈɡriːmənt/; [n]协议;同意,一致; [add]pl/agreements; [or]wrt;
agricultural: [a]/ˌæɡrɪˈkʌltʃərəl/; [adj]农业的;农艺的; [or]wrt;
aim: [a]/eɪm/; [v]目的在于;引导;把..对准;瞄准;[n]目的;瞄准; [or]wrt;
allow: [a]/əˈlaʊ/; [vt]允许;给予;认可;[vi]容许;考虑; [add]pt/allowed,pp/allowed,pr/allowing,s3/allows; [or]wrt;
alter: [a]/ˈɔːltə(r)/; [vt]改变,更改;[vi]改变;修改;[n](Alter) (美,德)阿尔特(人名); [or]wrt;
alteration: [a]/ˌɔːltəˈreɪʃn/; [n]修改,改变;变更; [add]pl/alterations; [or]wrt;
alternative: [a]/ɔːlˈtɜːnətɪv/; [adj]供选择的;选择性的;交替的;[n]二中择一;供替代的选择; [add]pl/alternatives; [or]wrt;
alternatively: [a]/ɔːlˈtɜːnətɪvli/; [adv]要不,或者;非此即彼;二者择一地;作为一种选择; [or]wrt;
although: [a]/ɔːlˈðəʊ/; [conj]尽管,虽然;但是,然而; [or]wrt;
among: [a]/əˈmʌŋ/; [prep]在..中间,周围是;在..之中,..之一;与..在一起;在三者或以上(中选择);以及;为..所特有;(群体内部)相互间; [or]wrt;
amount: [a]/əˈmaʊnt/; [n]数量,数额;总数;(感情,特质的)程度;[v]总计,合计;等于,相当于;发展成,变成; [add]pl/amounts,pt/amounted,pp/amounted,pr/amounting,s3/amounts; [or]wrt;
analyse: [a]/ˈænəlaɪz/; [vt]分析;分解;细察; [add]pt/analysed,pp/analysed,pr/analysing,s3/analyses; [or]wrt;
analysis: [a]/əˈnæləsɪs/; [n]分析;分解;验定; [add]pl/analyses; [or]wrt;
analyst: [a]/ˈænəlɪst/; [n]分析者;精神分析医师;分解者; [add]pl/analysts; [or]wrt;
analytical: [a]/ˌænəˈlɪtɪkl/; [adj]分析的;解析的;善于分析的; [or]wrt;
animal: [a]/ˈænɪml/; [n]动物; 动物的; [add]pl/animals; [or]wrt;
annual: [a]/ˈænjuəl/; [adj]年度的;每年的;[n]年刊,年鉴;一年生植物; [add]pl/annuals; [or]wrt;
anxiety: [a]/æŋˈzaɪəti/; [n]焦虑;渴望;挂念;令人焦虑的事; [add]pl/anxieties; [or]wrt;
apparent: [a]/əˈpærənt/; [adj]显然的;表面上的; [or]wrt;
appear: [a]/əˈpɪə(r)/; [vi]出现;显得;似乎;出庭;登场; [or]wrt;
applicable: [a]/əˈplɪkəbl; ˈæplɪkəbl/; [adj]可适用的;可应用的;合适的; [or]wrt;
application: [a]/ˌæplɪˈkeɪʃn/; [n]应用;申请;应用程序;敷用;(对事物,学习等)投入; [or]wrt;
apply: [a]/əˈplaɪ/; [vt]申请;涂,敷;应用;[vi]申请;涂,敷;适用;请求; [add]pt/applied,pp/applied,pr/applying,s3/applies; [or]wrt;
approach: [a]/əˈprəʊtʃ/; [v]走进;与..接洽;处理;临近,逐渐接近(某时间或事件);几乎达到(某水平或状态);[n]方法,方式;接近;接洽;(某事的)临近;路径;进场(着陆);相似的事物; [add]s3/approaches,pt/approached,pp/approached,pr/approaching,pl/approaches; [or]wrt;
appropriate: [a]/əˈprəʊpriət/; [adj]适当的;恰当的;合适的;[vt]占用,拨出; [or]wrt;
approximately: [a]/əˈprɒksɪmətli/; [adv]大约,近似地;近于; [or]wrt;
approximation: [a]/əˌprɒksɪˈmeɪʃn/; [n]<数>近似法;接近;<数>近似值; [add]pl/approximations; [or]wrt;
area: [a]/ˈeəriə/; [n]区域,地区;面积;范围;[n](Area)人名;(西)阿雷亚; [add]pl/areas; [or]wrt;
arguably: [a]/ˈɑːɡjuəbli/; [adv]可论证地;可争辩地;正如可提出证据加以证明的那样地; <广义用法]可能,大概; [or]wrt;
argue: [a]/ˈɑːɡjuː/; [vi]争论,辩论;提出理由;[vt]辩论,争论;证明;说服;[n](Argue)人名;(英,法)阿格; [add]pt/argued,pp/argued,pr/arguing,s3/argues; [or]wrt;
argument: [a]/ˈɑːɡjumənt/; [n]论证;论据;争吵;内容提要; [add]pl/arguments; [or]wrt;
arise: [a]/əˈraɪz/; [vi]出现;上升;起立;[n](Arise) (美,印,德,英)阿里塞(人名); [or]wrt;
arrangement: [a]/əˈreɪndʒmənt/; [n]布置;整理;准备;安排; [or]wrt;
article: [a]/ˈɑːtɪkl/; [n]文章;物品;条款;<语>冠词;[vt]订约将.收为学徒或见习生;使.受协议条款的约束;[vi]签订协议;进行控告; [add]pt/articled,pp/articled,pr/articling,pl/articles,s3/articles; [or]wrt;
aspect: [a]/ˈæspekt/; [n]方面;方向;形势;外貌; [add]pl/aspects; [or]wrt;
assert: [a]/əˈsɜːt/; [vt]维护,坚持;断言;主张;声称; [add]pt/asserted,pp/asserted,pr/asserting,s3/asserts; [or]wrt;
assertion: [a]/əˈsɜːʃn/; [n]断言,声明;主张,要求;坚持;认定; [or]wrt;
assess: [a]/əˈses/; [vt]评定;估价;对.征税; [add]pt/assessed,pp/assessed,pr/assessing,s3/assesses; [or]wrt;
assessment: [a]/əˈsesmənt/; [n]评定;估价; [add]pl/assessments; [or]wrt;
assign: [a]/əˈsaɪn/; [vt]分配;指派;<计]<数>赋值;[vi]将财产过户(尤指过户给债权人); [add]pt/assigned,pp/assigned,pr/assigning,s3/assigns; [or]wrt;
associate: [a]/əˈsəʊsieɪt; əˈsəʊʃieɪt/; [v]联想,联系;(使)关联;与(不被认同的人)交往;将..和..联系起来;表示同意;[n](生意或工作上的)伙伴;准会员;联想;准零售工;[adj](与某组织或企业)联合的;副的; [add]pt/associated,pp/associated,pr/associating,pl/associates,s3/associates; [or]wrt;
association: [a]/əˌsəʊsiˈeɪʃn; əˌsəʊʃiˈeɪʃn/; [n]协会,联盟,社团;联合;联想; [add]pl/associations; [or]wrt;
assume: [a]/əˈsjuːm/; [vi]设想;承担;采取;[vt]假定;僭取;篡夺;夺取;擅用;侵占; [or]wrt;
assumption: [a]/əˈsʌmpʃn/; [n]假定;设想;担任;采取; [add]pl/assumptions; [or]wrt;
attitude: [a]/ˈætɪtjuːd/; [n]态度;看法;意见;姿势; [add]pl/attitudes; [or]wrt;
attribute: [a]/əˈtrɪbjuːt/; [n]属性;特质;[vt]归属;把.归于; [add]pt/attributed,pp/attributed,pr/attributing,pl/attributes,s3/attributes; [or]wrt;
author: [a]/ˈɔːθə(r)/; [n]作者;作家;创始人;[vt]创作出版; [add]pl/authors,pt/authored,pp/authored,pr/authoring,s3/authors; [or]wrt;
authority: [a]/ɔːˈθɒrəti/; [n]权威;权力;当局; [add]pl/authorities; [or]wrt;
availability: [a]/əˌveɪləˈbɪləti/; [n]可用性;有效性;实用性; [or]wrt;
available: [a]/əˈveɪləbl/; [adj]可获得的;可购得的;可找到的;有空的; [or]wrt;
average: [a]/ˈævərɪdʒ/; [n]平均;平均数;(海损的)平均分担;平均水平;(按保单规定应付赔偿额的)降减;[adj]平均(数)的;普通的;典型的;平庸的;中等的,适中的;[v]算出..的平均数;将..平均分配;使..平衡;平均为,平均达到;呈中间色;(行情下跌时)买进更多的证券(或商品)以降低平均进价; [add]pt/averaged,pp/averaged,pr/averaging,pl/averages,s3/averages; [or]wrt;
avoid: [a]/əˈvɔɪd/; [vt]避免;避开,躲避;消除; [add]pt/avoided,pp/avoided,pr/avoiding,s3/avoids; [or]wrt;
aware: [a]/əˈweə(r)/; [adj]意识到的;知道的;有.方面知识的;懂世故的;[n](Aware)人名;(阿拉伯,索)阿瓦雷; [or]wrt;
awareness: [a]/əˈweənəs/; [n]意识,认识;明白,知道;[n]人群对品牌或产品的认知; [or]wrt;
background: [a]/ˈbækɡraʊnd/; [n]背景;隐蔽的位置;[vt]作.的背景;[adj]背景的;发布背景材料的; [add]pl/backgrounds; [or]wrt;
balance: [a]/ˈbæləns/; [n]平衡;余额;匀称;[vt]使平衡;结算;使相称;[vi]保持平衡;相称;抵销;[n](Balance)人名;(西)巴兰塞; [add]pt/balanced,pp/balanced,pr/balancing,pl/balances,s3/balances; [or]wrt;
barrier: [a]/ˈbæriə(r)/; [n]障碍物,屏障;界线;[vt]把.关入栅栏;[n](Barrier)人名;(法)巴里耶; [add]pl/barriers; [or]wrt;
base: [a]/beɪs/; [n]基底;基础;基地;基本成分;碱;(晶体管的)基极;词根;(数系的)基数;(棒球)垒;[adj]卑鄙的;低劣的;[v]以..作基础;将..的活动中心设在某地;[n](Base) (英,美,爱尔兰)马濑(人名); [or]wrt;
based: [a]/beɪst/; [adj]基地在..的;在..居住(或工作);(以某事)为基础,为根据;[v]立基于,以..为基础(base 的过去式和过去分词); [or]wrt;
basic: [a]/ˈbeɪsɪk/; [adj]基本的;基础的;[n]基础;要素; [add]pl/basics; [or]wrt;
basis: [a]/ˈbeɪsɪs/; [n]基础;底部;主要成分;基本原则或原理; [add]pl/bases; [or]wrt;
behave: [a]/bɪˈheɪv/; [vi]表现;(机器等)运转;举止端正;(事物)起某种作用;[vt]使守规矩;使表现得.; [add]pt/behaved,pp/behaved,pr/behaving,s3/behaves; [or]wrt;
behaviour: [a]/bɪˈheɪvjə(r)/; [n]行为;习性;运行状况(=behavior); [or]wrt;
belief: [a]/bɪˈliːf/; [n]相信,信赖;信仰;教义; [add]pl/beliefs; [or]wrt;
below: [a]/bɪˈləʊ/; [prep]在..下面;(位置或层面)低于;在..以下,低于;[adv]在下面,在较低处;在本页下面;在主甲板下;[n](Below) (英,德,芬,瑞,丹,加)贝洛(人名); [or]wrt;
beneficial: [a]/ˌbenɪˈfɪʃl/; [adj]有益的,有利的;可享利益的; [or]wrt;
beneficiary: [a]/ˌbenɪˈfɪʃəri/; [n]<金融>受益人,受惠者;封臣;[adj]拥有封地的;受圣俸的; [add]pl/beneficiaries; [or]wrt;
benefit: [a]/ˈbenɪfɪt/; [n]利益,好处;救济金;[vt]有益于,对.有益;[vi]受益,得益; [or]wrt;
between: [a]/bɪˈtwiːn/; [prep](空间,时间,数量等)在..之间;往返于;(表关系)两..之间;合用;一起;[adv](时间或空间)介于..之间;在期间; [or]wrt;
beyond: [a]/bɪˈjɒnd/; [prep]在(或向)..较远的一边;超过,越过;晚于,迟于;[adv]在另一边;在(或向)更远处;[n]远处的事物;来世,再生; [or]wrt;
bias: [a]/ˈbaɪəs/; [n]偏见;偏爱;斜纹;乖离率;[vt]使存偏见;[adj]偏斜的;[adv]偏斜地;[n](Bias)人名;(法,德,葡,喀)比亚斯;(英)拜厄斯; [add]pl/biases,pt/biased或biassed,pp/biased或biassed,pr/biasing或biassing,s3/biases; [or]wrt;
broad: [a]/brɔːd/; [adj]宽的,辽阔的;显著的;大概的;[n]宽阔部分;[adv]宽阔地;[n](Broad)人名;(英,德)布罗德; [add]pl/broads; [or]wrt;
broadly: [a]/ˈbrɔːdli/; [adv]明显地;宽广地;概括地;露骨地;粗鄙地; [or]wrt;
burden: [a]/ˈbɜːdn/; [n]负担;责任;船的载货量;[vt]使负担;烦扰;装货于;[n](Burden)人名;(英)伯登; [or]wrt;
can: [a]/kæn/;  aux. 能;能够;有机会;可能;被允许;[n]圆柱形金属容器;罐头;一听所装的(食物或饮料)量;酒瓶;喷罐;监狱;卫生间;臀部;驱逐舰;破坏者;[v]把(食物)装罐保存;(非正式)解雇;拒绝接受;[n](Can) (美)卡恩(人名); [or]wrt;
capability: [a]/ˌkeɪpəˈbɪləti/; [n]才能,能力;性能,容量; [add]pl/capabilities; [or]wrt;
capable: [a]/ˈkeɪpəbl/; [adj]有能力的;有才干的;容许..的;可以做(某事)的;综合性的;有资格的; [or]wrt;
capacity: [a]/kəˈpæsəti/; [n]能力;容量;资格,地位;生产力; [add]pl/capacities; [or]wrt;
care: [a]/keə(r)/; [n]关怀;照料;谨慎;忧虑;[vi]照顾;关心;喜爱;顾虑;[vt]在意;希望或喜欢;[n](Care)人名;(英)凯尔;(塞)察蕾; [add]pt/cared,pp/cared,pr/caring,s3/cares; [or]wrt;
case: [a]/keɪs/; [n]情况;实例;箱;[vt]包围;把.装于容器中;[n](Case)人名;(英)凯斯;(西)卡塞;(法)卡斯; [add]pt/cased,pp/cased,pr/casing,pl/cases,s3/cases; [or]wrt;
categorize: [a]/ˈkætəɡəraɪz/; [vt]分类; [add]pt/categorized,pp/categorized,pr/categorizing,s3/categorizes; [or]wrt;
category: [a]/ˈkætəɡəri/; [n]种类,分类;<数>范畴; [add]pl/categories; [or]wrt;
causal: [a]/ˈkɔːzl/; [adj]因果关系的;有原因的;[n]表示原因的连词; [or]wrt;
causation: [a]/kɔːˈzeɪʃn/; [n]原因;因果关系;出现; [or]wrt;
cause: [a]/kɔːz/; [n]原因;事业;目标;[vt]引起;使遭受; [add]pt/caused,pp/caused,pr/causing; [or]wrt;
central: [a]/ˈsentrəl/; [adj]中心的;主要的;中枢的;[n]电话总机; [add]pl/centrals; [or]wrt;
centralize: [a]/ˈsentrəlaɪz/; [vt]使集中;使成为.的中心;使集权;[vi]集中;实行中央集权; [add]pt/centralized,pp/centralized,pr/centralizing,s3/centralizes; [or]wrt;
centre: [a]/ˈsentə(r)/; [n]中心;(市镇的)中心区,人口集中的地区;活动中心;居领先地位的中心;聚集点;有..中心的;中间党派;(球赛的)中锋;传中(球赛中将球从场边扔向场中);巧克力夹心;转轴;(车床等用于支撑的)顶针;源头;最重要的地方;[v]将..放在中央;以..为中心;使(争论)集中于;(活动)集中于;传中;打中锋;[v](Centre) (印,澳,肯尼亚)森特尔(人名); [add]pt/centred,pp/centred,pr/centring,pl/centres,s3/centres; [or]wrt;
century: [a]/ˈsentʃəri/; [n]世纪,百年;(板球)一百分; [add]pl/centuries; [or]wrt;
certain: [a]/ˈsɜːtn/; [adj]某一;必然的;确信;无疑的;有把握的;[pron]某些;某几个;[n](Certain)人名;(葡)塞尔塔因;(法)塞尔坦; [add]比较级/morecertain,最高级/mostcertain; [or]wrt;
certainty: [a]/ˈsɜːtnti/; [n]必然;确实;确实的事情; [add]pl/certainties; [or]wrt;
chain: [a]/tʃeɪn/; [n]链;束缚;枷锁;[vt]束缚;囚禁;用铁链锁住; [or]wrt;
challenge: [a]/ˈtʃælɪndʒ/; [n]挑战;怀疑;[vt]向.挑战;对.质疑; [or]wrt;
change: [a]/tʃeɪndʒ/; [v]改变,转变,(使)不同;(使)变换;替代,更换;交换;货币兑换;将..换成零钱;退还;[n]变化,改变;替代物;换洗衣物;零钱,硬币;换乘;全新体验;新月相的出现; [add]pt/changed,pp/changed,pr/changing,pl/changes,s3/changes; [or]wrt;
channel: [a]/ˈtʃænl/; [n]电视台;频道;途径;方式;通道;水渠;航道;海峡;河床;信道,(电子)沟道;输液管;[v]引导,开导;提供资金;输送;开辟水道,形成凹槽;(人)通灵;模仿,努力赶上;[n](Channel) (美)沙内乐(人名); [add]pt/channeled或-nelled,pp/channeled或-nelled,pr/channeling或-nelling,pl/channels,s3/channels; [or]wrt;
character: [a]/ˈkærəktə(r)/; [n]性格,品质;特性;角色;<计>字符;[vt]印,刻;使具有特征;[n](Character)人名;(英)克拉克特; [add]pl/characters,pt/charactered,pp/charactered,pr/charactering,s3/characters; [or]wrt;
characteristic: [a]/ˌkærəktəˈrɪstɪk/; [adj]典型的;特有的;表示特性的;[n]特征;特性;特色; [add]pl/characteristics; [or]wrt;
characterization: [a]/ˌkærəktəraɪˈzeɪʃn/; [n]描述;特性描述; [add]pl/characterizations; [or]wrt;
characterize: [a]/ˈkærəktəraɪz/; [vt]描绘.的特性;具有.的特征;[vi]塑造人物; [add]pt/characterized,pp/characterized,pr/characterizing,s3/characterizes; [or]wrt;
choice: [a]/tʃɔɪs/; [n]选择;选择权;精选品;[adj]精选的;仔细推敲的; [add]比较级/choicer,最高级/choicest,pl/choices; [or]wrt;
circumstance: [a]/ˈsɜːkəmstəns; ˈsɜːkəmstɑːns; ˈsɜːkəmstæns/; [n]环境;状况;境遇;(尤指)经济状况;命运;[vt]处于某种情况; [or]wrt;
cite: [a]/saɪt/; [vt]引用;传讯;想起;表彰; [add]pt/cited,pp/cited,pr/citing,s3/cites; [or]wrt;
claim: [a]/kleɪm/; [v]宣称;要求,索取;引起(注意);获得;夺去(生命);索赔(钱财);需要;[n]声称;(财产等)所有权;(向公司等)索赔;专利新特征申明;要求(权利);(取得的)采矿地;索要; [add]pl/claims,pt/claimed,pp/claimed,pr/claiming,s3/claims; [or]wrt;
classic: [a]/ˈklæsɪk/; [adj]经典的;古典的,传统的;最优秀的;[n]名著;经典著作;大艺术家; [or]wrt;
classical: [a]/ˈklæsɪkl/; [adj]古典的;经典的;传统的;第一流的;[n]古典音乐; [or]wrt;
classification: [a]/ˌklæsɪfɪˈkeɪʃn/; [n]分类;类别,等级; [add]pl/classifications; [or]wrt;
classify: [a]/ˈklæsɪfaɪ/; [vt]分类;分等; [add]pt/classified,pp/classified,pr/classifying,s3/classifies; [or]wrt;
clear: [a]/klɪə(r)/; [adj]清楚的;清澈的;晴朗的;无罪的;[vt]通过;清除;使干净;跳过;[vi]放晴;变清澈;[adv]清晰地;完全地;[n]清除;空隙;[n](Clear)人名;(英)克利尔; [add]比较级/clearer,最高级/clearest,pt/cleared,pp/cleared,pr/clearing,s3/clears; [or]wrt;
clearly: [a]/ˈklɪəli/; [adv]清晰地;明显地;无疑地;明净地; [or]wrt;
climate: [a]/ˈklaɪmət/; [n]气候;风气;思潮;风土; [add]pl/climates; [or]wrt;
code: [a]/kəʊd/; [n]代码,密码;编码;法典;[vt]编码;制成法典;[vi]指定遗传密码;[n](Code)人名;(英,法,西)科德; [add]pt/coded,pp/coded,pr/coding,pl/codes,s3/codes; [or]wrt;
column: [a]/ˈkɒləm/; [n]纵队,列;专栏;圆柱,柱形物; [add]pl/columns; [or]wrt;
combination: [a]/ˌkɒmbɪˈneɪʃn/; [n]结合;组合;联合;<化学>化合; [add]pl/combinations; [or]wrt;
combine: [a]/kəmˈbaɪn/; [vt]使化合;使联合,使结合;[vi]联合,结合;化合;[n]联合收割机;联合企业; [add]pt/combined,pp/combined,pr/combining; [or]wrt;
commercial: [a]/kəˈmɜːʃl/; [adj]商业的;营利的;靠广告收入的;[n]商业广告; [add]pl/commercials; [or]wrt;
commit: [a]/kəˈmɪt/; [vt]犯罪;把...交托给;指派.作战;使.承担义务;(公开地)表示意见;[vi]忠于(某个人,机构等);承诺; [or]wrt;
commitment: [a]/kəˈmɪtmənt/; [n]承诺,保证;委托;承担义务;献身; [add]pl/commitments; [or]wrt;
common: [a]/ˈkɒmən/; [adj]共同的;普通的;一般的;通常的;[n]普通;平民;公有地;[n](Common)人名;(法)科蒙;(英)康芒; [add]比较级/commoner,最高级/commonest,pl/commons; [or]wrt;
commonly: [a]/ˈkɒmənli/; [adv]一般地;通常地;普通地; [add]比较级morecommonly/最高级; [or]wrt;
communicate: [a]/kəˈmjuːnɪkeɪt/; [vi]通讯,传达;相通;交流;感染;[vt]传达;感染;显露; [or]wrt;
communication: [a]/kəˌmjuːnɪˈkeɪʃn/; [n]通讯,<通信>通信;交流;信函; [or]wrt;
community: [a]/kəˈmjuːnəti/; [n]社区;<生态>群落;共同体;团体; [add]pl/communities; [or]wrt;
comparable: [a]/ˈkɒmpərəbl/; [adj]类似的,可比较的;同等的,相当的; [or]wrt;
comparative: [a]/kəmˈpærətɪv/; [adj]比较的;相当的;[n]比较级;对手; [add]pl/comparatives; [or]wrt;
compare: [a]/kəmˈpeə(r)/; [v]比较,对比;与..类似,将..比作;相比,匹敌;构成(形容词或副词)的比较级和最高级;[n]比较; [add]pt/compared,pp/compared,pr/comparing,s3/compares; [or]wrt;
comparison: [a]/kəmˈpærɪsn/; [n]比较;对照;比喻;比较关系; [add]pl/comparisons; [or]wrt;
compete: [a]/kəmˈpiːt/; [vi]竞争;比赛;对抗; [add]pt/competed,pp/competed,pr/competing,s3/competes; [or]wrt;
competition: [a]/ˌkɒmpəˈtɪʃn/; [n]竞争;比赛,竞赛; [add]pl/competitions; [or]wrt;
complex: [a]/ˈkɒmpleks/; [adj]复杂的;合成的;[n]复合体;综合设施; [add]比较级/morecomplex,最高级/mostcomplex,pl/complexes; [or]wrt;
complexity: [a]/kəmˈpleksəti/; [n]复杂,复杂性;复杂错综的事物; [add]pl/complexities; [or]wrt;
component: [a]/kəmˈpəʊnənt/; [n]组成部分;成分;组件,元件;[adj]组成的;构成的; [add]pl/components; [or]wrt;
composition: [a]/ˌkɒmpəˈzɪʃn/; [n]作文,作曲,作品;<材>构成;合成物;成分; [or]wrt;
comprehensive: [a]/ˌkɒmprɪˈhensɪv/; [adj]综合的;广泛的;有理解力的;[n]综合学校;专业综合测验; [add]pl/comprehensives; [or]wrt;
comprise: [a]/kəmˈpraɪz/; [vt]包含;由.组成; [add]pt/comprised,pp/comprised,pr/comprising,s3/comprises; [or]wrt;
conceive: [a]/kənˈsiːv/; [vt]怀孕;构思;以为;持有;[vi]怀孕;设想;考虑; [add]pt/conceived,pp/conceived,pr/conceiving,s3/conceives; [or]wrt;
concept: [a]/ˈkɒnsept/; [n]观念,概念; [add]pl/concepts; [or]wrt;
conception: [a]/kənˈsepʃn/; [n]怀孕;概念;设想;开始; [add]pl/conceptions; [or]wrt;
conceptual: [a]/kənˈseptʃuəl/; [adj]概念上的; [or]wrt;
conceptualize: [a]/kənˈseptʃuəlaɪz/; [vt]使概念化;[vi]概念化; [add]pt/conceptualized,pp/conceptualized,pr/conceptualizing,s3/conceptualizes; [or]wrt;
concern: [a]/kənˈsɜːn/; [vt]影响,牵扯(某人);关系到,涉及;使担心;[n]担心,忧虑;关爱,关心;关心的事,负责的事;关系;公司,企业;(非正式)复杂的物体; [or]wrt;
conclude: [a]/kənˈkluːd/; [vt]推断;决定,作结论;结束;[vi]推断;断定;决定; [add]pt/concluded,pp/concluded,pr/concluding,s3/concludes; [or]wrt;
conclusion: [a]/kənˈkluːʒn/; [n]结论;结局;推论; [add]pl/conclusions; [or]wrt;
condition: [a]/kənˈdɪʃn/; [n]条件;情况;环境;身份;[vt]决定;使适应;使健康;以.为条件; [add]pl/conditions,pt/conditioned,pp/conditioned,pr/conditioning,s3/conditions; [or]wrt;
conditional: [a]/kənˈdɪʃənl/; [adj]有条件的;假定的;[n]条件句;条件语; [add]pl/conditionals; [or]wrt;
conduct: [a]/kənˈdʌkt/; [v]组织,实施,进行;指挥(音乐);带领,引导;举止,表现;传导(热或电);[n]行为举止;管理(方式),实施(办法);引导; [add]pl/conducts,pt/conducted,pp/conducted,pr/conducting,s3/conducts; [or]wrt;
confirm: [a]/kənˈfɜːm/; [vt]确认;确定;证实;批准;使巩固; [add]pt/confirmed,pp/confirmed,pr/confirming,s3/confirms; [or]wrt;
conflict: [a]/ˈkɒnflɪkt/; [n]冲突,矛盾;斗争;争执;[vi]冲突,抵触;争执;战斗; [add]pl/conflicts,pt/conflicted,pp/conflicted,pr/conflicting,s3/conflicts; [or]wrt;
connect: [a]/kəˈnekt/; [vt]连接;联合;关连;链接;[vi]连接,连结;联合; [or]wrt;
connection: [a]/kəˈnekʃn/; [n]连接;关系;人脉;连接件; [or]wrt;
consensus: [a]/kənˈsensəs/; [n]一致;舆论;合意; [add]pl/consensuses; [or]wrt;
consent: [a]/kənˈsent/; [n]准许,同意;赞同,同意;正式批准文件,批文;(古)一致,和谐;[v]同意,准许;(古)赞成(意见,看法等);[n](Consent)(法,荷,美)孔桑(人名); [add]pt/consented,pp/consented,pr/consenting,s3/consents; [or]wrt;
consequence: [a]/ˈkɒnsɪkwəns/; [n]结果;重要性;推论; [add]pl/consequences; [or]wrt;
consequently: [a]/ˈkɒnsɪkwəntli/; [adv]因此;结果;所以; [or]wrt;
conservation: [a]/ˌkɒnsəˈveɪʃn/; [n]保存,保持;保护; [add]pl/conservations; [or]wrt;
conservative: [a]/kənˈsɜːvətɪv/; [adj]保守的;[n]保守派,守旧者; [add]比较级/moreconservative,最高级/mostconservative,pl/conservatives; [or]wrt;
conserve: [a]/kənˈsɜːv/; [vt]保存;将.做成蜜饯;使守恒;[n]果酱;蜜饯; [add]pt/conserved,pp/conserved,pr/conserving; [or]wrt;
consider: [a]/kənˈsɪdə(r)/; [vt]考虑;认为;考虑到;细想;[vi]考虑;认为;细想; [add]pt/considered,pp/considered,pr/considering,s3/considers; [or]wrt;
considerable: [a]/kənˈsɪdərəbl/; [adj]相当大的;重要的,值得考虑的; [add]比较级/moreconsiderable,最高级/mostconsiderable; [or]wrt;
considerably: [a]/kənˈsɪdərəbli/; [adv]相当地;非常地; [or]wrt;
consideration: [a]/kənˌsɪdəˈreɪʃn/; [n]考虑;原因;关心;报酬; [add]pl/considerations; [or]wrt;
consist: [a]/kənˈsɪst/; [vi]由.组成;在于;符合; [or]wrt;
consistency: [a]/kənˈsɪstənsi/; [n]<计>一致性;稠度;相容性; [add]pl/consistencies; [or]wrt;
consistent: [a]/kənˈsɪstənt/; [adj]始终如一的,一致的;坚持的; [add]比较级/moreconsistent,最高级/mostconsistent; [or]wrt;
consistently: [a]/kənˈsɪstəntli/; [adv]一贯地;一致地;坚实地; [or]wrt;
constant: [a]/ˈkɒnstənt/; [adj]不变的;恒定的;经常的;[n]<数>常数;恒量;[n](Constant)人名;(德)康斯坦特; [add]pl/constants; [or]wrt;
constitute: [a]/ˈkɒnstɪtjuːt/; [vt]组成,构成;建立;任命; [add]pt/constituted,pp/constituted,pr/constituting,s3/constitutes; [or]wrt;
constrain: [a]/kənˈstreɪn/; [vt]驱使;强迫;束缚; [add]pt/constrained,pp/constrained,pr/constraining,s3/constrains; [or]wrt;
constraint: [a]/kənˈstreɪnt/; [n]<数>约束;局促,态度不自然;强制; [add]pl/constraints; [or]wrt;
construct: [a]/kənˈstrʌkt/; [v]建造,修建(某物,尤指建筑物,公路,机器);组成,创建;(按照数学规则)编制,绘制;形成(观念,理论);[n]构想,概念;编造,杜撰;(短语的)结构成分,结构体;建造物,构筑物; [add]pl/constructs,pt/constructed,pp/constructed,pr/constructing,s3/constructs; [or]wrt;
construction: [a]/kənˈstrʌkʃn/; [n]建设;建筑物;解释;造句; [add]pl/constructions; [or]wrt;
constructive: [a]/kənˈstrʌktɪv/; [adj]建设性的;推定的;构造上的;有助益的; [or]wrt;
consume: [a]/kənˈsjuːm/; [vt]消耗,消费;使.着迷;挥霍;[vi]耗尽,毁灭;耗尽生命; [or]wrt;
consumption: [a]/kənˈsʌmpʃn/; [n]消费;消耗;肺痨; [add]pl/consumptions; [or]wrt;
contact: [a]/ˈkɒntækt/; [n]接触,联系;[vt]使接触,联系;[vi]使接触,联系; [or]wrt;
contain: [a]/kənˈteɪn/; [vt]包含;控制;容纳;牵制(敌军);[vi]含有;自制; [add]pt/contained,pp/contained,pr/containing,s3/contains; [or]wrt;
contemporary: [a]/kənˈtemprəri/; [adj]发生(属)于同时期的;当代的;[n]同代人,同龄人;同时期的东西; [add]pl/contemporaries; [or]wrt;
content: [a]/kən'tent/; [n]内容,目录;满足;容量;[adj]满意的;[vt]使满足;[n](Content)人名;(法)孔唐; [add]pl/contents,pt/contented,pp/contented,pr/contenting,s3/contents; [or]wrt;
context: [a]/ˈkɒntekst/; [n]环境;上下文;来龙去脉; [add]pl/contexts; [or]wrt;
continuity: [a]/ˌkɒntɪˈnjuːəti/; [n]连续性;一连串;分镜头剧本; [add]pl/continuities; [or]wrt;
continuous: [a]/kənˈtɪnjuəs/; [adj]连续的,持续的;继续的;连绵不断的; [or]wrt;
contrast: [a]/ˈkɒntrɑːst/; [n]明显的差异,对比,对照; 明显不同的人(或事物);(摄影或绘画中的)颜色反差;图像明暗对比度,反差;[v]对比,对照;显出明显的差异, 与..形成对比; [add]pl/contrasts,pt/contrasted,pp/contrasted,pr/contrasting,s3/contrasts; [or]wrt;
contribute: [a]/kənˈtrɪbjuːt; ˈkɒntrɪbjuːt/; [vt]贡献,出力;投稿;捐献;[vi]贡献,出力;投稿;捐献; < 过去式 contributed 过去分词 contributed 现在分词 contributing ]; [or]wrt;
contribution: [a]/ˌkɒntrɪˈbjuːʃn/; [n]贡献;捐献;投稿; [add]pl/contributions; [or]wrt;
control: [a]/kənˈtrəʊl/; [n]控制;管理;抑制;操纵装置;[vt]控制;管理;抑制; [add]pt/controlled,pp/controlled,pr/controlling,pl/controls,s3/controls; [or]wrt;
convention: [a]/kənˈvenʃn/; [n]大会;<法>惯例;<计>约定;<法>协定;习俗; [add]pl/conventions; [or]wrt;
conventional: [a]/kənˈvenʃənl/; [adj]符合习俗的,传统的;常见的;惯例的; [or]wrt;
conversion: [a]/kənˈvɜːʃn/; [n]转换;变换;<金融>兑换;改变信仰; [add]pl/conversions; [or]wrt;
convert: [a]/kənˈvɜːt/; [vt]使转变;转换.;使.改变信仰;[vi]转变,变换;皈依;改变信仰;[n]皈依者;改变宗教信仰者;[n](Convert)人名;(法)孔韦尔; [or]wrt;
cooperation: [a]/kəʊˌɒpəˈreɪʃn/; [n]合作,协作;<劳经>协力; [add]pl/cooperations; [or]wrt;
cooperative: [a]/kəʊˈɒpərətɪv/; [adj]合作的;合作社的;[n]合作社; [add]pl/cooperatives; [or]wrt;
coordinate: [a]/kəʊˈɔːdɪneɪt/; [v]调节,配合;使动作协调;(衣服,家具等)搭配;与..形成共价键;[adj]同等的,并列的;配位的;坐标的;[n]坐标;配套服装;同等的人或物; [add]pt/coordinated,pp/coordinated,pr/coordinating,pl/coordinates,s3/coordinates; [or]wrt;
coordination: [a]/kəʊˌɔːdɪˈneɪʃn/; [n]协调,调和;对等,同等; [or]wrt;
core: [a]/kɔː(r)/; [n]核心;要点;果心;<计>磁心;[vt]挖...的核;[n](Core)人名;(英)科尔;(西,意)科雷; [add]pt/cored,pp/cored,pr/coring,pl/cores,s3/cores; [or]wrt;
correct: [a]/kəˈrekt/; [adj](政治或思想)正确的;恰当的;端正的;[v]改正;批改(学生作业);校正;指出错误;抵消;校准(仪器);修正,调整(数据); [add]pt/corrected,pp/corrected,pr/correcting,s3/corrects; [or]wrt;
correction: [a]/kəˈrekʃn/; [n]改正,修正; [add]pl/corrections; [or]wrt;
correctly: [a]/kəˈrektli/; [adv]正确地;得体地; [or]wrt;
correlate: [a]/ˈkɒrələt/; [vi]关联;[vt]使有相互关系;互相有关系;[n]相关物;相关联的人; [or]wrt;
correlation: [a]/ˌkɒrəˈleɪʃn/; [n]<数>相关,关联;相互关系; [add]pl/correlations; [or]wrt;
correspond: [a]/ˌkɒrəˈspɒnd/; [vi]符合,一致;相应;通信; [or]wrt;
corresponding: [a]/ˌkɒrəˈspɒndɪŋ/; [adj]相当的,相应的;一致的;通信的;[v]类似(correspond的ing形式);相配; [or]wrt;
country: [a]/ˈkʌntri/; [n]国家,国土;国民;乡下,农村;乡村;故乡;[adj]祖国的,故乡的;地方的,乡村的;国家的;粗鲁的;乡村音乐的; [or]wrt;
coverage: [a]/ˈkʌvərɪdʒ/; [n]覆盖,覆盖范围;新闻报道;保险范围; [or]wrt;
create: [a]/kriˈeɪt/; [vt]创造,创作;造成; [add]pt/created,pp/created,pr/creating,s3/creates; [or]wrt;
creation: [a]/kriˈeɪʃn/; [n]创造,创作;创作物,产物; [or]wrt;
creative: [a]/kriˈeɪtɪv/; [adj]创造性的; [or]wrt;
criterion: [a]/kraɪˈtɪəriən/; [n](批评判断的)标准;准则;规范;准据; [or]wrt;
critical: [a]/ˈkrɪtɪkl/; [adj]鉴定的;<核>临界的;批评的,爱挑剔的;危险的;决定性的;评论的; [or]wrt;
critically: [a]/ˈkrɪtɪkli/; [adv]精密地;危急地;严重地;批评性地;用钻研眼光地;很大程度上;极为重要地; [or]wrt;
criticize: [a]/ˈkrɪtɪsaɪz/; [vt]批评;评论;非难;[vi]批评;评论;苛求; [add]pt/criticized,pp/criticized,pr/criticizing,s3/criticizes; [or]wrt;
crucial: [a]/ˈkruːʃl/; [adj]重要的;决定性的;定局的;决断的; [add]比较级/morecrucial,最高级/mostcrucial; [or]wrt;
cultural: [a]/ˈkʌltʃərəl/; [adj]文化的;教养的; [or]wrt;
culture: [a]/ˈkʌltʃə(r)/; [n]文化,文明;修养;栽培;[vt]<细胞]<微>培养(等于cultivate); [add]pt/cultured,pp/cultured,pr/culturing,pl/cultures,s3/cultures; [or]wrt;
cumulative: [a]/ˈkjuːmjələtɪv/; [adj]累积的; [or]wrt;
current: [a]/ˈkʌrənt/; [adj]现在的;流通的,通用的;最近的;草写的;[n](水,气,电)流;趋势;涌流;[n](Current)人名;(英)柯伦特; [add]pl/currents; [or]wrt;
currently: [a]/ˈkʌrəntli/; [adv]当前;一般地; [or]wrt;
cycle: [a]/ˈsaɪkl/; [n]循环;周期;自行车;整套;一段时间;[vt]使循环;使轮转;[vi]循环;骑自行车;轮转; [add]pt/cycled,pp/cycled,pr/cycling,pl/cycles,s3/cycles; [or]wrt;
data: [a]/ˈdeɪtə; ˈdɑːtə/; [n]数据(datum的复数);资料;[n](Data)人名;(日)驮太 (姓);(印,葡)达塔; [or]wrt;
deal: [a]/diːl/; [v]发(纸牌);发放;买卖;与..有关;(非正式)买卖毒品;应对;(以某种方式)对付;打交道;论及;给予..打击;[n]约定;一揽子交易;待遇;发牌;(某人的)发牌轮次;牌戏的一局;一手牌;松木;松木板;[n](Deal) (美)迪尔(人名); [add]pt/dealt,pp/dealt,pr/dealing,pl/deals,s3/deals; [or]wrt;
debate: [a]/dɪˈbeɪt/; [n]辩论;(正式的)讨论;[v](尤指正式)讨论,辩论;仔细考虑; [add]pt/debated,pp/debated,pr/debating; [or]wrt;
decade: [a]/ˈdekeɪd; dɪˈkeɪd/; [n]十年,十年期;十; [add]pl/decades; [or]wrt;
decision: [a]/dɪˈsɪʒn/; [n]决定,决心;决议; [add]pl/decisions; [or]wrt;
decline: [a]/dɪˈklaɪn/; [n]下降;衰退;斜面;[vi]下降;衰落;谢绝;[vt]谢绝;婉拒; [add]pt/declined,pp/declined,pr/declining,s3/declines; [or]wrt;
decrease: [a]/dɪ'kriːs/; [v]减少,减小,降低;[n]减少,减小;减少量;减少过程; [add]pt/decreased,pp/decreased,pr/decreasing,pl/decreases,s3/decreases; [or]wrt;
define: [a]/dɪˈfaɪn/; [vt]定义;使明确;规定;[n](Define)人名;(英)德法恩;(葡)德菲内; [add]pt/defined,pp/defined,pr/defining,s3/defines; [or]wrt;
definition: [a]/ˌdefɪˈnɪʃn/; [n]定义;<物>清晰度;解说; [add]pl/definitions; [or]wrt;
degree: [a]/dɪˈɡriː/; [n]程度,等级;度;学位;阶层; [add]pl/degrees; [or]wrt;
demand: [a]/dɪˈmɑːnd/; [n](坚决的或困难的)要求;(顾客的)需求;[v]强烈要求;需要;逼问;查问,查询;[n](Demand) (德)德曼德(人名); [add]pl/demands,pt/demanded,pp/demanded,pr/demanding,s3/demands; [or]wrt;
demonstrate: [a]/ˈdemənstreɪt/; [vt]证明;展示;论证;[vi]示威; [add]pt/demonstrated,pp/demonstrated,pr/demonstrating,s3/demonstrates; [or]wrt;
denote: [a]/dɪˈnəʊt/; [vt]表示,指示; [add]pt/denoted,pp/denoted,pr/denoting,s3/denotes; [or]wrt;
depend: [a]/dɪˈpend/; [vi]依赖,依靠;取决于;相信,信赖; [add]pt/depended,pp/depended,pr/depending,s3/depends; [or]wrt;
dependence: [a]/dɪˈpendəns/; [n]依赖;依靠;信任;信赖; [or]wrt;
dependent: [a]/dɪˈpendənt/; [adj]依靠的;从属的;取决于.的;[n]依赖他人者;受赡养者; [add]pl/dependents; [or]wrt;
derive: [a]/dɪˈraɪv/; [vt]源于;得自;获得;[vi]起源;[n](Derive)人名;(法)德里夫; [or]wrt;
describe: [a]/dɪˈskraɪb/; [vt]描述,形容;描绘; [add]pt/described,pp/described,pr/describing,s3/describes; [or]wrt;
description: [a]/dɪˈskrɪpʃn/; [n]描述,描写;类型;说明书; [add]pl/descriptions; [or]wrt;
descriptive: [a]/dɪˈskrɪptɪv/; [adj]描写的,叙述的;描写性的; [or]wrt;
design: [a]/dɪˈzaɪn/; [n]设计;构思;设计图样;装饰图案;打算;[v]设计,构思;计划;制造,意欲;[n](Design) (巴,印,俄)迪赛(人名); [add]pl/designs,pt/designed,pp/designed,pr/designing,s3/designs; [or]wrt;
desirable: [a]/dɪˈzaɪərəbl/; [adj]可取的,值得拥有的,令人向往的;引起性欲的,性感的;[n]称心如意的东西,合意的人,好的品质; [add]比较级/moredesirable,最高级/mostdesirable,pl/desirables; [or]wrt;
desire: [a]/dɪˈzaɪə(r)/; [n]欲望;要求,心愿;性欲;[vt]想要;要求;希望得到.;[vi]渴望;[n](Desire)人名;(刚(布),英)德西雷; [add]pt/desired,pp/desired,pr/desiring,pl/desires,s3/desires; [or]wrt;
detail: [a]/ˈdiːteɪl/; [n]细节,琐事;具体信息;次要部分;分队,支队;[vt]详述;选派;[vi]画详图; [or]wrt;
detailed: [a]/ˈdiːteɪld/; [adj]详细的,精细的;复杂的,详尽的;[v]详细说明(detail的过去分词); [or]wrt;
determinant: [a]/dɪˈtɜːmɪnənt/; [n]决定因素;行列式;[adj]决定性的; [add]pl/determinants; [or]wrt;
determination: [a]/dɪˌtɜːmɪˈneɪʃn/; [n]决心;果断;测定; [or]wrt;
determine: [a]/dɪˈtɜːmɪn/; [v](使)下决心,(使)做出决定;[vt]决定,确定;判定,判决;限定;[vi]确定;决定;判决,终止;<主用于法律]了结,终止,结束; [or]wrt;
develop: [a]/dɪˈveləp/; [vt]开发;进步;使成长;使显影;[vi]发育;生长;进化;显露; [add]pt/developed,pp/developed,pr/developing,s3/develops; [or]wrt;
development: [a]/dɪˈveləpmənt/; [n]发展;开发;发育;住宅小区(专指由同一开发商开发的);<摄>显影; [add]pl/developments; [or]wrt;
deviation: [a]/ˌdiːviˈeɪʃn/; [n]偏差;误差;背离; [add]pl/deviations; [or]wrt;
device: [a]/dɪˈvaɪs/; [n]装置;策略;图案;设备;终端; [or]wrt;
differ: [a]/ˈdɪfə(r)/; [vt]使.相异;使.不同;[vi]相异;意见分歧;[n](Differ)人名;(法)迪费; [add]pt/differed,pp/differed,pr/differing,s3/differs; [or]wrt;
difference: [a]/ˈdɪfrəns/; [n]差异;不同;争执; [or]wrt;
different: [a]/ˈdɪfrənt/; [adj]不同的;个别的,与众不同的; [or]wrt;
differentiate: [a]/ˌdɪfəˈrenʃieɪt/; [vi]区分,区别;[vt]区分,区别; [add]pt/differentiated,pp/differentiated,pr/differentiating,s3/differentiates; [or]wrt;
differentiation: [a]/ˌdɪfəˌrenʃiˈeɪʃn/; [n]变异,<生物>分化;区别; [or]wrt;
difficult: [a]/ˈdɪfɪkəlt/; [adj]困难的;不随和的;执拗的; [or]wrt;
difficulty: [a]/ˈdɪfɪkəlti/; [n]困难,困境; [add]pl/difficulties; [or]wrt;
digital: [a]/ˈdɪdʒɪtl/; [adj]数字的;手指的;[n]数字;键; [or]wrt;
dimension: [a]/daɪˈmenʃn; dɪˈmenʃn/; [n]方面;<数>维;尺寸;次元;容积;[adj]规格的;[vt]标出尺寸; [or]wrt;
direct: [a]/dəˈrekt; daɪˈrekt/; [adj]直接的;直系的;亲身的;恰好的;[vt]管理;指挥;导演;指向;[vi]指导;指挥;[adv]直接地;正好;按直系关系; [add]最高级/mostdirect或directest; [or]wrt;
direction: [a]/dəˈrekʃn; daɪˈrekʃn/; [n]方向;指导;趋势;用法说明; [or]wrt;
directly: [a]/dəˈrektli; daɪˈrektli/; [adv]直接地;立即;马上;正好地;坦率地;[conj]一.就; [or]wrt;
disadvantage: [a]/ˌdɪsədˈvɑːntɪdʒ/; [n]缺点;不利条件;损失; [add]pt/disadvantaged,pp/disadvantaged,pr/disadvantaging,pl/disadvantages; [or]wrt;
discipline: [a]/ˈdɪsəplɪn/; [n]学科;纪律;训练;惩罚;[vt]训练,训导;惩戒; [add]pt/disciplined,pp/disciplined,pr/disciplining,pl/disciplines,s3/disciplines; [or]wrt;
discrimination: [a]/dɪˌskrɪmɪˈneɪʃn/; [n]歧视;区别,辨别;识别力; [add]pl/discriminations; [or]wrt;
discuss: [a]/dɪˈskʌs/; [vt]讨论;论述,辩论; [add]pt/discussed,pp/discussed,pr/discussing,s3/discusses; [or]wrt;
discussion: [a]/dɪˈskʌʃn/; [n]讨论,议论; [add]pl/discussions; [or]wrt;
distance: [a]/ˈdɪstəns/; [n]距离;远方;疏远;间隔;[vt]疏远;把.远远甩在后面; [add]pt/distanced,pp/distanced,pr/distancing,pl/distances,s3/distances; [or]wrt;
distinct: [a]/dɪˈstɪŋkt/; [adj]明显的;独特的;清楚的;有区别的; [or]wrt;
distinction: [a]/dɪˈstɪŋkʃn/; [n]区别;差别;特性;荣誉,勋章; [add]pl/distinctions; [or]wrt;
distinctive: [a]/dɪˈstɪŋktɪv/; [adj]独特的,有特色的;与众不同的; [or]wrt;
distinguish: [a]/dɪˈstɪŋɡwɪʃ/; [vt]区分;辨别;使杰出,使表现突出;[vi]区别,区分;辨别; [or]wrt;
distribute: [a]/dɪˈstrɪbjuːt; ˈdɪstrɪbjuːt/; [vt]分配;散布;分开;把.分类; [add]pt/distributed,pp/distributed,pr/distributing,s3/distributes; [or]wrt;
distribution: [a]/ˌdɪstrɪˈbjuːʃn/; [n]分布;分配;供应; [or]wrt;
diverse: [a]/daɪˈvɜːs/; [adj]不同的,相异的;多种多样的,形形色色的; [or]wrt;
diversity: [a]/daɪˈvɜːsəti/; [n]多样性;差异; [add]pl/diversities; [or]wrt;
divide: [a]/dɪˈvaɪd/; [v](使)分开,分成;分配,分担;分隔;(道路)分叉;使产生分歧;(数)除,除以;[n]分歧,差异;分水岭;界限; [add]pt/divided,pp/divided,pr/dividing,s3/divides; [or]wrt;
division: [a]/dɪˈvɪʒn/; [n]<数>除法;部门;分配;分割;师(军队);赛区; [or]wrt;
document: [a]/ˈdɒkjumənt/; [n]文件,公文;<计>文档;证件;[vt]记录,记载; [add](/documenting,,documented,/												documents; [or]wrt;
domain: [a]/dəˈmeɪn; dəʊˈmeɪn/; [n]领域;域名;产业;地产;[n](Domain)人名;(英,法)多曼; [add]pl/domains; [or]wrt;
dominance: [a]/ˈdɒmɪnəns/; [n]优势;统治;支配; [or]wrt;
dominant: [a]/ˈdɒmɪnənt/; [adj]显性的;占优势的;支配的,统治的;[n]显性; [add]比较级/moredominant,最高级/mostdominant,pl/dominants; [or]wrt;
dominate: [a]/ˈdɒmɪneɪt/; [vt]控制;支配;占优势;在.中占主要地位;[vi]占优势;处于支配地位; [add]pt/dominated,pp/dominated,pr/dominating,s3/dominates; [or]wrt;
donor: [a]/ˈdəʊnə(r)/; [n]捐赠者;供者;赠送人;[adj]捐献的;经人工授精出生的; [add]pl/donors; [or]wrt;
due: [a]/djuː/; [adj]到期的;预期的;应付的;应得的;[n]应付款;应得之物;[adv]正(置于方位词前);[n](Due)人名;(英)迪尤; [or]wrt;
duration: [a]/djuˈreɪʃn/; [n]持续,持续的时间,期间;音长,音延; [or]wrt;
during: [a]/ˈdjʊərɪŋ/; [prep]在....的期间;在......期间的某个时候;[n](During) (美,瑞,英)迪兰(人名); [or]wrt;
dynamic: [a]/daɪˈnæmɪk/; [adj]动态的;动力的;动力学的;有活力的;[n]动态;动力; [add]pl/dynamics; [or]wrt;
early: [a]/ˈɜːli/; [adj]早期的;早熟的;[adv]提早;在初期;[n](Early)人名;(英)厄尔利; [add]比较级/earlier,最高级/earliest; [or]wrt;
ecological: [a]/ˌiːkəˈlɒdʒɪkl/; [adj]生态的,生态学的; [or]wrt;
economic: [a]/ˌiːkəˈnɒmɪk; ˌekəˈnɒmɪk/; [adj]经济的,经济上的;经济学的; [add]比较级/moreeconomic,最高级/mosteconomic; [or]wrt;
economically: [a]/ˌiːkəˈnɒmɪkli; ˌekəˈnɒmɪkli/; [adv]经济地;在经济上;节俭地; [or]wrt;
education: [a]/ˌedʒuˈkeɪʃn/; [n]教育;培养;教育学; [add]pl/educations; [or]wrt;
educational: [a]/ˌedʒuˈkeɪʃənl/; [adj]教育的;有教育意义的; [or]wrt;
effect: [a]/ɪˈfekt/; [n]影响;效果;作用;[vt]产生;达到目的; [add]pl/effects,pt/effected,pp/effected,pr/effecting,s3/effects; [or]wrt;
effective: [a]/ɪˈfektɪv/; [adj]有效的,起作用的;实际的,实在的;给人深刻印象; [add]比较级/moreeffective,最高级/mosteffective,pl/effectives; [or]wrt;
effectively: [a]/ɪˈfektɪvli/; [adv]有效地,生效地;有力地;实际上; [or]wrt;
efficacy: [a]/ˈefɪkəsi/; [n]功效,效力; [add]pl/efficacy,efficies或efficacy,efficacities; [or]wrt;
efficiency: [a]/ɪˈfɪʃnsi/; [n]效率;效能;功效; [add]pl/efficiencies; [or]wrt;
efficient: [a]/ɪˈfɪʃnt/; [adj]有效率的;有能力的;生效的; [add]比较级/moreefficient,最高级/mostefficient; [or]wrt;
efficiently: [a]/ɪˈfɪʃntli/; [adv]有效地;效率高地(efficient的副词形式); [or]wrt;
effort: [a]/ˈefət/; [n]努力;成就; [add]pl/efforts; [or]wrt;
element: [a]/ˈelɪmənt/; [n]元素;要素;原理;成分;自然环境;[n](Element)人名;(德)埃勒门特;(英)埃利门特; [add]pl/elements; [or]wrt;
elevate: [a]/ˈelɪveɪt/; [vt]提升;举起;振奋情绪等;提升.的职位; [add]pt/elevated,pp/elevated,pr/elevating,s3/elevates; [or]wrt;
eliminate: [a]/ɪˈlɪmɪneɪt/; [vt]消除;排除; [add]pt/eliminated,pp/eliminated,pr/eliminating,s3/eliminates; [or]wrt;
elsewhere: [a]/ˌelsˈweə(r)/; [adv]在别处;到别处; [or]wrt;
emerge: [a]/ɪˈmɜːdʒ/; [vi]浮现;摆脱;暴露; [add]pt/emerged,pp/emerged,pr/emerging,s3/emerges; [or]wrt;
emergence: [a]/ɪˈmɜːdʒəns/; [n]出现,浮现;发生;露头; [or]wrt;
emotional: [a]/ɪˈməʊʃənl/; [adj]情绪的;易激动的;感动人的; [or]wrt;
emphasis: [a]/ˈemfəsɪs/; [n]重点;强调;加强语气; [add]pl/emphases; [or]wrt;
emphasize: [a]/ˈemfəsaɪz/; [vt]强调,着重; [add]pt/emphasized,pp/emphasized,pr/emphasizing,s3/emphasizes; [or]wrt;
empirical: [a]/ɪmˈpɪrɪkl/; [adj]经验主义的,完全根据经验的;实证的; [or]wrt;
empirically: [a]/ɪmˈpɪrɪkli/; [adv]以经验为主地; [or]wrt;
employ: [a]/ɪmˈplɔɪ/; [vt]使用,采用;雇用;使忙于,使从事于;[n]使用;雇用; [add]pt/employed,pp/employed,pr/employing,s3/employs; [or]wrt;
empower: [a]/ɪmˈpaʊə(r)/; [vt]授权,允许;使能够; [add]pt/empowered,pp/empowered,pr/empowering,s3/empowers; [or]wrt;
enable: [a]/ɪˈneɪbl/; [v]使能够;使成为可能;授予权利或方法;(计算机)启动; [add]pt/enabled,pp/enabled,pr/enabling,s3/enables; [or]wrt;
encode: [a]/ɪnˈkəʊd/; [vt](将文字材料)译成密码;编码,编制成计算机语言; [or]wrt;
encounter: [a]/ɪnˈkaʊntə(r)/; [v]遭遇;邂逅;遇到;[n]遭遇;偶然碰见; [add]pl/encounters,pt/encountered,pp/encountered,pr/encountering,s3/encounters; [or]wrt;
encourage: [a]/ɪnˈkʌrɪdʒ/; [vt]鼓励,怂恿;激励;支持; [add]pt/encouraged,pp/encouraged,pr/encouraging,s3/encourages; [or]wrt;
energy: [a]/ˈenədʒi/; [n]<物>能量;精力;活力;精神; [add]pl/energies; [or]wrt;
engage: [a]/ɪnˈɡeɪdʒ/; [vt]吸引,占用;使参加;雇佣;使订婚;预定;[vi]从事;参与;答应,保证;交战;啮合; [or]wrt;
enhance: [a]/ɪnˈhɑːns/; [vt]提高;加强;增加; [add]pt/enhanced,pp/enhanced,pr/enhancing,s3/enhances; [or]wrt;
ensure: [a]/ɪnˈʃʊə(r); ɪnˈʃɔː(r)/; [vt]保证,确保;使安全; [add]pt/ensured,pp/ensured,pr/ensuring,s3/ensures; [or]wrt;
entity: [a]/ˈentəti/; [n]实体;存在;本质; [add]pl/entities; [or]wrt;
entry: [a]/ˈentri/; [n]进入;入口;条目;登记;报关手续;对土地的侵占; [add]pl/entries; [or]wrt;
environment: [a]/ɪnˈvaɪrənmənt/; [n]环境,外界; [add]pl/environments; [or]wrt;
environmental: [a]/ɪnˌvaɪrənˈmentl/; [adj]环境的,周围的;有关环境的; [or]wrt;
equal: [a]/ˈiːkwəl/; [adj]平等的;相等的;胜任的;[vt]等于;比得上;[n]对手;匹敌;同辈;相等的事物; [add]pt/equaled或equalled,pp/equaled或equalled,pr/equaling或equalling,pl/equals,s3/equals; [or]wrt;
equally: [a]/ˈiːkwəli/; [adv]同样地;相等地,平等地;公平地; [or]wrt;
equivalence: [a]/ɪˈkwɪvələns/; [n]等价;相等;等值; [or]wrt;
equivalent: [a]/ɪˈkwɪvələnt/; [adj](在价值,数量等方面)相等的;等价的;等效的;等量的;同意义的;[n]对等的人(或事物);当量; [add]pl/equivalents; [or]wrt;
error: [a]/ˈerə(r)/; [n]误差;错误;过失; [add]pl/errors; [or]wrt;
especially: [a]/ɪˈspeʃəli/; [adv]特别;尤其;格外; [or]wrt;
essence: [a]/ˈesns/; [n]本质,实质;精华;香精;[n](Essence)人名;(英)埃森丝; [add]pl/essences; [or]wrt;
essential: [a]/ɪˈsenʃl/; [adj]基本的;必要的;本质的;精华的;[n]本质;要素;要点;必需品; [add]pl/essentials; [or]wrt;
essentially: [a]/ɪˈsenʃəli/; [adv]本质上;本来; [or]wrt;
establish: [a]/ɪˈstæblɪʃ/; [v]建立,创立;确立;获得接受;查实,证实; [or]wrt;
establishment: [a]/ɪˈstæblɪʃmənt/; [n]确立,制定;公司;设施; [add]pl/establishments; [or]wrt;
estimate: [a]/ˈestɪmeɪt; ˈestɪmət/; [n]估计,估价;判断,看法;[v]估计,估量;判断,评价; [add]pt/estimated,pp/estimated,pr/estimating,pl/estimates,s3/estimates; [or]wrt;
estimation: [a]/ˌestɪˈmeɪʃn/; [n]估计;尊重; [add]pl/estimations; [or]wrt;
ethic: [a]/ˈeθɪk/; [n]伦理;道德规范;[adj]伦理的;道德的(等于ethical); [add]pl/ethics; [or]wrt;
ethical: [a]/ˈeθɪkl/; [adj]伦理的;道德的;凭处方出售的;[n]处方药; [or]wrt;
ethnic: [a]/ˈeθnɪk/; [adj]种族的;人种的; [add]pl/ethnics; [or]wrt;
ethnicity: [a]/eθˈnɪsəti/; [n]种族划分; [add]pl/ethnicities; [or]wrt;
evaluate: [a]/ɪˈvæljueɪt/; [vt]评价;估价;求.的值;[vi]评价;估价; [add]pt/evaluated,pp/evaluated,pr/evaluating,s3/evaluates; [or]wrt;
evaluation: [a]/ɪˌvæljuˈeɪʃn/; [n]评价;<审计>评估;估价;求值; [add]pl/evaluations; [or]wrt;
event: [a]/ɪˈvent/; [n]事件,大事;项目;结果; [add]pl/events; [or]wrt;
evidence: [a]/ˈevɪdəns/; [n]证据,证明;迹象;明显;[vt]证明; [add]pt/evidenced,pp/evidenced,pr/evidencing,pl/evidences,s3/evidences; [or]wrt;
evident: [a]/ˈevɪdənt/; [adj]明显的;明白的; [or]wrt;
evolution: [a]/ˌiːvəˈluːʃn; ˌevəˈluːʃn/; [n]演变;进化论;进展; [add]pl/evolutions; [or]wrt;
evolutionary: [a]/ˌiːvəˈluːʃənri; ˌevəˈluːʃənri/; [adj]进化的;发展的;渐进的; [or]wrt;
evolve: [a]/ɪˈvɒlv/; [vt]发展;进化;使逐步形成;推断出;[vi]发展,进展;进化;逐步形成; [or]wrt;
examination: [a]/ɪɡˌzæmɪˈneɪʃn/; [n]考试;检查;查问; [add]pl/examinations; [or]wrt;
examine: [a]/ɪɡˈzæmɪn/; [vt]检查;调查; 检测;考试;[vi]检查;调查; [add]pt/examined,pp/examined,pr/examining,s3/examines; [or]wrt;
example: [a]/ɪɡˈzɑːmpl/; [n]例子;榜样;[vt]作为.的例子;为.做出榜样;[vi]举例; [add]pt/exampled,pp/exampled,pr/exampling,pl/examples; [or]wrt;
exceed: [a]/ɪkˈsiːd/; [vt]超过;胜过;[vi]超过其他; [add]pt/exceeded,pp/exceeded,pr/exceeding,s3/exceeds; [or]wrt;
exception: [a]/ɪkˈsepʃn/; [n]例外;异议; [add]pl/exceptions; [or]wrt;
excess: [a]/ɪkˈses/; [n]超过,超额;过度,过量;无节制;[adj]额外的,过量的;附加的; [add]pl/excesses; [or]wrt;
excessive: [a]/ɪkˈsesɪv/; [adj]过多的,极度的;过分的; [or]wrt;
exchange: [a]/ɪksˈtʃeɪndʒ/; [n]交换;交流;交易所;兑换;[vt]交换;交易;兑换;[vi]交换;交易;兑换; [add]pt/exchanged,pp/exchanged,pr/exchanging,pl/exchanges,s3/exchanges; [or]wrt;
exclude: [a]/ɪkˈskluːd/; [vt]排除;排斥;拒绝接纳;逐出; [add]pt/excluded,pp/excluded,pr/excluding; [or]wrt;
exclusion: [a]/ɪkˈskluːʒn/; [n]排除;排斥;驱逐;被排除在外的事物; [add]pl/exclusions; [or]wrt;
exclusive: [a]/ɪkˈskluːsɪv/; [adj]独有的;排外的;专一的;[n]独家新闻;独家经营的项目;排外者; [add]pl/exclusives; [or]wrt;
exclusively: [a]/ɪkˈskluːsɪvli/; [adv]唯一地,专有地,排外地;作为唯一的(消息)来源; [or]wrt;
exemplify: [a]/ɪɡˈzemplɪfaɪ/; [vt]例证;例示; [add]pt/exemplified,pp/exemplified,pr/exemplifying,s3/exemplifies; [or]wrt;
exercise: [a]/ˈeksəsaɪz/; [n]运动;练习;运用;操练;礼拜;典礼;[vt]锻炼;练习;使用;使忙碌;使惊恐;[vi]运动;练习; [add]pt/exercised,pp/exercised,pr/exercising,pl/exercises,s3/exercises; [or]wrt;
exist: [a]/ɪɡˈzɪst/; [vi]存在;生存;生活;继续存在; [add]pt/existed,pp/existed,pr/existing,s3/exists; [or]wrt;
existence: [a]/ɪɡˈzɪstəns/; [n]存在,实在;生存,生活;存在物,实在物; [add]pl/existences; [or]wrt;
expand: [a]/ɪkˈspænd/; [vt]扩张;使膨胀;详述;[vi]发展;张开,展开; [add]pt/expanded,pp/expanded,pr/expanding,s3/expands; [or]wrt;
expansion: [a]/ɪkˈspænʃn/; [n]膨胀;阐述;扩张物; [add]pl/expansions; [or]wrt;
expect: [a]/ɪkˈspekt/; [vt]期望;指望;认为;预料;[vi]期待;预期; [add]pt/expected,pp/expected,pr/expecting,s3/expects; [or]wrt;
expectation: [a]/ˌekspekˈteɪʃn/; [n]期待;预期;指望; [add]pl/expectations; [or]wrt;
experience: [a]/ɪkˈspɪəriəns/; [n]经验;经历;体验;[vt]经验;经历;体验; [add]pt/experienced,pp/experienced,pr/experiencing,pl/experiences,s3/experiences; [or]wrt;
experiment: [a]/ɪkˈsperɪmənt/; [n]实验,试验;尝试;[v]尝试;试验;进行实验; [add]pl/experiments,pt/experimented,pp/experimented,pr/experimenting,s3/experiments; [or]wrt;
experimental: [a]/ɪkˌsperɪˈmentl/; [adj]实验的;根据实验的;试验性的; [or]wrt;
expert: [a]/ˈekspɜːt/; [n]专家;行家;能手;[adj]熟练的;内行的;老练的;[v]当专家;[n](Expert) (法,印,俄,罗,巴,荷)埃克斯佩(人名); [add]pl/experts,pt/expertsed,pp/experted,pr/experting,s3/experts; [or]wrt;
expertise: [a]/ˌekspɜːˈtiːz/; [n]专门知识;专门技术;专家的意见; [or]wrt;
explain: [a]/ɪkˈspleɪn/; [v]说明;解释; [add]pt/explained,pp/explained,pr/explaining,s3/explains; [or]wrt;
explanation: [a]/ˌekspləˈneɪʃn/; [n]说明,解释;辩解; [add]pl/explanations; [or]wrt;
explanatory: [a]/ɪkˈsplænətri/; [adj]解释的;说明的; [or]wrt;
explicit: [a]/ɪkˈsplɪsɪt/; [adj]明确的;清楚的;直率的;详述的; [or]wrt;
explicitly: [a]/ɪkˈsplɪsɪtli/; [adv]明确地;明白地; [or]wrt;
exploit: [a]/ɪkˈsplɔɪt/; [vt]开发,开拓;剥削;开采;[n]勋绩;功绩; [add]pt/exploited,pp/exploited,pr/exploiting,s3/exploits; [or]wrt;
exploitation: [a]/ˌeksplɔɪˈteɪʃn/; [n]开发,开采;利用;广告推销;剥削; [or]wrt;
exploration: [a]/ˌekspləˈreɪʃn/; [n]探测;探究;踏勘; [or]wrt;
explore: [a]/ɪkˈsplɔː(r)/; [vt]探索;探测;探险;[vi]探索;探测;探险; [add]pt/explored,pp/explored,pr/exploring,s3/explores; [or]wrt;
expose: [a]/ɪkˈspəʊz/; [vt]揭露,揭发;使曝光;显示; [add]pt/exposed,pp/exposed,pr/exposing,s3/exposes; [or]wrt;
express: [a]/ɪkˈspres/; [vt]表达;快递;[adj]明确的;迅速的;专门的;[n]快车,快递,专使;捷运公司; [add]pt/expressed,pp/expressed,pr/expressing,pl/expresses,s3/expresses; [or]wrt;
expression: [a]/ɪkˈspreʃn/; [n]表现,表示,表达;表情,脸色,态度,腔调,声调;式,符号;词句,语句,措辞,说法; [add]pl/expressions; [or]wrt;
extend: [a]/ɪkˈstend/; [vt]延伸;扩大;推广;伸出;给予;使竭尽全力;对.估价;[vi]延伸;扩大;伸展;使疏开; [add]pt/extended,pp/extended,pr/extending,s3/extends; [or]wrt;
extension: [a]/ɪkˈstenʃn/; [n]延长;延期;扩大;伸展;电话分机; [add]pl/extensions; [or]wrt;
extensive: [a]/ɪkˈstensɪv/; [adj]广泛的;大量的;广阔的; [or]wrt;
extent: [a]/ɪkˈstent/; [n]程度;范围;长度; [add]pl/extents; [or]wrt;
external: [a]/ɪkˈstɜːnl/; [adj]外部的;表面的;<药>外用的;外国的;外面的;[n]外部;外观;外面; [add]pl/externals; [or]wrt;
extreme: [a]/ɪkˈstriːm/; [adj]极端的;极度的;偏激的;尽头的;[n]极端;末端;最大程度;极端的事物; [add]比较级/extremer,最高级/extremest,pl/extremes; [or]wrt;
facilitate: [a]/fəˈsɪlɪteɪt/; [vt]促进;帮助;使容易; [add]pt/facilitated,pp/facilitated,pr/facilitating,s3/facilitates; [or]wrt;
facility: [a]/fəˈsɪləti/; [n]设施;设备;容易;灵巧;才能,天赋; [or]wrt;
fact: [a]/fækt/; [n]事实;实际;真相; [add]pl/facts; [or]wrt;
factor: [a]/ˈfæktə(r)/; [n]因素;要素;<物>因数;代理人;[vi]做代理商;[vt]把.作为因素计入;代理经营;把.分解成;[n](Factor)人名;(英)法克特; [add]pl/factors,pt/factored,pp/factored,pr/factoring,s3/factors; [or]wrt;
fail: [a]/feɪl/; [vi]失败,不及格;破产;缺乏;衰退;[vt]不及格;使失望;忘记;舍弃;[n]不及格;[n](Fail)人名;(葡,捷)法伊尔;(法)法伊; [add]pt/failed,pp/failed,pr/failing,s3/fails; [or]wrt;
failure: [a]/ˈfeɪljə(r)/; [n]失败;故障;失败者;破产; [add]pl/failures; [or]wrt;
favour: [a]/ˈfeɪvə(r)/; [n]偏爱;赞同;善行;[vt]赞成;喜爱;有助于; [add]pl/favours,pt/favoured,pp/favoured,pr/favouring,s3/favours; [or]wrt;
favourable: [a]/ˈfeɪvərəbl/; [adj]有利的,顺利的;赞成的; [or]wrt;
feature: [a]/ˈfiːtʃə(r)/; [n]特色,特征;容貌;特写或专题节目;[vi]起重要作用;[vt]特写;以.为特色;由.主演; [add]pt/featured,pp/featured,pr/featuring,pl/features,s3/features; [or]wrt;
federal: [a]/ˈfedərəl/; [adj]联邦的;同盟的;联邦政府的; 联邦制的;[adv]联邦政府地;[n](Federal)人名;(英)费德勒尔; [or]wrt;
female: [a]/ˈfiːmeɪl/; [adj]女性的;雌性的;柔弱的,柔和的;[n]女人;<动>雌性动物; [add]pl/females; [or]wrt;
field: [a]/fiːld/; [n]领域;牧场;旷野;战场;运动场;字段;[vi]担任场外队员;[adj]扫描场;田赛的;野生的;[vt]把暴晒于场上;使上场;[n](Field)人名;(英,法,德,葡)菲尔德; [or]wrt;
financial: [a]/faɪˈnænʃl; fəˈnænʃl/; [adj]金融的;财政的,财务的; [or]wrt;
finding: [a]/ˈfaɪndɪŋ/; [n]发现;裁决;发现物;[v]找到;感到(find的ing形式);遇到; [add]pl/findings; [or]wrt;
flexible: [a]/ˈfleksəbl/; [adj]灵活的;柔韧的;易弯曲的; [add]比较级/moreflexible,最高级/mostflexible; [or]wrt;
flow: [a]/fləʊ/; [v](使)流动,涌流;流通;传播;流畅;充满;大量供应;涨;涨潮;川流不息;飘扬;来自,由..产生;来月经;(矿物,岩石等)变形;[n]流动;生产,供应;车流;流量;传播;流通;滔滔不绝;连贯,流畅;涨潮;泛滥;(苏格兰)湿地,沼泽;月经;[n](Flow) (美)弗洛(人名); [add]pt/flowed,pp/flowed,pr/flowing,s3/flows; [or]wrt;
focus: [a]/ˈfəʊkəs/; [n]焦点;中心;清晰;焦距;[vt]使集中;使聚焦;[vi]集中;聚焦;调节焦距;[n](Focus)人名;(瑞典)福库斯; [add]pl/focuses或foci,pt/focused或focussed,pp/focused或focussed,pr/focusing或focussing,s3/focuses; [or]wrt;
force: [a]/fɔːs/; [n]力量;武力;军队;魄力;[vt]促使,推动;强迫;强加;[n](Force)人名;(意)福尔切;(英,法)福斯; [add]pt/forced,pp/forced,pr/forcing,pl/forces,s3/forces; [or]wrt;
form: [a]/fɔːm/; [n]形式,形状;形态,外形;方式;表格;[vt]构成,组成;排列,组织;产生,塑造;[vi]形成,构成;排列;[n](Form)人名;(英)福姆;(法,德)福尔姆; [add]pl/forms,pt/formed,pp/formed,pr/forming,s3/forms; [or]wrt;
formal: [a]/ˈfɔːml/; [adj]正式的;拘谨的;有条理的;[n]正式的社交活动;夜礼服;[n](Formal)人名;(法)福马尔; [add]比较级/moreformal,最高级/mostformal,pl/formals; [or]wrt;
formation: [a]/fɔːˈmeɪʃn/; [n]形成;构造;编队; [add]pl/formations; [or]wrt;
formula: [a]/ˈfɔːmjələ/; [n]<数>公式,准则;配方;婴儿食品; [add]pl/formulas或formulae; [or]wrt;
formulate: [a]/ˈfɔːmjuleɪt/; [vt]规划;用公式表示;明确地表达; [add]pt/formulated,pp/formulated,pr/formulating,s3/formulates; [or]wrt;
formulation: [a]/ˌfɔːmjuˈleɪʃn/; [n]制订,规划;(想法或理论的)系统阐述;表达方式;制剂,配方; [add]pl/formulations; [or]wrt;
framework: [a]/ˈfreɪmwɜːk/; [n]框架,骨架;结构,构架; [add]pl/frameworks; [or]wrt;
frequent: [a]/'friːkw(ə)nt/; [adj]频繁的;时常发生的;惯常的;[vt]常到,常去;时常出入于; [add]pt/frequented,pp/frequented,pr/frequenting,比较级/morefrequent,最高级/mostfrequent,s3/frequents; [or]wrt;
frequently: [a]/ˈfriːkwəntli/; [adv]频繁地,经常地;时常,屡次; [or]wrt;
fully: [a]/ˈfʊli/; [adv]充分地;完全地;彻底地;[n](Fully)人名;(法)菲利; [or]wrt;
function: [a]/ˈfʌŋkʃn/; [n]功能;<数>函数;职责;盛大的集会;[vi]运行;活动;行使职责; [add]pl/functions,pt/functioned,pp/functioned,pr/functioning,s3/functions; [or]wrt;
functional: [a]/ˈfʌŋkʃənl/; [adj]功能的; [or]wrt;
fund: [a]/fʌnd/; [n]基金;资金;存款;[vt]投资;资助;[n](Fund)人名;(德)丰德; [add]pl/funds,pt/funded,pr/funding,s3/funds; [or]wrt;
fundamental: [a]/ˌfʌndəˈmentl/; [adj]基本的,根本的;[n]基本原理;基本原则; [add]比较级/morefundamental,最高级/mostfundamental,pl/fundamentals; [or]wrt;
fundamentally: [a]/ˌfʌndəˈmentəli/; [adv]根本地,从根本上;基础地; [or]wrt;
funding: [a]/ˈfʌndɪŋ/; [n]提供资金;用发行长期债券的方法来收回短期债券;[v]提供资金;积存(fund的ing形式); [or]wrt;
further: [a]/ˈfɜːðə(r)/; [adv]更远地;远非(如此);进一步地;而且;处于更高阶段;[adj]更多的,附加的;更远的;进一步的,深一层的;[v]促进,增进,助长; [add]pt/furthered,pp/furthered,pr/furthering,s3/furthers; [or]wrt;
furthermore: [a]/ˌfɜːðəˈmɔː(r)/; [adv]此外;而且; [or]wrt;
future: [a]/ˈfjuːtʃə(r)/; [n]未来;前途;期货;将来时;[adj]将来的,未来的; [add]pl/futures; [or]wrt;
gain: [a]/ɡeɪn/; [n]增加;利润;收获;[vt]获得;增加;赚到;[vi]增加;获利;[n](Gain)人名;(英,匈,法)盖恩; [add]pl/gains,pt/gained,pp/gained,pr/gaining,s3/gains; [or]wrt;
gap: [a]/ɡæp/; [n]间隙;缺口;差距;分歧;[vi]裂开;[vt]使形成缺口; [or]wrt;
gender: [a]/ˈdʒendə(r)/; [n]性;性别;性交;[vt]生(过去式gendered,过去分词gendered,现在分词gendering,第三人称单数genders,形容词genderless); [add]pl/genders; [or]wrt;
general: [a]/ˈdʒenrəl/; [adj]一般的,普通的;综合的;大体的;[n]一般;将军,上将;常规;[n](General)人名;(英)杰纳勒尔; [or]wrt;
generalization: [a]/ˌdʒenrəlaɪˈzeɪʃn/; [n]概括;普遍化;一般化; [add]pl/generalizations; [or]wrt;
generalize: [a]/ˈdʒenrəlaɪz/; [vt]概括;推广;使...一般化;[vi]形成概念; [add]pt/generalized,pp/generalized,pr/generalizing,s3/generalizes; [or]wrt;
generally: [a]/ˈdʒenrəli/; [adv]通常;普遍地,一般地; [or]wrt;
generate: [a]/ˈdʒenəreɪt/; [vt]使形成;发生;生殖;产生物理反应; [or]wrt;
generation: [a]/ˌdʒenəˈreɪʃn/; [n]一代;产生;一代人;生殖; [add]pl/generations; [or]wrt;
geographical: [a]/ˌdʒiːəˈɡræfɪkl/; [adj]地理的;地理学的; [or]wrt;
global: [a]/ˈɡləʊbl/; [adj]全球的;总体的;球形的; [or]wrt;
goal: [a]/ɡəʊl/; [n]目标;球门,得分数;终点;[vi]攻门,射门得分; [add]pl/goals; [or]wrt;
govern: [a]/ˈɡʌvn/; [vt]管理;支配;统治;控制;[vi]居支配地位;进行统治;[n](Govern)人名;(英)戈文; [add]pt/governed,pp/governed,pr/governing,s3/governs; [or]wrt;
government: [a]/ˈɡʌvənmənt/; [n]政府;政体;管辖; [add]pl/governments; [or]wrt;
governmental: [a]/ˌɡʌvnˈmentl/; [adj]政府的;政治的;统治上的; [or]wrt;
group: [a]/ɡruːp/; [n]组;团体;[adj]群的;团体的;[vi]聚合;[vt]把.聚集;把.分组; [or]wrt;
growth: [a]/ɡrəʊθ/; [n]增长;发展;生长;种植; [add]pl/growths; [or]wrt;
guidance: [a]/ˈɡaɪdns/; [n]指导,引导;领导; [add]pl/guidances; [or]wrt;
harm: [a]/hɑːm/; [n]伤害;损害;[vt]伤害;危害;损害;[n](Harm)人名;(德)哈尔姆; [add]pl/harms,pt/harmed,pp/harmed,pr/harming,s3/harms; [or]wrt;
harmful: [a]/ˈhɑːmfl/; [adj]有害的;能造成损害的; [or]wrt;
hence: [a]/hens/; [adv]因此;今后; [or]wrt;
hierarchical: [a]/ˌhaɪəˈrɑːkɪkl/; [adj]分层的;等级体系的; [or]wrt;
hierarchy: [a]/ˈhaɪərɑːki/; [n]层级;等级制度; [add]pl/hierarchies; [or]wrt;
high: [a]/haɪ/; [adj]高的;高级的;崇高的;高音调的;[n]高水平;天空;由麻醉品引起的快感;高压地带;[adv]高;奢侈地;[n](High)人名;(英)海伊; [add]比较级/higher,最高级/highest,pl/highs; [or]wrt;
highlight: [a]/ˈhaɪlaɪt/; [v]突出;强调;使显著;加亮;着亮彩于(头发);[n]最精彩的部分;最重要的事情;强光部分; [add]pt/highlighted,pp/highlighted,pr/highlighting,pl/highlights,s3/highlights; [or]wrt;
highly: [a]/ˈhaɪli/; [adv]高度地;非常;非常赞许地; [or]wrt;
history: [a]/ˈhɪstri/; [n]历史,历史学;历史记录;来历; [add]pl/histories; [or]wrt;
horizontal: [a]/ˌhɒrɪˈzɒntl/; [adj]水平的;地平线的;同一阶层的;[n]水平线,水平面;水平位置; [add]pl/horizontals; [or]wrt;
however: [a]/haʊˈevə(r)/; [adv]无论如何;不管怎样(接副词或形容词);然而;可是;[conj]无论以何种方式; 不管怎样; [or]wrt;
human: [a]/ˈhjuːmən/; [adj]人的;人类的;[n]人;人类;[n](Human)人名;(英)休曼; [add]pl/humans; [or]wrt;
hypothesis: [a]/haɪˈpɒθəsɪs/; [n]假设; [add]pl/hypotheses; [or]wrt;
hypothesize: [a]/haɪˈpɒθəsaɪz/; [vt]假设,假定;[vi]假设,假定; [add]pt/hypothesized,pp/hypothesized,pr/hypothesizing,s3/hypothesizes; [or]wrt;
hypothetical: [a]/ˌhaɪpəˈθetɪkl/; [adj]假设的;爱猜想的; [add]pl/hypotheticals; [or]wrt;
ideal: [a]/aɪˈdiːəl/; [adj]理想的;完美的;想象的;不切实际的;[n]理想;典范; [add]pl/ideals; [or]wrt;
ideally: [a]/aɪˈdiːəli/; [adv]理想地;观念上地; [or]wrt;
identical: [a]/aɪˈdentɪkl/; [adj]同一的;完全相同的;[n]完全相同的事物; [or]wrt;
identification: [a]/aɪˌdentɪfɪˈkeɪʃn/; [n]鉴定,识别;认同;身份证明; [add]pl/identifications; [or]wrt;
identify: [a]/aɪˈdentɪfaɪ/; [vt]确定;鉴定;识别,辨认出;使参与;把.看成一样[vi]确定;认同;一致; [or]wrt;
identity: [a]/aɪˈdentəti/; [n]身份;同一性,一致;特性;恒等式; [add]pl/identities; [or]wrt;
illustrate: [a]/ˈɪləstreɪt/; [vt]阐明,举例说明;图解;[vi]举例; [add]pt/illustrated,pp/illustrated,pr/illustrating,s3/illustrates; [or]wrt;
image: [a]/ˈɪmɪdʒ/; [n]影像;想象;肖像;偶像;[vt]想象;反映;象征;作.的像;[n](Image)人名;(法)伊马热; [add]pt/imaged,pp/imaged,pr/imaging,pl/images,s3/images; [or]wrt;
immediate: [a]/ɪˈmiːdiət/; [adj]立即的;直接的;最接近的; [or]wrt;
impact: [a]/ˈɪmpækt/; [n]影响;效果;碰撞;冲击力;[vt]挤入,压紧;撞击;对.产生影响;[vi]影响;撞击;冲突;压紧(on,upon,with); [or]wrt;
implement: [a]/'ɪmplɪm(ə)nt/; [vt]实施,执行;实现,使生效;[n]工具,器具;手段; [add]pl/implements,pt/implemented,pp/implemented,pr/implementing,s3/implements; [or]wrt;
implementation: [a]/ˌɪmplɪmenˈteɪʃn/; [n]<计>实现;履行;安装启用; [or]wrt;
implicit: [a]/ɪmˈplɪsɪt/; [adj]含蓄的;暗示的;盲从的; [or]wrt;
implicitly: [a]/ɪmˈplɪsɪtli/; [adv]含蓄地;暗中地; [or]wrt;
imply: [a]/ɪmˈplaɪ/; [vt]意味;暗示;隐含; [add]pt/implied,pp/implied,pr/implying,s3/implies; [or]wrt;
importance: [a]/ɪmˈpɔːtns/; [n]价值;重要;重大;傲慢; [add]pl/importances; [or]wrt;
important: [a]/ɪmˈpɔːtnt/; [adj]重要的,重大的;有地位的;有权力的; [add]比较级/moreimportant,最高级/mostimportant; [or]wrt;
impose: [a]/ɪmˈpəʊz/; [vi]利用;欺骗;施加影响;[vt]强加;征税;以.欺骗; [add]pt/imposed,pp/imposed,pr/imposing,s3/imposes; [or]wrt;
improve: [a]/ɪmˈpruːv/; [vt]改善,增进;提高.的价值;[vi]增加;变得更好; [add]pt/improved,pp/improved,pr/improving,s3/improves; [or]wrt;
improvement: [a]/ɪmˈpruːvmənt/; [n]改进,改善;提高; [or]wrt;
inability: [a]/ˌɪnəˈbɪləti/; [n]无能力;无才能; [or]wrt;
inadequate: [a]/ɪnˈædɪkwət/; [adj]不充分的,不适当的; [add]比较级/moreinadequate,最高级/mostinadequate; [or]wrt;
inappropriate: [a]/ˌɪnəˈprəʊpriət/; [adj]不适当的;不相称的; [or]wrt;
include: [a]/ɪnˈkluːd/; [vt]包含,包括; [add]pt/included,pp/included,pr/including,s3/includes; [or]wrt;
including: [a]/ɪnˈkluːdɪŋ/; [v](使)成为..的一部分;允许(某人)加入活动(或同享特权)(include 的现在分词);[prep]包括..在内; [or]wrt;
inclusion: [a]/ɪnˈkluːʒn/; [n]包含;内含物; [add]pl/inclusions; [or]wrt;
inconsistent: [a]/ˌɪnkənˈsɪstənt/; [adj]不一致的;前后矛盾的; [or]wrt;
incorporate: [a]/ɪnˈkɔːpəreɪt/; [vt]包含,吸收;体现;把..合并;[vi]合并;混合;组成公司;[adj]合并的;一体化的;组成公司的; [add]pt/incorporated,pp/incorporated,pr/incorporating,s3/incorporates; [or]wrt;
increase: [a]/ɪn'kriːs/; [v]增加;增大;提高;增强;[n]增加;增多;增长;[n](Increase) (英,美,印,尼日尼亚)英克里斯(人名); [add]pt/increased,pp/increased,pr/increasing,pl/increases,s3/increases; [or]wrt;
increasingly: [a]/ɪnˈkriːsɪŋli/; [adv]越来越多地;渐增地; [or]wrt;
indeed: [a]/ɪnˈdiːd/; [adv]的确;实在;真正地;甚至; int. 真的(表示惊讶,怀疑,讽刺等); [or]wrt;
independence: [a]/ˌɪndɪˈpendəns/; [n]独立性,自立性;自主; [or]wrt;
independent: [a]/ˌɪndɪˈpendənt/; [adj]独立的;单独的;无党派的;不受约束的;[n]独立自主者;无党派者; [add]比较级/moreindependent,最高级/mostindependent,pl/independents; [or]wrt;
independently: [a]/ˌɪndɪˈpendəntli/; [adv]独立地;自立地; [or]wrt;
index: [a]/ˈɪndeks/; [n]指标;指数;索引;指针;[vi]做索引;[vt]指出;编入索引中; [add]pl/indexes或indices; [or]wrt;
indicate: [a]/ˈɪndɪkeɪt/; [vt]表明;指出;预示;象征; [add]pt/indicated,pp/indicated,pr/indicating,s3/indicates; [or]wrt;
indication: [a]/ˌɪndɪˈkeɪʃn/; [n]指示,指出;迹象;象征; [add]pl/indications; [or]wrt;
indicator: [a]/ˈɪndɪkeɪtə(r)/; [n]指标,标志,迹象; 指示器;<试剂>指示剂;<计>指示符;压力计; [or]wrt;
indirect: [a]/ˌɪndəˈrekt; ˌɪndaɪˈrekt/; [adj]间接的;迂回的;非直截了当的; [or]wrt;
indirectly: [a]/ˌɪndəˈrektli; ˌɪndaɪˈrektli/; [adv]间接地;不诚实;迂回地; [or]wrt;
individual: [a]/ˌɪndɪˈvɪdʒuəl/; [adj]个人的;个别的;独特的;[n]个人,个体; [add]pl/individuals; [or]wrt;
individually: [a]/ˌɪndɪˈvɪdʒuəli/; [adv]个别地,单独地; [or]wrt;
induce: [a]/ɪnˈdjuːs/; [vt]诱导;引起;引诱;感应; [add]pt/induced,pp/induced,pr/inducing,s3/induces; [or]wrt;
induction: [a]/ɪnˈdʌkʃn/; [n]<电磁>感应;归纳法;感应现象;入门培训,入职仪式,就职;诱导; [or]wrt;
inequality: [a]/ˌɪnɪˈkwɒləti/; [n]不平等;不同;不平均; [add]pl/inequalities; [or]wrt;
infer: [a]/ɪnˈfɜː(r)/; [vt]推断;推论;[vi]推断;作出推论; [add]pt/inferred,pp/inferred,pr/infering,s3/infers; [or]wrt;
inference: [a]/ˈɪnfərəns/; [n]推理;推论;推断; [add]pl/inferences; [or]wrt;
influence: [a]/ˈɪnfluəns/; [n]影响;势力;感化;有影响的人或事;[vt]影响;改变; [add]pt/influenced,pp/influenced,pr/influencing,pl/influences,s3/influences; [or]wrt;
inform: [a]/ɪnˈfɔːm/; [vt]通知;告诉;报告;[vi]告发;告密; [add]pt/informed,pp/informed,pr/informing,s3/informs; [or]wrt;
information: [a]/ˌɪnfəˈmeɪʃn/; [n]信息,资料;知识;情报; [or]wrt;
informed: [a]/ɪnˈfɔːmd/; [adj]见多识广的;消息灵通的;有根据的;明智的(猜测或决定);[v]通知;使了解;提供资料(inform的过去式和过去分词); [or]wrt;
inherent: [a]/ɪnˈherənt; ɪnˈhɪərənt/; [adj]固有的;内在的;与生俱来的,遗传的; [or]wrt;
initial: [a]/ɪˈnɪʃl/; [adj]最初的;字首的;[vt]用姓名的首字母签名;[n]词首大写字母;原始细胞; [or]wrt;
initially: [a]/ɪˈnɪʃəli/; [adv]最初,首先;开头; [or]wrt;
initiate: [a]/ɪˈnɪʃieɪt/; [vt]开始,创始;发起;使初步了解;[n]开始;新加入者,接受初步知识者;[adj]新加入的;接受初步知识的; [add]pt/initiated,pp/initiated,pr/initiating,s3/initiates; [or]wrt;
initiation: [a]/ɪˌnɪʃiˈeɪʃn/; [n]启蒙,传授;开始;入会; [add]pl/initiations; [or]wrt;
initiative: [a]/ɪˈnɪʃətɪv/; [n]主动权;首创精神;新方案;倡议;[adj]主动的;自发的;起始的; [or]wrt;
input: [a]/ˈɪnpʊt/; [n]投入;输入电路;[vt]<自]<电子>输入;将.输入电脑; [add]pt/inputted或input,pp/inputted或input,pr/inputting; [or]wrt;
insight: [a]/ˈɪnsaɪt/; [n]洞察力;洞悉;[n](Insight)人名;(英)因赛特; [add]pl/insights; [or]wrt;
instability: [a]/ˌɪnstəˈbɪləti/; [n]不稳定(性);基础薄弱;不安定; [add]pl/instabilities; [or]wrt;
instance: [a]/ˈɪnstəns/; [n]实例;情况;建议;[vt]举...为例; [add]pt/instanced,pp/instanced,pr/instancing,pl/instances,s3/instances; [or]wrt;
instruction: [a]/ɪnˈstrʌkʃn/; [n]指令,命令;指示;教导;用法说明; [add]pl/instructions; [or]wrt;
instrument: [a]/ˈɪnstrəmənt/; [n]仪器;工具;乐器;手段;器械;[v]给..装测量仪器; [or]wrt;
insufficient: [a]/ˌɪnsəˈfɪʃnt/; [adj]不足的;不能胜任的,缺乏能力的; [or]wrt;
integral: [a]/ˈɪntɪɡrəl; ɪnˈteɡrəl/; [adj]积分的;完整的,整体的;构成整体所必须的;[n]积分;部分;完整; [or]wrt;
integrate: [a]/ˈɪntɪɡreɪt/; [vt]使.完整;使.成整体;求.的积分;表示.的总和;[vi]求积分;取消隔离;成为一体;[adj]整合的;完全的;[n]一体化;集成体; [add]pt/integrated,pp/integrated,pr/integrating,s3/integrates; [or]wrt;
integrated: [a]/ˈɪntɪɡreɪtɪd/; [adj]综合的;完整的;互相协调的;[v]整合;使.成整体(integrate的过去分词); [or]wrt;
integration: [a]/ˌɪntɪˈɡreɪʃn/; [n]集成;综合; [or]wrt;
intend: [a]/ɪnˈtend/; [vt]打算;想要;意指;[vi]有打算; [add]pt/intended,pp/intended,pr/intending,s3/intends; [or]wrt;
intensity: [a]/ɪnˈtensəti/; [n]强度;强烈;<电子>亮度;紧张; [add]pl/intensities; [or]wrt;
intensive: [a]/ɪnˈtensɪv/; [adj]加强的;集中的;透彻的;加强语气的;[n]加强器; [add]pl/intensives; [or]wrt;
intention: [a]/ɪnˈtenʃn/; [n]意图;目的;意向;愈合; [add]pl/intentions; [or]wrt;
interact: [a]/ˌɪntərˈækt/; [vt]互相影响;互相作用;[vi]互相影响;互相作用;[n]幕间剧;幕间休息; [add]pt/interacted,pp/interacted,pr/interacting,s3/interacts; [or]wrt;
interaction: [a]/ˌɪntərˈækʃn/; [n]相互作用,相互影响;交流;<数>交互作用;互动; [or]wrt;
interactive: [a]/ˌɪntərˈæktɪv/; [adj]交互式的;相互作用的; [or]wrt;
interest: [a]/ˈɪntrəst; ˈɪntrest/; [n]兴趣,爱好;利息;利益;趣味;同行;[vt]使..感兴趣;引起..的关心;使..参与; [or]wrt;
intermediate: [a]/ˌɪntəˈmiːdiət/; [adj]中间的,过渡的;中级的,中等的;[n]中级生;(化合物)中间体,中间物;中介,媒介;[v]充当调解人,起媒介作用; [add]pt/intermediated,pp/intermediated,pr/intermediating; [or]wrt;
internal: [a]/ɪnˈtɜːnl/; [adj]内部的;体内的;(机构)内部的;国内的;本身的;内心的;(大学生)本校生的;[n]内脏;内部特征; [or]wrt;
international: [a]/ˌɪntəˈnæʃnəl/; [adj]国际的;国际通用的;[n]国际体育比赛(选手);外国人;[n](International) 共产国际(组织); [add]pl/internationals; [or]wrt;
interpret: [a]/ɪnˈtɜːprət/; [vt]说明;口译;[vi]解释;翻译; [add]pt/interpreted,pp/interpreted,pr/interpreting,s3/interprets; [or]wrt;
interpretation: [a]/ɪnˌtɜːprəˈteɪʃn/; [n]解释;翻译;演出; [add]pl/interpretations; [or]wrt;
interval: [a]/ˈɪntəvl/; [n]间隔;间距;幕间休息; [add]pl/intervals; [or]wrt;
intervene: [a]/ˌɪntəˈviːn/; [vi]干涉;调停;插入; [add]pt/intervened,pp/intervened,pr/intervening,s3/intervenes; [or]wrt;
intervention: [a]/ˌɪntəˈvenʃn/; [n]介入;调停;妨碍; [add]pl/interventions; [or]wrt;
interview: [a]/ˈɪntəvjuː/; [n]接见,采访;面试,面谈;[vt]采访;接见;对.进行面谈;对某人进行面试; [add]pl/interviews,pt/interviewed,pp/interviewed,pr/interviewing,s3/interviews; [or]wrt;
interviewee: [a]/ˌɪntəvjuːˈiː/; [n]参加面试者,被接见者,被访问者; [add]pl/interviewees; [or]wrt;
interviewer: [a]/ˈɪntəvjuːə(r)/; [n]采访者;会见者;面谈者;进行面试者; [or]wrt;
intrinsic: [a]/ɪnˈtrɪnzɪk; ɪnˈtrɪnsɪk/; [adj]本质的,固有的; [or]wrt;
introduce: [a]/ˌɪntrəˈdjuːs/; [vt]介绍;引进;提出;采用; [add]pt/introduced,pp/introduced,pr/introducing,s3/introduces; [or]wrt;
introduction: [a]/ˌɪntrəˈdʌkʃn/; [n]介绍;引进;采用;入门;传入; [add]pl/introductions; [or]wrt;
investigate: [a]/ɪnˈvestɪɡeɪt/; [v]调查;研究; [add]pt/investigated,pp/investigated,pr/investigating,s3/investigates; [or]wrt;
investigation: [a]/ɪnˌvestɪˈɡeɪʃn/; [n]调查;调查研究; [add]pl/investigations; [or]wrt;
investigator: [a]/ɪnˈvestɪɡeɪtə(r)/; [n]研究者;调查者;侦查员; [add]pl/investigators; [or]wrt;
involve: [a]/ɪnˈvɒlv/; [vt]包含;牵涉;使陷于;潜心于; [add]pt/involved,pp/involved,pr/involving,s3/involves; [or]wrt;
involvement: [a]/ɪnˈvɒlvmənt/; [n]参与;牵连;包含;混乱;财政困难; [or]wrt;
irrelevant: [a]/ɪˈreləvənt/; [adj]不相干的;不切题的; [or]wrt;
isolated: [a]/ˈaɪsəleɪtɪd/; [adj]偏远的;孤立的;孤独的;单独的; 绝缘的;[v]使..孤立;使..分离;将..剔出(isolate 的过去式和过去分词); [or]wrt;
isolation: [a]/ˌaɪsəˈleɪʃn/; [n]隔离;孤立;<电>绝缘;<化学>离析; [or]wrt;
issue: [a]/ˈɪʃuː; ˈɪsjuː/; [n]问题;流出;期号;发行物;[vt]发行,发布;发给;放出,排出;[vi]发行;流出;造成.结果;传下; [add]pt/issued,pp/issued,pr/issuing,pl/issues,s3/issues; [or]wrt;
item: [a]/ˈaɪtəm/; [n]条款,项目;一则;一件商品(或物品);[adv]又,同上;[v]记下;逐条列出; [or]wrt;
judgement: [a]/ˈdʒʌdʒmənt/; [n]意见;判断力;<法>审判;评价; [add]pl/judgements; [or]wrt;
justification: [a]/ˌdʒʌstɪfɪˈkeɪʃn/; [n]理由;辩护;认为有理,认为正当;释罪; [add]pl/justifications; [or]wrt;
justify: [a]/ˈdʒʌstɪfaɪ/; [vi]证明合法;整理版面;[vt]证明.是正当的;替.辩护; [add]pt/justified,pp/justified,pr/justifying,s3/justifies; [or]wrt;
key: [a]/kiː/; [n]钥匙;关键,密钥;(键盘乐器或电脑键盘的)键;调,声调,色调;答案;图例; 扳手;销子,楔,栓;翼果;板条间首层灰泥;(篮球)罚球区;低岛,礁;[vt]键入,用键盘输入;用别针等固定;使与..符合或关联;使..与..共处,相安无事;用钥匙将汽车表面划坏;将(表面)弄粗糙;给(广告)加识别码;成为获得..的关键;[adj]关键的,主要的;[n](Key)(美)基(人名); [or]wrt;
knowledge: [a]/ˈnɒlɪdʒ/; [n]知识,学问;知道,认识;学科;[n](Knowledge)人名;(南非)诺利奇; [or]wrt;
label: [a]/ˈleɪbl/; [n]标签;商标;绰号;唱片公司;词目标注;(计算机)标记;示踪剂;带垂饰的横带;[v]贴标签于;把..归类,给..扣帽子;用示踪剂使(物质等)示踪;[n](Label) (美,法,巴)拉贝尔(人名); [add]pt/labeled或labelled,pp/labeled或labelled,pr/labeling或labelling,pl/labels,s3/labels; [or]wrt;
lack: [a]/læk/; [n]缺乏,不足;[v]缺乏,不足,没有;需要;[n](Lack) (美,德)拉克(人名); [add]pl/lacks,pt/lacked,pp/lacked,pr/lacking,s3/lacks; [or]wrt;
language: [a]/ˈlæŋɡwɪdʒ/; [n]语言;语言文字;表达能力; [add]pl/languages; [or]wrt;
large: [a]/lɑːdʒ/; [adj]大的;多数的;广博的;[adv]大大地;夸大地;[n]大;[n](Large)人名;(英)拉奇;(法)拉尔热; [add]比较级/larger,最高级/largest; [or]wrt;
largely: [a]/ˈlɑːdʒli/; [adv]主要地;大部分;大量地; [or]wrt;
latter: [a]/ˈlætə(r)/; [adj]后者的;近来的;后面的;较后的;[n](Latter)人名;(英,德,捷)拉特; [or]wrt;
law: [a]/lɔː/; [n]法律;规律;法治;法学;诉讼;司法界;[vi]起诉;控告;[vt]控告;对.起诉;[n](Law)人名;(东南亚国家华语)刘;(英,缅,柬)劳; [or]wrt;
leader: [a]/ˈliːdə(r)/; [n]领导者;首领;指挥者;[n](Leader)人名;(英)利德; [add]pl/leaders; [or]wrt;
leadership: [a]/ˈliːdəʃɪp/; [n]领导能力;领导阶层; [add]pl/leaderships; [or]wrt;
learning: [a]/ˈlɜːnɪŋ/; [n]学习;学问;[v]学习(learn的现在分词); [or]wrt;
legal: [a]/ˈliːɡl/; [adj]法律的;合法的;法定的;依照法律的;[n](Legal)人名;(法)勒加尔; [or]wrt;
legally: [a]/ˈliːɡəli/; [adv]合法地;法律上; [or]wrt;
less: [a]/les/;  det. 量更少;数量较少(或更少);[adj]等级较低的;次要的;[adv]范围较小地;更少地;远不是,根本不;[prep]减去,除去(作介词用);[n](Less) (美,加拿大)莱斯(人名); [or]wrt;
level: [a]/ˈlevl/; [n]水平;标准;水平面;[adj]水平的;平坦的;同高的;[vi]瞄准;拉平;变得平坦;[vt]使同等;对准;弄平;[n](Level)人名;(法)勒韦尔; [add]pt/leveled或levelled,pp/leveled或levelled,pr/levelling或leveling; [or]wrt;
likely: [a]/ˈlaɪkli/; [adj]很可能的;合适的;有希望的;[adv]很可能;或许; [add]比较级/morelikely或likelier,最高级/mostlikely或likeliest; [or]wrt;
limit: [a]/ˈlɪmɪt/; [n]限制;限度;界线;[vt]限制;限定; [add]pl/limits,pt/limited,pr/limiting,s3/limits; [or]wrt;
limitation: [a]/ˌlɪmɪˈteɪʃn/; [n]限制;限度;极限;追诉时效;有效期限;缺陷; [or]wrt;
limited: [a]/ˈlɪmɪtɪd/; [adj]有限的;[n]高级快车; [or]wrt;
line: [a]/laɪn/; [n]路线,航线;排;绳;[vt]排成一行;划线于;以线条标示;使.起皱纹;[vi]排队;站成一排;[n](Line)人名;(英)莱恩;(俄)利涅; [add]pt/lined,pp/lined,pr/lining,pl/lines,s3/lines; [or]wrt;
link: [a]/lɪŋk/; [n]<计>链环,环节;联系,关系;[vt]连接,连结;联合,结合;[vi]连接起来;联系在一起;将人或物连接或联系起来;[n](Link)人名;(英,德,塞,捷,匈,瑞典)林克; [add]pl/links,pt/linked,pp/linked,pr/linking,s3/links; [or]wrt;
list: [a]/lɪst/; [n]列表,清单,目录;(船的)倾斜;[v]列清单;把.列入一览表;被列入价目表;把.列入正式名单(尤指医院或法庭的名单);(船只)倾斜; 使(公司) 上市; [or]wrt;
literature: [a]/ˈlɪtrətʃə(r)/; [n]文学;文献;文艺;著作; [or]wrt;
local: [a]/ˈləʊkl/; [adj]当地的,地方性的;局部的;局域的;本地通话的;(火车)慢车的;[n]当地人;附近的小酒馆;慢车;当地的分支机构;炒股散户;本地新闻;局部; [add]pl/locals; [or]wrt;
localized: [a]/ˈləʊkəlaɪzd/; [adj]局部的;地区的;小范围的;[v]定位(localize的过去分词); [or]wrt;
locally: [a]/ˈləʊkəli/; [adv]局部地;在本地; [or]wrt;
located: [a]/ləʊˈkeɪtɪd/; [adj]处于,位于;坐落的; [or]wrt;
location: [a]/ləʊˈkeɪʃn/; [n]位置;地点;外景拍摄场地; [or]wrt;
logic: [a]/ˈlɒdʒɪk/; [n]逻辑;逻辑学;逻辑性; [or]wrt;
logical: [a]/ˈlɒdʒɪkl/; [adj]合逻辑的,合理的;逻辑学的; [add]比较级/morelogical,最高级/mostlogical; [or]wrt;
loss: [a]/lɒs/; [n]减少;亏损;失败;遗失;[n](Loss)人名;(匈)洛什;(法,德,意)洛斯; [add]pl/losses; [or]wrt;
low: [a]/ləʊ/; [adj]低的,浅的;卑贱的;粗俗的;消沉的;[adv]低声地;谦卑地,低下地;[n]低;低价;低点;牛叫声;[vi]牛叫;[n](Low)人名;(英,德)洛; [add]比较级/lower,最高级/lowest; [or]wrt;
main: [a]/meɪn/; [adj]主要的,最大的,最重要的;[n](输送水,煤气等的)总管道,主管道;(the mains) (水,电等的)供应,供应系统;电源插座;海洋,公海;主帆(mailsail 的简称);(掷骰子游戏中)叫数;斗鸡比赛;[n](Main) (美)梅因(人名); [add]pl/mains; [or]wrt;
maintain: [a]/meɪnˈteɪn/; [vt]维持;继续;维修;主张;供养; [add]pt/maintained,pp/maintained,pr/maintaining,s3/maintains; [or]wrt;
major: [a]/ˈmeɪdʒə(r)/; [adj]主要的;重要的;主修的;较多的;[n]<人类>成年人;主修科目;陆军少校;[vi]主修;[n](Major)人名;(西)马霍尔;(法)马若尔;(捷,德,塞,瑞典)马约尔;(英)梅杰; [add]pl/majors,pt/majored,pr/majoring,s3/majors; [or]wrt;
majority: [a]/məˈdʒɒrəti/; [n]多数;成年; [add]pl/majorities; [or]wrt;
male: [a]/meɪl/; [adj]男性的;雄性的;有力的;[n]男人;雄性动物;[n](Male)人名;(柬)马尔;(意,西,塞)马莱;(英)梅尔; [add]pl/males; [or]wrt;
many: [a]/ˈmeni/;  det. 许多;[pron]许多;许多人;[adj]许多的;[n]大多数人;[n](Many) (美,法,加,印)马尼(人名); [add]比较级/more,最高级/most; [or]wrt;
margin: [a]/ˈmɑːdʒɪn/; [n]边缘;利润,余裕;页边的空白;[vt]加边于;加旁注于;[n](Margin)人名;(俄,意)马尔金; [add]pl/margins; [or]wrt;
material: [a]/məˈtɪəriəl/; [n]材料;用具;(有指明特征的)人才;素材;曲目;布料;[adj]物质的;身体需要的;和推理内容有关的;重要的;(证据或事实)决定性的;客观存在的;物欲的;[n](Material) (意,美)妈特力娅丽(人名); [add]pl/materials; [or]wrt;
matter: [a]/ˈmætə(r)/; [n]物质;事件;[vi]有关系;要紧;[n](Matter)人名;(英,法)马特;(西)马特尔; [or]wrt;
maximize: [a]/ˈmæksɪmaɪz/; [v](使)增加到最大限度;充分利用;找到..的最高值;(使计算机视窗)最大化; [add]pt/maximized,pp/maximized,pr/maximizing,s3/maximizes; [or]wrt;
maximum: [a]/ˈmæksɪməm/; [n]<数>极大,最大限度;最大量;[adj]最高的;最多的;最大极限的; [add]pl/maximums或maxima; [or]wrt;
may: [a]/meɪ/;  aux. 可以,能够;可能,也许;祝,愿;会,能; [or]wrt;
meaning: [a]/ˈmiːnɪŋ/; [n]意义;含义;意图;[adj]意味深长的;[v]意味;意思是(mean的ing形式); [add]pl/meanings; [or]wrt;
meaningful: [a]/ˈmiːnɪŋfl/; [adj]有意义的;意味深长的; [or]wrt;
means: [a]/miːnz/; [n]手段;方法;财产;[v]意思是;打算(mean的第三人称单数) < 复数means ]; [or]wrt;
measure: [a]/ˈmeʒə(r)/; [n]测量;措施;程度;尺寸;[vt]测量;估量;权衡;[vi]测量;估量; [add]pt/measured,pp/measured,pr/measuring,pl/measures,s3/measures; [or]wrt;
mechanism: [a]/ˈmekənɪzəm/; [n]机制;原理,途径;进程;机械装置;技巧; [add]pl/mechanisms; [or]wrt;
media: [a]/ˈmiːdiə/; [n]媒体;媒质(medium的复数);血管中层;浊塞音;中脉; [or]wrt;
mediate: [a]/ˈmiːdieɪt/; [vi]调解;斡旋;居中;[vt]调停;传达;[adj]间接的;居间的; [add]pt/mediated,pp/mediated,pr/mediating,s3/mediates; [or]wrt;
medical: [a]/ˈmedɪkl/; [adj]医学的;药的;内科的;[n]医生;体格检查; [add]pl/medicals; [or]wrt;
medium: [a]/ˈmiːdiəm/; [adj]中间的,中等的;半生熟的;(投球)中速的;[n]方法;媒体;媒介;中间物;溶剂;灵媒;中庸; [add]pl/mediums或media; [or]wrt;
member: [a]/ˈmembə(r)/; [n]成员;会员;议员; [add]pl/members; [or]wrt;
mental: [a]/ˈmentl/; [adj]精神的;脑力的;疯的;[n]精神病患者; [or]wrt;
method: [a]/ˈmeθəd/; [n]方法;条理;类函数;[adj]使用体验派表演方法的; [add]pl/methods; [or]wrt;
methodology: [a]/ˌmeθəˈdɒlədʒi/; [n]方法学,方法论; [add]pl/methodologies; [or]wrt;
might: [a]/maɪt/;  aux. 可能,也许,可以(may 的过去式);[n]强大力量,威力,势力;[n](Might) (美)迈特(人名); [or]wrt;
migrate: [a]/maɪˈɡreɪt/; [vi]移动;随季节而移居;移往;[vt]使移居;使移植; [add]pt/migrated,pp/migrated,pr/migrating,s3/migrates; [or]wrt;
migration: [a]/maɪˈɡreɪʃn/; [n]迁移;移民;移动; [add]pl/migrations; [or]wrt;
minimal: [a]/ˈmɪnɪml/; [adj]最低的;最小限度的; [or]wrt;
minimize: [a]/ˈmɪnɪmaɪz/; [vt]使减到最少;小看,极度轻视;[vi]最小化; [add]pt/minimized,pp/minimized,pr/minimizing,s3/minimizes; [or]wrt;
minimum: [a]/ˈmɪnɪməm/; [n]最小值;最低限度;最小化;最小量;[adj]最小的;最低的; [add]pl/minimums或minima; [or]wrt;
minor: [a]/ˈmaɪnə(r)/; [adj]未成年的;次要的;较小的;小调的;二流的;[n]未成年人;小调;辅修科目;[vi]辅修;[n](Minor)人名;(英)迈纳;(德,法,波,俄)米诺尔; [or]wrt;
minority: [a]/maɪˈnɒrəti/; [n]少数民族;少数派;未成年; [or]wrt;
mix: [a]/mɪks/; [v](使)混和;配制;参与;相容,平安相处;交往,交际;混合录音;混成;并置,使相结合;(非正式)打起来;[n]混合;良莠不齐;混合物;各色人混杂的一群;混乱;成分比例;配料;混录,混音;乐曲组合,连奏;叠化图像;[n](Mix) (美,俄,巴)米克斯(人名); [add]pt/mixed或mixt,pp/mixed或mixt,pr/mixing; [or]wrt;
mobile: [a]/ˈməʊbaɪl/; [adj]可移动的;机动的;易变的;非固定的;[n]移动电话; [or]wrt;
mobilize: [a]/ˈməʊbəlaɪz/; [vt]动员,调动;集合,组织;使.流通;使.松动;[vi]组织;动员起来; [add]pt/mobilized,pp/mobilized,pr/mobilizing,s3/mobilizes; [or]wrt;
mode: [a]/məʊd/; [n]模式;方式;风格;时尚;[n](Mode)人名;(德,英,法,乍,瑞典)莫德; [add]pl/modes; [or]wrt;
model: [a]/ˈmɒdl/; [n]模型;典型;模范;模特儿;样式;[vt]模拟;塑造;模仿;[vi]做模型;做模特儿;[adj]模范的;作模型用的;[n](Model)人名;(德,俄,英)莫德尔; [add]pt/modeled或-elled,pp/modeled或-elled,pr/modeling或-elling,pl/models,s3/models; [or]wrt;
modelling: [a]/ˈmɒdəlɪŋ/; [n]模化;立体感;模特儿职业(等于modeling);[v]模仿(model的ing形式);做模型; [or]wrt;
modern: [a]/ˈmɒdn/; [adj]现代的,近代的;时髦的;[n]现代人;有思想的人; [add]比较级/moremodern,最高级/mostmodern,pl/moderns; [or]wrt;
modernity: [a]/məˈdɜːnəti/; [n]现代性;现代的东西;新式; [add]pl/modernities; [or]wrt;
modernization: [a]/ˌmɒdənaɪˈzeɪʃn/; [n]现代化; [or]wrt;
modify: [a]/ˈmɒdɪfaɪ/; [vt]修改,修饰;更改;[vi]修改; [add]pt/modified,pp/modified,pr/modifying,s3/modifies; [or]wrt;
monitor: [a]/ˈmɒnɪtə(r)/; [n]监视器;监听器;监控器;显示屏;班长;[vt]监控; [or]wrt;
moreover: [a]/mɔːrˈəʊvə(r)/; [adv]而且;此外; [or]wrt;
most: [a]/məʊst/; [adv]最;非常,极其;最多;几乎;[adj]大部分的,多数的;最多的;[n]大部分,大多数;[n](Most)人名;(德,俄,法,芬,捷,英)莫斯特; [add]many或much;more;most/复数; [or]wrt;
motivate: [a]/ˈməʊtɪveɪt/; [v]刺激,使有动机,激发.的积极性;成为..的动机;给出理由;申请; [add]pt/motivated,pp/motivated,pr/motivating,s3/motivates; [or]wrt;
motivation: [a]/ˌməʊtɪˈveɪʃn/; [n]动机;积极性;推动; [add]pl/motivations; [or]wrt;
movement: [a]/ˈmuːvmənt/; [n]运动;活动;运转;乐章; [add]pl/movements; [or]wrt;
multiple: [a]/ˈmʌltɪpl/; [adj]多重的;多样的;许多的;[n]倍数;<电>并联; [add]pl/multiples; [or]wrt;
must: [a]/məst; mʌst/;  aux. 必须;一定;应该,得;[n]绝对必要的事物;待发酵的葡萄汁;发霉,潮气;[n](Must) (美)穆斯特(人名); [add]pl/musts,pt/must,pp/must,pr/musting,s3/musts; [or]wrt;
namely: [a]/ˈneɪmli/; [adv]也就是;即是;换句话说; [or]wrt;
national: [a]/ˈnæʃnəl/; [adj]国家的;国民的;民族的;国立的;[n]国民; [add]pl/nationals; [or]wrt;
natural: [a]/ˈnætʃrəl/; [adj]自然的;物质的;天生的;不做作的;[n]自然的事情;白痴;本位音;[n](Natural)人名;(西)纳图拉尔; [add]比较级/morenatural,最高级/mostnatural,pl/naturals; [or]wrt;
naturally: [a]/ˈnætʃrəli/; [adv]自然地; 自然而然地; 轻而易举; 天生地; 大方地; [or]wrt;
nature: [a]/ˈneɪtʃə(r)/; [n]自然;性质;本性;种类;[n](Nature)人名;(法)纳蒂尔; [add]pl/natures; [or]wrt;
necessarily: [a]/ˌnesəˈserəli; ˈnesəsərəli/; [adv]必要地;必定地,必然地; [or]wrt;
necessary: [a]/ˈnesəsəri/; [adj]必要的;必需的;必然的;[n]必需品;[n](Necessary)(英)内塞瑟里(人名); [or]wrt;
necessity: [a]/nəˈsesəti/; [n]需要;必然性;必需品; [add]pl/necessities; [or]wrt;
need: [a]/niːd/; [v]必须,需要;(表示应该或不得不做)有必要;[n]需要,必须; 特别需要,迫切要求;欲望;(食物,钱或生活来源的)短缺,缺乏;必需品;贫困(或困难)的处境; [add]pl/needs,pt/needed,pp/needed,pr/needing,s3/needs; [or]wrt;
negative: [a]/ˈneɡətɪv/; [adj]<数>负的;消极的;否定的;阴性的;[n]否定;负数;<摄>底片;[vt]否定;拒绝; [add]pt/negatived,pp/negatived,pr/negativing,pl/negatives,s3/negatives; [or]wrt;
net: [a]/net/; [n]网;有专门用途的网;球门网;球网;网络(等于 Internet);(板球)练球场;(板球)一次练球;捕鱼总量;网眼织物;陷阱;候选人的选择面;[adj]纯的;最后的;原价的;(重量)净的;(高尔夫球得分)净得的;[v]净赚;用网捕;(巧妙地)捕获,得到;(将球)踢入球门;用网覆盖;使(某人)获得(利益,收入);(计算时)扣除..(以得出净额);[adv]净地;净赚地;[n](Net) (俄)内(人名); [add]pt/netted,pp/netted,pr/netting; [or]wrt;
network: [a]/ˈnetwɜːk/; [n]网络;广播网;网状物; [or]wrt;
neutral: [a]/ˈnjuːtrəl/; [adj]中立的,中性的;中立国的;非彩色的;[n]中立国;中立者;非彩色;齿轮的空档; [add]比较级/moreneutral,最高级/mostneutral,pl/neutrals; [or]wrt;
nevertheless: [a]/ˌnevəðəˈles/; [adv]然而,不过;虽然如此;[conj]然而,不过; [or]wrt;
new: [a]/njuː/; [adj]新的,新鲜的;更新的;初见的;[adv]新近;[n](New)人名;(英)纽; [or]wrt;
norm: [a]/nɔːm/; [n]标准,规范; [or]wrt;
normal: [a]/ˈnɔːml/; [adj]正常的;正规的;标准的;[n]正常;标准;常态;法线(数学);[n](Normal)人名;(德)诺马尔; [or]wrt;
normally: [a]/ˈnɔːməli/; [adv]正常地;通常地,一般地; [or]wrt;
note: [a]/nəʊt/; [n]笔记;音符;票据;注解;纸币;便笺;照会;调子;[vt]注意;记录;注解;[n](Note) (美,法)诺特(人名); [or]wrt;
notion: [a]/ˈnəʊʃn/; [n]概念;见解;打算; [add]pl/notions; [or]wrt;
novel: [a]/ˈnɒvl/; [adj]新奇的;异常的;[n]小说;[n](Novel)人名;(法,西,英)诺韦尔; [add]pl/novels; [or]wrt;
number: [a]/ˈnʌmbə(r)/; [n]数;(杂志等的)期;号码;数字;算术;[vi]计入;总数达到;[vt]编号;计入;数.的数目;使为数有限; [add]pl/numbers,pt/numbered,pp/numbered,pr/numbering,s3/numbers; [or]wrt;
object: [a]/ˈɒbdʒɪkt/; [n]目标;物体;客体;宾语;[vt]提出.作为反对的理由;[vi]反对;拒绝; [or]wrt;
objective: [a]/əbˈdʒektɪv/; [n]目的;目标;(军事行动的)攻击目标;物镜;宾格;[adj]客观的;客观存在的;(疾病症状)客观的,他觉的;目标的;宾格的; [add]比较级/moreobjective,最高级/mostobjective,pl/objectives; [or]wrt;
observation: [a]/ˌɒbzəˈveɪʃn/; [n]观察;监视;观察报告; [add]pl/observations; [or]wrt;
observe: [a]/əbˈzɜːv/; [vt]庆祝;[vt]观察;遵守;说;注意到;评论;[vi]观察;说;注意到;评论; [or]wrt;
observer: [a]/əbˈzɜːvə(r)/; [n]观察者;<天>观测者;遵守者; [add]pl/observers; [or]wrt;
obtain: [a]/əbˈteɪn/; [vi]获得;流行;[vt]获得; [add]pt/obtained,pp/obtained,pr/obtaining,s3/obtains; [or]wrt;
occupation: [a]/ˌɒkjuˈpeɪʃn/; [n]职业;占有;消遣;占有期; [add]pl/occupations; [or]wrt;
occupy: [a]/ˈɒkjupaɪ/; [vt]占据,占领;居住;使忙碌; [add]pt/occupied,pp/occupied,pr/occupying,s3/occupies; [or]wrt;
occur: [a]/əˈkɜː(r)/; [vi]发生;出现;存在; [add]pt/occurred,pp/occurred,pr/occurring,s3/occurs; [or]wrt;
occurrence: [a]/əˈkʌrəns/; [n]发生;出现;事件;发现; [add]pl/occurrences; [or]wrt;
offer: [a]/ˈɒfə(r)/; [vt]提供;出价;试图;[n]提议;出价;意图;录取通知书;[vi]提议;出现;献祭;求婚; [add]pl/offers,pt/offered,pp/offered,pr/offering,s3/offers; [or]wrt;
often: [a]/ˈɒfn; ˈɒftən/; [adv]常常,时常;往往,大多; [add]比较级/moreoften或oftener,最高级/mostoften或oftenest; [or]wrt;
ongoing: [a]/ˈɒnɡəʊɪŋ/; [adj]仍在进行的;不断前进的;持续存在的; [or]wrt;
online: [a]/ˌɒnˈlaɪn/; [adj]联机的;在线的;[adv]在线地; [or]wrt;
operate: [a]/ˈɒpəreɪt/; [vi]运转;动手术;起作用;[vt]操作;经营;引起;对.开刀;行动; [or]wrt;
operation: [a]/ˌɒpəˈreɪʃn/; [n]操作;经营;<外科>手术;<数]<计>运算; [add]pl/operations; [or]wrt;
operational: [a]/ˌɒpəˈreɪʃənl/; [adj]操作的;运作的; [or]wrt;
opportunity: [a]/ˌɒpəˈtjuːnəti/; [n]时机,机会; [add]pl/opportunities; [or]wrt;
optimal: [a]/ˈɒptɪməl/; [adj]最佳的;最理想的; [or]wrt;
option: [a]/ˈɒpʃn/; [n]<计>选项;选择权;买卖的特权; [add]pl/options,pt/optioned,pp/optioned,pr/optioning,s3/options; [or]wrt;
order: [a]/ˈɔːdə(r)/; [n]命令;顺序;规则;<贸易]订单;[vt]命令;整理;订购;[vi]命令;订货; [or]wrt;
ordinary: [a]/ˈɔːdnri/; [adj]普通的;平凡的;平常的;[n]普通;平常的人(或事); [add]pl/ordinaries; [or]wrt;
organization: [a]/ˌɔːɡənaɪˈzeɪʃn/; [n]组织;机构;体制;团体; [add]pl/organizations; [or]wrt;
organize: [a]/ˈɔːɡənaɪz/; [vt]组织;使有系统化;给予生机;组织成立工会等;[vi]组织起来;成立组织; [add]pt/organized,pp/organized,pr/organizing,s3/organizes; [or]wrt;
orient: [a]/ˈɔːrient/; [v]朝向;确定方位;使适应;[n](诗,文)东方国家;[adj](诗,文)东方(国家)的;(太阳等)冉冉升起的;(宝石)光彩夺目的;[n](Orient) (美)奥里安(人名); [add]pt/oriented,pp/oriented,pr/orienting,s3/orients; [or]wrt;
orientation: [a]/ˌɔːriənˈteɪʃn/; [n]方向;定向;适应;情况介绍; [or]wrt;
origin: [a]/ˈɒrɪdʒɪn/; [n]起源;原点;出身;开端; [or]wrt;
original: [a]/əˈrɪdʒənl/; [adj]原来的;开始的;首创的,新颖的,创新的;原作的;[n]原件,原版;(文学中)原型;(歌,画等的)原创作品;原版唱片;真品原版服装;古怪的人; [add]pl/originals; [or]wrt;
originally: [a]/əˈrɪdʒənəli/; [adv]最初,起初;本来; [or]wrt;
originate: [a]/əˈrɪdʒɪneɪt/; [vt]引起;创作;[vi]发源;发生;起航; [add]pt/originated,pp/originated,pr/originating,s3/originates; [or]wrt;
other: [a]/ˈʌðə(r)/; [adj]其他的,另外的;[pron]另外一个; [add]pl/others; [or]wrt;
otherwise: [a]/ˈʌðəwaɪz/; [adv]否则;另外;在其他方面;[adj]另外的;其他方面的;原本,本来;[conj]其他;如果不;然后; [or]wrt;
outcome: [a]/ˈaʊtkʌm/; [n]结果,结局;成果; [add]pl/outcomes; [or]wrt;
outline: [a]/ˈaʊtlaɪn/; [n]轮廓;大纲;概要;略图;[vt]概述;略述;描画.轮廓; [add]pt/outlined,pp/outlined,pr/outlining,pl/outlines,s3/outlines; [or]wrt;
output: [a]/ˈaʊtpʊt/; [n]输出,输出量;产量;出产;[vt]输出; [add]pt/outputted或output,pp/outputted或output,pr/outputting,pl/outputs; [or]wrt;
overall: [a]/'əʊvərɔːl/; [adj]全部的;全体的;一切在内的;[adv]全部地;总的说来;[n]工装裤;罩衫; [add]pl/overalls; [or]wrt;
overlap: [a]/ˌəʊvəˈlæp/; [v]与..重叠,与..互搭;(职责等)部分地重叠,部分地相同;在时间上部分地重叠,同时发生;[n]重叠的部分,互搭量;共同的兴趣(或责任等);(两事发生的)重叠时间,交接时期; [add]pt/overlapped,pp/overlapped,pr/overlapping,pl/overlaps,s3/overlaps; [or]wrt;
overview: [a]/ˈəʊvəvjuː/; [n]<图情>综述;概观; [add]pl/overviews; [or]wrt;
parallel: [a]/ˈpærəlel/; [n]平行线;对比;[vt]使.与.平行;[adj]平行的;类似的,相同的; [add]pt/paralleled或-allelled,pp/paralleled或-allelled,pr/paralleling或-allelling,pl/parallels,s3/parallels; [or]wrt;
part: [a]/pɑːt/; [n]部分;角色;零件;一些;片段;[vt]分离;分配;分开;[vi]断裂;分手;[adv]部分地;[adj]部分的;[n](Part)人名;(英,瑞典)帕特;(泰)巴;(法)帕尔; [or]wrt;
partial: [a]/ˈpɑːʃl/; [adj]局部的;偏爱的;不公平的; [or]wrt;
partially: [a]/ˈpɑːʃəli/; [adv]部分地;偏袒地; [or]wrt;
participant: [a]/pɑːˈtɪsɪpənt/; [n]参与者,参加者;[adj]参与的; [add]pl/participants; [or]wrt;
participate: [a]/pɑːˈtɪsɪpeɪt/; [vi]参与,参加;分享;[vt]分享;分担; < 过去式participated 过去分词participated 现在分词participating ]; [or]wrt;
participation: [a]/pɑːˌtɪsɪˈpeɪʃn/; [n]参与;分享;参股; [or]wrt;
particular: [a]/pəˈtɪkjələ(r)/; [adj]特别的;详细的;独有的;挑剔的;[n]详细说明;个别项目; [add]pl/particulars; [or]wrt;
particularly: [a]/pəˈtɪkjələli/; [adv]异乎寻常地;特别是;明确地; [or]wrt;
partly: [a]/ˈpɑːtli/; [adv]部分地;在一定程度上; [or]wrt;
pattern: [a]/ˈpætn/; [n]模式;图案;样品;[vt]模仿;以图案装饰;[vi]形成图案; [add]pl/patterns,pt/patterned,pp/patterned,pr/patterning,s3/patterns; [or]wrt;
per: [a]/pə(r); pɜː(r)/; [prep]每,每一;经;按照;(纹章)依..的方向;[adv]每,每个;[abbr]时期 (period);人 (person);[n](Per) (挪,瑞,丹)佩尔(人名); [or]wrt;
perceive: [a]/pəˈsiːv/; [vt]察觉,感觉;理解;认知;[vi]感到,感知;认识到; [add]pt/perceived,pp/perceived,pr/perceiving,s3/perceives; [or]wrt;
percentage: [a]/pəˈsentɪdʒ/; [n]百分比;百分率,百分数; [add]pl/percentages; [or]wrt;
perception: [a]/pəˈsepʃn/; [n]认识能力;知觉,感觉;洞察力;看法;获取; [add]pl/perceptions; [or]wrt;
perform: [a]/pəˈfɔːm/; [vt]执行;完成;演奏;[vi]执行,机器运转;表演; [add]pt/performed,pp/performed,pr/performing,s3/performs; [or]wrt;
performance: [a]/pəˈfɔːməns/; [n]性能;绩效;表演;执行;表现; [or]wrt;
period: [a]/ˈpɪəriəd/; [n]周期,期间;时期;一段时间;经期;课时;句点,句号;[adj]某一时代的; [or]wrt;
permit: [a]/pəˈmɪt/; [vi]许可;允许;[vt]许可;允许;[n]许可证,执照; [add]pt/permitted,pp/permitted,pr/permitting,pl/permits,s3/permits; [or]wrt;
personal: [a]/ˈpɜːsənl/; [adj]个人的;身体的;亲自的;[n]人事消息栏;人称代名词; [add]pl/personals; [or]wrt;
perspective: [a]/pəˈspektɪv/; [n]观点;远景;透视图;[adj]透视的; [add]pl/perspectives; [or]wrt;
phase: [a]/feɪz/; [n]月相;时期,阶段;[vt]分阶段进行;使定相; [or]wrt;
phenomenon: [a]/fəˈnɒmɪnən/; [n]现象;奇迹;杰出的人才; [add]pl/phenomena或phenomenons; [or]wrt;
physical: [a]/ˈfɪzɪkl/; [adj]物理的;身体的;物质的;根据自然规律的,符合自然法则的;[n]体格检查; [or]wrt;
point: [a]/pɔɪnt/; [n]要点;得分;标点;<机>尖端;[vt]指向;弄尖;加标点于;[vi]表明;指向;[n](Point)人名;(法)普安; [add]pl/points,pt/pointed,pp/pointed,pr/pointing,s3/points; [or]wrt;
policy: [a]/ˈpɒləsi/; [n]政策,方针;保险单; [add]pl/policies; [or]wrt;
population: [a]/ˌpɒpjuˈleɪʃn/; [n]人口;<生物>种群,<生物>群体;全体居民;<统计学>总体; [or]wrt;
pose: [a]/pəʊz/; [vt]造成,形成;摆姿势;装模作样;提出.讨论;[vi]摆姿势;佯装;矫揉造作;[n]姿势,姿态;装模作样; [or]wrt;
position: [a]/pəˈzɪʃn/; [n]位置,方位;职位,工作;姿态;站位;<金融]仓位;[v]安置;把..放在适当位置; [or]wrt;
positive: [a]/ˈpɒzətɪv/; [adj]积极的;<数>正的,<医]<化学>阳性的;确定的,肯定的;实际的,真实的;绝对的;[n]正数;<摄>正片; [add]比较级/morepositive,最高级/mostpositive,pl/positives; [or]wrt;
positively: [a]/ˈpɒzətɪvli/; [adv]肯定地;明确地;断然地;乐观地; [or]wrt;
possibility: [a]/ˌpɒsəˈbɪləti/; [n]可能性;可能发生的事物; [add]pl/possibilities; [or]wrt;
possible: [a]/ˈpɒsəbl/; [adj]可能的;合理的;合适的;[n]可能性;合适的人;可能的事物; [add]pl/possibles; [or]wrt;
potential: [a]/pəˈtenʃl/; [adj]潜在的,可能的;势的;[n]潜能,可能性;电势; [add]pl/potentials; [or]wrt;
potentially: [a]/pəˈtenʃəli/; [adv]可能地,潜在地; [or]wrt;
poverty: [a]/ˈpɒvəti/; [n]贫困;困难;缺少;低劣; [or]wrt;
power: [a]/ˈpaʊə(r)/; [n]力量,能力;电力,功率,性能;政权,势力;<数>幂;[vt]激励;供以动力;使.有力量;[vi]快速前进;[adj]借影响有权势人物以操纵权力的;[n](Power)人名;(英,葡)鲍尔; [or]wrt;
practical: [a]/ˈpræktɪkl/; [adj]实际的;实用性的; [add]比较级/morepractical,最高级/mostpractical,pl/practicals; [or]wrt;
practice: [a]/ˈpræktɪs/; [n]实践;练习;惯例;[vi]练习;实习;实行;[vt]练习;实习;实行; [add]pt/practiced,pp/practiced,pr/practicing,pl/practices,s3/practices; [or]wrt;
practitioner: [a]/prækˈtɪʃənə(r)/; [n]开业者,从业者,执业医生; [or]wrt;
precede: [a]/prɪˈsiːd/; [vt]领先,在.之前;优于,高于;[vi]领先,在前面; [add]pt/preceded,pp/preceded,pr/preceding; [or]wrt;
precise: [a]/prɪˈsaɪs/; [adj]精确的;明确的;严格的; [add]比较级/moreprecise,最高级/mostprecise; [or]wrt;
precisely: [a]/prɪˈsaɪsli/; [adv]精确地;恰恰; [or]wrt;
precision: [a]/prɪˈsɪʒn/; [n]精度,<数>精密度;精确;[adj]精密的,精确的; [or]wrt;
predict: [a]/prɪˈdɪkt/; [v]预言,预知,预卜;做预报;断言; [or]wrt;
prediction: [a]/prɪˈdɪkʃn/; [n]预报;预言; [add]pl/predictions; [or]wrt;
predominantly: [a]/prɪˈdɒmɪnəntli/; [adv]主要地;显著地; [or]wrt;
preference: [a]/ˈprefrəns/; [n]偏爱,倾向;优先权; [add]pl/preferences; [or]wrt;
presence: [a]/ˈprezns/; [n]存在;出席;参加;风度;仪态; [add]pl/presences; [or]wrt;
present: [a]/ˈpreznt/; [adj]现在的;出席的;(事物)存在的;正在考虑的;现在时(态)的;[n]礼物;现在,目前;(动词)现在式;(举枪的)瞄准;[v]颁发;赠送;提出;展现;使发生;描述;出现;主持(节目);上演;介绍;出席;表达;提交(支票或账单);致谢;(教堂)向主教推荐已被委任的牧师就任;向法院正式提交;举枪瞄准 ;(疾病)症状显露; [add]pl/presents,pt/presented,pp/presented,pr/presenting,s3/presents; [or]wrt;
presentation: [a]/ˌpreznˈteɪʃn/; [n]展示;描述,陈述;介绍;赠送; [or]wrt;
pressure: [a]/ˈpreʃə(r)/; [n]压力;压迫,<物>压强;[vt]迫使;密封;使..增压; [add]pt/pressured,pp/pressured,pr/pressuring,pl/pressures,s3/pressures; [or]wrt;
prevent: [a]/prɪˈvent/; [vt]预防,防止;阻止;[vi]妨碍,阻止; [add]pt/prevented,pp/prevented,pr/preventing,s3/prevents; [or]wrt;
prevention: [a]/prɪˈvenʃn/; [n]预防;阻止;妨碍; [add]pl/preventions; [or]wrt;
previous: [a]/ˈpriːviəs/; [adj]以前的;早先的;过早的;[adv]在先;在.以前; [or]wrt;
previously: [a]/ˈpriːviəsli/; [adv]以前;预先;仓促地; [or]wrt;
primarily: [a]/praɪˈmerəli; ˈpraɪmərəli/; [adv]首先;主要地,根本上; [or]wrt;
primary: [a]/ˈpraɪməri/; [adj]主要的;初级的;基本的;[n]原色;最主要者; [add]pl/primaries; [or]wrt;
principle: [a]/ˈprɪnsəpl/; [n]原理,原则;主义,道义;本质,本义;根源,源泉; [add]pl/principles; [or]wrt;
prior: [a]/ˈpraɪə(r)/; [adj](时间,顺序等)先前的;优先的;[n]男修道院副院长;托钵会会长;(非正式)犯罪前科;先验;(一些宗教教派中的社区)长老;[n](Prior) (美)普廖尔(人名); [add]pl/priors; [or]wrt;
priority: [a]/praɪˈɒrəti/; [n]优先;优先权;<数>优先次序;优先考虑的事; [add]pl/priorities; [or]wrt;
private: [a]/ˈpraɪvət/; [adj]私人的,私有的;私立的;私营的;[adj]私下的,不公开的,秘密的;[adj](场所)清静的;(人)不愿吐露心思的,内向的;[adj]无官职的;[n]列兵;二等兵; [or]wrt;
probability: [a]/ˌprɒbəˈbɪləti/; [n]可能性;机率;<数>或然率; [add]pl/probabilities; [or]wrt;
problem: [a]/ˈprɒbləm/; [n]难题;引起麻烦的人;[adj]成问题的;难处理的; [add]pl/problems; [or]wrt;
problematic: [a]/ˌprɒbləˈmætɪk/; [adj]问题的;有疑问的;不确定的; [or]wrt;
procedural: [a]/prəˈsiːdʒərəl/; [adj]程序上的; [or]wrt;
procedure: [a]/prəˈsiːdʒə(r)/; [n]程序,手续;步骤; [add]pl/procedures; [or]wrt;
process: [a]/prəˈses;(for n.)ˈprəʊses/; [n](为达到某一目标的)过程;(自然变化的)过程;工艺流程;诉讼程序;传票;突起;进展;(发型)直发式;[v]加工;审核;处理(数据);列队行进;冲印(照片);把(头发)弄成直发;[adj]经过特殊加工的;照相板的;染印法的; [add]s3/processes,pt/processed,pp/processed,pr/processing,pl/processes; [or]wrt;
produce: [a]/prəˈdjuːs/; [vt]生产;引起;创作;生育,繁殖;[n]农产品,产品;[vi]生产,创作; [add](/producing,,produced,/												produces; [or]wrt;
product: [a]/ˈprɒdʌkt/; [n]产品;结果;<数>乘积;作品; [add]pl/products; [or]wrt;
production: [a]/prəˈdʌkʃn/; [n]成果;产品;生产;作品; [add]pl/productions; [or]wrt;
productive: [a]/prəˈdʌktɪv/; [adj]能生产的;生产的,生产性的;多产的;富有成效的; [add]比较级/moreproductive,最高级/mostproductive; [or]wrt;
professional: [a]/prəˈfeʃənl/; [adj]专业的;职业的;职业性的;[n]专业人员;职业运动员; [add]pl/professionals; [or]wrt;
profile: [a]/ˈprəʊfaɪl/; [n]侧面;轮廓;外形;剖面;简况;[vt]描.的轮廓;扼要描述;[vi]给出轮廓; [add]pl/profiles,pt/profiled,pp/profiled,pr/profiling,s3/profiles; [or]wrt;
programme: [a]/ˈprəʊɡræm/; [n]计划,规划;节目;程序;[vi]编程序;制作节目;[vt]规划;拟.计划; [add]pt/programmed,pp/programmed,pr/programming; [or]wrt;
progress: [a]/ˈprəʊɡres/; [n]进步,发展;前进;[vi]前进,进步;进行;[n](Progress)人名;(赞)普罗格雷斯; [add]pl/progresses,pt/progressed,pp/progressed,pr/progressing,s3/progresses; [or]wrt;
progression: [a]/prəˈɡreʃn/; [n]前进;连续; [add]pl/progressions; [or]wrt;
progressive: [a]/prəˈɡresɪv/; [adj]进步的;先进的;[n]改革论者;进步分子; [add]pl/progressives; [or]wrt;
project: [a]/ˈprɒdʒekt/; [n](生产或研究)工程;方案;计划;事业;项目;专题研究;住房,廉租住宅区;[v]设计;计划;抛射;投射;表现;促进(观点或意象);确立(好印象);突出;预测;发送;(声音)扩及远处;想象(自己或场景)在另一个时间或地点;作..投影线;(情感,愿望)无意投射转移(给别人); [add]pl/projects,pt/projected,pp/projected,pr/projecting,s3/projects; [or]wrt;
projection: [a]/prəˈdʒekʃn/; [n]投射;规划;突出;发射;推测; [add]pl/projections; [or]wrt;
promote: [a]/prəˈməʊt/; [vt]促进;提升;推销;发扬;[vi]成为王后或其他大于卒的子; [add]pt/promoted,pp/promoted,pr/promoting,s3/promotes; [or]wrt;
promotion: [a]/prəˈməʊʃn/; [n]提升,<劳经>晋升;推销,促销;促进;发扬,振兴; [add]pl/promotions; [or]wrt;
proportion: [a]/prəˈpɔːʃn/; [n]比例,占比;部分;面积;均衡;[vt]使成比例;使均衡;分摊; [or]wrt;
proportional: [a]/prəˈpɔːʃənl/; [adj]比例的,成比例的;相称的,均衡的;[n]<数>比例项; [add]pl/proportionals; [or]wrt;
proposal: [a]/prəˈpəʊzl/; [n]提议,建议;求婚; [add]pl/proposals; [or]wrt;
propose: [a]/prəˈpəʊz/; [vt]建议;打算,计划;求婚;[vi]建议;求婚;打算; [add]pt/proposed,pp/proposed,pr/proposing,s3/proposes; [or]wrt;
proposition: [a]/ˌprɒpəˈzɪʃn/; [n]<数>命题;提议;主题;议题;[vt]向.提议;向.求欢; [or]wrt;
protect: [a]/prəˈtekt/; [vt]保护,防卫;警戒; [add]pt/protected,pp/protected,pr/protecting,s3/protects; [or]wrt;
protection: [a]/prəˈtekʃn/; [n]保护;防卫;护照; [add]pl/protections; [or]wrt;
protocol: [a]/ˈprəʊtəkɒl/; [n]协议;草案;礼仪;[vt]拟定;[vi]拟定; [add]pt/protocolled或coled,pp/protocolled或coled,pr/protocolling或coling,pl/protocols; [or]wrt;
provide: [a]/prəˈvaɪd/; [vt]提供;规定;准备;装备;[vi]规定;抚养;作准备; [add]pt/provided,pp/provided,pr/providing,s3/provides; [or]wrt;
psychological: [a]/ˌsaɪkəˈlɒdʒɪkl/; [adj]心理的;心理学的;精神上的; [or]wrt;
public: [a]/ˈpʌblɪk/; [adj]公众的;政府的;公用的;公立的;[n]公众;社会;公共场所;[n](Public)人名;(英)帕布利克; [add]pl/publics; [or]wrt;
purpose: [a]/ˈpɜːpəs/; [n]目的;用途;意志;[vt]决心;企图;打算; [add]pt/purposed,pp/purposed,pr/purposing,pl/purposes,s3/purposes; [or]wrt;
qualitative: [a]/ˈkwɒlɪtətɪv/; [adj]定性的;质的,性质上的; [or]wrt;
quality: [a]/ˈkwɒləti/; [n]质量,<统计>品质;特性;才能;[adj]优质的;高品质的;棒极了; [or]wrt;
quantify: [a]/ˈkwɒntɪfaɪ/; [vt]量化;为.定量;确定数量;[vi]量化;定量; [add]pt/quantified,pp/quantified,pr/quantifying,s3/quantifies; [or]wrt;
quantitative: [a]/ˈkwɒntɪtətɪv/; [adj]定量的;量的,数量的; [or]wrt;
quantity: [a]/ˈkwɒntəti/; [n]量,数量;大量;总量; [add]pl/quantities; [or]wrt;
question: [a]/ˈkwestʃən/; [n]问题,疑问;询问;疑问句;[vt]询问;怀疑;审问;[vi]询问;怀疑;审问; [add]pl/questions,pt/questioned,pp/questioned,pr/questioning,s3/questions; [or]wrt;
race: [a]/reɪs/; [n]属,种;种族,人种;家庭,门第;赛事,赛跑;[vt]使参加比赛;和.竞赛;使急走,使全速行进;[vi]比速度,参加竞赛;全速行进;[n](Race)人名;(英)雷斯;(塞)拉采; [or]wrt;
random: [a]/ˈrændəm/; [adj]<数>随机的;任意的;胡乱的;[n]随意;[adv]胡乱地; [or]wrt;
randomize: [a]/ˈrændəmaɪz/; [vt]使随机化;(使)作任意排列或不规则分布; [add]pt/randomized,pp/randomized,pr/randomizing,s3/randomizes; [or]wrt;
randomly: [a]/ˈrændəmli/; [adv]随便地,任意地;无目的地,胡乱地;未加计划地; [or]wrt;
range: [a]/reɪndʒ/; [n]范围;幅度;排;山脉;[vi](在...内)变动;平行,列为一行;延伸;漫游;射程达到;[vt]漫游;放牧;使并列;归类于;来回走动; [or]wrt;
rapid: [a]/ˈræpɪd/; [adj]迅速的,急促的;飞快的;险峻的;[n]急流;高速交通工具,高速交通网; [add]比较级/rapider,最高级/rapidest; [or]wrt;
rapidly: [a]/ˈræpɪdli/; [adv]迅速地;很快地;立即; [or]wrt;
rate: [a]/reɪt/; [n]比率,率;速度;价格;等级;[vt]认为;估价;责骂;[vi]责骂;被评价;[n](Rate)人名;(法,塞)拉特; [add]pt/rated,pp/rated,pr/rating,pl/rates,s3/rates; [or]wrt;
rather: [a]/ˈrɑːðə(r)/; [adv]宁可,宁愿;相当;准确地说;或多或少地;[conj]而不是; int. 当然啦(回答问题时用);[n](Rather)人名;(英)拉瑟; [or]wrt;
rating: [a]/ˈreɪtɪŋ/; [n]等级;等级评定;额定功率;[v]对.评价(rate的ing形式);[n](Rating)人名;(德)拉廷; [add]pl/ratings; [or]wrt;
ratio: [a]/ˈreɪʃiəʊ/; [n]比率,比例; [add]pl/ratios; [or]wrt;
rational: [a]/ˈræʃnəl/; [adj]合理的;理性的;[n]有理数; [add]比较级/morerational,最高级/mostrational,pl/rationals; [or]wrt;
rationale: [a]/ˌræʃəˈnɑːl/; [n]基本原理;原理的阐述; [add]pl/rationales; [or]wrt;
rationality: [a]/ˌræʃəˈnæləti/; [n]合理性;合理的行动; [add]pl/rationalities; [or]wrt;
reaction: [a]/riˈækʃn/; [n]反应,感应;反动,复古;反作用; [add]pl/reactions; [or]wrt;
readily: [a]/ˈredɪli/; [adv]容易地;乐意地;无困难地; [add]比较级/morereadily,最高级/mostreadily; [or]wrt;
reality: [a]/riˈæləti/; [n]现实;实际;真实; [add]pl/realities; [or]wrt;
reason: [a]/ˈriːzn/; [n]理由;理性;动机;[vi]推论;劝说;[vt]说服;推论;辩论;[n](Reason)人名;(英)里森; [add]pl/reasons,pt/reasoned,pp/reasoned,pr/reasoning,s3/reasons; [or]wrt;
reasonable: [a]/ˈriːznəbl/; [adj]合理的,公道的;通情达理的; [add]比较级/morereasonable,最高级/mostreasonable; [or]wrt;
reasoning: [a]/ˈriːzənɪŋ/; [n]推理;论证;评理;[adj]推理的;[v]推论;说服(reason的ing形式); [or]wrt;
recent: [a]/ˈriːsnt/; [adj]最近的;近代的; [or]wrt;
recently: [a]/ˈriːsntli/; [adv]最近;新近; [or]wrt;
recognition: [a]/ˌrekəɡˈnɪʃn/; [n]识别;承认,认出;重视;赞誉;公认; [add]pl/recognitions; [or]wrt;
recognize: [a]/ˈrekəɡnaɪz/; [vt]认出,识别;承认;接受,认可;赞赏;[vi]确认,承认;具结; [or]wrt;
recommend: [a]/ˌrekəˈmend/; [vt]推荐,介绍;劝告;使受欢迎;托付;[vi]推荐;建议; [add]pt/recommended,pp/recommended,pr/recommending,s3/recommends; [or]wrt;
reconstruct: [a]/ˌriːkənˈstrʌkt/; [vt]重建;改造;修复;重现; [add]pt/reconstructed,pp/reconstructed,pr/reconstructing,s3/reconstructs; [or]wrt;
reconstruction: [a]/ˌriːkənˈstrʌkʃn/; [n]再建,重建;改造;复兴; [add]pl/reconstructions; [or]wrt;
record: [a]/ˈrekɔːd/; [n]记录,记载;唱片;(过去的)经历,履历;纪录,最佳成绩;前科,犯罪记录;[v]记录,记载;录制;发表正式声明;(仪器)标明,显示;取得(成就);[adj]创纪录的;[n](Record) (美)勒科尔(人名); [add]pl/records,pt/recorded,pp/recorded,pr/recording,s3/records; [or]wrt;
recording: [a]/rɪˈkɔːdɪŋ/; [n]录音;唱片;[adj]记录的;记录用的;[v]录音;记录;录像(record的ing形式); [add]pl/recordings; [or]wrt;
recovery: [a]/rɪˈkʌvəri/; [n]恢复,复原;痊愈;重获; [add]pl/recoveries; [or]wrt;
reduce: [a]/rɪˈdjuːs/; [vt]减少;降低;使处于;把.分解;[vi]减少;缩小;归纳为; [add]pt/reduced,pp/reduced,pr/reducing,s3/reduces; [or]wrt;
reduction: [a]/rɪˈdʌkʃn/; [n]减少;下降;缩小;还原反应; [or]wrt;
refer: [a]/rɪˈfɜː(r)/; [vi]参考;涉及;提到;查阅;[vt]涉及;委托;归诸于;使.求助于; [add]pt/referred,pp/referred,pr/referring,s3/refers; [or]wrt;
reference: [a]/ˈrefrəns/; [n]参考,参照;涉及,提及;参考书目;介绍信;证明书;[vi]引用;[vt]引用; [add]pt/referenced,pp/referenced,pr/referencing,pl/references,s3/references; [or]wrt;
reflect: [a]/rɪˈflekt/; [vt]反映;反射,照出;表达;显示;反省;[vi]反射,映现;深思; [or]wrt;
reflection: [a]/rɪˈflekʃn/; [n]反射;沉思;映象; [add]pl/reflections; [or]wrt;
regard: [a]/rɪˈɡɑːd/; [n]注意;尊重;问候;凝视;[vt]注重,考虑;看待;尊敬;把.看作;与.有关;[vi]注意,注重;注视;[n](Regard)人名;(西,意)雷加德;(法)勒加尔; [add]pl/regards,pt/regarded,pp/regarded,pr/regarding,s3/regards; [or]wrt;
regardless: [a]/rɪˈɡɑːdləs/; [adj]不管的,不顾的;不注意的;[adv]不顾后果地;不加理会;不管怎样,无论如何; [or]wrt;
regime: [a]/reɪˈʒiːm/; [n]政权,政体;社会制度;管理体制; [add]pl/regimes; [or]wrt;
region: [a]/ˈriːdʒən/; [n]地区;范围;部位; [add]pl/regions; [or]wrt;
regional: [a]/ˈriːdʒənl/; [adj]地区的;局部的;整个地区的; [or]wrt;
regulation: [a]/ˌreɡjuˈleɪʃn/; [n]管理;规则;校准;[adj]规定的;平常的; [add]pl/regulations; [or]wrt;
reinforce: [a]/ˌriːɪnˈfɔːs/; [vt]加强,加固;强化;补充;[vi]求援;得到增援;给予更多的支持;[n]加强;加固物;加固材料; [add]pt/reinforced,pp/reinforced,pr/reinforcing,s3/reinforces; [or]wrt;
reject: [a]/rɪˈdʒekt/; [vt]拒绝;排斥;抵制;丢弃;[n]被弃之物或人;次品; [add]pl/rejects,pt/rejected,pp/rejected,pr/rejecting,s3/rejects; [or]wrt;
rejection: [a]/rɪˈdʒekʃn/; [n]抛弃;拒绝;被抛弃的东西;盖帽; [add]pl/rejections; [or]wrt;
relate: [a]/rɪˈleɪt/; [vt]叙述;使.有联系;[vi]涉及;认同;符合;与.有某种联系; [add]pt/related,pp/related,pr/relating,s3/relates; [or]wrt;
related: [a]/rɪˈleɪtɪd/; [adj]有关系的,有关联的;讲述的,叙述的;[v]叙述(relate过去式); [or]wrt;
relation: [a]/rɪˈleɪʃn/; [n]关系;叙述;故事;亲属关系; [add]pl/relations; [or]wrt;
relationship: [a]/rɪˈleɪʃnʃɪp/; [n]关系;关联; [add]pl/relationships; [or]wrt;
relative: [a]/ˈrelətɪv/; [adj]相对的;有关系的;成比例的;[n]亲戚;相关物;<语>关系词;亲缘植物; [add]pl/relatives; [or]wrt;
relatively: [a]/ˈrelətɪvli/; [adv]相当地;相对地,比较地; [or]wrt;
release: [a]/rɪˈliːs/; [v]释放;放开;发泄;免除;松开;使不紧张;公开;解禁;放弃(权利);[n]释放;发布;新发行的东西;排放;解脱;新闻稿;让予;宣泄;释放装置; [add]pt/released,pp/released,pr/releasing; [or]wrt;
relevance: [a]/ˈreləvəns/; [n]关联;适当;中肯; [or]wrt;
relevant: [a]/ˈreləvənt/; [adj]相关的;切题的;中肯的;有重大关系的;有意义的,目的明确的; [or]wrt;
reliability: [a]/rɪˌlaɪəˈbɪləti/; [n]可靠性; [add]pl/reliabilities; [or]wrt;
reliable: [a]/rɪˈlaɪəbl/; [adj]可靠的;可信赖的;[n]可靠的人; [add]比较级/morereliable,最高级/mostreliable; [or]wrt;
reliance: [a]/rɪˈlaɪəns/; [n]信赖;信心;受信赖的人或物; [add]pl/reliances; [or]wrt;
rely: [a]/rɪˈlaɪ/; [vi]依靠;信赖; [add]pt/relied,pp/relied,pr/relying,s3/relies; [or]wrt;
removal: [a]/rɪˈmuːvl/; [n]免职;移动;排除;搬迁; [add]pl/removals; [or]wrt;
remove: [a]/rɪˈmuːv/; [vt]移动,迁移;开除;调动;[vi]移动,迁移;搬家;[n]移动;距离;搬家; [add]pt/removed,pp/removed,pr/removing,s3/removes; [or]wrt;
replace: [a]/rɪˈpleɪs/; [vt]取代,代替;替换,更换;归还,偿还;把.放回原处; [add]pt/replaced,pp/replaced,pr/replacing,s3/replaces; [or]wrt;
replacement: [a]/rɪˈpleɪsmənt/; [n]更换;复位;代替者;补充兵员; [add]pl/replacements; [or]wrt;
report: [a]/rɪˈpɔːt/; [n]报告;报道;成绩单;[vt]报告;报导;使报到;[vi]报告;报到;写报导;[n](Report)人名;(匈)雷波特; [add]pl/reports,pt/reported,pp/reported,pr/reporting,s3/reports; [or]wrt;
reporting: [a]/rɪˈpɔːtɪŋ/; [n]报告;报导;[adj]报告的; [or]wrt;
represent: [a]/ˌreprɪˈzent/; [vt]代表;表现;描绘;回忆;再赠送;[vi]代表;提出异议; [add]pt/represented,pp/represented,pr/representing,s3/represents; [or]wrt;
representation: [a]/ˌreprɪzenˈteɪʃn/; [n]代表;表现;表示法;陈述; [or]wrt;
representative: [a]/ˌreprɪˈzentətɪv/; [adj]典型的,有代表性的;代议制的;表现的,体现的;与表象有关的;[n]代表;典型;众议员;销售代表; [add]比较级/morerepresentative,最高级/mostrepresentative; [or]wrt;
require: [a]/rɪˈkwaɪə(r)/; [vt]需要;要求;命令; [add]pt/required,pp/required,pr/requiring,s3/requires; [or]wrt;
requirement: [a]/rɪˈkwaɪəmənt/; [n]要求;必要条件;必需品; [add]pl/requirements; [or]wrt;
research: [a]/rɪ'sɜːtʃ; 'riːsɜːtʃ/; [n]研究;调查;[vi]研究;调查;[vt]研究;调查; < 过去式 researched 过去分词 researched 现在分词 researching ]; [or]wrt;
researcher: [a]/rɪˈsɜːtʃə(r); ˈriːsɜːtʃə(r)/; [n]研究员; [add]pl/researchers; [or]wrt;
resident: [a]/ˈrezɪdənt/; [n]居民;(旅店)房客;住院医生,(美国的)高级专科住院实习医生;(美)寄宿制学校学生;(英国派驻半独立国家的)特派代表;驻外特工;[adj]居住的;定居的,常驻的;(鸟,蝴蝶等)非迁徙性的;(计算机程序,文件在存储器中)常驻的;属于..的(幽默用法); [add]pl/residents; [or]wrt;
resistance: [a]/rɪˈzɪstəns/; [n]阻力;电阻;抵抗;反抗;抵抗力; [add]pl/resistances; [or]wrt;
resistant: [a]/rɪˈzɪstənt/; [adj]抵抗的,反抗的;顽固的;[n]抵抗者; [or]wrt;
resolution: [a]/ˌrezəˈluːʃn/; [n]<物>分辨率;决议;解决;决心; [add]pl/resolutions; [or]wrt;
resolve: [a]/rɪˈzɒlv/; [vt]决定;溶解;使.分解;决心要做.;[vi]解决;决心;分解;[n]坚决;决定要做的事; [add]pt/resolved,pp/resolved,pr/resolving,pl/resolves,s3/resolves; [or]wrt;
resource: [a]/rɪˈsɔːs; rɪˈzɔːs/; [n]资源,财力;办法;智谋;[vi]向...提供资金; [or]wrt;
respect: [a]/rɪˈspekt/; [n]尊敬,尊重;方面;敬意;[vt]尊敬,尊重;遵守; [add]pt/respected,pp/respected,pr/respecting,s3/respects; [or]wrt;
respectively: [a]/rɪˈspektɪvli/; [adv]分别地;各自地,独自地; [or]wrt;
respond: [a]/rɪˈspɒnd/; [vi]回答;作出反应;承担责任;[vt]以.回答;[n]应答;唱和; [add]pt/responded,pp/responded,pr/responding,s3/responds; [or]wrt;
response: [a]/rɪˈspɒns/; [n]响应;反应;回答; [add]pl/responses; [or]wrt;
responsibility: [a]/rɪˌspɒnsəˈbɪləti/; [n]责任,职责;义务; [add]pl/responsibilities; [or]wrt;
responsible: [a]/rɪˈspɒnsəbl/; [adj]负责的,可靠的;有责任的; [add]比较级/moreresponsible,最高级/mostresponsible; [or]wrt;
restrict: [a]/rɪˈstrɪkt/; [vt]限制;约束;限定; [add]pt/restricted,pp/restricted,pr/restricting,s3/restricts; [or]wrt;
restriction: [a]/rɪˈstrɪkʃn/; [n]限制;约束;束缚; [add]pl/restrictions; [or]wrt;
restrictive: [a]/rɪˈstrɪktɪv/; [adj]限制的;限制性的;约束的;[n]限制词; [or]wrt;
result: [a]/rɪˈzʌlt/; [n]结果;成绩;答案;比赛结果;[vi]结果;导致;产生; [add]pl/results,pt/resulted,pp/resulted,pr/resulting,s3/results; [or]wrt;
reveal: [a]/rɪˈviːl/; [vt]显示;透露;揭露;泄露;[n]揭露;暴露;门侧,窗侧; [add]pt/revealed,pp/revealed,pr/revealing,s3/reveals; [or]wrt;
review: [a]/rɪˈvjuː/; [n]回顾;复习;评论;检讨;检阅;[vt]回顾;检查;复审;[vi]回顾;复习功课;写评论; [add]pl/reviews,pt/reviewed,pp/reviewed,pr/reviewing,s3/reviews; [or]wrt;
right: [a]/raɪt/; [adj]正确的;直接的;右方的;[vi]复正;恢复平稳;[n]正确;右边;正义;权利;[adv]正确地;恰当地;彻底地;[vt]纠正;[n](Right)人名;(英)赖特; [or]wrt;
rise: [a]/raɪz/; [v]攀升;起床;升起;休会;(数量)增加;变得更成功;(声响)提高;(风)刮起来;(情感)增强;(毛发)竖起;(土地)凸起;起源;发酵;[n](数量或水平的)增加;加薪;(权利等)增强;上升;小丘;(诱饵)游上水面;源头;(楼梯的)级高;晋升;出现; [add]pt/rose,pp/risen,pr/rising,s3/rises; [or]wrt;
risk: [a]/rɪsk/; [n]风险;危险;冒险;[vt]冒.的危险;[n](Risk)人名;(英,阿拉伯)里斯克; [add]pl/risks,pt/risked,pp/risked,pr/risking,s3/risks; [or]wrt;
role: [a]/rəʊl/; [n]角色;任务;[n](Role)人名;(意,塞,赤几)罗莱; [add]pl/roles; [or]wrt;
root: [a]/ruːt/; [n]根;根源;词根;祖先;[vi]生根;根除;[vt]生根,固定;根源在于;[n](Root)人名;(英)鲁特;(德,瑞典)罗特; [add]pl/roots,pt/rooted,pp/rooted,pr/rooting,s3/roots; [or]wrt;
rule: [a]/ruːl/; [n]规则;建议;统治;习惯;定律;法治;尺子;破折号;[v]统治,管理;支配;规定;裁决;用尺画;(非正式)极好;(行星)对..有影响;(价格)普遍处于某一水平;[n](Rule) (西)鲁莱(人名); [add]pt/ruled,pp/ruled,pr/ruling,pl/rules,s3/rules; [or]wrt;
rural: [a]/ˈrʊərəl/; [adj]农村的,乡下的;田园的,有乡村风味的; [add]比较级/morerural,最高级/mostrural; [or]wrt;
safety: [a]/ˈseɪfti/; [n]安全;保险;安全设备;保险装置;安打; [add]pl/safeties; [or]wrt;
sample: [a]/ˈsɑːmpl/; [n]样品,样本;(化验的)抽样;(用于新乐曲中的)节录乐曲;确定(模拟信号)瞬时值;[v]品尝,体验;抽样检验;节录(某一曲子,用于新乐曲中);[adj]样品的,作为例子的;[n](Sample) (美,英,爱尔兰)桑普尔(人名); [add]pt/sampled,pp/sampled,pr/sampling,pl/samples,s3/samples; [or]wrt;
sampling: [a]/ˈsɑːmplɪŋ/; [n]取样;抽样;[v]取样;抽样(sample的ing形式); [or]wrt;
satisfaction: [a]/ˌsætɪsˈfækʃn/; [n]满意,满足;赔偿;乐事;赎罪; [or]wrt;
satisfy: [a]/ˈsætɪsfaɪ/; [vi]令人满意;令人满足;[vt]满足;说服,使相信;使满意,使高兴; [add]pt/satisfied,pp/satisfied,pr/satisfying,s3/satisfies; [or]wrt;
scale: [a]/skeɪl/; [n]规模;比例;鳞;刻度;天平;数值范围;[vi]衡量;攀登;剥落;生水垢;[vt]测量;攀登;刮鳞;依比例决定;[n](Scale)人名;(意)斯卡莱; [add]pt/scaled,pp/scaled,pr/scaling,pl/scales,s3/scales; [or]wrt;
scenario: [a]/səˈnɑːriəʊ/; [n]方案;情节;剧本;设想; [or]wrt;
scheme: [a]/skiːm/; [n]计划;组合;体制;诡计;[vi]搞阴谋;拟订计划;[vt]计划;策划;[n](Scheme)人名;(瑞典)谢默; [add]pt/schemed,pp/schemed,pr/scheming,pl/schemes,s3/schemes; [or]wrt;
science: [a]/ˈsaɪəns/; [n]科学;技术;学科;理科;[n](Science)人名;(英)赛恩斯; [add]pl/sciences; [or]wrt;
scientific: [a]/ˌsaɪənˈtɪfɪk/; [adj]科学的,系统的; [add]比较级/morescientific,最高级/mostscientific; [or]wrt;
scope: [a]/skəʊp/; [n]范围;余地;视野;眼界;导弹射程;[vt]审视; [add]pt/scoped,pp/scoped,pr/scoping,pl/scopes,s3/scopes; [or]wrt;
second: [a]/'sek(ə)nd/;  num. 第二;(规模,质量等)居第二位的;另外的;[adj]第二(个)的;(比赛,级别上)居第二位的;另外的;次要的;[n]秒;瞬间;第二名;二等品;[v]支持,附议;临时调派(工作人员等);[adv]居第二位;第二,其次;[n](Second) (美)塞孔(人名); [add]pl/seconds,pt/seconded,pp/seconded,pr/seconding,s3/seconds; [or]wrt;
secondary: [a]/ˈsekəndri/; [adj]第二的;中等的;次要的;中级的;[n]副手;代理人; [add]pl/secondaries; [or]wrt;
secondly: [a]/ˈsekəndli/; [adv]其次;第二; [or]wrt;
section: [a]/ˈsekʃn/; [n]截面;部分;部门;地区;章节;[vi]被切割成片;被分成部分;[vt]把.分段;将.切片;对.进行划分; [or]wrt;
sector: [a]/ˈsektə(r)/; [n]部门;扇形,扇区;象限仪;函数尺;[vt]把.分成扇形; [add]pl/sectors; [or]wrt;
security: [a]/sɪˈkjʊərəti/; [n]安全,安全性;保证;证券;抵押品;[adj]安全的;保安的;保密的; [or]wrt;
seek: [a]/siːk/; [vt]寻求;寻找;探索;搜索;[vi]寻找;探索;搜索; [add]pt/sought,pp/sought,pr/seeking,s3/seeks; [or]wrt;
segment: [a]/ˈseɡmənt/; [n]段,部分;(水果或花的)瓣,(动物的)节;弓形;音段;(广播或节目的)时间段;[v]分割;(细胞)分裂; [add]pl/segments,pt/segmented,pr/segmenting,s3/segments; [or]wrt;
select: [a]/sɪˈlekt/; [v]选择;(在计算机屏幕上)选定;(从菜单中)选取;[adj]精选的;(地点)仅供精英阶层专用的;有辨别能力的;[n]被挑选者;[n](Select) (美,印)塞阿克特(人名); [add]pt/selected,pp/selected,pr/selecting,s3/selects; [or]wrt;
selection: [a]/sɪˈlekʃn/; [n]选择,挑选;选集;精选品; [add]pl/selections; [or]wrt;
selective: [a]/sɪˈlektɪv/; [adj]选择性的; 讲究的; 有选择地; 有选择性地; 仔细挑选地; [or]wrt;
sense: [a]/sens/; [n]感觉,功能;观念;道理;理智;[vt]感觉到;检测;[n](Sense) (美)森斯(人名); [or]wrt;
sensitive: [a]/ˈsensətɪv/; [adj]敏感的;感觉的;<仪>灵敏的;感光的;易受伤害的;易受影响的;[n]敏感的人;有灵异能力的人; [or]wrt;
sensory: [a]/ˈsensəri/; [adj]感觉的;知觉的;传递感觉的; [or]wrt;
separate: [a]/ˈseprət/; [adj]分开的;单独的;不同的;各自的;不受影响的;[v](使)分离,分开;隔开;分手;(使)分居;(使)区别(于);[n]可搭配穿着的单件衣服;抽印本;独立音响设备;土壤划分; [add]pt/separated,pp/separated,pr/separating,s3/separates; [or]wrt;
separately: [a]/ˈseprətli/; [adv]分别地;分离地;个别地; [or]wrt;
separation: [a]/ˌsepəˈreɪʃn/; [n]分离,分开;间隔,距离;<法>分居;缺口; [add]pl/separations; [or]wrt;
sequence: [a]/ˈsiːkwəns/; [n]<数]<计>序列;顺序;续发事件;[vt]按顺序排好; [add]pt/sequenced,pp/sequenced,pr/sequencing,pl/sequences,s3/sequences; [or]wrt;
series: [a]/ˈsɪəriːz/; [n]系列,连续;<电>串联;级数;丛书; [add]pl/series; [or]wrt;
service: [a]/ˈsɜːvɪs/; [n]服务,服侍;服役;仪式;[adj]服务性的;耐用的;服现役的;[vt]维修,检修;保养;[n](Service)人名;(英)瑟维斯; [add]pt/serviced,pp/serviced,pr/servicing,pl/services,s3/services; [or]wrt;
set: [a]/set/; [v]放,置,使处于;使开始;(故事,电影等)以......为背景;树立,创立,确立;设置,安排;摆放餐具;镶嵌;布置,分配,指派;凝固,凝结;使现出坚定的表情;固定发型;把(断骨)复位;排版;为..谱曲;(日,月)落沉;结果;点燃;[n](物品的)一套,一组,一副;一伙(或一帮)人,团伙,阶层;电视机,收音机;布置,场景,舞台;(网球,排球比赛等的)盘,局;(数学中的)集,集合;一组歌曲(乐曲);(能力相当的)一批学生;(尤指坚定的)姿势,神情;做头发;凝固,凝结;兽穴;(供移植的)秧苗,插枝;装置;[adj]安排好的,固定的;位于......的;以..为背景的;顽固的,固执的;套(餐);有可能的;做好准备的;呆板的,不自然的;[n](Set) (瑞,以)塞特(人名); [or]wrt;
sex: [a]/seks/; [n]性;性别;性行为;色情;[vt]引起.的性欲;区别.的性别; [add]pl/sexes; [or]wrt;
sexual: [a]/ˈsekʃuəl/; [adj]性的;性别的;有性的; [or]wrt;
sexuality: [a]/ˌsekʃuˈæləti/; [n]<胚>性别;性欲;性征;性方面的事情(比如性行为或性能力); [or]wrt;
shape: [a]/ʃeɪp/; [n]形状;模型;身材;具体化;[vt]形成;塑造,使成形;使符合;[vi]形成;成形;成长;[n](Shape)人名;(瑞典)沙佩; [add]pt/shaped,pp/shaped,pr/shaping,pl/shapes,s3/shapes; [or]wrt;
share: [a]/ʃeə(r)/; [v]分享,共用;分配;有同样的感情(或经历);分担;[n]份,份额;股份;责任,贡献;[n](Share) (美)沙雷(人名); [add]pt/shared,pp/shared,pr/sharing,pl/shares,s3/shares; [or]wrt;
shift: [a]/ʃɪft/; [v]转移;快速移动;变换;改变观点;推卸(责任);振作;移位;狼吞虎咽地吃;去除(污迹);销售,出售;换挡;轮班;含糊其辞,拐弯抹角;[n]转移;改变,转变;手段;轮班;轮班职工;转换(键);(直筒式)连衣裙,内衣;计谋,诡计; [add]pl/shifts,pt/shifted,pp/shifted,pr/shifting,s3/shifts; [or]wrt;
should: [a]/ʃəd; ʃʊd/;  aux. 应该;就;可能;将要;本当;竟然; [or]wrt;
show: [a]/ʃəʊ/; [vt]显示;说明;演出;展出;[vi]显示;说明;指示;[n]显示;表演;炫耀;[n](Show) (美,巴西)肖(人名); [or]wrt;
significance: [a]/sɪɡˈnɪfɪkəns/; [n]意义;重要性;意思; [add]pl/significances; [or]wrt;
significant: [a]/sɪɡˈnɪfɪkənt/; [adj]重大的;有效的;有意义的;值得注意的;意味深长的;[n]象征;有意义的事物; [add]比较级/moresignificant,最高级/mostsignificant; [or]wrt;
significantly: [a]/sɪɡˈnɪfɪkəntli/; [adv]显著地;相当数量地; [or]wrt;
similar: [a]/ˈsɪmələ(r)/; [adj]相似的;[n]类似物; [add]比较级/moresimilar,最高级/mostsimilar,pl/similars; [or]wrt;
similarity: [a]/ˌsɪməˈlærəti/; [n]类似;相似点; [add]pl/similarities; [or]wrt;
similarly: [a]/ˈsɪmələli/; [adv]类似地,差不多地;同样地,也; [or]wrt;
simple: [a]/ˈsɪmpl/; [adj]简单的;单纯的;天真的;[n]笨蛋;愚蠢的行为;出身低微者;[n](Simple)人名;(法)桑普勒; [add]比较级/simpler,最高级/simplest; [or]wrt;
simplify: [a]/ˈsɪmplɪfaɪ/; [vt]简化;使单纯;使简易; [add]pt/simplified,pp/simplified,pr/simplifying,s3/simplifies; [or]wrt;
simply: [a]/ˈsɪmpli/; [adv]简单地;仅仅;简直;朴素地;坦白地; [or]wrt;
simultaneous: [a]/ˌsɪmlˈteɪniəs/; [adj]同时的;联立的;同时发生的;[n]同时译员; [add]pl/simultaneouses; [or]wrt;
simultaneously: [a]/ˌsɪmlˈteɪniəsli/; [adv]同时地; [or]wrt;
single: [a]/ˈsɪŋɡl/; [adj]单一的;单身的;单程的;[n]一个;单打;单程票;[vt]选出;[vi]击出一垒安打; [add]pt/singled,pp/singled,pr/singling,pl/singles,s3/singles; [or]wrt;
site: [a]/saɪt/; [n]地点;位置;场所;[vt]设置;为.选址; [add]pt/sited,pp/sited,pr/siting,pl/sites,s3/sites; [or]wrt;
situation: [a]/ˌsɪtʃuˈeɪʃn/; [n]情况;形势;处境;位置; [or]wrt;
size: [a]/saɪz/; [n]大小;尺寸;[adj]一定尺寸的;[vt]依大小排列;[vi]可比拟; [add]pt/sized,pp/sized,pr/sizing,pl/sizes,s3/sizes; [or]wrt;
skill: [a]/skɪl/; [n]技能,技巧;本领,技术;[n](Skill)人名;(瑞典)希尔; [add]pl/skills; [or]wrt;
social: [a]/ˈsəʊʃl/; [adj]社会的,社交的;群居的;[n]联谊会;联欢会; [add]pl/socials; [or]wrt;
socially: [a]/ˈsəʊʃəli/; [adv]在社会上;在社交方面;善于交际地; [or]wrt;
societal: [a]/səˈsaɪətl/; [adj]社会的; [or]wrt;
society: [a]/səˈsaɪəti/; [n]社会;交往;社团;社交界; [add]pl/societies; [or]wrt;
software: [a]/ˈsɒftweə(r)/; [n]软件; [or]wrt;
solution: [a]/səˈluːʃn/; [n]解决方案;溶液;溶解;解答; [add]pl/solutions; [or]wrt;
solve: [a]/sɒlv/; [vt]解决;解答;溶解;[vi]作解答; [add]pt/solved,pp/solved,pr/solving,s3/solves; [or]wrt;
source: [a]/sɔːs/; [n]来源;水源;原始资料;[n](Source)人名;(法)苏尔斯; [add]pl/sources,pt/sourced,pp/sourced,pr/sourcing,s3/sources; [or]wrt;
space: [a]/speɪs/; [n]空间;太空;距离;[vi]留间隔;[vt]隔开; [add]pt/spaced,pp/spaced,pr/spacing,pl/spaces,s3/spaces; [or]wrt;
spatial: [a]/ˈspeɪʃl/; [adj]空间的;存在于空间的;受空间条件限制的; [or]wrt;
specialist: [a]/ˈspeʃəlɪst/; [n]专家;专门医师;[adj]专家的;专业的; [add]pl/specialists; [or]wrt;
specialized: [a]/ˈspeʃəlaɪzd/; [adj]专业的;专门的;[v]专攻(specialize的过去分词);使.专门化;详细说明; [or]wrt;
specific: [a]/spəˈsɪfɪk/; [adj]特殊的,特定的;明确的;详细的;<药>具有特效的;[n]特性;细节;特效药; [add]比较级/morespecific,最高级/mostspecific,pl/specifics; [or]wrt;
specifically: [a]/spəˈsɪfɪkli/; [adv]特别地;明确地; [or]wrt;
specification: [a]/ˌspesɪfɪˈkeɪʃn/; [n]规格;说明书;详述; [add]pl/specifications; [or]wrt;
specify: [a]/ˈspesɪfaɪ/; [vt]指定;详细说明;列举;把.列入说明书; [add]pt/specified,pp/specified,pr/specifying,s3/specifies; [or]wrt;
sphere: [a]/sfɪə(r)/; [n]范围;球体;[vt]包围;放入球内;使.成球形;[adj]球体的; [add]pt/sphered,pp/sphered,pr/sphering,pl/spheres,s3/spheres; [or]wrt;
stability: [a]/stəˈbɪləti/; [n]稳定性;坚定,恒心; [add]pl/stabilities; [or]wrt;
stabilize: [a]/ˈsteɪbəlaɪz/; [vt]使稳固,使安定;[vi]稳定,安定; [add]pt/stabilized,pp/stabilized,pr/stabilizing,s3/stabilizes; [or]wrt;
stable: [a]/ˈsteɪbl/; [adj]稳定的,牢固的;稳重的,沉稳的;持久的;(化学术语)稳定的;[n]马厩;养马场;(属同一马主或驯马师的)一群赛马;(同一地方工作的)一批人,(同一公司生产的)系列产品;(提供相同训练的)组织,机构;[v]赶入马房,把(马)拴在马厩;(被)关在马厩;[n](Stable) (美,英,法)斯特布尔(人名); [add]pt/stabled,pp/stabled,pr/stabling,pl/stables,s3/stables; [or]wrt;
stage: [a]/steɪdʒ/; [n]阶段;舞台;戏剧;驿站;[vt]举行;上演;筹划;[vi]举行;适于上演;乘驿车旅行;[n](Stage)人名;(英)斯特奇; [add]pt/staged,pp/staged,pr/staging,pl/stages,s3/stages; [or]wrt;
standard: [a]/ˈstændəd/; [n]标准;水准;旗;度量衡标准;[adj]标准的;合规格的;公认为优秀的;[n](Standard)人名;(英)斯坦达德;(德)施坦达德; [add]pl/standards; [or]wrt;
state: [a]/steɪt/; [n]国家;州;情形;[vt]规定;声明;陈述;[adj]国家的;州的;正式的;[n](State)人名;(罗,瑞典)斯塔特;(英)斯泰特; [add]pt/stated,pp/stated,pr/stating,pl/states,s3/states; [or]wrt;
statement: [a]/ˈsteɪtmənt/; [n]声明;陈述,叙述;报表,清单; [add]pl/statements,pt/statemented,pp/statemented,pr/statementing,s3/statements; [or]wrt;
statistic: [a]/stəˈtɪstɪk/; [n]统计资料;统计学;(一项)统计数据;统计量;[adj]统计的,统计学的; [add]pl/statistics; [or]wrt;
statistical: [a]/stəˈtɪstɪkl/; [adj]统计的;统计学的; [or]wrt;
status: [a]/ˈsteɪtəs/; [n]地位;状态;情形;重要身份; [or]wrt;
stimulate: [a]/ˈstɪmjuleɪt/; [vt]刺激;鼓舞,激励;[vi]起刺激作用;起促进作用; [add]pt/stimulated,pp/stimulated,pr/stimulating,s3/stimulates; [or]wrt;
stimulation: [a]/ˌstɪmjuˈleɪʃn/; [n]刺激;激励,鼓舞; [or]wrt;
stock: [a]/stɒk/; [n]股份,股票;库存;血统;树干;家畜;[adj]存货的,常备的;平凡的;[vt]进货;备有;装把手于.;[vi]囤积;办货;出新芽;[n](Stock)人名;(德,匈,捷)施托克;(英,法,葡,瑞典)斯托克; [or]wrt;
store: [a]/stɔː(r)/; [n]商店;储备,贮藏;仓库;[vt]贮藏,储存;[n](Store)人名;(德)施托雷; [add]pt/stored,pp/stored,pr/storing,pl/stores,s3/stores; [or]wrt;
strategy: [a]/ˈstrætədʒi/; [n]战略,策略; [add]pl/strategies; [or]wrt;
strength: [a]/streŋθ/; [n]力量;力气;兵力;长处; [add]pl/strengths; [or]wrt;
strengthen: [a]/ˈstreŋθn/; [vt]加强;巩固;[vi]变强;变坚挺; [add]pt/strengthened,pp/strengthened,pr/strengthening,s3/strengthens; [or]wrt;
stress: [a]/stres/; [n]压力;强调;紧张;重要性;重读;[vt]强调;使紧张;加压力于;用重音读;[n](Stress)人名;(意)斯特雷斯; [add]pt/stressed,pp/stressed,pr/stressing,pl/stresses,s3/stresses; [or]wrt;
structural: [a]/ˈstrʌktʃərəl/; [adj]结构的;建筑的; [or]wrt;
structure: [a]/ˈstrʌktʃə(r)/; [n]结构;构造;建筑物;[vt]组织;构成;建造; [add]pt/structured,pp/structured,pr/structuring,pl/structures,s3/structures; [or]wrt;
study: [a]/ˈstʌdi/; [n]学习,研究;课题;书房;学问;[vt]学习;考虑;攻读;细察;[vi]研究;用功;[n](Study)人名;(英)斯塔迪; [add]pl/studies,pt/studied,pp/studied,pr/studying,s3/studies; [or]wrt;
subject: [a]/ˈsʌbdʒɪkt; ˈsʌbdʒekt/; [n]主题;起因;科目;主词;(绘画,摄影等的)题材;实验对象;主语;国民;主旋律;主体;中心实体;[adj]易遭受..的;有待于..的;受..支配的;受异族统治的;臣服的;[adv]在..的条件下;[v](使)臣服; [add]pl/subjects,pt/subjected,pp/subjected,pr/subjecting,s3/subjects; [or]wrt;
subjective: [a]/səbˈdʒektɪv/; [adj]主观的;个人的;自觉的; [or]wrt;
subsequent: [a]/ˈsʌbsɪkwənt/; [adj]随后的; [or]wrt;
substance: [a]/ˈsʌbstəns/; [n]物质;实质;资产;主旨; [add]pl/substances; [or]wrt;
substantial: [a]/səbˈstænʃl/; [adj]大量的;实质的;内容充实的;[n]本质;重要材料; [add]比较级/moresubstantial,最高级/mostsubstantial,pl/substantials; [or]wrt;
substantially: [a]/səbˈstænʃəli/; [adv]实质上;大体上;充分地; [or]wrt;
substantive: [a]/səbˈstæntɪv; ˈsʌbstəntɪv/; [adj]有实质的;大量的;真实的;独立存在的;[n]名词性实词;独立存在的实体; [add]pl/substantives; [or]wrt;
substitute: [a]/ˈsʌbstɪtjuːt/; [n]代用品;代替者;[vi]替代;[vt]代替; [add]pt/substituted,pp/substituted,pr/substituting,pl/substitutes,s3/substitutes; [or]wrt;
substitution: [a]/ˌsʌbstɪˈtjuːʃn/; [n]代替;<数>置换;代替物; [add]pl/substitutions; [or]wrt;
successful: [a]/səkˈsesfl/; [adj]成功的;一帆风顺的; [add]比较级/moresuccessful,最高级/mostsuccessful; [or]wrt;
successfully: [a]/səkˈsesfəli/; [adv]成功地;顺利地; [or]wrt;
such: [a]/sʌtʃ/; [adj]这样的,如此的;[n](Such)人名;(英)萨奇;(德)祖赫; [or]wrt;
sufficient: [a]/səˈfɪʃnt/; [adj]足够的;充分的; [or]wrt;
sufficiently: [a]/səˈfɪʃntli/; [adv]充分地;足够地; [or]wrt;
suggest: [a]/səˈdʒest/; [vt]提议,建议;启发;使人想起;显示;暗示; [or]wrt;
suitable: [a]/ˈsuːtəbl; ˈsjuːtəbl/; [adj]适当的;相配的; [add]比较级/moresuitable,最高级/mostsuitable; [or]wrt;
sum: [a]/sʌm/; [n]金额;总数;[vi]概括;[vt]总结;合计;[n](Sum)人名;(英)萨姆;(柬)孙;(俄,德,捷)苏姆;(越)森; [add]pt/summed,pp/summed,pr/summing; [or]wrt;
summarize: [a]/ˈsʌməraɪz/; [vt]总结;概述;[vi]作总结;作概括; [add]pt/summarized,pp/summarized,pr/summarizing,s3/summarizes; [or]wrt;
summary: [a]/ˈsʌməri/; [n]总结,概要;[adj]总结性的;简略的,扼要的;(司法程序)即决的;简易判罪的; [add]pl/summaries; [or]wrt;
supply: [a]/səˈplaɪ/; [n]供给,补给;供应品;[vt]供给,提供;补充;[vi]供给;替代; [add]pl/supplies,pt/supplied,pp/supplied,pr/supplying,s3/supplies; [or]wrt;
support: [a]/səˈpɔːt/; [v]支持;帮助;支撑;维持;证实;胜任;忍受;(尤指在财政方面)资助;(在流行音乐会上)当助演;安慰;(计算机)支持..的运行;[n]支持;帮助;支撑物;支撑;扶持;物质援助;安慰;(流行乐或摇滚音乐会的)伴奏;技术支持;证据;(战争中的)支援; [add]pt/supported,pp/supported,pr/supporting,s3/supports; [or]wrt;
survey: [a]/ˈsɜːveɪ/; [n]调查;测量;审视;纵览;[vt]调查;勘测;俯瞰;[vi]测量土地; [add]pl/surveys,pt/surveyed,pp/surveyed,pr/surveying,s3/surveys; [or]wrt;
survival: [a]/səˈvaɪvl/; [n]幸存,残存;幸存者,残存物; [add]pl/survivals; [or]wrt;
sustain: [a]/səˈsteɪn/; [vt]维持;支撑,承担;忍受;供养;证实; [add]pt/sustained,pp/sustained,pr/sustaining,s3/sustains; [or]wrt;
system: [a]/ˈsɪstəm/; [n]制度,体制;系统;方法; [add]pl/systems; [or]wrt;
systematic: [a]/ˌsɪstəˈmætɪk/; [adj]系统的;体系的;有系统的;<图情>分类的;一贯的,惯常的; [or]wrt;
systematically: [a]/ˌsɪstəˈmætɪkli/; [adv]有系统地;有组织地; [or]wrt;
target: [a]/ˈtɑːɡɪt/; [n]目标,指标;(攻击的)对象;靶子;[v]把...作为目标;面向,对准(某群体);[n](Target)美国塔吉特公司; [or]wrt;
task: [a]/tɑːsk/; [n](困难的)任务,工作;(语言教学中的)活动;[v]派给某人(任务);对(手段或能力)要求极高; [add]pl/tasks,pt/tasked,pp/tasked,pr/tasking,s3/tasks; [or]wrt;
technical: [a]/ˈteknɪkl/; [adj]工艺的,科技的;技术上的;专门的; [add]比较级/moretechnical,最高级/mosttechnical; [or]wrt;
technique: [a]/tekˈniːk/; [n]技巧,技术;手法; [add]pl/techniques; [or]wrt;
technological: [a]/ˌteknəˈlɒdʒɪkl/; [adj]技术的;工艺的; [or]wrt;
technology: [a]/tekˈnɒlədʒi/; [n]技术;工艺;术语; [add]pl/technologies; [or]wrt;
tend: [a]/tend/; [vi]趋向,倾向;照料,照顾;[vt]照料,照管; [add]pt/tended,pp/tended,pr/tending,s3/tends; [or]wrt;
tendency: [a]/ˈtendənsi/; [n]倾向,趋势;癖好; [add]pl/tendencies; [or]wrt;
tension: [a]/ˈtenʃn/; [n]张力,拉力;紧张,不安;电压;[vt]使紧张;使拉紧; [add]pl/tensions; [or]wrt;
term: [a]/tɜːm/; [n]术语;学期;期限;条款;(代数式等的)项;[vt]把.叫做;[n](Term)人名;(泰)丁; [or]wrt;
terminology: [a]/ˌtɜːmɪˈnɒlədʒi/; [n]术语,术语学;用辞; [add]pl/terminologies; [or]wrt;
terms: [a]/tɜːmz/; [n]地位,关系;<法>条款;术语;措辞;价钱(term的复数形式);[v]把.称为(term的三单形式); [or]wrt;
territory: [a]/ˈterətri/; [n]领土,领域;范围;地域;版图; [add]pl/territories; [or]wrt;
test: [a]/test/; [n]测验,考查;测试;检验;化验;[v]测验;化验,检查;试验,测试;考验; [or]wrt;
text: [a]/tekst/; [n]<计>文本;课文;主题;[vt]发短信; [add]pl/texts,pt/texted,pr/texting,s3/texts; [or]wrt;
theme: [a]/θiːm/; [n]主题;主旋律;题目;[adj]以奇想主题布置的; [add]pt/themed,pp/themed,pr/theming,pl/themes; [or]wrt;
theoretical: [a]/ˌθɪəˈretɪkl/; [adj]理论的;理论上的;假设的;推理的; [or]wrt;
theoretically: [a]/ˌθɪəˈretɪkli/; [adv]理论地;理论上; [or]wrt;
theory: [a]/ˈθɪəri/; [n]理论;原理;学说;推测; [add]pl/theories; [or]wrt;
thereby: [a]/ˌðeəˈbaɪ/; [adv]从而,因此;在那附近;在那方面; [or]wrt;
therefore: [a]/ˈðeəfɔː(r)/; [adv]因此;所以; [or]wrt;
threat: [a]/θret/; [n]威胁,恐吓;凶兆; [add]pl/threats; [or]wrt;
threshold: [a]/ˈθreʃhəʊld/; [n]入口;门槛;开始;极限;临界值; [or]wrt;
thus: [a]/ðʌs/; [adv]因此;从而;这样;如此; [or]wrt;
tool: [a]/tuːl/; [n]工具,用具;器械,机床;手段;[vi]使用工具;用机床装备工厂;[vt]用工具给..加工; [add]pl/tools,pt/tooled,pp/tooled,pr/tooling,s3/tools; [or]wrt;
topic: [a]/ˈtɒpɪk/; [n]主题(等于theme);题目;一般规则;总论; [add]pl/topics; [or]wrt;
total: [a]/ˈtəʊtl/; [adj]全部的;完全的;整个的;[vt]总数达;[vi]合计;[n]总数,合计;[n](Total)人名;(法,德)托塔尔; [add]pt/totaled或-talled,pp/totaled或-talled,pr/totaling或-talling,s3/totals; [or]wrt;
traditional: [a]/trəˈdɪʃənl/; [adj]传统的;惯例的; [add]比较级/moretraditional,最高级/mosttraditional; [or]wrt;
training: [a]/ˈtreɪnɪŋ/; [n]训练;培养;瞄准;整枝;[v]训练;教养(train的ing形式); [add]pl/trainings; [or]wrt;
transfer: [a]/trænsˈfɜː(r)/; [v]转让;转接;移交;转移(地方);(使)换乘;转存,转录;调动(工作);传染,传播;使(运动员)转队;把(钱)转到另一账户,机构上;[n](地点的)转移;(工作的)调动;已调动的人或东西;权力的移交;运动员转会;(公共汽车,飞机等的)转移;(财产的)转让;数据的拷贝;图画,图案;转车票; [add]pt/transferred,pp/transferred,pr/transferring,s3/transfers; [or]wrt;
transform: [a]/trænsˈfɔːm/; [vt]改变,使.变形;转换;[vi]变换,改变;转化; [add]pt/transformed,pp/transformed,pr/transforming,s3/transforms; [or]wrt;
transformation: [a]/ˌtrænsfəˈmeɪʃn/; [n]<遗>转化;转换;改革;变形; [add]pl/transformations; [or]wrt;
transition: [a]/trænˈzɪʃn; trænˈsɪʃn/; [n]过渡;转变;<分子生物>转换;变调; [add]pl/transitions,pt/transitioned,pr/transitioning,s3/transitions; [or]wrt;
transmission: [a]/trænzˈmɪʃn; trænsˈmɪʃn/; [n]传动装置,<机>变速器;传递;传送;播送; [add]pl/transmissions; [or]wrt;
transmit: [a]/trænzˈmɪt; trænsˈmɪt/; [vt]传输;传播;发射;传达;遗传;[vi]传输;发射信号; [add]pt/transmitted,pp/transmitted,pr/transmitting,s3/transmits; [or]wrt;
transport: [a]/ˈtrænspɔːt/; [n]运输;运输机;狂喜;流放犯;[vt]运输;流放;使狂喜; [add]pl/transports,pt/transported,pp/transported,pr/transporting,s3/transports; [or]wrt;
transportation: [a]/ˌtrænspɔːˈteɪʃn/; [n]运输;运输系统;运输工具;流放; [or]wrt;
treat: [a]/triːt/; [vt]治疗;对待;探讨;视为;[vi]探讨;请客;协商;[n]请客;款待;[n](Treat)人名;(英)特里特; [add]pl/treats,pt/treated,pp/treated,pr/treating,s3/treats; [or]wrt;
treatment: [a]/ˈtriːtmənt/; [n]治疗,疗法;处理;对待; [add]pl/treatments; [or]wrt;
trend: [a]/trend/; [n]趋势,倾向;走向;[vi]趋向,伸向;[vt]使.趋向;[n](Trend)人名;(英)特伦德; [add]pl/trends,pt/trended,pp/trended,pr/trending,s3/trends; [or]wrt;
type: [a]/taɪp/; [n]类型,品种;模范;样式;[vt]打字;测定(血等)类型;[vi]打字;[n](Type)人名;(英)泰普; [add]pt/typed,pp/typed,pr/typing,pl/types,s3/types; [or]wrt;
typical: [a]/ˈtɪpɪkl/; [adj]典型的;特有的;象征性的; [add]比较级/moretypical,最高级/mosttypical; [or]wrt;
typically: [a]/ˈtɪpɪkli/; [adv]代表性地;作为特色地; [or]wrt;
ultimate: [a]/ˈʌltɪmət/; [adj]最终的;极限的;根本的;[n]终极;根本;基本原则; [add]pl/ultimates; [or]wrt;
ultimately: [a]/ˈʌltɪmətli/; [adv]最后;根本;基本上; [or]wrt;
uncertainty: [a]/ʌnˈsɜːtnti/; [n]犹豫;不确定的事物;不确定度; [add]pl/uncertainties; [or]wrt;
unclear: [a]/ˌʌnˈklɪə(r)/; [adj]不清楚的;不易了解的; [or]wrt;
undergo: [a]/ˌʌndəˈɡəʊ/; [vt]经历,经受;忍受; [add]pt/underwent,pp/undergone,pr/undergoing,s3/undergoes; [or]wrt;
underlying: [a]/ˌʌndəˈlaɪɪŋ/; [adj]潜在的;根本的;在下面的;优先的;[v]放在.的下面;为.的基础;优先于(underlie的ing形式); [or]wrt;
understanding: [a]/ˌʌndəˈstændɪŋ/; [n]谅解,理解;理解力;协议;[adj]了解的;聪明的;有理解力的;[v]理解;明白(understand的ing形式); [add]pl/understandings; [or]wrt;
undertake: [a]/ˌʌndəˈteɪk/; [vt]承担,保证;从事;同意;试图; [add]pt/undertook,pp/undertaken,pr/undertaking,s3/undertakes; [or]wrt;
undertaking: [a]/ˌʌndəˈteɪkɪŋ/; [n]事业;企业;保证;殡仪业;[v]同意;担任;许诺(undertake的ing形式); [add]pl/undertakings; [or]wrt;
unique: [a]/juˈniːk/; [adj]独特的,稀罕的;<数>唯一的,独一无二的;[n]独一无二的人或物;[n](Unique)人名;(英)尤妮克; [or]wrt;
unit: [a]/ˈjuːnɪt/; [n]单位,单元;装置;<军>部队;部件; [add]pl/units; [or]wrt;
universal: [a]/ˌjuːnɪˈvɜːsl/; [adj]普遍的;通用的;宇宙的;全世界的;全体的;[n]一般概念;普通性; [add]pl/universals; [or]wrt;
unlikely: [a]/ʌnˈlaɪkli/; [adj]不太可能的;没希望的;[adv]未必; [add]比较级/unlikelier或moreunlikely,最高级/unlikeliest或mostunlikely; [or]wrt;
unrelated: [a]/ˌʌnrɪˈleɪtɪd/; [adj]无关的,不相干的; [or]wrt;
unstable: [a]/ʌnˈsteɪbl/; [adj]不稳定的;动荡的;易变的; [or]wrt;
upper: [a]/ˈʌpə(r)/; [adj]上面的,上部的;较高的;[n](Upper)人名;(英)厄珀; [add]pl/uppers; [or]wrt;
urban: [a]/ˈɜːbən/; [adj]城市的;住在都市的;[n](Urban)人名;(西)乌尔万;(斯洛伐)乌尔班;(德,俄,罗,匈,塞,波,捷,瑞典,意)乌尔班;(英)厄本;(法)于尔邦; [or]wrt;
usage: [a]/ˈjuːsɪdʒ; ˈjuːzɪdʒ/; [n]使用;用法;惯例; [add]pl/usages; [or]wrt;
use: [a]/juːz/; [n]使用;用途;发挥;[vt]利用;耗费;[vi]使用,运用;[n](Use)人名;(德)乌泽; [add]pt/used,pp/used,pr/using,pl/uses,s3/uses; [or]wrt;
useful: [a]/ˈjuːsfl/; [adj]有用的,有益的;有帮助的; [add]比较级/moreuseful,最高级/mostuseful; [or]wrt;
utility: [a]/juːˈtɪləti/; [n]实用;效用;公共设施;功用;[adj]实用的;通用的;有多种用途的; [add]pl/utilities; [or]wrt;
utilization: [a]/ˌjuːtəlaɪˈzeɪʃn/; [n]利用,使用; [or]wrt;
utilize: [a]/ˈjuːtəlaɪz/; [vt]利用; [add]pt/utilized,pp/utilized,pr/utilizing,s3/utilizes; [or]wrt;
valid: [a]/ˈvælɪd/; [adj]有效的;有根据的;合法的;正当的; [or]wrt;
validate: [a]/ˈvælɪdeɪt/; [vt]证实,验证;确认;使生效; [add]pt/validated,pp/validated,pr/validating,s3/validates; [or]wrt;
validation: [a]/ˌvælɪˈdeɪʃn/; [n]确认;批准;生效; [add]pl/validations; [or]wrt;
validity: [a]/vəˈlɪdəti/; [n]<计>有效性;正确;正确性; [or]wrt;
valuable: [a]/ˈvæljuəbl/; [adj]有价值的;贵重的;可估价的;[n]贵重物品; [add]比较级/morevaluable,最高级/mostvaluable,pl/valuables; [or]wrt;
value: [a]/ˈvæljuː/; [n]值;价值;价格;重要性;确切涵义;[vt]评价;重视;估价; [add]pt/valued,pp/valued,pr/valuing,pl/values,s3/values; [or]wrt;
variable: [a]/ˈveəriəbl/; [adj]变量的;可变的;易变的,多变的;变异的,<生物>畸变的;[n]<数>变量;可变物,可变因素; [add]比较级/morevariable,最高级/mostvariable,pl/variables; [or]wrt;
variance: [a]/ˈveəriəns/; [n]变异;变化;不一致;分歧;<数>方差; [add]pl/variances; [or]wrt;
variation: [a]/ˌveəriˈeɪʃn/; [n]变化;<生物>变异,变种; [add]pl/variations; [or]wrt;
varied: [a]/ˈveərid/; [adj]各式各样的;多变的;杂色的;[v]变化,改变;使多样化(vary 的过去式和过去分词); [or]wrt;
variety: [a]/vəˈraɪəti/; [n]多样;种类;杂耍;变化,多样化; [add]pl/varieties; [or]wrt;
various: [a]/ˈveəriəs/; [adj]各种各样的;多方面的; [or]wrt;
vary: [a]/ˈveəri/; [vi]变化;变异;违反;[vt]改变;使多样化;变奏;[n](Vary)人名;(英,法,罗,柬)瓦里; [add]pt/varied,pp/varied,pr/varying,s3/varies; [or]wrt;
version: [a]/ˈvɜːʃn/; [n]版本;译文;倒转术; [add]pl/versions; [or]wrt;
versus: [a]/ˈvɜːsəs/; [prep]对,对抗;与..相对,与..相比; [or]wrt;
vertical: [a]/ˈvɜːtɪkl/; [adj]垂直的,直立的;<解剖>头顶的,顶点的;<植]纵长的,直上的;[n]垂直线,垂直面;垂直位置; [or]wrt;
via: [a]/ˈvaɪə; ˈviːə/; [prep]经由,通过;凭借,借助于; [or]wrt;
view: [a]/vjuː/; [n]观察;视野;意见;风景;[vt]观察;考虑;查看; [add]pl/views,pt/viewed,pp/viewed,pr/viewing,s3/views; [or]wrt;
viewer: [a]/ˈvjuːə(r)/; [n]观察者;观看者;观众;<仪>指示器; [or]wrt;
violence: [a]/ˈvaɪələns/; [n]暴力;侵犯;激烈;歪曲; [or]wrt;
visible: [a]/ˈvɪzəbl/; [adj]明显的;看得见的;现有的;可得到的;[n]可见物;进出口贸易中的有形项目; [add]比较级/morevisible,最高级/mostvisible; [or]wrt;
visual: [a]/ˈvɪʒuəl/; [adj]视觉的,视力的;栩栩如生的; [add]pl/visuals; [or]wrt;
volume: [a]/ˈvɒljuːm/; [n]量;体积;卷;音量;大量;册;[adj]大量的;[vi]成团卷起;[vt]把.收集成卷; [add]pl/volumes; [or]wrt;
voluntary: [a]/ˈvɒləntri/; [adj]自愿的;志愿的;自发的;故意的;[n]志愿者;自愿行动; [add]pl/voluntaries; [or]wrt;
wealth: [a]/welθ/; [n]财富;大量;富有; [or]wrt;
website: [a]/ˈwebsaɪt/; [n]网站(全球资讯网的主机站); [add]pl/websites; [or]wrt;
weight: [a]/weɪt/; [n]重量,重力;负担;砝码;重要性;[vt]加重量于,使变重;[n](Weight)人名;(英)韦特;(捷)魏格特; [add]pl/weights,pt/weighted,pr/weighting,s3/weights; [or]wrt;
welfare: [a]/ˈwelfeə(r)/; [n]福利;幸福;福利事业;安宁;[adj]福利的;接受社会救济的; [or]wrt;
whereas: [a]/ˌweərˈæz/; [conj]然而;鉴于;[n]序言,开场白;条件语句; [add]pl/whereases; [or]wrt;
whether: [a]/ˈweðə(r)/; [conj]是否;不论;[pron]两个中的哪一个; [or]wrt;
whole: [a]/həʊl/; [adj]完整的;纯粹的;[n]整体;全部; [add]pl/wholes; [or]wrt;
wide: [a]/waɪd/; [adj]广泛的;宽的,广阔的;张大的;远离目标的;[adv]广泛地;广阔地;充分地;[n]大千世界;[n](Wide)人名;(瑞典,芬)维德; [add]比较级/wider,最高级/widest; [or]wrt;
widely: [a]/ˈwaɪdli/; [adv]广泛地; [or]wrt;
widespread: [a]/ˈwaɪdspred/; [adj]普遍的,广泛的;分布广的; [add]比较级/morewidespread,最高级/mostwidespread; [or]wrt;
within: [a]/wɪˈðɪn/; [prep]在..之内;在..里面;[adv]在内部;在里面;[n]里面;内部; [or]wrt;
working: [a]/ˈwɜːkɪŋ/; [adj]有工作的;从事普通工作的;工作上的;可行的;初步的;基本够用的;能运转的;(机器部件)操作的;[n](机器,系统等的)运作;工作,干活;矿,作业区;班次;操纵;计算过程;[v]工作;影响;受雇于;使卖力干活;争取(work 的现在分词);[n](Working) (美)沃金(人名); [add]pl/workings,pt/worked,pp/worked,pr/working,s3/works; [or]wrt;
world: [a]/wɜːld/; [n]世界;领域;世俗;全人类;物质生活; [or]wrt;
yield: [a]/jiːld/; [v]出产(产品或作物);产出(效果,收益等);生息;屈服;放弃;停止争论;给(车辆)让路;(在外力,重压等下)屈曲;[n]产量;利润,红利率; [add]pl/yields,pt/yielded,pp/yielded,pr/yielding,s3/yields; [or]wrt;
