Aerosol: [a]/ˈeərəsɒl/; [n]<物化>气溶胶;气雾剂;喷雾器;浮质; [adj]喷雾的;喷雾器的; [add]pl/aerosols; [or]chem;
Factice: [a]/'fæktis/; [n]硫化油膏;<化工>油膏,油胶; [or]chem;
Indanthrene: [a]/in'dænθri:n/; [n]<染料>阴丹士林,靛蒽醌; [or]chem;
Leatherette: [a]/ˌleðəˈret/; [n]<皮革>人造革;假皮; [or]chem;
Vitaglass: [a]/'vaɪtə'glɑs/; [n]维他玻璃;<玻璃>透紫外线玻璃; [or]chem;
Xylonite: [a]/'zaɪlə,naɪt/; [n]赛璐珞,<塑料>假象牙;电影; [or]chem;
abatis: [a]/'æbətɪs/; [n]鹿砦;有刺铁丝网; [add]pl/abatis或abatises; [or]chem;
abelite: [a]/'eibə,lait/; [n]<化工>阿贝立特炸药; [or]chem;
abietate: [a]/'æbi:i,teit/; [n]松香酸盐; [or]chem;
absarokite: [a]/æb'særəkait/; [n]橄榄粒玄岩;正边玄武岩;阿布沙玄武岩; [or]chem;
absorbency: [a]/əbˈzɔːbənsi; əbˈsɔːbənsi/; [n]吸收能力;吸收性;吸墨性;<物化>吸光率; [or]chem;
abyssolith: [a]/ə'bisəliθ/; [n]深岩基;岩基; [or]chem;
acetal: [a]/'æsɪtæl/; [n]乙缩醛; [or]chem;
acetanilid: [a]/ˌæsɪˈtænɪlɪd/; 乙酰苯胺; 退热冰; [or]chem;
acetoacetanilide: [a]/,æsətəu'æsitənilaid/; [n]乙酰乙酰替苯胺; [or]chem;
acetoacetate: [a]/,æsətəu'æsiteit/; [n]乙酰乙酸盐; [or]chem;
acetylphenylhydrazine: [a]/,æsetil,fenil'haidrəzi:n/; [n]乙酰苯肼; [or]chem;
acetylsalicylate: [a]/ə,siːtɪlsə'lɪsɪleɪt/; 乙酰水杨酸盐; 乙酰水杨酸; [or]chem;
acidifier: [a]/ə'sɪdɪfaɪə/; [n]<助剂>酸化剂;成酸剂; [or]chem;
acidimetry: [a]/,æsə'dɪmətri/; [n]<分化>酸量滴定法; [or]chem;
acidometer: [a]/,æsi'dɔmitə/; [n]<分化>酸度计; [or]chem;
acidotic: [a]/,æsi'dɔtik/; [adj]酸中毒的;<分化>定酸量的; [or]chem;
acierate: [a]/'æsɪəreɪt/; [vt]化铁为钢; [add]pt/acierated,pp/acierated,pr/acierating; [or]chem;
ackey: [a]/'æki:/; [n]电镀用的硝酸硫酸混合液;西非黄金海岸用银元; [add]pl/ackeys; [or]chem;
acraldehyde: [a]/ə'krældə,haid/; [n]丙烯醛(等于acrolein); [or]chem;
acrobatholithic: [a]/,ækrə'bæθə,liθik/; [adj]露岩基的; [or]chem;
acrometer: [a]/ə'krɔmitə/; [n]<油气>油类比重计; [or]chem;
acryl: [a]/'ækril/; [n]丙烯醛基(俗称压克力); [or]chem;
acrylate: [a]/'ækrɪleɪt/; [n]丙烯酸盐,丙烯酸脂; [or]chem;
acrylic: [a]/əˈkrɪlɪk/; [adj]丙烯酸的; [add]pl/acrylics; [or]chem;
acrylyl: [a]/'ækrɪlɪl/; 丙烯酰; [or]chem;
activable: [a]/'æktivəbl/; [adj]<物化>能被活化的; [or]chem;
activator: [a]/'æktɪveɪtə/; [n]催化剂;<助剂>活化剂;<助剂>激活剂;触媒剂; [add]pl/activators; [or]chem;
activin: [a]/'æktəvɪn; æk'tɪvɪn/; [n]激活素;苯丙酸诺龙; [or]chem;
acyloxy: [a]/,æsi'lɔksi/; [adj]酸基的;酰氧基的; [n]酸基;酸氧基; [or]chem;
adamellite: [a]/,ædə'melait/; [n]石英二长岩,石英二长石; [or]chem;
adatom: [a]/æd'ætəm/; [n]吸附原子; [or]chem;
adelite: [a]/'ædəlait/; [n]砷钙镁石; [or]chem;
adelpholite: [a]/ə'delfəsait/; [n]铌铁锰矿; [or]chem;
adinole: [a]/'ædinəul/; [n]<岩>钠长英板岩; [or]chem;
adopter: [a]/əˈdɑːptər/; [n]养父母;<化工>接受管; [add]pl/adopters; [or]chem;
aerobus: [a]/'eərə,bʌs/; [n]由架空电缆悬挂的单轨铁路; [or]chem;
aerogel: [a]/'eərədʒel/; [n]<物化>气凝胶; [or]chem;
aerosol: [a]/ˈeərəsɒl/; [n]<物化>气溶胶;气雾剂;喷雾器;浮质; [adj]喷雾的;喷雾器的; [add]pl/aerosols; [or]chem;
agateware: [a]/'æɡətweə/; [n]玛瑙彩釉的搪瓷铁器;仿玛瑙斑纹之陶器; [or]chem;
agglomerant: [a]/ə'ɡlɔmərənt/; [n]<胶粘>粘结剂,<助剂>凝聚剂; [or]chem;
agglomerate: [a]/ə'glɒməreɪt/; [v]使成团,使结块;凝聚; [n]团块;凝聚物;(事物的)集合;(火山)集块岩; [adj]成团的,结块的;凝聚的,聚集的; [add]pt/agglomerated,pp/agglomerated,pr/agglomerating,s3/agglomerates; [or]chem;
agglomeratic: [a]/ə,ɡlɔmə'rætik/; [adj]集块岩状的; [or]chem;
agmatine: [a]/'æɡməti:n/; [n]胍基丁胺;胍丁胺; [or]chem;
ailsyte: [a]/'eilsait/; [n]<岩>钠闪微岗岩; [or]chem;
akenobeite: [a]/,ækə'nəubi,ait/; [n]<岩>明延岩; [or]chem;
akerite: [a]/'ækərait/; [n]<岩>英辉正长岩;尖晶石; [or]chem;
alaskite: [a]/ə'læskait/; [n]白(花)岗岩; [or]chem;
albitite: [a]/'ælbɪtaɪt/; 钠长石岩; <岩>钠长岩; [or]chem;
albitization: [a]/'ælbiti'zeiʃən/; [n]钠长石化;钠长石化作用; [or]chem;
albitophyre: [a]/æl'bitə,faiə/; [n]<岩>钠长斑岩; [or]chem;
alcogel: [a]/'ælkədʒel/; [n]<物化>醇凝胶; [or]chem;
aldehyde: [a]/'ældɪhaɪd/; [n]醛;乙醛; [or]chem;
aldehydic: [a]/,ældɪ'haɪdɪk/; 醛式的; [or]chem;
aldohexose: [a]/,ældəu'heksəus/; [n]己醛醣; [or]chem;
aldol: [a]/'ældɒl/; [n]丁间醇醛; [or]chem;
aldolization: [a]/,ældɔlai'zeiʃən, -li'z-/; [n]醇醛缩合;羟醛缩合; [or]chem;
alginate: [a]/'ældʒə,net/; [n]藻朊酸盐; [or]chem;
alicyclic: [a]/,ælɪ'saɪklɪk; -'sɪk-/; [adj]脂环的;脂环族的(等于cycloaliphatic); [n]脂环族; [or]chem;
alkalemia: [a]/,ælkə'li:miə/; [n]碱血症; [or]chem;
alkalescency: [a]/,ælkə'lesəns,-sənsi/; [n]微碱性; [or]chem;
alkalescent: [a]/,ælkə'lɛsənt/; [adj]碱性的;弱碱性的; [or]chem;
alkali: [a]/ˈælkəlaɪ/; [adj]碱性的; [add]pl/alkalies或alkalis;  [or]chem;
alkalic: [a]/æl'kælɪk/; [adj]碱性的; [or]chem;
alkalify: [a]/'ælkəlifai/; [v](使)成碱化; [add]pt/alkalified,pp/alkalified,pr/alkalifying; [or]chem;
alkalimeter: [a]/,ælkə'lɪmɪtə/; [n]碳酸定量计;碱量计; [or]chem;
alkalimetry: [a]/,ælkɜː'lɪmɪtrɪ/; [n]<分化>碱量滴定法;<分化>碱测定法; [or]chem;
alkaline: [a]/ˈælkəlaɪn/; [adj]碱性的;含碱的; [or]chem;
alkalinization: [a]/,ælkəlɪnɪ'zeʃən/; [n]碱化; [or]chem;
alkalinize: [a]/'ælkəlɪnaɪz/; [vi]碱化;成碱性; [vt]使碱化;使成碱性; [add]pt/alkalinized,pp/alkalinized,pr/alkalinizing; [or]chem;
alkalization: [a]/,ælkəli'zeʃən/; [n]碱性化; [or]chem;
alkalize: [a]/'ælkəlaɪz/; [vt]使成碱性;使碱化; [vi]碱化;成碱性; [add]pt/alkalized,pp/alkalized,pr/alkalizing,s3/alkalizes; [or]chem;
alkalosis: [a]/,ælkə'ləʊsɪs/; [n]碱中毒,碱毒症; [add]pl/alkaloses; [or]chem;
alkoxy: [a]/'ælkɔksi/; [adj]烷氧基的; [n]烷氧基; [or]chem;
alkyl: [a]/'ælkaɪl; -kɪl/; [adj]烷基的,烃基的; [n]烷基,烃基; [or]chem;
alkylate: [a]/'ælkɪleɪt/; [v]使烷基化; [or]chem;
alkylene: [a]/'ælkili:n/; [n]烯属烃基; [or]chem;
alkyne: [a]/'ælkaɪn/; [n]炔属烃; [or]chem;
allalinite: [a]/ə'lælənaɪt/; 蚀变辉长岩; [or]chem;
allivalite: [a]/'ælivə,lait/; [n]<岩>橄长岩;橄榄钙长岩; [or]chem;
allochetite: [a]/,ælə'ketait/; [n]<岩>霞辉二长斑岩; [or]chem;
allochromatic: [a]/,æləkrə'mætik/; [adj]杂质引起光化作用的;无色但含有色杂质之矿物的; [or]chem;
allotrope: [a]/ˈælətrəʊp/; [n]<物化>同素异形体; [or]chem;
allotropism: [a]/ə'lɑtrəpɪzəm/; [n]同素异形性,<物化>同素异形现象(等于allotropy); [or]chem;
allotropy: [a]/əˈlɒtrəpi/; [n](化学)同素异形; [or]chem;
allyl: [a]/'ælaɪl; -lɪl/; [n]烯丙基; [adj]烯丙基的; [or]chem;
allylamine: [a]/,ælələ'mi:n/; [n]烯丙胺; [or]chem;
allylic: [a]/'æləˌlɪk/; [adj]烯丙基的; [or]chem;
almandine: [a]/'ælməndiːn; -daɪn/; [n]铁铝榴石;铁铝石榴子石; [or]chem;
almandite: [a]/'ælmən,dait/; [n]<宝>贵榴石; [or]chem;
alnoite: [a]/'ælnə,ait/; [n]<岩>黄长煌斑岩,橄辉煌斑岩; [or]chem;
alpenstock: [a]/'ælpənstɒk/; [n]铁头登山杖; [or]chem;
alsbachite: [a]/'ɔ:lzbɑ:kait/; [n]<岩>榴云细斑岩; [or]chem;
alumina: [a]/əˈluːmɪnə/; [n]<无化>氧化铝;矾土; [or]chem;
aluminate: [a]/ə'ljuːmɪneɪt/; [n]<无化>铝酸盐; [or]chem;
aluminiferous: [a]/ə,ljuːmɪ'nɪfərəs/; [adj]含铝的; [n]<岩>铝铁岩; [or]chem;
aluminosilicate: [a]/ə,ljʊməno'sɪləkɪt/; [n]<无化>铝硅酸盐;铝矽酸盐; [or]chem;
alumite: [a]/əl'ju:maɪt/; [n]明矾石;耐酸铝;耐热绝缘性铝; [or]chem;
amalgamate: [a]/əˈmælɡəmeɪt/; [vi]合并;汞齐化;调制汞合金; [vt]合并;使(金属)汞齐化;混合; [add]pt/amalgamated,pp/amalgamated,pr/amalgamating,s3/amalgamates; [or]chem;
amalgamative: [a]/ə'mælɡəmeitiv/; [adj]合并的;混汞的; [or]chem;
amalgamator: [a]/ə'mælɡəmeɪtə/; [n]合并者;混汞器; [or]chem;
amanitin: [a]/,æmə'ni:tin/; [n]鹅膏蕈碱; [or]chem;
amarantite: [a]/,æmə'ræntait/; [n]红铁矾; [or]chem;
amatol: [a]/'æmətɒl/; [n]<化工>阿马托炸药(一种强力炸药); [or]chem;
ambonite: [a]/'æmbənait/; [n]<岩>堇青安山岩; [or]chem;
amethyst: [a]/ˈæməθɪst/; [n]紫水晶;<宝>紫晶;紫色; [add]pl/amethysts; [or]chem;
amherstite: [a]/'æməstait/; [n]反纹二长岩;反纹正长闪长岩; [or]chem;
amic: [a]/'æmɪk/; [adj]氨的;氨化物的;  [or]chem;
amidate: [a]/'æmideit/; [n]酰胺化物; [vt]化为醯胺; [add]pt/amidated,pp/amidated,pr/amidating; [or]chem;
amide: [a]/'eɪmaɪd; 'æmaɪd/; [n]氨基化合物;酰胺; [or]chem;
amido: [a]/ə'miːdəʊ/; [adj]氨基的;  [or]chem;
amino: [a]/ə'miːnəʊ; ə'maɪnəʊ/; [adj]氨基的;  [or]chem;
aminophenol: [a]/ə,miːnəʊ'fiːnɒl/; [n]氨基酚; [or]chem;
aminoplast: [a]/ə'miːnəplæst/; 聚酰胺塑料; <塑料>氨基塑料; [or]chem;
ammine: [a]/'æmiːn/; [n]氨络物;氨合物; [or]chem;
ammonate: [a]/'æmə,neɪt/; 氨合物; [or]chem;
ammonation: [a]/,æmə'neiʃən/; [n]<无化>氨合作用; [or]chem;
ammonia: [a]/əˈməʊniə/; [n]<无化>氨,阿摩尼亚; [or]chem;
ammoniacal: [a]/,æmə(ʊ)'naɪək(ə)l/; [adj]<无化>氨的;含氨的; [or]chem;
ammoniate: [a]/ə'məʊnɪeɪt/; [n]氨合物; [vt]加氨; [add]pt/ammoniated,pp/ammoniated,pr/ammoniating,s3/ammoniates; [or]chem;
ammonic: [a]/ə'mɒnɪk/; [adj]氨的;铵的; [or]chem;
ammonification: [a]/ə,mɒnɪfɪ'keɪʃən/; [n]<无化>氨化;加氨; [or]chem;
ammonify: [a]/ə'mɒnɪfaɪ/; [v]使..氨化;加氨,加氨于..; [add]pt/ammonified,pp/ammonified,pr/ammonifying,s3/ammonifies; [or]chem;
ammonium: [a]/əˈməʊniəm/; [n]<无化>铵;氨盐基; [or]chem;
ampelite: [a]/'æmpəlait/; [n]<岩>黄铁碳质页岩; [or]chem;
amphetamine: [a]/æmˈfetəmiːn; æmˈfetəmɪn/; [n]苯丙胺,安非他明(解除忧郁,疲劳的药); [add]pl/amphetamines; [or]chem;
amphibolite: [a]/æm'fɪbəlaɪt/; [n]<岩>闪岩,角闪岩; [or]chem;
amygdaloid: [a]/ə'mɪgdəlɒɪd/; [adj]杏仁状的;似杏仁岩的; [n]杏仁岩;扁桃核; [or]chem;
amygdaloidal: [a]/ə,mɪgdə'lɒɪd(ə)l/; [adj]杏仁岩的;杏仁状的(等于amygdaloid); [or]chem;
anabohitsite: [a]/,ænəbəu'hit,sait/; [n]<岩>铁橄苏辉岩; [or]chem;
andesite: [a]/'ændɪzaɪt; -saɪt/; [n]安山岩,安山石,中性长石; [or]chem;
andesitic: [a]/,ændɪ'zɪtɪk/; 安山岩的; [or]chem;
aneurin: [a]/'ænjʊərɪn/; [n]硫胺素;维生素B1; [or]chem;
angle: [a]/ˈæŋɡl/; [n]角,角度;视角;立场;角铁;(古)鱼钩; [v]斜移;从..角度提供信息;钓鱼;谋取; [add]pt/angled,pp/angled,pr/angling,pl/angles,s3/angles; [or]chem;
anilide: [a]/'ænəlɪd/; [n]苯胺;醯基; [or]chem;
aniline: [a]/'ænɪliːn; -lɪn/; [n]苯胺; [adj]苯胺的; [or]chem;
ankaramite: [a]/,æŋkə'rɑ:mait/; [n]橄榄辉玄岩;<岩>富辉橄玄岩;钭长辉石岩; [or]chem;
ankaratrite: [a]/,æŋkə'rɑ:trait/; [n]<岩>橄霞玄武岩;<岩>黄橄霞玄岩; [or]chem;
anodize: [a]/ˈænədaɪz/; [v]对(金属,尤指铝)作阳极氧化,阳极处理; [add]pt/anodize,anodized,pp/anodize,anodised,pr/anodize,anodising,s3/anodizes; [or]chem;
anorthosite: [a]/ə'nɔːθəsaɪt/; [n]斜长岩,钙长石(一种粒状火成岩); [or]chem;
antalkali: [a]/ænt'ælkəlaɪ/; [n]<助剂>抗碱剂;碱性中和剂; [add]pl/antalkalies或antalkalis; [or]chem;
antalkaline: [a]/ænt'ælkəlaɪn/; [n]解碱药; [adj]解碱的; [or]chem;
anthracene: [a]/'ænθrəsiːn/; [n]蒽(一种碳氢化合物); [or]chem;
anthranilate: [a]/æn'θrænileit/; [n]邻氨基苯甲酸盐; [or]chem;
anthroponomy: [a]/,ænθrə'pɒnəmɪ/; 人类进化学; 人体进化论; [or]chem;
anticatalyst: [a]/,æntɪ'kætəlɪst/; [n]<物化>反催化剂;抗化剂; [or]chem;
antichlor: [a]/'æntɪklɔː/; [n]除氯剂,<助剂>去氯剂;阴氢剂; [or]chem;
anticorrosive: [a]/,æntɪkə'rəʊsɪv/; [adj]<化工>防蚀的; [n]<助剂>防腐剂; [or]chem;
antifreeze: [a]/ˈæntifriːz/; [n]<助剂>防冻剂; [or]chem;
antihistamine: [a]/ˌæntiˈhɪstəmiːn/; [n]抗组胺剂; [add]pl/antihistamines; [or]chem;
antihistaminic: [a]/'æntɪhɪstə'mɪnɪk/; [n]抗组胺剂; [adj]抗组织胺剂的; [or]chem;
antimonate: [a]/'æntɪmə,net/; [n]<无化>锑酸盐; [or]chem;
antimonial: [a]/,æntɪ'məʊnjəl/; [adj]锑的;含锑的; [n]<无化>含锑药剂; [or]chem;
antimonite: [a]/'æntimə,nait/; [n]<无化>亚锑酸盐;辉锑矿; [or]chem;
antimony: [a]/ˈæntɪməni/; [n](化学元素)锑元素(符号 Sb); [or]chem;
antioxidant: [a]/ˌæntiˈɒksɪdənt/; [n]抗氧化剂;硬化防止剂;防老化剂; [add]pl/antioxidants; [or]chem;
anvil: [a]/ˈænvɪl/; [n]铁砧;砧骨; [add]pt/anviled或anvilled,pp/anviled或anvilled,pr/anviling或anvilling,pl/anvils; [or]chem;
aphanite: [a]/'æfənaɪt/; [n]<岩>非显晶岩;<岩>隐晶岩; [or]chem;
aphanitic: [a]/,æfə'nɪtɪk/; [adj]非显晶岩的;隐晶岩的; [or]chem;
aplite: [a]/'æplaɪt/; [n]半花岗岩;<岩>细晶岩(等于haplite); [or]chem;
apophorometer: [a]/,æpəfə'rɔmitə/; [n]<分化>升华仪; [or]chem;
apophysis: [a]/ə'pɒfɪsɪs/; [n]隆起;突起;岩脉的分支; [add]pl/apophyses; [or]chem;
appinite: [a]/'æpinait/; [n]<岩>富闪深成岩类; [or]chem;
apyrous: [a]/e'paɪrəs/; [adj]<化工>耐火的;不易燃的; [or]chem;
aquamarine: [a]/ˌækwəməˈriːn/; [n]<宝>海蓝宝石;碧绿色,浅绿色; [add]pl/aquamarines; [or]chem;
ara: [a]/'erə/; [abbr]非洲铁路协会(African Railway Association);机载雷达附件(Airborn; [prep]Attachment);  [or]chem;
arabinose: [a]/'ærəbɪnəʊz; -s/; [n]阿拉伯糖,阿戊糖;树胶醛醣; [or]chem;
arapahite: [a]/ə'ræpəhait/; [n]磁铁玄武岩;<岩>磁玄岩; [or]chem;
ardennite: [a]/ɑ:'denait/; [n]硅铝锰矿; [or]chem;
argentite: [a]/'ɑːdʒəntaɪt/; [n]辉银矿; [or]chem;
argentometry: [a]/ɑ:dʒən'tɔmitri/; [n]<分化>银盐定量; [or]chem;
argillaceous: [a]/,ɑːdʒɪ'leɪʃəs/; [adj](岩石,沉积物的)由黏土构成的,含黏土的;(似)黏土的; [or]chem;
argillite: [a]/'ɑːdʒɪlaɪt/; [n]粘板岩;硅质粘土岩; [or]chem;
ariegite: [a]/,æri'edʒait/; [n]<岩>尖榴辉岩;尖馏辉岩; [or]chem;
arizonite: [a]/,æri'zəunait/; [n]红钛铁矿;<岩>正长脉岩; [or]chem;
arkite: [a]/'ɑ:kait/; [n]黑白榴霞斑岩;阿克特炸药; [or]chem;
arkose: [a]/'ɑːkəʊs; -z/; [n]<岩>长石砂岩; [or]chem;
arkosic: [a]/ɑ:'kɔsik/; [adj]长石砂岩的;岩质的; [or]chem;
arsenate: [a]/'ɑːs(ə)neɪt/; [n]<无化>砷酸盐;砒酸盐; [or]chem;
arsenide: [a]/'ɑːs(ə)naɪd/; [n]<无化>砷化物; [or]chem;
arsenite: [a]/'ɑːsənaɪt/; [n]亚砷酸盐; [or]chem;
arsoite: [a]/'ɑ:səu,ait/; [n]<岩>辉橄粗面岩; [or]chem;
artiad: [a]/'ɑ:ti,æd/; [n]偶价元素;偶价原子团; [or]chem;
aryl: [a]/'æraɪl; -rɪl/; [n]芳香基; [adj]芳香基的; [or]chem;
aseptic: [a]/ˌeɪˈseptɪk/; [adj]无菌的;防腐性的; [n]<助剂>防腐剂; [or]chem;
ashery: [a]/'æʃərɪ/; [n]钾碱厂;堆灰场; [add]pl/asheries; [or]chem;
asphaltene: [a]/æs'fælti:n/; [n]<油气>沥青质;<油气>沥青烯; [or]chem;
asphaltite: [a]/æs'fæltaɪt/; [n]<岩>沥青岩;沥青矿; [adj]沥青岩的; [or]chem;
assaying: [a]/ə'seɪŋ/; [n]<分化>试金;分析矿物; [v]分析;试验;对.估价(assay的ing形式); [or]chem;
assyntite: [a]/'æsintait/; [n]<岩>钛辉方钠正长岩; [or]chem;
asteria: [a]/æ'stɪərɪə/; [n]<宝>星彩宝石;显星形之宝石; [or]chem;
asthenolith: [a]/æs'θenəliθ/; [n]熔岩浆,岩浆体;软流圈岩浆体;岩浆袋; [or]chem;
astrakanite: [a]/'æstrəkənait/; [n]白钠美钒; [or]chem;
astrochemist: [a]/,æstrəʊ'kemɪst/; [n]天体化学家; [or]chem;
astrogony: [a]/æ'strɒɡənɪ/; 恒星演化学; [or]chem;
at: [a]/ət; æt/; [prep]temperature); [n]阿特(老挝货币基本单位 att);砹(极不稳定放射性元素); [abbr]密封的 (airtight);大气 (atmosphere);原子的 (atomic);气温 (ai; [or]chem;
atacamite: [a]/,ætə'kæmait/; [n]氯铜矿; [or]chem;
atlantite: [a]/æt'læntait/; [n]霞石碱玄岩,<岩>暗霞碧玄岩; [or]chem;
atom: [a]/ˈætəm/; [n]原子; [add]pl/atoms; [or]chem;
atomic: [a]/əˈtɒmɪk/; [adj]原子的,原子能的;微粒子的; [or]chem;
atomicity: [a]/ˌætəˈmɪsəti/; [n]原子数;原子价; [or]chem;
atomist: [a]/'ætəmɪst/; [n]原子论者; [or]chem;
atomistic: [a]/ˌætəˈmɪstɪk/; [adj]原子的;原子论的; [or]chem;
atomistics: [a]/,ætəu'mistiks/; [n]原子论;核子物理学; [or]chem;
atomization: [a]/,ætəʊmaɪ'zeɪʃən/; [n]雾化,<分化>原子化; [or]chem;
atomize: [a]/ˈætəmaɪz/; [vt]使分裂为原子;将.喷成雾状;使遭受原子弹轰炸; [vi]分裂; [add]pt/atomized,pp/atomized,pr/atomizing,s3/atomizes; [or]chem;
atomy: [a]/'ætəmɪ/; [n]微粒,原子;矮人;骨骼; [add]pl/atomies; [or]chem;
atophan: [a]/'ætə,fæn/; [n]阿托方,苯基金鸡宁酸;辛可芬; [or]chem;
auganite: [a]/'ɔ:ɡənait/; [n]<岩>辉安岩; [or]chem;
augitite: [a]/'ɔ:dʒitait/; [n]辉石岩;玻辉岩; [or]chem;
augitophyre: [a]/'ɔ:dʒitəfaiə/; [n]<岩>辉斑玄武岩; [or]chem;
auramine: [a]/'ɔ:rəmi:n, -min/; [n]金胺; [or]chem;
aurate: [a]/'ɔret/; [n]<无化>金酸盐; [or]chem;
autocatalysis: [a]/,ɔːtəʊkə'tælɪsɪs/; [n]链式反应扩大;<物化>自动催化作用; [add]pl/autocatalyses; [or]chem;
autocatalytic: [a]/,ɔtokætə'lɪtɪk/; [adj]<物化>自动催化的; [or]chem;
autoxidator: [a]/ɔː'tɒksɪ,deɪtə/; 自动氧化剂; [or]chem;
auxochrome: [a]/'ɔːksəkrəʊm/; [n]<染料>助色团(用以使染料固着在织物上); [or]chem;
aviolite: [a]/'ævriəlait/; [n]堇云角岩; [or]chem;
azide: [a]/'eɪzaɪd/; [n]<无化>叠氮化物; [or]chem;
azine: [a]/'eɪziːn/; [n]吖嗪;连氮; [or]chem;
azo: [a]/'æzəʊ/; [adj]偶氮基的;  [or]chem;
azoic: [a]/eɪˈzəʊɪk/; [adj]无生命时代的;无生命的; [n]无生代;无生代岩石; [or]chem;
azoimide: [a]/,æzəu'imaid/; [n]三氮化氢;<无化>叠氮酸(等于hydrazoic acid); [or]chem;
azote: [a]/ə'zəʊt/; [n]氮(nitrogen的旧称); [or]chem;
azotic: [a]/ə'zɒtɪk/; 含氮的; [or]chem;
azotize: [a]/'æzətaɪz/; 氮化; 使与氮化合; [or]chem;
azotometer: [a]/,æzəu'tɔmitə/; [n]定氮仪;氮定量器;量氮器; [or]chem;
azulene: [a]/'æʒə,li:n/; [n]<染料>甘菊蓝;甘菊环; [or]chem;
azulite: [a]/'æʒə,lait/; [n]蓝菱锌矿; [or]chem;
azurite: [a]/'æʒʊraɪt; -ʒj(ʊ)ə-; 'eɪ-/; [n]蓝铜矿; [or]chem;
babingtonite: [a]/'bæbiŋtə,nait/; [n]铁灰石; [or]chem;
bahiaite: [a]/bə'hi:ə,ait/; [n]<岩>橄闪紫苏岩; [or]chem;
banakite: [a]/'bænəkait/; [n]橄云安粗岩;粗绿岩; [or]chem;
banatite: [a]/'bænətait/; [n]<岩>正辉英闪长岩; [or]chem;
banksman: [a]/'bæŋksmən/; [n]矿坑口的监工;排字工人; [add]pl/banksmen; [or]chem;
barbital: [a]/'bɑːbɪt(ə)l/; [n]巴比妥(具有长效镇静和催眠作用的药用巴比妥钠盐); [or]chem;
barbwire: [a]/bɑːb'waɪə/; [n]倒钩铁丝; [add]pt/barbedwire,barbwired,pp/barbedwire,barbwired,pr/barbedwire,barbwiring; [or]chem;
barehanded: [a]/'beə'hændɪd/; [adj]手无寸铁的;空手的;赤手空拳的; [or]chem;
barkevikite: [a]/'bɑ:kəvi,kait/; [n]<岩>棕闪石;铁角闪石; [or]chem;
baryta: [a]/bə'raɪtə/; [n]氧化钡;重土; [or]chem;
basaltic: [a]/bə'sɔːltɪk/; [adj]<岩>玄武岩的; [or]chem;
basaltine: [a]/bə'sɔ:ltin/; [n]玄武角闪石;玄武岩石; [or]chem;
basanite: [a]/'bæsə,naɪt/; [n]试金石;<岩>碧玄岩; [or]chem;
basicity: [a]/beɪ'sɪsɪtɪ/; [n]碱度;盐基度; [or]chem;
basifier: [a]/'beisi,faiə/; [n]<助剂>碱化剂; [or]chem;
basify: [a]/'beɪsɪfaɪ/; [v]使..盐基化;使..碱化; [add]pt/basified,pp/basified,pr/basifying,s3/basifies; [or]chem;
basophilic: [a]/,besə'fɪlɪk; ,bezə'fɪlɪk/; [adj]嗜碱性的;适碱性的; [or]chem;
bathochrome: [a]/'bæθəkrəʊm/; [n]<染料>向红基;<染料>向红团(有机化合物原子团);深色基团; [or]chem;
beakiron: [a]/'bi:k,aiən/; [n]鸟嘴砧;台砧;铁角砧; [or]chem;
bebeerine: [a]/bə'bɪəriːn/; [n]比比林(一植物碱); [or]chem;
benjaminite: [a]/'bendʒəmənait/; [n]铜银铅铋矿; [or]chem;
benzal: [a]/'bɛnzæl/; [adj]苯亚甲基(等于benzylidene); [or]chem;
benzaldoxime: [a]/,benzæl'dɒksaɪm/; 苯甲醛肟; [or]chem;
benzenoid: [a]/'benzənɔid/; [adj]苯(环)型的; [or]chem;
benzoate: [a]/'benzəʊeɪt/; [n]苯酸盐;安息香酸盐; [or]chem;
benzoin: [a]/'benzəʊɪn/; [n]安息香;苯偶姻; [or]chem;
benzol: [a]/'benzɒl/; [n]不纯苯; [or]chem;
benzole: [a]/'benzɔl,-zəul/; [n]粗苯; [or]chem;
benzophenone: [a]/,benzəʊ'fɪnəʊn/; [n]苯甲酮; [or]chem;
benzoyl: [a]/'benzəʊaɪl; -zəʊɪl/; [n]苯甲酰; [or]chem;
benzoylate: [a]/'benzəuə,leit/; [n]苯酰化; [or]chem;
benzylic: [a]/ben'zilik/; [adj]苄基的;苄型的; [or]chem;
benzylidene: [a]/ben'zilidi:n/; [adj]苯亚甲基的(等于benzal); [n]苯亚甲基;苄叉二氯(等于benzal); [or]chem;
berberine: [a]/'bɜːbəriːn/; [n]黄连素;小檗碱; [or]chem;
berlinite: [a]/bɜː'lɪnaɪt/; 块磷铝矿; [or]chem;
berthierite: [a]/'bə:θiə,rait/; [n]蓝铁矿;辉锑铁矿; [or]chem;
beryl: [a]/ˈberəl/; [n]<宝>绿宝石;绿玉;浅绿色; [or]chem;
beryllia: [a]/bə'riliə/; [n]<无化>氧化铍; [or]chem;
beryllonite: [a]/bi'rilənait/; [n]磷酸钠铍石; [or]chem;
bevatron: [a]/'bevətrɒn/; [n]质子加速器;阳子原子核破坏装置; [or]chem;
bianchite: [a]/bɪ'æŋkaɪt/; 锌铁矾; [or]chem;
bicarbonate: [a]/ˌbaɪˈkɑːbənət/; [n]碳酸氢盐;重碳酸盐;酸式碳酸盐; [or]chem;
bichromate: [a]/'baɪ'kromɪt/; [n]重铬酸盐; [or]chem;
bichrome: [a]/'baikrəum/; [n]重铬酸盐; [adj]两色的; [or]chem;
bidentate: [a]/baɪ'denteɪt/; [adj]双齿的;双配位基的; [or]chem;
bifluoride: [a]/bai'flu:əraid/; [n]<无化>氟氢化物; [or]chem;
biochemical: [a]/ˌbaɪəʊˈkemɪkl/; [adj]生物化学的; [or]chem;
biochemist: [a]/ˌbaɪəʊˈkemɪst/; [n]生物化学家; [add]pl/biochemists; [or]chem;
biochemistry: [a]/ˌbaɪəʊˈkemɪstri/; [n]生物化学; 生物化学过程; [add]pl/biochemistries; [or]chem;
biogeochemistry: [a]/,baɪo,dʒɪo'kɛmɪstri/; [n]生物地球化学(研究一地区内生物物质及其与地球化学物质的关系); [or]chem;
biolith: [a]/'baiəuliθ/; [n]<岩>生物岩; [or]chem;
bischofite: [a]/'biʃəfait/; [n]水氯镁石; [or]chem;
bismuthate: [a]/'bɪzmə,θeɪt/; <无化>铋酸盐; [or]chem;
bismuthinite: [a]/biz'mʌθənait/; [n]辉铋矿; [or]chem;
bisphenoid: [a]/bai'sfi:nɔid/; [n]<晶体>双榍; [or]chem;
bisque: [a]/bɪsk/; [n]<陶瓷>素瓷;浓汤;橘黄色; [or]chem;
bisulphate: [a]/,bai'sʌlfeit/; [n]重硫酸盐;硫酸氢盐; [or]chem;
bisulphide: [a]/,bai'sʌlfaid/; [n]二硫化物(等于bisulfide); [or]chem;
bisulphite: [a]/,bai'sʌlfait/; [n]<无化>亚硫酸氢盐,酸式亚硫酸盐; [or]chem;
bituminization: [a]/bɪ,tjʊmɪnɪ'zeʃən/; [n]<油气>沥青固化; [or]chem;
bivinyl: [a]/bai'vainil/; [n]丁二烯; [or]chem;
blacksmith: [a]/ˈblæksmɪθ/; [n]铁匠;锻工; [add]pl/blacksmiths; [or]chem;
blae: [a]/bli/; [adj]青灰色的;(方)深蓝色的; [n]灰青炭质页岩; [or]chem;
blastophitic: [a]/,blæstəu'fitik/; [adj]变余辉绿岩的;变余辉绿状; [n]<岩>变余辉岩; [or]chem;
blistering: [a]/ˈblɪstərɪŋ/; [adj]猛烈的;极热的,极快的; [n]<涂料>起泡;发疱; [v]起水疱;起气泡;使受暴晒(blister的ing形式); [or]chem;
bloomery: [a]/'blʊməri/; [n]锻铁炉;熟铁块吹炼法; [add]pl/bloomeries; [or]chem;
blowpipe: [a]/ˈbləʊpaɪp/; [n]<玻璃>吹管;吹风管; [or]chem;
bonanza: [a]/bəˈnænzə/; [n]富矿带;带来好运之事;幸运; [add]pl/bonanzas; [or]chem;
boninite: [a]/'bɔninait/; [n]玻古安山岩; [or]chem;
bookkeeper: [a]/ˈbʊkkiːpə(r)/; [n]簿记员;会计员;铁路的司旗员; [add]pl/bookkeepers; [or]chem;
boracic: [a]/bə'ræsɪk/; [adj]含硼素的;硼素的; [or]chem;
boral: [a]/'bɔːrəl/; [n]碳化硼铝;碳洒石酸铝; [or]chem;
boric: [a]/'bɔːrɪk/; [adj]硼的;含硼的;  [or]chem;
boride: [a]/'bɔːraɪd/; [n]<无化>硼化物; [or]chem;
borofluoride: [a]/,bɔːrəʊ'flʊəraɪd/; <无化>氟硼酸盐; [or]chem;
borosilicate: [a]/,bɔːrəʊ'sɪlɪkeɪt/; [n]硼硅酸盐; [or]chem;
bostonite: [a]/'bɔstənait/; [n]<岩>歪正细晶岩; [or]chem;
bottoming: [a]/'bɔtəmiŋ/; [v](船)到达海底;(成绩或局势 )走出低谷;钻探..直到矿物层;勘探到金子(或其他矿物);发现..范围(或本质)(bottom 的现在分词); [n]铺底(路或其他建筑物基底材料的最底层); [or]chem;
brachyaxis: [a]/,bræki'æksis/; [n]<晶体>短轴; [or]chem;
brassart: [a]/'bræsət/; [n]臂铠;铁护手; [or]chem;
braunite: [a]/'braunait/; [n]褐锰矿;布氏体;布劳奈铁; [or]chem;
brazilein: [a]/brə'zɪlɪɪn/; [n]巴戊;氧化巴西木素; [or]chem;
brecciated: [a]/'bretʃieitid/; [adj]角砾化的;角砾状的; [v]使(岩石)形成角砾岩(brecciate的过去分词); [or]chem;
brecciation: [a]/,bretʃi'eiʃən/; [n]角砾岩化作用; [or]chem;
brimstone: [a]/ˈbrɪmstəʊn/; [n]硫磺;悍妇; [or]chem;
bromate: [a]/'brəʊmeɪt/; [n]溴酸盐; [v]使与溴化合; [add]pt/bromated,pp/bromated,pr/bromating,s3/bromates; [or]chem;
bromide: [a]/ˈbrəʊmaɪd/; [n]<无化>溴化物;庸俗的人;陈词滥调; [add]pl/bromides; [or]chem;
bromination: [a]/,brəumi'neiʃən/; [n]<无化>溴化;溴处理; [or]chem;
buddle: [a]/'bʌd(ə)l/; [v]用洗矿槽洗; [n]洗矿槽,淘汰盘; [add]pt/buddled,pp/buddled,pr/buddling; [or]chem;
buhrstone: [a]/'bɜːstəʊn/; [n]沙质多孔石灰岩;砂质岩;矽石; [or]chem;
bunkhouse: [a]/ˈbʌŋkhaʊs/; [n]牧场工作人宿舍;(矿工等的)简易住屋; [add]pl/bunkhouses; [or]chem;
burette: [a]/bjuˈret/; [n]<分化>滴定管;量管; [or]chem;
buttgenbachite: [a]/'bʌtdʒən,bækaɪt/; 毛青铜矿; [or]chem;
bysmalith: [a]/baɪs'mælɪθ/; [n]<岩>岩栓; [or]chem;
cabble: [a]/'kæbəl/; [vt]将(铁条或钢条)切成短条; [or]chem;
cacholong: [a]/'kætʃəlɔŋ/; [n]<宝>美蛋白石; [or]chem;
cacodyl: [a]/'kækə(ʊ)daɪl; -dɪl/; [n]二甲砷基;四甲二砷; [adj]含卡可基的; [or]chem;
cadalene: [a]/'kædəli:n/; [n]卡达烯; [or]chem;
cadmia: [a]/'kædmiə/; [n]碳酸锌,菱锌矿;锌壳,锌渣; [or]chem;
calamine: [a]/ˈkæləmaɪn/; [n]炉甘石;菱梓矿,锌矿石; [or]chem;
calcimeter: [a]/kæl'simitə/; [n]钙定量器;<分化>石灰测定器; [or]chem;
calcination: [a]/,kælsɪ'neʃən/; [n]煅烧;<化工>焙烧;烧矿法; [or]chem;
calcine: [a]/'kælsaɪn; -sɪn/; [v]锻烧,焙烧;(使)氧化; [n]煅烧产物; [add]pt/calcined,pp/calcined,pr/calcining,s3/calcines; [or]chem;
calcioferrite: [a]/,kælsiəu'fe,rait/; [n]钙磷铁矿; [or]chem;
calcrete: [a]/'kælkriːt/; [n]<岩>钙质结砾岩; [or]chem;
calk: [a]/kɔk/; [v]用填料或密封剂密封(缺口等);(使船)不漏水;加尖铁;描摹复制; [add]pl/calks,pt/calked,pp/calked,pr/calking,s3/calks;  [or]chem;
calkin: [a]/'kɔːkɪn/; [n]鞋底铁掌(防滑用的); [or]chem;
calomel: [a]/'kæləmel/; [n]<无化>甘汞;氯化亚汞; [or]chem;
caltrop: [a]/'kæltrəp/; [n]铁蒺藜;矢车菊;菱; [or]chem;
calx: [a]/kælks/; [n]矿灰;金属灰;生石灰; [add]pl/calxes或calces; [or]chem;
cambrel: [a]/ˈkæmbrəl/; [n]马脚形铁钩;吊肉棒; [or]chem;
camptonite: [a]/'kæmptəʊnaɪt/; [n]<岩>闪煌岩; [or]chem;
candy: [a]/ˈkændi/; [n]糖果,巧克力;冰糖;(糖果包装的)毒品;中看不中用的东西; [v]把..制成蜜饯;用糖煮;使结晶; [add]pl/candies,pt/candied,pp/candied,pr/candying; [or]chem;
canfieldite: [a]/'kænfildait/; [n]硫锗锡矿; [or]chem;
cantalite: [a]/'kæntəlait/; [n]斑碱粗面岩;疗松脂岩;松脂流纹岩;钠玻流纹岩; [or]chem;
capping: [a]/'kæpiŋ/; [n](对物件起保护作用的)遮盖物;(岩)盖层岩; [v]用..覆盖;限额收取(或支出);胜过;包(牙);选入(某项体育运动的国家队)(ca; [prep]的现在分词); [or]chem;
caproate: [a]/'kæprəueit/; [n]己酸酯;己酸盐; [or]chem;
caprylate: [a]/'kæprileit/; [n]辛酸盐; [or]chem;
capsulation: [a]/kæpsju'leiʃən/; [n]封装;<高分子>包囊化作用; [or]chem;
carbamide: [a]/'kɑrbə,maɪd/; [n]尿素,碳酰二胺;脲; [or]chem;
carbamyl: [a]/'kɑ:bəmil/; [n]氨基甲酰;甲氨酰; [or]chem;
carbazole: [a]/,kɑːbə'zəʊl/; [n]咔唑; [or]chem;
carbide: [a]/'kɑːbaɪd/; <无化>碳化物; [or]chem;
carbonatation: [a]/,kɑ:bənə'teiʃən/; [n]二氧化碳饱和;碳酸化; [or]chem;
carbonate: [a]/ˈkɑːbənət/; [n]碳酸盐; [v]溶解碳酸盐;转成碳酸盐; [add]pt/carbonated,pp/carbonated,pr/carbonating,pl/carbonates,s3/carbonates; [or]chem;
carbonitride: [a]/,ka:bəu'naitraid/; [n]碳氮化物; [or]chem;
carbonyl: [a]/'kɑːbənaɪl; -nɪl/; [n]羰基(含有羰基的金属化合物);碳酰; [or]chem;
carburet: [a]/'kɑːbjʊret/; [v](使)气体与碳化合;给(铁,钢等)渗碳(以增加表面硬度); [n]碳化物; [add]pt/carbureted或carburetted,pp/carbureted或carburetted,pr/carbureting或-retting; [or]chem;
carburize: [a]/ˈkɑːbjəraɪz; ˈkɑːbəraɪz/; [v]使(铁,钢等)渗碳(以增加表面硬度); [add]pt/carburized,pp/carburized,pr/carburizing; [or]chem;
caryopilite: [a]/,kæriə'pilait/; [n]肾硅锰矿,肾矽锰矿; [or]chem;
cascadite: [a]/'kæskə,dait; 'kæskədait/; [n]橄辉云煌岩; [or]chem;
caseinate: [a]/kei'si:neit/; [n]酪朊酸盐;金属(如钙或钠)与酪蛋白的化合物;酪蛋白酸; [or]chem;
catalyst: [a]/ˈkætəlɪst/; [n]<物化>催化剂;刺激因素; [add]pl/catalysts; [or]chem;
catalyzer: [a]/'kætə,laɪzɚ/; [n]<物化>催化剂;触媒剂; [or]chem;
cavate: [a]/'keɪveɪt/; [adj]形成山洞的;挖空岩石而形成的; [or]chem;
cebollite: [a]/si'bɔlait/; [n]铁维石;纤维石; [or]chem;
cecilite: [a]/'si:silait/; [n]<岩>黄长白榴岩; [or]chem;
celsian: [a]/'selsiən/; [n](矿物)钡长石; [or]chem;
cement: [a]/sɪˈment/; [n]水泥;接合剂;纽带;使人们团结的因素;黏固粉;牙骨质;沉积岩基质; [v]粘牢,胶合;巩固,确定;在......上抹水泥;(物质)在沉积岩中黏附(颗粒 ); [add]pt/cemented,pp/cemented,pr/cementing,s3/cements; [or]chem;
centric: [a]/'sentrɪk/; [adj]中心的;重要的;(硅藻)放射性对称的; [or]chem;
ceramography: [a]/serə'mɔgrəfi/; [n]<陶瓷>陶瓷学,陶瓷相学; [or]chem;
ceride: [a]/'siraid/; [n]脂蜡;铈系元素; [or]chem;
cervantite: [a]/sə:'væntait/; [n]白安矿; [or]chem;
cesium: [a]/'siːzɪəm/; [n]铯(55号元素,符号Cs); [or]chem;
cetene: [a]/'seti:n/; [n]鲸蜡烯;十六烯; [or]chem;
chain: [a]/tʃeɪn/; [n]链;束缚;枷锁; [vt]束缚;囚禁;用铁链锁住; [or]chem;
chalcophyllite: [a]/kæl'kɒfɪlaɪt/; 云母铜矿; [or]chem;
chalybeate: [a]/kə'lɪbɪət/; [n]铁剂;含铁物; [adj]含有铁质的; [or]chem;
charnockite: [a]/'tʃɑ:nəkait/; [n]<岩>紫苏花岗岩; [or]chem;
chasmophyte: [a]/'kæzmɔfait/; [n]岩缝植物; [or]chem;
chavicol: [a]/'ʃævikɔl/; [n]萎叶酚;佳味酚;对烯丙基苯酚;胡椒酚; [or]chem;
che: [a]/,si: eɪtʃ 'i:/; abbr. 胆碱酯酶(等于cholinesterase);化学(等于Chemical);充电指示灯;  [or]chem;
cheddite: [a]/'tʃedaɪt/; [n]<化工>谢德炸药(最初在法国谢德制造); [or]chem;
chelerythrine: [a]/ki'leriθri:n/; [n]白屈菜赤碱; [or]chem;
chemic: [a]/'kemɪk/; [adj]化学的;炼金术的; [n]炼金术士;化学家; [or]chem;
chemical: [a]/ˈkemɪkl/; [n]化学制品,化学药品; [adj]化学的; [add]pl/chemicals; [or]chem;
chemicalization: [a]/,kemɪkəlaɪ'zeɪʃən/; [n]化学化; [or]chem;
chemicalize: [a]/'kemɪkəlaɪz/; [v]以化学品处理; [add]pt/chemicalized,pp/chemicalized,pr/chemicalizing; [or]chem;
chemiluminescence: [a]/,kemɪ,ljuːmɪ'nesəns/; [n]化学发光,化合光; [or]chem;
chemism: [a]/'kemɪzəm/; [n]化学机制;化学作用; [or]chem;
chemisorb: [a]/'kemɪsɔːb/; [v]用化学方法吸收,吸附(某种物质); [or]chem;
chemist: [a]/ˈkemɪst/; [n]化学家;化学工作者;药剂师;炼金术士; [add]pl/chemists; [or]chem;
chemistry: [a]/ˈkemɪstri/; [n]化学;化学过程; [add]pl/chemistries; [or]chem;
chemokinetic: [a]/,kaɪmokɪ'nɛtɪk/; 化学增活的; [or]chem;
chemolysis: [a]/kɪ'mɒlɪsɪs/; 化学溶解; 化学溶蚀; 化学分解; [or]chem;
chemoreception: [a]/'kɛmorɪ'sɛpʃən/; [n]感官对化学品刺激的反应; [or]chem;
chemoresistance: [a]/'keməuri'zistəns/; [n]化学抵抗;化学抗性;药物抗性; [or]chem;
chemosmosis: [a]/,kemɒz'məʊsɪs/; [n]化学渗透作用; [add]pl/chemosmoses; [or]chem;
chemotherapeutic: [a]/'keməu,θerə'pju:tik/; [adj]化学疗法的; [or]chem;
chemotherapeutics: [a]/'keməʊ,θerə'pjuːtɪks/; [n]化学疗法; [or]chem;
chemurgy: [a]/'kemɜːdʒɪ/; [n]应用化学;农业化工; [or]chem;
chibinite: [a]/'ʃibi,nait/; [n]希宾岩; [or]chem;
chillagite: [a]/'tʃilə,gait/; [n]钨钼铅矿; [or]chem;
chipping: [a]/'tʃɪpɪŋ/; [v]打破;凿下(碎片);削成;(边缘或表面)剥落;打(或踢)高球;将(土豆等)切条;植入微芯片(chi; [prep]的现在分词); [n](石或木等)碎屑;(铺路或铁轨用的)碎石;切削; [or]chem;
chitosamine: [a]/kai'təusə,mi:n/; [n]壳糖胺;葡糖胺;氨基葡糖; [or]chem;
chloanthite: [a]/kləu'ænθait/; [n]砷镍矿; [or]chem;
chloral: [a]/'klɔːræl/; [n]三氯乙醛; [or]chem;
chlorate: [a]/'klɔːreɪt/; [n]<无化>氯酸盐; [or]chem;
chloroacetate: [a]/klɔ:rəu'æsiteit/; [n]氯醋酸盐; [or]chem;
chloroaurate: [a]/klɔ:rə'ɔ:reit/; [n]氯金酸盐; [or]chem;
chlorophyllite: [a]/'klɔrəfilait/; [n]<岩>绿叶石; [or]chem;
chloroplatinate: [a]/,kləurə'plætineit/; [n]<无化>氯铂酸盐; [or]chem;
chokedamp: [a]/'tʃəʊkdæmp/; [n]矿坑或深井内令人窒息的瓦斯; [or]chem;
cholinergic: [a]/,kəʊlɪ'nɜːdʒɪk/; [adj]胆碱能的; [or]chem;
christianite: [a]/'kristjə,nait/; [n]钙十字沸石;碱花岗岩; [or]chem;
chromate: [a]/'krəʊmeɪt/; [n]铬酸盐; [vt]用铬酸盐处理; [add]pt/chromated,pp/chromated,pr/chromating; [or]chem;
chromatogram: [a]/krə(ʊ)'mætəgræm/; [n]<分化>色谱图;<分化>色层分离谱; [or]chem;
chromite: [a]/'krəʊmaɪt/; [n]铬铁矿;亚铬酸盐; [or]chem;
chromometer: [a]/krə'mɔmitə/; [n]<分化>比色计;色度计; [or]chem;
chrysoidine: [a]/kri'sɔidi:n/; [n]<染料>柯衣定;橘红; [or]chem;
churchite: [a]/'tʃə:tʃait/; [n]水磷铈矿;针磷钇铒矿; [or]chem;
cig: [a]/siɡ/; abbr. 化学的离子发生器(Chemical Ion Generator); [or]chem;
ciminite: [a]/'siminait/; [n]<岩>橄辉粗面岩; [or]chem;
cinnamic: [a]/sə'næmɪk/; [adj]含苯乙烯基的; [or]chem;
citrate: [a]/'sɪtreɪt/; [n]柠檬酸盐; [or]chem;
citrated: [a]/'sɪtreɪt/; [n]柠檬酸盐; [or]chem;
citrullin: [a]/'sitrəlin/; [n]瓜氨酸; [or]chem;
claim: [a]/kleɪm/; [v]宣称;要求,索取;引起(注意);获得;夺去(生命);索赔(钱财);需要; [n]声称;(财产等)所有权;(向公司等)索赔;专利新特征申明;要求(权利);(取得的)采矿地;索要; [add]pl/claims,pt/claimed,pp/claimed,pr/claiming,s3/claims; [or]chem;
cleek: [a]/kliːk/; [n]铁钩;铁头的高尔夫球棒; [add]pt/claught或cleeked或claucht,pp/cleeked,pr/cleeking; [or]chem;
cleeked: [a]/kliːk/; [n]铁钩;铁头的高尔夫球棒; [add]pt/claught或cleeked或claucht,pp/cleeked,pr/cleeking; [or]chem;
clinkstone: [a]/'klɪŋkstəʊn/; [n]响石;响岩; [or]chem;
clobber: [a]/ˈklɒbə(r)/; [vt]击倒;痛打; [n]软膏;环草胺除草剂; [or]chem;
clypeate: [a]/'klɪpɪ,eɪt/; [adj]圆盾形的;(昆虫)有额板的;有唇基的; [or]chem;
clypeiform: [a]/'klɪpiːəfɔːm/; [adj](昆虫)有唇基的,有额板的;圆盾的; [or]chem;
coagulant: [a]/kəʊ'ægjʊlənt/; [n]<建><化工>促凝剂;凝血剂;凝结剂; [or]chem;
coagulator: [a]/ko'ægjə,letɚ/; [n]<助剂>凝结剂;<化工>凝结器; [or]chem;
coaler: [a]/'kəʊlə/; [n]煤商;运煤船;运煤的铁路; [or]chem;
coater: [a]/'kəʊtə/; [n]<涂料>涂料器; [or]chem;
cobaltammine: [a]/,kəubɔ:lt'æmi:n/; [n]钴氨化合物; [or]chem;
cobaltite: [a]/kəʊ'bɔːltaɪt/; [n]辉钴矿; [or]chem;
cocainism: [a]/kə'keɪnɪzəm/; [n]古柯碱瘾;古柯碱中毒;可卡因瘾; [or]chem;
cocainize: [a]/kə'keɪnaɪz/; [vt]用古柯碱使其麻醉; [add]pt/cocainized,pp/cocainized,pr/cocainizing,s3/cocainizes; [or]chem;
colliery: [a]/ˈkɒliəri/; [n]煤矿; [add]pl/collieries; [or]chem;
collobrierite: [a]/,kɔlə'briə,rait/; [n]铁闪橄榴岩; [or]chem;
collodion: [a]/kə'ləʊdɪən/; [n]火棉胶;<高分子>胶棉; [or]chem;
collotype: [a]/'kɒlətaɪp/; [n]珂罗版;重铬酸盐制版法; [or]chem;
columbate: [a]/kə'lʌmbɪt/; [n]铌酸盐; [or]chem;
columbite: [a]/kə'lʌmbaɪt/; [n]钶铁矿;铌铁矿; [or]chem;
combustion: [a]/kəmˈbʌstʃən/; [n]燃烧,氧化;骚动; [or]chem;
comendite: [a]/'kɔməndait/; [n]硷性疗岩;<岩>钠闪碱流岩; [or]chem;
conglomerate: [a]/kənˈɡlɒmərət/; [n]企业集团;聚合物;砾岩; [adj]企业集团的;聚合物的;成团的;砾岩性的; [v](使)聚结,凝聚成团; [add]pt/conglomerated,pp/conglomerated,pr/conglomerating,pl/conglomerates; [or]chem;
conglomeratic: [a]/kən,glɔmə'rætik/; [adj]砾岩状;砾岩状的; [or]chem;
cookeite: [a]/'ku:kait/; [n]锂绿泥石;细鳞云母; [or]chem;
copolymer: [a]/kəʊ'pɒlɪmə/; [n]<高分子>共聚物; [or]chem;
copperas: [a]/'kɒp(ə)rəs/; [n]<无化><中医>绿矾; [or]chem;
corf: [a]/kɔːf/; [n]小型矿车;提矿大筐; [add]pl/corves; [or]chem;
corkite: [a]/'kɔ:kait/; [n]磷硫铅铁矿,磷铅铁矾; [or]chem;
cornwallite: [a]/'kɔ:nwɔ:lait/; [n]翠绿砷铜矿; [or]chem;
corrasion: [a]/kə'reʒən/; [n]岩石侵蚀; [or]chem;
corsite: [a]/'kɔ:sait/; [n]<岩>球状闪长岩; [or]chem;
coulee: [a]/'kuːlɪ/; [n]熔岩流;深谷;小川; [or]chem;
covalent: [a]/ˌkəʊˈveɪlənt/; [adj]共价的;共有原子价的; [or]chem;
covelline: [a]/kəu'velain/; [n]铜蓝;靛铜矿; [or]chem;
crack: [a]/kræk/; [v]使破裂;将(谷物)粗磨; 砸开(保险箱);成功获得;(可听到响声的)重击;(使)发出爆裂声;(突然)变嘶哑;使屈服;(非正式)吃不消; (非正式)突然大笑;(非正式)找到解决方法;阻止;开瓶;说(笑话);使(碳氢化合物)裂化; [adj]训练有素的,技艺高明的,最好的; [add]pl/cracks,pt/cracked,pp/cracked,pr/cracking,s3/cracks;  [or]chem;
crag: [a]/kræɡ/; [n]峭壁;岩石碎块;颈;嗉囊; [add]pl/crags; [or]chem;
cragsman: [a]/'krægzmən/; [n]爬岩名手;善于攀登危岩和峭壁者; [add]pl/cragsmen; [or]chem;
cramp: [a]/kræmp/; [vt]束缚,限制;使.抽筋;以铁箍扣紧; [adj]狭窄的;难解的;受限制的; [add]pl/cramps,pt/cramped,pp/cramped,pr/cramping,s3/cramps;  [or]chem;
creatine: [a]/'kriːətiːn/; [n]肌(氨)酸,肌肉素; [or]chem;
creatinuria: [a]/,kriəti'nju:riə/; [n]肌氨酸尿;肌氨酸尿血症; [or]chem;
cresyl: [a]/'krisɪl/; [n]甲苯基(等于tolyl); [or]chem;
crowbar: [a]/ˈkrəʊbɑː(r)/; [n]撬棍;铁橇;起货钩; [add]pt/crowbarred,pp/crowbarred,pr/crowbarring,pl/crowbars; [or]chem;
crowberry: [a]/'krəʊb(ə)rɪ/; [n]岩高兰,红莓苔子; [add]pl/crowberries; [or]chem;
cryptocrystalline: [a]/,krɪptəʊ'krɪst(ə)laɪn/; [adj](岩石)隐晶质的; [or]chem;
crystallinity: [a]/,krɪstə'lɪnətɪ/; <晶体>结晶度; [or]chem;
crystallizability: [a]/'kristə,laizə'biləti/; [n]可结晶性; [or]chem;
crystallizable: [a]/'krɪstə,laɪzəbl/; [adj]可结晶的; [or]chem;
crystallization: [a]/ˌkrɪstəlaɪˈzeɪʃn/; [n]结晶化;具体化; [or]chem;
crystallize: [a]/ˈkrɪstəlaɪz/; [vt]使结晶;明确;使具体化;做成蜜饯; [vi]结晶,形成结晶;明确;具体化; [add]pt/crystallized,pp/crystallized,pr/crystallizing,s3/crystallizes; [or]chem;
crystallized: [a]/ˈkrɪstəlaɪzd/; [adj]裹有糖霜的;蜜饯的; [v]结晶(crystalize的过去分词); [or]chem;
crystallizer: [a]/'kristəlaizə/; [n]<化工>结晶器;结晶设备; [or]chem;
crystallogeny: [a]/kristə'lɔdʒini/; [n]<晶体>晶体发生学; [or]chem;
crystallogram: [a]/'kristələu,græm/; [n]<晶体>晶体衍射图;<晶体>结晶衍射图; [or]chem;
crystallographic: [a]/,krɪstəlɑ'ɡræfɪk/; [adj]结晶的; [or]chem;
cuirass: [a]/kwɪ'ræs/; [n]胸甲;铁甲; [or]chem;
culmiferous: [a]/kʌl'mifərəs/; [adj]含有碳质页岩的;含有无烟煤的; [or]chem;
culturology: [a]/,kʌltʃə'rɔlədʒi/; [n](美)文化学(社会人类学的一个分支,研究文化现象或体系); [or]chem;
cumberlandite: [a]/'kʌmbələn,dait/; [n]<岩>钛铁橄榄岩;<岩>钛铁长橄岩; [or]chem;
cumbraite: [a]/'kʌmbrə,ait/; [n]培斑安山岩; [or]chem;
cuprammonium: [a]/,kju:prə'məuniəm/; [n]铜氨液; [or]chem;
cuprobismutite: [a]/kju:prə'bizmətait/; [n]铜辉铋矿; [or]chem;
cuprous: [a]/'kjuːprəs/; [adj]<无化>亚铜的;一价铜的; [or]chem;
cyanamide: [a]/saɪ'ænəmaɪd/; [n]氨腈; [or]chem;
cyanidation: [a]/saiəni'deiʃən/; [n]<无化>氰化;<冶>氰化法; [or]chem;
cyanide: [a]/ˈsaɪənaɪd/; [n]<无化>氰化物; [add]pt/cyanided,pp/cyanided,pr/cyaniding,s3/cyanides; [or]chem;
cyanobenzene: [a]/,saiənəu'benzi:n/; [n]苯甲腈; [or]chem;
cyanuramide: [a]/,saiə'njurəmaid/; [n]氰尿酰胺;蜜胺; [or]chem;
cycad: [a]/'saɪkæd/; [n]苏铁属植物; [or]chem;
cyclane: [a]/'saiklein/; [n]环烷烃; [or]chem;
cyclonite: [a]/'saɪklə,naɪt/; [n]黑索今炸药,<化工>旋风炸药(一种高性能的炸药); [or]chem;
cycloolefin: [a]/,saikləu'əuləfin/; [n]环烯; [or]chem;
cymophane: [a]/'saɪməʊ,feɪn/; <宝>金绿宝石; [or]chem;
cytochemistry: [a]/,saɪtəʊ'kemɪstrɪ/; [n]细胞化学,显微生物化学; [or]chem;
dacite: [a]/'deɪsaɪt/; [n]<岩>英安岩;石英安山石; [or]chem;
dalton: [a]/'dɔːlt(ə)n/; [n]道尔顿(英国化学家,物理学家); [or]chem;
dancalite: [a]/'dænkəlait/; [n]方沸粗安岩; [or]chem;
datolite: [a]/'dætə,laɪt/; [n]硅灰硼石;硅钙硼石; [or]chem;
deactivation: [a]/diː,æktɪ'veɪʃən/; [n]<物化>减活化作用;钝化作用; [or]chem;
deading: [a]/'dediŋ/; [n]岩巷掘进;保热套;保温套;褪光; [or]chem;
deaeration: [a]/,di:εə'reiʃən/; [n]<油气><化工>脱气;通风; [or]chem;
dealkylation: [a]/di:ælki'leiʃən/; [n]脱烷基化作用; [or]chem;
deaminase: [a]/di'æmə,nes; di'æmə,nez/; [n]脱氨酶,脱氨基酶; [or]chem;
deaminate: [a]/diː'æmɪneɪt/; [vt]使脱去氨基; [n]脱氨基; [add]pt/deaminated,pp/deaminated,pr/deaminating; [or]chem;
deamination: [a]/di:,æmi'neiʃən/; [n]去氨基;脱氨基作用; [or]chem;
deaminize: [a]/diː'æmɪnaɪz/; [vt]使脱去氨基(等于deaminate); [add]pt/deaminized,pp/deaminized,pr/deaminizing; [or]chem;
decahydronaphthalene: [a]/'dekə,haidrəu'næfθə,li:n/; [n]萘烷;十氢化萘; [or]chem;
decalcomania: [a]/dɪ,kælkə(ʊ)'meɪnɪə/; [n]<陶瓷>印花釉法;贴花纸转印法;贴花转印的图案; [or]chem;
decantation: [a]/,di:kæn'teiʃən/; [n]<化工>倾析;倾注; [or]chem;
decarbonate: [a]/diː'kɑːbəneɪt/; [v]除去碳酸,脱去(溶液,物质等的)二氧化碳; [add]pt/decarbonated,pp/decarbonated,pr/decarbonating; [or]chem;
decyl: [a]/'desəl/; [adj]癸基的,烷基的; [n]癸基,烷基; [or]chem;
decylene: [a]/'di:sailnə/; [n]癸烯; [or]chem;
deflocculation: [a]/dɪ,flɒkjʊ'leɪʃən/; [n]抗絮凝作用;解絮凝;<物化>胶溶作用; [or]chem;
dehydrogenate: [a]/diːhaɪ'drɒdʒəneɪt/; [vt]使脱氢; [add]pt/dehydrogenated,pp/dehydrogenating,pr/dehydrogenate,dehydrogenizing; [or]chem;
dehydrogenization: [a]/di:,haidrə-dʒənai'zeiʃəna/; [n]脱氢作用; [or]chem;
dehydrogenize: [a]/di'haɪdrədʒə,naɪz/; [vt]使脱氢; [add]pt/dehydrogenated,pp/dehydrogenating,pr/dehydrogenate,dehydrogenizing; [or]chem;
delphinine: [a]/'delfɪniːn/; [n]翠雀宁;飞燕草碱; [or]chem;
demineralization: [a]/diːˌmɪnərələˈzeɪʃn/; [n]去矿化作用;除盐作用;失矿质; [or]chem;
demineralize: [a]/ˌdiːˈmɪnərəlaɪz/; [vt]去除矿物质; [add]pt/demineralized,pp/demineralized,pr/demineralizing; [or]chem;
demorphism: [a]/di'mɔ:fizəm/; [n]岩石分解;风化变质作用(等于weathering); [or]chem;
denitrate: [a]/diː'naɪtreɪt/; [vt]除去硝酸或氮化物;使脱硝; [or]chem;
denitrify: [a]/ˌdiːˈnaɪtrɪfaɪ/; [v]除去..中的亚硝酸盐;(使)脱氮; [add]pt/denitrified,pp/denitrified,pr/denitrifying; [or]chem;
deoxidant: [a]/di:'ɔkisdənt/; [n]<助剂>脱氧剂;还原剂; [or]chem;
deoxidizer: [a]/di'ɑksədaɪzɚ/; [n]还原剂,<助剂>脱氧剂; [or]chem;
dephlegmation: [a]/,di:fleɡ'meiʃən/; [n]分馏;<化工>分凝作用; [or]chem;
depolarizer: [a]/di:'pəuləraizə/; [n]<助剂>去极剂;消偏振镜; [or]chem;
depolymerization: [a]/'diː,pɒlɪməraɪ'zeɪʃən/; [n]<高分子>解聚(合)作用; [or]chem;
desiccant: [a]/'desɪk(ə)nt/; [adj]去湿的,使干燥的; [n]<助剂>干燥剂; [or]chem;
desiccative: [a]/,desi'keitiv/; [adj]使干燥的,去湿的; [n]<助剂>干燥剂; [or]chem;
deslime: [a]/di:'slaim/; [vi]除矿泥; [or]chem;
desulphurization: [a]/di,sʌlfərɪ'zeʃən/; [n]脱硫; [or]chem;
desulphurize: [a]/di:'sʌlfjuraiz, -fə-/; [vt]使脱硫; [add]pt/desulphurize,desulphurized,pp/desulphurize,desulphurizing;-rised,pr/desulphurize,desulphurising; [or]chem;
detrital: [a]/dɪ'traɪtl/; [adj]碎屑的;由岩屑形成的; [or]chem;
detrited: [a]/dɪ'traɪtɪd/; [adj]成为岩屑的; [or]chem;
devonite: [a]/de'vəunait/; [n]斜斑粗粒玄武岩;银星石; [or]chem;
devulcanization: [a]/di:vʌlkənai'zeiʃən/; [n]脱硫,反硫化;去硫化; [or]chem;
diabase: [a]/'daɪəbeɪs/; [n]辉绿岩; [or]chem;
diacetate: [a]/dai'æsiteit/; [n]二醋酸盐;双醋酸酯;乙酰乙酸盐; [or]chem;
diacid: [a]/daɪ'æsɪd/; [adj](碱)二元的;二酸的,二盐的; [n]二酸,二酸盐; [or]chem;
diagenetic: [a]/,daiədʒə'netik/; [adj]成岩作用的; [or]chem;
dialkyl: [a]/dai'ælkil/; [n]二烃化物; [adj]二烃基的; [or]chem;
dialogite: [a]/dai'ælədʒait/; [n]菱锰矿; [or]chem;
dialyzate: [a]/dai'ælizeit/; [n]<分化>透析液; [or]chem;
diamine: [a]/daɪ'eɪmiːn; daɪ'æm-; 'daɪəmiːn/; [n]二元胺;<无化>联氨; [or]chem;
diammonium: [a]/daiə'məuniəm/; [n]联胺; [or]chem;
diatomaceous: [a]/,daɪətə'meʃəs/; [adj]硅藻的;含硅藻的;矽藻土的; [or]chem;
diatomic: [a]/ˌdaɪəˈtɒmɪk/; [adj](分子或化合物)双原子的,含双原子的;含两个性质团的; [or]chem;
diazole: [a]/'daɪəzəʊl/; [n]二唑;二唑衍生物; [or]chem;
diazonium: [a]/,daɪə'zəʊnɪəm/; [n]重氮化合物; [adj]重氮化合物的; [or]chem;
diazotization: [a]/daɪ,æzətaɪ'zeɪʃən/; [n]重氮化作用; [or]chem;
diazotize: [a]/daɪ'æzətaɪz/; [v]使重氮化; [add]pt/diazotized,pp/diazotized,pr/diazotizing; [or]chem;
dibasic: [a]/daɪ'beɪsɪk/; [adj]二盐基的;二元的,二碱价的; [or]chem;
dibenzoyl: [a]/dai'benzəuil/; [n]联苯甲酰; [or]chem;
diborate: [a]/dai'bɔ:reit/; [n]二硼酸盐; [or]chem;
dibromide: [a]/daɪ'bromɪd/; [n]<无化>二溴化物; [or]chem;
dicarbonate: [a]/dai'ka:bəneit/; [n]小苏打;<无化>碳酸氢钠; [or]chem;
dichloramine: [a]/dai,klɔ:'ræmi:n/; [n]<无化>二氯胺; [or]chem;
dichloride: [a]/daɪ'klɔːraɪd/; [n]<无化>二氯化合物; [or]chem;
dichromate: [a]/daɪ'krəʊmeɪt/; [n]<无化>重铬酸盐; [or]chem;
dicyanodiamide: [a]/daɪ,saɪə,nəʊdaɪ'æmaɪd/; 双氰胺; [or]chem;
diethyl: [a]/daɪ'ɛθəl/; [adj]二乙基的; [or]chem;
diethylstilbestrol: [a]/daɪ,eθɪlstɪl'bestrɒl/; [n]己烯雌酚;乙芪酚; [or]chem;
digger: [a]/ˈdɪɡə(r)/; [n]挖掘机;挖掘者;矿工;以色相骗钱的女人;扒手; [add]pl/diggers; [or]chem;
diggings: [a]/'dɪgɪŋz/; [n]矿区;发掘物;寓所(原指金矿矿工宿营地); [or]chem;
dihalide: [a]/dai'hælaidl/; [n]<无化>二卤化物;二卤化; [or]chem;
dihydrate: [a]/dai'haidreit/; [n]<无化>二水合物;二水物; [or]chem;
dihydric: [a]/daɪ'haɪdrɪk/; [adj]二羟基的; [or]chem;
dihydrotachysterol: [a]/daɪ,haɪdrotə'kɪstə,rɔl; daɪ,haɪdrotə'kɪstə,rol/; [n]二氢速留醇; [or]chem;
dimethyl: [a]/daɪˈmiːθaɪl/; [adj]二甲基的; [n]乙烷,二甲基; [or]chem;
dimethylaniline: [a]/daɪ,mɛθɪl'ænɪlɪn/; [n]二甲基苯胺; [or]chem;
dimethylbenzene: [a]/dai,meθil'benzi:n/; [n]二甲苯; [or]chem;
dinitrotoluene: [a]/dai,naitrəu'tɔljui:nl/; [n]二硝基甲苯; [or]chem;
dioctahedral: [a]/dai,ɔktə'hi:drəl/; [adj]<晶体>二八面体的; [or]chem;
diolefin: [a]/dəɪ'əʊləfɪn/; [n]二烯; [or]chem;
diorite: [a]/'daɪəraɪt/; [n]<岩>闪长岩;闪绿岩; [or]chem;
dioritic: [a]/,daiə'rittik/; [adj]闪长岩的; [or]chem;
dioxide: [a]/daɪˈɒksaɪd/; [n]二氧化物; [add]pl/dioxides; [or]chem;
diphenol: [a]/dai'fi:nɔl/; [n]联苯酚;二元酚; [or]chem;
diphenyl: [a]/daɪfenɪl/; [n]联苯;二苯基; [or]chem;
diphenylene: [a]/dai'fenəli:n/; [n]二亚苯基; [or]chem;
diphenylmethane: [a]/,dai,fenil'meθein/; [n]二苯基甲烷; [or]chem;
diphosphate: [a]/daɪ'fɑs,fet/; [n]二磷酸;磷酸氢盐; [or]chem;
dipicrylamine: [a]/daɪ'paɪkrɪ,læmiːn/; 二苦胺; [or]chem;
dipole: [a]/ˈdaɪpəʊl/; [n]<物化>偶极;双极子; [or]chem;
discoid: [a]/'dɪskɒɪd/; [adj]平圆形的;盘形药丸;铁饼状的; [or]chem;
discus: [a]/ˈdɪskəs/; [n]铁饼;掷铁饼; [add]pl/discuses或disci; [or]chem;
disilane: [a]/dai'silein/; [n]<无化>乙硅烷; [or]chem;
disilicate: [a]/dai'silikeit/; [n]二矽酸盐; [or]chem;
disilicide: [a]/dai'silisaid/; [n]<无化>二硅化物; [or]chem;
disodium: [a]/daɪ'soʊdiəm/; [n]二钠; [or]chem;
disperser: [a]/dɪs'pɝsɚ/; [n]<助剂>分散剂;分散器;扩散器; [or]chem;
disphenoid: [a]/dai'sfi:nɔid/; [n]复正方楔;复正方榍;<晶体>双半面晶形; [or]chem;
disulphate: [a]/dai'sʌlfeit/; [n]硫酸氢盐; [or]chem;
disulphide: [a]/dai'sʌlfaid/; [n]二硫化物; [or]chem;
diterpene: [a]/dai'tə:pi:n/; [n](化)二萜(烯); [or]chem;
dithionate: [a]/dai'θaiə,neit/; [n]<无化>连二硫酸盐; [or]chem;
dithionite: [a]/dai'θaiə,nait/; [n]连二亚硫酸盐; [or]chem;
ditolyl: [a]/dai'tɔlil/; [n]二甲苯基;联甲苯; [or]chem;
ditroite: [a]/dai'trəuait/; [n]<岩>方钠二霞正长岩; [or]chem;
divine: [a]/dɪˈvaɪn/; [adj]神圣的;非凡的;天赐的;极好的; [vt]占卜;预言;用占卜勘探; [vi]占卜;预言;使用占卜勘探矿; [add]pt/divined,pp/divined,pr/divining,pl/divines,s3/divines;  [or]chem;
divining: [a]/də'vaɪn/; [v](凭直觉)猜测;占卜;(通过探矿术)发现(水源);(用丫形杖)探测(地下水)(divin; [prep]的现在分词); [or]chem;
divinyl: [a]/dai'vainil/; [n]二乙烯基;联乙烯;丁二烯; [or]chem;
dixie: [a]/ˈdɪksi/; [n]迪克西(美国东南部各州的非正式统称);(复数)露营或士兵所用的大铁锅; [adj](与)美国南部(有关)的; [or]chem;
dodecyl: [a]/'dodə,sɪl/; [n]十二烷基; [or]chem;
dogger: [a]/ˈdɒɡə(r)/; [n]双桅荷兰帆船;道格统(沉积岩中的大量球形固结物);猎澳洲野狗的人; [or]chem;
doghole: [a]/'dɔɡhəul/; [n]狗窝;破旧简陋的房屋;不安全的小煤矿; [or]chem;
dolerite: [a]/'dɒləraɪt/; [n]辉绿岩;粗粒玄武岩; [or]chem;
doleritic: [a]/dɑlə'rɪtɪk/; [adj]辉绿岩的;深色火成岩的; [or]chem;
dolina: [a]/də'li:nə/; [n]落水洞;灰岩坑;石灰穴; [or]chem;
doodlebug: [a]/'duːd(ə)lbʌg/; [n]探矿杖;飞弹;短程往返火车; [or]chem;
dopa: [a]/ˈdəʊpə/; [n]多巴;二羟基苯丙氨酸; [or]chem;
downline: [a]/'daun'lain/; [n]沿铁路线;下线; [or]chem;
dowse: [a]/daʊz/; [v]把..浸入水(或其他液体)中;熄灭(灯,火);急降(桅帆)(等于 douse);用探测杆探寻(地下水或矿藏);用魔叉探杆探寻; [add]pt/dowsed,pp/dowsed,pr/dowsing,s3/dowses;  [or]chem;
dundasite: [a]/'dʌndə,sait/; [n]白铅铝矿; [or]chem;
dunite: [a]/'dʌnaɪt/; [n]<岩>纯橄榄岩; [or]chem;
dyestuff: [a]/'daɪstʌf/; [n]染料,<助剂>着色剂; [or]chem;
dysanalyte: [a]/dis'ænəlait/; [n]钛铌铁钙矿;钛铌铁钙石; [or]chem;
dysgenics: [a]/dɪs'dʒenɪks/; [n]劣生学;种族退化学; [or]chem;
ean: [a]/i:n/; [abbr]有效原子序数(Effective Atomic [n]umber);实验过敏性神经炎(Experimental Allergic [n]euritis);  [or]chem;
ebulliometer: [a]/i,bʌli'ɔmitə/; [n]<分化>沸点计,<分化>沸点测定器;酒精测量器; [or]chem;
ebullioscope: [a]/ɪ'bʌlɪəskəʊp/; [n]<分化>沸点测定器; [or]chem;
ebullioscopy: [a]/i'bʌli'ɔskəpi/; [n]<分化>沸点升高测定法; [or]chem;
eclogite: [a]/'eklɒdʒaɪt/; [n]<岩>榴辉岩; [or]chem;
effervescence: [a]/ˌefəˈvesns/; [n]冒泡;<化工>泡腾;欢腾; [or]chem;
effusive: [a]/ɪˈfjuːsɪv/; [adj]流露感激之情的;(火山岩)喷发的;(岩浆)大量喷发的; [or]chem;
effusiveness: [a]/e'fju:sivnis/; [n]热情洋溢;岩石喷发; [or]chem;
eglestonite: [a]/'eɡəlstənait/; [n]氯汞矿; [or]chem;
electrochemical: [a]/ɪ,lɛktro'kɛmɪkl/; [adj]<物化>电化学的;<物化>电气化学的; [or]chem;
electrochemistry: [a]/ɪ,lektrəʊ'kemɪstrɪ/; [n]<物化>电化学; [or]chem;
electrodeposition: [a]/i'lektrəu,depə'ziʃən/; [n]<化工>电沉积;电镀; [or]chem;
electrodialysis: [a]/ɪ,lektrəʊdaɪ'ælɪsɪs/; [n]<物化>电渗析; [add]pl/electrodialyses; [or]chem;
electrography: [a]/i,lek'trɔɡrəfi/; [n]传真电报术;<分化>电谱法;电描记术; [or]chem;
electrokinetics: [a]/ɪ,lektrəʊkaɪ'netɪks/; [n]<物化>动电学; [or]chem;
electroosmosis: [a]/ɪ,lɛktroɑz'mosɪs/; [n]<物化>电渗,<物化>电渗透; [or]chem;
elevated: [a]/ˈelɪveɪtɪd/; [adj]提高的;高尚的;严肃的;欢欣的; [v]提高;抬起;振奋;提拔(elevate的过去分词); [n]高架铁路; [or]chem;
eluate: [a]/'eljuːət; -eɪt/; [n]<分化>洗出液; [or]chem;
elution: [a]/i'lju:ʃən/; [n]<分化>洗脱;<冶>洗提; [or]chem;
elutriator: [a]/i'lju:tri,eitə/; [n]含泥量试验仪;<化工>淘析器; [or]chem;
emeraldine: [a]/'emərəldain/; [n]仿造祖母绿;苯胺绿; [adj]祖母绿一样的;鲜绿的; [or]chem;
enargite: [a]/en'ɑ:dʒait/; [n]硫砷钢矿; [or]chem;
endomorph: [a]/ˈendəʊmɔːf/; [n]内容矿物;胖型体质; [or]chem;
enhydrous: [a]/en'hɑɪdrəs/; [adj]水的;(晶体矿物)含水的; [or]chem;
entrainment: [a]/in'treinmənt/; [n]夹带;<化工>雾沫;带走; [or]chem;
epidiorite: [a]/epə'daɪəraɪt/; 变闪长岩; [or]chem;
erbia: [a]/'ɜːbɪə/; <无化>氧化铒; [or]chem;
ergot: [a]/'ɜːgɒt/; [n]麦角;麦角症;麦角碱; [or]chem;
errite: [a]/'ə:rait/; [n]褐硅锰矿; [or]chem;
erubescite: [a]/i'ru:bi,sait/; [n]斑铜矿; [or]chem;
erythrophleine: [a]/,erɪ'θrɒfleɪn/; 围涎树碱; [or]chem;
erythrosiderite: [a]/i,riθəu'sidərait/; [n]红钾铁盐; [or]chem;
espichellite: [a]/ispi'ʃɛə,lait/; [n]橄闪斑岩; [or]chem;
essexite: [a]/'esik,sait/; [n]碱性辉长岩;<岩>厄塞岩; [or]chem;
ethanal: [a]/,eθə'næl/; [n]乙醛(等于 acetaldehyde); [or]chem;
ethene: [a]/ˈeθiːn/; [n]乙烯(等于ethylene); [or]chem;
ethenyl: [a]/'eθinil/; [n]乙烯基;次乙基; [or]chem;
ethnology: [a]/eθˈnɒlədʒi/; [n]人种学;人类文化学; [or]chem;
ethyl: [a]/ˈeθɪl; ˈiːθaɪl/; [n]乙烷基;含四乙铅的汽车燃料; [or]chem;
ethylene: [a]/ˈeθɪliːn/; [n]乙烯; [or]chem;
ethylenediamine: [a]/,ɛθɪlin,daɪə'mɪn/; [n]乙二胺; [or]chem;
eucrite: [a]/'ju:krait/; [n]<岩>倍长辉长岩;钙长辉长无粒陨石; [or]chem;
euhedral: [a]/ju:'hi:drəl/; [adj]<岩>自形的;全形的; [or]chem;
eurite: [a]/'ju:rait/; [n]霏细岩; [or]chem;
evansite: [a]/'evənzait/; [n]核磷铝石,核磷酸铝石; [or]chem;
exsiccator: [a]/'eksɪ,keɪtə/; [n]除湿剂;<化工>除湿器; [or]chem;
extruder: [a]/ek'struːdə/; [n]<塑料>挤出机;挤压机; [or]chem;
farriery: [a]/'færɪərɪ/; [n]马掌铺;蹄铁场;蹄铁术; [or]chem;
fasibitikite: [a]/fæsi'baiti,kait/; [n]负异钠闪花岗岩;负异钠花岗岩;钠闪锥辉花岗岩; [or]chem;
felsitic: [a]/fɛl'sɪtɪk/; [adj]霏细岩的;致密长石的; [or]chem;
felsophyric: [a]/felsə'fairik/; [adj]霏细斑岩的;<岩>隐晶基斑状的; [or]chem;
femic: [a]/'femik/; [adj]铁镁质的; [or]chem;
fenite: [a]/'fenait/; [n]长霓岩; [or]chem;
fergusite: [a]/'fə:gjusait/; [n]假白榴等色岩; [or]chem;
ferrate: [a]/'fereɪt/; [n]高铁酸盐,铁酸盐; [or]chem;
ferreous: [a]/'ferɪəs/; [adj]铁的;含铁的;硬如铁的; [or]chem;
ferric: [a]/'ferɪk/; [adj]铁的;<无化>三价铁的;含铁的; [gd]un; [or]chem;
ferricyanide: [a]/,ferɪ'saɪənaɪd/; [n]<无化>铁氰化物; [or]chem;
ferriferous: [a]/fe'rɪfərəs/; [adj]含铁的,含有三价铁的; [or]chem;
ferrite: [a]/ˈferaɪt/; [n]铁酸盐;铁素体; [or]chem;
ferroaluminum: [a]/ferɔ'æljuminiəm/; [n]铝铁; [or]chem;
ferrocalcite: [a]/,ferə'kælsait/; [n]铁方解石; [or]chem;
ferrochrome: [a]/ˌfɛrəʊˈkrəʊmɪəm/; [n]铬铁;铬铁合金; [or]chem;
ferrocyanide: [a]/,ferəʊ'saɪənaɪd/; [n]氰亚铁酸盐;<无化>亚铁氰化物; [or]chem;
ferromagnesian: [a]/,ferə(ʊ)mæg'niːʒ(ə)n; -zɪən/; [adj]含有铁与镁的; [n]铁镁矿物; [or]chem;
ferromanganese: [a]/ferəʊ'mæŋɡəniːz/; [n]锰铁;铁锰齐; [or]chem;
ferromolybdenum: [a]/,fεrəumə'libdinəm/; [n]钼钢;铁铜齐; [or]chem;
ferrosilicon: [a]/ferəʊ'sɪlɪkɒn/; [n]硅铁合金; [or]chem;
ferrotitanium: [a]/,ferəutai'teiniəm/; [n]铁钛合金; [or]chem;
ferrovanadium: [a]/,ferəvə'nædiəm/; [n]铁钒; [or]chem;
ferruginous: [a]/fe'ruːdʒɪnəs/; [adj]铁的;铁锈的;含铁的; [or]chem;
ferrum: [a]/'ferəm/; [n]铁; [or]chem;
filterability: [a]/,filtərə'biləti/; [n]过滤性;<化工>可滤性;滤过率; [or]chem;
filtering: [a]/'fɪltərɪŋ/; [v]<化工>过滤,滤除(filter的ing形式); [or]chem;
fissile: [a]/ˈfɪsaɪl/; [adj](原子或元素)可裂变的;(尤指岩石)易裂的,可裂的; [or]chem;
fissure: [a]/ˈfɪʃə(r)/; [n]裂缝,(尤指岩石上的)裂沟;分歧; [v](使)裂开,分裂; [add]pt/fissured,pp/fissured,pr/fissuring,pl/fissures,s3/fissures; [or]chem;
flagstone: [a]/ˈflæɡstəʊn/; [n]石板;<岩>薄层砂岩; [add]pl/flagstones; [or]chem;
flask: [a]/flɑːsk/; [n]<分化>烧瓶;长颈瓶,细颈瓶;酒瓶,携带瓶; [add]pl/flasks; [or]chem;
floatation: [a]/fləʊ'teɪʃən/; [n]<物化>浮选;漂浮性; [or]chem;
flow: [a]/fləʊ/; [v](使)流动,涌流;流通;传播;流畅;充满;大量供应;涨;涨潮;川流不息;飘扬;来自,由..产生;来月经;(矿物,岩石等)变形; [add]pt/flowed,pp/flowed,pr/flowing,s3/flows;  [or]chem;
fluorobenzene: [a]/,fluərəu'bænzili:n/; [n]氟苯,氟代苯; [or]chem;
fluoroborate: [a]/,flu:ərə'bɔ:reit/; [n]氟硼酸盐; [or]chem;
fold: [a]/fəʊld/; [v]折叠;可折叠;包;倒闭,停业;结束;把..调入;拥抱;突然不在状态;将牌面朝下表示放弃一盘; [n]褶层;褶痕;羊圈;(地壳岩石层的)褶皱;山坳;折起的纸(或布); [add]pt/folded,pp/folded,pr/folding,s3/folds; [or]chem;
formaldoxime: [a]/,fɔ:mæl'dɔksaim/; [n]甲醛肟; [or]chem;
formanilide: [a]/fɔ:'mænilaid/; [n]甲酰苯胺; [or]chem;
formose: [a]/'fɔ:məus/; [n]甲醛聚糖;福模糖; [or]chem;
fortifier: [a]/'fɔrtə,faɪɚ/; [n]筑城者;强化物;<助剂>增强剂;加固物; [add]pl/fortifiers; [or]chem;
fortunite: [a]/'fɔ:tʃənait/; 金云粗面岩;橄榄金云煌斑岩; [or]chem;
fossick: [a]/ˈfɒsɪk/; [v](非正式)搜寻;(在废矿中)淘金; [add]pt/fossicked,pp/fossicked,pr/fossicking,s3/fossicks; [or]chem;
foyaite: [a]/fɔi'eit/; [n]良正长岩;<岩>流霞正长岩; [or]chem;
fra: [a]/frɑ:/; [abbr]联邦铁路局(Federal Railroad Administration);联邦储备法(Federal Reserve Act);流量警报记录器(Flow Alarm Recorder);自由基型(Free Radical Type);  [or]chem;
francium: [a]/ˈfrænsiəm/; [n]元素钫; [or]chem;
frenzelite: [a]/'frenzə,lait/; [n]硒铋矿; [or]chem;
frother: [a]/'frɔðə/; [n]<助剂><矿业>起泡剂;<助剂>起沫剂;泡沫发生剂; [or]chem;
fuchsin: [a]/'fuːksiːn/; [n]碱性品红;洋红; [or]chem;
fuchsine: [a]/'fu:ksi(:)n/; [n]碱性品红,洋红; [or]chem;
fucose: [a]/'fjʊ,kos/; [n]海藻糖;岩藻糖; [or]chem;
fulgurite: [a]/'fʌlgjʊraɪt/; [n]闪电管石,闪电熔岩;闪电管石块; [or]chem;
fuller: [a]/'fʊlə/; [v]用套锤锻制(铁);用套锤在..上开凿;  [or]chem;
fulminate: [a]/ˈfʊlmɪneɪt; ˈfʌlmɪneɪt/; [vi]爆炸;电闪;怒喝; [vt]使爆发;以严词谴责; [n]雷酸盐;烈性炸药; [add]pt/fulminated,pp/fulminated,pr/fulminating,pl/fulminates,s3/fulminates; [or]chem;
funicular: [a]/fjuːˈnɪkjələ(r)/; [n]缆索铁道; [adj]用缆索牵引的;绳索的;绳索张力的; [or]chem;
furfuraldehyde: [a]/,fə:fə'rældə,haid/; [n]糠醛; [or]chem;
gabbroid: [a]/'ɡæbrɔid/; [adj]似辉长岩的; [or]chem;
gaize: [a]/geiz/; [n]云母海绿石质砂岩;生物旦白岩; [or]chem;
galactite: [a]/gə'læktait/; [n]针钠沸石; [or]chem;
gallate: [a]/'gælet/; [n]没食子酸盐;五倍子酸盐; [or]chem;
gambrel: [a]/'gæmbr(ə)l/; [n]踝关节;马脚状的铁钩;复折屋顶; [or]chem;
gange: [a]/ɡændʒ/; [v]以细铁丝保护;用细金属线加固钓钩; [add]pt/ganged,pp/ganged,pr/ganging;  [or]chem;
ganister: [a]/'gænɪstə/; [n]<岩>致密硅岩;硅火泥(耐火性很强用作锅炉内侧衬料); [or]chem;
gavelock: [a]/'ɡævəlɔk/; [n]铁撬,铁杆; [or]chem;
gaylussite: [a]/'ɡeilə,sait/; [n]单斜钠钙石;斜碳钠钙石; [or]chem;
gelation: [a]/dʒə'leɪʃ(ə)n/; [n]<物化>凝胶化;冻结; [or]chem;
gemmology: [a]/dʒɛ'mɑlədʒi/; [n]<宝>宝石学; [or]chem;
geochemical: [a]/,dʒi:ə'kemikəl/; [adj]地球化学的; [or]chem;
geochemistry: [a]/dʒiːəʊ'kemɪstrɪ/; [n]地球化学; [or]chem;
geognosy: [a]/dʒɪ'ɒɡnəsɪ/; [n]地球构造学;地质学;岩石学; [or]chem;
geranial: [a]/dʒə'reniəl/; [n]香叶醛;牻牛儿醛; [or]chem;
gibelite: [a]/'gibəlait/; [n]歪长粗面岩; [or]chem;
gladkaite: [a]/'glædkə,ait/; [n]英斜煌岩;英斜闪煌岩; [or]chem;
glassmaking: [a]/'ɡlæs,mekɪŋ/; [n]<玻璃>玻璃制造术; [or]chem;
glimmerite: [a]/'glimə,rait/; [n]云母岩; [or]chem;
glockenspiel: [a]/ˈɡlɒkənʃpiːl/; [n]钟琴,铁琴;键盘式钟琴; [add]pl/glockenspiels; [or]chem;
glucinum: [a]/ɡluː'saɪnəm/; 铍; [or]chem;
glutamine: [a]/'gluːtəmiːn/; [n]谷氨酰胺; [or]chem;
glyceryl: [a]/'glɪs(ə)raɪl; -rɪl/; [n]丙三基,甘油基; [adj]甘油基的; [or]chem;
glycocoll: [a]/'ɡlaikəukɔl/; [n]氢氨乙酸; [or]chem;
glycolate: [a]/'ɡlaikəleit/; [n]羟乙酸盐或酯;乙醇酸盐或酯; [or]chem;
gneiss: [a]/naɪs/; [n]片麻岩; [or]chem;
gneissic: [a]/'naisik/; [adj]片麻岩的,似片麻岩的; [or]chem;
gneissoid: [a]/'naɪsɔɪd/; [adj]像片麻岩的(指结构等); [or]chem;
gneissose: [a]/'naɪsəʊs/; 片麻岩的; [or]chem;
goaf: [a]/gof/; [n]废矿; [add]pl/goafs或goaves; [or]chem;
gothite: [a]/'gəutait/; [n]针铁矿(等于goethite); [or]chem;
graining: [a]/'ɡreɪnɪŋ/; [n]粒化;漆纹理;结晶; [v]使.成颗粒;结晶(grain的ing形式); [or]chem;
grampus: [a]/'græmpəs/; [n]逆戟鲸;呼吸声粗重的人;大铁钳; [add]pl/grampuses; [or]chem;
graniteware: [a]/'grænɪtweə/; [n]有花岗岩般斑纹的陶器;涂有瓷釉的铁器器皿;花岗石纹的法琅铁器; [or]chem;
granitic: [a]/grə'nɪtɪk/; [adj]花岗石的;由花岗岩形成的; [or]chem;
granitoid: [a]/'ɡrænɪtɒɪd/; [adj]花岗岩状的,似花岗石的; [n]花岗岩类岩石; [or]chem;
granodiorite: [a]/,grænə(ʊ)'daɪəraɪt/; [n]<岩>花岗闪长岩; [or]chem;
granolithic: [a]/,ɡrænəu'liθik/; [n]花岗岩混凝土(或铺面); [adj]含有碎花岗岩的;用人造花岗岩铺成的; [or]chem;
granophyre: [a]/'ɡrænəʊfaɪə/; <岩>花斑岩; <岩>文象斑岩; [or]chem;
granularity: [a]/grænjʊ'lærɪtɪ/; [n]间隔尺寸,<岩>粒度; [or]chem;
granulite: [a]/'grænjʊlaɪt/; [n]<岩>麻粒岩;粒变岩; [or]chem;
graphitization: [a]/,ɡræfɪtɪ'zeʃən/; [n]<化工><冶>石墨化; [or]chem;
graywacke: [a]/'ɡreɪ,wækə/; [n]杂砂岩;硬砂岩(等于greywacke); [or]chem;
griddle: [a]/ˈɡrɪdl/; [n]矿筛;煎饼用浅锅; [vt]筛; [vi]用锅煎; [add]pt/griddled,pp/griddled,pr/griddling; [or]chem;
grike: [a]/ɡraɪk/; 岩溶沟; [or]chem;
gritstone: [a]/'ɡristəun/; [n]粗砂岩; [or]chem;
grush: [a]/grʌʃ/; [n]花岗岩碎砾; [or]chem;
habilitate: [a]/hə'bɪlɪteɪt/; [v]取得任职资格;(使)合适,有能力;给..穿衣;给(煤矿)提供设备(或资金); [add]pt/habilitated,pp/habilitated,pr/habilitating,s3/habilitates; [or]chem;
hade: [a]/heɪd/; [n]偃角(矿脉与垂直面所成的斜角); [vi]矿井断层等倾斜; [add]pt/haded,pp/haded,pr/hading; [or]chem;
halite: [a]/'hælaɪt/; [n]岩盐; [or]chem;
hammerman: [a]/'hæməmən/; [n]锻工;铁腕人物; [add]pl/hammermen; [or]chem;
handcar: [a]/'hænd,kɑr/; [n](美)(铁路线检查和工人交通用的)手摇车; [or]chem;
harmine: [a]/'hɑ:mi:n, -min/; [n]肉叶芸香碱;骆驼蓬碱; [or]chem;
harrisite: [a]/'hærisait/; [n]方铜矿;方辉铜矿; [or]chem;
hartshorn: [a]/'hɑːts,hɔːn/; [n]鹿角精;鹿角;氨水溶液; [or]chem;
harzburgite: [a]/'hɑ:z,bə:ɡait/; [n]<岩>斜辉橄榄岩;<岩>方辉橄榄岩; [or]chem;
hasp: [a]/hɑːsp/; [n](门,盖等的)搭扣,铁扣; [v]把铁扣或搭扣扣上; [add]pl/hasps,pt/hasped,pp/hasped,pr/hasping,s3/hasps; [or]chem;
hatchettolite: [a]/'hætʃətəu,lait/; [n]铀钽铌矿; [or]chem;
hawkbill: [a]/'hɔ:kbil/; [n]坩埚钳;焊钳,铁钳; [or]chem;
haywire: [a]/ˈheɪwaɪə(r)/; [adj](非正式)天马行空的,不受控制的; [adv](非正式)天马行空地,不受控制地; [n]捆干草用的铁丝; [or]chem;
headlight: [a]/ˈhedlaɪt/; [n]汽车等的前灯;前灯的光束;船上的桅灯;矿工和医生用的帽灯; [add]pl/headlights; [or]chem;
heathberry: [a]/'hiθ,bəri/; [n]岩高兰之类;欧石南属植物的浆果(尤指乌饭树浆果); [add]pl/heathberries; [or]chem;
heintzite: [a]/'haintsait/; [n]硼钾镁石; [or]chem;
heme: [a]/hiːm/; [n]亚铁血红素; [or]chem;
hemiacetal: [a]/,hemi'æsitæl/; [n](化)半缩醛; [or]chem;
hemicrystalline: [a]/ˌhɛmɪˈkrɪstəˌlaɪn/; [adj]半结晶的,<岩>半晶质的; [or]chem;
hemiprism: [a]/,hemi'prizəm/; [n]半柱;半棱晶;<晶体>半棱柱;半棱柱体; [or]chem;
hemosiderosis: [a]/,hɛmo,sɪdə'rosɪs/; [n]血铁质;含铁血黄素沉着; [or]chem;
heronite: [a]/'herə,nait/; [n]正长球粒霞霓岩;正长球粒浅成岩; [or]chem;
heterogeneous: [a]/ˌhetərəˈdʒiːniəs/; [adj]由很多种类组成的,混杂的;各种各样的;(化学)不均一的,多相的;(数学)不纯一的,参差的; [or]chem;
heterotopic: [a]/,hɛtərə'topɪk/; [adj]异位的;异位素的;异原子序的; [or]chem;
hewer: [a]/'hjʊɚ/; [n]煤矿工;砍伐者; [or]chem;
hexad: [a]/'heksæd/; [n]六价原子;六个一组; [or]chem;
hexamethylenetetramine: [a]/'heksə,meθəliːn'tetrəmiːn/; [n]环六亚甲基四胺; [or]chem;
hexoctahedron: [a]/'heksəuktə,hedrɔn/; [n]<晶体>六八面体; [or]chem;
hexogen: [a]/'heksədʒən/; [n]黑索今,环三亚甲基三硝基胺;黑素金炸药; [or]chem;
hexosamine: [a]/hek'sɔsəmi:n/; [n]己醣胺,氨基己醣; [or]chem;
hiddenite: [a]/'hɪd(ə)naɪt/; [n]希登石;<宝>翠绿锂辉石; [or]chem;
hielmite: [a]/'hi:lmait/; [n]钙铌钽矿; [or]chem;
hieratite: [a]/'haiərətait/; [n]氟硅钾石,氟矽钾石; [or]chem;
hintzeite: [a]/'hin(t)sə,ait/; [n]硼钾镁石; [or]chem;
histochemical: [a]/,hɪstə'kɛmɪkəl/; [adj]组织化学的; [or]chem;
holoclastic: [a]/,hɒləʊ'klæstɪk/; 全碎屑岩; [or]chem;
holocrystalline: [a]/,hɔləu'kristəlain/; [adj]<岩>全晶质的,全晶的; [or]chem;
holohyaline: [a]/,hɔləu'haiəlin/; [adj]<岩>全玻质的; [or]chem;
holomorph: [a]/'hɔləmɔ:f/; [n]全型;<晶体>全形; [or]chem;
hoodoo: [a]/ˈhuːduː/; [n]招来不幸的人,不祥的人;伏都教;魔法,巫术;(岩石风化而成的)圆柱岩石,尖顶岩石; [v]使倒霉;蛊惑,迷惑; [add]pl/hoodoos,pt/hoodooed,pp/hoodooed,pr/hoodooing,s3/hoodoos; [or]chem;
hoop: [a]/huːp/; [n]箍;铁环;呼呼声; [vt]加箍于;包围; [vi]发呼呼声; [add]pl/hoops; [or]chem;
hornfels: [a]/'hɔrnfɛls/; [n]<岩>角页岩; [or]chem;
hornito: [a]/hɔː'niːtəʊ/; [n]溶岩滴丘; [add]pl/hornitos; [or]chem;
horseshoe: [a]/ˈhɔːsʃuː; ˈhɔːʃʃuː/; [n]马蹄铁;U形物; [v]装蹄铁于..; [add]pt/horseshoed,pp/horseshoed,pr/horseshoeing,pl/horseshoes; [or]chem;
hortite: [a]/'hɔ:tait/; [n]方解辉长混杂岩;暗色正长岩; [or]chem;
howlite: [a]/'haulait/; [n]硅硼钙石; [or]chem;
hubnerite: [a]/'hʌbnə,rait/; [n]钨锰矿; [or]chem;
hudsonite: [a]/'hʌdsənait/; [n]角闪橄榄岩,黑铁辉石; [or]chem;
humate: [a]/'hjuːmeɪt/; [n]腐殖酸盐;腐殖酸酯; [or]chem;
humectant: [a]/hjuːˈmektənt/; [adj]湿润的;湿润剂的; [n]<助剂>湿润剂; [or]chem;
hush: [a]/hʌʃ/; [v]安静;(使)安静,停止说话;用水清洗矿石; [n]寂静,安静;(人造的)喷水; [int]嘘;别作声; [add]pl/hushes,pt/hushed,pr/hushing,s3/hushes; [or]chem;
hutch: [a]/hʌtʃ/; [n]笼;小屋;贮藏箱;矿车; [vt]把.装箱; [add]pl/hutches; [or]chem;
hyacinth: [a]/ˈhaɪəsɪnθ/; [n]风信子;<宝>红锆石;紫蓝色; [add]pl/hyacinths; [or]chem;
hydracid: [a]/haɪ'dræsɪd/; [n]氢酸; [or]chem;
hydrastine: [a]/haɪ'dræstiːn/; [n]白毛莨碱;黄连碱;金印草素; [or]chem;
hydrazine: [a]/'haɪdrəziːn/; [n]<无化>肼;<无化>联氨;酰肼; [or]chem;
hydric: [a]/'haɪdrɪk/; [adj]氢气的;含氢的; [or]chem;
hydride: [a]/'haɪdraɪd/; [n]<无化>氢化物; [or]chem;
hydrindene: [a]/'haidrindi:n/; [n]二氢化茚; [or]chem;
hydrocarbonate: [a]/,haidrə'ka:bə,neit/; [n]碳酸氢盐;酸性碳酸盐;重碳酸盐; [or]chem;
hydrochloric: [a]/,haɪdrəʊ'klɒrɪk/; [adj]氯化氢的,盐酸的; [or]chem;
hydrochloride: [a]/,haɪdrə(ʊ)'klɔːraɪd/; [n]盐酸盐;盐酸化物;氢氯化物; [or]chem;
hydroforming: [a]/'haɪdrəʊ,fɔːmɪŋ/; [n]<油气>加氢重整; [v]液压成形(hydroform的ing形式); [or]chem;
hydrogel: [a]/'haɪdrə(ʊ)dʒel/; [n]<物化>水凝胶; [or]chem;
hydrogenate: [a]/haɪ'drɒdʒəneɪt; 'haɪdrədʒəneɪt/; [v](使)氢化,(使)与氢结合; [add]pt/hydrogenated,pp/hydrogenated,pr/hydrogenating,s3/hydrogenates; [or]chem;
hydrogenator: [a]/haidrə'dʒeneitə/; [n]氢化器; [or]chem;
hydrogenic: [a]/haidrə'dʒenik/; [adj]水成的,类似氢的; [or]chem;
hydrogenium: [a]/,haidrəu'dʒi:niəm/; [n]氢(一种化学元素);氢气; [or]chem;
hydrogenization: [a]/,haɪdrədʒɪnɪ'zeʃən/; [n]加氢;氢化; [or]chem;
hydrogenize: [a]/'haɪdrədʒɪnaɪz/; [vt]使与氢化合(等于hydrogenate); [add]pt/hydrogenized,pp/hydrogenized,pr/hydrogenizing; [or]chem;
hydrogenolysis: [a]/,haɪdrodʒə'nɑlɪsɪs/; [n]氢解作用; [add]pl/hydrogenolyses; [or]chem;
hydrogenous: [a]/haɪ'drɑdʒənəs/; [adj]氢的;含氢的; [or]chem;
hydrolysis: [a]/haɪˈdrɒlɪsɪs/; [n]水解作用; [add]pl/hydrolyses; [or]chem;
hydrolyte: [a]/'haɪdrəlaɪt/; [n]水解质;被水解之物质; [or]chem;
hydrolytic: [a]/,haidrə'litik/; [adj]水解的,水解作用的; [or]chem;
hydrolyzate: [a]/haɪ'drɒlɪzeɪt/; [n]水解产物; [or]chem;
hydrolyze: [a]/'haɪdrəlaɪz/; [vi]水解; [vt]使水解; [add]pt/hydrolyzed,pp/hydrolyzed,pr/hydrolyzing,s3/hydrolyzes; [or]chem;
hydroperoxide: [a]/,haidrəupə'rɔksaid/; [n]<无化>氢过氧化物; [or]chem;
hydrosulphate: [a]/,haɪdrəʊ'sʌlfeɪt/; 硫酸氢盐; [or]chem;
hydrosulphide: [a]/,haidrəu'sʌlfaid/; [n]<无化>氢硫化物; [or]chem;
hydrosulphite: [a]/,haidrəu'sʌlfait/; [n]亚硫酸氢盐; [or]chem;
hydroxide: [a]/haɪˈdrɒksaɪd/; [n]<无化>氢氧化物;羟化物; [or]chem;
hydroxy: [a]/haɪ'drɒksɪ/; [adj]氢氧根的; [or]chem;
hydroxyl: [a]/haɪ'drɒksaɪl; -sɪl/; [n]羟基,氢氧基; [or]chem;
hyperoxide: [a]/,haipə'rɔksaid/; [n]过氧化物; [or]chem;
hypnone: [a]/'hɪpnon/; [n]苯乙酮; [or]chem;
hypobromite: [a]/,haipəu'brəumait/; [n]<无化>次溴酸盐; [or]chem;
hypochlorite: [a]/,haɪpəʊ'klɔːraɪt/; [n]<无化>次氯酸盐;低氧化氯; [or]chem;
hypocrystalline: [a]/,haipə'kristəlain/; [adj]<岩>半晶质的; [or]chem;
hypogene: [a]/'haɪpə(ʊ)dʒiːn/; [adj]深成的;地面下形成的; [n]深生岩; [or]chem;
hyponitrite: [a]/,haɪpə'naɪtraɪt/; [n]连二次硝酸盐; [or]chem;
hypophosphate: [a]/,haɪpəʊ'fɒsfeɪt/; [n]<无化>连二磷酸盐; [or]chem;
hypophosphite: [a]/,haɪpə'fɒsfaɪt/; [n]<无化>次磷酸盐; [or]chem;
hyposulphite: [a]/,haipəu'sʌlfait/; [n]硫代硫酸钠(等于sodium thiosulphate);连二亚硫酸盐(等于hydrosulphite); [or]chem;
hyrax: [a]/ˈhaɪræks/; [n]蹄兔;岩狸; [add]pl/hyraxes或hyraces; [or]chem;
ijolite: [a]/'ijəlait/; [n]<岩>霓霞岩; [or]chem;
ijussite: [a]/'idʒu,sait/; [n]棕闪钛辉岩; [or]chem;
imidazole: [a]/,ɪmɪ'deɪzəʊl; ɪ'mɪdəzəʊl/; [n]咪唑;异吡唑; [or]chem;
imino: [a]/ɪ'miːnəʊ/; [adj](与)亚氨基(有关)的,含亚氨基的; [or]chem;
immunochemistry: [a]/,ɪmjʊnəʊ'kemɪstrɪ; ɪ,mjuːnəʊ-/; [n]免疫化学; [or]chem;
indamine: [a]/'ɪndəmiːn/; [n]引达胺(一种染料); [or]chem;
indanthrene: [a]/in'dænθri:n/; [n]<染料>阴丹士林,靛蒽醌; [or]chem;
indazole: [a]/'indəzəul/; [n]吲唑; [or]chem;
indophenol: [a]/,ɪndəʊ'fiːnɒl/; [n]<染料>靛酚;靛酚染料; [or]chem;
induline: [a]/'ɪndjʊliːn/; [n]对氮蒽蓝;<染料>引杜林染料; [or]chem;
inhibitor: [a]/ɪnˈhɪbɪtə(r)/; [n]<助剂>抑制剂,抗化剂;抑制者; [or]chem;
inorganic: [a]/ˌɪnɔːˈɡænɪk/; [adj]<无化>无机的;无生物的; [or]chem;
inoxidize: [a]/ɪn'ɑksədaɪz/; [vt]使.不受氧化; [add]pt/inoxidized,pp/inoxidized,pr/inoxidizing; [or]chem;
interatomic: [a]/,ɪntərə'tɒmɪk/; [adj]原子间的; [or]chem;
interchange: [a]/ˈɪntətʃeɪndʒ/; [n](思想,信息等的)交换,互换;交错,更替;(进出高速公路的)互通式立交,立体交叉道;(铁路,汽车客运等)转车站,枢纽站; [v]交换,互换(思想,信息等);将..交换;(使)互换位置; [add]pt/interchanged,pp/interchanged,pr/interchanging,pl/interchanges,s3/interchanges; [or]chem;
intercrystalline: [a]/,intə'kristəlain/; [adj]晶间的;沿晶界的; [n]内结晶; [or]chem;
internuclear: [a]/,ɪntɚ'nʊkliɚ; ,ɪntɚ'njʊkliɚ/; [adj](原子)<物化>核间的;(细胞)<物化>核间的;视网膜核层间的; [or]chem;
interpolymer: [a]/'intə,pɔlimə/; [n]<高分子>互聚物; [or]chem;
interstratify: [a]/,ɪntɚ'strætə,fai/; [v](地质学)放(岩层)在地层间;安排于隔层之间; [add]pt/interstratified,pp/interstratified,pr/interstratifying; [or]chem;
interurban: [a]/,ɪntə'ɜːbən/; [n]市间铁路; [adj]都市间的; [or]chem;
inverse: [a]/ˌɪnˈvɜːs/; [adj]相反的;倒转的; [n]相反;倒转;反面;相反的事物;倒数;逆元素; [add]pt/inversed,pp/inversed,pr/inversing,s3/inverses; [or]chem;
iodate: [a]/'aɪədeɪt/; [n]<无化>碘酸盐; [vt]以碘处理; [add]pt/iodated,pp/iodated,pr/iodating; [or]chem;
iodide: [a]/ˈaɪədaɪd/; [n]碘化物;碘负离子;氢碘酸盐; [or]chem;
iodoxybenzene: [a]/'aɪə,dɒksɪ'benziːn/; 碘酰苯; [or]chem;
ionium: [a]/aɪ'əʊnɪəm/; [n]锾(一种化学元素,第90号元素钍的放射性同位素); [or]chem;
ionizer: [a]/ˈaɪənaɪzər/; [n]<化工>电离剂;离子发生器; [add]pl/ionizers; [or]chem;
iron: [a]/ˈaɪən/; [vt]熨;用铁铸成; [adj]铁的;残酷的;刚强的; [vi]熨衣;烫平; [add]pl/irons,pt/ironed,pp/ironed,pr/ironing,s3/irons;  [or]chem;
ironbound: [a]/'aɪənbaʊnd/; [adj]坚硬的;包铁的;戴镣铐的;岩石围绕的; [or]chem;
ironman: [a]/'aiənmən/; [n]钢铁人;钢铁侠; [or]chem;
ironmaster: [a]/'aɪənmɑːstə/; [n]铁工厂厂长;铁器制造商;铁匠镇; [or]chem;
ironmongery: [a]/ˈaɪərnmɑːŋɡəri/; [n]铁器店;铁器类;五金器件; [add]pl/ironmongeries; [or]chem;
ironsides: [a]/'aɪənsaɪdz/; [n]铁甲军;勇敢果断的人;装甲舰; [or]chem;
ironsmith: [a]/'aɪənsmɪθ/; [n]铁匠,锻工; [or]chem;
ironstone: [a]/ˈaɪənstəʊn/; [n]铁矿石; [or]chem;
ironware: [a]/'aɪənweə/; [n]五金;铁器;金属器具; [or]chem;
ironwork: [a]/ˈaɪənwɜːk/; [n]铁制品; [or]chem;
ironworker: [a]/'aɪən,wɜːkə/; [n]钢铁工人; [or]chem;
ironworks: [a]/ˈaɪənwɜːks/; [n]钢铁厂;铁工厂; [add]pl/ironworks; [or]chem;
irony: [a]/ˈaɪrəni/; [n]讽刺;反语;具有讽刺意味的事; [adj]铁的;似铁的; [add]pl/ironies; [or]chem;
isatin: [a]/'aɪsətɪn/; [n]<染料>靛红; [or]chem;
isobaric: [a]/,aɪsə'bærɪk/; [adj]同重元素的;表示等压的; [n]等压线; [or]chem;
isobutyrate: [a]/,aisəu'bju:tireit/; [n]异丁酸盐; [or]chem;
isocyanate: [a]/aɪsə(ʊ)'saɪəneɪt/; [n]<无化>异氰酸盐; [or]chem;
isocyanide: [a]/,aisəu'saiənaid/; [n]异腈;<无化>异氰化物; [or]chem;
isomorphism: [a]/,aɪsəʊ'mɔːfɪzəm/; [n]类质同像,<物化>类质同晶;同形; [or]chem;
isopropenyl: [a]/aisə'prɔpənil/; [n]异丙烯基; [or]chem;
isothiocyanates: [a]/'aisəu,θaiəu'saiəneit/; [n]<无化>异硫氰酸盐;<无化>异硫氰酸酯; [or]chem;
isotypic: [a]/,aisə'tipik/; [adj]<晶体>同型的;代表性图表或记号的; [or]chem;
isoxazole: [a]/ai'sɔksə,zəul/; [n]异恶唑; [or]chem;
issite: [a]/'i:sait/; [n]<岩>暗闪辉长岩,<岩>辉长角闪石岩; [or]chem;
itabirite: [a]/,i:tə'birait/; [n]<岩>铁英岩; [or]chem;
itacolumite: [a]/,ɪtə'kɒljʊmaɪt/; [n]<岩>可弯砂岩; [or]chem;
jadeite: [a]/'dʒeɪdaɪt/; [n]翡翠;<宝>硬玉; [or]chem;
jambalaya: [a]/ˌdʒæmbəˈlaɪə/; [n](美国南部的)什锦饭(用米饭,海鲜,鸡肉等加香料制作而成);各种元素(或物质)的混合物; [or]chem;
jap: [a]/dʒæp/; [n]手持式凿岩机;日本的椰子牛轧糖; [add]pt/japped,pp/japped,pr/japping; [or]chem;
jasperoid: [a]/'dʒæspərɔid/; [n]<宝>碧玉;碧玉状; [or]chem;
jaspilite: [a]/'dʒæspɪlaɪt/; [n]碧玉铁质岩(等于jaspilyte); [or]chem;
jezekite: [a]/'dʒezə,kait/; [n]柱晶磷矿;红磷盐矿,红磷钠矿; [or]chem;
joseite: [a]/ʒə'ʒei,ait/; [n]硫锑铋矿; [or]chem;
junkman: [a]/'dʒʌŋkmæn/; [n]拾破烂者;拾废铁者; [add]pl/junkmen; [or]chem;
kafir: [a]/ˈkæfɪə(r)/; [n]卡菲尔人;南非矿山股票;南非黑人; [or]chem;
kalium: [a]/'keɪlɪəm/; [n]钾(19号元素, 符号K); [or]chem;
karstenite: [a]/'ka:stə,nait/; [n]硬石膏;硬石膏岩; [or]chem;
kasolite: [a]/'kæsəulait/; [n]矽铅铀矿; [or]chem;
kentledge: [a]/'kentlɪdʒ/; [n]压舱用铁块; [or]chem;
kenyte: [a]/'ki:nait/; [n]<岩>霓橄粗面岩;霓橄响斑岩; [or]chem;
keralite: [a]/'kerə,lait/; [n]英云角页岩; [or]chem;
kermes: [a]/'kɜːmɪz/; [n]胭脂虫;胭脂虫粉;无定形三硫化锑; [or]chem;
kersantite: [a]/'kə:sən,tait/; [n]<岩>云斜煌岩; [or]chem;
ketene: [a]/'kiːtiːn/; [n]烯酮;乙烯酮; [or]chem;
ketol: [a]/'kiːtɒl/; [n]酮醇;乙烯醇; [or]chem;
kieserite: [a]/'kiːzəraɪt/; [n]硫酸镁石; [or]chem;
kimberlite: [a]/'kɪmbəlaɪt/; [n]<岩>金伯利岩;<岩>角砾云橄岩; [or]chem;
kornerupine: [a]/,kɔ:nə'ru:pin/; [n]钠柱晶石; [or]chem;
koswite: [a]/'kɔswait/; [n]橄榄透辉岩;导剥磁铁橄榄岩;磁铁橄榄岩; [or]chem;
kragerite: [a]/'krægə,rait/; [n]金红钠长细晶岩; [or]chem;
kulaite: [a]/'ku:lə,ait/; [n]<岩>闪霞粒玄岩; [or]chem;
kylite: [a]/'kailait/; [n]<岩>富橄霞斜岩;<岩>辉橄霞斜岩; [or]chem;
laccolith: [a]/'lækəlɪθ/; [n]岩盘;岩盖; [or]chem;
lactamide: [a]/lækt'æmaid/; [n]乳酰胺; [or]chem;
lactate: [a]/lækˈteɪt/; [v](妇女或雌性动物)泌乳,哺乳; [n]乳酸盐(或酯); [add]pt/lactated,pp/lactated,pr/lactating,s3/lactates; [or]chem;
ladanum: [a]/'læd(ə)nəm/; [n]岩蔷薇(等于labdanum);赖百当; [or]chem;
ladderway: [a]/'lædəwei/; [n](上下矿井的)梯道,井筒梯子间; [or]chem;
ladle: [a]/ˈleɪdl/; [n]长柄杓;钢铁水包; [v]用长柄勺舀;把..倒入; [add]pt/ladled,pp/ladled,pr/ladling,pl/ladles,s3/ladles; [or]chem;
lagonite: [a]/'lægə,nait; 'lægənait/; [n]杂硼铁矿;硼铁矿; [or]chem;
lakarpite: [a]/'leikɑ:pait/; [n]钠闪正长岩;含霞钠闪正长岩; [or]chem;
laminae: [a]/'læməni/; [n](沉积岩,有机组织的)薄片,薄层;椎板;叶片(lamina 的复数); [or]chem;
lamping: [a]/'læmpɪŋ/; 用紫外线灯勘探荧光矿物;  [or]chem;
lamprophyre: [a]/'læmprə,faɪɚ/; [n]<岩>煌斑岩; [or]chem;
langbeinite: [a]/'læ,baɪnaɪt/; [n]<无化>无水钾镁矾; [or]chem;
lanthana: [a]/'lænθənə/; [n]<无化>氧化镧; [or]chem;
larderellite: [a]/,lɑ:də'rilait/; [n]硼铵石; [or]chem;
lardon: [a]/ˈlɑːdn/; [n]肥腊肉片;肥碱肉片; [or]chem;
larvikite: [a]/'lɑ:vikait/; [n]<岩>歪碱正长岩; [or]chem;
laterite: [a]/'lætəraɪt/; [n]红土带;砖红壤;铁矾土; [or]chem;
latite: [a]/'leitait/; [n]<岩>安粗岩;二长安山岩; [or]chem;
lauraldehyde: [a]/,lɔ:'rældəhaid/; [n]樟醛;十二醛; [or]chem;
laurate: [a]/'lɔ:reit/; [n]月桂酸盐;十二酸酯; [or]chem;
laurdalite: [a]/'lɔ:dəlait, 'lɑ:-/; [n]<岩>歪霞正长岩; [or]chem;
lauryl: [a]/'lɔrəl; 'lɑrəl/; [n]十二烷基;月桂酰; [or]chem;
lavialite: [a]/'læviə,lait/; [n]残拉角闪岩; [or]chem;
lepidoblastic: [a]/,lepɪdəʊ'blæstɪk/; <岩>鳞片变晶状的; [or]chem;
leptite: [a]/'leptait/; [n]<岩>长英粒变岩; [or]chem;
lestiwarite: [a]/'lestəwə,rait/; [n]辉闪正长细晶岩;正长细晶岩; [or]chem;
leucitite: [a]/'lu:sitait/; [n]白榴石岩; [or]chem;
leucocratic: [a]/,lju:kə'krætik/; [adj]以浅色矿物质为主要成份的; [or]chem;
leucon: [a]/'ljuːkən/; 嘌呤胺单盐酸盐; [or]chem;
limburgite: [a]/'limbəɡait/; [n]<岩>玻基辉橄岩;灵堡干酪; [or]chem;
limestone: [a]/ˈlaɪmstəʊn/; [n]<岩>石灰岩; [add]pl/limestones; [or]chem;
limonene: [a]/'lɪməniːn/; [n]柠檬烯;柠檬油精; [or]chem;
limonitic: [a]/,laimə'nitik/; [adj]褐铁矿的;由褐铁矿构成的; [or]chem;
liparite: [a]/'lipərait/; [n]<岩>流纹岩;萤石;硅孔雀石; [or]chem;
litharge: [a]/'lɪθɑːdʒ/; [n]一氧化铅;铅黄; [or]chem;
lithia: [a]/'lɪθɪə/; [n]<无化>氧化锂;锂氧; [or]chem;
lithic: [a]/'lɪθɪk/; [adj]石的;膀胱结石的;锂的; [or]chem;
lithium: [a]/ˈlɪθiəm/; [n]锂(符号Li); [or]chem;
lithogenous: [a]/lɪ'θɒdʒɪnəs/; [adj]成结石的;造岩的;造礁的; [or]chem;
lithologic: [a]/,liθəu'lɔdʒik/; [adj]岩性的; [or]chem;
lithology: [a]/lɪˈθɒlədʒi/; [n]岩石学,岩性学;岩性,岩石特征; [or]chem;
lithotype: [a]/'liθə,taip/; [n]煤岩类型;利索型照相排字机; [or]chem;
lividity: [a]/lɪ'vɪdəti/; [n]铁青色,铅色; [or]chem;
lixiviation: [a]/lɪk,sɪvɪ'eʃən/; [n]<化工>浸滤(作用); [or]chem;
loadstone: [a]/ˈləʊdstəʊn/; [n]天然磁石;极磁铁矿;吸引人的东西; [or]chem;
loggerhead: [a]/'lɒgəhed/; [n]红海龟;铁球棒;(非正式)傻瓜; [or]chem;
longspur: [a]/'lɒŋspɜː/; [n]铁爪鸟; [or]chem;
lophine: [a]/'ləʊfɪn/; 洛粉碱; [or]chem;
lorenzenite: [a]/lɔ'renzənait/; [n]硅钠钛矿;矽钠钛矿; [or]chem;
lyddite: [a]/'lɪdaɪt/; [n]<化工>立德炸药(一种强力炸药); [or]chem;
lydite: [a]/'lidait/; [n]<岩>燧石板岩,试金石; [or]chem;
lye: [a]/laɪ/; [vt]用碱液洗涤;  [or]chem;
lys: [a]/li:s/; abbr. 赖氨酸 (lysine); [or]chem;
mackintoshite: [a]/'mækintɔ,ʃait/; [n]黑铀缸矿;黑铀钍矿; [or]chem;
macrochemistry: [a]/,mækrəʊ'kemɪstrɪ/; 常量化学; [or]chem;
mafic: [a]/'mæfɪk/; [adj]铁镁质的; [or]chem;
magmatic: [a]/'mægmətik/; [adj]岩浆的; [or]chem;
magnesia: [a]/mæɡˈniːʒə; mæɡˈniːziə/; [n]氧化镁;苦土;水合碳酸镁; [or]chem;
magnesian: [a]/mæg'niʃən/; [adj]镁的;氧化镁的; [or]chem;
maidenhair: [a]/ˈmeɪdnheə(r)/; [n]孔雀草;掌叶铁线蕨; [or]chem;
maitlandite: [a]/'meitləndait/; [n]钍脂铅铀矿; [or]chem;
malate: [a]/'meɪleɪt/; [n]苹果酸盐;苹果酸酯; [or]chem;
malchite: [a]/'mælkait/; [n]<岩>微闪长岩; [or]chem;
malonate: [a]/mæləu'neit/; [n]丙二酸盐;丙二酸酯; [or]chem;
manganate: [a]/'mæŋgənət; -neɪt/; [n]<无化>锰酸盐; [or]chem;
manganocalcite: [a]/,mæŋgənəu'kælsait/; [n]锰方解石;含钙菱锰矿; [or]chem;
mangerite: [a]/'meindʒə,rait/; [n]纹长二长岩; [or]chem;
marcasite: [a]/ˈmɑːkəsaɪt; ˈmɑːkəziːt/; [n]白铁矿; [or]chem;
marchite: [a]/'mɑ:tʃait/; [n]<岩>顽火透辉岩; [or]chem;
margarate: [a]/'ma:gəreit/; [n]十七酸盐; [or]chem;
marlite: [a]/'mɑːlaɪt/; [n]<岩>泥灰岩(泥灰土的一种); [or]chem;
marmoreal: [a]/mɑːˈmɔːriəl/; [adj]冰冷的;大理石的;<岩>大理石状的; [or]chem;
mascagnite: [a]/mæs'kænait/; [n]硫铵石;铵矾; [or]chem;
mashie: [a]/'mæʃɪ/; [n]五号铁头球棒; [add]pl/mashies; [or]chem;
mashy: [a]/'mæʃi/; [adj]磨碎的; [n]5号铁头球棍; [or]chem;
massicot: [a]/'mæsɪkɒt/; [n]黄铅丹(天然一氧化铅); [or]chem;
melam: [a]/'melæm/; [n]蜜白胺; [or]chem;
melamine: [a]/ˈmeləmiːn/; [n]三聚氰胺,蜜胺; [or]chem;
melilitite: [a]/'meləlitait/; [n]黄长岩; [or]chem;
melteigite: [a]/'melti:gait/; [n]霞霓钠辉岩;暗霓霞岩; [or]chem;
menilite: [a]/'menilait/; [n]<宝>硅乳石; [or]chem;
mercaptides: [a]/mə'kæptaɪd/; [n]硫醇盐; [or]chem;
mercapto: [a]/mə'kæptəʊ/; [adj]含巯基的,含氢硫基的; [or]chem;
mercerize: [a]/ˈmɜːsəraɪz/; [v]将(棉布或棉纱)作丝光处理;作碱化处理(将棉花等); [add]pt/mercerized,pp/mercerized,pr/mercerizing,s3/mercerizes; [or]chem;
mercurate: [a]/'mɜːkjʊreɪt/; [vt]用汞处理;使汞化; [n]汞化产物; [add]pt/mercurated,pp/mercurated,pr/mercurating,s3/mercurates; [or]chem;
mercuration: [a]/,mə:kju'reiʃən/; [n]汞化;加汞作用; [or]chem;
mercurial: [a]/mɜːˈkjʊəriəl/; [adj]水银的;水星的;墨丘利神的;雄辩机智的;活泼善变的; [n]汞剂;水银剂; [or]chem;
mercuric: [a]/mɜː'kjʊərɪk/; [adj]<无化>汞的;水银的; [or]chem;
mercurous: [a]/'mɜːkjʊrəs/; [adj]一价汞的,(亚)汞的;含汞的; [or]chem;
merohedral: [a]/,mɛrə'hidrəl/; <晶体>缺面的; [or]chem;
mesitylene: [a]/'mezɪtɪliːn/; [n]1,3,5-三甲基苯; [or]chem;
messelite: [a]/'mesə,lait/; [n]次磷钙铁矿;水磷铁斜钙石; [or]chem;
metabiotic: [a]/mə'tæbaɪ'ɒtɪk/; 甲烯土霉素; [or]chem;
metacryst: [a]/'metəkrɪst/; [n]斑晶变晶;<岩>变晶;次生晶; [or]chem;
metallogenetic: [a]/mətælədʒɪ'nɛtɪk/; [adj]成矿的;产金属的; [or]chem;
metallogenic: [a]/mɪ,tælə(ʊ)'dʒenɪk; 'met(ə)lə(ʊ)-/; [adj]成矿的; [or]chem;
metamorphose: [a]/ˌmetəˈmɔːfəʊz/; [v](昆虫,两栖动物)变态(尤指变成熟);变形,变质;(使)完全改变;(使)岩石变质; [add]pt/metamorphosed,pp/metamorphosed,pr/metamorphosing,s3/metamorphoses; [or]chem;
metaphosphate: [a]/metə'fɒsfeɪt/; [n]<无化>偏磷酸盐; [or]chem;
metasilicate: [a]/,mɛtə'sɪlɪket/; [n]硅酸盐; [or]chem;
methacrylate: [a]/mɪ'θækrɪleɪt/; [n]甲基丙烯酸酯;异丁烯酸甲酯; [or]chem;
methenamine: [a]/me'θiːnəmiːn/; [n]乌洛托品;六亚甲基四胺; [or]chem;
methionine: [a]/mɪ'θaɪəniːn/; [n]甲硫氨酸,蛋氨酸; [or]chem;
methylal: [a]/'meθɪlæl/; [n]甲缩醛; [or]chem;
methylate: [a]/'meθɪleɪt/; [v]在..中加入甲醛(或甲基化酒精);(使)甲基化; [n]甲醇盐; [add]pt/methylated,pp/methylated,pr/methylating; [or]chem;
methylic: [a]/mɛ'θɪlɪk/; [adj]甲基的;含甲基的; [or]chem;
metopon: [a]/'mɛtə,pɑn/; [n]甲基二氢吗啡酮(一种镇痛药);麦托朋; [or]chem;
miarolitic: [a]/,mi:ərəu'litik/; [adj]<岩>晶洞状的; [n]洞隙; [or]chem;
microanalysis: [a]/,maɪkrəʊə'nælɪsɪs/; [n]<分化>微量分析; [add]pl/microanalyses; [or]chem;
microchemical: [a]/,maɪkrəʊ'kemɪkəl/; 微量化学的; [or]chem;
microelement: [a]/'maɪkrəʊ,elɪmənt/; [n]微量元素; [or]chem;
microgranite: [a]/'maɪkrəʊ,grænɪt/; [n]微花岗岩; [or]chem;
microspherulitic: [a]/'maikrəu,sfirə'litik/; [adj]<岩>微球粒状; [or]chem;
midiron: [a]/'mɪdaɪən/; [n]二号铁杆(铁头球杆之一种); [or]chem;
migmatite: [a]/'miɡmətait/; [n]<岩>混合岩,复片麻岩; [or]chem;
mijakite: [a]/'mi:dʒəkait/; [n]锰辉玄武岩,三宅岩; [or]chem;
miliolite: [a]/'miliəu,lait/; [n]小粟虫灰岩,风成细粒灰岩;糜棱岩; [or]chem;
millerite: [a]/'mɪləraɪt/; [n]针硫镍矿; [or]chem;
mine: [a]/maɪn/; [vt]开采,采掘;在.布雷; [vi]开矿,采矿;埋设地雷; pro; [add]pt/mined,pp/mined,pr/mining,pl/mines,s3/mines;  [or]chem;
mineral: [a]/ˈmɪnərəl/; [n]矿物;(英)矿泉水;无机物;苏打水(常用复数表示); [adj]矿物的;矿质的; [add]pl/minerals; [or]chem;
mineralize: [a]/'mɪn(ə)rəlaɪz/; [v]使含无机化合物;使矿物化,石化;给(有机物或水等)加入矿物质:采集矿物; [add]pt/mineralized,pp/mineralized,pr/mineralizing,s3/mineralizes; [or]chem;
mineralogical: [a]/ˌmɪnərəˈlɑːdʒɪkl/; [adj]矿物学的; [or]chem;
mineralogist: [a]/ˌmɪnəˈrælədʒɪst/; [n]矿物学者; [or]chem;
mineralogy: [a]/ˌmɪnəˈrælədʒi/; [n]矿物学;矿物学书籍; [or]chem;
mining: [a]/ˈmaɪnɪŋ/; [n]矿业;采矿; [or]chem;
minverite: [a]/'minvə,rait/; [n]<岩>钠长角闪辉绿岩; [or]chem;
mirbane: [a]/'mə:bein/; [n]硝基苯,密斑油; [or]chem;
modifiable: [a]/ˈmɒdɪfaɪə(r)/; [adj]可修饰的;可更改的; modification:; [n]<助剂>改性剂;<语>修饰语;修正的人; [add]pl/modifiers; [or]chem;
modifier: [a]/ˈmɒdɪfaɪə(r)/; [n]<助剂>改性剂;<语>修饰语;修正的人; [add]pl/modifiers; [or]chem;
molysite: [a]/'mɒlɪsaɪt/; 铁盐; [or]chem;
monatomic: [a]/,mɒnə'tɒmɪk/; [adj]单原子的; [or]chem;
monaxial: [a]/'mɔnʃikait/; [adj]单轴的; monazite:; [n]<岩>沸煌岩; [or]chem;
monchiquite: [a]/'mɔnʃikait/; [n]<岩>沸煌岩; [or]chem;
monobasic: [a]/mɒnə(ʊ)'beɪsɪk/; [adj]单碱的;一价硷的; [or]chem;
monochromic: [a]/'mɔnəkɔt/; [adj]<晶体>单斜的;<晶体>单斜晶体的; monocot:; [n]单子叶植物; [add]pl/monocles;monoclinal:; [or]chem;
monoclinic: [a]/mɒnə(ʊ)'klɪnɪk/; [adj]<晶体>单斜的;<晶体>单斜晶体的; [or]chem;
monohydrate: [a]/mə'nɒlətrɪ/; [n]单神崇拜;一神崇拜; [adj]一羟基的; monoid:; [or]chem;
monohydric: [a]/mɒnə(ʊ)'haɪdrɪk/; [adj]一羟基的; [or]chem;
monohydroxy: [a]/,mɒnəʊhaɪ'drɒksɪ/; [adj]一羟基的; [or]chem;
mononitrate: [a]/mɔnəu'naitreit/; [n]一硝酸盐; [or]chem;
monorail: [a]/ˈmɒnəʊreɪl/; [n]单轨;单轨铁路; [add]pl/monorails; [or]chem;
monoxide: [a]/mə'nɒksaɪd/; [n]<无化>一氧化物; [or]chem;
monzodiorite: [a]/mɔnzə'daiərait/; [n]二长闪长岩; [or]chem;
monzonite: [a]/'mɒnzənaɪt/; [n]<岩>二长岩; [or]chem;
moonstone: [a]/ˈmuːnstəʊn/; [n]<宝>月长石; [or]chem;
moorstone: [a]/'mɔston/; [n]花岗岩; [or]chem;
morphology: [a]/,mɔ:fəu'trɔpizəm/; [n]<晶体>变形性,准同形性; [add]pl/morphoses;morphotropism:; [or]chem;
morphotropism: [a]/,mɔ:fəu'trɔpizəm/; [n]<晶体>变形性,准同形性; [or]chem;
mosaicist: [a]/məu'sændrait/; [n]褐硅铈矿,褐矽铈矿; [or]chem;
mosandrite: [a]/məu'sændrait/; [n]褐硅铈矿,褐矽铈矿; [or]chem;
mottramite: [a]/'mɒtrəmaɪt/; 钒铜铅矿; [or]chem;
mudstone: [a]/'mʌdstəʊn/; [n]泥岩; [or]chem;
mugearite: [a]/mʊ'ɡiəraɪt/; [n]<岩>橄榄粗安岩; [or]chem;
multivalence: [a]/mʌl'tɪvələns/; [n]多价;多原子价;多义性;有多种价值; [or]chem;
mundic: [a]/'mʌndik/; [n]黄铁矿; [or]chem;
muskeg: [a]/'mʌskeg/; [n](尤指北美北部和北欧的)泥岩沼泽地;青苔沼泽地; [or]chem;
mylonite: [a]/'mɪlənaɪt/; [n]<岩>糜棱岩; [or]chem;
myristate: [a]/mi'risteit/; [n]十四酸盐;豆蔻酸盐; [or]chem;
myrmekite: [a]/'mə:mi,kait/; [n]<岩>蠕状石; [or]chem;
myrosinase: [a]/'mairəsineis/; [n](黑)芥子酶;黑芥子硫苷酸酶; [or]chem;
naphthalene: [a]/ˈnæfθəliːn; ˈnæpθəliːn/; [n]萘(一种二环芳族烃);卫生球,樟脑丸; [or]chem;
napper: [a]/'nɑːsɪiːn/; [n]罂粟碱(可作麻醉剂); [v]小睡;疏忽;使起绒(nap的ing形式); [adj](非正式)(黑人的头发)卷曲的;毛绒绒的;(酒精饮料,尤指啤酒)醉人的;有点儿醉的;(马)跳动的,易怒的; [add]er/nappi-er,est/nappiest,pl/nappies;naprapathy:; [or]chem;
narceine: [a]/'nɑːsɪiːn/; [n]罂粟碱(可作麻醉剂); [or]chem;
natrium: [a]/'neɪtrɪəm/; [n]钠(11号元素); [or]chem;
naujaite: [a]/'nəujə:ait/; [n]闪霞方钠正长岩;方钠霞石正长岩; [or]chem;
navigator: [a]/'neivait/; [n]<岩>蛇纹粒玄斑岩; [add]pl/navigators;navite:; [or]chem;
navite: [a]/'neivait/; [n]<岩>蛇纹粒玄斑岩; [or]chem;
nebular: [a]/'nebjulait/; [adj]星云的;星云状的; nebule:; [n]<岩>星云岩; [or]chem;
nebulite: [a]/'nebjulait/; [n]<岩>星云岩; [or]chem;
nebulium: [a]/nə'bju:liəm/; [n]过去假设星云中的化学元素; [or]chem;
nelsonite: [a]/'nelsənait/; [n]<岩>钛铁磷灰岩; [or]chem;
nema: [a]/,nemətə'blæstik/; [adj]<岩>纤状变晶质的; [gd]un; [or]chem;
nematic: [a]/nɪ'mætɪk/; [adj](液晶)<晶体>向列的; [or]chem;
nematoblastic: [a]/,nemətə'blæstik/; [adj]<岩>纤状变晶质的; [or]chem;
nephelinite: [a]/'nef(ə)lɪnaɪt/; [n]霞岩; [or]chem;
neptunist: [a]/'neptju:nist/; [n]岩石水成论者; [or]chem;
neutralizer: [a]/'njʊtrəl,aɪzɚ/; [n]<助剂>中和剂;<化工>中和器; [or]chem;
nevadite: [a]/'nevə,dait/; [n]<岩>斑流岩; [or]chem;
newlandite: [a]/'nju:ləndait/; [n]顽火榴辉石;榴顽透辉岩; [or]chem;
niblick: [a]/'nɪblɪk/; [n]九号铁头球棒(等于numbe; [prep]iron); [or]chem;
nickeling: [a]/ˈnɪkəl/; [v]<化工>镀镍(nickel的ing形式); [or]chem;
nicolayite: [a]/,nikə'leiait/; [n]水硅铀钍铅矿; [or]chem;
nicotinic: [a]/,nɪkə'tɪnɪk/; [adj]烟碱的;烟碱酸的; [or]chem;
nicotinism: [a]/'nɪkətiːnɪzəm/; [n]烟碱中毒;吸烟中毒; [or]chem;
nicotinize: [a]/,nɪkə'tinaɪz/; [vt]使中烟碱毒;使中尼古丁毒; [add]pt/nicotinized,pp/nicotinized,pr/nicotinizing; [or]chem;
nigrine: [a]/'naigrain/; [n]铁金红石; [or]chem;
nigrosine: [a]/'nɪɡrəsiːn/; [n]<染料>苯胺黑; [or]chem;
niklesite: [a]/'nikl,sait/; [n]<岩>三辉岩; [or]chem;
niobate: [a]/'naiəbeit/; [n]<无化>铌酸盐; [or]chem;
niobite: [a]/'naɪəbaɪt/; [n]铌铁矿; [or]chem;
nitramine: [a]/'naitrəmi:n/; [n]四硝甲苯胺;硝铵; [or]chem;
nitramino: [a]/nɪ'træməno/; [n]硝胺基; [or]chem;
nitrate: [a]/ˈnaɪtreɪt/; [n]硝酸盐; [v]用硝酸处理; [add]pt/nitrated,pp/nitrated,pr/nitrating,pl/nitrates,s3/nitrates; [or]chem;
nitric: [a]/'naɪtrɪk/; [adj]氮的;含氮的;硝石的; [or]chem;
nitridation: [a]/,naitri'deiʃən/; [n]<无化>氮化;渗氮; [or]chem;
nitriding: [a]/'naɪtraɪdɪŋ/; [v]渗氮(nitrid; [prep]的现在分词); [n]渗氮法,氮化法; [or]chem;
nitrify: [a]/ˈnaɪtrɪfaɪ/; [v](使)硝化;使与氮化合;用氮饱和; [add]pt/nitrified,pp/nitrified,pr/nitrifying,s3/nitrifies; [or]chem;
nitrite: [a]/ˈnaɪtraɪt/; [n]亚硝酸盐; [or]chem;
nitrogenization: [a]/,naɪtrədʒənaɪ'zeɪʃən/; 氮化; 氮化作用; [or]chem;
nitrogenize: [a]/'naɪtrədʒənaɪz/; [v]使含氮,使氮化; [add]pt/nitrogenized,pp/nitrogenized,pr/nitrogenizing; [or]chem;
nitrometer: [a]/naɪ'trɒmɪtə/; [n]<分化>氮量计;<分化>测氮管; [or]chem;
nitrophilous: [a]/naɪˈtrɒfɪləs/; 喜氮; [or]chem;
nitrophyte: [a]/'naitrə,fait/; [n]嗜氮植物;嗜硝酸植物; [or]chem;
nitrosamine: [a]/naɪ'trəʊsəmiːn/; [n]亚硝胺; [or]chem;
nitrosyl: [a]/'naɪtrəsɪl/; [n]亚硝酰基; [adj]亚硝酰基的; [or]chem;
nitrous: [a]/'naɪtrəs/; [adj]氮的;硝石的;含氮的; [or]chem;
noncrystalline: [a]/'nɔn'kristəlain/; [adj]非结晶的; [or]chem;
nonene: [a]/'nəuni:n/; [n]壬烯; [or]chem;
nonferrous: [a]/nɒn'ferəs/; [adj]非铁的;不含铁的; [or]chem;
nonmetal: [a]/'nɒn,metəl/; [n]非金属(元素); [or]chem;
norite: [a]/'nɔraɪt/; [n]苏长岩; [or]chem;
nornicotine: [a]/nɔː'nɪkətiːn/; 降烟碱; 去甲烟碱; [or]chem;
nosean: [a]/'nəuzən/; [n]方岩,方石;黝方石; [or]chem;
novaculite: [a]/nə(ʊ)'vækjʊlaɪt/; [n]<岩>均密石英岩; [or]chem;
nuclei: [a]/'njuːklɪaɪ/; [n]核心,核子;原子核(nucleus的复数形式); [or]chem;
nucleonics: [a]/,njuːklɪ'ɒnɪks/; [n]核子学;原子核物理学; [or]chem;
nucleus: [a]/ˈnjuːkliəs/; [n]核,核心;原子核; [add]pl/nucleuses或nuclei; [or]chem;
nugget: [a]/ˈnʌɡɪt/; [n]天然金块,矿块;(某些食物)小圆块;小块东西;珍闻,珍品; [or]chem;
octad: [a]/'ɒktæd/; 八价元素; [or]chem;
odinite: [a]/'əudinait/; [n]<岩>拉辉煌斑岩;钛云母; [or]chem;
olefin: [a]/'əʊlɪfɪn/; [n]烯烃; [or]chem;
olefine: [a]/'əuləfin/; [n]链烯烃; [or]chem;
oligoclasite: [a]/,ɔliɡəu'kleisait/; [n]奥长岩;奥长石; [or]chem;
ollenite: [a]/'ɔlənait/; [n]绿帘金红角闪片岩;帘梢全红角闪片岩; [or]chem;
oolitic: [a]/,əuəu'litik/; [adj]像鲕粒岩的;鲕粒岩的; [or]chem;
ophitic: [a]/ə'fɪtɪk/; [adj]辉绿岩的;辉绿岩结构的; [or]chem;
orbite: [a]/'ɔ:bait/; [n]角闪玢岩; [or]chem;
orchil: [a]/'ɔːtʃɪl/; [n]红色染料;苔色素;石蕊地衣;<染料>紫色地衣染料; [or]chem;
ordosite: [a]/'ɔ:dəsait/; [n]河套岩;锥辉正长岩; [or]chem;
organogel: [a]/ɔ:'gænədʒel/; [n]<物化>有机凝胶; [or]chem;
organomercury: [a]/,ɔːɡənəʊ'mɜːkjʊrɪ/; [n]有机汞(等于organomercurial); [adj]有机汞制剂的(等于organomercurial); [or]chem;
ormolu: [a]/ˈɔːməluː/; [n]<化工>镀金物;锌青钢; [or]chem;
orthogranite: [a]/'ɔ:θəgrænait/; [n]正花冈岩; [or]chem;
orthophosphate: [a]/,ɔːθəʊ'fɒsfeɪt/; [n]<无化>正磷酸盐; [or]chem;
orthorhombic: [a]/,ɔːθə(ʊ)'rɒmbɪk/; [adj]<晶体>正交晶的;斜方晶系的; [or]chem;
orthosilicate: [a]/,ɔ:θə'siləkeit/; [n]正硅酸盐;正矽酸盐; [or]chem;
orthovanadate: [a]/'ɔ:θəvænə,deit/; [n]<无化>原钒酸盐; [or]chem;
oscillometry: [a]/,ɔsi'lɔmitri/; [n]<电子>示波测量法;高频指示;<物化>振量法; [or]chem;
osmiridium: [a]/,ɒzmɪ'rɪdɪəm/; [n]铱锇矿; [or]chem;
outcrop: [a]/ˈaʊtkrɒp/; [n]露头;露出地面的岩层; [vi]露出; [add]pt/outcropped,pp/outcropped,pr/outcropping,pl/outcrops; [or]chem;
overburden: [a]/ˌəʊvəˈbɜːdn/; [v](使)负担过重;给..过多工作(或压力); [n]岩石覆盖;过重负担; [or]chem;
overcoating: [a]/'ovɚ,kotɪŋ/; [n]外敷层;<涂料>饰面; [or]chem;
overcured: [a]/əuvə'kjuə/; [vt]过熟化;<化工>过硫化;过硬化; [or]chem;
overthrow: [a]/əʊvə'θrəʊ/; [v]推翻,倾覆;瓦解;投(球)过远;背弃; [n]推翻,打倒,倾覆;投球过猛;(拱门,门廊上方的)铁艺装饰板; [add]pt/overthrew,pp/overthrown,pr/overthrowing,pl/overthrows,s3/overthrows; [or]chem;
oxamide: [a]/'ɔksəmaid/; [n]乙二酰二胺;草酰胺; [or]chem;
oxidant: [a]/ˈɒksɪdənt/; [n]氧化剂; [or]chem;
oxidate: [a]/'ɔksideit, 'ɔksidit/; [v]氧化; [n]氧化物; [add]pt/oxidated,pp/oxidated,pr/oxidating; [or]chem;
oxidimetry: [a]/,ɔksi'dimitri/; [n]氧化还原滴定; [or]chem;
oxidizability: [a]/,ɔksi,daizə'biliti/; [n]氧化性能;易氧化度;可氧化性; [or]chem;
oxidize: [a]/ˈɒksɪdaɪz/; [vt]使氧化;使生锈; [vi]氧化; [add]pt/oxidized,pp/oxidized,pr/oxidizing,s3/oxidizes; [or]chem;
oxidizer: [a]/'ɑksə,daɪzɚ/; [n]<助剂>氧化剂; [or]chem;
oxidizing: [a]/'ɑksə,daɪzɪŋ/; [v](使)氧化;(使)生锈(oxidiz; [prep]的现在分词); [or]chem;
oxidoreductase: [a]/,ɑksɪdorɪ'dʌk,tes; ,ɑksɪdorɪ'dʌk,tez/; [n]氧化还原酶; [or]chem;
oxybromide: [a]/ɔksi'brəumaid/; [n]<无化>溴氧化物; [or]chem;
oxygenant: [a]/'ɔksidʒinənt/; [n]氧化剂; [or]chem;
oxygenate: [a]/ˈɒksɪdʒəneɪt/; [v]供氧,输氧;(使)用氧饱和;(使)富氧;氧化; [n]氧化物; [add]pt/oxygenated,pp/oxygenated,pr/oxygenating,s3/oxygenates; [or]chem;
oxygenation: [a]/ˌɒksɪdʒəˈneɪʃn/; [n]以氧处理,氧化作用; [or]chem;
oxygenize: [a]/'ɒksɪdʒənaɪz/; [vt]使氧化; [add]pt/oxygenized,pp/oxygenized,pr/oxygenizing; [or]chem;
oxyhydrogen: [a]/,ɒksɪ'haɪdrədʒən/; [adj]氢氧混合气的; [n]氢氧混合气; [or]chem;
oxyneurine: [a]/,ɒksɪ'njʊəriːn/; 甜菜碱; [or]chem;
oxysalt: [a]/'ɒksɪsɔːlt/; <无化>含氧酸盐; 含氧盐; [or]chem;
ozonization: [a]/,ozənɪ'zeʃən/; [n]臭氧化; [or]chem;
paddling: [a]/'pædlɪŋ/; [n]<皮革>划动; [v]用桨划;在水中行进(paddle的现在分词); [or]chem;
paisanite: [a]/'paisənait/; [n]<岩>钠闪微岗岩; [or]chem;
pantellerite: [a]/pæn'telərait/; [n]<岩>碱流岩; [or]chem;
paradichlorobenzene: [a]/,pærədaɪ,klɔrə'bɛn,zin; ,pærədaɪ,klɔrə'bɛn'zin; ,pærədaɪ,klorə'bɛn,zin/; [n]对二氯苯(用作杀虫剂); [or]chem;
paraform: [a]/'pærəfɔːm/; [n]多聚甲醛;聚甲醛; [or]chem;
paragenesia: [a]/ˌpærədʒɪˈniːzɪə/; 1.  [n] a characteristic association of minerals in a particula; [prep]deposit 在特殊种类的岩石或矿床中的典型性矿产结合; [or]chem;
paragneiss: [a]/,pærəɡ'nais/; [n]<岩>副片麻岩; [or]chem;
parahydrogen: [a]/,pærə'haɪdrədʒən/; 仲氢; [or]chem;
pararosaniline: [a]/,pærərəʊ'zænɪlɪn/; [n]副蔷薇苯胺;副品红;副玫瑰红; [or]chem;
paraxylene: [a]/pə'ræksili:n/; [n]对二甲苯; [or]chem;
pasteur: [a]/pæs'tə:/; [n]巴斯德(法国化学家,细菌学家); [or]chem;
pawdite: [a]/'pɔ:dait/; [n]云英微闪长岩; [or]chem;
pedion: [a]/'pediən/; [n]单面晶;<晶体>单面; [add]pl/pedia; [or]chem;
peel: [a]/piːl/; [v]剥,剥落;削;(槌球中)击(他人的球)穿过铁环门;  [or]chem;
pegmatite: [a]/'pegmətaɪt/; [n]伟晶岩;结晶花岗岩; [or]chem;
pegmatoid: [a]/'peɡmətɔid/; [n]伟晶岩相;伟晶相; [adj]似伟晶岩的; [or]chem;
pegmatophyre: [a]/peg'mætə,faiə/; [n]伟斑岩;文象斑岩; [or]chem;
pelite: [a]/'pi,laɪt/; [n]<岩>泥质岩; [or]chem;
pennate: [a]/'penət/; [adj](硅藻)两侧对称的,翼状的;有羽毛的; [or]chem;
pentoxide: [a]/pen'tɒksaɪd/; [n]<无化>五氧化物; [or]chem;
pentylene: [a]/'pentili:n/; [n]戊二烯; [or]chem;
peperino: [a]/,pɛpə'rino/; [n]白榴拟灰岩; [or]chem;
pepino: [a]/pəpi:'nəu/; [n]灰岩残丘;茄瓜; [add]pl/pepinos; [or]chem;
peptization: [a]/,peptə'zeɪʃən/; [n]<物化>胶溶作用; [or]chem;
perborate: [a]/pə'bɔːreɪt/; [n]过硼酸盐;高硼酸盐; [or]chem;
perchlorate: [a]/pə'klɔːreɪt/; [n]<无化>高氯酸盐(或酯); [or]chem;
perchloride: [a]/pə'kləʊraɪd/; [n]<无化>高氯化物;过氯化物; [or]chem;
perchromate: [a]/pə'krəumeit/; [n]过铬酸盐; [or]chem;
percrystallization: [a]/pɝ,krɪstəlɪ'zeʃən/; 透析结晶; [or]chem;
peridotite: [a]/'perɪdɒtaɪt/; [n]<岩>橄榄岩; [or]chem;
periodate: [a]/pɜː'raɪədeɪt/; [n]<无化>高碘酸盐;过碘酸盐; [or]chem;
perite: [a]/pə'raɪt/; 氯氧铋铅矿; [or]chem;
perknite: [a]/'pə:knait/; [n]辉闪岩;<岩>辉闪岩类; [or]chem;
permalloy: [a]/'pɜːməlɒɪ/; [n]坡莫合金;透磁合金;镍铁导磁合金; [or]chem;
permanganate: [a]/pə'mæŋgənət; -eɪt/; [n]<无化>高锰酸盐; [or]chem;
peroxidate: [a]/pə'rɔksideit/; [v]过氧化; [or]chem;
peroxidation: [a]/pə,rɑksɪ'deʃən/; [n]过氧化反应; [or]chem;
peroxide: [a]/pəˈrɒksaɪd/; [n]过氧化氢;过氧化物; [vt]以过氧化氢漂白;以过氧化物处理; [adj]以过氧化氢漂白的; [add]pt/peroxided,pp/peroxided,pr/peroxiding,pl/peroxides; [or]chem;
persulphate: [a]/pə'sʌlfeit/; [n]过硫酸盐; [or]chem;
perthosite: [a]/'pə:θəsait/; [n]淡纹长岩;<岩>淡钠二长岩; [or]chem;
petrochemical: [a]/ˌpetrəʊˈkemɪkl/; [n]石油化学产品; [adj]石油化工的;石油化学的; [add]pl/petrochemicals; [or]chem;
petrochemistry: [a]/petrə(ʊ)'kemɪstrɪ/; [n]岩石化学;石油化学; [or]chem;
petrogenesis: [a]/,petrə(ʊ)'dʒenɪsɪs/; [n]岩石发展学,<岩>岩石成因论; [or]chem;
petrogenic: [a]/,petrəu'dʒenik/; [adj]造岩的; [or]chem;
petroglyph: [a]/'petrə(ʊ)glɪf/; [n]岩石雕刻;岩石画; [or]chem;
petrographic: [a]/,petrəu'græfik/; [adj]岩相学的;岩类学的; [or]chem;
petrographical: [a]/,petrəu'græfikəl/; [adj]岩相学的;岩石学的; [or]chem;
petrography: [a]/pe'trɒgrəfɪ/; [n]岩相学;岩石记述学; [or]chem;
petrolene: [a]/'petrəli:n/; [n]石油烯,软沥青; [or]chem;
petrological: [a]/,petrə'lɔdʒikl/; [adj]岩石学的; [or]chem;
petrosal: [a]/pɪ'trəʊs(ə)l/; [adj]岩石般的;坚硬的; [or]chem;
petrosilex: [a]/,petrəu'sileks/; [n]霏细岩,火成岩;潜晶霏细岩; [or]chem;
petrous: [a]/'petrəs/; [adj]岩石的;岩石般的;坚硬的; [or]chem;
phacolite: [a]/'fækəlaɪt/; 岩脊; [or]chem;
phacolith: [a]/'fækəʊlɪθ/; [n]<岩>岩脊;岩鞍; [or]chem;
phanerite: [a]/'fænərait/; [n]<岩>显晶岩; [or]chem;
phenate: [a]/'fiːneɪt/; [n]石炭酸盐;苯酚盐; [or]chem;
phenazine: [a]/'fenəziːn/; [n]吩嗪;夹二氮蒽; [or]chem;
phene: [a]/fi:n/; [n]苯(等于benzene); [or]chem;
phenethyl: [a]/fen'eθəl/; [n]苯乙基; [or]chem;
phenobarbital: [a]/,fiːnə(ʊ)'bɑːbɪt(ə)l; ,fenə(ʊ)'bɑːbɪt(ə)l/; [n]苯巴比妥,鲁米那(镇静安眠剂); [or]chem;
phenocryst: [a]/'fiːnə(ʊ)krɪst; 'fenə(ʊ)krɪst/; [n]<岩>斑晶;显斑晶; [or]chem;
phenyl: [a]/'fiːnaɪl; 'fenɪl/; [n]苯基; [or]chem;
phenylene: [a]/'fenəliːn/; [n]亚苯基; [or]chem;
phenylenediamine: [a]/'fenəli:n'daiəmin/; [n]苯二胺; [or]chem;
phenylglycine: [a]/fenəl'glaisi:n/; [n]苯基甘氨酸; [or]chem;
phoenicochroite: [a]/fi:ni'kɔkrəait/; [n]红铬铅矿; [or]chem;
phonolite: [a]/'fəʊnəlaɪt/; [n]<岩>响岩;响石; [or]chem;
phonolitic: [a]/,fəunə'litik/; [adj]响岩状的; [or]chem;
phosgene: [a]/ˈfɒzdʒiːn/; [n]<无化>光气;<无化>碳酰氯; [or]chem;
phosphamide: [a]/fɔs'fæmaid/; [n]磷酰胺; [or]chem;
phosphate: [a]/ˈfɒsfeɪt/; [n]磷酸盐;皮膜化成; [add]pl/phosphates; [or]chem;
phosphated: [a]/'fəusfetid/; [adj]含磷酸盐的; [or]chem;
phosphatic: [a]/fɒs'fætɪk/; [adj]磷酸盐的;含磷酸盐的; [or]chem;
phosphatization: [a]/,fɔsfətai'zeiʃən, -ti'z-/; [n]磷化;磷酸盐化; [or]chem;
phosphatize: [a]/'fɒsfətaɪz/; [vt]用磷酸盐处理;使磷化; [add]pt/phosphatized,pp/phosphatized,pr/phosphatizing; [or]chem;
phosphide: [a]/'fɒsfaɪd/; [n]<无化>磷化物; [or]chem;
phosphine: [a]/'fɒsfiːn/; [n]磷化氢;三氢化磷; [or]chem;
phosphite: [a]/'fɒsfaɪt/; [n]亚磷酸盐; [or]chem;
phosphoglycerate: [a]/,fɔsfəu'ɡlisəreit/; [n]磷酸甘油酸盐;磷酸甘油酸酯; [or]chem;
phosphomolybdate: [a]/'fɔsfəu,mə'libdeit/; [n]钼磷酸盐; [or]chem;
phosphonate: [a]/'fɔsfəuneit/; [n]膦酸酯;瞵酸盐; [or]chem;
phosphorite: [a]/'fɒsfəraɪt/; [n]磷灰石;<岩>磷钙土; [or]chem;
photochemical: [a]/ˌfoʊtoʊˈkemɪkl/; [adj]光化学的; [n]光催化学物; [or]chem;
photochemigraphy: [a]/fəutəu,ke'migrəfi/; [n]摄影制版;光化学制版; [or]chem;
photochemistry: [a]/fəʊtəʊ'kemɪstrɪ/; [n]光化学; [or]chem;
photogen: [a]/'fəʊtədʒen/; [n]页岩煤油; [or]chem;
photooxidation: [a]/,fəʊtəʊ,ɒksə'deɪʃən/; [n]光致氧化;感光氧化; [or]chem;
phthalocyanine: [a]/,(f)θæləʊ'saɪəniːn/; [n]酞化青染料;苯二甲蓝染料;酞菁染料; [or]chem;
phyllite: [a]/'fɪlaɪt/; [n]<岩>千枚岩;硬绿泥石; [or]chem;
physicochemical: [a]/,fɪzɪkəʊ'kemɪkəl/; [adj]物理化学的; [or]chem;
physiochemical: [a]/,fɪzɪəʊ'kemɪk(ə)l/; [adj]生化的;生理化学的; [or]chem;
phytin: [a]/'faitin/; [n]植酸钙镁;非丁; [or]chem;
phytochemical: [a]/faɪtəʊ'kemɪk(ə)l/; [adj]植物化学的; 植物化学成分; [or]chem;
phytochemistry: [a]/faɪtəʊ'kemɪstrɪ/; [n]植物化学; [or]chem;
picrate: [a]/'pɪkreɪt/; [n]苦味酸盐; [or]chem;
picrite: [a]/'pɪkraɪt/; [n]辉石;橄榄岩;<岩>苦橄岩; [or]chem;
picromerite: [a]/pɪ'krɒməraɪt/; 软钾镁矾; [or]chem;
piezochemistry: [a]/piː'eɪzəʊ'kemɪstrɪ/; [n]高压化学; [or]chem;
piezocrystallization: [a]/pi'ezo,krɪstəlɪ'zeʃən/; [n]压结晶;压结晶作用; [or]chem;
pigging: [a]/pɪg/; [n]清管,清刮;生铁; [v]贪婪地吃;生小猪(pig的ing形式); [or]chem;
pikestaff: [a]/ˈpaɪkstɑːf/; [n]枪柄;有铁尖的行路杖; [add]pl/pikestaves; [or]chem;
pimelate: [a]/'piməleit/; [n]庚二酸;庚二酸酯;庚二酸盐;庚二酸根; [or]chem;
pinacoid: [a]/'pɪnəkɔɪd/; [n]<晶体>轴面;平行双面式; [or]chem;
piperazin: [a]/pi'perəzi:n/; [n]对二氮己环;哌嗪; [or]chem;
piperonal: [a]/'pɪpərənæl/; [n]胡椒醛; [or]chem;
piperylene: [a]/pi'perili:n/; [n]戊间二烯; [or]chem;
pisolite: [a]/'pɪzəlaɪt; 'paɪsə-/; [n]豆岩,豆石; [or]chem;
pisolitic: [a]/,paɪso'lɪtɪk/; [adj]<岩>豆状的; [or]chem;
pitchstone: [a]/'pɪtʃstəʊn/; [n]松脂石;松脂岩; [or]chem;
plagiaplite: [a]/,pleidʒi'æplait/; [n]斜长细晶岩; [or]chem;
plancheite: [a]/'pla:ntʃi,ait/; [n]纤硅铜矿;纤矽铜矿; [or]chem;
plasticization: [a]/,plæstɪsɪ'zeʃən/; [n]塑化;<高分子>增塑作用; [or]chem;
plastisol: [a]/'plæstɪsɒl/; [n]<塑料>塑料溶胶; [or]chem;
plastochron: [a]/'plæstəkrɔn/; [n](第一个叶原基的形成与第二个叶原基的形成之间的)间隔期; [or]chem;
platelayer: [a]/ˈpleɪtleɪər/; [n]铁路工人; [or]chem;
platinate: [a]/'plætineit/; [n]铂酸盐; [add]pt/platinateed,pp/platinateed,pr/platinating; [or]chem;
platinocyanide: [a]/,plætno'saɪə,naɪd/; [n]氰亚铂酸盐; [or]chem;
pleochroism: [a]/plɪ'ɒkrəʊɪzəm/; [n]<晶体>多向色性;多色现象; [or]chem;
pleomorphic: [a]/pliːə'mɔːfɪk/; [adj]<晶体>多形的;多晶的; [or]chem;
plumbate: [a]/'plʌmbeit/; [n]铅酸盐; [adj]高铅酸盐四价铅的; [or]chem;
plumbite: [a]/'plʌmbait/; [n]铅酸盐;<无化>亚铅酸盐; [or]chem;
plumbojarosite: [a]/,plʌmbəu'dʒærəsait/; [n]铅铁矾; [or]chem;
plutonian: [a]/plu:'təuniən/; [adj]冥王星的;冥界的;深成岩的; [or]chem;
plutonite: [a]/'plutə,nait/; [n]深成岩; [or]chem;
poikiloblast: [a]/pɔɪ'kɪloblæst/; [n]异形成红细胞;<岩>变嵌晶; [or]chem;
poiser: [a]/'pɔɪzɚ/; [n]平衡者;平衡剂(氧化还原反应缓冲剂); [or]chem;
polarogram: [a]/pəʊ'lærəɡræm/; [n]<分化>极谱图; [or]chem;
polarograph: [a]/po'lærəɡræf/; [n]<分化>极谱仪,极谱记录仪; [or]chem;
polarography: [a]/,pəʊlə'rɒgrəfɪ/; [n]<分化>极谱法; [or]chem;
policeman: [a]/pəˈliːsmən/; [n]警察,警员;<分化>淀帚(橡皮头玻璃搅棒); [add]pl/policemen; [or]chem;
polyacid: [a]/,pɔli'æsid/; [n](无化)多元酸; [adj]多酸的(尤指碱基); [or]chem;
polyamide: [a]/,pɒlɪ'eɪmaɪd; -'æm-/; [n]<高分子>聚酰胺(尼龙); [or]chem;
polyatomic: [a]/ˌpɒlɪəˈtɒmɪk/; [adj]多原子的;多碱的,多酸的; [or]chem;
polybasic: [a]/,pɒlɪ'beɪsɪk/; [adj]多元的;多碱的;多硷的; [or]chem;
polyethylene: [a]/ˌpɒliˈeθəliːn/; 聚乙烯 (PE); [or]chem;
polygenetic: [a]/,pɑlidʒə'nɛtɪk/; [adj]<染料>多色的;多成因的;多时代的; [or]chem;
polymerism: [a]/pə'limərizəm, 'pɔli-/; [n]聚合性,<高分子>聚合现象; [or]chem;
polymerization: [a]/ˌpɒliməraɪˈzeɪʃn/; [n]聚合;<高分子>聚合作用; [or]chem;
polymethylene: [a]/,pɔli'meθili:n/; [n]聚亚甲基;聚甲烯; [or]chem;
polyoxymethylene: [a]/,pɔli,ɔksi'meθili:n/; [n]<高分子>聚甲醛; [or]chem;
polysilicate: [a]/,pɔli'silikit/; [n]聚硅酸盐; [or]chem;
polystyrene: [a]/ˌpɒliˈstaɪriːn/; [n]<高分子>聚苯乙烯; [or]chem;
polysulphide: [a]/pɔli'sʌlfaid/; [n]<无化>多硫化物; [or]chem;
polythene: [a]/ˈpɒlɪθiːn/; [n]<高分子>聚乙烯(等于polyethylene); [or]chem;
polyvinyl: [a]/,pɒlɪ'vaɪn(ə)l/; [n]聚乙烯化合物; [adj]乙烯聚合物的; [or]chem;
polyvinylidene: [a]/,pɒlɪvaɪ'nɪlə,diːn/; [n]聚乙二烯; [or]chem;
pontil: [a]/'pɒntɪl/; [n]铁棒; [or]chem;
porphyrine: [a]/'pɔːfɪraɪn/; 紫菜碱; [or]chem;
porphyrite: [a]/'pɔ:firait/; [n]<岩>玢岩;斜长斑岩,微闪长岩; [or]chem;
porphyritic: [a]/,pɔːfɪ'rɪtɪk/; [adj]斑岩的; [or]chem;
porphyroid: [a]/'pɔːfɪrɒɪd/; [n]残斑岩; 残斑岩的; [or]chem;
portcullis: [a]/pɔːtˈkʌlɪs/; [n]吊闸;铁闸门; [vt]给.装吊闸; [add]pl/portcullises; [or]chem;
powder: [a]/ˈpaʊdə(r)/; [n]粉;粉末;<化工><军>火药;尘土; [vt]使成粉末;撒粉;搽粉于; [vi]搽粉;变成粉末; [add]pl/powders,pt/powdered,pr/powdering,s3/powders; [or]chem;
powellite: [a]/'pauəlait/; [n]钼钨钙矿; [or]chem;
precure: [a]/'pri:'kjuə/; [n]预固化,预塑化;预硫早熟化; [v]预塑化,预硫早熟化; [or]chem;
preparator: [a]/prɪ'pærətɚ/; [n]选矿机;制作标本人员;食品制作人; [or]chem;
propene: [a]/'prəʊpiːn/; [n]丙烯; [or]chem;
propenyl: [a]/prə'penil/; [n]丙烯基; [or]chem;
propyl: [a]/'prəʊpaɪl; -pɪl/; [n]丙基;丙烷基; [or]chem;
propylite: [a]/'prɒpɪlaɪt/; [n]青磐岩; [or]chem;
propylitization: [a]/,prɔpəlitai'zeiʃən/; [n]绿磐岩化(作用); [or]chem;
propylon: [a]/'prɔpilɔn/; [n]入口;普罗皮纶聚丙烯纤维; [add]pl/propylons或propyla; [or]chem;
prospect: [a]/ˈprɒspekt/; [n]前途;预期;景色; [vi]勘探,找矿; [vt]勘探,勘察; [add]pl/prospects,pt/prospected,pp/prospected,pr/prospecting,s3/prospects; [or]chem;
prospector: [a]/prəˈspektə(r)/; [n]探勘者;采矿者; [add]pl/prospectors; [or]chem;
prosthetic: [a]/prɒsˈθetɪk/; [adj]假体的;非朊基的; [or]chem;
protogine: [a]/'prəutəudʒin/; [n]绿泥花岗岩; [or]chem;
prototrophic: [a]/,prəʊtə'trɒfɪk/; [adj]原养型的;矿质寄生的; [or]chem;
protoxide: [a]/prəʊ'tɒksaɪd/; [n]<无化>低氧化物; [or]chem;
psammite: [a]/'sæmaɪt/; [n]<岩>砂屑岩(等于arenite); [or]chem;
psephite: [a]/'siːfaɪt/; [n]<岩>砾质岩;碎砾岩; [or]chem;
pseudoephedrine: [a]/,sʊdoɪ'fɛdrɪn; ,sʊd'ɛfɪ,drin/; [n]伪麻黄碱(可解除鼻腔充血的药物); [or]chem;
pseudotachylite: [a]/sju:dəu'tækilait/; [n]<岩>假玄武玻璃; [or]chem;
ptomain: [a]/'tomen/; [n]尸碱;尸毒; [or]chem;
ptomaine: [a]/'təʊmeɪn/; [n]尸碱;尸毒;肉毒胺; [or]chem;
puddled: [a]/ˈpʌdəl/; [v]使泥泞,搅浑;用胶土填塞;把(黏土和沙)捣成胶土;搅炼(融化的铁水)(puddl; [prep]'s pt and pp); [or]chem;
puddling: [a]/'pʌdlɪŋ/; [v](尤指雨水)弄湿;(液体)形成水潭;(在泥潭,浅水滩)打滚;用胶土填(洞);把(黏土和沙)捣成胶土(puddl; [prep]的现在分词); [n]搅炼,炼铁;捣成泥浆; [or]chem;
pulaskite: [a]/pə'læskait/; [n]斑霞正长细晶岩;斑霞正长岩; [or]chem;
pumice: [a]/ˈpʌmɪs/; [n]浮岩,浮石,轻石; [v]用浮石打磨,清洁; [add]pt/pumiced,pp/pumiced,pr/pumicing,pl/pumices,s3/pumices; [or]chem;
pylon: [a]/ˈpaɪlən/; [n]桥塔;指示塔;高压线铁塔; [add]pl/pylons; [or]chem;
pyrazolone: [a]/pi'ræzə,ləun/; [n]吡唑啉酮; [or]chem;
pyrazolyl: [a]/pi'ræzə,lil/; [n]吡唑基; [or]chem;
pyridazine: [a]/pai'ridə,zin/; [n]哒嗪;邻二氮杂苯; [or]chem;
pyridyl: [a]/'piridil/; [n]氮苯基;吡啶基; [or]chem;
pyrimidine: [a]/pɪ'rɪmɪdiːn/; [n]嘧啶,密定二氮三烯陆环; [or]chem;
pyrites: [a]/paɪˈraɪtiːz/; [n]硫化铁矿; [add]pl/pyrites; [or]chem;
pyritic: [a]/paiə'ritik/; [adj]硫化铁矿的; [or]chem;
pyroborate: [a]/,paɪərə'bɔːreɪt/; <无化>焦硼酸盐; [or]chem;
pyrochemical: [a]/,paɪərəʊ'kemɪkəl/; [adj]高温化学的(副词pyrochemically); [or]chem;
pyrogenic: [a]/,paɪrə(ʊ)'dʒenɪk/; [adj]<岩>火成的;高热所产生的; [or]chem;
pyrophosphate: [a]/,paɪrə(ʊ)'fɒsfeɪt/; [n]<无化>焦磷酸盐;焦磷酸酯; [or]chem;
pyrosphere: [a]/'pairə,sfiə/; [n]岩浆圈;火界;熔界; [or]chem;
pyroxenite: [a]/paɪ'rɒksɪnaɪt/; [n]辉石岩;<岩>辉岩; [or]chem;
pyrrhotine: [a]/ˈpɪrəˌtiːn, -ˌtaɪn, -tɪn/; 磁黄铁矿; [or]chem;
quantivalence: [a]/kwɔnti'veiləns/; [n]原子价;化合价; [or]chem;
quarried: [a]/ˈkwɒrɪ/; [v]从(采石场)采(石等);开凿(岩石或地面)采石;挖掘(真相等)(quarry 的过去式及过去分词); [or]chem;
quartzite: [a]/'kwɔːtsaɪt/; [n]石英岩;硅岩; [or]chem;
quicksilver: [a]/ˈkwɪksɪlvə(r)/; [n]水银,汞;变化莫测的事物; [adj]瞬息万变的; [v]用水银处理; [or]chem;
quicksilvering: [a]/ˈkwɪksɪlvə(r)/; [n]水银,汞;变化莫测的事物; [adj]瞬息万变的; [v]用水银处理; [or]chem;
quinazoline: [a]/kwi'næzəli:n/; [n]间二氮杂萘;喹唑啉; [or]chem;
quinine: [a]/ˈkwɪniːn/; [n]奎宁;金鸡纳碱; [or]chem;
quinquevalent: [a]/,kwɪnkwɪ'veɪl(ə)nt/; [adj]五价的;有五种不同原子价的; [or]chem;
quintessence: [a]/kwɪnˈtesns/; [n]精华;典范;第五元素(被视为地,水,火,风以外之构成宇宙的元素); [or]chem;
quoit: [a]/kɔɪt; kwɔɪt/; [n]铁圈;金属环; [vt]投掷; [vi]玩套环游戏; [add]pl/quoits; [or]chem;
quoits: [a]/kɔɪt; kwɔɪt/; [n]铁圈;金属环; [vt]投掷; [vi]玩套环游戏; [add]pl/quoits; [or]chem;
radiochemical: [a]/ˌreɪdioʊˈkemɪkl/; [adj]放射化学的; [or]chem;
raffinate: [a]/'ræfɪneɪt/; [n]<化工>萃余液;残油液;剩余液; [or]chem;
raglanite: [a]/'ræɡlənait/; [n]奥霞正长岩;刚玉霞长岩; [or]chem;
ragstone: [a]/'rægstəun/; [n]硬质岩石; [or]chem;
rail: [a]/reɪl/; [n]铁轨;扶手;横杆;围栏; [vi]抱怨;责骂; [vt]铺铁轨;以横木围栏; [add]pl/rails,pt/railed,pp/railed,pr/railing,s3/rails; [or]chem;
railage: [a]/'reilidʒ/; [n]铁路运输;铁路运费; [or]chem;
railman: [a]/ˈreɪlmən/; [n]铁路员工;铁路公司老板;码头工人; [add]pl/railmen; [or]chem;
railroad: [a]/ˈreɪlrəʊd/; [n]铁路;铁路公司; [v]迫使..仓促行事; 强使..草率通过; 轻率判处; 在铁路工作;乘火车旅行; [add]pl/railroads,pt/railroaded,pp/railroaded,pr/railroading,s3/railroads; [or]chem;
railroadiana: [a]/,reɪlrəʊdɪ'ɑːnə/; [n]铁路文献; [or]chem;
railroading: [a]/'reɪl,rəʊdɪŋ/; [n]铁路建设;仓促行事; [v]由铁路运输;乘火车旅行(railroad的ing形式); [or]chem;
railway: [a]/ˈreɪlweɪ/; [n](英)铁路;轨道;铁道部门; [vi]乘火车旅行; [add]pl/railways; [or]chem;
rapakivi: [a]/,rɑːpə'kiːviː/; [n]<岩>奥环斑花岗岩;奥长环斑岩;环斑花岗岩; [or]chem;
rashing: [a]/'ræʃiŋ/; [n]煤下页岩;煤层底板的软碳质页岩; [or]chem;
react: [a]/riˈækt/; [vi]反应,作出反应;产生(化学)反应; [or]chem;
reactivation: [a]/riˌæktɪˈveɪʃn/; [n]<物化>再活化;再生;复能的情况;<核>重激活; [or]chem;
realgar: [a]/rɪ'ælgə/; [n]雄黄(二硫化二砷);鸡冠石; [or]chem;
rechar: [a]/ˈriːtʃɑː/; 1.  [n]an EU funding programm; [prep]development of depressed mining areas 欧盟矿区转产资助计划; [or]chem;
recrystallization: [a]/riː,krɪstəlaɪ'zeɪʃən/; [n]再结晶; [or]chem;
recrystallize: [a]/ri:'kristəlaiz/; [vt](使)再结晶; [vi]再结晶; [add]pt/recrystallized,pp/recrystallized,pr/recrystallizing; [or]chem;
rectifiable: [a]/ˌrektɪˈfaɪəbl/; [adj]<化工>可精馏的;可矫正的;可改正的; [or]chem;
recuperability: [a]/ri,kju:pərə'biləti/; [n]<化工>可回收性;恢复力; [or]chem;
reducer: [a]/rɪ'djuːsə/; [n]<助剂>还原剂;减径管; [or]chem;
reductant: [a]/rɪ'dʌkt(ə)nt/; [n]<助剂>还原剂; [or]chem;
reductive: [a]/rɪˈdʌktɪv/; [adj]还原的;减少的; [n]<助剂>还原剂; [or]chem;
refined: [a]/rɪˈfaɪnd/; [adj]<油气><化工><冶>精炼的;精确的;微妙的;有教养的; [add]er/morerefined,est/mostrefined; [or]chem;
refinement: [a]/rɪˈfaɪnmənt/; [n]改进,改善;有教养;精制;文雅;acidimetric: [a]/,æsidi'metrik/; [adj]<分化>酸量滴定的; [or]chem;
regenerator: [a]/rɪ'dʒenəreɪtə/; [n]<化工>再生器;改革者,更新者;蓄热器; [or]chem;
remineralization: [a]/rɪ,mɪnərəlaɪ'zeɪʃən/; [n]补充矿质; [or]chem;
remineralize: [a]/riː'mɪnərəlaɪz/; 使重新矿化; [or]chem;
resist: [a]/rɪˈzɪst/; [vi]抵抗,抗拒;忍耐; [vt]抵抗;忍耐,忍住; [n]<助剂>抗蚀剂;防染剂; [add]pt/resisted,pp/resisted,pr/resisting,s3/resists; [or]chem;
retinene: [a]/'retɪniːn/; [n]视网醛,视黄素;维生素A醛; [or]chem;
rezbanyite: [a]/rez'bæni,ait/; [n]铜辉铅铋矿; [or]chem;
rhabdomancy: [a]/'ræbdə,mænsɪ/; [n]棍卜术(用探矿杖占测矿物的迷信活动); [or]chem;
rhabdophanite: [a]/ræbdə'fænait/; [n]磷铈钇矿; [or]chem;
rhodochrosite: [a]/,rəʊdə(ʊ)'krəʊsaɪt/; [n]菱锰矿; [or]chem;
rhodolite: [a]/'rəʊdəlaɪt/; [n]铁镁铝榴石,红榴石; [or]chem;
rhombohedron: [a]/,rɒmbə(ʊ)'hiːdr(ə)n; -'hed-/; [n]<晶体>菱面体; [add]pl/rhombohedrons或rhombohedra; [or]chem;
rhyodacite: [a]/rai'ɔdəsait/; [n]疗英安岩,<岩>流纹英安岩; [or]chem;
rhyolite: [a]/'raɪəlaɪt/; [n]<岩>流纹岩;表面光滑的火山岩; [or]chem;
ride: [a]/raɪd/; [v]骑,乘(自行车,摩托车或马等),搭乘(地铁,火车);驾驭,支配,试图控制(某人)并强迫其工作;飘浮;穿越,翻越; 依赖于,取决于;数落,嘲弄;被(巨大冲力)带走,得益于; [add]pt/rode或rid,pp/ridden或rid,pr/riding,s3/rides;  [or]chem;
rimrock: [a]/'rɪmrɒk/; [n](美)悬崖;<岩>顶岩; [or]chem;
rinkite: [a]/'riŋ,kait/; [n]层硅铈钛矿;褐硅铈石; [or]chem;
roast: [a]/rəʊst/; [v]烘,烤(肉等);烤,炒(坚果,豆子等);(食物)烤;烘干(食品原料,金属矿等);(使)受热发烫;变热;以火刑折磨;严厉批评;(非正式)和善地戏弄; [n]烤肉;一盘烘烤物;烘,烤(尤指咖啡);(某种)烘过的咖啡;户外烧烤野餐;耍笑庆祝会; [adj](食物)烤过的; [add]pl/roasts,pt/roasted,pp/roasted,pr/roasting,s3/roasts; [or]chem;
rockallite: [a]/'rɔkəlait/; [n]钠辉花岗岩; [or]chem;
rockless: [a]/'rɑklɪs/; [adj]无岩石的; [or]chem;
rocklike: [a]/'rɔklaik/; [adj]石头般的;坚硬如岩石的; [or]chem;
rockslide: [a]/'rɒkslaɪd/; [n]岩滑;崩落的岩石; [or]chem;
rockweed: [a]/'rɒkwiːd/; [n]生在海岸岩石上的海草; [or]chem;
rockwork: [a]/'rɒkwɜːk/; [n]天然岩石群;假山;攀岩技术; [or]chem;
rocky: [a]/ˈrɒki/; [adj]岩石的,多岩石的;坚如岩石的;摇晃的;头晕目眩的; [add]er/rockier,est/rockiest; [or]chem;
rodingite: [a]/'rəudiŋait/; [n]异剥钙榴岩; [or]chem;
roestone: [a]/'rəustəun/; [n]<岩>鲕粒岩;鱼卵石; [or]chem;
rogersite: [a]/'rɔgə,sait/; [n]六水铁矾; [or]chem;
rosaniline: [a]/rə(ʊ)'zænɪliːn; -lɪn; -laɪn/; [n]由苯胺制得的红色染料; [or]chem;
rosenbuschite: [a]/'rəuzənbu,ʃait/; [n]橙针钠钙石; [or]chem;
rougemontite: [a]/'ru:ʒməntait/; [n]橄钛辉长岩; [or]chem;
routivarite: [a]/ru:'tivərait/; [n]褶英二长岩;榴英斜长岩;英榴细斜长岩; [or]chem;
rowlandite: [a]/'rəuləndait/; [n]硅氟铁钇矿;矽氟钇矿; [or]chem;
ruddleman: [a]/'rʊdlmən/; [n]卖赤铁矿的人;红土商; [add]pl/ruddlemen; [or]chem;
runite: [a]/'ru:nait/; [n]文象花岗岩; [or]chem;
rupestrine: [a]/ruː'pestrɪn/; [adj]生长在岩石上的; [or]chem;
rust: [a]/rʌst/; [vt]使生锈;腐蚀; [vi]生锈;成铁锈色;变迟钝; [add]pl/rusts,pt/rusted,pp/rusted,pr/rusting,s3/rusts;  [or]chem;
rusty: [a]/ˈrʌsti/; [adj]生锈的,腐蚀的;铁锈色的,锈色的;迟钝的; [add]er/rustier,est/rustiest; [or]chem;
rutherford: [a]/'rʌðəfəd/; [n]卢瑟福(英国物理学家,化学家); [or]chem;
rutilated: [a]/'ru:tileitid/; [adj](矿物,尤指石英)含金红针的; [or]chem;
sadiron: [a]/'sæd,aɪən/; [n]熨斗;烙铁; [or]chem;
safflower: [a]/ˈsæflaʊə(r)/; [n]红花;<染料>红花染料; [or]chem;
safranine: [a]/'sæfrəniːn/; [n]盐基性红色染料;番红精;碱性臧红,番红;番红色燃料; [or]chem;
sagvandite: [a]/'sægvəndait/; [n]菱镁古铜岩;菱镁古铜碳酸岩; [or]chem;
saleratus: [a]/,sælə'reɪtəs/; [n]小苏打;碳酸氢钠; [or]chem;
salicyl: [a]/'sæləsɪl/; [n]水杨基;邻羟苯基; [or]chem;
salicylanilide: [a]/,sælɪsɪl'ænɪlaɪd/; [n]N-水杨酰苯胺; [or]chem;
saline: [a]/ˈseɪlaɪn/; [adj]盐的,含盐的;咸的;含氯化钠的;含镁盐类的;含碱金属盐类的; [n]盐溶液;生理盐水; [or]chem;
salivation: [a]/ˌsælɪˈveɪʃn/; [n]分泌唾液;流涎症;汞中毒; [or]chem;
salol: [a]/'sælɔl/; [n]萨罗(水杨酸苯酯,用作保护皮肤的药剂); [or]chem;
saltiness: [a]/ˈsɔːltinəs; ˈsɒltinəs/; [n]咸性;尖酸;碱度; [or]chem;
salting: [a]/'sɔltɪŋ/; [n](常用作复数)盐碱滩; [v]给.加盐(salt的ing形式); [or]chem;
salvarsan: [a]/'sælvɚ,sæn/; [n]撒尔佛散(治疗梅毒特效剂);胂凡钠明; [or]chem;
samiresite: [a]/,sæmi'resait/; [n]铌钛铀铅矿;铀铅烧绿石; [or]chem;
sandrock: [a]/'sænd,rɑk/; [n]沙岩; [or]chem;
sanidinite: [a]/'sænidinait/; [n]<岩>透长岩;透长石岩; [or]chem;
sannaite: [a]/'sænnait/; [n]棕闪煌岩;霞闪正煌岩; [or]chem;
santorinite: [a]/'sæntərinait/; [n]班苏安山岩;淡苏英安岩; [or]chem;
sanukite: [a]/'sænjukait/; [n]赞岐岩;琉苏安山岩; [or]chem;
saponin: [a]/'sæpənɪn/; [n]肥皂精,皂素;皂角苷;甾族和萜糖苷类物质; [or]chem;
sarcolite: [a]/'sa:kə,lait/; [n]肉色柱石;肉柱石;钠菱沸石; [or]chem;
sartorite: [a]/'sɑ:tərait/; [n]脆硫砷铅矿; [or]chem;
saturator: [a]/'sætʃəreitə/; [n]<化工>饱和器; [or]chem;
saxatile: [a]/'sæksətɪl/; [adj]岩栖的;生长于岩石间的; [or]chem;
saxicoline: [a]/sæk'sɪkəlɪn/; [adj]岩生的,岩栖的; [or]chem;
saxonite: [a]/'sæksənait/; [n]方辉橄榄岩;色克桑那特(炸药); [or]chem;
scandia: [a]/'skændiə/; [n]<无化>氧化钪; [or]chem;
schalstein: [a]/'ʃɑ:lstain/; [n]<岩>辉绿凝灰岩;基变凝炭岩; [or]chem;
schist: [a]/ʃɪst/; [n]<岩>片岩; [or]chem;
schistose: [a]/'ʃɪstoz/; [adj](变形岩石)片岩结构的; [or]chem;
schizolite: [a]/skizəlait/; [n]锰针钠钙石; [or]chem;
schlieren: [a]/'ʃliərən/; [n]纹影;(火成岩的)异离体; [or]chem;
schriesheimite: [a]/'ʃri:ʃai,mait/; [n]辉闪苦橄岩; [or]chem;
scopolamine: [a]/skə(ʊ)'pɒləmiːn/; [n]莨菪碱(等于scopalamine); [or]chem;
scorching: [a]/ˈskɔːtʃɪŋ/; [adj]灼热的;激烈的;讽刺的;过早硫化的; [v]把.烧焦;严厉批评;切割;过早硫化(scorch的ing形式); [or]chem;
scoriaceous: [a]/,skɔ:ri'eiʃəs/; [adj]烧石的;铁渣子的; [or]chem;
scorify: [a]/'skɔːrɪfaɪ/; [vt]使变成矿渣;析取; [add]pt/scorified,pp/scorified,pr/scorifying,s3/scorifies; [or]chem;
scotia: [a]/'skəʊʃə/; [n]凹形边饰,(柱基的)凹线边饰; [or]chem;
scrambling: [a]/ˈskræmblɪŋ/; [v]攀登;快速移动;仓促地(或艰难地)完成;炒(蛋);(非正式)取得;(美式橄榄球)带球跑到阻截争球线后避免阻截;对(广播,电话)加密;争夺;扰乱..的频率;打乱;紧急起飞(scramble 的现在分词); [n]摩托车越野赛;越野(尤指悠闲活动);攀岩;扰频; [or]chem;
scree: [a]/skriː/; [n]小石子;岩屑堆;崩落;筛; [add]pl/screes; [or]chem;
scrubber: [a]/ˈskrʌbə(r)/; [n]<化工>洗涤器;洗刷者;刷子; [add]pl/scrubbers; [or]chem;
scyelite: [a]/'sailait/; [n]<岩>闪云橄榄岩; [or]chem;
sebacate: [a]/sɪ'bæket/; [n]癸二酸盐;癸二酸酯; [or]chem;
sebastianite: [a]/si'bæstjənait/; [n]黑云钙长岩; [or]chem;
selagite: [a]/'si:ləɡait/; [n]黑云粗面岩; [or]chem;
selenate: [a]/'selɪneɪt/; [n]硒酸盐; [or]chem;
selenide: [a]/'selin（a）id/; [n]硒醚,<无化>硒化物; [or]chem;
selenite: [a]/'selɪnaɪt/; [n]<无化>亚硒酸盐;透明石膏; [or]chem;
semimetal: [a]/ˈsemimetl/; [n]半金属,准金属; [or]chem;
seps: [a]/seps/; [n](SEPS) 苯乙烯―乙烯/丙烯―苯乙烯嵌段共聚物; [or]chem;
sesquiterpene: [a]/,seskwi'tə:pi:n/; [n]倍半萜烯; [or]chem;
shale: [a]/ʃeɪl/; [n]<岩>页岩;泥板岩; [add]pl/shales; [or]chem;
shaly: [a]/ˈʃeɪli/; [adj]页岩的;含页岩的; [or]chem;
sherardize: [a]/'ʃɛrɚ,daɪz/; [vt]在(铁制品等)上镀锌; [vi]镀上锌粉; [add]pt/sherardized,pp/sherardized,pr/sherardizing; [or]chem;
shingling: [a]/'ʃɪŋgl/; [n]覆盖作用;叠瓦构造;压挤熟铁块; [v]用墙面板装修;使叠盖(shingle的ing形式); [or]chem;
shod: [a]/ʃɒd/; [v]给(马)钉蹄铁;穿鞋(或靴);用金属片包裹;为(轮子)装轮胎(sho; [prep]的过去式及过去分词); [adj]穿着..鞋的; [or]chem;
shoeing: [a]/ʃuː/; [v]给(马)钉蹄铁;给..穿鞋;用金属片包裹;为(轮子)装轮胎(sho; [prep]的现在分词); [or]chem;
shoer: [a]/'ʃuːə/; [n]钉蹄铁工人;挂掌匠; [or]chem;
shonkinite: [a]/'ʃɔŋkinait/; [n]<岩>等色岩;暗辉正长岩; [or]chem;
shoshonite: [a]/ʃəu:'ʃəunait/; [n]正边粗玄岩;橄辉碱玄岩;橄榄玄粗岩; [or]chem;
shovel: [a]/ˈʃʌvl/; [n]铁铲;一铲的量;铲车; [vt]铲除;用铲挖;把.胡乱塞入; [vi]铲; [add]pt/shovelled或shoveled,pp/shovelled或shoveled,pr/shovelling或shoveling,pl/shovels,s3/shovels; [or]chem;
siberite: [a]/'sibərait/; [n]<宝>紫碧硒,西伯电气石; [or]chem;
siderism: [a]/'sidərizəm/; [n]金属疗法;铁质沉着磁性; [or]chem;
siderite: [a]/'saɪdəraɪt; 'sɪd-/; [n]菱铁矿;陨铁; [or]chem;
siderolite: [a]/'s（a）ɪdərəlaɪt/; [n]铁陨石; [or]chem;
silane: [a]/'sɪleɪn/; [n]<无化><电子>硅烷;矽烷; [or]chem;
silcrete: [a]/'silkri:t/; [n]<岩>硅结砾岩;硅质壳层; [or]chem;
silicane: [a]/'silikein/; [n]<无化>硅烷;甲硅烷; [or]chem;
silication: [a]/,sili'keiʃən/; [n]硅化作用; [or]chem;
silicatization: [a]/silikəti'zeiʃən/; [n]硅化,硅化作用;硅化酌; [or]chem;
siliceous: [a]/sɪ'lɪʃəs/; [adj]硅酸的;硅土的; [or]chem;
silicic: [a]/sɪ'lɪsɪk/; [adj]硅的;含硅的; [or]chem;
silicide: [a]/'sɪlɪsaɪd/; [n]<无化>硅化物; [or]chem;
silicification: [a]/sɪlɪ,səfɪ'keʃən/; [n]<无化>硅化;硅化作用; [or]chem;
silicify: [a]/sɪ'lɪsɪfaɪ/; [v]使硅化; [add]s3/silicifies,pt/silicified,pp/silicified,pr/silicifying; [or]chem;
silicious: [a]/sɪ'lɪʃəs/; [adj]含硅的;硅土的;硅酸的; [or]chem;
silicium: [a]/sɪ'lɪsɪəm/; [n]硅(14号元素,旧名矽); [or]chem;
silicoethane: [a]/,silikəu'eθein/; [n]乙硅烷; [or]chem;
silicoflagellate: [a]/,silikəfrə'dʒeləti:/; [n]硅鞭藻; [or]chem;
silicofluoride: [a]/silikəu'fluəraid/; [n]氟硅酸盐,氟硅化物; [or]chem;
siliconize: [a]/'silikənaiz/; [v]硅化处理; [add]pt/siliconized,pp/siliconized,pr/siliconizing; [or]chem;
silicotic: [a]/,sɪlɪ'kɒtɪk/; 硅肺的; 矽肺的; [or]chem;
sillimanite: [a]/'sɪlɪmənaɪt/; [n]硅线石; [or]chem;
silyl: [a]/' silil/; [n]甲硅烷基; [or]chem;
sinalbin: [a]/sɪ'nælbɪn/; 白芥子硫苷; 芥子白; [or]chem;
sinapine: [a]/'sinəpin/; [n]芥子酸胆碱; [or]chem;
singled: [a]/ˈsɪŋɡəl/; [v]挑选;对(幼树)进行间苗;将(铁轨)变成单线;(棒球)击出一垒打(singl; [prep]'s pt and pp); [or]chem;
sinomenine: [a]/,sainəu'meni:n/; [n]青藤碱;汉防己碱; [or]chem;
sinople: [a]/'sinəpl/; [n]铁石英;铁水铝英石; [or]chem;
skerry: [a]/ˈskeri/; [n]礁;多岩石之小岛; [add]pl/skerries; [or]chem;
skleropelite: [a]/'sklerə,pelaɪt/; 硬土粘土岩; [or]chem;
skomerite: [a]/'skəumərəit/; [n]橄辉钠长斑岩;橄辉钠质粗面岩; [or]chem;
slag: [a]/slæɡ/; [n]炉渣;矿渣;熔渣; [vt]使成渣;使变成熔渣; [vi]变熔渣; [add]pt/slagged,pp/slagged,pr/slagging,pl/slags,s3/slags; [or]chem;
slate: [a]/sleɪt/; [vt]铺石板;严厉批评某人;计划; [adj]板岩的;石板色的; [add]pl/slates,pt/slated,pp/slated,pr/slating,s3/slates;  [or]chem;
slaty: [a]/ˈsleɪti/; [adj]深灰色的,石板色的;石板一样的,板岩的; [add]er/slatier,est/slatiest; [or]chem;
slickenside: [a]/'slɪk(ə)nsaɪd/; [n](与邻石摩擦而成之)岩石光滑面;镜岩; [or]chem;
slimer: [a]/'slaimə/; [n]细粉碎机;矿泥摇床;细粒摇床;洗肠机; [or]chem;
sluice: [a]/sluːs/; [n]水闸;蓄水;洗矿槽; [vt]冲洗;开闸放水; [vi]奔流; [add]pt/sluiced,pp/sluiced,pr/sluicing,pl/sluices,s3/sluices; [or]chem;
smit: [a]/smɪt/; [abbr]系统管理界面工具(System Management Interfac; [prep]Tool);钠离子-肌醇转运蛋白;  [or]chem;
smith: [a]/smɪθ/; [n]铁匠;锻工;制作者; [vt]锻制; [vi]锻打金属;当锻工; [or]chem;
smithery: [a]/'smɪθ(ə)rɪ/; [n]铁匠铺;锻冶工作;锻冶技术; [add]pl/smitheries; [or]chem;
smithite: [a]/'smiθait/; [n]斜硫砷银矿; [or]chem;
smithy: [a]/ˈsmɪði/; [n]铁匠铺;铁匠;锻冶场; [add]pl/smithies; [or]chem;
snotter: [a]/'snɑtɚ/; [n]鼻涕;氧化铈夹杂物; [or]chem;
snowshed: [a]/'snəʊʃed/; [n](铁路)防雪棚; [or]chem;
sodamide: [a]/'sodəmaɪd/; [n]<无化>氨基钠(等于sodium amide); [or]chem;
sodic: [a]/'sodɪk/; [adj]钠的;含钠的; [or]chem;
solanine: [a]/'sɒləniːn/; [n]茄碱; [or]chem;
solod: [a]/'sɔlət, -əd/; [n]脱碱土; [add]pl/solods或solodi; [or]chem;
solutizer: [a]/'sɔlju:taizə/; [n]硫醇溶解加速剂; [or]chem;
spa: [a]/spɑː/; 矿泉;温泉浴场;矿泉治疗地;水疗会所 ;水疗生活馆; [or]chem;
spall: [a]/spɔːl/; [v]击碎(矿石等);(矿石等)裂成碎片;(使)死皮脱落;  [or]chem;
spectrochemistry: [a]/,spektrə(ʊ)'kemɪstrɪ/; [n]光谱化学; [or]chem;
spectrophone: [a]/'spektrəfəun/; [n]<分化>光谱测声器; [or]chem;
sperone: [a]/spə'rəuni/; [n]黑榴白榴岩; [or]chem;
sphingosine: [a]/'sfɪŋɡəsɪn/; [n]鞘氨醇;神经胺; [or]chem;
spilite: [a]/'spailait/; [n]<岩>细碧岩; [or]chem;
spilosite: [a]/'spailəsait/; [n]绿点板岩; [or]chem;
spleenwort: [a]/'spliːnwɜːt/; [n]铁角蕨;铁角凤尾草属的植物; [or]chem;
stabilizer: [a]/ˈsteɪbəlaɪzə(r)/; [n]<助剂>稳定剂;稳定器;安定装置; [add]pl/stabilizers; [or]chem;
stable: [a]/ˈsteɪbl/; [adj]稳定的,牢固的;稳重的,沉稳的;持久的;(化学术语)稳定的; [v]赶入马房,把(马)拴在马厩;(被)关在马厩; [add]pt/stabled,pp/stabled,pr/stabling,pl/stables,s3/stables;  [or]chem;
stainierite: [a]/'steiniərait/; [n]水钴矿; [or]chem;
stannane: [a]/'stænein/; [n]<无化>锡烷; [or]chem;
stannary: [a]/'stæn(ə)rɪ/; [n]锡矿区;锡矿山; [add]pl/stannaries; [or]chem;
stannate: [a]/'stænet/; [n]<无化>锡酸盐; [or]chem;
stannite: [a]/'stænaɪt/; 黄锡矿; <无化>亚锡酸盐; [or]chem;
stavrite: [a]/'stævrait/; [n]黑云角闪岩; [or]chem;
steatite: [a]/'stɪətaɪt/; [n]滑石;皂石;<岩>块滑石; [or]chem;
steel: [a]/stiːl/; [vt]钢化;使冷酷; [adj]钢制的;钢铁业的;坚强的; [add]pl/steels,pt/steeled,pp/steeled,pr/steeling,s3/steels;  [or]chem;
steelmaker: [a]/'stil,mekɚ/; [n]钢铁公司;炼钢工; [add]pl/steelmakers; [or]chem;
steelwork: [a]/'stiːlwɜːk/; [n]钢制品;炼钢厂;钢铁构造; [or]chem;
steely: [a]/ˈstiːli/; [adj]似钢的,钢铁般的;钢制的;严格的; [add]er/steelier,est/steeliest;  [or]chem;
stereochemical: [a]/,steriəu'kemik, ,steriəu'kemikəl, ,stiə-/; [adj]立体化学的; [or]chem;
stereoisomer: [a]/,sterɪəʊ'aɪsəmə; ,stɪə-/; [n]<物化>立体异构体; [or]chem;
steric: [a]/'sterɪk; 'stɪərɪk/; [adj]位的(副词sterically,异体字sterical);(原子的)空间(排列)的;  [or]chem;
stibine: [a]/'stɪbiːn/; <无化>锑化氢; [or]chem;
stilbene: [a]/'stɪlbiːn/; [n]对称二苯代乙烯; [or]chem;
stilbestrol: [a]/stɪl'biːstrɒl/; [n]已烯雌酚; [or]chem;
stillage: [a]/'stɪlɪdʒ/; [n]<化工>釜馏物;酿酒厂的放桶台; [add]pt/stillaged,pp/stillaged,pr/stillaging; [or]chem;
stinkstone: [a]/'stɪŋkstəʊn/; [n]臭石,臭石灰岩; [or]chem;
stithy: [a]/'stɪðɪ/; [n]铁砧;打铁店; [vt]锻冶; [add]pl/stithies,pt/stithied,pp/stithied,pr/stithying,s3/stithies; [or]chem;
stob: [a]/stɒb/; [n]长铁楔; [or]chem;
stoichiometric: [a]/,stɒɪkɪə(ʊ)'metrɪk/; [adj]化学计量的;化学计算的; [or]chem;
stoichiometry: [a]/,stɒɪkɪ'ɒmɪtrɪ/; [n]化学计量学; [or]chem;
stope: [a]/stəʊp/; [v]用梯段法采矿;受顶蚀作用; [add]pt/stoped,pp/stoped,pr/stoping,pl/stopes,s3/stopes;  [or]chem;
stoper: [a]/'stəupə/; [n]伸缩式凿岩机,向上式凿岩机;上向凿岩机; [or]chem;
stratiform: [a]/'strætɪfɔːm/; [adj]分层排列的;(矿床)成层的; [or]chem;
stratigraphy: [a]/strə'tɪgrəfɪ/; [n]地层学;地层中的岩石组成; [or]chem;
strigovite: [a]/'striɡəvait/; [n]柱绿泥石;铁柱绿泥石; [or]chem;
strontia: [a]/'strɒnʃ(ɪ)ə/; [n]氧化锶; [or]chem;
structureless: [a]/'strʌktʃəlɪs/; [adj]无结构的,无定形的;不结晶的; [or]chem;
struvite: [a]/'stru:vait/; [n]鸟粪石,磷酸铵镁; [or]chem;
strychnic: [a]/'striknik/; [adj]马钱子碱的;士的宁的; [or]chem;
strychnine: [a]/ˈstrɪkniːn/; [n]士的宁;番木鳖碱; [or]chem;
stylographic: [a]/,staɪlə'ɡræfɪk/; [adj]尖笔写法的;铁笔刻写法的; [or]chem;
stylolite: [a]/'staɪlə(ʊ)laɪt/; [n]缝合岩面;(构成缝合线一部分的)石笔杆; [or]chem;
stylotypite: [a]/,stailə'taipait/; [n]柱形石;黝铜矿; [or]chem;
stylus: [a]/ˈstaɪləs/; [n]铁笔;唱针;尖笔;药笔剂; [add]pl/styluses或styli; [or]chem;
styrolene: [a]/'stairəli:n/; [n]肉桂塑料;苯乙烯(等于styrene); [or]chem;
styryl: [a]/'stairil/; [n]苯乙烯基; [or]chem;
sub: [a]/sʌb/; [n]潜水艇;地铁;替补队员; [vi]代替; [add]pt/subbed,pp/subbed,pr/subbing; [or]chem;
subalkaline: [a]/,sʌb'ælkəlɪn/; [adj]微碱的; [or]chem;
subatom: [a]/sʌb'ætəm/; [n]亚原子;次原子; [or]chem;
subcrystalline: [a]/,sʌb'krɪstəlɪn/; 亚晶态的; 结晶不明显的; 部分结晶的; [or]chem;
suberate: [a]/'sju:bəreit/; [n]辛二酸盐; [or]chem;
subhedral: [a]/,sʌb'hɛdrəl/; [adj]<晶体>半形的(没有完全被晶面包住的); [or]chem;
suboxide: [a]/sʌb'ɒksaɪd/; [n]低值氧化物; [or]chem;
subsilicate: [a]/'sʌb'siləkit/; [n]碱式硅酸盐; [or]chem;
subsurface: [a]/'sʌbsɜːfɪs/; [adj]地下的;表面下的; [n]地表下岩石; [or]chem;
subterrane: [a]/'sʌbtəreɪn/; [n]下层;地下室,洞穴;表层下基岩; [or]chem;
subunit: [a]/'sʌb,jʊnɪt/; [n]亚组;副族;子单元;元素,亚单元; [or]chem;
subway: [a]/ˈsʌbweɪ/; [n]地铁;地道; [vi]乘地铁; [add]pl/subways; [or]chem;
succinimide: [a]/sək'sinimaid/; [n]琥珀酰亚胺; [or]chem;
sudburite: [a]/'sʌdbərait/; [n]<岩>倍苏玄武岩; [or]chem;
sulfa: [a]/'sʌlfə/; [adj]磺胺的;磺胺药剂的; [n]磺胺药物; [add]pl/sulfas; [or]chem;
sulfamethazine: [a]/'sʌlfə'mɛθəzɪn/; [n]磺胺甲嘧啶; [or]chem;
sulfapyridine: [a]/,sʌlfə'pɪrɪdɪn/; 磺胺吡啶; [or]chem;
sulfaquinoxaline: [a]/,sʌlfəkwi'nɔksəli:n, -lin/; [n]磺胺喹喔啉(等于sulphaquinoxaline); [or]chem;
sulfathiazole: [a]/,sʌlfə'θaizəul, -zɔl/; [n]磺胺塞唑(等于sulphathiazole); [or]chem;
sulfhydryl: [a]/sʌl'haidril/; [n]巯氢基; [or]chem;
sulfonamide: [a]/sʌl'fɒnəmaɪd/; [n]磺胺类药;磺胺剂; [or]chem;
sulfonate: [a]/'sʌlfəneɪt/; [n]磺化, 磺酸盐(等于 sulphonate); [v]使..磺化; [or]chem;
sulfurate: [a]/'sʌlfjʊreɪt/; [adj]硫磺的;如硫磺的(等于sulphurate); [vt]使硫化;用硫处理; [add]pt/sulfurated,pp/sulfurated,pr/sulfurating; [or]chem;
sulfuration: [a]/,sʌlfə'reʃən/; [n]硫化; [or]chem;
sulfurator: [a]/'sʌlfəretɚ/; [n]硫黄熏蒸器; [or]chem;
sulfuret: [a]/'sʌlfjʊret/; [n]硫化物; [vt]使同硫化合;使含有硫; [add]pt/sulfureted或sulfuretted,pp/sulfureted或sulfuretted,pr/sulfureting或sulfuretting; [or]chem;
sulfuric: [a]/sʌl'fjʊərɪk/; [adj]硫磺的;含多量硫磺的;含(六价)硫的; [or]chem;
sulfurize: [a]/'sʌlfjʊəraɪz/; [vt]使含有硫磺;使硫化(等于sulphurize); [add]pt/sulfurized,pp/sulfurized,pr/sulfurizing,s3/sulfurizes; [or]chem;
sulfurous: [a]/'sʌlfərəs/; [adj]硫磺的;含有硫磺的; [or]chem;
sulpha: [a]/'sʌlfə/; [n]磺胺类药品; [or]chem;
sulphamate: [a]/'sʌlfəmeit/; [n]氨基磺酸盐; [or]chem;
sulphate: [a]/ˈsʌlfeɪt/; [n]硫酸盐; [vt]使与硫酸化合; [vi]硫酸盐化; [add]pt/sulphated,pp/sulphated,pr/sulphating,pl/sulphates,s3/sulphates; [or]chem;
sulphated: [a]/ˈsʌlfeɪt/; 硫酸盐; [or]chem;
sulphation: [a]/sʌl'feiʃən/; [n]硫酸化;硫化; [or]chem;
sulphidation: [a]/sʌlfi'deiʃən/; [n]硫化作用; [or]chem;
sulphide: [a]/ˈsʌlfaɪd/; [n]硫化物; [add]pl/sulphides; [or]chem;
sulphinyl: [a]/'sʌlfinil/; [n]亚硫酰基;亚磺酰; [or]chem;
sulphite: [a]/'sʌlfait/; [n]亚硫酸盐; [or]chem;
sulphohalite: [a]/,sʌlfəl'hælaɪt/; 卤钠石; [or]chem;
sulphonamide: [a]/sʌlfə'næmaɪd/; [n]磺胺;磺胺类药剂; [or]chem;
sulphonate: [a]/'sʌlfəneit/; [n]磺酸盐; [vt]使磺化; [add]pt/sulphonated,pp/sulphonated,pr/sulphonating; [or]chem;
sulphone: [a]/'sʌlfəun/; [n]砜(一种化学化合物); [or]chem;
sulphonyl: [a]/'sʌlfənil/; [n]磺酰(基);硫酰; [or]chem;
sulphur: [a]/ˈsʌlfə(r)/; [n]硫磺;硫磺色; [vt]使硫化;用硫磺处理; [or]chem;
sulphurate: [a]/'sʌlfəret/; [vt]使硫化;用硫处理; [n]硫磺熏蒸器; [or]chem;
sulphureous: [a]/sʌl'fjuəriəs/; [adj]含硫的;硫黄的; [or]chem;
sulphurization: [a]/,sʌlfəraɪ'zeʃən/; [n]硫化作用; [or]chem;
sulphurize: [a]/'sʌlfəraɪz/; [vt]用硫处理;使硫化; [add]pt/sulphurized,pp/sulphurized,pr/sulphurizing; [or]chem;
sulphurous: [a]/ˈsʌlfərəs/; [adj]含硫磺的;地狱般的; [or]chem;
sulphydryl: [a]/sʌl'faidril/; [n]巯基;氢硫基; [adj]含巯基的; [or]chem;
supercarbonate: [a]/sju:pə'ka:bəneit/; [n]碳酸氢盐(等于bicarbonate); [or]chem;
superelevation: [a]/,sju:pə,eli'veiʃən/; [n](铁路或公路的)超高; [or]chem;
superoxide: [a]/,supər'ɑksaɪd/; [n]超氧化物;过氧化物; [or]chem;
superphosphate: [a]/,suːpə'fɒsfeɪt; ,sjuː-/; [n](化肥)过磷酸钙,过磷酸盐,酸性磷盐; [or]chem;
swage: [a]/sweɪdʒ/; [n]旋锻工具;物体上的凹槽;型砧;冲模;型铁;铁模; [v]用旋锻工具模锻;用模锻法将金属连接在一起;用型铁弄弯曲; [add]pt/swaged,pp/swaged,pr/swaging,s3/swages; [or]chem;
sweetener: [a]/ˈswiːtnə(r)/; [n]甜料;好处;脱硫设备; [add]pl/sweeteners; [or]chem;
sweetening: [a]/'swiːtənɪŋ/; [n]<化工>脱硫;甜味剂;变甜; [v]使.变甜(sweeten的ing形式);加糖于.; [or]chem;
swinestone: [a]/'swain,stəun/; [n]<岩>臭灰岩,臭石灰; [or]chem;
switch: [a]/swɪtʃ/; [n]开关;转变;(铁道的)转辙器,道岔;(树上砍下的)细软枝条;假发; [v]改变(立场,方向等);替换;转换;调换;调(班);(用枝条)击打;摆动; [add]pl/switches,pt/switched,pp/switched,pr/switching,s3/switches; [or]chem;
swordsmith: [a]/'sɔrd'fɪʃ/; [n]打造刀剑的铁匠; [or]chem;
syenite: [a]/'saɪənaɪt/; [n]<岩>正长岩; [or]chem;
syenodiorite: [a]/sainəu'daiərait/; [n]<岩>正长闪长岩; [or]chem;
syenogabbro: [a]/,saiinəu'ɡæbrəu/; [n]<岩>正长辉长岩; [or]chem;
sylvate: [a]/'silveit/; [n]松香酸盐; [or]chem;
sylvinite: [a]/'silvinait/; [n]钾盐;钾石盐岩;杂钠钾盐; [or]chem;
synergist: [a]/'sɪnədʒɪst/; [n]<助剂>增效剂,配合剂;协作剂; [or]chem;
syssiderite: [a]/si'sidərait/; [n]石铁陨石; [or]chem;
tabasheer: [a]/,tæbə'ʃiə/; [n]竹黄(一种取自竹节的含硅凝结物,可用作药物); [or]chem;
tachiol: [a]/'tækol/; [n]<无化>氟化银; [or]chem;
taconite: [a]/'tækənaɪt/; [n]角岩;<岩>铁燧岩; [or]chem;
tactite: [a]/'tæktait/; [n]<岩>接触岩;接触碳酸岩; [or]chem;
taenite: [a]/'tiːnaɪt/; 镍纹石; 天然铁镍合金; [or]chem;
tagger: [a]/ˈtæɡər/; [n]薄铁片;垂下物;尾随者;加标签者; [or]chem;
tangeite: [a]/'tæŋait/; [n]钒钙铜矿; [or]chem;
tannate: [a]/'tæneɪt/; [n]丹宁酸盐; [or]chem;
tantalate: [a]/'tæntəleɪt/; [n]钽酸盐; [or]chem;
taramellite: [a]/tærə'melait/; [n]纤硅钡铁矿; [or]chem;
tartrate: [a]/'tɑːtreɪt/; [n]酒石酸盐,酒石酸酯; [or]chem;
tasmanite: [a]/'tæzmənait/; [n]含硫树脂;沸黄霞辉岩;<岩>塔斯曼油页岩; [or]chem;
taurine: [a]/ˈtɔːriːn/; [n]牛磺酸,氨基乙磺酸; [adj](似)公牛的;(与)斗牛(有关)的; [or]chem;
taurite: [a]/'tɔ,rait/; [n]霓疗岩;霓流纹石; [or]chem;
taurocholate: [a]/,tɔ:rə'kəuleit/; [n]牛磺胆酸盐; [or]chem;
tautomer: [a]/'tɔːtəmə/; [n]<物化>互变异构体; [or]chem;
tautomerization: [a]/tɔ:tɔmərai'zei-ʃən, -ri'z-/; [n]<物化>互变异构化; [or]chem;
taxite: [a]/'tæksait/; [n]斑杂岩; [or]chem;
taxitic: [a]/tæk'sɪtɪk/; 斑杂岩的; [or]chem;
teck: [a]/tek/; abbr. 胸腺表达化学因子;  [or]chem;
tellurate: [a]/'tɛljʊ,ret/; [n]碲酸盐(酯); [or]chem;
telluride: [a]/'teljʊraɪd/; [n]<无化>碲化物; [or]chem;
tengerite: [a]/'tendʒərait/; [n]水菱钇矿; [or]chem;
tenorite: [a]/'tenəraɪt/; [n]黑铜矿; [or]chem;
tephrite: [a]/'tefraɪt/; [n]<岩>碱玄岩; [or]chem;
terebene: [a]/'terəbiːn/; [n]芸香烯,松节油精; [or]chem;
terephthalate: [a]/,teref'θæleɪt/; [n]对苯二酸盐;对苯二酸酯; [or]chem;
terne: [a]/tɚn/; [n]镀铅锡铁板;镀铅锡钢; [vt]镀铅;镀锡; [add]pt/terned,pp/terned,pr/terning; [or]chem;
terneplate: [a]/'tɜːnpleɪt/; [n]镀铅薄铁板;钢铁的薄铅涂层; [or]chem;
terpene: [a]/'tɜːpiːn/; [n]萜(烃);萜烯; [or]chem;
terphenyl: [a]/'tə:fenil/; [n]三联苯; [or]chem;
terpin: [a]/'tə:pin/; [n]水合萜品; [or]chem;
terrane: [a]/te'reɪn/; [n]岩层; [or]chem;
teschenite: [a]/'teʃənait/; [n]沸方绿岩,<岩>沸绿岩;方沸煌绿石; [or]chem;
tetraborate: [a]/tetrə'bɔ:reit/; [n]四硼酸盐; [or]chem;
tetrahedron: [a]/ˌtetrəˈhiːdrən; ˌtetrəˈhedrən/; [n]<晶体>四面体; [add]pl/tetrahedrons或tetrahedra; [or]chem;
tetrahexahedron: [a]/'tetrə,heksə'hi:drɔn/; [n]<晶体>四六面体,二十四面体; [or]chem;
tetrathionates: [a]/,tetrə'θaiə,neit/; [n]连四硫酸盐; [or]chem;
tetratomic: [a]/,tetrə'tɒmɪk/; 四原子的; 四羟基的; [or]chem;
tetrazane: [a]/'tetrəzein/; [n]四氮烷; [or]chem;
tetrazolium: [a]/,tetrə'zəuliəm/; [n]四唑; [or]chem;
tetroxide: [a]/te'trɒksaɪd/; [n]<无化>四氧化物; [or]chem;
tetryl: [a]/'tetrɪl/; [n]特屈儿;三硝基苯甲硝胺(用作炸药或弹药);四硝基炸药(等于tetralite); [or]chem;
tha: [a]/,ti ɛtʃ 'e/; [abbr]总碳氢分析器(Total Hydrocarbon Analyzer);泰国(thailand);  [or]chem;
thaumasite: [a]/'θɔ:məsait/; [n]碳硫硅钙石; [or]chem;
theine: [a]/'θiːiːn; 'θiːɪn/; [n]咖啡碱;茶素; [or]chem;
theralite: [a]/'θiərə,lait/; [n]霞斜岩;<岩>企猎岩; [or]chem;
therblig: [a]/'θə:bliɡ/; [n]动作元素;基本动作; [or]chem;
thermite: [a]/'θɝmɪt/; [n]<化工>铝热剂;灼热剂; [or]chem;
thermochemical: [a]/,θɝmo'kɛmɪkl/; [adj]热化学的; [or]chem;
thermochemistry: [a]/θɜːməʊ'kemɪstrɪ/; [n]<物化>热化学; [or]chem;
thermometamorphism: [a]/'θə:məu,metə'mɔ:fizəm/; [n]热力变质,<岩>热变质作用;热同素异形现象; [or]chem;
thermonatrite: [a]/'θə:məu,neitrait/; [n]水碱;一水碳酸钠; [or]chem;
thermoplastic: [a]/ˌθɜːməʊˈplæstɪk/; [adj]热塑性的; [n]<塑料>热塑性塑料; [add]pl/thermoplastics; [or]chem;
thiamin: [a]/'θaɪəmɪn/; [n]硫胺;维生素B1; [or]chem;
thiazole: [a]/θaɪ'eɪzəʊl/; [n]噻唑; [or]chem;
thickener: [a]/ˈθɪkənə(r)/; [n]<助剂>增稠剂;浓缩机; [add]pl/thickeners; [or]chem;
thio: [a]/ˈθaɪə;ˈθaɪoʊ/; [adj]含硫的;硫代(氧)的; [or]chem;
thioalcohol: [a]/,θaiəu'ælkəhɔl/; [n]硫醇; [or]chem;
thioamide: [a]/θaiəu'æmaid/; [n]硫代酰胺; [or]chem;
thiocarbamide: [a]/,θaɪəʊ'kɑːbəmaɪd/; [n]硫脲; [or]chem;
thiocarbanilide: [a]/'θaɪəʊ,kɑːbə'nɪlaɪd/; 均二苯硫脲; [or]chem;
thiocarbonate: [a]/θaiəu'ka:bəneit/; [n]硫代碳酸盐; [or]chem;
thiochrome: [a]/'θaiəukrəum/; [n]硫色素,硫胺萤;脱氢硫胺素; [or]chem;
thiocresol: [a]/,θaɪəʊ'kriːsɒl/; 甲苯硫酚; [or]chem;
thiocyanate: [a]/,θaɪə(ʊ)'saɪəneɪt/; [n]<无化>硫氰酸盐; [or]chem;
thiocyanogen: [a]/,θaɪəʊsaɪ'ænədʒən/; [n]<无化>硫化氰; [or]chem;
thionate: [a]/'θaɪəneɪt/; 硫代硫酸盐; [or]chem;
thionyl: [a]/'θaɪənaɪl; -nɪl/; [n]亚硫酰; [or]chem;
thiophosphate: [a]/,θaɪəʊ'fɒsfeɪt/; [n]硫代磷酸盐; [or]chem;
thiosulphate: [a]/,θaɪə(ʊ)'sʌlfeɪt/; [n]硫代硫酸盐; [or]chem;
tholeiite: [a]/'θəʊlɪaɪt/; [n]<岩>拉斑玄武岩; [or]chem;
thoria: [a]/'θɔːrɪə/; [n]<无化>氧化钍(钍土);二氧化钍; [or]chem;
thunderstone: [a]/'θʌndəstəʊn/; [n]黄铁矿团块;雷石陨石; [or]chem;
tiemannite: [a]/'tiːmə,naɪt/; [n]灰硒汞矿; [or]chem;
tillite: [a]/'tɪlaɪt/; [n]<岩>冰碛岩; [or]chem;
tin: [a]/tɪn/; [adj]锡制的; [vt]涂锡于;给.包马口铁; [add]pt/tinned,pp/tinned,pr/tinning;  [or]chem;
tincal: [a]/'tɪŋkəl/; [n]粗硼砂;原硼砂; [or]chem;
tinman: [a]/'tɪnmən/; [n]洋铁器商;洋铁匠; [add]pl/tinmen; [or]chem;
tinned: [a]/tɪnd/; [adj]罐头的;镀锡的,包马口铁的;听装的; [v]包以马口铁(tin的过去分词); [or]chem;
tinsmith: [a]/'tɪnsmɪθ/; [n]洋铁匠;锡匠,白铁工; [or]chem;
tinware: [a]/'tɪnweə/; [n]洋铁细工;锡器(马口铁器皿); [or]chem;
tipstaff: [a]/'tɪpstɑːf/; [n]铁头手仗;法警; [add]pl/tipstaves或tipstaffs; [or]chem;
titanate: [a]/'taɪtəneɪt/; [n]<无化>钛酸盐; [or]chem;
titania: [a]/taɪ'tenɪə/; [n]<无化>二氧化钛;人造金红石; [or]chem;
titanomagnetite: [a]/taitənəu'mægnitait/; [n]钛磁铁矿; [or]chem;
titration: [a]/taɪˈtreɪʃn; tɪˈtreɪʃn/; [n]<分化>滴定;滴定法; [or]chem;
titre: [a]/'taɪtə; 'tiːtə/; [n]<分化>滴定度;最小滴定量; [or]chem;
tjosite: [a]/'tʃɔsait/; [n]霞石煌斑岩;斜辉煌岩; [or]chem;
toadstone: [a]/'təʊdstəʊn/; [n]玄武斑岩,蟾蜍石; [or]chem;
toddite: [a]/'tɔdait/; [n]铀铌钽铁矿; [or]chem;
toellite: [a]/'təulait/; [n]英云闪玢岩; [or]chem;
toernebohmite: [a]/'təuənə,bəu,mait/; [n]绿硅矿; [or]chem;
tolan: [a]/'təʊlæn/; [n]二苯乙炔; [or]chem;
tolane: [a]/ˈtəʊleɪn/; 二苯乙炔; [or]chem;
tolualdehyde: [a]/tɔlju'ældihaid/; [n]甲苯甲醛; [or]chem;
toluate: [a]/'tɒljʊeɪt/; [n]甲苯甲酸盐(或酯); [or]chem;
toluidine: [a]/tə'ljuːɪdiːn/; [n]甲苯胺; [or]chem;
toluyl: [a]/'tɒljʊɪl/; [n]甲苯甲酰; [or]chem;
tolyl: [a]/'tɑləl/; [n]甲苯基; [or]chem;
tolylene: [a]/'tɔlili:n/; [n]甲代亚苯基(等于toluylene); [or]chem;
tonalite: [a]/'təunəlait/; [n]<岩>石英闪长岩,<岩>英云闪长岩;英闪岩; [or]chem;
topazolite: [a]/tə(ʊ)'pæzəlaɪt/; [n]<宝>黄榴石; [or]chem;
topman: [a]/'tɑpmən/; [n]地面矿工;桅楼守望员;锯木时在上端的人; [add]pl/topmen; [or]chem;
topsailite: [a]/tɔpsei'lait/; [n]中长辉磷煌斑岩;中辉煌岩; [or]chem;
torbanite: [a]/'tɔ:bənait/; [n]深褐色烛煤;藻烛煤;块煤;苞芽油页岩; [or]chem;
tordrillite: [a]/'tɔ:dri,lait/; [n]淡流纹岩; [or]chem;
torrefy: [a]/'tɒrɪfaɪ/; [v]烘干,烘烤(药品,矿石等); [add]pt/torrefied,pp/torrefied,pr/torrefying,s3/torrefies; [or]chem;
toryhillite: [a]/tɔri'hilait/; [n]多霞钠长岩; [or]chem;
toscanite: [a]/'tɔskənait/; [n]石英粗安岩;紫苏流安岩;斑苏粗安岩(流纹岩); [or]chem;
tourmalite: [a]/'tuəmə,lait/; [n]电英岩; [or]chem;
towerman: [a]/'tauəmən/; [n](美)铁路的信号员;机场塔台指挥人员; [add]pl/towermen; [or]chem;
trachybasalt: [a]/'treɪkɪbə'sɔːlt/; <岩>粗玄岩; 粗面玄武岩; [or]chem;
trachyte: [a]/'treɪkaɪt; 'trækaɪt/; [n]<岩>粗面岩; [or]chem;
trachytic: [a]/trə'kɪtɪk/; [adj]<岩>粗面岩状的; [or]chem;
trackage: [a]/'trækɪdʒ/; [n]轨道;轨长;铁路使用权;拖曳(等于towage); [or]chem;
tramcar: [a]/'træmkɑː/; [n](有轨)电车;矿车; [or]chem;
tramroad: [a]/'træmrəʊd/; [n]矿车轨道,轨道; [or]chem;
transamination: [a]/,trænsæmɪ'neɪʃ(ə)n; ,trɑːns-; -nz-/; [n]转氨作用; [or]chem;
transuranic: [a]/,trænsjʊ'rænɪk; ,trɑːns-; -nz-/; [adj]超铀的; [n]超铀元素(等于transuranium); [or]chem;
transuranium: [a]/,trænsjʊə'reɪnɪəm/; [n]铀后元素; [adj]超铀的;铀后的; [or]chem;
trass: [a]/træs/; [n]火山土,粗面凝灰岩; [or]chem;
traverser: [a]/'trævɝsɚ/; [n]否认者;横越者;(铁路的)转盘; [add]pl/traversers; [or]chem;
treater: [a]/'tri:tə/; [n]<化工>处理器;精制器; [or]chem;
treating: [a]/'triːtɪŋ/; [n]<化工>处理; [v]<化工>处理(treat的ing形式);对待; [or]chem;
trechmannite: [a]/'tretʃmən,nait/; [n]硫砷银矿;轻硫砷铅矿; [or]chem;
triad: [a]/ˈtraɪæd/; [n]三和音;三个一组;三价元素;三合会(华人黑社会);三合会成员;三人组合;三件套;三和弦;三题词; [add]pl/triads; [or]chem;
triamine: [a]/trai'æmin/; [n]三胺; [or]chem;
triatomic: [a]/,traɪə'tɒmɪk/; [adj]由三个原子组成的;一分子中有三个原子的; [or]chem;
triazole: [a]/'traɪəzəʊl; traɪ'æzəʊl/; [n]三唑;苯三唑; [or]chem;
tribasic: [a]/traɪ'beɪsɪk/; [adj]三盐基的;三元的; [or]chem;
tricarboxylic: [a]/traɪ,kɑːbɒk'sɪlɪk/; [adj]三羧基的; [or]chem;
tricyclene: [a]/trai'saikl:n/; [n]三环烯;三环萜; [or]chem;
triethyl: [a]/traɪ'eθɪl/; [adj]三乙基的; [or]chem;
trimer: [a]/'traɪmə/; [n]<高分子>三聚物; [or]chem;
trimethylene: [a]/traɪ'mɛθɪlɪn/; [n]三甲烯;环丙烷(等于cyclopropane); [or]chem;
trinitrotoluene: [a]/'traɪ,naɪtrəʊ'tɒljʊiːn/; [n]三硝基甲苯;烈性炸药; [or]chem;
trioxide: [a]/traɪ'ɒksaɪd/; [n]三氧化物; [or]chem;
trioxymethylene: [a]/traiɔksi'meθəli:n/; [n]三聚甲醛; [or]chem;
triphenyl: [a]/trai,fi:nil, -'fe-/; [adj]三苯基的; [n]三苯基; [or]chem;
triphenylamine: [a]/'traɪ,fɛnɪlə'min/; [n]三苯胺; [or]chem;
triphenylcarbinol: [a]/'traɪ,fiːnɪ'kɑːbɪnɒl/; 三苯基甲醇; [or]chem;
triphenylmethane: [a]/'traɪ,fiːnɪl'meθeɪn/; [n]三苯代甲烷; [or]chem;
triphenylmethyl: [a]/'traɪ,fɛnɪl'miθaɪl/; [n]三苯甲基; [or]chem;
triphylite: [a]/'trifilait/; [n]磷酸锂铁矿; [or]chem;
tripolite: [a]/'trɪpəlaɪt/; [n]硅藻土,板状硅石; [or]chem;
trisilane: [a]/'traisilein/; [n]丙硅烷; [or]chem;
trisilicate: [a]/,trai'siləkeit/; [n]三硅酸盐; [or]chem;
trithionate: [a]/,trai'θaiəuneit/; [n]连三硫酸盐; [or]chem;
tritomite: [a]/'tritə,mait/; [n]锥稀土矿;尖锥稀土壤; [or]chem;
trivalency: [a]/trai'veilənsi/; [n]三价;有三价不同的原子价; [or]chem;
troctolite: [a]/'trɔktəlait/; [n]橄长石;<岩>橄长岩; [or]chem;
trondhjemite: [a]/'trɔnje,mait/; [n]<岩>奥长花岗岩; [or]chem;
troostite: [a]/'truːstaɪt/; [n]屈氏体;锰硅锌矿; [or]chem;
tropine: [a]/'tro,pin; 'tro,pɪn/; [n]托品碱; [or]chem;
trotyl: [a]/'trəʊtɪl/; [n]三硝基甲苯; [or]chem;
trowlesworthite: [a]/,trəulis'wə:θait/; [n]萤电花岗岩; [or]chem;
tsingtauite: [a]/'tsiŋtauait/; [n]青岛岩; [or]chem;
tube: [a]/tjuːb/; [n]管;电子管;隧道;电视机; [vt]使成管状;把.装管;用管输送; [vi]乘地铁;不及格; [add]pt/tubed,pp/tubed,pr/tubing,pl/tubes,s3/tubes; [or]chem;
tubocurarine: [a]/,tju:bəukju'rɑ:rin, -rin/; [n]筒箭毒碱; [or]chem;
tungstate: [a]/'tʌŋsteɪt/; [n]<无化>钨酸盐; [or]chem;
turbidimetry: [a]/,tə:bi'dimitri/; [n]<分化>比浊法;测浊法;<分化>浑浊度测定; [or]chem;
turbidity: [a]/tɜːˈbɪdəti/; [n]<分化>浊度;浑浊;混浊度;混乱; [or]chem;
tutty: [a]/'tʌtɪ/; [n]未加工的氧化锌; [or]chem;
tyrosinase: [a]/'taɪrəsɪneɪz; taɪ'rɒs-/; [n]酪氨酸酶; [or]chem;
tyrosyl: [a]/'tairɔ,sil/; [n]酪氨酰; [or]chem;
ulexite: [a]/jʊ'lɛksaɪt/; [n]硼钠钙石;钠硼解石; [or]chem;
ulrichite: [a]/'ʌlri,tʃait/; [n]方铀矿;碱长霞霓岩; [or]chem;
ultrabasic: [a]/,ʌltrə'besɪk/; [adj]<岩>超基性的;超碱的; [or]chem;
ultrafilter: [a]/,ʌltrə'fɪltɚ/; [vt]以超滤器过滤; [n]<化工>超滤器; [or]chem;
ultramicrochemistry: [a]/'ʌltrə,maikrəu'kemistri/; [n]超微量化学; [or]chem;
unattackable: [a]/'ʌnə'tækəbl/; [adj]不可攻破;<化工>耐侵蚀的; [or]chem;
uncured: [a]/ʌn'kjʊrd/; [adj]未硫化的;未熏制的;未处治的; [or]chem;
underground: [a]/ˌʌndəˈɡraʊnd/; [adv]在地下;秘密地; [adj]位于地下的;地下的;先锋派的,急进探索的; [v]铺(电缆)于地下; [n]地铁;秘密政治组织; [or]chem;
undermining: [a]/,ʌndə'maɪnɪŋ/; [v]侵蚀(岩层)底基;暗中破坏;逐渐削弱;从根基处破坏;动摇(某人地位或权威);在..下挖坑道;逐渐损害(undermin; [prep]的现在分词形式); [or]chem;
ungaite: [a]/'ʌŋgə,ait/; [n]<岩>奥长英安岩; [or]chem;
ungalvanized: [a]/ʌn'gælvənaizd/; [adj]<化工>未镀锌的; [or]chem;
unglazed: [a]/ʌn'gleɪzd/; [adj]<陶瓷>未上釉的;<纸>无光的;没有装玻璃的; [or]chem;
unhydrolyzed: [a]/'ʌn'haidrəulaizd/; [adj]不水解的; [or]chem;
unoxidized: [a]/ʌn'ɒksɪdaɪzd/; [adj]未氧化的; [or]chem;
unreactive: [a]/'ʌnri'æktiv/; [adj]不起化学反应的;化学上惰性的; [or]chem;
unshod: [a]/ʌn'ʃɒd/; [adj]赤脚的;未钉蹄铁的;未穿靴的; [v]使看不见; [or]chem;
upthrow: [a]/'ʌpθrəʊ/; [n]向上的投掷;岩层的隆起,上投地貌; [or]chem;
uranic: [a]/jʊ'rænɪk/; [adj]星学的;天的;铀矿的; [or]chem;
uranine: [a]/'juərənin/; [n]萤光素钠; [or]chem;
uranothorite: [a]/,jurənəu'θɔ:rait/; [n]铀钍矿石;铀钍石;方铀钍矿; [or]chem;
uranyl: [a]/'jʊər(ə)naɪl; 'jʊər(ə)nɪl/; [n]<无化>铀酰; [or]chem;
urethan: [a]/ˈjʊərɪˌθæn/; 氨基甲酸乙酯; 尿烷; [or]chem;
valeraldehyde: [a]/vælə'rældihaid/; [n]戊醛; [or]chem;
vallevarite: [a]/və'levərait/; [n]<岩>反纹二长岩; [or]chem;
vanadate: [a]/'vænədeɪt/; [n]钒酸酯;<无化>钒酸盐(等于vanadiate); [or]chem;
vanillate: [a]/'vænileit/; [n]4-羟基-3-甲氧基苯酸盐(酯);香子兰酸盐(酯); [or]chem;
variolite: [a]/'vɛrɪə'laɪt/; [n]<岩>球颗玄武岩;麻点玄武岩; [or]chem;
variolitic: [a]/,vɛrɪə'lɪtɪk/; [adj]<岩>球颗玄武岩的;有斑点的; [or]chem;
variscite: [a]/'værɪ,saɪt/; [n]磷酸铝石; [or]chem;
varnished: [a]/'vɑrnɪʃ/; [adj]<涂料>涂漆的;浸渍过的; [v]给.上清漆;文饰(varnish的过去分词); [or]chem;
varnsingite: [a]/'va:nsin,gait/; 粗晶辉石钠长岩;钠长榍伟晶岩; [or]chem;
vegasite: [a]/'veigə,sait/; [n]铅铁矾,黄铅铁矾; [or]chem;
veinal: [a]/'veinəl/; [adj]静脉的;矿脉的;翅脉的; [or]chem;
veratraldehyde: [a]/verə'trældihaid/; [n]藜芦醛; [or]chem;
veratrine: [a]/'verətriːn; -ɪn/; [n]藜芦碱;藜芦碱类; [or]chem;
verite: [a]/'verait/; [n]金云橄煌松岩;金橄玻基煌斑岩; [or]chem;
vermilion: [a]/vəˈmɪliən/; [n]<无化>朱砂;朱红色; [adj]朱红色的; [vt]涂以朱红色; [or]chem;
vesuvite: [a]/vi'su:vait/; [n]<岩>白榴碱玄岩;碧玄白榴岩; [or]chem;
vetiver: [a]/'vetɪvə/; [n](东印度)香根草,岩兰草; [or]chem;
viaduct: [a]/ˈvaɪədʌkt/; [n]高架桥;高架铁路; [add]pl/viaducts; [or]chem;
vicine: [a]/'visin/; [n]巢菜核甙;巢菜碱; [or]chem;
villiaumite: [a]/vi'ljɔ:mait/; [n]<无化>氟盐; [or]chem;
vinyl: [a]/ˈvaɪnl/; [n]乙烯基(化学);黑胶唱片; [or]chem;
vinylene: [a]/'vainili:n/; [n]1,2-亚乙烯基;次亚乙烯基;乙烯撑; [or]chem;
vitriol: [a]/ˈvɪtriəl/; [n]硫酸,<无化>硫酸盐;尖刻的话; [vt]用硫酸处理;用尖刻的话伤害; [add]pt/vitrioled或vitriolled,pp/vitrioled或vitriolled,pr/vitrioling或-olling; [or]chem;
vitriolic: [a]/ˌvɪtriˈɒlɪk/; [adj]硫酸的;刻薄的; [or]chem;
vitriolization: [a]/,vɪtrɪəlɪ'zeʃən/; [n]溶于硫酸;硫酸处理; [or]chem;
vitriolize: [a]/'vɪtrɪəlaɪz/; [vt]使..硫酸化;用硫酸处理; [add]pt/vitriolized,pp/vitriolized,pr/vitriolizing; [or]chem;
vitrophyre: [a]/'vɪtrə,faɪɚ/; [n]玻基斑岩; [or]chem;
vogesite: [a]/'vɔdʒesait/; [n]<岩>闪辉正煌岩; [or]chem;
volcanic: [a]/vɒlˈkænɪk/; [adj]火山的;猛烈的;易突然发作的; [n]火山岩; [or]chem;
volcanite: [a]/'vɔlkənait/; [n]火山岩;<岩>歪辉熔岩;含硒硫磺; [or]chem;
volumetry: [a]/vɔ'lju:mitri/; [n]<分化>容量分析;<分化>容量测定; [or]chem;
vomit: [a]/ˈvɒmɪt/; [v]呕吐;喷出;(火山)喷出岩浆;(使)呕吐; [n]呕吐;呕吐物;催吐剂; [add]pl/vomits,pt/vomited,pp/vomited,pr/vomiting,s3/vomits; [or]chem;
vulcanite: [a]/'vʌlkənaɪt/; [n]硬橡皮(经硫化处理的橡皮);硬橡胶; [or]chem;
vulcanization: [a]/,vʌlkənaɪ'zeɪʃən/; [n]橡胶的硫化; [or]chem;
vulcanize: [a]/'vʌlkənaɪz/; [v]硫化;硬化(等于 vulcanise); [add]pt/vulcanized,pp/vulcanized,pr/vulcanizing-,s3/vulcanizes; [or]chem;
waller: [a]/'wɔ:lə/; [n]石垛工;煤矿井下充填工; [or]chem;
wash: [a]/wɒʃ/; [v]洗涤;洗澡;耐洗;洗刷;冲走;拍打;浸湿;(情绪)冲击;洗矿;粉刷;站得住脚;被冲蚀; [prep]Wash) 沃什湾; [add]s3/washes,pt/washed,pp/washed,pr/washing;  [or]chem;
whinstone: [a]/'hwinstəun/; [n]<岩>暗色岩;玄武岩类; [or]chem;
whisker: [a]/ˈwɪskə(r)/; [n]<晶体>晶须;胡须;腮须; [add]pl/whiskers; [or]chem;
whitesmith: [a]/'waɪtsmɪθ/; [n]锡铁匠; [or]chem;
whitneyite: [a]/'(h)witniait/; [n]淡砷铜矿; [or]chem;
wiikite: [a]/'vi:kait/; [n]黑稀金矿;杂铌矿;杂钶矿; [or]chem;
winze: [a]/wɪnz/; [n]矿井;通道; [or]chem;
wiredraw: [a]/'waɪədrɔː/; [vt]拉长;抽成铁丝; [add]pt/wiredrew,pp/wiredrawn,pr/wiredrawing,s3/wiredraws; [or]chem;
wiredrawn: [a]/'waɪədrɔːn/; [adj]太琐碎的;抽成铁丝的; [or]chem;
wirelike: [a]/'waɪr,laɪk/; [adj]线状的,丝状的;细如铁丝的; [or]chem;
wirer: [a]/'waɪərə/; [n]打电报者;用金属线缠结的工人;以铁丝网捕猎鸟兽者; [or]chem;
wireworm: [a]/'waɪəwɜːm/; [n]铁线虫;金针虫; [or]chem;
wolframate: [a]/'wulfrəmeit/; [n]钨酸盐; [or]chem;
wolframite: [a]/'wʊlfrəmaɪt/; [n]黑钨矿,钨锰铁矿; [or]chem;
wollastonite: [a]/'wʊləstənaɪt/; [n]硅灰石,硅酸钙岩矿; [or]chem;
wurtzite: [a]/'wɚrt,saɪt/; [n]纤锌矿; [or]chem;
xanthate: [a]/'zænθeɪt/; [n]黄酸盐; [or]chem;
xanthene: [a]/'zænθiːn/; [n]氧杂蒽(黄色小晶体,供有机合成物用); [or]chem;
xanthone: [a]/'zænθəʊn/; [n]氧杂蒽酮; [or]chem;
xanthydrol: [a]/'zænθidrɔl/; [n]吨氢醇; [or]chem;
xenocryst: [a]/'zenə(ʊ)krɪst/; [n]<晶体>捕获晶; [or]chem;
xenolite: [a]/'zenəlait/; [n]重硅线石;重矽线石; [or]chem;
xenolith: [a]/'zenəlɪθ/; [n]捕虏岩(指火成岩中与其无成因关系的包体);<岩>捕虏体; [or]chem;
xylidine: [a]/'zaɪlɪdiːn/; [n]二甲代苯胺; [or]chem;
xylyl: [a]/'zaɪləl/; [n]甲苄基;二甲苯基; [or]chem;
xylylene: [a]/'zailili:n/; [n]亚二甲苯基;苯二甲基; [or]chem;
yad: [a]/jɑd/; [abbr]酵母乙醇脱氢酶(yeast alcohol dehydrogenase); [or]chem;
yamaskite: [a]/'ja:mə,skait/; [n]角闪钛辉岩;<岩>钙长闪辉岩; [or]chem;
yatalite: [a]/'jætə,lait/; [n]阳起伟晶岩; [or]chem;
yogoite: [a]/'jəugə,ait/; [n]等辉正长岩; [or]chem;
yoking: [a]/jok/; [n]矿区的分界;配轭; [or]chem;
yperite: [a]/'i:pərait/; [n]芥子气;二氧二乙硫醚; [or]chem;
ytterbia: [a]/ɪ'tɝbɪə/; [n]<无化>氧化镱; [or]chem;
yttria: [a]/'ɪtrɪə/; [n]<无化>氧化钇(等于yttrium oxide); [or]chem;
yttrialite: [a]/'itriəlait/; [n]硅钍钇矿; [or]chem;
yttrocolumbite: [a]/,itrəu,kə'lʌmbait/; [n]钇铌铁矿; [or]chem;
yttrogummite: [a]/,itrə'gʌmait/; [n]钇铅铀矿; [or]chem;
zinc: [a]/zɪŋk/; [n]锌;(用于屋顶等的)镀锌铁板; [v]镀锌于,用锌处理; [add]pt/zincked或zinced,pp/zincked或zinced,pr/zincking或zincing,pl/zincs,s3/zincs; [or]chem;
zincate: [a]/'zɪŋkeɪt/; [n]<无化>锌酸盐; [or]chem;
zincing: [a]/zɪŋk/; [v]<化工>镀锌(zince的现在分词); [or]chem;
zirconate: [a]/'zɝkən,et/; [n]<无化>锆酸盐;锆酸根; [or]chem;
zirconia: [a]/zɜː'kəʊnɪə/; [n]氧化锆; [or]chem;
zoochemistry: [a]/,zəʊəʊ'kemɪstrɪ/; [n]动物化学; [or]chem;
