ATP: [a]/ˌeɪ tiː ˈpi/; abbr. 国际男子职业网球协会(Association of Tennis Professionals);三磷酸腺苷(Adenosine Triphosphate);农业贸易政策(Agricultural Trade Policy);阵列变换处理机(Array Transform Processor);宇宙航行测试程序(Astronautics Test Procedure); [gd]family;
Abel: [a]/'eibəl/; [n]亚伯(亚当和夏娃的次子);艾贝尔(男子名); [gd]male;
Abernethy: [a]/,æbə'neθi/; [n]硬饼干; [gd]family;
Abraham: [a]/'eibrə,hæm/; [n]亚伯拉罕(男子名); [gd]male;
Acker: [a]/'eikə/; [n](Acker)人名;(英,法,西,丹,德,荷)阿克; [gd]family;
Acs: [a]/,eɪ si: 'es/; abbr. 美国癌症学会(American Cancer Society);美国陶瓷学会(American Ceramic Society);美国化学学会(American Chemical Society);美国外科医师学会(American College of Surgeons); [n](Acs)人名;(捷)阿奇;(芬,罗)阿克斯; [gd]family;
Acton: [a]/'æktən/; [n](Acton) (美)阿克顿(人名); [gd]family;
Adam: [a]/ˈædəm/; [n]亚当; [gd]male;
Adams: [a]/'ædəmz/; [n]亚当斯(姓氏); [gd]male;
Adler: [a]/'ædlə/; [n]阿德勒(姓氏); [gd]family;
Admin: [a]/ˈædmɪn/; abbr. 管理,行政(administration); [gd]family;
Administration: [a]/ədˌmɪnɪˈstreɪʃn/; [n]管理;行政;实施;行政机构; [gd]family;
Administrator: [a]/ədˈmɪnɪstreɪtə(r)/; [n]管理人;行政官; [gd]family;
Adorno: [a]/ə'dɔ:nəu/; [n]阿多诺(姓氏); [gd]family;
Aery: [a]/'ɛri/; [n]高巢;高处的城堡;高处的房子(等于aerie); [adj]天空中的;飘渺的; [gd]family;
Akita: [a]/ɑ:'ki:tə/; [n]秋田市(日本本州岛西北岸城市);秋田犬(宠物); [gd]family;
Al: [a]/æl/; abbr. 美国联盟(American League);美国军团(American Legion);阿尔巴尼亚(Albania,欧洲一国家名);美国亚拉巴马州(Alabama); [n](Al)人名;(英)阿尔(Albert 在美国的昵称); [gd]male;
Alary: [a]/'eɪlərɪ/; [adj]翼的;翼状的; [gd]family;
Albert: [a]/'ælbət/; [n]艾伯特(男子名); [gd]male;
Alexander: [a]/,ælɪg'zændɚ/; [n]亚历山大(男子名); [gd]male;
Algie: [a]/'ældʒi/; [n]阿尔吉(男子名); [gd]family;
Ali: [a]/,ælɪ/; [n]阿里; [gd]male;
Allen: [a]/'ælən/; [n]艾伦(男子名); [gd]male;
Alms: [a]/ɑːmz/; [n]捐献;救济物,施舍金; [gd]family;
Altay: [a]/'æltai/; [n]阿尔泰(是中国新疆最北的一个地区); [gd]family;
America: [a]/ə'merɪkə/; [n]美洲(包括北美和南美洲);美国; [gd]family;
Amos: [a]/'eimɔs/; [n]阿摩司(前八世纪的希伯来先知);阿摩司书; [gd]male;
Amu: [a]/eɪem'juː/; abbr. 天线匹配器(Antenna Matching Unit);原子质量单位(Atomic Mass Unit); [n](Amu)人名;(罗)阿穆; [gd]family;
Amundsen: [a]/'a:məndsən/; [n]阿蒙森(挪威探险家);阿蒙森海(南极洲的边缘海,在瑟斯顿岛同达尔特角之间,终年结冰); [gd]family;
Andersen: [a]/'ændəsn/; [n]安徒生(丹麦的童话作家); [gd]family;
Anderson: [a]/'ændəsn/; [n]安德森市(美国印第安纳州);安德森(男子名); [gd]family;
Andre: [a]/'ændrei/; [n]安德烈(男子名,等于Andrew); [gd]male;
Andrew: [a]/'ændru:/; [n]安德鲁(男子名); [gd]male;
Andros: [a]/'ændrəs/; [n]安德罗斯岛(巴哈马联邦最大的岛屿和地区); [gd]male;
Angus: [a]/'æŋgəs/; [n]安格斯(男子名); [gd]male;
Applications: [a]/,æplə'keʃən/; [n]应用;应用程序;应用软件(application的复数); [gd]family;
Archer: [a]/ˈɑːtʃə(r)/; [n]射手座;阿彻(姓氏); [gd]family;
Ard: [a]/ɑ:d/; abbr. 远景研究部(Advanced Research Division);近似混响反褶积;德国国营广播电台工作联合会; [n](Ard)人名;(泰)阿;(阿拉伯,法,英)阿尔德; [gd]family;
Ares: [a]/'εəri:z/; [n] [天]阿瑞斯(战神); [gd]family;
Armour: [a]/ˈɑːmə(r)/; [n](Armour)人名;(英,西,葡)阿穆尔; [gd]family;
Arnold: [a]/'ɑ:nəld/; [n]阿诺德(男子名); [gd]male;
Arthur: [a]/ˈɑːθə/; [n]亚瑟(男子名);亚瑟王(传说中六世纪前后英国的国王,圆桌骑士团的首领); [gd]male;
Ashby: [a]/'æʃbi/; [n]阿什贝阶;阿什比(姓氏); [gd]male;
Assistance: [a]/əˈsɪstəns/; [n]援助,帮助;辅助设备; [gd]family;
Associates: [a]/ə'səʊʃɪeɪts/; [n]同伴;合作人;联合公司(associate的复数形式); v. 联合(associate的第三人称单数形式);把.联系起来; [gd]family;
Aston: [a]/'æstən/; [n]阿斯顿(姓氏); [gd]family;
Astor: [a]/'æstə/; [n]阿斯特(男子名); abbr. 反潜鱼雷(antisubmarine torpedo); [gd]family;
Atlantic: [a]/æt'læntɪk/; [n]大西洋; [adj]大西洋的; [gd]family;
Au: [a]/ˌeɪ ˈjuː/; abbr. 任意单位(Arbitrary Unit);运算器(Arithmetical Unit);原子单位(Atom Unit); [n](Au)人名;(日)逢(姓);(柬)欧;(德)奥; [gd]family;
Aula: [a]/'ɔ:lə/; [n](西)教室;大学礼堂; [gd]family;
Auld: [a]/ɔːld; ɑːld/; [adj]旧的,老的(同 old); [n](Auld) (美)奥尔德(人名); [gd]family;
Austin: [a]/ˈɔːstən/; [n]奥斯丁(人名); 奥斯汀(美国得克萨斯州首府); 英国制汽车牌名; [gd]male;
Australia: [a]/ɒ'streɪlɪə/; [n]澳大利亚,澳洲; [gd]family;
Bach: [a]/bætʃ/; [n]巴赫(德国作曲家); [gd]family;
Badger: [a]/ˈbædʒə(r)/; [n](Badger)人名;(英)巴杰; [vt]纠缠不休;吵着要;烦扰; [gd]family;
Bahia: [a]/bɑ:'hi:ə/; [n]巴伊亚(巴西北部的一个省份); [gd]family;
Bailey: [a]/ˈbeɪli/; [n](Bailey)人名;(英)贝利,贝莉 (女名);(葡)拜莱;(西)贝利; [gd]male;
Bailie: [a]/'beɪlɪ/; [n](苏格兰的)市政官; [gd]male;
Bajada: [a]/bə'hɑ:də/; [n](Bajada)人名;(法)巴雅达; [地理]山麓冲积平原; [gd]family;
Baker: [a]/ˈbeɪkə(r)/; [n]贝克(姓氏); [gd]family;
Banks: [a]/bæŋks/; [n]班克斯(姓氏); [gd]family;
Bannister: [a]/ˈbænɪstə(r)/; [n](Bannister)人名;(英)班尼斯特; [gd]family;
Barbour: [a]/'bɑ:bə/; [n]巴伯衫(商标名称); [gd]family;
Barker: [a]/ˈbɑːkə(r)/; [n](Barker)人名;(英,西)巴克;(阿拉伯,土,法,德)巴克尔; [木]剥皮机;剥树皮工;杂耍,戏院前叫喊招揽观众的人; [gd]family;
Barnaby: [a]/'bɑ:nəbi/; [n]巴纳比(男子名); [gd]male;
Barry: [a]/'bɑːrɪ/; [n]巴里(男子名); [gd]male;
Bartholomew: [a]/bɑ:'θɔləmju:/; [n]巴塞洛缪(男子名); [gd]male;
Bartlett: [a]/'bɑrtlɪt/; [n]巴特利特梨(西洋梨的一种);巴特利特(男子名); [gd]male;
Barton: [a]/'bɑːt(ə)n/; [n]巴顿(男子名); [gd]male;
Baskerville: [a]/'bæskəvil/; [n]巴斯克维尔体(活字书体之一种); [gd]family;
Bason: [a]/'beɪsən/; [n](Bason)人名;(法,意)巴松;(英)巴森; [gd]family;
Bauer: [a]/'bauə/; [n]鲍尔(德语姓氏); [gd]family;
Bays: [a]/beiz/; [n](Bays)人名;(英)贝斯; [地理]港湾(bay的复数);凹进处;吠声;桂冠;堤; v. 嚎叫;用堤坝拦;围困住(bay的三单形式); [gd]family;
Bears: [a]/bɛr/; [n]熊(bear的复数);空头(卖空的证券交易投机); [gd]family;
Beaty: [a]/'bi:ti/; [adj](音乐)有很强节奏感的; [n](Beaty) (美)贝蒂(人名); [gd]family;
Beckett: [a]/ˈbekɪt/; 贝克特(人名); [gd]family;
Beckham: [a]/'bekhæm/; [n]贝克汉姆(男子名); [gd]family;
Bedford: [a]/'bedfəd/; [n]贝德福德(英格兰一郡及该郡之首府);贝德福德(美国俄亥俄州城市);贝德福德(男子名); [gd]family;
Bees: [a]/'biːz/; [n] [蜂]蜜蜂(bee的复数); [gd]family;
Belcher: [a]/'bɛltʃɚ/; [n](Belcher)人名;(英)贝尔彻; [gd]family;
Bender: [a]/ˈbendə(r)/; [n](Bender)人名;(英)本德;(西,罗,土,德,塞,波,荷,芬,瑞典,匈)本德尔; [gd]family;
Benefits: [a]/'bɛnəfɪt/; [n]福利,效益(benefit的复数形式);利益,收益; [gd]family;
Benjamin: [a]/'bɛndʒəmən/; [n]本杰明(男子名);受宠爱的幼子; [gd]male;
Benne: [a]/'benɪ/; [n]胡麻(等于sesame); [gd]family;
Bento: [a]/'bentəʊ/; [n](Bento)人名;(西,葡)本托; [gd]family;
Benton: [a]/ben'tən/; [n]本顿(姓氏); [gd]male;
Bernstein: [a]/'bə:nstein/; [n]伯恩斯坦(姓氏); [gd]family;
Bertrand: [a]/'bə:trənd/; [n]伯特兰(男子名); [gd]male;
Beton: [a]/'betən/; [n](Beton)人名;(西,德)贝通;(英)贝顿; [gd]family;
Bible: [a]/ˈbaɪbl/; [n]圣经; [gd]family;
Bice: [a]/baɪs/; [n](Bice)人名;(意)比切(女子教名 Beatrice 的意大利语昵称);(英)比奇; [gd]family;
Billing: [a]/ˈbɪlɪŋ/; [n](Billing)人名;(英,德,芬,瑞典,匈)比林; [gd]family;
Binder: [a]/ˈbaɪndə(r)/; [n](Binder)人名;(英,西)宾德;(德,俄,罗,捷,瑞典,匈)宾德尔; [胶粘]粘合剂;活页夹;装订工;捆缚者;用以绑缚之物; [gd]family;
Bins: [a]/bɪnz/; [n](Bins)人名;(德,葡)宾斯; [gd]family;
Birk: [a]/bə:k/; [n]比尔克(姓氏); [gd]family;
Blackwood: [a]/'blækwud/; [n]布莱克伍德(姓氏); [gd]family;
Blair: [a]/blεə/; [n]布莱尔(男子名); [gd]male;
Blake: [a]/bleɪk/; [n]布莱克(英国作家); [gd]male;
Blanche: [a]/'bla:ntʃ/; [n]布兰奇(女子名); [gd]female;
Blazer: [a]/ˈbleɪzə(r)/; [n](Blazer) (美)布莱泽(人名); [gd]family;
Boarder: [a]/ˈbɔːdə(r)/; [n]寄膳者;寄膳宿者;寄宿生; [gd]family;
Bodkin: [a]/ˈbɒdkɪn/; [n](Bodkin)人名;(英,意)博德金; [gd]family;
Bogart: [a]/'bəuɡɑ:t/; [n]博加特(姓氏);弓的力量(星座名的含义); [gd]male;
Bois: [a]/bwɑ:/; [n]博伊斯(男子名); [gd]family;
Bolton: [a]/ˈbəʊltən/; [n](Bolton) (美)博尔顿(人名); [gd]family;
Bombardier: [a]/ˌbɑːmbərˈdɪr/; [n]庞巴迪公司(加拿大一家飞机生产商); [gd]family;
Booking: [a]/ˈbʊkɪŋ/; [n]预订;预约;演出契约; [gd]family;
Boose: [a]/bu:z/; [n](Boose)人名;(德)博泽; [gd]family;
Bopp: [a]/bɔp/; [n]博普(姓氏); [gd]family;
Borel: [a]/'bɔrəl/; [n]波莱尔(手表品牌);波雷尔(瑞士国际法学家); [gd]family;
Borgia: [a]/'bɔ:dʒiə/; [n]博尔吉亚(意大利15,16世纪权门家族); [gd]family;
Boroughs: [a]/ˈbʌrə/; [n](Borough)人名;(英)伯勒; [gd]family;
Bosch: [a]/bɒʃ/; [n]博世(德国公司名); [gd]family;
Bot: [a]/bɒt/; [n](Bot) (罗,法,俄,荷)博(人名); [gd]family;
Bott: [a]/bɒt/; [n](Bott)人名;(英,法,德,意,罗,匈)博特; [gd]family;
Bottoms: [a]/'bɒtəms/; [n](Bottoms)人名;(英)博顿斯; [gd]family;
Boudin: [a]/bʊ'dæn; bʊ'dæŋ/; [n](Boudin)人名;(法)布丹;(意,英)布丁; [地质]石香肠;猪血香肠;串肠构造体; [gd]family;
Bounds: [a]/baʊndz/; [n](Bounds)人名;(英)邦兹; [gd]family;
Bourne: [a]/buən/; [n](Bourne)人名;(英)伯恩;(西)博尔内; [gd]family;
Bower: [a]/ˈbaʊə(r)/; [n](Bower)人名;(英,西)鲍尔; [gd]family;
Bowler: [a]/ˈbəʊlə(r)/; [n](Bowler)人名;(英)鲍勒; [gd]family;
Bowling: [a]/ˈbəʊlɪŋ/; [n](Bowling)人名;(英)鲍林; [gd]family;
Bowser: [a]/ˈbaʊzə(r)/; [n](Bowser)人名;(英)鲍泽; [gd]family;
Bowyer: [a]/'bəʊjə/; [n](Bowyer)人名;(英)鲍耶; [gd]family;
Boyle: [a]/bɔil/; [n]波义耳(17世纪英国物理学家,化学家); [gd]family;
Brabant: [a]/brə'bænt/; [n]布拉班特省(比利时中部省份); [gd]family;
Bradford: [a]/'brædfəd/; [n]布拉德福德(英格兰北部城市); [gd]male;
Bradshaw: [a]/'brædʃɔ:/; [n](Bradshaw)人名;(英)布拉德肖; [gd]family;
Bragg: [a]/bræg/; [n]布拉格(姓氏); [gd]family;
Brander: [a]/'brændɚ/; [n](Brander)人名;(英,丹,芬,瑞典)布兰德; [gd]family;
Brandon: [a]/'brændən/; [n]布兰登(男子名); [gd]male;
Brassard: [a]/'bræsɑːd/; [n](Brassard)人名;(法)布拉萨尔;(英,德,葡)布拉萨德; [gd]family;
Brent: [a]/brent/; [n]布伦特(男子名); [gd]male;
Breton: [a]/ˈbretən/; [n]布列塔尼人; [adj]布列塔尼的; [gd]family;
Brewer: [a]/ˈbruːə(r)/; [n](Brewer)人名;(英)布鲁尔; [gd]male;
Brewster: [a]/'brʊstɚ/; [n](Brewster)人名;(英,西)布鲁斯特; [gd]male;
Briard: [a]/bri'ɑnd; bri'ɑŋ/; [n](Briard)人名;(法)布里亚尔; [gd]family;
Bridges: [a]/brɪdʒ/; [n]布里奇斯(姓氏); [gd]family;
Britt: [a]/brɪt/; [n](Britt)人名;(英,德,瑞典)布里特; [gd]male;
Brock: [a]/brɒk/; [n](Brock)人名;(英,德,西,捷)布罗克; [gd]male;
Brooks: [a]/bruks/; [n]布鲁克斯(姓氏); [gd]male;
Brownfield: [a]/ˈbraʊnfiːld/; [n]布朗菲尔德(美国得克萨斯州西北部城市); [gd]family;
Browning: [a]/'braʊnɪŋ/; [n](美,爱,英)勃朗宁(人名); [gd]family;
Bruce: [a]/bru:s/; [n]布鲁斯(男名); [gd]male;
Bruin: [a]/'bruːɪn/; [n]熊,熊先生; [gd]family;
Brule: [a]/bru'lei/; [n](Brule)人名;(英)布鲁尔; [gd]family;
Brunet: [a]/bruː'net/; [n](Brunet) (美,加,法)布吕内(人名); [adj]深色的;深褐色的; [gd]family;
Bryant: [a]/'braɪənt/; [n]布赖恩特(男子名,等于Brian); [gd]male;
Buchanan: [a]/bju:ˈkænən/; 布坎南; [gd]family;
Buckingham: [a]/'bʌkɪŋəm/; [n]白金汉宫(英国皇室); [gd]family;
Buffett: [a]/'bʌfit/; [n]巴菲特(男子名); [gd]family;
Buhr: [a]/bɜː/; [机]硅质磨石; [n](Buhr)人名;(捷)布赫尔;(德)布尔; [gd]family;
Bulger: [a]/'bʌldʒə/; [n](Bulger)人名;(英)巴尔杰; [gd]family;
Bullas: [a]/'bʊlə/; [n](Bulla)人名;(西)布利亚;(意,德,匈,加纳)布拉; [gd]family;
Bullion: [a]/ˈbʊliən/; [n](Bullion)人名;(法)比利翁; [gd]family;
Bunker: [a]/ˈbʌŋkə(r)/; [n](Bunker)人名;(英,西)邦克; [vt]使陷入困境;把球击入沙坑; [gd]family;
Bunting: [a]/ˈbʌntɪŋ/; v. 顶撞(bunt 的现在分词); [n](Bunting) (美,英,加,澳,法)邦廷(人名); [gd]family;
Burger: [a]/ˈbɜːɡə(r)/; [n](Burger)人名;(西)布尔赫尔;(法)比尔热;(英)伯格;(德,罗,捷,塞,匈)布格尔; [gd]family;
Burke: [a]/bə:k/; v. (通常用窒息方式)秘密谋杀; [n](Burke) (美,加,英,澳)伯克(人名); [gd]male;
Burnet: [a]/'bɜːnɪt/; [n](Burnet)人名;(法)比尔内;(英)伯内特; [gd]family;
Burns: [a]/bɜːnz/; [n]伯恩斯(姓氏); [gd]family;
Burr: [a]/bɜː(r)/; [n](Burr)人名;(德,西)布尔;(英)伯尔; [vt]以粗喉音发出; [gd]family;
Burton: [a]/ˈbɜːtn/; [n](Burton)人名;(法)比尔东;(英,西,葡)伯顿; [gd]male;
Busby: [a]/ˈbʌzbi/; [n](Busby) (美,英,加,澳)巴斯比(人名); [gd]family;
Butcher: [a]/ˈbʊtʃə(r)/; [n](Butcher) (美,爱,英)布彻(人名); [gd]family;
Butts: [a]/bʌts/; [n](Butts)人名;(英)巴茨; [gd]family;
Byrd: [a]/bə:d/; [n]伯德(姓氏); [gd]family;
Cae: [a]/ˌsiː eɪ ˈiː/; abbr. 计算机辅助工程(Computer Aided Engineering);计算机辅助教育(Computer Aided Education); [n](Cae)人名;(罗)卡埃; [gd]family;
Cai: [a]/,si: eɪ'aɪ/; abbr. 计算机辅助教学 (computer-aided instruction); [n](Cai) (美)卡伊(人名); [gd]family;
Cain: [a]/kein/; [n]凶手;杀兄弟者;该隐(亚当之子); [gd]male;
Cairns: [a]/kernz/; [n]凯恩斯(澳大利亚港口); [gd]family;
Calvin: [a]/'kælvɪn/; [n]卡尔文(男子名);加尔文(法国神学家); [gd]male;
Campagna: [a]/kæm'pɑːnjə/; [n]坎帕尼亚大区(位于意大利半岛南部,亚平宁山脉南麓,濒临蒂勒尼安海); [gd]family;
Campbell: [a]/'kæmbel/; [n]坎贝尔(姓氏); [gd]family;
Canada: [a]/'kænədə/; [n]加拿大(北美洲国家); [gd]female;
Canfield: [a]/'kænfiːld/; [n](Canfield)人名;(英,西)坎菲尔德; [gd]family;
Captives: [a]/'kæptɪv/; [n]真情俘虏(电影名); [gd]family;
Carlin: [a]/'ka:lin/; [n](Carlin)人名;(英,西,意,瑞典)卡林;(法)卡兰; [gd]male;
Carling: [a]/'kɑːlɪŋ/; [n](Carling)人名;(瑞典)卡林;(英,挪)卡林; [gd]family;
Carlton: [a]/'ka:ltən/; [n]卡尔顿(男子名,姓氏); [gd]male;
Carnegie: [a]/'kɑ:nəɡɪ/; [n]卡内基(姓氏); [gd]family;
Carpool: [a]/ˈkɑːpuːl/; v. 合伙用车,拼车; [n]合伙用车者;(公司或机构供员工使用的))车队; [gd]family;
Carr: [a]/kɑː/; [n]凯尔(挪威,住在沼泽的人); [gd]family;
Carroll: [a]/'kærəl/; [n]卡罗尔(罗马人的姓); [gd]male;
Carson: [a]/'kɑ:sən/; [n]卡尔森(姓氏,男子名); [gd]male;
Carter: [a]/'kɑːtə/; [n]卡特(男子名); [gd]male;
Carver: [a]/'kɑːvə/; [n](Carver)人名;(英)卡弗; [gd]family;
Casanova: [a]/ˌkæsəˈnəʊvə; ˌkæzəˈnəʊvə/; [n]卡萨诺瓦式人物(意大利浪荡公子); [gd]family;
Casey: [a]/'keisi:/; [n]凯西(男子名); [gd]male;
Castro: [a]/'kæstrəu/; [n]卡斯特罗(古巴领导人,1976-2006年在任); [gd]family;
Catering: [a]/ˈkeɪtərɪŋ/; v. 提供饮食,承办酒席(cater 的现在分词); [n](会议或社交活动的)饮食服务,酒席承办; [gd]family;
Caton: [a]/'kɛtən/; [n]卡顿(男子名);金榜(德国品牌名); [gd]family;
Caudle: [a]/'kɔːdl/; [n]粥汤;酒汤; [gd]family;
Cavan: [a]/'kævən/; [n]卡文(爱尔兰地名); [gd]family;
Caves: [a]/kev/; [n](Caves) (美,英,加)卡夫(人名); [gd]family;
Cecil: [a]/'sesəl; 'sisəl/; [n]塞西尔(男子名); [gd]male;
Center: [a]/ˈsentə(r)/; [n](Center)人名;(英)森特; [vt]集中,使聚集在一点;定中心; [adj]中央的,位在正中的; [gd]family;
Centre: [a]/ˈsentə(r)/; [n]中心;(市镇的)中心区,人口集中的地区;活动中心;居领先地位的中心;聚集点;有..中心的;中间党派;(球赛的)中锋;传中(球赛中将球从场边扔向场中);巧克力夹心;转轴;(车床等用于支撑的)顶针;源头;最重要的地方; v. 将..放在中央;以..为中心;使(争论)集中于;(活动)集中于;传中;打中锋; v. (Centre) (印,澳,肯尼亚)森特尔(人名); [gd]family;
Cervantes: [a]/sə:'væntiz/; [n]塞万提斯(西班牙作家); [gd]family;
Chadwick: [a]/'tʃædwik/; [n]查德威克(姓氏); [gd]male;
Chai: [a]/tʃaɪ/; [n](Chai) (美,印尼,新)斋(人名); [gd]family;
Chambers: [a]/'tʃembɚ/; [n]钱伯斯(姓氏); [gd]family;
Chang: [a]/tʃɑːŋ/; [n](Chang)人名;(柬)章;(泰)昌; [gd]family;
Changes: [a]/tʃendʒz/; [n]变化,改变(change的复数); v. 改变;交换(change的第三人称单数形式); [gd]family;
Chapman: [a]/'tʃæpmən/; [n](Chapman)人名;(英,西,葡)查普曼; [gd]family;
Charter: [a]/ˈtʃɑːtə(r)/; [n](Charter) (美,英)查特(人名); [adj]包租的; [gd]family;
Chasse: [a]/ˈʃæseɪ/; [n](Chasse) (美,加,法)沙塞(人名); [gd]family;
Chenier: [a]/'ʃiniə/; [n] [地理]沼泽沙丘,海岸沙脊; [gd]family;
Chester: [a]/'tʃestə/; [n]切斯特(美国港口城市);切斯特(英国一城市); [gd]male;
Chesterfield: [a]/ˈtʃestəfiːld/; [n]切斯特菲尔德(姓氏); [gd]family;
Cheval: [a]/ʃə'væl/; [n](Cheval) (法,美)舍瓦尔(人名); [gd]family;
Chia: [a]/'tʃi:ə/; [n](Chia)人名;(中)贾(普通话-威妥玛);(柬)介; [gd]family;
Ching: [a]/tʃɪŋ/; [n](Ching)人名;(泰,缅)清;(朝)称;(英)钦;(柬)京; [gd]family;
Cho: [a]/,si etʃ 'o/; abbr. 首席人事官(Chief Human resources Officer); [n](Cho)人名;(中)卓(普通话-威妥玛);(越)给;(日)猪(姓);(缅)丘; [gd]family;
Chong: [a]/'tʃʊŋ/; [n](Chong)人名;(泰,缅,柬)宗;(东南亚国家华语)庄; [gd]family;
Chou: [a]/ʃu:/; [n]周;甘蓝;心爱的人; [gd]family;
Christian: [a]/ˈkrɪstʃən/; [n]基督徒,信徒; [adj]基督教的;信基督教的; [gd]male;
Christie: [a]/'kristi/; [n]克里斯蒂(姓氏);挪威首都奥斯陆的旧称; [gd]male;
Chubb: [a]/tʃʌb/; [n]丘伯保险锁(商标名称); [gd]family;
Chung: [a]/tʃʊŋ/; [n]钟,宗,忠,聪; [gd]family;
Churchill: [a]/'tʃə:tʃil/; [n]邱吉尔(英国政治家及作家); [gd]male;
Cicero: [a]/'sisərəu/; [n]西塞罗(古罗马政治家,雄辩家,著作家);西塞罗(美国伊利诺伊州东北部城市,在芝加哥附近); [gd]family;
Circe: [a]/'sə:si/; [n](希神)赛丝; [gd]family;
Cisco: [a]/'sɪskəʊ/; [n](Cisco)人名;(英)西斯科;(意)奇斯科; [gd]family;
Clark: [a]/kla:k/; [n](Clark)人名;(瑞典,葡,西,芬,斐,意,德,匈,英,土)克拉克; [gd]male;
Clarke: [a]/klɑ:k/; [n] [地化]克拉克(姓氏); [gd]male;
Clary: [a]/'kleərɪ/; [n](Clary) (美,英)克莱莉(人名); [gd]female;
Clayton: [a]/'kleitn/; [n]克莱顿(姓氏,男子名); [gd]male;
Clifton: [a]/'kliftən/; [n]克利夫顿(男子名); [gd]male;
Cline: [a]/klaɪn/; [n](Cline)人名;(英)克莱因;(法)克利纳; [生物]渐变群,生态群; [gd]family;
Clinton: [a]/ˈklintən/; [n]克林顿; [gd]male;
Clough: [a]/klʌf/; [n](Clough)人名;(法)克卢;(英,西)克拉夫; [gd]family;
Co: [a]/ˌsiː ˈəʊ/; abbr. 一氧化碳(carbon monoxide);哥伦比亚(Colombia);现付票(Cash Order);货源证书(Certificate of Origin); [n](Co)人名;(中)措(藏语-汉语拼音); [gd]family;
Co-op: [a]/ˈkəʊ ɒp/; [n]合作社(cooperative society);消费合作社; [gd]family;
Coats: [a]/kəuts/; [n](英国)高士集团(公司名,全球最大的制线企业之一和第二大拉链生产企业); [gd]family;
Coble: [a]/'kəʊb(ə)l/; [n]平底渔船; [gd]family;
Cody: [a]/'kəudi/; [n]科迪(姓氏); [gd]male;
Coffey: [a]/'kɔfi/; [n]科菲(姓氏); [gd]family;
Cohen: [a]/'kəuən/; 科恩(姓氏); [gd]family;
Colby: [a]/'kəulbi/; [n](Colby)人名;(英)科尔比; [gd]family;
Cole: [a]/kol/; [n]科尔(男子名); [gd]male;
Coleman: [a]/'kəulmən/; [n]科尔曼(姓氏); [gd]male;
Coles: [a]/kəuls/; [n](Coles)人名;(英)科尔斯;(法)科勒;(西)科莱斯; [gd]family;
Coley: [a]/ˈkoʊli/; [n](Coley)人名;(英)科利;(法)科莱; [gd]family;
Collette: [a]/'kɔlit/; [n](Collette)人名;(法)科莱特; [gd]female;
Collier: [a]/ˈkɒliə(r)/; [n](Collier)人名;(西,葡)科列尔;(英,德)科利尔;(法)科利耶; [gd]family;
Collins: [a]/'kɔlinz/; [n]柯林斯(姓氏名);柯林斯酒; [gd]male;
Colter: [a]/'kəʊltə/; [n](Colter)人名;(英)科尔特; [gd]family;
Combs: [a]/kɒmz/; [n](Combs)人名;(英)库姆斯; [gd]family;
Comm: [a]/kɒm/; abbr. 通信 (communication);商业,贸易 (commerce);委员会 (committee); [n](Comm) (美,印,加)科姆(人名); [gd]family;
Commons: [a]/'kɒmənz/; [n](Commons)人名;(英)康芒斯; [gd]family;
Communication: [a]/kəˌmjuːnɪˈkeɪʃn/; [n]通讯,; [通信]通信;交流; [gd]family;
Communications: [a]/kəmju:ni'keiʃ(ə)nz/; [n] [通信]通信;沟通;通讯系统;交通设施(communication的复数形式); [gd]family;
Comp: [a]/kɒmp/; [n](Comp)人名;(英,德)康普; [vt]给.排字;作为赠券或赠书送给;为.伴奏; vi. 排版;做伴奏; [gd]family;
Compton: [a]/'kɔmptən/; [n]康普顿(姓氏,美国城市); [gd]family;
Conrad: [a]/'kɔnræd/; [n]康拉德(男子名,等于Konrad); [gd]male;
Constable: [a]/ˈkʌnstəbl/; [n](Constable)人名;(英)康斯特布尔; [gd]family;
Constantine: [a]/'kɔnstəntain/; [n]康斯坦丁(男子名);君士坦丁(阿尔及利亚地名); [gd]male;
Consultancy: [a]/kənˈsʌltənsi/; [n]咨询公司;顾问工作; [gd]family;
Conte: [a]/'kənte/; [n](Conte)人名;(英)康特;(意)孔特,贵族头衔"伯爵";(法,葡,西)孔特;(几)孔戴; [gd]family;
Coogan: [a]/'ku:gən/; [n](Coogan)人名;(英)库根; [gd]family;
Cooper: [a]/ˈkuːpə(r)/; [n](cooper) 制桶工人,修桶匠; v. (cooper) 箍桶,修桶,制桶; [gd]male;
Coordinator: [a]/kəʊˈɔːdɪneɪtə(r)/; [n]协调者; [自]协调器;同等的人或物; [gd]family;
Corbeil: [a]/'kɔːbeɪl/; [n](Corbeil)人名;(法,英)科贝伊; [gd]family;
Corbett: [a]/ˈkɔːbət/; 科比特(人名); 科比特(地名); [gd]family;
Corbin: [a]/'kɔ:bin/; [n](Corbin)人名;(英,意)科尔宾;(法)科尔班;(西)科尔温; [gd]male;
Corker: [a]/ˈkɔːkə(r)/; [n](Corker)人名;(英)科克; [gd]family;
Cornell: [a]/kɔ:'nel/; [n]康奈尔(姓氏); [gd]family;
Corner: [a]/ˈkɔːnə(r)/; [n](Corner)人名;(法)科尔内;(英)科纳; [vt]垄断;迫至一隅;使陷入绝境;把.难住; [gd]family;
Correa: [a]/ˈkɒrɪə, kəˈriːə/; [n](Correa)人名;(英,意)科雷亚; [gd]family;
Corse: [a]/kɔ:s/; [n]尸体(等于Corsia); [gd]family;
Costa: [a]/'kɒstə/; [n](Costa)人名;(希,印尼,西,芬,罗,葡,加纳,德,意,英,法)科斯塔; [解剖]肋骨;叶脉; [昆]前缘脉; [gd]male;
Cote: [a]/kəʊt/; [n](Cote)人名;(英,西)科特; [gd]family;
Cotter: [a]/'kɒtə/; [n](Cotter)人名;(西,罗,葡)科特尔;(英)科特; [vt]用销固定; [gd]family;
Coulter: [a]/'kəʊltə/; [n](Coulter)人名;(英,法)库尔特; [gd]family;
Couture: [a]/kuˈtjʊə(r)/; [n](Couture) (加,美,法)科图雷(人名); [gd]family;
Covey: [a]/ˈkʌvi/; [n](Covey)人名;(英)科维; [gd]family;
Cowling: [a]/ˈkaʊlɪŋ/; [n](Cowling)人名;(英)考林; [航]整流罩;飞机引擎罩; [gd]family;
Craig: [a]/kreɪɡ/; [n]克雷格(男子名); [gd]male;
Cranston: [a]/'krænstən/; [n]克兰斯顿(美国城市名); [gd]family;
Crawford: [a]/'krɔfəd/; [n]克劳福德(美国西部小镇); [gd]male;
Creamer: [a]/ˈkriːmə(r)/; [n](Creamer)人名;(英)克里默; [gd]family;
Cremer: [a]/'kri:mə/; [n]克莱莫(姓氏); [gd]family;
Crick: [a]/krɪk/; [n](Crick) (美,英,加,澳,法)克里克(人名); [gd]family;
Crockett: [a]/'krɔkit/; [n]克罗克特(姓氏);克罗克特市(位于美国加利福尼亚州); [gd]family;
Crompton: [a]/'krʌmptən/; 康普顿公司(专注于精细化工产品的跨国企业);克朗普顿(姓氏); [gd]family;
Cromwell: [a]/'krɔmwel/; [n]克伦威尔(姓氏); [gd]family;
Cronk: [a]/krɔŋk/; [n]克朗克(人名); [gd]family;
Cropper: [a]/ˈkrɒpə(r)/; [n](Cropper)人名;(意)克罗珀尔;(英)克罗珀; [gd]family;
Crozier: [a]/ˈkrəʊziə(r)/; [n](Crozier)人名;(英)克罗泽;(法)克罗齐耶; [gd]family;
Cruzado: [a]/kruː'zeɪdəʊ/; [n](Cruzado)人名;(西)克鲁萨多; [gd]family;
Cuddy: [a]/'kʌdi/; [n](Cuddy) (美,爱)卡迪(人名); [gd]family;
Culver: [a]/'kʌlvə/; [n](Culver)人名;(英)卡尔弗; [gd]family;
Currier: [a]/'kʌrɪə/; [n](Currier)人名;(英)柯里尔; [gd]family;
Curtis: [a]/'kə:tis/; [n]柯蒂斯(男子名); [gd]male;
Cushing: [a]/'kuʃiŋ/; [n]库欣(姓氏); [gd]family;
DALE: [a]/deɪl/; [n]山谷;排水孔; [gd]family;
DMS: [a]/ˌdiː ˈemz/; abbr. 数据库管理系统(Database Management System); [gd]family;
DPP: [a]/ˌdiː piː ˈpiː/; abbr. 延付贷款计划(deferred payment plan);民进党(Democratic Progressive Party); [gd]family;
Da: [a]/ˌdiː ˈeɪ/; [n](Da)人名;(柬)达; [gd]family;
Dace: [a]/deɪs/; [n](Dace)人名;(英)戴斯;(西)达塞; [gd]family;
Dack: [a]/dæk/; [n]达克(男子名); [gd]family;
Dada: [a]/ˈdɑːdɑː/; [n]达达主义(等于Dadaism); [gd]family;
Dal: [a]/dɑːl/; [n](Dal)人名;(瑞典)达尔;(英,挪,法,土,西)达尔; [gd]family;
Dallas: [a]/ˈdæləs/; [n]达拉斯(美国城市); [gd]male;
Dalton: [a]/'dɔːlt(ə)n/; [n]道尔顿(英国化学家,物理学家); [gd]male;
Dane: [a]/deɪn/; [n]丹麦人;戴恩(男子名); [gd]male;
Daniel: [a]/'dænjəl/; [n]丹尼尔(男子名); [gd]male;
Dao: [a]/'dɑːəʊ/; [n](Dao)人名;(布基,马里)达奥;(老,柬)道; [gd]family;
Darby: [a]/'dɑ:bi/; [n](Darby) (美)达尔比(人名); [gd]male;
Darcy: [a]/'dɑːsɪ/; [n]达西(人名); [gd]male;
Darlington: [a]/'dɑ:liŋtən/; [n]达灵顿(英国英格兰东北部城市); [gd]family;
Darnel: [a]/'dɑːn(ə)l/; [n]毒麦; [gd]family;
Das: [a]/dæs; dɑ:s/; abbr. 数据收集台(Data Acquisition Station); [n](Das)人名;(土)达什;(法,德,印,尼,巴基)达斯; [gd]family;
Dassie: [a]/'dæsɪ/; [n](Dassie)人名;(意)达谢; [gd]family;
David: [a]/'deɪvɪd/; [n]大卫;戴维(男子名); [gd]male;
Davidson: [a]/'deividsn/; [n]戴维森(姓氏); [gd]male;
Davis: [a]/'devɪs/; [n]戴维斯(男子名); [gd]male;
Dawson: [a]/'dɔ:sən/; [n]道森(加拿大西北部城市); [gd]male;
Dbs: [a]/ˌdiː biː ˈes/; abbr. 直播卫星(direct broadcasting by satellite); [gd]family;
De: [a]/diː/; [n](De) (丹,越)大(人名); [gd]family;
Dee: [a]/diː/; [n](Dee)人名;(英)迪伊; [gd]female;
Deek: [a]/diːk/; [英国方言] [常用祈使语气以引起注意]看看吧; [美国俚语]私人侦探; 侦探,侦察员; [gd]family;
Del: [a]/del/; [n](Del)人名;(匈)戴尔;(柬)德; [数]倒三角形; [gd]male;
Delf: [a]/delf/; [n](Delf)人名;(英)德尔夫; [gd]family;
Dement: [a]/dɪ'ment/; v. (尤指因为年龄而)精神衰退;失去理智; [n](Dement) (美,乌,俄)德门特(人名); [gd]family;
Dempster: [a]/'dempstə/; [n](Dempster)人名;(英)登普斯特; [gd]family;
Deng: [a]/'dʌŋ/; abbr. 工程学博士(Doctor of Engineering); [n](Deng)人名;(埃塞)登格;(老,柬)登; [gd]family;
Denmark: [a]/ˈdenmɑːk/; [n]丹麦(欧洲国家); [gd]family;
Dennis: [a]/'denɪs/; [n]丹尼斯(男子名); [gd]male;
Denter: [a]/'dentə/; [n]穿筘刀; [gd]family;
Denton: [a]/'dentən/; [n]丹顿(姓氏); [gd]family;
Denver: [a]/'denvə/; [n]丹佛(地名,美国城市); [gd]family;
Deployment: [a]/dɪˈplɔɪmənt/; [n]调度,部署; [gd]family;
Dept: [a]/dept/; abbr. 部;科(department);处; [gd]family;
Derbyshire: [a]/'da:biʃə/; [n]德比郡(英国英格兰中部的郡); [gd]family;
Derry: [a]/'derɪ/; [n](Derry)人名;(英,法)德里; [gd]family;
Development: [a]/dɪˈveləpmənt/; [n]发展;开发;发育;住宅小区(专指由同一开发商开发的); [摄]显影; [gd]family;
Di: [a]/ˌdiː ˈaɪ/; abbr. 直接射油,直接注入 (direct injection); [n](Di) (葡)迪(人名); [gd]female;
Dias: [a]/'di:əs/; [n]二叠纪;迪亚斯(品牌); [gd]family;
Dickie: [a]/'diki/; [n](Dickie) (英,法)迪基(人名); [gd]male;
Dido: [a]/'daɪdəʊ/; [n]黛朵(女子名);狄多(迦太基女王); [gd]female;
Dieter: [a]/ˈdaɪətə(r)/; [n](Dieter)人名;(英,德,葡,罗)迪特尔; [gd]male;
Dinges: [a]/'dɪŋəs/; [n](Dinges)人名;(德)丁格斯; [gd]family;
Dingle: [a]/'dɪŋg(ə)l/; [n](Dingle)人名;(英,葡)丁格尔; [gd]family;
Dipper: [a]/ˈdɪpər/; [n]北斗七星; [gd]family;
Discover: [a]/dɪˈskʌvə(r)/; [vt]发现;发觉; vi. 发现; [gd]family;
Dispatch: [a]/dɪˈspætʃ/; v. 派遣,发送;迅速处理,快速办妥;杀死,处决; [n]派遣,调遣,发送;(军事人员或政府官员间的)急件,快信;(由身在外地的记者发给报纸的)报道,电讯; [gd]family;
Dixon: [a]/'diksən/; [n]狄克逊(姓氏); [gd]family;
Dobby: [a]/'dɑbi/; [n](Dobby)人名;(法)多比; [gd]family;
Doi: [a]/ˌdiː oʊ ˈaɪ/; abbr. 数字对象识别码,数字对象标识符 (digital object identifier); [n](Doi) (美)多伊(人名); [gd]family;
Donator: [a]/dəʊ'neɪtə/; [n]捐赠者; [gd]family;
Doncaster: [a]/'dɔŋkəstə/; [n]唐卡斯特(城市名); [gd]family;
Dong: [a]/dɒŋ/; [n](Dong)人名;(中)董 (普通话-威妥玛); [vt]打击;敲击; vi. 发出铛铛的钟声; [gd]family;
Dormer: [a]/'dɔːmə/; [n](Dormer)人名;(法)多尔梅;(英)多默; [gd]family;
Dorr: [a]/dɔ:/; [n](Dorr)人名;(法,英,德,意,西)多尔; [gd]family;
Doss: [a]/dɒs/; v. (凑合着)睡觉,过夜;消磨时间; [n](Doss) (美)多斯(人名); [gd]family;
Dost: [a]/dʌst/; v. 动词 do 的老式第二人称单数形式; [n](Dost) (美,德)多斯特(人名); [gd]family;
Doughty: [a]/ˈdaʊti/; [adj]强的;勇敢的;刚强的; [n](Doughty)人名;(英)道蒂; [gd]family;
Douglas: [a]/'dʌɡləs/; [n]道格拉斯(男子名);道格拉斯(英国马恩岛首府); [gd]male;
Dover: [a]/'dəuvə/; [n]多佛(英国东南部的港口); [gd]family;
Dow: [a]/daʊ/; [n](Dow)人名;(英)道;(东南亚国家华语)涛; [gd]family;
Dowdy: [a]/ˈdaʊdi/; [adj]懒散的;过时的;寒酸的; [n](Dowdy)人名;(英)道迪; [gd]family;
Dower: [a]/'daʊə/; [n](Dower)人名;(英)道尔; [vt]给以嫁妆;给以产业; [gd]family;
Downer: [a]/ˈdaʊnə(r)/; [n](Downer)人名;(英)唐纳; [gd]family;
Downs: [a]/daʊnz/; [n]唐斯(英国英格兰南部和西南部的有草丘陵地); [gd]family;
Dowse: [a]/daʊz/; v. 把..浸入水(或其他液体)中;熄灭(灯,火);急降(桅帆)(等于 douse);用探测杆探寻(地下水或矿藏);用魔叉探杆探寻; [n](Dowse) (美)道丝(人名); [gd]family;
Doyle: [a]/dɔil/; [n]柯南道尔(英国医师,小说家,推理小说家);道尔(人名); [gd]male;
Dracula: [a]/ˈdrækjələ/; [n]德拉库拉(人名);吸血鬼,又叫惊情四百年(电影名); [gd]family;
Draper: [a]/ˈdreɪpə(r)/; [n](Draper)人名;(英)德雷珀;(法)德拉佩; [gd]family;
Dray: [a]/dreɪ/; [n](Dray)人名;(英,法)德雷;(意,葡)德拉伊; [vt]用马车运载; vi. 以运货马车运; [gd]family;
Dresser: [a]/ˈdresə(r)/; [n](Dresser)人名;(英,德)德雷瑟; [gd]family;
Driver: [a]/ˈdraɪvə(r)/; [n](Driver)人名;(德)德里弗;(英)德赖弗; [gd]family;
Drummer: [a]/ˈdrʌmə(r)/; [n](Drummer)人名;(德)德鲁默尔;(法)德吕梅;(英)德鲁默; [gd]family;
Dryer: [a]/ˈdraɪə(r)/; [n](Dryer)人名;(英)德赖尔; [助剂]干燥剂; [gd]family;
DuBois: [a]/dju'bwa:/; [n](Dubious) (美,法,加,比利时)迪布瓦(人名); [gd]family;
Dubois: [a]/dju'bwa:/; [n]杜布瓦(姓氏); [gd]family;
Dudgeon: [a]/ˈdʌdʒən/; [n]愤怒;生气,不高兴; [gd]family;
Dukes: [a]/du:ks/; [n]杜克斯钨钢; [gd]family;
Dumas: [a]/dju'ma:/; [n]大仲马(法国小说家);小仲马(法国小说家,大仲马之子); [gd]family;
Dupont: [a]/du:'pɒnt/; [n]杜邦,杜邦公司; [gd]family;
Durham: [a]/'dʌrəm/; [n]达拉谟(英格兰一郡及其首府名);一种产自该地的有短角肉牛; [gd]family;
Dyke: [a]/daɪk/; [n](Dyke)人名;(英)戴克;(德)迪克; [gd]family;
ENG: [a]/ˌiː en ˈdʒiː/; abbr. 电子新闻采集(Electronic News Gathering); [gd]family;
Eagles: [a]/'igl/; [n](Eagles)人名;(英)伊格尔斯; [gd]family;
Early: [a]/ˈɜːli/; [adj]早期的;早熟的; [adv]提早;在初期; [n](Early)人名;(英)厄尔利; [gd]family;
Eastman: [a]/'i:stmən/; [n]伊士曼(姓氏); [gd]family;
Easton: [a]/'i:stən/; [n]伊斯顿(人名);伊斯顿(美国地名); [gd]male;
Eaves: [a]/iːvz/; [n](Eaves)人名;(英)伊夫斯; [gd]family;
Edgar: [a]/'edgə/; [n]埃德加(男子名); [gd]male;
Edwards: [a]/'edwədz/; [n]爱德华兹(姓氏); [gd]family;
Ehrlich: [a]/'eəliu/; [n]欧利希(德国细菌学家); [gd]family;
Eide: [a]/'edɛi/; abbr. 加强式整合驱动电子界面(Enhanced Intelgrated Device Electronics); [n](Eide)人名;(英,德,挪,瑞典)艾德; [gd]family;
Elam: [a]/'i:ləm/; [n]埃兰(亚洲西南部一古国); [gd]family;
Electronics: [a]/ɪˌlekˈtrɒnɪks/; [n]电子学;电子工业; [gd]family;
Elgar: [a]/'elgə/; [n]埃尔加(姓氏); [gd]family;
Elias: [a]/ɪ'laɪəs/; [n]伊莱亚斯(希伯来先知,等于Elijah); [gd]male;
Ely: [a]/'i:li/; [n]伊利(男子名); [gd]male;
Emerson: [a]/'eməsn/; [n]爱默生(Ralph Waldo Emerson 美国思想家,诗人); [gd]male;
Emery: [a]/ˈeməri/; [n](Emery)人名;(英)埃默里;(西,意,葡)埃梅里; [矿物]刚玉砂; [gd]male;
Eng: [a]/ˌiː en ˈdʒiː/; abbr. 电子新闻采集(Electronic News Gathering); [n](Eng)人名;(德,柬,老,匈)恩;(匈,瑞典)恩格; [gd]family;
Engineering: [a]/ˌendʒɪˈnɪərɪŋ/; [n]工程,工程学; v. 设计;管理(engineer的ing形式);建造; [gd]family;
England: [a]/ˈɪŋɡlənd/; [n]英格兰; [gd]family;
English: [a]/ˈɪŋɡlɪʃ/; [adj]英格兰人的;英格兰的;英文的; [n](美,加,英,澳)英格利希(人名); [gd]family;
Enos: [a]/'i:nɔs/; [n]以挪士(基督教《圣经-创世记》中Seth的儿子); [gd]family;
Ensign: [a]/ˈensən/; [n](Ensign)人名;(英)恩赛因; [gd]family;
Environment: [a]/ɪnˈvaɪrənmənt/; [n]环境,外界; [gd]family;
Eros: [a]/ˈɪərɒs/; [n]厄洛斯(爱神); [gd]family;
Eu: [a]/ˌiː ˈjuː/; abbr. 欧盟(European Union);能量单位(Energy Unit);熵的单位(Entropy Unit);等效单位(Equivalent Unit); [n](Eu)人名;(中)余 (普通话-威妥玛);(英)尤; [gd]family;
Euler: [a]/ˈɔɪlər/; [n]欧拉(姓氏,瑞士数学家); [gd]family;
Eva: [a]/'i:və/; [n]伊娃(女子名); [gd]female;
Evans: [a]/'evənz/; [n]埃文斯(姓氏); [gd]family;
Events: [a]/ɪ'vɛnt/; [n](Events) (印度)伊文茨(人名); [gd]family;
Everett: [a]/'evərit/; [n]埃弗雷特(男子名); [gd]male;
Ewing: [a]/'ju:iŋ/; [n]尤因(男子名);尤英(美国新泽西州西部一县属区);尤文氏肉瘤; [gd]family;
Ezekiel: [a]/i'zi:kjəl/; [n]以西结(希伯来先知,旧约圣经以西结书之作者);伊齐基尔(姓氏); [gd]male;
Fab: [a]/fæb/; [adj]外事局(Foreign Affairs Bureau); [gd]family;
Falconer: [a]/ˈfɔːlkənə(r)/; [n](Falconer)人名;(英)福尔克纳;(西)法尔科内尔;(德,瑞典)法尔科纳; [gd]family;
Farmer: [a]/ˈfɑːmə(r)/; [n](Farmer)人名;(英)法默;(法)法尔梅;(西)法梅尔; [gd]family;
Farrow: [a]/ˈfærəʊ/; [n](Farrow)人名;(英)法罗; [vt]产(仔猪); vi. 产小猪; [adj](母牛)未怀孕的; [gd]family;
Faulkner: [a]/'fɔ:knə/; [n]福克纳(美国小说家, 曾获1949年诺贝尔文学奖); [gd]family;
Faust: [a]/faust/; [n]浮士德(歌德同名悲剧著作的主人公); [gd]family;
Felder: [a]/'feldə/; [n](Felder)人名;(英,德)费尔德; [gd]family;
Felton: [a]/'feltən/; [n]费尔顿(姓氏); [gd]family;
Fender: [a]/ˈfendə(r)/; [n](Fender)人名;(德,英)芬德; [gd]family;
Ferro: [a]/'fɛrə/; [n]西班牙耶劳岛的旧称; [gd]family;
Fielding: [a]/ˈfiːldɪŋ/; [n]菲尔丁(姓氏); [gd]family;
Fields: [a]/'fiːldz/; [n](Fields)人名;(德,英,葡)菲尔茨; [gd]family;
Filer: [a]/'faɪlɚ/; [n](Filer)人名;(罗,法)菲莱尔;(英)法勒; [gd]family;
Finn: [a]/fɪn/; [n]芬兰人; 爱尔兰巨人; [gd]male;
Fisher: [a]/ˈfɪʃə(r)/; [n](Fisher) (美,加,英,俄)费希尔(人名); [gd]family;
Fitch: [a]/fɪtʃ/; [n](Fitch) (美)菲奇(人名); [gd]family;
Fitzgerald: [a]/fits'dʒerəld/; [n]菲茨杰拉德(姓氏);菲茨杰拉德(英国诗人,翻译家,爱德华-菲茨杰拉德);菲茨杰拉德(美国作家,弗-司各特-菲茨杰拉德); [gd]male;
Flanders: [a]/'flɑ:ndəz/; [n]佛兰德斯(中世纪欧洲一伯爵领地,包括现比利时 的以及法国各一地区); [gd]family;
Fleming: [a]/'flɛmɪŋ/; [n]佛兰芒人;说佛兰芒语的比利时人;弗莱明(姓氏); [gd]male;
Fletcher: [a]/'fletʃə/; [n]弗莱彻(姓氏, 男子名);弗莱彻(John, 1579-1625, 英国剧作家);弗莱彻(John Gould, 1886-1950, 美国诗人及批评家); [gd]male;
Fleury: [a]/'flɜːrɪ/; [adj]有鸢尾(或百合)花纹饰的; [n](Fleury) (美,英)弗勒里(人名); [gd]family;
Florence: [a]/'flɔrəns/; [n]佛罗伦萨(意大利都市名);弗洛伦斯(女子名); [gd]female;
Flores: [a]/'flɔːrɪz/; [n](Flores) (美)弗洛里斯(人名); [gd]family;
Flowers: [a]/ˈflaʊɚz/; [植]花(flower的复数); [n](Flowers)人名;(英)弗劳尔斯; [gd]family;
Floyd: [a]/flɔid/; [n]弗洛伊德(男子名); [gd]male;
Fluty: [a]/'fluːtɪ/; [adj]似笛声的;(声音)柔软清澈的; [gd]family;
Foley: [a]/'fəuli:/; [n]福利(姓氏); [gd]family;
Foods: [a]/fu:dz/; [n] [食品]食品; [gd]family;
Forbes: [a]/fɔ:rbz/; [n]福布斯(美国出版及媒体集团);福布斯(美国著名财经杂志);福布斯(姓氏); [gd]male;
Forecasting: [a]/'for,kæst/; [n]预测; v. 预言;作预告(forecast的ing形式); [gd]family;
Foreman: [a]/ˈfɔːmən/; [n](Foreman)人名;(英,西)福尔曼; [gd]family;
Forester: [a]/ˈfɒrɪstə(r)/; [n](Forester) (美,英,爱尔兰)福雷斯捷(人名); [gd]male;
Forrest: [a]/'fɔrɪst/; [n]佛利斯特(人名,或美国电影阿甘正传); [gd]male;
Forster: [a]/'fɔ:stə/; [n]福斯特(姓氏); [gd]male;
Foss: [a]/fɔ:s/; [n](Foss)人名;(德,英,法,西,瑞典)福斯; [gd]family;
Foucault: [a]/fu:'kəu/; [n]傅科(人名); [gd]family;
Fougere: [a]/'fu:dʒiə/; [n]馥香(香型); [gd]family;
France: [a]/frɑːns/; [n]法国;法郎士(姓氏); [gd]female;
Francis: [a]/'frɑ:nsɪs/; [n]弗朗西斯(男子名,义为自由之人); [gd]male;
Franco: [a]/ˈfræŋkəʊ/; [n](Franco) (意,美)弗兰考(人名); [gd]family;
Franks: [a]/fræŋks/; [n]弗兰克斯(姓氏);法兰克人(书名); [gd]family;
Fraser: [a]/'freɪzər/; [n]弗雷则河(加拿大西南部河流);弗雷泽(男子名); [gd]male;
French: [a]/frentʃ/; [adj]法国的;法语的;法国人的; [n](美,英,加,澳)弗伦奇(人名); [gd]male;
Frey: [a]/frei/; [n]弗雷(司丰饶和平及耕耘之神); [gd]family;
Frisk: [a]/frɪsk/; v. 搜(某人的)身;(动物)蹦跳,欢跃,轻摇; [n](Frisk) (美,瑞典,丹)弗里斯克(人名); [gd]family;
Fritz: [a]/frɪts/; [n]德国人;德国佬; [gd]male;
Fryer: [a]/ˈfraɪə(r)/; [n](Fryer)人名;(瑞典)弗吕耶;(英)弗赖尔; [gd]family;
Fu: [a]/,ɛf 'ju/; abbr. 字段单元(Field Unit);芬森单位(Finsen Unit);流量单位(flux unit);熔断器(fuse); [gd]family;
Fuller: [a]/'fʊlə/; [n](Fuller) (英,德,匈,葡,捷)富勒(人名); [gd]family;
Gabbard: [a]/'ɡæbəd/; [n](Gabbard)人名;(英)加伯德; [gd]family;
Gabriel: [a]/'ɡeibriəl; 'ɡɑ:bri:'el/; [n]加布里埃尔(男子名);加百利(替上帝把好消息报告世人的天使); [gd]male;
Gainer: [a]/'ɡeɪnə/; [n](Gainer)人名;(英)盖纳; [gd]family;
Galt: [a]/gɔ:lt/; [n]高尔特(姓氏); [gd]family;
Gan: [a]/ɡæn/; v. 将去;开始,着手(gin 的过去式); [n](Gan) (美,马,新,俄)加恩(人名); [gd]family;
Gandhi: [a]/'gændi:/; [n]甘地(印度政府,社会和宗教领袖); [gd]family;
Gane: [a]/ɡen/; [n](Gane)人名;(意,罗,法,塞)加内;(英)甘恩; [gd]family;
Gardner: [a]/'ɡɑ:dnə/; [n]加德纳(男子名); [gd]male;
Garfield: [a]/'ɡɑ:fi:ld/; [n]加菲猫(卡通形象);加菲尔德(男子名); [gd]male;
Garvey: [a]/'gɑrve/; [n](Garvey)人名;(英,西,法)加维; [gd]male;
Gary: [a]/'ɡæri/; [n]盖理; [gd]male;
Gascon: [a]/'ɡæskən/; [n]吹牛的人;法国加斯科涅(Gascony)的人; [gd]family;
Gast: [a]/gæst/; v. 使惊讶;恐吓; [n](Gast) (美,德,法,荷,英,瑞)加斯特(人名); [gd]family;
Gaston: [a]/,ɡæstən/; [n]加斯顿(男子名); [gd]male;
Gateau: [a]/ɡæˈtoʊ/; [n](Gateau)人名;(法)加托; [gd]family;
Gater: [a]/'ɡeitə/; [n]盖特(人名); [gd]family;
Gaul: [a]/ɡɔ:l/; [n]高卢(位于欧洲西部);高卢人; [gd]family;
Gault: [a]/gɔlt/; [n](Gault) (美)戈(人名); [gd]family;
Gelling: [a]/'dʒeliŋ/; [n]凝胶化作用;胶凝作用; [gd]family;
Genet: [a]/ˈdʒenɪt/; [n](Genet)人名;(英)吉尼特;(罗)杰内特; [gd]family;
Genova: [a]/'dʒenəvə/; [n]热那亚(意大利一城市名,等于Genoa); [gd]family;
Gentes: [a]/'dʒɛntiz/; [n]氏族(gens的复数); [gd]family;
George: [a]/dʒɔ:dʒ/; [n]乔治(男子名);自动操纵装置;英国最高勋爵勋章上的圣乔治诛龙图; [gd]male;
Gera: [a]/'ɡeirɑ:/; [n]格拉(德国东部城市); [gd]female;
Gerald: [a]/'dʒerəld/; [n]杰拉尔德(男子名,义为勇敢的战士); [gd]male;
Gibbs: [a]/ɡɪbz/; [n]吉布斯(姓氏); [gd]family;
Gibson: [a]/'ɡibsn/; [n]吉布森鸡尾酒; [gd]family;
Gillette: [a]/dʒə'let/; [n]吉列公司(财富500强公司之一); [gd]family;
Glaser: [a]/'gleizə/; [n]格拉泽(姓氏); [gd]family;
Glasgow: [a]/'ɡlɑ:sɡəu/; [n]格拉斯哥(英国城市名); [gd]family;
Glazer: [a]/'glezɚ/; [n](Glazer)人名;(俄,法,塞)格拉泽尔;(英)格莱泽; [gd]family;
Glover: [a]/'ɡlʌvə/; [n](Glover)人名;(西,法)格洛韦尔;(英)格洛弗; [gd]family;
Goodman: [a]/'gʊdmən/; [n](Goodman)人名;(英,意)古德曼;(德)戈德曼; [gd]family;
Goss: [a]/ɡɔs/; [n](美,波兰,丹麦)戈斯(人名); [gd]family;
Gowan: [a]/'gaʊən/; [n](Gowan)人名;(英)高恩; [gd]family;
Gowl: [a]/ɡaʊl/; 落顶片帮; [gd]family;
Grader: [a]/ˈɡreɪdə(r)/; [n](Grader) (美,芬,俄)格雷德尔(人名); [gd]family;
Granger: [a]/'ɡreɪndʒə/; [n](Granger)人名;(德)格兰格;(西)格兰赫尔;(法)格朗热;(英)格兰杰; [gd]family;
Graver: [a]/'greɪvə/; [n](Graver) (美)格拉弗(人名); [adj]更重大的,更严峻的;更庄重的;更阴沉的; [gd]family;
Graves: [a]/ɡreivz/; [n](法国)格拉夫葡萄酒; [gd]family;
Greaves: [a]/ɡreɪvz/; [n](Greaves)人名;(英)格里夫斯;(西)格雷亚韦斯; [gd]family;
Greco: [a]/ˈɡrekoʊ/; [n]埃尔格列柯(El Greco,1541～1614,西班牙画家,原籍希腊); pref. 表示"希腊"(= Graeco-); [gd]family;
Greeley: [a]/'ɡri:li/; [n]格里利市(美国科罗拉多州中北部一城市); [gd]family;
Greene: [a]/gri:n/; [n]格林(姓氏); [gd]family;
Greenfield: [a]/ˈɡriːnfiːld/; [n](Greenfield)人名;(英)格林菲尔德; [adj]未开发地区的; [gd]family;
Greenway: [a]/'ɡrin,we/; [n](Greenway)人名;(英)格林韦; [gd]family;
Gregory: [a]/'ɡreɡəri/; [n]格雷戈里(男子名, 古代罗马教皇之名); [gd]male;
Griffith: [a]/'ɡrifiθ/; [n]格里菲思(女子名,Griffin的异体); [gd]male;
Gros: [a]/grəʊ/; [n]格罗斯; [gd]family;
Gu: [a]/gwɑm/; abbr. 关岛(Guam); [gd]family;
Gubbins: [a]/ˈɡʌbɪnz/; [n]小机件;小装置; [gd]family;
Gudgeon: [a]/'gʌdʒ(ə)n/; [n](Gudgeon)人名;(英)格杰恩; [gd]family;
Gunn: [a]/ɡʌn/; [adj]耿氏效应的;基于耿氏效应的; [n](Gunn) (挪,美,瑞典)冈恩(人名); [gd]family;
Gunter: [a]/'gʌntɚ/; [n]甘特(英国数学家); [gd]male;
Gunther: [a]/'ɡuntə/; [n]巩特尔(《尼伯龙之歌》中的勃艮第王); [gd]male;
Gupta: [a]/ˈɡʌptə/; 笈多; [n](Gupta)人名;(德,意,印,孟,尼)古普塔; [gd]family;
Gurney: [a]/ˈɡɜːni/; [n](Gurney)人名;(英)格尼; [gd]family;
Guyot: [a]/'giːəʊ/; [n](Guyot)人名;(法)居约;(英)盖约特; [海洋]平顶海山,平顶山; [gd]family;
Hacker: [a]/ˈhækə(r)/; [n](Hacker)人名;(英)哈克; [gd]family;
Hafiz: [a]/'hɑːfɪz/; [n](Hafiz)人名;(阿拉伯)哈菲兹; [gd]family;
Hagar: [a]/'heiga:/; [n](基督教)夏甲; [gd]family;
Hagen: [a]/'ha:gən/; [n]哈根(德国著名民间史诗《尼伯龙根之歌》中的人物);哈根(德国北部工业城市); [gd]male;
Halley: [a]/'hæli/; [n]哈雷(姓氏); [gd]female;
Hamilton: [a]/ˈhæmɪltən/; [n]汉密尔顿(男子名);哈密尔顿(美国城市名); [gd]male;
Hampshire: [a]/'hæmpʃə/; [n]汉普郡(英国南部之一郡); [gd]family;
Hannah: [a]/'hænə/; [n]汉娜(女子名); [gd]female;
Harbour: [a]/ˈhɑːbə(r)/; [n](Harbour)(美,英,加拿大)哈伯(人名); [gd]family;
Hardman: [a]/ˈhɑːdˌmæn/; [n](Hardman)人名;(英)哈德曼; [gd]family;
Harman: [a]/'hɑ:mən/; [n](Harman)人名;(英)哈曼; [gd]male;
Harmon: [a]/'ha:mən/; [n]哈蒙(姓氏); [gd]male;
Harper: [a]/'hɑ:pə/; [n]哈珀(英语姓氏); [gd]family;
Harris: [a]/ˈhæris/; [n]哈里斯(英国苏格兰一地区);哈里斯(姓氏); [gd]male;
Harrison: [a]/'hærisn/; [n]哈里森(男子名,哈里之子); [gd]male;
Hartley: [a]/'ha:tli/; [n]哈特利(一种信息量单位,等于3.323比特);哈特利(姓氏); [gd]male;
Harvey: [a]/'hɑ:vɪ/; [n]哈维(男子名); [gd]male;
Hastings: [a]/ˈheɪstɪŋz/; [n]黑斯廷斯(姓氏); [gd]male;
Hatcher: [a]/'hætʃɚ/; [n](Hatcher)人名;(英)哈彻; [gd]family;
Havelock: [a]/'hævlɒk/; [n](Havelock)人名;(英)哈夫洛克; [gd]family;
Hawker: [a]/ˈhɔːkə(r)/; [n](Hawker)人名;(英)霍克; [gd]family;
Hawkins: [a]/'hɔ:kinz/; [n]霍金斯(姓氏); [gd]family;
Hayes: [a]/heiz/; [n]海耶斯(男子名); [gd]male;
Hayward: [a]/'heiwəd/; [n](Hayward)人名;(英)海沃德; [gd]male;
Heald: [a]/hi:ld/; [n](Heald)人名;(英)希尔德; [gd]family;
Heller: [a]/'helə/; [n](Heller) (荷)埃莱尔(人名); [gd]family;
Helpline: [a]/ˈhelplaɪn/; [n]热线服务电话; [gd]family;
Henderson: [a]/'hendəsn/; [n]亨德森(姓氏); [gd]male;
Henley: [a]/'henlɪ/; [n]亨利(姓氏);亨里(英国诗人);亨利镇(英国地名); [gd]family;
Hermes: [a]/'ɛrmɛs/; [n]赫耳墨斯(希腊神话人物); 爱马仕(Hermès,法国的奢侈品品牌); [gd]family;
Herr: [a]/hεə/; [n](德)先生;德国绅士; [gd]family;
Herring: [a]/ˈherɪŋ/; [n](Herring) (美)赫林(人名); [gd]family;
Hesse: [a]/'hɛsi/; 海塞(姓氏); [gd]family;
Hester: [a]/'hestə/; [n]海丝特(女子名,等于Esther); [gd]female;
Hewer: [a]/'hjʊɚ/; [n]煤矿工;砍伐者; [gd]family;
Hews: [a]/hjuː/; v. 砍;劈;砍倒;砍成(某物或某种形状);遵从,坚持; [n](Hew) (美,英,马来)休(人名); [gd]family;
Hickey: [a]/ˈhɪki/; [n](Hickey)人名;(英)希基; [gd]family;
Hight: [a]/haɪt/; [n](Hight) (美)海特(人名); [adj](hight) (诗,文)名叫..的; v. (hight) 被称为..的; [gd]family;
Hiller: [a]/'hilə/; [n]希勒(德国歌唱家); [gd]family;
Hills: [a]/hɪlz/; [n]希尔思(猫粮品牌); [gd]family;
Hilton: [a]/'hɪltən/; [n]希尔顿(姓氏);希尔顿集团(主营酒店和香烟等); [gd]male;
Hitchcock: [a]/'hitʃkɔk/; [n]希契科克(姓氏); [gd]family;
Hodgkin: [a]/'hɔdʒkin/; [n]霍奇金(英国生理学家,生物物理学家, 曾获1963年诺贝尔生理学-医学奖);霍奇金(英国女化学家, 曾获1964年诺贝尔化学奖); [gd]family;
Hogg: [a]/hɒɡ/; [n]霍格(姓氏);一至二岁尚未剪过毛的小羊; [gd]family;
Holder: [a]/ˈhəʊldə(r)/; [n](Holder)人名;(英,罗,瑞典,德)霍尔德; [gd]family;
Holland: [a]/'hɒlənd/; [n]荷兰; [gd]family;
Hollander: [a]/'hɔləndə/; [n]荷兰船;荷兰人;打浆机; [gd]family;
Holmes: [a]/həulmz/; [n]福尔摩斯(英国作家柯南道尔所著侦探小说中的神探); [gd]family;
Holy: [a]/ˈhəʊli/; [adj]圣洁的,神圣的;至善的; [n](Holy)人名;(英,德,匈)霍利; [gd]family;
Homa: [a]/'homɚ/; abbr. 现代艺术酒店(Hotel of Modern Art); [n](Homa)人名;(日)保间(姓);(捷,波,英)霍马; [gd]family;
Hooker: [a]/ˈhʊkə(r)/; [n](Hooker)人名;(英)胡克; [gd]family;
Hooks: [a]/hʊk/; [n](Hooks)人名;(英)胡克斯; [机]钩;钓(hook的第三人称单数); [gd]family;
Hooper: [a]/'huːpə/; [n](Hooper) (美,加,英)奥佩尔(人名); [gd]family;
Hoover: [a]/ˈhuːvə(r)/; [n]吸尘器; v. 用吸尘器打扫; [gd]family;
Hopkins: [a]/'hɔpkinz/; [n]霍普金(姓氏); [gd]family;
Hopkinson: [a]/'hɔpkinsn/; [n]霍普金森(姓氏); [gd]family;
Hopper: [a]/ˈhɒpə(r)/; [n](Hopper)人名;(英,德)霍珀; [gd]family;
Hosier: [a]/'hoʒɚ/; [n]霍西尔(姓氏); [gd]family;
Hotline: [a]/ˈhɒtlaɪn/; [n]热线;热线电话,咨询电话; [gd]family;
Hotlist: [a]/ˈhɑːtlɪst/; [n]热站列表,常用项列表;活动表; [gd]family;
Houston: [a]/'hju:stən/; [n]休斯顿(美国得克萨斯州港市); [gd]family;
Howard: [a]/'haʊəd/; [n]霍华德(男子名); [gd]male;
Howe: [a]/haʊ/; [n]豪(姓氏,Elias,美国缝纫机发明人); [gd]family;
Hr: [a]/ˌeɪtʃ ˈɑː(r)/; abbr. 小时(hour);本垒打(home run); [gd]family;
Hu: [a]/,etʃ 'ju/; abbr. 海南航空公司在国际航空运输协会中的二字代码;匈牙利(Hungary);英国无国界卫生组织(Health Limited); [n](Hu)人名;(中)胡(广东话-威妥玛);(柬)胡;(东南亚国家华语)胡; [gd]family;
Huang: [a]/'hwɑŋ/; [n]黄(姓氏); [gd]family;
Hubbard: [a]/'hʌbəd/; [n]哈伯德(人名); [gd]family;
Hudson: [a]/'hʌdsən/; [n]哈得孙河; [gd]male;
Hughes: [a]/hju:z/; [n]休斯(人名); [gd]family;
Hugo: [a]/'hju:ɡəʊ/; [n]雨果(男子名,等于Hugh); [gd]male;
Hui: [a]/'huːɪ/; [n](Hui) (美,加,新)胡伊(人名); [gd]family;
Hume: [a]/hju:m/; [n]休姆(人名,姓氏); [gd]family;
Hummel: [a]/'hʌməl/; [adj](母牛,牧鹿等)无角的; [n](Hummel) (美)胡梅尔(人名); [gd]family;
Hunter: [a]/ˈhʌntə(r)/; [n]猎户座;亨特(姓氏); [gd]male;
Huntington: [a]/'hʌntiŋtən/; [n]亨廷顿(男子名,美国地名); [gd]male;
Hurst: [a]/hɜːst/; [n](Hurst)人名;(英)赫斯特;(德)胡斯特; [gd]family;
IC: [a]/,aɪ 'si:/; abbr. 集成电路(integrated circuit); [gd]family;
Ibsen: [a]/'ibsen/; [n]易卜生(姓氏);易卜生(挪威戏剧作家); [gd]family;
Id: [a]/ˌaɪ ˈdiː/; [n](Id)人名;(阿拉伯)埃德;(芬); [心理]伊德; [gd]family;
Ide: [a]/aɪd/; [n](Ide) (爱尔兰,巴西,美)艾德(人名); [gd]family;
Ilk: [a]/ɪlk/; [n]类型,种类;同类; [adj]相同的; [gd]family;
Ing: [a]/ɪŋ/; abbr. 惯性导航与制导(Inertial Navigation and Guidance);强中子发生器(Intense Neutron Generator); [n](Ing)人名;(柬)英;(朝)剩; [gd]family;
Ingle: [a]/'ɪŋg(ə)l/; [n](Ingle)人名;(英)英格尔; [gd]family;
Inspection: [a]/ɪnˈspekʃn/; [n]视察,检查; [gd]family;
Instal: [a]/in'stɔ:l/; [vt]安装;使就任;设置; [gd]family;
Integration: [a]/ˌɪntɪˈɡreɪʃn/; [n]集成;综合; [gd]family;
Interaction: [a]/ˌɪntərˈækʃn/; [n]互动; [数]交互作用; [gd]family;
Ip: [a]/'aɪ'pi/; abbr. 互联网协议(Internet Protocol);工业生产(Industrial Production);项目处理(Item Processing);位置辨识(Identification of Position); [n](Ip)人名;(朝)入;(中)叶(广东话-威妥玛); [gd]family;
Irc: [a]/ˌaɪ ɑːr ˈsiː/; abbr. 国际红十字会(International Red Cross);Internet交互式闲聊程序(Internet Relay Chat); [gd]family;
Ireland: [a]/'aɪələnd/; [n]爱尔兰; [gd]family;
Irvine: [a]/'ə:vin/; [n]警官; [gd]male;
Isaac: [a]/'aizək/; [n]艾萨克(男人名);以撒(希伯来族长, 犹太人的始祖亚伯拉罕和萨拉的儿子); [gd]male;
Islam: [a]/ˈɪzlɑːm; ɪzˈlɑːm/; [n](Islam)人名;(阿拉伯,巴基,孟)伊斯兰; [gd]family;
Ito: [a]/'i:,təu/; abbr. 国际贸易组织(International Trade Organization); [n](Ito)人名;(葡)伊托; [gd]family;
Ives: [a]/aivz/; [n]艾维斯(男子名); [gd]family;
Jackson: [a]/ˈdʒæksən/; [n]杰克逊(男子名);杰克逊(美国密西西比州的城市); [gd]male;
Jacob: [a]/'dʒeikəb/; [n]雅各(以色列人的祖先);雅各布(男子名); [gd]male;
Jacques: [a]/ʒɑk/; [n]雅克(男子名); [gd]male;
Jain: [a]/dʒeɪn/; [n](印,美,英,加,澳)然(人名); [adj]耆那教徒的;耆那教的; [gd]family;
Jak: [a]/jæk/; [n]木菠萝; [gd]family;
James: [a]/dʒeimz/; [n]詹姆斯(姓氏,男子名);《雅各书》; [gd]male;
Jarvis: [a]/'dʒɑ:vis/; [n]贾维斯(男子名);贾维斯岛; [gd]male;
Jasmin: [a]/'dʒæsmɪn/; [n](Jasmin)人名;(塞)亚斯明;(英)贾斯明,贾丝明(女名);(法)雅斯曼; [gd]female;
Java: [a]/'dʒɑːvə/; [n](Java) (美,印)杰娃(人名); [gd]family;
Jee: [a]/dʒiː/; int. (表示惊奇,兴奋)哎呀; [n](Jee) (美,巴,英,马,加)杰(人名); [gd]family;
Jefferson: [a]/'dʒefəsn/; [n]杰弗逊(姓氏); [gd]male;
Jew: [a]/dʒuː/; [n]犹太人;犹太教徒;守财奴; [vt]欺骗;杀价; [gd]family;
Jewett: [a]/'dʒu:it/; [n]朱厄特(姓氏); [gd]family;
Joe: [a]/dʒəʊ/; [n]乔(男子名); [gd]male;
Johannes: [a]/dʒəʊ'hænɪs/; [n](Johannes)人名;(英,西)约翰尼斯;(德,芬,捷,挪,冰,丹,意,瑞典)约翰内斯; [gd]male;
John: [a]/dʒɒn/; [n]约翰(男子名); [gd]male;
Johnson: [a]/'dʒɒns(ə)n/; [n]约翰逊(姓氏); [gd]family;
Joiner: [a]/ˈdʒɔɪnə(r)/; [n](Joiner)人名;(英)乔伊纳; [gd]family;
Jone: [a]/dʒon/; [n]约恩(男子名); [gd]family;
Jones: [a]/dʒəʊnz/; [n]琼斯(姓氏); [gd]family;
Jong: [a]/jɒŋ/; [n](Jong)人名;(东南亚国家华语)永;(德,荷)容; [gd]family;
Jordan: [a]/ˈdʒɔːdn/; [n]约旦(阿拉伯北部的国家);乔丹(男子名); [gd]male;
Joseph: [a]/ˈdʒəuzif/; [n]约瑟夫(男子名);约瑟(圣经中雅各的第十一子); [gd]male;
Josiah: [a]/dʒəu'saiə/; [n]约西亚(男子名); [gd]male;
Joyce: [a]/dʒɔis/; [n]乔伊斯(女名); [gd]female;
Julian: [a]/'dʒu:liən/; [adj]与凯撒有关的; [n](美,西)朱利安(人名); [gd]male;
Juneau: [a]/ˈdʒuːnəʊ/; [n]朱诺(美国阿拉斯加州的首府); [gd]family;
Junkie: [a]/ˈdʒʌŋki/; [n]有毒瘾者;废旧品商人; [gd]family;
Kara: [a]/'kɑːrə/; [n]喀拉海(北冰洋边海,在苏联新地岛和北地群岛之间); [gd]female;
Kaus: [a]/kauz/; [n]卡乌斯(波斯湾冬季带雨的东南风); [气象]考斯风; [gd]family;
Kawa: [a]/'ka:wə/; [n](Kawa)人名;(阿富)卡瓦; [gd]family;
Kawaguchi: [a]/,kɑ:wə'ɡutʃi/; [n]川口(日本本州岛东南部城市); [gd]family;
Kay: [a]/keɪ/; [n](Kay)人名;(中)祁(广东话-威妥玛);(老,柬)凯; [gd]female;
Kea: [a]/'kiːə/; [n](Kea)人名;(英)基亚;(柬)吉; [gd]family;
Keck: [a]/kek/; vi. 想吐;作呕;极为讨厌; [n](Keck)人名;(英,德)凯克; [gd]family;
Keef: [a]/kiː'ef/; [n]吸毒后的迷糊状态;麻醉品(等于kef); [gd]family;
Keels: [a]/kiːl/; [n](Keel) (美,瑞士,英)克尔(人名); [gd]family;
Kellogg: [a]/'kelɔg/; [n]凯洛格(姓氏); [gd]family;
Kelly: [a]/'kelɪ/; [n]凯利(男子名);战士; [gd]male;
Kemp: [a]/kemp/; [n](Kemp) (美,加,英)肯普(人名); [gd]family;
Kennedy: [a]/'kenidi/; [n]肯尼迪(姓氏,美国第35任总统); [gd]male;
Kenneth: [a]/'kenɪθ/; [n]肯尼思(男子名);英俊的领导者; [gd]male;
Kent: [a]/kent/; [n]肯特(英国东南部州名);不列颠岛南部的古代盎格鲁所建的王国; [gd]male;
Kiang: [a]/kɪ'æŋ/; [n](Kiang)人名;(刚(布))基昂;(老)江; [脊椎]西藏野驴; [gd]family;
Kidd: [a]/kɪd/; [n]基德(姓名); [gd]family;
Kim: [a]/kɪm/; [n]金姆(人名); [gd]male;
Kingston: [a]/'kɪŋztən/; [n]金斯敦(牙买加首都); [gd]male;
Kinsman: [a]/ˈkɪnzmən/; [n](Kinsman)人名;(英,法)金斯曼; [gd]family;
Kish: [a]/kɪʃ/; [n](Kish)人名;(英,罗,塞)基什; [冶]凝壳; [gd]family;
Knickerbocker: [a]/'nɪkəbɒkə/; [n](最初到美国纽约的)荷兰移民的后代;荷兰籍纽约人;纽约人;灯笼裤; [gd]family;
Ko: [a]/ˌkeɪ ˈoʊ/; [n](日)高(人名); abbr. (KO) (拳击比赛中)击倒 (knockout);开球 (kick-off); v. (KO) (拳击比赛中)击倒对手取胜;打倒某人; [gd]family;
Koa: [a]/'kəʊə/; [n]寇阿相思树(洋槐的一种);寇阿相思树木材;(夏威夷)寇阿相思树;柯阿金合欢; [gd]family;
Kohl: [a]/kəʊl/; [n](Kohl)人名;(德,英,罗,匈,葡,瑞典,捷)科尔; [gd]family;
Komatsu: [a]/kəu'mɑ:tsu/; [n]小松(日本本州岛城市); [gd]family;
Korea: [a]/kəˈriə/; [n]韩国;朝鲜; [gd]family;
Kos: [a]/kəus/; [n](希)科斯岛; [gd]family;
Krone: [a]/ˈkrəʊnə/; [n](Krone)人名;(德,法,瑞典)克罗内;(英)克朗; [gd]family;
Kuhn: [a]/ku:n/; [n]库恩(德国化学家,曾获1938年诺贝尔化学奖); [gd]family;
Kum: [a]/kum/; [n]库姆(伊朗西北部城市); [gd]family;
Kuo: [a]/kwɔ/; [n](Kuo)人名;(中)郭(广东话-威妥玛); [gd]family;
Kwa: [a]/kwɑ:/; [n]克瓦语(西部非洲的一个语族); [gd]family;
Kyle: [a]/kaɪl/; [n](Kyle)人名;(英)凯尔;(瑞典)许勒;(西)基莱; [gd]male;
LIBRARIAN: [a]/laɪˈbreəriən/; [n]图书馆员;图书管理员; [gd]family;
LLoyd: [a]/lɔɪd/; [n]劳埃德(男子名); [gd]family;
Labrador: [a]/ˈlæbrədɔː(r)/; [n]拉布拉多(加拿大东部一地区);一种纽芬兰猎犬; [gd]family;
Lai: [a]/,ɛl e 'aɪ/; [n](Lai) (美)拉伊(人名); [gd]family;
Laker: [a]/'lekɚ/; [n]湖畔派诗人;习惯于在湖上居住(或工作,航行)的人;湖鱼(尤指鲑鱼);湖船(尤指北美洲五大湖上的船); [gd]family;
Lally: [a]/'lɑ:li/; [n] [建]拉莱柱(中间浇注混凝土的钢圆柱); [gd]family;
Lan: [a]/læn/; 局域网(local area network); [n](Lan)人名;(东南亚国家华语)兰;(英,西,柬,瑞典)兰; [gd]family;
Lander: [a]/'lændə/; [n](Lander)人名;(丹)兰诺;(德,俄,西,捷,瑞典)兰德尔;(英)兰德; [gd]family;
Lang: [a]/læŋ/; abbr. 语言(language); [n](Lang)人名;(瑞典,俄,芬,葡,塞,捷,法,德,爱沙)朗;(中)冷(广东话-威妥玛);(英,法)兰; [gd]family;
Lange: [a]/'lɑŋə/; [n]兰格(姓氏); [gd]family;
Langer: [a]/ˈlæŋə/; 兰格; [n](Langer)人名;(英)兰格;(法,葡)朗热;(德,俄,罗,匈,捷,波,塞)朗格尔;(瑞典,丹)朗厄; [gd]family;
Langley: [a]/'læŋlɪ/; [n]兰利(姓氏);兰利(汽车品牌);兰利市(美国中央情报局本部所在地); [gd]family;
Lao: [a]/laʊ/; [n]老挝语;老挝人; [adj]老挝人的; [gd]family;
Larkin: [a]/'la:kin/; [n]拉金(男子名); [gd]family;
Latin: [a]/ˈlætɪn/; [n](Latin) (美)拉京(人名); [adj]拉丁语的,用拉丁语写成的; 拉丁语系国家(或民族)的;拉丁人的; [gd]family;
Laurence: [a]/'lɔrəns/; [n]劳伦斯(男子名); [光]闪烁景; [gd]male;
Laurent: [a]/'lɔrənt/; [n]劳伦(法国数学家); [gd]male;
Laurin: [a]/'lɔ:rin/; [n](Laurin)人名;(英,西,捷,瑞典)劳林;(法)洛兰; [有化]三月桂酸甘油酯; [gd]family;
Lawless: [a]/ˈlɔːləs/; [adj]无法律的,不遵守法律的;目无法纪的,不守法的;不受法律约束的; [n](Lawless) (美)劳利斯(人名); [gd]family;
Lawrence: [a]/'lɒrəns/; [n]劳伦斯(男子名); [gd]male;
Laws: [a]/lɔ:z/; [n](Laws)人名;(英)劳斯; [gd]family;
Lawson: [a]/'lɔ:sən/; [n]劳森(姓氏); [gd]male;
Lazar: [a]/'leɪzə; 'læzə/; [n](Lazar)人名;(英,法,意,俄,塞,捷,保)拉扎尔;(西)拉萨尔; [gd]male;
Le: [a]/,el'i:/; abbr. 语言工程 (language engineering); abbr. (LE) 红斑狼疮 (Lupus Erythematosus);领先地位 (Leading Edge); [n](Le) (美,挪,越,丹)列(人名); [gd]family;
Leader: [a]/ˈliːdə(r)/; [n](Leader)人名;(英)利德; [gd]family;
Leander: [a]/li':ændə/; [n]利安得(希腊传说中海洛的情人); [gd]family;
Leary: [a]/'lɪərɪ/; [adj]空的; [n](Leary) (美,英,加,澳)利里(人名); [gd]family;
Leaver: [a]/ˈliːvə(r)/; [n](Leaver)人名;(英)利弗; [gd]family;
Lem: [a]/lem/; abbr. 登月舱(Lunar Excursion Module);激光能量监控器(Laser Energy Monitor); [n](Lem)人名;(俄,西,英)莱姆; [gd]male;
Leo: [a]/ˈliːəʊ/; [n]狮子座;狮子(用于儿童故事寓言等);利奥(男子名); [gd]male;
Leonard: [a]/'lenəd/; [n]伦纳德(男子名); [gd]male;
Leone: [a]/liː'əʊn/; [n](Leone)人名;(英,葡,德,意)莱昂内; [gd]female;
Lett: [a]/let/; [n]列托人;列托语; [gd]family;
Levi: [a]/'li:vai/; [n]利瓦伊(男子名); [gd]male;
Levin: [a]/'levɪn/; [n](Levin)人名;(英,以)莱文;(德,罗,俄,意,葡,塞,芬,挪,匈,瑞典)莱温;(法)勒万; [gd]male;
Levo: [a]/'livo/; [adj]左旋的(等于 levorotatory); [n](Levo) (美,意)莱沃(人名); [gd]family;
Lew: [a]/lu:/; [n]卢(等于Louis,男子名); [gd]male;
Ley: [a]/leɪ/; [n](Ley)人名;(德,法,匈,柬)莱;(英)利; [gd]family;
Li: [a]/liː/; [n](Li)人名;(朝)李;(德,俄,柬)利; [gd]family;
Liang: [a]/lɪɑːŋ/; [n](Liang)人名;(泰)良;(中)梁(普通话-威妥玛);(中)梁(广东话-威妥玛); [gd]family;
Liao: [a]/ljau/; [n]辽河(在中国东北部);廖(中国姓氏); [gd]family;
Lias: [a]/'laɪəs/; [n]蓝色石灰岩; [gd]family;
Limerick: [a]/ˈlɪmərɪk/; [n](Limerick)人名;(英)利默里克; [gd]family;
Ling: [a]/lɪŋ/; [n](Ling) (美,马,新)林格(人名); [gd]family;
Linn: [a]/lɪn/; [n](Linn)人名;(英,德,匈,瑞典)林; [gd]female;
Lister: [a]/'lɪstə/; [n](Lister) (美,英,加,澳)利斯特(人名); [gd]family;
Livingston: [a]/'liviŋstən/; [n]利文斯顿(美国新泽西州东北部城镇); [gd]family;
Llewellyn: [a]/'lu:'elin/; [n]卢埃林(男子名); [gd]male;
Lloyd: [a]/lɔɪd/; [n]劳埃德(男子名); [gd]male;
Loa: [a]/'ləʊə/; abbr. 总长 (length overall); [n](Loa) (美)洛亚(人名); [gd]family;
Loader: [a]/'ləʊdə/; [n](Loader) (美,爱,英)洛德(人名); [gd]family;
Locke: [a]/lɔk/; [n]洛克(姓氏); [gd]male;
Logan: [a]/'lɒg(ə)n; 'ləʊg(ə)n/; [n]洛根(男子名); [gd]male;
London: [a]/ˈlʌndən/; [n]伦敦; [gd]family;
Loo: [a]/luː/; [n](Loo)人名;(德,法)洛; [vt]使罚赌金; [gd]family;
Loos: [a]/luːs/; [n](Loos)人名;(法,德,西,捷,瑞典)洛斯;(英)卢斯; [gd]family;
Lorimer: [a]/'lɔrɪmɚ/; [n](Lorimer)人名;(英)洛里默; [gd]family;
Lou: [a]/,el əʊ 'ju:/; [n]卢(女子名,等于Louise或Lu); [gd]male;
Lough: [a]/lɒk; lɒx/; [n](Lough)人名;(英)洛; [gd]family;
Louis: [a]/ˈlu(:)i, ˈlu(:)is/; [n]路易斯(男子名); [gd]male;
Lovelace: [a]/'lʌv,les/; [n]色鬼(原为Samuel Richardson小说Clarrisa Harlowe中人物的名字);浪子; [gd]family;
Loveless: [a]/ˈlʌvləs/; [adj]不可爱的;无爱情的; [n](Loveless)人名;(英)洛夫莱斯; [gd]family;
Luff: [a]/lʌf/; [n](Luff)人名;(英)勒夫;(德)卢夫; [vt]将船首朝上风; vi. 转船首迎风行驶;驶出上风; [gd]family;
Luke: [a]/lu:k/; [n]卢克(男子名);路加(基督教早期信徒之一);路加福音; [gd]male;
Lum: [a]/lʌm/; [n](Lum)人名;(越)珑;(英,西)卢姆; [gd]family;
Luna: [a]/'lunɚ/; [n]月神;月亮; [gd]female;
Lutz: [a]/luts/; [n](Lutz)人名;(英,法,德,西,意,罗,匈,芬,瑞典)卢茨; [gd]family;
Ly: [a]/,ɛl'waɪ/; [n](Ly) (老,柬,塞内,毛里塔)利(人名);(东南亚国家华语)李(人名); [gd]family;
Lynn: [a]/lɪn/; [n]林恩(姓氏); [gd]male;
Lyon: [a]/liˈoŋ, ljɔŋ/; [n]苏格兰纹章院长官;里昂(法国城市); [gd]family;
MACKenzie: [a]/mə'kenzi/; [n](MacKenzie)人名;(英,意,葡)麦肯齐; [gd]family;
MIC: [a]/maɪk/; abbr. 军界,工业界集团(Military-Industrial Complex); [gd]family;
Maas: [a]/mɑːs/; [n]马斯河(欧洲一主要河流); [gd]family;
Mac: [a]/mæk/; [n](美)马克(人名); [gd]male;
MacArthur: [a]/mək'a:θə; mæ'ka:θə/; [n]麦克阿瑟(美国五星上将); [gd]family;
MacFarlane: [a]/mək'fɑ:lin/; [n](MacFarlane)人名;(英)麦克法兰; [gd]family;
MacKenzie: [a]/mə'kenzi/; [n](MacKenzie)人名;(英,意,葡)麦肯齐; [gd]family;
Macfarlane: [a]/mək'fɑ:lin/; [n](MacFarlane)人名;(英)麦克法兰; [gd]family;
Mach: [a]/mɑːk; mæk/; [n]马赫(奥地利物理家); [航]马赫数(飞行速度除以音速); [gd]family;
Machan: [a]/mʌ'tʃɑːn/; [n](Machan)人名;(捷)马汉; [gd]family;
Mackenzie: [a]/mə'kenzi/; [n]麦肯齐河(又译"马更些河",加拿大西北部河流);麦肯齐区(又译"马更些区",加拿大西北部的小区);麦肯齐氏; [gd]male;
Madison: [a]/ˈmædɪsn/; [n]麦迪逊(姓氏);麦迪逊(美国城市); [gd]male;
Madras: [a]/məˈdræs; məˈdrɑːs/; [n]马德拉斯(印度港市); [gd]family;
Mage: [a]/meɪdʒ/; [n](Mage)人名;(西)马赫;(法)马热; [gd]family;
Mahon: [a]/mɑ:'hɔ:/; [n]马翁(西班牙地名);马洪(姓氏); [gd]family;
Maidenhead: [a]/ˈmeɪdnhed/; [n]处女膜;处女性; [gd]family;
Maine: [a]/meɪn/; [n]缅因州(美国州名); [gd]family;
Mak: [a]/mæk/; abbr. 多次激活密钥(Multiple Activation Key); [n](Mak)人名;(柬)马;(英,俄,塞,捷,罗)马克; [gd]family;
Malam: [a]/'mæləm/; [n]马来赤铁树; [gd]family;
Malcolm: [a]/'mælkəm/; [n]马尔科姆(男子名); [gd]male;
Malta: [a]/ˈmɔːltə/; [n]马耳他(欧洲岛国); [gd]family;
Maltese: [a]/ˌmɔːlˈtiːz/; [n]马耳他人;马耳他语; [adj]马耳他的; [gd]family;
Management: [a]/ˈmænɪdʒmənt/; [n]管理;管理人员;管理部门;操纵;经营手段; [gd]family;
Manager: [a]/ˈmænɪdʒə(r)/; [n]经理;管理人员; [gd]family;
Manchester: [a]/ˈmæntʃestə(r)/; [n]曼彻斯特(英格兰西北部一大城市); [gd]family;
Mandel: [a]/'mændəl/; [n]曼德尔(人名); [gd]family;
Manner: [a]/ˈmænə(r)/; [n](Manner)人名;(德,芬,瑞典)曼纳; [gd]family;
Manners: [a]/'mænəz/; [n](Manners)人名;(英,瑞典)曼纳斯; [gd]family;
Manning: [a]/'mænɪŋ/; v. 在..岗位上工作;操纵(机器等);保卫(防御工事);配备(人员);为..鼓气(man 的现在分词); [n](Manning) (美)曼宁(人名); [gd]family;
Manto: [a]/'mæntəu/; [n]黑披巾;平卧状矿床,; [地质]席状交代矿床; [gd]family;
Manus: [a]/'meɪnəs/; [n](Manus)人名;(俄,意)马努斯; [gd]family;
Mao: [a]/mau/; [n](Mao) (美,日,法)马奥(人名); [gd]family;
Marc: [a]/mɑːk/; [n](Marc)人名;(塞)马尔茨;(德,俄,法,荷,罗,瑞典,西,英)马克; [gd]male;
Marchese: [a]/mɑːr'keziː/; [n](Marchese) (美,意,加,根,法)马尔凯塞(人名); [gd]family;
Marconi: [a]/mɑ:'kəuni/; [n]马可尼(意大利物理学家); [gd]family;
Marcus: [a]/'mɑ:kəs/; [n]马库斯(男子名); [gd]male;
Marion: [a]/'mɛəriən/; [n]马里恩(男子名); [gd]male;
Marketing: [a]/ˈmɑːkɪtɪŋ/; v. 推销,促销;市场宣传,市场推广;买卖;出售(market 的现在分词); [n]促销,销售;市场营销; [gd]family;
Marks: [a]/ma:rks/; [n](Marks)人名;(英,德,意,瑞典,西,捷)马克斯;(俄)马克思; [gd]family;
Marling: [a]/'mɑ:liŋ/; [n](Marling)人名;(英,德)马林; [gd]family;
Marriott: [a]/'mærɪət/; [n]马里奥特(美国第二大宴会承包商); [gd]family;
Marshall: [a]/'mɑ:ʃl/; [n]马歇尔(姓氏,男子名,等于Mar'shal); [gd]male;
Marting: [a]/mɑːt/; [n](Mart)人名;(爱沙)马尔特;(塞,法,土库,阿塞,俄)马尔特; [gd]family;
Marx: [a]/ma:ks/; [n]马克思(无产阶级的伟大领袖); [gd]family;
Masse: [a]/mæs/; [n](Masse)人名;(英,法)马斯;(西)马塞; [gd]family;
Masson: [a]/'mæsn/; [n]马森(姓氏); [gd]family;
Masters: [a]/'mæstɚ/; [n]马斯特斯(人名); [gd]family;
Maund: [a]/mɔːnd/; [n]莫恩德(尼泊尔,印度,巴基斯坦及某些中东国家使用的一种重量单位); [gd]family;
Mavis: [a]/'meɪvɪs/; [n](Mavis)人名;(西)马维斯;(英)梅维斯,梅维丝(女名); [gd]female;
Mayo: [a]/'meɪəʊ/; [n]梅奥(爱尔兰西北部一郡); [gd]family;
Mazey: [a]/ˈmeɪzɪ/; [n](Mazey)人名;(英)梅齐; [gd]family;
Mc: [a]/ˌem ˈsiː/; abbr. 司仪(Master of Ceremonies);国会议员(member of Congress); [gd]family;
McCarthy: [a]/mə'ka:θi/; [n]麦卡锡(姓氏); [gd]family;
McCoy: [a]/məˈkɔɪ/; [n]本人;真品; [gd]family;
McDonald: [a]/mək'dɔnəld/; [n]麦克唐纳(男子名);麦当劳(快餐店名称); [gd]family;
McIntosh: [a]/'mækin,tɔʃ/; [n](McIntosh) (美,加,英)麦金托什; [gd]family;
Mccarthy: [a]/mə'ka:θi/; [n]麦卡锡(姓氏); [gd]family;
Meany: [a]/ˈmiːni/; [n](Meany)人名;(英)米尼; [gd]family;
Measures: [a]/ˈmeʒə(r)z/; [n](Measures)人名;(英)梅热斯; [gd]family;
Mei: [a]/,ɛm i 'aɪ/; [n](Mei) (美,马,新)梅伊(人名); [gd]female;
Melton: [a]/'melt(ə)n/; [n](Melton)人名;(英)梅尔顿; [纺]麦尔登呢(等于melton cloth); [gd]family;
Meres: [a]/mɪə(r)/; [adj]仅仅的;只不过的; [n](Mere)人名;(日)目连(姓);(西)梅雷; [gd]family;
Merrill: [a]/mə'rɪl/; [n]美林(美国证券公司);美林(美国城市); [gd]male;
Metrics: [a]/ˈmetrɪks/; [n]度量;作诗法;韵律学; [gd]family;
Metz: [a]/mɛs/; [n]梅茨(法国东北部城市); [gd]family;
Meyer: [a]/'meijə/; [n]迈耶(日耳曼语,指首席侍从或农夫); [gd]male;
Mia: [a]/ˌem aɪ ˈeɪ/; abbr. 战斗中失踪的(Missing In Action); [n](Mia)人名;(德,芬,罗,巴基,孟)米娅 (女名),米亚;(英)米娅; [gd]female;
Michael: [a]/'maɪkl/; [n]迈克尔(男子名); [gd]male;
Miles: [a]/mailz/; [n]迈尔斯(男子名); [gd]male;
Mills: [a]/milz/; [n]米尔斯(人名); [gd]family;
Milton: [a]/'mɪltən/; [n]米尔顿(男子名,英国诗人); [gd]male;
Mina: [a]/'minə/; [n](Mina)人名;(罗,塞,葡,西,希,意,伊朗,英)米纳,米娜(女名); [gd]female;
Miner: [a]/ˈmaɪnə(r)/; [n](Miner)人名;(英)迈纳;(西)米内尔; [gd]family;
Minos: [a]/'mainɔs/; [n]迈诺斯(希腊神话中克里特岛的王, 死后做阴间的法官); [gd]family;
Mir: [a]/miə/; [n](Mir)人名;(法,西,印,阿拉伯,土库,阿塞,巴基,伊朗,哈萨,乌兹,塔吉,吉尔,阿富)米尔; [gd]family;
Miranda: [a]/məˈrændə/; [n]米兰达(女子名); [gd]female;
Mirza: [a]/'mɜːzə/; [n](Mirza)人名;(阿拉伯,土,意,巴基,哈萨,塔吉,吉尔,乌兹,阿塞,土库,英)米尔扎; [gd]family;
Mis: [a]/ˌem aɪ ˈes/; [n](Mis)(葡,美,俄,法,印)米斯(人名); [gd]family;
Mitchell: [a]/'mitʃəl/; [n]米切尔(男子名,等于Michael); [gd]male;
Mo: [a]/məʊ/; abbr. 方式(Modus Operandi);卫生干事,卫生管员(Medical Officer);邮购(Mail Order);邮政汇票(Money Order); [n](Mo)人名;(日)茂(姓);(意,缅,瑞典)莫; [gd]family;
Modi: [a]/'modaɪ/; [n](Modi)人名;(意)莫迪; [gd]family;
Monaco: [a]/ˈmɒnəkəʊ/; [n]摩纳哥(欧洲西南部国家); [gd]family;
Mong: [a]/mʌŋ/; [n](Mong) (美,罗,加,法,英)蒙格(人名); [gd]family;
Monroe: [a]/mən'rəu/; [n]门罗(男子名);门罗(美国第五任总统); [gd]male;
Montero: [a]/mɒn'teərəʊ/; [n](Montero)人名;(英,法,西,葡)蒙特罗;(意)蒙泰罗; [gd]family;
Montgomery: [a]/mɑnt'gʌməri/; [n]蒙哥马利(姓氏);蒙哥马利(英国郡名); [gd]male;
Montreal: [a]/ˌmɒntriˈɔːl/; [n]蒙特利尔(加拿大东南部港市); [gd]family;
Mony: [a]/'mɒnɪ/; [n](mony) 许多;大多数人(等于 many); [adj](mony) 许多的(等于 many); [gd]family;
Mooney: [a]/'mu:ni/; [n]穆尼(姓氏); [gd]family;
Moore: [a]/mɔ:/; [n]摩尔(男子名); [gd]male;
Mordecai: [a]/'mɔdəkaɪ/; [n]末底改(基督教《圣经》故事人物); [gd]male;
Morden: [a]/'mɔ:dn/; [n]莫登(加拿大曼尼托巴省南方临近美国边界的城市); [gd]family;
Morgan: [a]/'mɔ:ɡən/; [n]摩根; [gd]male;
Mori: [a]/ˈmɔːrɪ/; abbr. 国际市场研究公司(Market &Opinion Research International); [n](Mori)人名;(法,意,西,英)莫里;(日)守 (名); [gd]family;
Morin: [a]/'mɔ:rin/; [n](Morin)人名;(法)莫兰;(德,意,俄,英,塞,瑞典)莫林; [试剂]桑色素; [gd]family;
Morrison: [a]/'mɔrisn/; [n]莫里森(姓氏); [gd]family;
Morse: [a]/mɔ:s/; [n](morse) (斗篷式长袍上的)钩扣; v. (morse) 用摩尔斯电码发送; [gd]male;
Mortimer: [a]/'mɔ:timə/; [n]莫蒂默(男子名); [gd]male;
Mote: [a]/məʊt/; [n](Mote)人名;(英,法,塞)莫特; [gd]family;
Mou: [a]/mu:/; abbr. 谅解备忘录(Memorandum of Understanding); [n](Mou)人名;(意,柬)穆;(中)牟(普通话-威妥玛); [gd]family;
Msg: [a]/ˌem es ˈdʒiː/; abbr. 味精(Monosodium Glutamate);谷胺酸单钠(Monosodium Glutamate); [gd]family;
Mufti: [a]/ˈmʌfti/; [n](Mufti)人名;(俄)穆夫季;(阿拉伯)穆夫提(伊斯兰教教法权威); [gd]family;
Muir: [a]/muːr, mjuːr, myr/; 缪尔; [gd]family;
Mullen: [a]/'mʌlən/; [n](Mullen)人名;(英)马伦; [gd]family;
Muller: [a]/'mʌlə/; [n](Muller)人名;(德,罗,俄,意)穆勒;(英)马勒;(法)米勒; [gd]family;
Munro: [a]/mʌnˈrəʊ/; 芒罗(苏格兰姓氏); [gd]family;
Munter: [a]/'mʌntə/; [n]芒特(人名); [gd]family;
Murdoch: [a]/'mə:dɔk/; [n]默多克(男子名); [gd]male;
Murphy: [a]/'mɜːfɪ/; [n](Murphy)人名;(英,葡,瑞典)墨菲; [gd]male;
Musa: [a]/'mju:zə/; [n]穆萨(人名);(拉丁); [植]芭蕉属; [gd]family;
Musca: [a]/'mʌskə/; [n]苍蝇(星)座; [gd]family;
Nairn: [a]/nεən/; [n]奈恩(英国苏格兰北部旧郡);耐恩(姓氏); [gd]family;
Napper: [a]/'næpə/; [n](Napper)人名;(德,英)纳珀; [gd]family;
Nashville: [a]/'næʃvil/; [n]那什维尔(美国田纳西州首府); [gd]family;
Nava: [a]/'nævə/; [n]纳瓦(姓氏); [gd]family;
Navarre: [a]/nə'vɑ:/; [n]纳瓦拉(中世纪时期位于西班牙东北部和法国西南部的王国); [gd]family;
Nelson: [a]/ˈnelsn/; [n](Nelson)人名;(英,俄)纳尔逊;(德,西,葡,瑞典)内尔松; [gd]male;
Ness: [a]/nes/; [n](Ness)人名;(德,英,西,瑞典)内斯,内丝(女名); [gd]family;
Nestor: [a]/'nestə/; [n]内斯特;聪明的长者; [gd]male;
Neville: [a]/'nevil/; [n]内维尔(男子名); [gd]male;
Newell: [a]/'nju:əl/; [n]纽厄尔(男子名); [gd]family;
Newport: [a]/ˈnjuːpɔːt/; [n]新港;纽波特(美国罗得岛之避暑胜地); [gd]family;
News: [a]/njuːz/; [n]新闻,消息;新闻报导; [gd]family;
Ngo: [a]/ˌen dʒiː ˈoʊ/; abbr. 非政府组织(Non-Governmental Organization);民间组织; [n](Ngo)人名;(喀)恩戈;(柬)努; [gd]family;
Nickle: [a]/'nɪkl/; [n]尼科尔(男子名); [gd]family;
Nicol: [a]/'nikəl/; [n]尼科尔棱镜(偏光镜); [gd]female;
Nicosia: [a]/,nikəu'si:ə/; [n]尼科西亚(塞浦路斯首都); [gd]family;
Nill: [a]/nɪl/; v. 拒绝;不愿意,不想; [n](Nill) (美)尼尔(人名); [gd]family;
Nipper: [a]/ˈnɪpə(r)/; [n](Nipper)人名;(德)尼佩尔; [gd]family;
Niu: [a]/nju:/; [n](Niu) (美)丹生(人名); [gd]family;
Nix: [a]/nɪks/; [n](Nix) (德,英,美)尼克斯(人名); [adv]不,不行; [gd]family;
Nixon: [a]/'niksn/; [n]尼克松(美国第37任总统); [gd]family;
Noah: [a]/'nəuə/; [n]诺亚(圣经人物); [gd]male;
Nock: [a]/nɒk/; [n](Nock)人名;(英,德)诺克; [vt]作凹痕于;将弦搭上; [gd]family;
Noel: [a]/nəʊˈel/; [n]诺埃尔(姓氏);圣诞节; [gd]male;
Norman: [a]/ˈnɔːmən/; [adj]与诺曼人有关的;诺曼式的;(现代)诺曼底的; [n](美,加,英,瑞,澳)诺尔曼(人名); [gd]male;
Norton: [a]/'nɔrtən/; [n]诺顿(男子名);诺顿公司(美国一软件公司); [gd]male;
Nowell: [a]/'noɛl/; 诺埃尔(人名); [gd]family;
Noy: [a]/nɔi/; [n](Noy)人名;(老)内;(英)诺伊; [声]纳(感觉噪声的单位); [gd]family;
OPERATIONS: [a]/,ɑpə'reʃən/; [n]运营;运作;业务操作(operation的复数); [gd]family;
OPS: [a]/ɔps/; abbr. (美国)物价管制局(Office of Price Stabilization);管道安全处(Office of Pipeline Safety); [gd]family;
OTTAWA: [a]/ˈɒtəwə/; [n]渥太华(加拿大首都); [gd]family;
Oakley: [a]/'əukli/; [n]赠券(等于Annie Oakley);奥克利眼镜; [gd]family;
Oaks: [a]/əuks/; [n](英国)欧克斯马赛; [gd]family;
Oates: [a]/əuts/; [n]奥兹(姓氏名); [gd]family;
Oka: [a]/'ɒkə/; [n]奥卡河(俄罗斯欧洲部分中部河流); [gd]family;
Oke: [a]/əʊk/; [n](Oke) (土,美)奥凯(人名); [adj]可以的;安全的(等于 okay); [gd]family;
Older: [a]/'əʊldə/; [adj]年长的;较旧的; [n](Older)人名;(英)奥尔德; [gd]family;
Oliver: [a]/'ɒlɪvə/; [n]奥利弗(男子名); [gd]male;
Olivier: [a]/əu'liviə/; [n]奥利维尔(男子名); [gd]male;
Oman: [a]/əʊˈmɑːn; əʊˈmæn/; [n]阿曼(西南亚国家); [gd]family;
Op: [a]/ɒp/; [n]手术,军事行动(Operation,非正式); abbr. 手术 (operation),技工 (operative),操作员 (operator);机会 (opportunity);作品 (opus); abbr. (OP) 观测所 (Observation Post);绝版 (Out of Print);有机磷酸酯 (organophosphate);道明会 (Order of Preachers); [gd]family;
Operations: [a]/,ɑpə'reʃən/; [n]运营;运作;业务操作(operation的复数); [gd]family;
Operator: [a]/ˈɒpəreɪtə(r)/; [n]经营者;操作员;话务员;行家; [gd]family;
Operators: [a]/ˈɒpəreɪtə(r)s/; [n]经营者;操作者; [计]运算符(operator的复数); [gd]family;
Oran: [a]/ɔ:'ræn; ɔ'rɔŋ/; [n]奥兰(阿尔及利亚一座城市); [gd]male;
Orders: [a]/'ɔːdərs/; abbr. 圣职 (holy orders); [n](Orders) (美)奥德斯(人名); [gd]family;
Organization: [a]/ˌɔːɡənaɪˈzeɪʃn/; [n]组织;机构;体制;团体; [gd]family;
Orlando: [a]/ɔ:'lændəu/; [n]奥兰多(美国城市名,男子名); [gd]male;
Outage: [a]/ˈaʊtɪdʒ/; [n](电力等)停止供应期,断供期;设备停开期; [gd]family;
Oviedo: [a]/ɔ:'vjedɔ:/; [n]奥维耶多(西班牙西北部一城市); [gd]family;
Pacey: [a]/ˈpeɪsi/; [n](Pacey)人名;(英)佩西;(法)帕塞; [gd]family;
Packager: [a]/'pækɪdʒɚ/; [n]打包机,包装机;包装者;节目制作人; [gd]family;
Pai: [a]/paɪ/; abbr. 纤溶酶原激活物抑制物 (plasminogen activator inhibitor); [n](Pai) (美)帕伊(人名); [gd]family;
Painter: [a]/ˈpeɪntə(r)/; [n](Painter)人名;(英)佩因特; [gd]family;
Palmer: [a]/'pɑːmə/; [n](Palmer)人名;(英,德,挪)帕尔默;(法)帕尔梅; [gd]male;
Papers: [a]/'pepɚz/; [n](Papers)人名;(希)帕佩尔斯; [gd]family;
Paris: [a]/'pærɪs/; [n]巴黎(法国首都);帕里斯(特洛伊王子); [gd]family;
Parker: [a]/'pɑːkə/; [n](Parker)人名;(英,俄,西,瑞典,德,捷)帕克; [gd]male;
Parkin: [a]/ˈpɑːrkɪn/; [n](Parkin)人名;(英,西,德)帕金; [gd]family;
Parkinson: [a]/'pa:kinsən/; [n]帕金森(姓氏);帕金森(全名詹姆士•帕金森,英国医生,帕金森症即以他的姓氏命名); [gd]family;
Parr: [a]/pɑː/; [n](Parr)人名;(英,法,德)帕尔; [gd]family;
Parra: [a]/ˈpærə/; [n](Parra)人名;(法,西,意,葡)帕拉; [gd]family;
Parton: [a]/'pɑːtɒn/; [n]部分子; [gd]family;
Pascal: [a]/ˈpæskl/; [n](Pascal) (法,罗)帕斯卡尔(人名); [gd]male;
Pasternak: [a]/'pæstənæk/; 苏联诗人及小说家;帕斯捷尔纳克 (姓氏); [gd]family;
Paterson: [a]/'pætəsn/; [n]帕特森(美国一座城市); [gd]family;
Patrick: [a]/'pætrɪk/; [n]帕特里克(男子名); [gd]male;
Patten: [a]/'pæt(ə)n/; [n](Patten) (美,加,澳)帕滕(人名); [gd]family;
Pau: [a]/pəu/; [n]波城(法国西南部城市,避寒胜地); [gd]family;
Paul: [a]/pɔ:l/; [n]保罗(男子名); [gd]male;
Paulin: [a]/'pɔ:lin/; [n](Paulin)人名;(西,意,匈,捷,芬,瑞典)保林;(法)保兰;(英)波林; [纺]防水帆布; [gd]family;
Pauling: [a]/'pɔ:liŋ/; [n]鲍林(美国化学家); [gd]family;
Paye: [a]/ˌpiː eɪ waɪ ˈiː/; abbr. (所得税的)发薪时扣除制(Pay As You Earn);开车入内付费(Pay As You Enter); [gd]family;
Payne: [a]/pein/; [n]佩恩(姓氏);佩恩(美国剧作家,演员); [gd]family;
Peacemaker: [a]/ˈpiːsmeɪkə(r)/; [n]调解者;和事佬; [gd]family;
Pearson: [a]/'pɪəsən/; [n]皮尔森(人名); [gd]family;
Peart: [a]/piət/; [n](美,爱)皮尔特(人名); [adj](peart) 有精神的,兴高采烈的; [gd]family;
Peers: [a]/pɪrs/; [n](Peers)人名;(英)皮尔斯; [gd]family;
Peon: [a]/ˈpiːən/; [n](Peon)人名;(俄,葡)佩翁; [gd]family;
Pepper: [a]/ˈpepə(r)/; [n](Pepper)人名;(英,德,意)佩珀; [vt]加胡椒粉于;使布满; [gd]family;
Perrier: [a]/'pɛrɪɛi/; [n]毕雷矿泉水(法国南部产的一种冒泡的矿泉水,商标名); [gd]family;
Perron: [a]/'perən/; [n](Perron)人名;(法,德,西,意,葡,瑞典)佩龙; [gd]family;
Perry: [a]/ˈperi/; [n]佩里(男子名); [gd]male;
Peter: [a]/ˈpiːtə(r)/; [n]彼得(男子名); [gd]male;
Peterman: [a]/'pi:təmən/; [n]彼特曼(姓氏); [gd]family;
Petrie: [a]/'pi:tri/; [n]皮特里(姓氏); [gd]family;
Philip: [a]/ˈfilip/; [n]菲利普(男子名); [gd]male;
Philips: [a]/'filips/; [n]飞利浦(荷兰公司名); [gd]family;
Phillip: [a]/'filəp/; [n]菲利普(人名);爱马的人; [gd]male;
Pickles: [a]/'pɪkl/; [n](Pickles)人名;(英)皮克尔斯; [vt]腌(pickle的第三人称单数); [gd]family;
Pierre: [a]/pi(:)'ɛə/; [n]皮埃尔(男子名); [gd]male;
Pilch: [a]/pɪltʃ/; [n]尿布垫; [gd]family;
Pintado: [a]/pɪn'tɑːdəʊ/; [n]大西洋马鲛(等于pintada); [gd]family;
Piper: [a]/ˈpaɪpə(r)/; [n](Piper)人名;(法,塞,瑞典)皮佩;(德,罗)皮珀;(英)派珀; [gd]female;
Pipit: [a]/ˈpɪpɪt/; [n]田云雀;鹡鸰; [gd]family;
Pippin: [a]/'pɪpɪn/; [n](Pippin)人名;(德)皮平; [gd]family;
Pitcher: [a]/ˈpɪtʃə(r)/; [n](Pitcher)人名;(英)皮彻; [gd]family;
Pitt: [a]/pit/; [n]皮特钻石(品牌名);皮特(姓氏,特指英国政治家父子威廉姆斯皮特); abbr. 匹兹堡(Pittsburgh); [gd]family;
Planting: [a]/ˈplɑːntɪŋ/; [n](Planting)人名;(芬,瑞典)普兰廷; [gd]family;
Plato: [a]/'pleitəu/; [n]柏拉图(古希腊哲学家); [gd]male;
Plotter: [a]/ˈplɒtə(r)/; [n]绘图机;阴谋者,策划者; [gd]family;
Plummer: [a]/'plʌmɚ/; [n](Plummer)人名;(英,德)普卢默; [gd]family;
Poe: [a]/'pəui/; abbr. 载货港(port of embarkation);进口港(port of entry); [n](Poe)人名;(英)波; [gd]family;
Polder: [a]/'pəʊldə/; [n](Polder)人名;(意)波尔德; [gd]family;
Poley: [a]/'pəʊlɪ/; [n](Poley)人名;(英)波利;(德)波莱; [gd]family;
Polk: [a]/pɔlk/; [n](Polk) (美)波尔克(人名); [gd]family;
Pollack: [a]/'pɒlək/; [n](Pollack)人名;(英,德,罗,瑞典)波拉克;(西)波利亚克; [gd]family;
Pols: [a]/pɑːl/; abbr. 油料(Petroleum, Oil and Lubricants);北极星导弹(Polaris); [n](Pol)人名;(法,西,俄,意,葡,荷,柬)波尔;(阿拉伯)布勒; [gd]family;
Poon: [a]/puːn/; [n](Poon)人名;(中)潘(广东话-威妥玛);(泰)鹏;(瑞典)蓬; [gd]family;
Popper: [a]/ˈpɒpə(r)/; [n](Popper) (美,英)波珀(人名); [gd]family;
Porter: [a]/ˈpɔːtə(r)/; [n](Porter)人名;(英,西,葡)波特;(德)波特; [gd]male;
Potter: [a]/ˈpɒtə(r)/; [n](Potter)人名;(英,荷,德,葡)波特; [vt]闲混,虚度; vi. 闲逛;慢条斯理地做事; [gd]family;
Pottle: [a]/'pɒt(ə)l/; [n]半加仑的酒;半加仑; [gd]family;
Powell: [a]/'pəuəl/; [n]鲍威尔(英国物理学家); [gd]male;
Prado: [a]/'prɑːdəʊ/; [n](Prado)人名;(英,法,德,西,意,葡,芬)普拉多; [gd]family;
Prang: [a]/præŋ/; v. (使)撞击,碰撞;(使飞机)坠毁; [n](Prang) (美,泰)普朗(人名); [gd]family;
Pratt: [a]/præt/; [n]普拉特(男子名); [gd]family;
Preece: [a]/pri'is/; [n]泼里斯(电阻率单位); [gd]family;
Prescott: [a]/'preskət/; [n]普莱斯考特(男子名,姓氏); [gd]male;
Preston: [a]/ˈprestən/; [n]普勒斯顿(男子名;英国港市名字); [gd]male;
Prints: [a]/prɪnt/; [n](Prints)人名;(俄)普林茨; [计]打印;报刊,印刷品;图片,相片;印花布(print的复数); v.; [印刷]印刷;出版;复制(print的三单形式); [gd]family;
Problems: [a]/'prɔ:bləmz/; [n] [数]问题;难题(problem的复数); [gd]family;
Production: [a]/prəˈdʌkʃn/; [n]成果;产品;生产;作品; [gd]family;
Prog: [a]/prɒg/; [n]食物;学监;掠夺得的食物; vi. 掠夺; [gd]family;
Projects: [a]/'prɑdʒɛkt/; [n]项目;工程(project的复数);企划; v. 计划;表达(project的第三人称单数);投射; [gd]family;
Pung: [a]/pʌŋ/; [n](Pung)人名;(柬)本;(德)蓬; [gd]family;
Purcell: [a]/'pə:sl/; [n]珀塞尔(姓氏); [gd]male;
Purchasing: [a]/ˈpɜːtʃəsɪŋ/; [n] [贸易]采购(purchase的ing形式);购买; [gd]family;
Pyron: [a]/'paiərɔn/; [n]派朗(辐射强度单位); [gd]family;
Quintero: [a]/kin'terəu/; [n]坤脱罗(智利一城市); [gd]family;
Quizmaster: [a]/ˈkwɪzmæstər/; [n](广播,电视)问答比赛主持人; [gd]family;
Racine: [a]/'rɑ'si:n/; [n]拉辛(姓氏); [gd]family;
Radcliffe: [a]/'rædklif/; [n]拉德克利夫(姓氏); [gd]male;
Rafter: [a]/ˈrɑːftə(r)/; [n]椽;筏夫(等于raftsman); [vt]装椽于; [gd]family;
Raker: [a]/'rekɚ/; [n]用耙子耙的人;耙地机; [gd]family;
Rama: [a]/'rɑ:mə/; [n]罗摩(印度教神名); [gd]family;
Raman: [a]/'ra:mən/; [n]拉曼(姓氏);拉曼(印度物理学家); [gd]family;
Ramee: [a]/'ræmi/; [n]苎麻,苎麻纤维; [gd]family;
Ramsay: [a]/'ræmzei/; [n]拉姆塞(姓氏); [gd]male;
Ramsey: [a]/'ræmzi/; [n]拉姆齐(人名); [gd]male;
Rance: [a]/ræns/; [n](Rance)人名;(英)兰斯; [gd]family;
Rand: [a]/rænd; rɑːnt/; [n](Rand)人名;(英,德,俄,瑞典)兰德; [gd]male;
Ranger: [a]/ˈreɪndʒə(r)/; [n](Ranger)人名;(英)兰杰;(法)朗热; [gd]family;
Raphael: [a]/'ræfeiəl; ,rɑ:fai'el/; [n]拉斐尔(姓氏);拉斐尔(意大利画家,建筑学家); [gd]male;
Receiving: [a]/rɪ'si:vɪŋ/; [n]接受; v. 收到;遭受;接受(治疗);承受;对..作出反应;接待;接纳;接收;购买(赃物);接(发球)(receive 的现在分词); [gd]family;
Records: [a]/'rekɔːdz/; [n](Records)人名;(英)雷科兹; [电子]唱片,档案(record的复数形式); v. 记录,记载(record的第三人称单数形式); [gd]family;
Recycling: [a]/ˌriːˈsaɪklɪŋ/; [n](资源,垃圾的)回收利用; v. 回收;再循环利用(recycle的现在分词); [gd]family;
Redfoot: [a]/ˈrɛdˌfʊt/; 红足症; 红脚病; [gd]family;
Register: [a]/ˈredʒɪstər/; [n](register) 登记;注册;记录;寄存器;登记簿; [gd]family;
Rego: [a]/ˈredʒoʊ/; [n](Rego)人名;(西,葡)雷戈; [gd]family;
Reich: [a]/raɪk/; [n]德国;德意志帝国; [gd]family;
Reilly: [a]/ˈraɪlɪ/; [n]赖利(姓氏); [gd]male;
Reimbursement: [a]/ˌriːɪmˈbɜːsmənt/; [n]退还,偿还;赔偿; [gd]family;
Relations: [a]/rɪ'leɪʃ(ə)nz/; [n]关系;交往;事务; [gd]family;
Reporting: [a]/rɪˈpɔːtɪŋ/; [n]报告;报导; [adj]报告的; [gd]family;
Reports: [a]/rɪˈpɔ:ts/; [n]报告;(统计)报表(report 的复数); v. 报告;传达;记录(report 的第三人称单数); [gd]family;
Research: [a]/rɪ'sɜːtʃ; 'riːsɜːtʃ/; [n]研究;调查; vi. 研究;调查; [vt]研究;调查; [gd]family;
Restore: [a]/rɪˈstɔː(r)/; [vt]恢复;修复;归还; vi. 恢复;还原; [gd]family;
Reuben: [a]/ˈruːbɪn/; [n]鲁宾(男子名);流便(圣经人物); [gd]male;
Reynolds: [a]/'renəldz/; [n]雷诺兹(姓氏); [gd]male;
Richard: [a]/'ritʃəd/; [n]理查德(男子名); [gd]male;
Richards: [a]/'ritʃədz/; [n]理查兹(姓氏); [gd]family;
Richardson: [a]/'ritʃədsən/; [n]理查森(姓氏); [gd]family;
Richmond: [a]/'ritʃmənd/; [n]里士满(美国弗吉尼亚首府); [gd]male;
Ricker: [a]/ˈrɪkə/; [n]雷克(男子名); [gd]family;
Rickey: [a]/'rɪkɪ/; [n](Rickey)人名;(英)里基; [gd]male;
Rider: [a]/ˈraɪdə(r)/; [n](Rider)人名;(英)赖德;(西)里德尔; [gd]family;
Ridgeway: [a]/'rɪdʒweɪ/; [n](Ridgeway)人名;(英)里奇韦; [gd]family;
Ridley: [a]/'rɪdlɪ/; [n](Ridley)人名;(英)里德利; [gd]family;
Riley: [a]/ˈraɪli/; [n](美)莱利(人名); [adj](riley) 生气的,激动的;浑浊的,污浊的; [gd]male;
Ritz: [a]/rɪts/; [n](Ritz)人名;(英,法,德,匈,西,捷)里茨; [gd]family;
Rivers: [a]/'rɪvəz/; [n]里弗斯(人名);河流州(尼日利亚州名);河水钻; [gd]family;
Roberts: [a]/'rɔbəts/; [n]罗伯茨(姓氏); [gd]family;
Robins: [a]/'rəubinz/; [n]罗宾斯(姓氏); [gd]family;
Robinson: [a]/'rɒbɪnsən/; [n]罗宾逊(男子名); [gd]male;
Robustness: [a]/rəʊˈbʌstnəs/; [n] [自]鲁棒性; [计]稳健性;健壮性; [gd]family;
Roger: [a]/ˈrɒdʒə(r)/; [n](Roger) (英,美,法)罗杰(人名); [gd]male;
Rogers: [a]/'rɔdʒəz/; [n]罗杰斯(姓氏);乐爵士(英国一家音箱生产厂); [gd]male;
Rok: [a]/rɔk/; abbr. 大韩民国,南朝鲜(Republic of Korea); [gd]family;
Rolland: [a]/rɔ:'lænd/; [n]罗兰(姓氏); [gd]male;
Roman: [a]/ˈrəʊmən/; [n]罗马人;古罗马语; [adj]罗马的;罗马人的; [gd]male;
Romano: [a]/rəʊˈmɑːnəʊ; rəˈmɑːnəʊ/; [n]罗马诺干酪(一种意大利浓味硬干酪,常磨碎作调味品用); [gd]family;
Rondeau: [a]/'rɒndəʊ/; [n](Rondeau)人名;(法,西)龙多; [gd]family;
Roots: [a]/ruːts/; [n](Roots)人名;(瑞典)罗茨;(英)鲁茨; [数] [植]根;根源(root的复数形式); v. 生根;扎根;连根拔起(root的三单形式); [gd]family;
Rosa: [a]/'roʊzə/; [n]罗莎(女子名); [gd]female;
Ross: [a]/rɒs/; [n]罗丝(女性名); [gd]male;
Rosser: [a]/'rɔsɚ/; [n]伐木工人; [gd]family;
Rouleau: [a]/'ruːləʊ; ruː'ləʊ/; [n](Rouleau)人名;(法)鲁洛; [gd]family;
Rousseau: [a]/'ru:səu/; [n]卢梭(法国启蒙思想家); [gd]family;
Routing: [a]/'ruːtɪŋ/; [n]路由选择;工艺路线;选择途径;(计算机网络间的)信息发送; v. 按指定路线发送;为..规定路线(route 的现在分词); [gd]family;
Rowan: [a]/ˈrəʊən; ˈraʊən/; [n](Rowan)人名;(英)罗恩; [gd]family;
Roy: [a]/rɔɪ/; [n]罗伊(男子名); [gd]male;
Royer: [a]/'rɔiə/; [n]罗耶(姓氏); [gd]family;
Ruck: [a]/rʌk/; [n](Ruck)人名;(德,匈,意,瑞典)鲁克;(英)拉克; [vt]弄皱; vi. 变皱; [gd]family;
Rudd: [a]/rʌd/; [n](Rudd)人名;(英)拉德;(德,捷)鲁德; [gd]male;
Ruddle: [a]/'rʌd(ə)l/; [n](用来给羊作记号的)代赭石,红土; v. 用红土(给羊)作记号; [gd]family;
Rundle: [a]/'rʌndl/; [n](Rundle)人名;(英)朗德尔;(德)伦德勒; [gd]family;
Running: [a]/ˈrʌnɪŋ/; [n](Running)人名;(英)朗宁; [adj]连续的;流动的;跑着的;运转着的; v. 跑;运转(run的ing形式);行驶; [gd]family;
Rupert: [a]/'ru:pət/; [n]鲁珀特(男子名); [gd]male;
Rushing: [a]/'rʌʃɪŋ/; [adj]急速流动的,飞奔的; [n](Rushing) (美)拉欣(人名); [gd]family;
Russell: [a]/'rʌsəl/; [n]拉塞尔(英国工程师,整流器发明人); [gd]male;
Ruth: [a]/ruːθ/; [n]露丝(女子名);路得;路得记; [gd]female;
Rutherford: [a]/'rʌðəfəd/; [n]卢瑟福(英国物理学家,化学家); [gd]male;
Rutland: [a]/'rʌtlənd(ʃiə(r))/; [n]拉特兰郡; [gd]family;
SHOP: [a]/ʃɒp/; [n]商店;店铺; [vt]购物; vi. 购物;买东西; [gd]family;
SMith: [a]/smɪθ/; [n]铁匠;锻工;制作者; [vt]锻制; vi. 锻打金属;当锻工; [gd]family;
SOS: [a]/ˌes əʊ ˈes/; [n]紧急求救信号; vi. 发出遇难信号; [gd]family;
SUPPORT: [a]/səˈpɔːt/; v. 支持;帮助;支撑;维持;证实;胜任;忍受;(尤指在财政方面)资助;(在流行音乐会上)当助演;安慰;(计算机)支持..的运行; [n]支持;帮助;支撑物;支撑;扶持;物质援助;安慰;(流行乐或摇滚音乐会的)伴奏;技术支持;证据;(战争中的)支援; [gd]family;
SYS: [a]/sɪs/; 待会儿见,是 see you soon 的网络缩略语; [gd]family;
Salem: [a]/ˈseɪləm/; [n]塞伦;礼拜堂; [gd]male;
Sales: [a]/selz/; [n](sales) 销售(sale的复数);销售额; [adj](sale) 销售的,售货的;有关销售的; [gd]family;
Sallee: [a]/'sæli/; [n]金合欢属植物; [gd]female;
Salter: [a]/'sɔːltə; 'sɒ-/; [n](Salter)人名;(英)索尔特;(罗)萨尔特; [gd]family;
Samson: [a]/'sæmsn/; [n]大力士;参孙; [gd]male;
Samuel: [a]/ˈsæmjuəl/; [n]撒母耳(希伯来先知);塞缪尔(男子名); [gd]male;
Sanders: [a]/'sɑːndəz; 'sæn-/; [n](Sanders)人名;(英)桑德斯(教名Alasdair,Alastair,Alexander,Alister,Elshender 的昵称);(英,法,德,西,荷,瑞典)桑德斯; [gd]male;
Sandrock: [a]/'sænd,rɑk/; [n]沙岩; [gd]family;
Sangha: [a]/'sæŋɡə/; [n](刚果)桑加地区;僧伽;僧宝; [gd]family;
Sanity: [a]/ˈsænəti/; [n]明智;头脑清楚;精神健全;通情达理; [gd]family;
Santiago: [a]/,sænti:'eiɡəu/; [n]圣地亚哥(智利首都); [gd]family;
Santos: [a]/'sa:ntu:s/; [n]桑托斯(巴西港口); [gd]family;
Saran: [a]/sə'ræn/; [n](Saran)人名;(法,意,俄,捷,印,柬,土)萨兰; [gd]family;
Sarin: [a]/ˈsɑːrɪn/; [n]萨林(姓氏); [gd]family;
Sartor: [a]/'sɑːtə/; [n](Sartor)人名;(意,法,德)萨尔托尔; [gd]family;
Saul: [a]/sɔ:l/; [n]索尔(男名); [gd]male;
Saunders: [a]/'sɔ:ndəz, 'sɑ:n-/; [n](Saunders)人名;(英,俄)桑德斯; [gd]male;
Sayer: [a]/'seiə/; [n](Sayer)人名;(西)萨耶尔;(英)塞耶;(阿拉伯,土)萨伊尔; [gd]male;
Scales: [a]/skeilz/; [n](Scales)人名;(英)斯凯尔斯; [gd]family;
Scarborough: [a]/'skɑr,bəro/; [n]士嘉堡(多伦多一区名);斯卡伯勒(英格兰一自治市); [gd]family;
Scarlett: [a]/'ska:lət/; [n]斯嘉丽(女子名或《飘》中的女主人公); [gd]female;
Scheduling: [a]/'ʃɛdʒʊəlɪŋ/; [n]时序安排,行程安排; v. 把.列入计划;为.制定时间表(schedule的现在分词); [gd]family;
Schiller: [a]/'ʃɪlə/; [n]席勒(姓氏,德国诗人及剧作家); [gd]family;
Schilling: [a]/ˈʃɪlɪŋ/; [n](Schilling)人名;(德,匈)席林; [gd]family;
Schmitt: [a]/ʃmit/; [n](Schmitt) (美)施密特(人名); [gd]family;
Schubert: [a]/'ʃu:bə:t/; [n]舒伯特(奥地利作曲家); [gd]family;
Schwartz: [a]/ʃwa:ts/; [n]施瓦兹(姓氏);史华兹(姓氏); [gd]family;
Schwarz: [a]/ʃwa:z/; [n](schwarz) 一圈所打(或赢)的牌; [gd]family;
Scott: [a]/skɒt/; [n]斯科特(男子名); [gd]male;
Screener: [a]/ˈskriːnə(r)/; [n]掩护队员;分级机,筛选器;筛分工;过滤网; [gd]family;
Security: [a]/sɪˈkjʊərəti/; [n]安全;保证;证券;抵押品; [adj]安全的;保安的;保密的; [gd]family;
Seeds: [a]/si:dz/; [n](Seeds)人名;(英)西兹; [gd]family;
Sei: [a]/seɪ/; [n](Sei) (美,日,新)塞(人名); [gd]family;
Selkirk: [a]/'selkə:k/; [n]塞尔扣克(山名,城市名); [gd]family;
Sellers: [a]/'sɛlɚ/; [n]塞勒斯(姓氏); [gd]family;
Services: [a]/'sə:visis/; [n]服务;服务项目(service复数形式); v. 服务(service的第三人称单数); [gd]family;
Shaddock: [a]/'ʃædək/; [n]文旦,柚子; [gd]family;
Shames: [a]/'ʃɑ:məs/; [n]西姆斯(人名); [gd]family;
Shan: [a]/ʃæn/; [n]掸人,掸族(居住在东南亚一带);掸邦(前缅甸联邦的成员国之一); [gd]family;
Shang: [a]/ʃæŋ/; [n]商(中国古朝代名); [gd]family;
Shannon: [a]/'ʃænən/; [n]香农; [gd]male;
Shapiro: [a]/ʃə'pirəu/; [n]夏皮罗(姓氏); [gd]family;
Shaver: [a]/ˈʃeɪvə(r)/; [n](Shaver)人名;(英)谢弗; [gd]family;
Shea: [a]/ʃiː; 'ʃiːə/; [n](Shea)人名;(英)谢伊; [gd]male;
Shearer: [a]/'ʃɪərə/; [n](Shearer)人名;(英)希勒; [gd]family;
Shears: [a]/ʃɪəz/; [n](Shears)人名;(英,塞拉)希尔斯; [gd]family;
Sheets: [a]/ʃit/; [n](Sheets)人名;(英)希茨; [材]片材,板片(sheet复数); [纺]被单; v. 覆盖(sheet的第三人称单数形式);使成大片;铺床单; [gd]family;
Sheffield: [a]/'ʃefi:ld/; [n]谢菲尔德(英国城市); [gd]male;
Sheikh: [a]/ʃeɪk,ʃiːk/; [n]族长;阿拉伯酋长(等于sheik); [gd]family;
Shelby: [a]/'ʃelbi/; [n]谢尔比(男子名); [gd]male;
Sheldon: [a]/'ʃeldən/; [n]谢尔登(男子名); [gd]male;
Shelley: [a]/'ʃeli/; [n]谢莉(女子名); [gd]male;
Shen: [a]/ʃen/; [n]沈(姓氏); [gd]family;
Shepard: [a]/'ʃepəd/; [n]谢泼德(人名); [gd]male;
Sherif: [a]/ʃe'riːf/; [n](Sherif)人名;(阿拉伯)谢里夫; [gd]family;
Shew: [a]/ʃəʊ/; v. (show 的旧式拼法)表明;展示;解说;指出;引领;体现;显示出;露出;描绘;上映;展出;收到成效;出现;替(动物)报名参加比赛;获得第三名;已显出身孕;对待(某人); [n](Shew)(美)休(人名); [gd]family;
Shiel: [a]/ʃiːl/; 希尔(人名); [n](Shiel)人名;(英)希尔; [gd]family;
Shields: [a]/'ʃild/; [n](Shields)人名;(英)希尔兹; [gd]family;
Shier: [a]/ˈʃaɪə/; 易受惊的马; [n](Shier)人名;(英)希尔; [gd]family;
Shingler: [a]/'ʃiŋɡlə/; [n]挤渣压力机;挤压操作工; [gd]family;
Shirley: [a]/'ʃɜ:lɪ/; [n]雪莉(女子名); [gd]female;
Shoemaker: [a]/ˈʃuːmeɪkə(r)/; [n](Shoemaker)人名;(英)休梅克; [gd]family;
Shu: [a]/,ɛs etʃ 'ju/; abbr. 上海大学(Shanghai University);辣味强弱程度(Scoville Heat Units); [n](Shu)人名;(缅)舒; [gd]family;
Shute: [a]/ʃu:t/; [n]舒特(姓氏); [gd]family;
Sides: [a]/saɪdz/; [n](Sides)人名;(英)塞兹; [gd]family;
Siemens: [a]/ˈsiːmənz/; [n]维尔纳-冯-西门子(Werner von Siemens)(1816—1892)世界著名的德国发明家,企业家,西门子公司创始人; [gd]family;
Silva: [a]/'silvə/; [n](Silva)人名;(德,俄,法,罗,塞,葡,瑞典,斯里,西,意,英)席尔瓦; [gd]female;
Sim: [a]/sɪm/; abbr. 用户身份识别卡 (subscriber identity module);电脑模拟游戏 (simulation); [n](Sim) (美,新,加)西姆(人名); [gd]male;
Simon: [a]/saɪmən/; [n]西蒙(男子名); [gd]male;
Sinclair: [a]/sin'klεə/; [n]辛克莱(男子名); [gd]male;
Singer: [a]/ˈsɪŋə(r)/; [n](Singer)人名;(英,德,瑞典,塞,罗,捷,葡,土)辛格;(法)桑热; [gd]family;
Singh: [a]/siŋ/; [n]辛格(印度总理);查理-拉杰(电影名); [gd]family;
Sitar: [a]/sɪˈtɑː(r); ˈsɪtɑː(r)/; [n](Sitar)人名;(塞)西塔尔; [gd]family;
Skelly: [a]/ˈskɛlɪ/; [n](Skelly)人名;(英)斯凯利; [gd]male;
Skene: [a]/'skiːnɪ/; [n]短剑的一种;弧拱; [gd]family;
Skerry: [a]/ˈskeri/; [n]礁;多岩石之小岛; [gd]family;
Skinner: [a]/ˈskɪnə(r)/; [n](Skinner)人名;(英)斯金纳;(瑞典)希纳; [gd]family;
Smit: [a]/smɪt/; abbr. 系统管理界面工具(System Management Interface Tool);钠离子-肌醇转运蛋白; [n](Smit)人名;(德,罗,俄,南非)斯米特; [gd]family;
Smothers: [a]/ˈsmʌðə(r)/; [vt]使窒息;抑制;(用灰等)闷熄;忍住; vi. 窒息;被抑制;闷死; [n]窒息状态;令人窒息的浓烟; [gd]family;
Snapper: [a]/ˈsnæpə(r)/; [n](Snapper)人名;(英)斯纳珀; [gd]family;
Snipes: [a]/snaɪp/; [n]狙击; [鸟]鹬;香烟屁股;被开玩笑的人物; vi. 狙击; [军]伏击;抨击;猎鸟;诽谤; [vt]狙击; [gd]family;
Soh: [a]/soʊ/; [n](Soh)人名;(东南亚国家华语)素;(朝)见 So; [gd]family;
Solomon: [a]/ˈsɒləmən/; [n]所罗门(男子名);所罗门(古以色列国王大卫之子,以智慧著称);大智者,聪明人; [gd]male;
Somerville: [a]/'sʌməvil/; [n]萨默维尔市(美国马萨诸塞州东部城市); [gd]family;
Sommer: [a]/ˈsɑːmər/; [n](Sommer)人名;(德)佐默;(英)萨默;(西)松梅尔; [建]地梁;凛条; [gd]family;
Sonne: [a]/'sɔni/; [n](Sonne)人名;(英)索恩;(德,芬)松内; [航] [水运]桑尼(相位控制的区域顺序旋转无线电指向标); [gd]family;
Soto: [a]/soto/; [n]索托(手表品牌); [gd]family;
Souther: [a]/'saʊðə/; [n]正南强风;南风; [gd]family;
Sparks: [a]/spɑrks/; [n](sparks) 电工; [gd]family;
Speaker: [a]/ˈspiːkə(r)/; [n](Speaker)人名;(英)斯皮克; [gd]family;
Spearman: [a]/'spɪəmən/; [n](Spearman)人名;(英)斯皮尔曼; [gd]family;
Spearpoint: [a]/'spɪəpɒɪnt/; [n]牙轮顶尖;矛头;先锋; [vt]作.的先锋;突击(等于spearhead); [gd]family;
Specs: [a]/speks/; abbr. 规格,说明书(specifications);眼镜(spectacles); [gd]family;
Speer: [a]/spiə/; v. (speer) 问询; [n](Speer) (美,荷)施佩尔(人名); [gd]family;
Spence: [a]/spens/; [n]思朋斯(男子名,等于Spencer); [gd]male;
Spencer: [a]/'spensə/; [n](Spencer) (美)斯盆塞(人名); [gd]male;
St: [a]/es ti:/; abbr. 标准时间(standard time);Shipping装货单(Shipping Ticket); [gd]family;
Stability: [a]/stəˈbɪləti/; [n]稳定性;坚定,恒心; [gd]family;
Staffing: [a]/ˈstɑːfɪŋ/; [n]安置职工; [gd]family;
Stamps: [a]/stæmps/; [n](Stamps)人名;(英)斯坦普斯; [邮]邮票;印记;图章(stamp的复数); v. 踩踏;镇压;贴邮票于.(stamp的第三人称单数); [gd]family;
Stanley: [a]/'stænli/; [n]斯坦利(男子名); [gd]male;
Staring: [a]/'steərɪŋ/; [adj]凝视的,目不转睛的;瞪着眼的;显眼的;怪俗气的;(头发)倒竖的; v. 凝视;盯着看;显眼,明摆在某人面前;目不转睛把..看得(stare 的现在分词); [n](Staring) (美,荷,瑞典,加)斯塔林(人名); [gd]family;
Starr: [a]/stɑ:/; [n]斯塔尔(姓氏); [gd]female;
Stars: [a]/stɑ:z/; [n]明星类,明星(star的复数形式); v. 点缀;成辐射状开裂;使担任主角(star的第三人称单数); abbr. specialized training and reassignment students 经过专门训练后再分配的学生;stationary automotive road stimulator (Toyota) 汽车公路固定刺激物(丰田汽车); [gd]family;
Stat: [a]/stæt/; [n]静;斯达(放射性强度单位); [gd]family;
Ste: [a]/,es ti: 'i:/; abbr. 专用测试设备(Special Test Equipment);(英)电信工程师学会(Society of Telecommunications Engineers);适合配性试验的鉴定(Suitability Test Evaluation); [gd]family;
Steelman: [a]/'sti:lmæn/; [n]斯蒂尔曼(男子名或姓氏); [gd]family;
Steen: [a]/stɪən; stiːn/; [n](Steen) (丹)斯蒂恩(人名); [gd]family;
Stephen: [a]/'stivən/; [n]斯蒂芬(男子名); [gd]male;
Stewart: [a]/'stjuət/; [n] [宝]斯图尔特(男子名); [gd]male;
Stirling: [a]/'stə:liŋ/; [n]斯特灵(英国苏格兰中部城市,中央区首府); [gd]male;
Stocker: [a]/'stɒkə/; [n](Stocker)人名;(英)斯托克;(德,匈)施托克尔; [gd]family;
Stocks: [a]/stɔks/; [n](Stocks)人名;(英)斯托克斯;(德)施托克斯; [金融]股票; [贸易]存货;库存量(stock的复数); v. 采购;有.的存货;贮存(stock的第三人称单数); [gd]family;
Stokes: [a]/stəuks/; [n]斯托克斯(姓氏); [gd]family;
Stoner: [a]/'stonɚ/; [n](Stoner) (美)斯托纳(人名); [gd]family;
Storey: [a]/ˈstɔːri/; [n](Storey)人名;(西,瑞典)斯托雷;(英)斯托里; [建]楼层;叠架的一层; [gd]female;
Stover: [a]/'stəʊvə/; [n](Stover)人名;(英)斯托弗;(法)斯托韦; [gd]family;
Stowe: [a]/stəu/; [n]斯陀园(英国的园林名字);斯托(地名,滑雪胜地);史杜威(姓氏); [gd]family;
Strauss: [a]/straʊs/; [n]施特劳斯(奥国作曲家); [gd]family;
Strider: [a]/'straidə/; [n]出击飞龙(游戏名); [gd]family;
Stroud: [a]/straud/; [n](Stroud)人名;(英)斯特劳德; [gd]family;
Stuart: [a]/'stjʊt/; [n]英国斯图亚特王室;斯图尔特(男子名,等于Stewart); [gd]male;
Su: [a]/,es 'ju:/; abbr. (SU) 锶单位 (strontium unit); [n](Su) (中,土)苏(人名); [gd]family;
Sudan: [a]/suˈdɑːn; suˈdæn/; [n]苏丹(非洲国家); [gd]family;
Sudbury: [a]/sʌdbəri/; [n]萨德伯里(加拿大安大略省南部城市); [gd]family;
Summers: [a]/'sʌməz/; [n]萨莫斯(人名); [gd]family;
Sumpter: [a]/'sʌm(p)tə/; [n]驮畜;赶驮马的人;拉货车的马或驴子; [gd]family;
Supervisor: [a]/ˈsuːpəvaɪzə(r); ˈsjuːpəvaɪzə(r)/; [n]监督人,; [管理]管理人;检查员; [gd]family;
Sura: [a]/ˈsʊərə/; [n](Sura)人名;(意,英,西,罗,捷)苏拉; [解剖]腓肠; [gd]family;
Sutherland: [a]/'sʌðələnd/; [n]萨瑟兰郡(英国苏格兰原郡名);萨瑟兰; [gd]male;
Sweeney: [a]/'swi:ni/; [n]斯威尼(男子名); [gd]family;
Swinks: [a]/swɪŋk/; [n](Swink)人名;(英)斯温克; [vt]使劳累;使工作过度; [gd]family;
Switching: [a]/'swɪtʃɪŋ/; [n] [电]开关;转换;整流;配电; v. 转换(switch的ing形式); [gd]family;
Switzer: [a]/'switsə/; [n]瑞士人; [gd]family;
Sy: [a]/sai/; abbr. 平方码(square yard);石油天然气行业标准;叙利亚(Syria);苏丹黄(Sudan yellow); [n](Sy)人名;(越)士;(阿拉伯,老,柬,法)西; [gd]family;
Sylvester: [a]/sil'vestə/; [n]西尔威斯特(美国城市名); [gd]male;
Systems: [a]/'sɪstəm/; [n]系统;体制,体系;制度(system 的复数); [gd]family;
TRIAL: [a]/ˈtraɪəl/; [n](Trial)人名;(法)特里亚尔; [adj]试验的;审讯的; [gd]family;
Ta: [a]/tɑː/; abbr. 助教(teaching assistant);正切角(Tangent Angle);顶部攻击(Top Attack);技术援助(technical assistance);公差表; [gd]family;
Tabor: [a]/ˈteɪbər/; [n]塔博尔(捷克古城); [gd]male;
Tac: [a]/,ti e 'si/; abbr. 战术空军司令部(Tactical Air Command); [n](Tac)人名;(柬)达; [gd]family;
Tai: [a]/taɪ/; [n](Tai) (美,加,马)塔伊(人名); [gd]family;
Talbot: [a]/'tɔlbət/; [n](Talbot)人名;(英,德,意)塔尔博特;(西)塔尔沃特; [gd]male;
Tanner: [a]/ˈtænə(r)/; [n](Tanner)人名;(英,德,芬,瑞典)坦纳; [gd]male;
Taranto: [a]/tə'ræntəu; 'tɑ:rɑ:ntɔ:/; [n]塔兰托(意大利东南部城市名); [gd]family;
Tatar: [a]/'tɑ:tə/; [n]鞑靼人(等于Tartar); [gd]family;
Taverner: [a]/'tævənə/; [n]酒店老板;经常光顾酒店的人; [gd]family;
Tay: [a]/tei/; [n]泰河(北海的港湾,位于英国苏格兰中部);茶(爱尔兰方言,等于tea); [gd]family;
Taylor: [a]/'teɪlə/; [n]泰勒; [gd]male;
Td: [a]/ˌtiː ˈdiː/; abbr. (美)财政部(Treasury Department);任务说明书(Task Description);反坦克自行火炮(Tank Destroyer); [gd]family;
Teacher: [a]/ˈtiːtʃə(r)/; [n](Teacher)人名;(英)蒂彻; [gd]family;
Tel: [a]/tɛl/; abbr. 试验仪器清单(Test Equipment List); [n](Tel)人名;(土)泰尔;(阿拉伯)塔勒; [gd]family;
Telco: [a]/ˈtelkoʊ/; abbr. 电话公司(telephone central office); [gd]family;
Telecom: [a]/ˈtɛlɪˌkɒm/; [n]电信,远距通信;电讯; [gd]family;
Telesis: [a]/'telɪsɪs/; [n]目的性利用; [gd]family;
Telex: [a]/ˈteleks/; [n]电传;电传机;用户直通电报; [vt]用电传拍发;用直通电报拍发; vi. 发电传;拍发直通电报; [gd]family;
Telfer: [a]/'telfə/; [n](Telfer) (美)特尔弗(人名); [gd]family;
Telos: [a]/'telɒs/; [n]目的;终极; [gd]family;
Temp: [a]/temp/; [n]临时雇员; [vt]做临时工作; abbr. 温度(temperature); [gd]male;
Teran: [a]/tə'ræŋ/; [n]特朗红葡萄酒(南斯拉夫产红葡萄酒); [gd]family;
Terminals: [a]/'tɝmənl/; [n] [计]终端;终端机; [电]接线端子;终止节点(terminal的复数); [gd]family;
Terrell: [a]/'terəl/; [n]特勒尔(姓氏, 男子名); [gd]male;
Testa: [a]/'testə/; [n](Testa)人名;(意,法)泰斯塔;(英,西,葡,塞舌)特斯塔; [植]外种皮;介壳,甲壳; [gd]family;
Tester: [a]/ˈtestə(r)/; [n](Tester)人名;(英)特斯特; [gd]family;
Testing: [a]/ˈtestɪŋ/; [n] [试验]测试; [adj]试验的;棘手的; v. 测验;考查;受考验(test的ing形式); [gd]family;
Thames: [a]/temz/; [n](伦敦的)泰晤士河; [gd]family;
Thill: [a]/θɪl/; [n]车把;辕; [gd]family;
Thomas: [a]/'tɒməs/; [n]托马斯(男子名);多马(耶稣十二门徒之一); [gd]male;
Thompson: [a]/'tɔmpsn/; [n]汤普森(姓); [gd]family;
Thomson: [a]/'tɒmsən/; [n]汤姆森(①姓氏 ②Sir George Paget, 1892-1975, 英国物理学家, 曾获1937年诺贝尔物理学奖 ③Sir Joseph John, 1856-1940, 英国物理学家, 曾获1906年诺贝尔物理学奖); [gd]family;
Thorpe: [a]/θɔ:p/; [n](Thorpe)人名;(瑞典)托珀;(英)索普; [gd]male;
Threader: [a]/'θredə/; [n]螺丝车床;穿线器; [gd]family;
Tiller: [a]/ˈtɪlə(r)/; [n](Tiller)人名;(英,德,捷)蒂勒; [船]舵柄;农夫; vi. 分蘖; [gd]family;
Ting: [a]/tɪŋ/; [n](Ting)(西,美)廷(人名); [gd]family;
Tipping: [a]/tɪpɪŋ/; [n](Tipping) (美)蒂平(人名); [gd]family;
Titus: [a]/'taitəs/; [n]提图斯(古罗马皇帝);《提多书》(《圣经》的一卷); [gd]male;
Tiu: [a]/'ti:u/; [n]蒂乌(日耳曼神话里的战神和天神); [gd]family;
Tod: [a]/tɑːd/; [n]托德(男子名); [gd]male;
Tolar: [a]/tɔlɑ:/; [n]托拉尔(斯洛文尼亚货币单位); [gd]family;
Tom: [a]/tɒm/; [n]汤姆(男子名); [gd]male;
Toolroom: [a]/'tuːlruːm/; [n]工具间;工具室; [gd]family;
Tools: [a]/tuːlz/; [n] [机]工具,工具菜单;工具箱(tool的复数形式); v. 用工具加工.(tool的第三人称单数形式); [gd]family;
Toolset: [a]/ˈtuːlˌsɛt/; [n](计)软件工具集; [gd]family;
Towers: [a]/'tauəz/; [n](Towers)人名;(英)托尔斯; [建]塔;塔器;空中跳台(tower的复数); [gd]family;
Towns: [a]/taʊnz/; [n]汤斯; [gd]family;
Trader: [a]/ˈtreɪdə(r)/; [n](Trader)人名;(英)特雷德; [gd]family;
Trainer: [a]/ˈtreɪnə(r)/; [n](Trainer)人名;(英,德)特雷纳; [gd]family;
Training: [a]/ˈtreɪnɪŋ/; [n]训练;培养;瞄准;整枝; v. 训练;教养(train的ing形式); [gd]family;
Trame: [a]/træm/; [n](Trame)人名;(意)特拉梅; [gd]family;
Translations: [a]/træns'leʃən/; [n] [语] [计]翻译(translation的复数形式);译文; [gd]family;
Treen: [a]/triːn/; [n]全部木造器具; [adj]全部木造的; [gd]family;
Trent: [a]/trent/; [n]特伦特(男子名);特伦托河(英格兰中部河流); [gd]male;
Trinidad: [a]/'trɪnɪ,dæd/; [n]特立尼达拉岛; [gd]family;
Trotsky: [a]/'trɔtski/; [n]托洛茨基(前苏联托洛茨基集团领袖,后被开除出党); [gd]family;
Trotter: [a]/ˈtrɑːtər/; 特罗特(人名); [gd]family;
Trowbridge: [a]/'trəubridʒ/; [n]特洛布里治(英国英格兰南部城镇); [gd]family;
Truelove: [a]/'truːlʌv/; [n]爱人;轮叶王孙(白檀科的矮树);纯爱; [gd]family;
Trull: [a]/trʌl/; [n](Trull)人名;(英)特鲁尔; [gd]family;
Tu: [a]/,ti: 'ju:/; [n](Tu) (老挝)杜(人名); [gd]family;
Tuan: [a]/tu:'ɑ:n; tu-/; [n](马来语)先生;(马来语)老爷; [gd]family;
Tucker: [a]/ˈtʌkə(r)/; [n](Tucker)人名;(英,塞拉)塔克;(匈)图克; [vt]使.疲倦;使.衰弱; [gd]male;
Turner: [a]/'tɜːnə/; [n]特纳(姓氏); [gd]male;
Twa: [a]/twɑ:/; abbr. (美)环球航空公司(Trans World Airlines); [n](苏格兰)两个(等于two); [gd]family;
Twx: [a]/twiks/; abbr. 电传打字电报台(Teletype Writer Exchange); [gd]family;
Tye: [a]/tai/; [n](Tye)人名;(英)泰伊; [gd]male;
Typer: [a]/'taipə/; [n] [印刷]打字员; [gd]family;
US: [a]/əs,ʌs/; 美国; [gd]family;
USER: [a]/ˈjuːzə(r)/; [n](User)人名;(土)乌塞尔; [gd]family;
Underwood: [a]/'ʌndəwʊd/; [n](Underwood)人名;(英,意)安德伍德; [林]林下灌丛;丛林(等于underbrush); [gd]family;
Unix: [a]/'jʊnɪks/; [n](Unix) (印)尤尼斯(人名); [gd]family;
User: [a]/ˈjuːzər/; [n](美,印,俄,澳,巴,土)乌塞尔(人名); [gd]family;
VO: [a]/,vi 'o/; abbr. 口头命令(Verbal Order); [gd]family;
Valdez: [a]/væl'di:z/; [n]瓦尔迪兹(美国阿拉斯加州城市); [gd]family;
Varia: [a]/'veərɪə/; [n]杂物;杂文集(尤指文学作品); [gd]family;
Vaughn: [a]/vɔ:n/; [n]沃恩(姓氏); [gd]male;
Vega: [a]/ˈviːɡə/; [n] [天]织女星; [gd]family;
Vela: [a]/'viːlə/; [n] [天]船帆座(南天星座名); [gd]family;
Vetter: [a]/'vetə/; [n](Vetter)人名;(英,法,瑞典,匈,捷)维特尔;(德)费特尔; [gd]family;
Vincent: [a]/'vɪnsnt/; [n]文森特(男名); [gd]male;
Vivian: [a]/vɪvɪən/; [n]维维安(女子名); [gd]female;
Vo: [a]/,vi 'o/; abbr. 口头命令(Verbal Order); [gd]family;
Volk: [a]/fɔ:lk/; [n](德)人民;民族; [gd]family;
Vowels: [a]/'vaʊəlz/; [n]元音(vowel 的复数); [gd]family;
WAR: [a]/wɔː(r)/; [n]战争,斗争;军事,战术;冲突,对抗,竞争; vi. 打仗,作战;对抗; [gd]family;
Wa: [a]/wɑ/; abbr. 华盛顿州(Washington State);担保单独海损(with average); [n](Wa)人名;(肯,柬,缅,刚(金))瓦; [gd]family;
Wacker: [a]/ˈwækə/; [n]瓦克尔(人名); [gd]family;
Wada: [a]/ˈvɑːdə/; abbr. 世界反兴奋剂机构 (World Anti-Doping Agency); [n](Wada) (美,日)瓦达(人名); [gd]family;
Wager: [a]/ˈweɪdʒə(r)/; [n](Wager)人名;(英)韦杰;(芬,瑞典)瓦格; [vt]下赌注; [gd]family;
Waggoner: [a]/'wægənɚ/; [n]御夫座; [gd]family;
Wagner: [a]/'wa:gnə/; [n]瓦格纳(姓氏);瓦格纳(德国歌剧家,作曲家); [gd]family;
Wagoner: [a]/'wæg(ə)nə/; [n](Wagoner)人名;(英)瓦戈纳; [gd]family;
Wai: [a]/ˈwɑːiː/; [n](Wai) (美)韦(人名); [gd]family;
Wainwright: [a]/'weɪnraɪt/; [n](Wainwright)人名;(英)温赖特; [gd]male;
Wales: [a]/weɪlz/; [n]威尔士(英国大不列颠岛西南部地区); [gd]family;
Walker: [a]/ˈwɔːkə(r)/; [n](Walker)人名;(德,西,芬,瑞典)瓦尔克;(英)沃克; [gd]male;
Wallace: [a]/ˈwɒlɪs/; [n]华莱士(男子名); [gd]male;
Waller: [a]/'wɔlə/; [n]沃勒(人名); [gd]family;
Wallis: [a]/'vɑ:lis/; [n]沃利斯(姓氏); [gd]male;
Walsh: [a]/wɔ:lʃ/; [n]沃尔什(姓氏); [gd]male;
Walton: [a]/'wɔ:ltən/; [n]沃尔顿(男子姓氏); [gd]male;
Wang: [a]/wang/; [n]王(姓氏);王安电脑公司; [gd]male;
Wares: [a]/wɛəz/; [n](Wares)人名;(英)韦尔斯; [贸易]商品;货物; [gd]family;
Wark: [a]/wɔːrk/; [n]华克; [gd]family;
Warner: [a]/'wɔ:nə/; [n](Warner)人名;(英)沃纳;(德,瑞典)瓦尔纳; [gd]male;
Washington: [a]/ˈwɒʃɪŋtən/; [n]华盛顿(美国州名,美国城市名,美国第一任总统,姓氏); [gd]male;
Watchmaker: [a]/ˈwɒtʃmeɪkə(r)/; [n]钟表匠;表的制造人; [gd]family;
Waterman: [a]/'wɔtəmən/; [n]华特曼(名笔品牌); [gd]family;
Waters: [a]/'wɔtɚ/; [n]沃特斯(姓氏); [gd]family;
Watts: [a]/wɔts/; [n]瓦特(功率单位); [gd]family;
Weatherly: [a]/'weðəlɪ/; [adj]能抢风航行的;能驶向上风的; [gd]family;
Weaver: [a]/ˈwiːvə(r)/; [n](Weaver)人名;(英)韦弗; [gd]family;
Webster: [a]/'wɛbstɚ/; [n]韦伯斯特(姓氏或男子名); [gd]male;
Weiss: [a]/wais/; [n](Weiss)人名;(法,德,西,葡,罗,匈,以,瑞典,捷)魏斯;(英)韦斯; [gd]family;
Welch: [a]/weltʃ; welʃ/; [n]韦尔奇(姓氏); [gd]male;
Wells: [a]/wɛlz/; [n]威尔斯(姓氏); [gd]male;
Wen: [a]/wen/; [n](Wen)人名;(英)温; [医]皮脂囊肿;人口集中的大城市; [gd]family;
Werewolf: [a]/ˈweəwʊlf/; [n]狼人;凶人;残忍狡诈的人; [gd]family;
Wester: [a]/'westə/; [n](Wester)人名;(英,德,匈,芬,瑞典)韦斯特; [gd]family;
Weston: [a]/'westən/; [n]韦斯顿标准电池;韦斯顿(姓氏); [gd]male;
Whang: [a]/wæŋ/; [vt]重击;鞭打;使劲工作; vi. 发出重击声;使劲地打击;切成厚大的块; [n]皮鞭;用力的一击;制皮带的皮革(等于whang leather);一大块; [gd]family;
Wheeler: [a]/'wiːlə/; [n](Wheeler)人名;(英,葡,法,瑞典)惠勒; [gd]male;
Whited: [a]/'hwaɪtɪd/; [adj]漂白的;弄白的; v. 使变白色;涂白(white 的过去式和过去分词); [gd]family;
Whiting: [a]/ˈwaɪtɪŋ/; [n](Whiting)人名;(英)怀廷; [gd]family;
Whitman: [a]/'(h)witmən/; [n]惠特曼(姓氏); [gd]male;
Whitney: [a]/'wɪtnɪ/; [n]惠特尼(女子名);惠特尼山(位于美国加利福尼亚州东部); [gd]male;
Whitworth: [a]/'witwə:θ/; [n]惠氏;惠特沃思(姓氏); [gd]family;
Wieland: [a]/'wiə'lænd/; [n]维兰德(姓氏);维兰德(Heinrich,1877-1957,德国化学家,曾获1927年诺贝尔化学奖); [gd]family;
Wight: [a]/waɪt/; [n](Wight)人名;(英)怀特; [gd]family;
Wilde: [a]/waild/; [n]王尔德(姓氏); [gd]family;
Wilder: [a]/ˈwɪldə/; [n]怀尔德(姓氏); [gd]family;
Wilkes: [a]/wilks/; [n]威尔克斯(南极洲地名); [gd]family;
Wilkinson: [a]/'wilkinsn/; [n]威尔金森(姓氏); [gd]family;
Willets: [a]/'wɪlɪt/; [n](Willet)人名;(英)威利特; [gd]family;
Williams: [a]/'wɪljəmz/; [n]威廉姆斯(男子名); [gd]family;
Wilson: [a]/'wɪlsən/; [n]威尔逊(姓氏); [gd]male;
Wilton: [a]/'wiltən/; [n]威尔顿机织绒头地毯;威尔顿(男子名); [gd]male;
Winchester: [a]/ˈwɪntʃɪstə(r)/; [n]温彻斯特(英格兰南部城市); [gd]family;
Windsor: [a]/ˈwɪnzə(r)/; [n]温莎(地名,伦敦西方的城市); [gd]family;
Winnipeg: [a]/ˈwɪnɪpeɡ/; [n]温尼伯(加拿大城市); [gd]family;
Witt: [a]/wit/; [n]威特(男子名); [gd]family;
Wolfe: [a]/wulf/; [n]乌尔夫(姓氏,男子名); [gd]family;
Woodman: [a]/ˈwʊdmən/; [n](Woodman)人名;(英)伍德曼; [gd]male;
Woods: [a]/wʊdz/; [n](Woods) (美,加,英)伍兹(人名); [gd]family;
Woodward: [a]/'wʊdwɚd/; [n]伍德沃(姓氏,美国化学家); [gd]family;
Wrigley: [a]/'rigli:/; [n]箭牌(口香糖品牌); [gd]family;
Wu: [a]/wuː/; abbr. 西联(Western Union);工作单位(Work Unit);武汉航空公司; [gd]family;
Wye: [a]/waɪ/; [n](Wye)人名;(英)怀; [gd]male;
Xu: [a]/suː/; [n]分(越南的货币单位,100分等于1盾); [gd]family;
Yan: [a]/jæn/; [n](Yan)人名;(中)扬(普通话-威妥玛);(俄,西,缅,柬,吉尔)扬; [gd]family;
Yao: [a]/jaʊ/; [n]尧(传说中的中国古代父糸氏族社会后期部落联盟领袖); [gd]family;
Yeh: [a]/je/; int. 是的;对(等于 yeah); pro; [n](Yeh) (美)叶(人名); [gd]family;
Ying: [a]/ˈjɪŋ/; 营; [n](Ying)人名;(缅,泰)英;(中)应(普通话-威妥玛); [gd]family;
York: [a]/jɔːk/; [n]约克郡;约克王朝; [gd]family;
Younger: [a]/'jʌŋɡə/; [adj]更年轻的,年纪更小的;更未成熟的,更没经验的;更年轻人似的,更朝气的;小..(用于称呼与父母同名的年纪较小者);平民地主产业的继承人的; [n](Younger) (美)扬格(人名); [gd]family;
Yu: [a]/ju/; [n]禹(传说的中国古代圣君); [gd]family;
Yuan: [a]/juˈɑːn/; [n]元朝; [gd]family;
Yue: [a]/juˈeɪ/; [n]粤语,广东话;广东人; [adj]粤语的;广东人的;与广州..有关的; [gd]family;
Yum: [a]/jʌm/; int. (表示味道或气味好)嗯; [n](Yum) (美)鑫(人名); [gd]family;
Zacharias: [a]/,zækə'raiəs/; [n]撒迦利亚;扎卡赖亚斯;殉道者撒迦利亚; [gd]male;
Zander: [a]/'zændə/; [n](Zander)人名;(德)灿德尔;(西,瑞典)桑德尔;(英,俄)赞德; [鱼]梭鲈(等于Stizostedion lucioperca); [gd]family;
Zee: [a]/ziː/; [n](Zee)人名;(中)徐(广东话-威妥玛); [gd]family;
Zen: [a]/zen/; [n](Zen)人名;(意,索,纳米,印尼,英)泽恩; [gd]family;
Zhao: [a]/'dʒaʊ/; [n]赵(姓氏); [gd]family;
Zhou: [a]/dʒəu/; [n]周(中国姓氏);周朝(中国古代王朝); [gd]family;
Ziegler: [a]/'zi:ɡlə/; [n]齐格勒(德语人名);捷格罗白葡萄酒; [gd]family;
Zimmer: [a]/'zɪmɚ/; [n]齐默(商标名),年老,体 弱者使用的助行金属架; [gd]family;
cprs: [a]/ˌsiːpiːˈɑː/; abbr. 综合精神病理学分级量表(comprehensive psychopathological rating scale); [gd]family;
Aaron: [a]/'ɛrən/; [n]亚伦(男子名);亚伦(摩西之兄,犹太教的第一祭司长); [gd]male;
Abbey: [a]/ˈæbi/; [n](Abbey)人名;(法)阿贝;(英)阿比(教名Abigail的昵称); [gd]male;
Abbot: [a]/ˈæbət/; [n]阿博特(男子名,等于Abbott); [gd]male;
Abelard: [a]/'æbə,la:d/; [n]阿伯拉德(法国哲学家,神学家); [gd]male;
Abner: [a]/'æbnə/; [n]艾伯纳(男子名); [gd]male;
Ace: [a]/eɪs/; [n](Ace)人名;(英)埃斯; [adj]一流的,突出的; [vt]以发球赢一分;击败; int. 太棒了;太好了; [gd]male;
Agamemnon: [a]/,æɡə'memnən/; [n]阿伽门农(特洛伊战争中希腊军队的统帅); [gd]male;
Alec: [a]/ˈælɪk/; [n]亚历克(男子名); [gd]male;
Aleck: [a]/ˈælɪk/; [n]亚力克(男子名); [gd]male;
Alex: [a]/'ælɪks/; [n]亚历克斯(男子名); [gd]male;
Alexis: [a]/ə'leksis/; [n]亚历克西斯(男子名); [gd]male;
Alf: [a]/ælf/; [n]阿尔夫(男子名)(Alfred的昵称); [gd]male;
Allah: [a]/ˈælə; əˈlɑː/; [n]阿拉;真主; [gd]male;
Alley: [a]/ˈæli/; [n](Alley)人名;(英)阿利; [gd]male;
Alvin: [a]/'ælvin/; [n](Alvin)人名;(俄,葡,瑞典)阿尔温;(英)阿尔文; [gd]male;
Amadeus: [a]/a'madiəs/; [n]莫扎特(奥地利作曲家);莫扎特传(电影名);阿玛迪斯(唱片公司品牌); [gd]male;
Angel: [a]/ˈeɪndʒl/; [n](Angel)人名;(德,塞,俄,保,瑞典,挪)安格尔;(土)安盖尔;(法,葡)安热尔;(西)安赫尔;(英,罗)安杰尔; [vt]出钱支持; [gd]male;
Anselm: [a]/'ænselm/; [n]安塞姆(男子名,等于Ansel); [gd]male;
Antoine: [a]/æn'twɑ:n/; [n]安托万(男子名,Anthony的异体); [gd]male;
Apollo: [a]/ə'pɒləʊ/; [n]阿波罗(太阳神);美男子; [gd]male;
Archie: [a]/'ɑ:tʃi/; [n]阿奇(男子名);档案检索系统; [gd]male;
Archon: [a]/'ɑːkən/; [n]执政官(古代雅典九名统治者之一);统治者; [gd]male;
Archy: [a]/'ɑ:tʃi/; [n](Archy) (美)阿奇(人名); [gd]male;
Ariel: [a]/'eərɪəl/; [n](Ariel)人名;(英)阿里尔;(法)阿里埃尔;(西)阿列尔;(俄)阿里耶尔;(以)阿里埃勒; [gd]male;
Aristotle: [a]/'æristɔtl/; [n]亚里士多德; [gd]male;
Art: [a]/ɑːt/; [n](Art)人名;(泰,柬)阿;(英)阿特; [adj]艺术的;艺术品的; v. 是(be的变体); [gd]male;
Ash: [a]/æʃ/; [n](Ash) (英,美)阿什(人名); [gd]male;
August: [a]/ɔːˈɡʌst/; [n](美,德,英,波)奥古斯特(人名); [adj](august) 威严的,令人敬畏的; [gd]male;
Augustine: [a]/'ɔɡəstin/; [n]奥古斯汀(男子名); [gd]male;
Augustus: [a]/ɔ:'gʌstəs/; [n]奥古斯都(男子名); [gd]male;
Austen: [a]/'ɔstin/; [n](Austen)人名;(英)奥斯汀;(德)奥斯滕; [gd]male;
Ave: [a]/'ɑ:vi/; abbr. 途径;林荫大道;大街(avenue); [gd]male;
Axel: [a]/ˈæksl/; [n](Axel)人名;(瑞典)阿克塞尔;(英,西,德,捷,芬,丹,挪)阿克塞尔;(葡)阿谢尔; [gd]male;
Baily: [a]/ˈbeɪlɪ/; 贝利(人名); [gd]male;
Bard: [a]/bɑːd/; [n](Bard)人名;(瑞典,英)巴德;(法)巴尔;(阿拉伯,德,俄)巴尔德; [gd]male;
Barn: [a]/bɑːn/; [n]谷仓;畜棚;车库;靶(核反应截面单位); [vt]把.贮存入仓; [gd]male;
Barnabas: [a]/'bɑ:nəbəs/; [n]巴拿巴,巴纳巴斯;先知; [gd]male;
Barney: [a]/ˈbɑːni/; [n](Barney)人名;(法)巴内;(英,西)巴尼; [gd]male;
Baron: [a]/ˈbærən/; [n](Baron)人名;(英,汤)巴伦;(匈)鲍龙;(法,俄,德,意,捷,荷,罗,以,瑞典,印尼)巴龙; [gd]male;
Barret: [a]/'bærɪt/; [n](Barret)人名;(英)巴雷特; [gd]male;
Barrie: [a]/'bæri/; 巴里; [gd]male;
Barth: [a]/ba:θ/; [n]巴斯(姓氏);巴斯(德国地名); [gd]male;
Basil: [a]/ˈbæzl/; [n]巴兹尔(男子名); [gd]male;
Bay: [a]/beɪ/; [n](Bay)人名;(越)七;(英,老)贝;(德,意,罗,捷,土,丹)巴伊;(匈)鲍伊;(瑞典)巴伊; [vt]向.吠叫; vi. 吠叫;大声叫嚷; [gd]male;
Bayard: [a]/'beɚd/; [n]勇武异常的人; [gd]male;
Bear: [a]/ber/; [n](bear) 熊;熊科;玩具熊;没教养的人;行动迟缓的人;(年龄较大,身材魁梧且多毛的)同性恋男人;(股市中)卖空的人;警察; [gd]male;
Beau: [a]/bəʊ/; [n](Beau)人名;(英,德,法,葡)博; [adj]美的;好的; [gd]male;
Beaufort: [a]/'bəufət/; [n]蒲福(姓氏); [gd]male;
Beck: [a]/bek/; [n](Beck)人名;(英,法,德,西,葡,罗,捷,芬,丹,瑞典)贝克; [gd]male;
Ben: [a]/bɛn/; [n]本(男子名);(苏格兰)内室; [gd]male;
Benedict: [a]/'benɪ,dɪkt/; [n]本尼迪克特(男子名); [gd]male;
Bennet: [a]/'benɪt/; [n](Bennet)人名;(法)贝内;(瑞典)贝内特; [gd]male;
Benny: [a]/'benɪ/; [n](Benny)人名;(法)贝尼;(以,印尼)本尼; [gd]male;
Beowulf: [a]/ˈbeəˌwʊlf/; [n]贝奥武夫(有记载的最早的一部英国文学作品); [gd]male;
Berk: [a]/bɜːrk/; [n](Berk)人名;(英,德)伯克;(法,俄,土)贝尔克; [gd]male;
Bert: [a]/bə:t/; [n]伯特(男子名,等于Burt); [gd]male;
Biff: [a]/bɪf/; v. (用拳头)狠打;(非正式,骑单车等时)摔下来; [n](用拳的)重击;洋相; [gd]male;
Bill: [a]/bɪl/; [n]比尔(男名); [gd]male;
Billy: [a]/ˈbɪli/; [n]比利(男子名); [gd]male;
Bing: [a]/bɪŋ/; [n](Bing) (美)宾(人名); [gd]male;
Bishop: [a]/ˈbɪʃəp/; [n]主教; 象; [gd]male;
Blare: [a]/bleə(r)/; v. 发出响而刺耳的声音; [n]刺耳的鸣响;绚丽; [gd]male;
Bo: [a]/ˌbiː ˈəʊ/; abbr. 分支机构(branch office);狐臭(Body Odor);戏院售票房(Box Office);原油(Base Oil); [n](Bo)人名;(中)步(广东话-威妥玛);(中)柏(普通话-威妥玛);(瑞典)布;(意,葡,刚(金),柬)博;(老)保; [gd]male;
Bob: [a]/bɒb/; v. (使)上下跳动,振动;(使)轻敲;把(头发)剪成波波头;乘大雪橇;突然出现(或消失);(沿某个方向)快速移动;点头;微微鞠躬行礼; [n](Bob) 鲍勃(人名); [gd]male;
Bobby: [a]/ˈbɒbi/; [n](Bobby)人名;(英)博比; [gd]male;
Brad: [a]/bræd/; [n](Brad)人名;(英,罗)布拉德; [建]曲头钉;角钉; [vt]用无头钉固定; [gd]male;
Brandy: [a]/ˈbrændi/; [n](Brandy)人名;(法)布朗迪; [gd]male;
Brant: [a]/brænt/; [n](Brant)人名;(英,葡,瑞典,捷)布兰特;(俄)勃兰特; [gd]male;
Brian: [a]/'braɪən/; [n]布莱恩(男子名); [gd]male;
Brook: [a]/brʊk/; [n]布鲁克; [gd]male;
Buck: [a]/bʌk/; [n](Buck)人名;(英,西)巴克;(法)比克;(德,瑞典,匈)布克; [gd]male;
Bud: [a]/bʌd/; [n](Bud)人名;(英)巴德;(中)布特(蒙语-汉语拼音);(罗,匈)布德; [vt]使发芽; [gd]male;
Buddy: [a]/ˈbʌdi/; [n](Buddy)人名;(英)巴迪; [gd]male;
Burgess: [a]/'bɜːdʒɪs/; [n](Burgess)人名;(德)布格斯;(英)伯吉斯; [gd]male;
Burl: [a]/bɜːl/; [n]瘤;树节;节; [vt]去掉节; [gd]male;
Buster: [a]/ˈbʌstər/; [n]伯斯特(男子名); [gd]male;
Butch: [a]/bʊtʃ/; [n]布奇(男子名); [gd]male;
Butler: [a]/ˈbʌtlə(r)/; [n](Butler)人名;(英,西)巴特勒;(俄,德,瑞典)布特勒; [gd]male;
Byron: [a]/'bairən/; [n]拜伦(男子名); [gd]male;
Caesar: [a]/'si:zə/; [n]凯撒(罗马皇帝);暴君;人间的主宰;剖腹产手术; [gd]male;
Cal: [a]/kæl/; abbr. 小卡(热量单位) (small calorie); [n](Cal) (美)贾尔(人名); [gd]male;
Caleb: [a]/'keileb/; [n]迦勒(男子名);卡莱布(手表品牌);"天狗"发射装置; [gd]male;
Cam: [a]/kæm/; [n](Cam)人名;(英,法,西)卡姆; [gd]male;
Carl: [a]/kɑrl/; [n]卡尔(男名); [gd]male;
Carmine: [a]/ˈkɑːmaɪn/; [adj]深红色的,洋红色的; [n](Carmine) (意,英)卡尔米内(人名); [gd]male;
Case: [a]/keɪs/; [n](Case)人名;(英)凯斯;(西)卡塞;(法)卡斯; [vt]包围;把.装于容器中; [gd]male;
Caspar: [a]/'kæspə/; [n]卡斯帕(《圣经》中三哲士之一,等于Gaspar); [gd]male;
Cass: [a]/kæs/; abbr. 货物财务结算系统(Cargo Account Settlement System);指令主动声纳浮标系统(Commanded Active Sonobuoy System); [n](Cass)人名;(英,西)卡斯; [gd]male;
Cat: [a]/kæt/; [n](Cat)人名;(西,英)卡特; [gd]male;
Chad: [a]/tʃæd/; [n]乍得(非洲国名); [gd]male;
Chance: [a]/tʃɑːns/; [n](Chance)人名;(英)钱斯; [vt]偶然发生;冒..的险; vi. 碰巧;偶然被发现; [gd]male;
Chandler: [a]/ˈtʃɑːndlə(r)/; [n](Chandler)人名;(英)钱德勒; [gd]male;
Chariot: [a]/ˈtʃæriət/; [n](Chariot)人名;(法)沙里奥; [vt]驾驭(过去式charioted,过去分词charioted,现在分词charioting,第三人称单数chariots); vi. 乘战车;驾驭战车; [gd]male;
Charles: [a]/tʃɑ:lz/; [n]查尔斯(人名); [gd]male;
Charley: [a]/ˈtʃɑːlɪ/; [n]查理(人名); [gd]male;
Charlie: [a]/ˈtʃɑːli/; [n]查理(男子名); [gd]male;
Chase: [a]/tʃeɪs/; [n](chase) 追赶;努力获得;打猎;越野障碍赛马;徒劳之举;(旧时)狩猎地;猎物;(凸版印刷术)活版架;枪管;(凿于墙面等的)嵌管槽; [gd]male;
Che: [a]/,si: eɪtʃ 'i:/; abbr. 胆碱酯酶(等于cholinesterase);化学(等于Chemical);充电指示灯; [n](Che)人名;(中)锗(广东话-威妥玛);(越)制;(柬)则; [gd]male;
Chevalier: [a]/,ʃevə'lɪə/; [n](Chevalier)人名;(英)希瓦利埃;(法)舍瓦利耶; [gd]male;
Chevy: [a]/'tʃɛvi/; 雪佛兰(Chevrolet); [n](Chevy)人名;(法)舍维; [gd]male;
Chip: [a]/tʃɪp/; [n]炸薯条(片);芯片,晶片;碎片,碎屑;缺口;筹码;(足球的)挑球,(高尔夫球)短切球; v. 打缺,弄缺;铲,凿,削;短切(球),踢(高球);把(土豆等)切成小片(条); [gd]male;
Christ: [a]/kraɪst/; [n]基督;救世主; int. 天啊!; [gd]male;
Chuck: [a]/tʃʌk/; v. 抛掷;丢弃;放弃;与..断绝关系;驱逐;轻拍,抚弄;犯规投(球); [n](Chuck) 恰克(人名); [gd]male;
Clare: [a]/klεə/; [n]克莱尔(女子名); [gd]male;
Clarence: [a]/'klær(ə)ns/; [n](Clarence)人名;(英,西,南非)克拉伦斯;(法)克拉朗斯;(葡)克拉伦塞; [gd]male;
Clay: [a]/kleɪ/; [n](Clay)人名;(英,法,西,意,葡)克莱; [土壤]粘土;泥土;肉体;似黏土的东西; [vt]用黏土处理; [gd]male;
Clem: [a]/klem/; v. (使)受饥渴寒冷之苦;遭受饥渴寒冷之苦; [n](Clem) (美)克莱姆(人名); [gd]male;
Clement: [a]/ˈklemənt/; [adj](天气)温和的;(人,行为)仁慈的; [gd]male;
Cleveland: [a]/'klivlənd/; [n]克利夫兰(美国城市); [gd]male;
Cliff: [a]/klɪf/; [n](Cliff)人名;(英)克利夫; [gd]male;
Clint: [a]/klint/; [n]克林特(男子名); [gd]male;
Clyde: [a]/klaid/; [n]克莱德(男子名); [gd]male;
Cob: [a]/kɒb/; [n](Cob)人名;(西)科夫; [vt]捣碎; [gd]male;
Colin: [a]/'kolɪn/; [n]科林(男子名); [gd]male;
Connie: [a]/'kɔni/; [n]康妮(女子名,Constance的昵称); [gd]male;
Corky: [a]/'kɔːkɪ/; [adj]像软木的;(酒)有软木塞味的;(非正式)活泼的; [gd]male;
Corrie: [a]/ˈkɒri/; [n](Corrie)人名;(英)科里; [gd]male;
Cosmo: [a]/'kɔzməu; 意大利语 'kɔ:zmɔ:/; [n]科兹摩(男子名);(美)都市性; [gd]male;
Cris: [a]/kri:s/; [n](Cris) (美,罗马尼亚,菲)克里斯(人名); [gd]male;
Curt: [a]/kɜːt/; [adj]简短而失礼的,唐突无礼的;简略的,简要的;草率的; [n](Curt) (美)库尔特(人名); [gd]male;
Cy: [a]/sai/; abbr. 日历年度(calendar year); [n](Cy)人名;(英)赛 (教名Cyrus的昵称); [gd]male;
Daffy: [a]/ˈdæfi/; [adj]愚笨的;疯狂的; [n](Daffy)人名;(法)达菲; [gd]male;
Dale: [a]/deɪl/; [n]黛尔(女子名,等于Dayle);戴尔(男子名); [gd]male;
Dan: [a]/dæn/; [n]丹(男子名,等于Danie);但(雅各和辟拉的儿子);达恩(古代巴勒斯坦北端的村庄);但族(由但传下来的以色列12部族之一); [gd]male;
Dani: [a]/ˈdɑːnɪ/; [n]达尼(人名);丹尼人(部落名,聚居在巴列姆山谷); [gd]male;
Danny: [a]/,dæni/; [n]丹尼(男子名,等于Daniel); [gd]male;
Dante: [a]/'dænti/; [n]但丁(意大利诗人); [gd]male;
Darien: [a]/'dɑ:ri,en/; [n]达连湾(加勒比海最南部的海湾); [gd]male;
Darwin: [a]/ˈdɑːwɪn/; [n]达尔文(①姓氏, 男子名 ②Charles Robert, 1809-1882, 英国博物学家, 进化论创始人 ③澳大利亚港市); [gd]male;
Daryl: [a]/'dæril/; [n]达里尔(Darrell的异体); [gd]male;
Dean: [a]/diːn/; [n]院长;系主任;教务长;主持牧师; [gd]male;
Dell: [a]/del/; [n]美国戴尔公司; [gd]male;
Derby: [a]/ˈdɑːbi/; [n]德比(英国中部的都市);德比赛马;大赛马; [gd]male;
Derrick: [a]/ˈderɪk/; 德里克(人名); [gd]male;
Devon: [a]/'devən/; [n]德文郡(等于Devon shire,英国郡名);德文岛(加拿大北部); [gd]male;
Dewey: [a]/'dju(:)i/; [n]杜威(男子名); [gd]male;
Dexter: [a]/'dekstə/; [adj](在)盾徽右侧的; [n](Dexter)(英,菲)德克斯特(人名); [gd]male;
Dick: [a]/dɪk/; [n]迪克(男子名); [gd]male;
Dickey: [a]/'diki/; [n](Dickey)人名;(英,葡)迪基; [adj]不可靠的;低劣的; [gd]male;
Dino: [a]/'daɪnəʊ/; [n](Dino)人名;(法,意,西,葡)迪诺; [gd]male;
Dionysus: [a]/,daiə'naisəs/; [n]迪奥尼索司(希腊神话中的酒神); [gd]male;
Dirk: [a]/dɜːk/; [n](Dirk)人名;(德,荷,葡)迪尔克;(英)德克; [vt]用短剑刺; [gd]male;
Dom: [a]/dɑm/; [n](Dom)人名;(柬)敦; [gd]male;
Dominick: [a]/'dɔminik/; [n]多明尼克; [gd]male;
Dominique: [a]/,dɔmi'ni:k/; [n]多米尼加鸡;多米尼克(女子名); [gd]male;
Don: [a]/dɒn/; [n](Don) (美)唐(人名); [gd]male;
Donny: [a]/ˈdænɪ/; [n]唐尼(男子名); [gd]male;
Dorian: [a]/'dɔriən/; [n]多利安人; [adj]多利安人的;多利斯地区的; [gd]male;
Dory: [a]/ˈdɔːri/; [n](Dory)人名;(法)多里; [gd]male;
Drake: [a]/dreɪk/; [n](Drake)人名;(德,芬,葡)德拉克;(英)德雷克; [gd]male;
Drew: [a]/druː/; v. 牵引(draw的过去式);描绘;起草; [n](Drew)人名;(英)德鲁; [gd]male;
Duke: [a]/djuːk/; [n](Duke)人名;(西,俄,瑞典,英)杜克; [gd]male;
Dylan: [a]/'dilən/; [n]狄伦(男子名); [gd]male;
Earl: [a]/ɜːl/; [n](Earl)人名;(英,挪)厄尔; [gd]male;
Ed: [a]/ɪd/; abbr. Edmund,Edward,Edwin等的昵称; [gd]male;
Eddie: [a]/'edi/; [n]埃迪(男子名); [gd]male;
Eddy: [a]/ˈedi/; [n](Eddy)人名;(英,法,印尼,葡)埃迪; [vt]使.起漩涡; [gd]male;
Edward: [a]/ˈedwəd/; [n](Edward) (美,波)爱德华(人名); [gd]male;
Eli: [a]/'i,laɪ/; [n]伊莱(男子名); [gd]male;
Elihu: [a]/i'laihju:/; [n]伊莱休(男子名);以利户(约伯苦恼时访问约伯的友人之一); [gd]male;
Elijah: [a]/i'laidʒə/; [n]以利亚(希伯来先知); [gd]male;
Eliot: [a]/'ɛlɪət/; [n]艾略特(姓氏); [gd]male;
Elisha: [a]/i'laiʃə/; [n]以利沙(男子名); [gd]male;
Elvis: [a]/'elvis/; [n]埃尔维斯(男子名); [gd]male;
Emil: [a]/ei'mi:l/; [n]埃米尔(男子名); [gd]male;
Emile: [a]/ei'mi:l/; [n]埃米尔(男子名,等于Emil); [gd]male;
Emmanuel: [a]/i'mænjuəl/; [n]以马内利(耶稣基督的别称);伊曼纽尔(男子名,等于Immanuel); [gd]male;
Emmet: [a]/'emɪt/; [n]埃米特(男子名); [gd]male;
Emmy: [a]/ˈemi/; [n]艾美奖(美国电视最高荣誉奖); [gd]male;
Ender: [a]/'bɪtɚ'rɛndɚ/; [n]安德(游戏中的人物名);恩德(男子名); [gd]male;
Enoch: [a]/'i:nɔk/; [n]伊诺克(男子名); [gd]male;
Ephraim: [a]/'i:freiim/; [n]以色列民族;以法莲(约瑟的次子); [gd]male;
Er: [a]/ɜː; ə/; int. (表示说话时的犹豫,迟疑)哦,嗯; abbr. 急救室 (emergency room); [gd]male;
Erasmus: [a]/i'ræzməs/; [n]伊拉兹马斯(男子名); [gd]male;
Eric: [a]/'erɪk/; 埃里克,男子名; [gd]male;
Ernie: [a]/'ə:ni/; [n]摇奖机;欧尼(男子名,等于Ernest);欧尼(女子名,等于Ernestine); [gd]male;
Esau: [a]/'i:sɔ:/; [n]以扫(圣经中人物); [gd]male;
Euclid: [a]/'ju:klid/; [n]欧几里得;欧几里德几何学; [gd]male;
Eugene: [a]/ˈjuːdʒiːn/; [n]尤金(男子名); [gd]male;
Ev: [a]/ˌiː ˈviː/; abbr. 电子伏特(electron volt);萨尔瓦多(El Salvador); [gd]male;
Evan: [a]/'evən/; [n]埃文(男子名); [gd]male;
Ewan: [a]/'ju:ən/; [n]尤恩(男子名,等于Evan); [gd]male;
Ezra: [a]/'ezrə/; [n]以斯拉(男子名);以斯拉记; [gd]male;
Fabian: [a]/'feibiən/; [n]费边主义; [adj]费边式的;拖延时间的; [gd]male;
Fergus: [a]/'fə:ɡəs/; [n]费格斯(男子名,意思是有男子气概的或强壮的); [gd]male;
Filbert: [a]/ˈfɪlbət/; [n](Filbert)人名;(德,坦桑)菲尔贝特;(英)菲尔伯特; [gd]male;
Fletch: [a]/fletʃ/; v. 为(箭)加羽毛尾翼; [n]箭的尾翼; [gd]male;
Flint: [a]/flɪnt/; [n](Flint)人名;(德,英,俄,法,瑞典)弗林特; [gd]male;
Flipper: [a]/ˈflɪpə(r)/; [n]鳍状肢;鳍;烤饼;胖听罐头; vi. 靠鳍足(或鸭甲板)行动; [adj]无礼的; [gd]male;
Ford: [a]/fɔːd/; [n]福特(汽车品牌); [vt]涉过;徒涉; [gd]male;
Forest: [a]/ˈfɒrɪst/; [n](Forest) 福雷斯特(人名); [gd]male;
Foster: [a]/ˈfɒstə(r)/; [n](美,加)福斯特(人名); v. (foster) 助长,培养;养育,抚育;收养;抱(希望等); [adj](foster) 收养的,养育的; [gd]male;
Fox: [a]/fɒks/; [n](fox) 狐狸;狐皮;狡猾的人,老滑头;漂亮的年轻女子; [adj](与)福克斯人(有关)的;(与)福克斯语(有关)的; [gd]male;
Frank: [a]/fræŋk/; [n]弗兰克(男子名); [gd]male;
Franklin: [a]/'fræŋklɪn/; [n]富兰克林(男子名);富兰克林(加拿大西北地区的北部分区); [gd]male;
Franz: [a]/fra:nts/; [n]弗朗茨(Francis Ferdinand的德文名); [gd]male;
Fred: [a]/fred/; [n]佛瑞德(男子名); [gd]male;
Freeman: [a]/ˈfriːmən/; [n]弗里曼(姓氏或男子名); [gd]male;
Fulton: [a]/'fultən/; [n]富尔顿(姓氏); [gd]male;
Gail: [a]/ɡeil/; [n]盖尔(女子名,等于Gale或Gayle); [gd]male;
Gale: [a]/ɡeɪl/; [n](Gale)人名;(西,葡,塞)加莱;(缅)格礼;(英)盖尔; [气象]大风,狂风;(突发的)一阵; [gd]male;
Galen: [a]/'ɡeilin/; [n]伽林(古希腊名医及有关医术的作家); [gd]male;
Gamaliel: [a]/ɡə'meiljəl/; [n]甘梅利尔(男子名); [gd]male;
Garcon: [a]/ga:'sɔ:ŋ/; [n](Garcon)人名;(西)加尔孔;(英)加肯; [gd]male;
Gardener: [a]/ˈɡɑːdnə(r)/; [n](Gardener)人名;(英)加德纳; [gd]male;
Garret: [a]/ˈɡærət/; [n](Garret)人名;(英)加勒特;(法)加雷;(西,葡)加雷特; [gd]male;
Garth: [a]/gɑːθ/; [n](Garth)人名;(德)加特;(英)加思; [gd]male;
Gaspar: [a]/'ga:spə/; [n](Gaspar)人名;(法,德,西,俄,葡,塞)加斯帕尔;(英); [材]加斯帕; [gd]male;
Gasper: [a]/'gɑːspə/; [n](Gasper)人名;(英,德,塞)加斯珀; [gd]male;
Gay: [a]/ɡeɪ/; [adj]快乐的;放荡的;艳丽的; [n](Gay)人名;(西)加伊;(英,法,瑞典,毛里塔)盖伊; [gd]male;
Gene: [a]/dʒiːn/; [n]吉恩(男子名); [gd]male;
Geo: [a]/gjəʊ; 'dʒiːəʊ/; [n](Geo) (美,意,罗)杰奥(人名); [gd]male;
Georgia: [a]/ˈdʒɔːdʒə/; [n]乔治亚州;格鲁吉亚(前苏联加盟共和国);乔治娅(女子名); [gd]male;
Georgie: [a]/'dʒɔ:dʒi/; [n]乔吉(George 的昵称); [gd]male;
Gideon: [a]/'ɡidiən/; [n]犹太勇士,曾击败过Midianites;吉迪恩(男子名); [gd]male;
Gil: [a]/ɡil/; [n]吉尔(人名); [gd]male;
Gilbert: [a]/'gɪlbɚt/; [n]吉尔伯特(男子名); [gd]male;
Gill: [a]/gɪl/; [n](Gill)人名;(英,法,德,匈,印)吉尔;(瑞典,挪)伊尔;(西)希尔; [vt]用刺网捕鱼;去除内脏; [gd]male;
Ginger: [a]/ˈdʒɪndʒə(r)/; [n](Ginger)人名;(法)然热;(英)金杰; [vt]用姜给.调味;使某人有活力; [adj]姜黄色的; [gd]male;
Glen: [a]/ɡlen/; [n]格伦(姓名); [gd]male;
Goober: [a]/'guːbə/; [n]花生;落花生(等于goober pea); [gd]male;
Goose: [a]/ɡuːs/; [n](Goose)人名;(德)戈泽;(英)古斯; [vt]突然加大油门;嘘骂; [gd]male;
Grace: [a]/ɡreɪs/; [n](Grace)人名;(英)格雷斯,格雷丝 (女名);(法)格拉斯; [vt]使优美; [gd]male;
Graham: [a]/'greɪəm/; [n](Graham) (英,美)格雷厄姆(人名); [adj]全麦的; [gd]male;
Grant: [a]/ɡrɑːnt/; [n](grant) 拨款;正式授予;合法转让; [gd]male;
Griff: [a]/ɡrɪf/; 格里夫; [gd]male;
Griffin: [a]/ˈɡrɪfɪn/; [n]希腊神话中半狮半鹫的怪兽;格里芬(姓氏); [gd]male;
Grove: [a]/ɡroʊv/; [n]格鲁夫(姓氏); [gd]male;
Gunner: [a]/ˈɡʌnə(r)/; [n]炮手,枪手;火炮瞄准手;经常投篮的投手; [gd]male;
Gus: [a]/ɡʌs/; [n]格斯(男子名); [gd]male;
Gustavus: [a]/'ɡustɑ:vəs/; [n]古斯塔夫斯(男子名); [gd]male;
Guy: [a]/ɡaɪ/; [n](Guy)人名;(西)吉;(法)居伊;(英)盖伊; [vt]嘲弄,取笑; vi. 逃跑; [gd]male;
Hakeem: [a]/hɑ:'ki:m/; [n](Hakeem)人名;(巴基,捷,英)哈基姆; [gd]male;
Hakim: [a]/hæˈkiːm/; [n](Hakim)人名;(吉尔,阿拉伯)哈基姆; [gd]male;
Hal: [a]/hæl/; abbr. 硬件抽象层; [n]哈尔(男子名,等于Henry,Harold); [gd]male;
Hale: [a]/heɪl/; [n](美)哈勒(人名); [adj](hale) 矍铄的(尤指老人);强壮的; [adv](hale) 完全地; v. (hale) 迫使;猛拉;不断流出; [gd]male;
Hall: [a]/hɔːl/; [n](Hall)人名;(土)哈勒;(德,波,丹,芬,瑞典)哈尔;(英)霍尔;(法)阿尔; [gd]male;
Ham: [a]/hæm/; [n](Ham)人名;(英,瑞典,塞)哈姆;(老)罕;(柬)汉; [vt]演得过火; [adj]过火的;做作的; [gd]male;
Hamlet: [a]/ˈhæmlət/; [n]哈姆雷特(莎士比亚著名悲剧剧名及该剧的主人公); [gd]male;
Hank: [a]/hæŋk/; [n]汉克(男子名); [gd]male;
Hannibal: [a]/'hænibəl/; [n]汉尼巴尔(男子名);汉尼拔(公元前247～前183,迦太基名将,统帅); [gd]male;
Hansel: [a]/'hæns(ə)l/; [n](Hansel)人名;(英,德,瑞典)汉塞尔; [gd]male;
Harry: [a]/ˈhæri/; v. (不断)烦扰;不断袭击; [n](Harry) (英,瑞)哈里(人名); [gd]male;
Hart: [a]/hɑːt/; [n](Hart)人名;(匈)豪尔特;(西,法)阿特;(英,罗,捷,芬,德)哈特; [gd]male;
Harvard: [a]/'hɑ:vəd/; [n]哈佛大学;哈佛大学学生; [gd]male;
Hasty: [a]/ˈheɪsti/; [adj]轻率的;匆忙的;草率的;性怠的; [n](Hasty)人名;(英)黑斯蒂; [gd]male;
Haven: [a]/ˈheɪvn/; [n](Haven) (美)黑文(人名); [gd]male;
Hazel: [a]/ˈheɪzl/; [n](Hazel)人名;(英)黑兹尔; [adj]淡褐色的;榛树的; [gd]male;
Heath: [a]/hiːθ/; [n](Heath)人名;(柬)夏;(芬)海亚特;(英)希思; [adj]杜鹃花科木本植物的; [gd]male;
Hector: [a]/ˈhektə(r)/; [n]赫克托(男子名);荷马史诗《伊利亚特》中的一勇士名; [gd]male;
Heinrich: [a]/'haɪnrɪk/; [n]海因里希(男子名); [gd]male;
Henry: [a]/ˈhenri/; [n]亨利(男子名); [gd]male;
Herb: [a]/hɜːb/; [n](Herb)人名;(德,英,瑞典)赫布; [gd]male;
Herby: [a]/'hɜːbɪ/; [adj](食物)含有药草的,多草本植物的; [gd]male;
Hercules: [a]/'hə:kjuli:z/; [n] [天]武仙座;力士;大力神; [gd]male;
Herschel: [a]/'hə:ʃəl/; [n]赫歇尔(十九世纪的天文学家);天王星; [gd]male;
Hew: [a]/hjuː/; v. 砍;劈;砍倒;砍成(某物或某种形状);遵从,坚持; [n](Hew) (美,英,马来)休(人名); [gd]male;
Hezekiah: [a]/ˌhɛzəˈkaɪə/; [n]希西家(人名,也指圣经中提到的希西家王); [gd]male;
Hill: [a]/hɪl/; [n](Hill)人名;(法,西)伊尔;(德,英,匈,捷,罗,芬,瑞典)希尔; [gd]male;
Hodge: [a]/hɔdʒ/; [n]霍奇(男子名,等于Roger); [gd]male;
Hogan: [a]/'həʊg(ə)n/; [n](Hogan)人名;(西)奥甘;(英)霍根; [gd]male;
Holly: [a]/ˈhɒli/; [n](Holly)人名;(英,德,捷,罗)霍利;(西)奥利; [adj]冬青属植物的; [gd]male;
Homer: [a]/ˈhəʊmə(r)/; [n]荷马(公元前9世纪前后的希腊盲诗人);本垒打; [gd]male;
Horst: [a]/hɔːst/; [n](Horst)人名;(英,德,罗,捷,塞,波,瑞典)霍斯特;(西,法)奥尔斯特; [地质]地垒; [gd]male;
Humbert: [a]/'hʌmbət/; [n]亨伯特(男子名); [gd]male;
Hunt: [a]/hʌnt/; v. 打猎;搜索;追捕;(英国)猎狐运动;用(马和猎犬)狩猎(尤指猎狐或鹿);用猎犬(或骑马)打猎;(动物)追捕猎物);(机器,仪表针或系统)摆动;(飞机或火箭)不规则摆动; [n](Hunt) (美)安(人名); [gd]male;
Hurley: [a]/'hɝli/; [n]赫尔利(姓氏); [gd]male;
Hy: [a]/,etʃ 'waɪ/; abbr. 亨利(Henry,男子名);高产(high yield); [n](Hy)人名;(柬)希; [gd]male;
Iago: [a]/i'ɑ:ɡəu/; [n]埃古(莎士比亚剧作《奥赛罗》中的反面人物); [gd]male;
Ike: [a]/aik/; [n]艾克(等于Isaac,男子名); [gd]male;
Ikey: [a]/'aiki/; [n]网络钥匙(一种身份识别工具,是基于USB接口,由SafeNet公司严格按照ISO7816-4标准生产的硬件设备);艾奇(男子名); [gd]male;
Immanuel: [a]/i'mænjuə/; [n]以马内利(基督的别称); [gd]male;
Ira: [a]/ˌaɪ ɑːr ˈeɪ/; abbr. 爱尔兰共和军(Irish Republican Army);个人退休帐户(Individual Retirement Account); [n](Ira)人名;(土,芬,捷,西)伊拉;(英)艾拉; [gd]male;
Isa: [a]/,aɪ es 'eɪ/; abbr. 工业标准结构(Industry Standard Architecture);美国仪器学会(Instrument Society of America);网络安全与加速(Internet Security and Acceleration); [n](Isa)人名;(阿拉伯,土,土库,阿塞,塞,巴基,尼日利,阿富,西,印尼)伊萨;(英)艾莎(教名 Isabel,Isabella,Isbel,Ishbel,Isobel 的昵称); [gd]male;
Isaiah: [a]/aɪ'zer/; [n]以赛亚书(圣经旧约);以赛亚(圣经男子名,希伯来预言家); [gd]male;
Ishmael: [a]/'iʃmεəl/; [n]以赛玛利;社会公敌;被遗弃的人; [gd]male;
Israel: [a]/ˈɪzreɪl/; [n]以色列(亚洲国家);犹太人,以色列人; [gd]male;
Jack: [a]/dʒæk/; [n]杰克(男子名); [gd]male;
Jackie: [a]/'dʒæki/; [n]杰基(人名); [gd]male;
Jake: [a]/dʒeɪk/; [adj](非正式)顺利的,令人满意的; [n](Jake) 杰克(人名); [gd]male;
Jameson: [a]/'dʒeimsn/; [n]詹姆士(姓氏); [gd]male;
Janus: [a]/'dʒeinəs/; [n](古罗马的)两面神; [gd]male;
Jason: [a]/ˈdʒeɪsən/; [n]詹森(男子名); [gd]male;
Jasper: [a]/'dʒæspə/; [n](Jasper)人名;(德)雅斯佩尔;(西)哈斯佩尔; [gd]male;
Jay: [a]/dʒeɪ/; [n](Jay)人名;(英)杰伊;(法)热; [gd]male;
Jean: [a]/dʒiːn/; [n]珍(女子名); [gd]male;
Jed: [a]/jɛd/; [n]杰德(男子名,Jedediah的昵称); [gd]male;
Jeff: [a]/dʒef/; [n]杰夫(男子名,等于Jeffrey); [gd]male;
Jehu: [a]/'dʒi:hju:/; [n]耶户(以色列国王,相传为莽撞的御车者); [gd]male;
Jephthah: [a]/'dʒefθə/; [n]耶弗他;以色列士师; [gd]male;
Jeremiah: [a]/,dʒeri'maiə/; [n]耶利米(《圣经》故事人物);耶利米书; [gd]male;
Jerry: [a]/ˈdʒeri/; [n]杰里(男子名); [gd]male;
Jess: [a]/dʒes/; [n](jess) 驯鹰脚带圈; v. (jess) 给(猎鹰)系上脚带圈; [gd]male;
Jesse: [a]/ˈdʒesi/; [n]杰西(男子名); [gd]male;
Jessie: [a]/ˈdʒesi/; [n]杰西(女子名); [gd]male;
Jesus: [a]/ˈdʒiːzəs/; [n]耶稣(上帝之子);杰西(男子名); [gd]male;
Jethro: [a]/ˈdʒɛθrəʊ/; 杰思罗(人名); [gd]male;
Jim: [a]/dʒɪm/; [n]吉姆(人名); [gd]male;
Jimmy: [a]/ˈdʒɪmi/; [n]吉米(男子名); [gd]male;
Jo: [a]/,dʒe 'o/; abbr. 乔(女子名,等于Joseph,Josephine); [gd]male;
Joab: [a]/'dʒəuæb/; [n]约押(大卫王军队的元帅,见《圣经》); [gd]male;
Job: [a]/dʒɒb/; [n](Job)人名;(英)乔布;(法,葡)若布;(?-1605)约伯〈俄〉俄罗斯正教会莫斯科牧首.;(德,塞,捷,荷,意)约布; [vt]承包;代客买卖; vi. 做零工; [gd]male;
Jock: [a]/dʒɑːk/; [n]苏格兰高原地方的士兵;(大学)运动员;乔克(男子名); [gd]male;
Jody: [a]/'dʒəudi/; [n]乔迪(女子名,等于Judith,Jodi,Jodie); [gd]male;
Joel: [a]/'dʒəuəl/; [n](圣经中的)约耳书;约珥(圣经人物); [gd]male;
Joey: [a]/ˈdʒəʊi/; [n](Joey)人名;(纳米,英)乔伊; [gd]male;
Johnny: [a]/'dʒɒnɪ/; [n](Johnny)人名;(英,西,瑞典)约翰尼; [gd]male;
Jon: [a]/dʒɒn/; [n]乔恩(男子名); [gd]male;
Jonah: [a]/'dʒəunə/; [n]约拿(圣经人物);约拿书;带来厄运的人; [gd]male;
Jonas: [a]/'dʒəunəs/; [n]乔纳斯(人名); [gd]male;
Jonathan: [a]/'dʒɑnəθən/; [n]乔纳森(男子名); [gd]male;
Josh: [a]/dʒɑːʃ/; [vt]戏弄; vi. 戏弄,开玩笑; [n](Josh) 乔希(人名);(Josh) 约书亚(男子教名 Joshua 的简称); [gd]male;
Joshua: [a]/'dʒɔʃwə/; [n]约书亚;约书亚书; [gd]male;
Judah: [a]/'dʒu:də/; [n](圣经中的)犹大;犹大的后裔; [gd]male;
Judas: [a]/ˈdʒuːdəs/; [n](Judas) (法,美)茹达斯(人名); [gd]male;
Jude: [a]/dʒu:d/; [n]犹大书(圣经新约的一书); [gd]male;
Judith: [a]/'dʒu:diθ/; [n]朱迪思(女子名); [gd]male;
Judy: [a]/'dʒu:di/; [n]朱迪(女子名);朱迪(英国木偶戏 Punch and Judy中的妻子); [gd]male;
Jules: [a]/dʒu:lz/; [n]朱尔斯(男子名); [gd]male;
Kaiser: [a]/ˈkaɪzə(r)/; [n](德国)皇帝; [gd]male;
Karl: [a]/kɑrl/; [n]卡尔(男子名,等于Charles); [gd]male;
Kelvin: [a]/ˈkelvɪn/; [n]绝对温标;凯尔文(男子名); [热]开尔文(英国物理学家,数学家); [adj]开氏度的(常作K-); [gd]male;
Ken: [a]/ken/; [n]肯恩(男名); [gd]male;
Kermit: [a]/'kə:mit；'kɝmɪt/; 一种文件传输协议,由哥伦比亚大学设计发展的一种透过 Modem 上载或下载档案的异步档案传输协定; 克米特(人名,来源于凯尔特语,含义是"武器之神"(god of arms)); 克米特(地)名,在美国; [n](Kermit)人名;(英)克米特; [gd]male;
Kerry: [a]/'kerɪ/; [n](Kerry) (美)凯瑞(人名); [gd]male;
Kin: [a]/kɪn/; [n](Kin)人名;(缅)庆;(朝)紧;(匈,柬,塞)金;(中)金(普通话-威妥玛); [adj]同类的;有亲属关系的;性质类似的; [gd]male;
King: [a]/kɪŋ/; [n](King)人名;(德,英,葡,捷,西)金;(中)金(普通话-威妥玛);(泰)京;(东南亚国家华语)京; [vt]立.为王; [adj]主要的,最重要的,最大的; [gd]male;
Kip: [a]/kɪp/; [n]睡觉;客栈;千磅;生幼兽皮; vi. 住客栈;躺下睡觉; [gd]male;
Kirk: [a]/kɜːk/; [n](Kirk)人名;(德,丹)基尔克;(英)柯克; [gd]male;
Kit: [a]/kɪt/; [n](Kit)人名;(俄)基特;(东南亚国家华语)吉;(英)基特,姬特(女名)(教名 Christopher,Katherine 的昵称); [vt]装备; vi. 装备; [gd]male;
Kris: [a]/kriːs/; [n](Kris)人名;(印,阿拉伯)克里斯;(泰)吉;(英)克里斯,克丽丝(女名); [gd]male;
Krishna: [a]/'kriʃnə/; [n](印)克利须那神; [gd]male;
Laird: [a]/leəd/; [n](Laird)人名;(英)莱尔德; [gd]male;
Lambert: [a]/'læmbət/; [n]兰伯特(姓氏); [gd]male;
Lance: [a]/lɑːns/; [n](Lance)人名;(英)兰斯;(法)朗斯; [vt]以长矛攻击;用柳叶刀割开;冲进; vi. 急速前进; [gd]male;
Lancelot: [a]/'lænsələt/; [n]兰斯洛特(男子名,亚瑟王圆桌武士中的第一位勇士); [gd]male;
Lane: [a]/leɪn/; [n](Lane)人名;(英,俄)莱恩;(老)兰;(德,法,意,葡,塞,瑞典)拉内; [航] [水运]航线;车道;罚球区; [gd]male;
Larry: [a]/'lærɪ/; [n]拉里(男子名); [gd]male;
Lay: [a]/leɪ/; [n](lay) 位置;短诗;花纹方向; [adj](lay) 世俗的;外行的; [gd]male;
Lazarus: [a]/ˈlæzərəs/; [n]穷人;圣经中的麻疯乞丐;拉扎勒斯(男子名); [gd]male;
Lee: [a]/liː/; [n](Lee)人名;(朝)李;(中)李(普通话-威妥玛);(柬)利;(中)李(广东话-威妥玛); [adj]保护的;庇荫的;避风的; [gd]male;
Lefty: [a]/ˈlefti/; [n]左撇子;左翼分子; [gd]male;
Leonid: [a]/'li:əunid/; [n]狮子座流星群; [gd]male;
Leopold: [a]/'li:əpəuld/; [n]利奥波德(男子名); [gd]male;
Les: [a]/lez/; [n](Les) (美,加,澳)雷(人名); [gd]male;
Lev: [a]/lɛf/; [n]列弗(保加利亚的货币单位); [gd]male;
Levy: [a]/ˈlevi/; [n](Levy)人名;(西,意,葡,芬,法,瑞典)莱维;(英,以)利维; [vt]征收(税等);征集(兵等); vi. 征税;征兵; [gd]male;
Lewis: [a]/'luːɪs/; [n]路易斯(男子名); [gd]male;
Lex: [a]/leks/; [n](Lex)人名;(德,匈)莱克斯;(葡)莱什; [gd]male;
Lincoln: [a]/ˈlɪŋkən/; [n]林肯(美国第16任总统);林肯(福特汽车厂出产的名牌豪华汽车); [gd]male;
Lindy: [a]/'lindi/; [n](Lindy) 林迪(人名); [gd]male;
Linus: [a]/'lainəs/; [n]莱纳斯; [gd]male;
Lion: [a]/ˈlaɪən/; [n](Lion)人名;(西,葡)利昂;(德,法,意,捷,瑞典)利翁;(英)莱昂; [gd]male;
Lowell: [a]/'ləuəl/; [n]洛厄尔(男子名,等于Lovell); [gd]male;
Luce: [a]/luːs/; [n]卢斯(姓氏); [gd]male;
Luis: [a]/'lwis/; [n]路易斯(人名); [gd]male;
Luther: [a]/'lu:θə/; [n]卢瑟(男子名); [gd]male;
Mace: [a]/meɪs/; [n]狼牙棒;权杖; [gd]male;
Mack: [a]/mæk/; abbr. 军事空运司令部(Millitary Airlift Command); [n](Mack)人名;(德,意,法)马克;(英)麦克; [gd]male;
Magnum: [a]/ˈmæɡnəm/; [n]大酒瓶(容量为1.5升);头状骨; [gd]male;
Magnus: [a]/'mægnəs/; [n]马格纳斯力;鲁班结; [gd]male;
Major: [a]/ˈmeɪdʒər/; [n](major) 成年人;主修科目;陆军少校; v. (major) 主修; [adj](major) 主要的;重要的;主修的;较多的; [gd]male;
Marcel: [a]/mɑː'sel/; [n]大波浪发型; v. 把(头发)烫成大波浪发型; [gd]male;
Mario: [a]/'mærɪə/; [n]马里奥(男子名); [gd]male;
Mark: [a]/mɑːk/; [n](Mark)人名;(老)马; [vt]标志;做标记于;打分数; [gd]male;
Marlin: [a]/ˈmɑːrlɪn/; [n]马林(人名);枪鱼(吻呈长镖枪状); [gd]male;
Marlowe: [a]/'ma:ləu/; [n]马洛(英国剧作家及诗人); [gd]male;
Marsh: [a]/mɑːʃ/; [n](Marsh)人名;(俄)马尔什;(英,瑞典)马什; [adj]沼泽的;生长在沼泽地的; [gd]male;
Marshal: [a]/ˈmɑːʃl/; [n](Marshal)人名;(英)马歇尔; [vt]整理;引领;编列; vi. 排列; [gd]male;
Mart: [a]/mɑːt/; [n](Mart)人名;(爱沙)马尔特;(塞,法,土库,阿塞,俄)马尔特; [gd]male;
Marten: [a]/ˈmɑːtɪn/; [n](Marten)人名;(意,俄,法,德,英,荷,西)马滕; [gd]male;
Martin: [a]/'mɑːtɪn/; [n]马丁(男子名); [gd]male;
Marv: [a]/ma:v/; abbr. 机动重返飞弹(manoeuvring reentry vehicle); [gd]male;
Mason: [a]/ˈmeɪsn/; [n]梅森(男子名); [gd]male;
Matt: [a]/mæt/; [n]马特(男子名,等于Matthew); [gd]male;
Matthew: [a]/'mæθju:/; [n]马太福音(新约第一卷);马太(耶稣12门徒之一);马修(姓氏,男子名); [gd]male;
Max: [a]/mæks/; [n]马克斯(男子名,等于Maximilian); [gd]male;
Maxim: [a]/ˈmæksɪm/; [n](Maxim)人名;(英,罗,俄,哈萨)马克西姆; [gd]male;
Maxwell: [a]/ˈmækswəl/; [n]麦克斯韦(英国物理学家,数学家); [gd]male;
Mayor: [a]/meə(r)/; [n](Mayor)人名;(英)梅厄;(法,西,俄)马约尔; [gd]male;
Mead: [a]/miːd/; [n](Mead)人名;(英)米德; [gd]male;
Mel: [a]/mel/; [n](Mel)人名;(英,德,西,葡,塞,科特,斯里)梅尔; [gd]male;
Mendel: [a]/'mendl/; [n]孟德尔(奥地利遗传学家); [gd]male;
Merle: [a]/mɜːl/; [n]默尔(男子名); [gd]male;
Merlin: [a]/ˈmɜːlɪn/; [n](Merlin)人名;(意)梅林;(英,德)默林;(法)梅兰; [gd]male;
Merry: [a]/ˈmeri/; [adj]愉快的;微醉的;嬉戏作乐的; [n](Merry)人名;(英,法,西)梅里; [gd]male;
Mic: [a]/maɪk/; abbr. 麦克风,话筒 (microphone); [n](Mic) (阿,瑞)米克(人名); [gd]male;
Micah: [a]/'maikə/; [n]弥迦书(略作Mic);弥迦(希伯来先知);迈卡(男子名); [gd]male;
Mick: [a]/mɪk/; [n](贬)爱尔兰人;米克(男子名); [gd]male;
Mickey: [a]/ˈmɪki/; [n](Mickey) (美)米基(人名); [gd]male;
Micky: [a]/'miki/; [n](Micky)人名;(英)米基(教名Michael的昵称); [gd]male;
Mike: [a]/maɪk/; [n](Mike)人名;(意,匈,罗,塞,捷)米凯;(加纳)迈克;(英,西)迈克; [vt]用扩音器传送;用窃听器窃听; [gd]male;
Millicent: [a]/'milisənt/; [n]米利森特(女子名); [gd]male;
Milo: [a]/'maɪləʊ/; [n]蜀黍;麦洛(公元前6世纪的希腊摔跤能手); [gd]male;
Milt: [a]/mɪlt/; [n](Milt)人名;(英,捷)米尔特; [vt]使受精; [adj]繁殖期的; [gd]male;
Mitch: [a]/mɪtʃ/; v. (非正式)逃学;(非正式)逃课; [n](Mitch) (美,加,澳)米奇(人名); [gd]male;
Monte: [a]/'mɒntɪ/; [n](Monte) (美)蒙特(人名); [gd]male;
Morris: [a]/'mɒrɪs/; [n](Morris)人名;(丹,德,法,捷,葡,西,意,英)莫里斯; [gd]male;
Mort: [a]/mɔːt/; [n](Mort)人名;(法)莫尔;(英)莫特; [gd]male;
Mose: [a]/məuz/; [n]摩斯(男子名); [gd]male;
Moses: [a]/'məuziz/; [n]摩西(《圣经》故事中犹太人古代领袖);立法者;领导者; [gd]male;
Moss: [a]/mɒs/; [n](Moss)人名;(英,德,意,西,葡,波,挪,瑞典)莫斯; [vt]使长满苔藓; [gd]male;
Muffin: [a]/ˈmʌfɪn/; [n]小松饼; 小甜面包卷; [gd]male;
Muhammad: [a]/məˈhæmɪd/; [n]穆罕默德; [gd]male;
Myron: [a]/'mairən/; [n](Myron)人名;(英)迈伦; [gd]male;
Nahum: [a]/'neihəm/; [n]那鸿书;那鸿; [gd]male;
Napoleon: [a]/nə'pəuliən/; [n]拿破仑; [gd]male;
Nat: [a]/næt/; [n]纳特(男子名);苏格兰,威尔士的民族主义者; [gd]male;
Nathan: [a]/'neɪθən/; [n]南森(男子名); [gd]male;
Nathanael: [a]/nəˈθænjəl/; [n]纳撒尼尔(男子名);拿但业(圣经里的名字,意思是神的恩赐,在基督的十二使徒中出现); [gd]male;
Ned: [a]/ned/; [n]内德(男子名,等于Edward); [gd]male;
Neddy: [a]/'nedɪ/; [n](Neddy)人名;(英)内迪; [gd]male;
Nero: [a]/'niərəu/; [n]尼禄(古罗马暴君); [gd]male;
Newton: [a]/ˈnjuːtən/; [n]牛顿(英国科学家);牛顿(力的单位); [gd]male;
Nick: [a]/nɪk/; [n](Nick) (英,美,菲,瑞,比)尼克(人名); [gd]male;
Nico: [a]/'nikəu/; [n]尼科,妮可(人名); [gd]male;
Nigel: [a]/'naidʒəl/; [n]奈杰尔(男子名); [gd]male;
Noble: [a]/ˈnoʊbl/; [adj](noble) 贵族的,高贵的;(品质)高尚的;宏伟的,壮丽的;惰性的; [n](美,加,英)诺布尔(人名); [gd]male;
Noe: [a]/,ɛn o 'i/; abbr. 例外情况通知(Notice of Exception);核磁欧氏效应(Nuclear Overhauser Effect); [n](Noe)人名;(德,英,意,匈,罗)诺埃; [gd]male;
Norm: [a]/nɔːm/; [n](Norm)人名;(英)诺姆; [gd]male;
Obadiah: [a]/,əubə'daiə/; [n]俄巴底亚书(圣经旧约);希伯来的先知; [gd]male;
Oberon: [a]/'obə,rɑn/; [n]天王星之第四卫星;奥伯龙(民间传说的仙王); [gd]male;
Odin: [a]/'əudin/; [n]欧丁神(北欧神话中的神); [gd]male;
Odysseus: [a]/əu'disju:s/; [n]奥德修斯(荷马史诗《奥德赛》中的主人公; 曾指挥特洛伊战争, 献木马计,使希腊获胜); [gd]male;
Ole: [a]/əʊl/; [adj]老的,旧的; abbr. 对象链接和嵌入 (Object Linkingand Embedding); int. (表示赞成或高兴)好哇,哇; [n](Ole) (挪,丹,美)奥利(人名); [gd]male;
Ollie: [a]/ˈɑːli/; [n]奥利(男子名,等于Oliver);奥莉(女子名,等于Olive);翱骊(滑板的一种动作); [gd]male;
Omar: [a]/'əumɑ:/; [n]奥马尔(男子名); [gd]male;
Oral: [a]/ˈɔːrəl/; [adj]口头的,口述的; [n](Oral)人名;(土)奥拉尔; [gd]male;
Orion: [a]/ɔ'raɪən/; [n]猎户星座;俄里翁(希腊神话人物); [gd]male;
Orville: [a]/'ɔ:vil/; [n]奥维尔(男子名); [gd]male;
Oscar: [a]/'ɒskə/; [n](美)奥斯卡金像奖;钱;奥斯卡(男子名); [gd]male;
Osmund: [a]/'ɔzmənd, 'ɔs-/; [n](Osmund)人名;(英)奥斯蒙德;(挪)奥斯蒙; [gd]male;
Othello: [a]/əu'θeləu/; [n]奥赛罗(莎士比亚四大悲剧之一); [gd]male;
Otis: [a]/'əutis/; [n]奥蒂斯(男子名); [gd]male;
Otto: [a]/ˈɒtəʊ/; [n]玫瑰油;香精油,玫瑰精油(同 attar); [gd]male;
Ozzie: [a]/ˈɔːzi/; [n]奥齐(男子名); [gd]male;
Pace: [a]/peɪs/; [n](Pace)人名;(捷)帕采;(英)佩斯;(法)帕斯;(罗)帕切; [vt]踱步于;用步测; [gd]male;
Paddy: [a]/ˈpædi/; [n]稻田(复数paddies);爱尔兰人;Patrick(男子名)和Patricia(女子名)的昵称; [gd]male;
Page: [a]/peɪdʒ/; [n](Page)人名;(西)帕赫;(英)佩奇;(意)帕杰;(法)帕日; [vt]给.标页码; vi. 翻书页,浏览; [gd]male;
Pail: [a]/peɪl/; [n]桶,提桶; [gd]male;
Paolo: [a]/'pɑ:ɔ:lɔ:/; [n]保罗(男子名); [gd]male;
Park: [a]/pɑːk/; [n](Park)人名;(英,芬,瑞典)帕克; [交]停车场; [vt]停放;放置;寄存; vi. 停放车辆; [gd]male;
Parry: [a]/ˈpæri/; v. 挡开;回避; [n](Parry) (威尔士)帕里(人名); [gd]male;
Parsifal: [a]/'pɑ:si,fɔl/; [n]帕西发尔(亚瑟王传奇中寻找圣杯的英雄人物); [gd]male;
Pat: [a]/pæt/; [n](pat) 轻拍;小块;轻拍声; [adj](pat) 恰好的;熟练的;合适的; [adv](pat) 恰好;熟记地; [gd]male;
Pate: [a]/peɪt/; [n](Pate)人名;(法,德,意)帕特;(英)佩特; [gd]male;
Paten: [a]/'pæt(ə)n/; [n]祭碟,圣餐盘;金属制平碟; [gd]male;
Patsy: [a]/ˈpætsi/; [n](Patsy)人名;(英)帕齐(男子教名 Patrick 的昵称); [gd]male;
Pattie: [a]/'pæti/; [n](Pattie)人名;(英)帕蒂; [gd]male;
Patty: [a]/ˈpæti/; [n]帕蒂(女子名); [gd]male;
Pen: [a]/pen/; [n](Pen)人名;(法)庞;(俄,塞,英,意)佩恩;(柬)宾; [vt]写;关入栏中; [gd]male;
Penny: [a]/ˈpeni/; [n](美)分;便士; [gd]male;
Perceval: [a]/'pə:sivəl/; [n]珀西瓦尔(等于Perceval,男子名); [gd]male;
Percival: [a]/'pə:sivəl/; [n]珀西瓦尔(男子名); [gd]male;
Pete: [a]/pi:t/; [n]皮特(等于Peter,男子名); [gd]male;
Pierce: [a]/pɪəs/; [n]皮尔斯(男子名,等于Pearce); [gd]male;
Piggy: [a]/ˈpɪɡi/; [adj]像猪的;贪心的; [n]小猪; [gd]male;
Pip: [a]/pɪp/; [n](Pip)人名;(朝)逼;(德,英)皮普;(朝)乏; [vt]破壳而出; [gd]male;
Pooh: [a]/puː/; int. (表示对臭气的厌恶)噗;呸(用以表示不耐烦或蔑视); [n](Pooh) (美)朴(人名); [gd]male;
Prentice: [a]/'prentɪs/; [n](Prentice) (美,英,加,澳)普伦蒂塞(人名); [gd]male;
Price: [a]/praɪs/; [n](Price)人名;(英)普赖斯;(法)普里斯;(葡,瑞典)普里塞; [vt]给..定价;问..的价格; [gd]male;
Prince: [a]/prɪns/; [n](Prince)人名;(英,葡)普林斯;(法)普兰斯; [gd]male;
Puff: [a]/pʌf/; v. 喷出,张开;膨胀,使膨胀;抽(香烟,烟斗);(发动机,烟囱或炉子等) 喷;喷着气前进;喘粗气;夸张;使骄傲自满;鼓吹; [n](Puff) (德)普夫(人名); [gd]male;
Quentin: [a]/'kwentin/; [n]昆廷(男子名); [gd]male;
Quill: [a]/kwɪl/; [n](Quill)人名;(英)奎尔; [vt]刺穿; [gd]male;
Quincy: [a]/'kwinsi/; [n]昆西(男子名);昆西(美国马萨诸塞州东部城市);第五; [gd]male;
Quint: [a]/kwɪnt/; [n](Quint)人名;(德,意,瑞典)昆特;(西)金特;(法)坎; [gd]male;
Rabbi: [a]/ˈræbaɪ/; [n]拉比(犹太人的学者);法师;犹太教律法专家;先生; [gd]male;
Rabi: [a]/ˈrʌbiː/; [n]拉比(姓氏); [gd]male;
Rad: [a]/ræd/; [n](Rad)人名;(塞,罗,德)拉德; [gd]male;
Rainer: [a]/'reinə/; [n](Rainer)人名;(法,意)雷内;(德,芬,罗,捷,匈,瑞典,爱沙)赖纳;(英)雷纳; [gd]male;
Raj: [a]/rɑ:dʒ/; [n](Raj)人名;(匈)劳伊;(印,尼,斐)拉杰;(塞,瑞典)拉伊; [gd]male;
Raleigh: [a]/ˈrɑːli/; [n]罗利(美国北卡罗来纳州首府);罗利(英国的探险家,航海家及作家); [gd]male;
Ram: [a]/ræm/; abbr. 随机存取存储器(random access memory的缩写);随机访问内存(random-access memory的缩写); [n](Ram)人名;(英,印,尼,不丹,瑞典)拉姆; [机]活塞; v. 撞击;填塞;强迫通过或接受; [gd]male;
Randy: [a]/ˈrændi/; [adj]性欲冲动的;粗鲁放肆的; [n](Randy) 兰迪(人名); [gd]male;
Ransom: [a]/ˈrænsəm/; [n](Ransom) (美,英,加)兰塞姆(人名); [gd]male;
Ray: [a]/reɪ/; [n](Ray)人名;(西,意,匈,印,尼日尔,瑞典,阿拉伯)拉伊;(英,法,柬,博)雷,蕾(女名); [vt]放射;显出; vi. 放射光线;浮现; [gd]male;
Reagan: [a]/'reigən/; [n]里根(姓氏); [gd]male;
Red: [a]/red/; [adj]红的,红色的;(毛发)红褐色的;(脸)涨红的;(眼睛)红肿的;革命的,激进的;(人)红种的;(纸牌中)红桃的,红方块的;(葡萄酒)红的;(表示停止)红(灯),红(旗);被禁止的,危险的;(滑雪道上用红色标志指示)第二高难度的;(物理)表示夸克三种颜色之一的红色;赤色的(尤指冷战期间用于指前苏联);沾有鲜血的;(古或诗/文)流血的;(科萨人)来自传统部落文化的; [n](Red) 雷德(人名); [gd]male;
Reed: [a]/riːd/; [n](Reed)人名;(西,意,瑞典)雷德;(英)里德; [作物]芦苇;簧片;牧笛;不可依靠的人; [vt]用芦苇盖;用芦苇装饰; [gd]male;
Rem: [a]/rem; ˌɑːr iː ˈem/; abbr. 识别内存(recognition memory);指定由DOS忽略的命令行; [n](Rem)人名;(塞,罗,匈)雷姆;(俄)列姆; [gd]male;
Remus: [a]/'ri:məs/; [n]雷穆斯(罗马神话中战神Mars的儿子); [gd]male;
Renard: [a]/'renəd/; [n]勒纳尔;雷纳德; [gd]male;
Rex: [a]/reks/; [n]雷克斯(男子名);国王;君主; [gd]male;
Reynard: [a]/'renəd; -nɑ:d; 'rei-/; [n]列那(中世纪法国讽刺故事中狐狸的名字);狐狸; [gd]male;
Ricardo: [a]/ri'ka:dəu/; [n]里卡多(姓氏); [gd]male;
Rice: [a]/raɪs/; [n](Rice)人名;(瑞典)里瑟;(塞)里采;(英)赖斯; [vt]把.捣成米糊状; [gd]male;
Rich: [a]/rɪtʃ/; [adj](rich) 富有的;肥沃的;昂贵的; [gd]male;
Rick: [a]/rɪk/; [n](Rick) (英,美,德)里克(人名); [gd]male;
Rob: [a]/rɒb/; v. 抢劫,掠夺;(非正式)敲诈;(非正式)盗窃;使..丧失,非法剥夺;(英足)夺(对手)的球; [gd]male;
Robin: [a]/ˈrɑːbɪn/; [n]罗宾(人名); [gd]male;
Rochester: [a]/ˈrɑːtʃɪstər/; [n]罗契斯特市(美国明尼苏达州一城市);罗契斯特市(美国纽约州港市);罗契斯特市(英国东南部一城市); [gd]male;
Rock: [a]/rɒk/; [n](Rock)人名;(英,德,匈,意,瑞典)罗克; [vt]摇动;使摇晃; vi. 摇动;摇晃; [gd]male;
Rockwell: [a]/'rɒk,wel/; [n]罗克韦尔(美国公司);洛克威尔(姓氏); [gd]male;
Rocky: [a]/ˈrɒki/; [adj]岩石的,多岩石的;坚如岩石的;摇晃的;头晕目眩的; [gd]male;
Rod: [a]/rɒd/; [n](Rod)人名;(英,法,德,捷,希)罗德;(阿拉伯)鲁德;(老)罗; [gd]male;
Roland: [a]/'rolənd/; [n]罗兰(男子名); [gd]male;
Romeo: [a]/ˈrəʊmiəʊ/; [n]罗密欧(莎士比亚悲剧《罗密欧与朱丽叶》之男主角);热恋的男子; [gd]male;
Ron: [a]/rɔn/; abbr. remain overnight 留宿; abbr. 研究法辛烷值(Research Octane Number); [n](Ron)人名;(柬)龙;(英,西,捷,以)罗恩;(朝)论; [gd]male;
Ronnie: [a]/'rɔni/; [n]罗尼(男子名);罗妮(女子名); [gd]male;
Roosevelt: [a]/'rəuzəvelt/; [n]罗斯福(姓氏,美国第26任总统); [gd]male;
Royal: [a]/ˈrɔɪəl/; [n](美,印,英,加,俄,法)罗亚尔(人名); [adj](royal) 英国的;(英国)皇家的; [gd]male;
Royce: [a]/rɔis/; [n]罗伊斯(姓氏); [gd]male;
Rube: [a]/ruːb/; [n](Rube)人名;(德)鲁贝;(英)鲁布; [adj]土里土气的;像乡巴佬的; [gd]male;
Ruby: [a]/ˈruːbi/; [n](Ruby)人名;(法)吕比;(英,西,德,匈,瑞典)鲁比; [adj]红宝石色的; [vt]使带红宝石色; [gd]male;
Ruddy: [a]/ˈrʌdi/; [adj]红的;红润的; [adv]极度;非常; [vt]使变红; vi. 变红; [n](Ruddy)人名;(英)拉迪; [gd]male;
Rudolf: [a]/'ru:dɒlf/; [n]鲁道夫(男子名); [gd]male;
Rudolph: [a]/'ru:dɔlf/; [n]鲁道夫(男子名); [gd]male;
Russ: [a]/rʌs/; [n](美)鲁斯(人名); [adj]俄国的;俄国人的;俄国语的(等于 Russian); [gd]male;
Rusty: [a]/ˈrʌsti/; [adj]生锈的,腐蚀的;铁锈色的,锈色的;迟钝的; [gd]male;
Sal: [a]/sɑːl/; abbr.; [林]婆罗双树(Saltree);盐(salt); [n](Sal)人名;(西,葡,土)萨尔;(柬)萨;(匈)绍尔;(英)萨尔(教名Sara,Sarah的昵称); [gd]male;
Salmon: [a]/ˈsæmən/; [n](Salmon)人名;(意,法,葡,捷)萨尔蒙;(英)萨蒙; [adj]浅澄色的; [gd]male;
Salvador: [a]/'sælvədɔ:/; [n]萨尔瓦多(巴西东部港市); [gd]male;
Sam: [a]/sæm/; [n]萨姆(男子名); [gd]male;
Sammy: [a]/'sæmi/; [n]美国兵;傻瓜;萨米(女子名);塞米(男子名); [gd]male;
Sander: [a]/ˈsændə(r)/; [n](Sander) (荷,瑞,挪,比)桑德尔(人名); [gd]male;
Sandy: [a]/ˈsændi/; [adj]沙地的;多沙的;含沙的; [n](Sandy)人名;(法,喀,罗,西,英)桑迪(教名Alasdair,Alastair,Alexander,Alister,Elshender的昵称); [gd]male;
Sarge: [a]/sɑːdʒ/; [n]警官;军士;军士长; [gd]male;
Saw: [a]/sɔː/; [n]锯;格言; v. 锯;锯成;用锯;乱剪;拉锯似的来回移动; v. 看见;明白,了解(see 的过去式); [gd]male;
Sawyer: [a]/'sɔːjə/; [n](Sawyer)人名;(英,葡)索耶; [gd]male;
Sax: [a]/sæks/; [n](Sax)人名;(英,法,德,瑞典)萨克斯; [gd]male;
Saxon: [a]/ˈsæksn/; [n]撒克逊人; [adj]撒克逊人的; [gd]male;
Say: [a]/seɪ/; [vt]讲;说明;例如;声称;假设;指明; vi. 讲;表示;念;假定;背诵; [n](Say)人名;(土)萨伊;(法,老,柬)赛;(英)塞伊;(匈,罗)绍伊; [gd]male;
Scot: [a]/skɒt/; [n]苏格兰人;苏格兰方言; [gd]male;
Scottie: [a]/ˈskɑːti/; [n]苏格兰人;苏格兰的一种野狗; [gd]male;
Scotty: [a]/'skɔti/; [n]苏格兰狗(等于Scottie); [gd]male;
See: [a]/siː/; [vt]看见;理解;领会; vi. 看;看见;领会; [n](See)人名;(英)西伊;(柬)塞;(德)泽; [gd]male;
Serge: [a]/sɜːdʒ/; [n](Serge)人名;(德,罗)泽格;(法)塞尔日;(英)瑟奇; [vt]粗缝...的毛边;锁(毛边); [gd]male;
Sergeant: [a]/ˈsɑːdʒənt/; [n](Sergeant)人名;(英)萨金特;(法)塞尔让; [gd]male;
Seth: [a]/seɪt/; [n]赛斯(男子名); [gd]male;
Shadow: [a]/ˈʃædəʊ/; [n]阴影;影子;幽灵;庇护;隐蔽处; [vt]遮蔽;使朦胧;尾随;预示; vi. 渐变;变阴暗; [adj]影子内阁的; [gd]male;
Shamus: [a]/'ʃeɪməs/; [n]私家侦探;警察; [gd]male;
Shaw: [a]/ʃɔː/; [n](Shaw)人名;(中)邵(普通话-威妥玛);(英,德)肖; [gd]male;
Shay: [a]/ʃeɪ/; [n](Shay)人名;(英)谢伊; [gd]male;
Shell: [a]/ʃel/; 壳牌(石油化工公司名); [gd]male;
Shem: [a]/ʃem/; [n]闪(基督教《圣经》中挪亚的长子,被认为是闪米特人的祖先); [gd]male;
Shepherd: [a]/ˈʃepərd/; [n](shepherd) 牧羊人;牧师;德国牧羊犬; v. (shepherd) 牧(羊);带领;(尤指精神方面)给..指导; [gd]male;
Sherwood: [a]/'ʃɝwud/; [n]舍伍德(姓氏,男子名); [gd]male;
Shorty: [a]/ˈʃɔːti/; [n](Shorty)人名;(英)肖蒂; [gd]male;
Si: [a]/ˌes ˈaɪ/; abbr. 硅(silicon); [gd]male;
Sibyl: [a]/ˈsɪbl/; [n](Sibyl)人名;(英)西比尔; [gd]male;
Sid: [a]/sid/; abbr. 电离层突然骚动(sudden ionospheric disturbance); [n](Sid)人名;(英,阿拉伯,瑞典)锡德; [gd]male;
Siddhartha: [a]/sid'dɑ:tə/; [n]悉达多(教创始人释迦牟尼的本名);流浪者之歌(书名); [gd]male;
Sidney: [a]/ˈsɪdnɪ/; [n]西德尼(男子名);茜德尼(女子名); [gd]male;
Siegfried: [a]/'zɪkfrit/; [n]齐格弗里德(德国民间史诗尼贝龙根之歌中的英雄人物); [gd]male;
Sig: [a]/sɪɡ/; [n](Sig) (美,加,瑞典)西(人名); [gd]male;
Sigmund: [a]/'sɪgmənd/; [n]西格蒙德(男子名); [gd]male;
Silvan: [a]/'sɪlvən/; [adj](诗/文)森林的,树木多的;田园的;生活在森林中的(等于 sylvan); [n](Silvan) (瑞,巴,美,荷)希尔文(人名); [gd]male;
Silvanus: [a]/sil'veinəs/; [n]西尔瓦诺斯(古罗马神话中的森林田野之神); [gd]male;
Simeon: [a]/ˈsɪmɪən/; [n]西米恩(男子名);西面(圣经中的人物); [gd]male;
Skip: [a]/skɪp/; vi. 跳跃;跳绳;遗漏;跳读; [vt]跳过;遗漏; [n](Skip)人名;(英)斯基普; [gd]male;
Skipper: [a]/ˈskɪpə(r)/; [n](Skipper)人名;(英)斯基珀; [vt]带领;作.的船长(或机长); [gd]male;
Sky: [a]/skaɪ/; [n](Sky)人名;(英)斯凯; [vt]把.投向空中;把.挂得过高; vi. 踢或击高空球;把桨叶翘得过高;飞涨; [gd]male;
Skye: [a]/skai/; [n]匐犬(一种猎狐犬);斯凯岛(苏格兰西部的岛); [gd]male;
Slim: [a]/slɪm/; [n](比,法)斯利姆(人名); [adj](slim) 苗条的;修长的;微小的;差的; v. (slim) 使.体重减轻;使.苗条;减轻体重;变细; [gd]male;
Sly: [a]/slaɪ/; [n](Sly) (美)斯莱(人名); [gd]male;
Smith: [a]/smɪθ/; [n]史密斯(男子姓氏); [gd]male;
Socrates: [a]/'sɔkrəti:z/; [n]苏格拉底(古希腊哲学家); [gd]male;
Sol: [a]/sɒl/; [n]索尔(男子名,等于Solomon);(罗马神话)太阳神;黄金; [gd]male;
Somerset: [a]/'sʌməsɛt/; [n](Somerset)人名;(英)萨默塞特; [gd]male;
Son: [a]/sʌn/; [n](Son)人名;(土,老,柬)松;(法,罗)索恩;(日)存(名);(日)孙(姓);(越)山; [gd]male;
Sonny: [a]/ˈsʌni/; [n](Sonny)人名;(英,西)桑尼; [gd]male;
Sparky: [a]/ˈspɑːrki/; [adj]活泼的,充满活力的; [gd]male;
Spenser: [a]/'spensə/; [n]斯宾塞(男子名); [gd]male;
Spike: [a]/spaɪk/; [n](Spike)人名;(瑞典)斯皮克; [vt]阻止;以大钉钉牢;用尖物刺穿; [gd]male;
Spud: [a]/spʌd/; [n]马铃薯;小锄头;剥取树皮用的刀; [vt]用小锄头挖掘; [gd]male;
Stafford: [a]/'stæfəd/; [n]斯塔福郡(英格兰中西部一郡); [gd]male;
Stanford: [a]/'stænfərd/; [n]斯坦福(姓氏,男子名);斯坦福大学(美国一所大学); [gd]male;
Sterling: [a]/ˈstɜːlɪŋ/; [n](Sterling) (美,爱,英)斯特林(人名); [adj]优秀的;(银)标准纯度的;英币的;纯银制的; [gd]male;
Stern: [a]/stɜːn/; [adj]严厉的;坚定的;严峻的;认真的; [n](Stern) (英,以,法,瑞典,西)斯特恩(人名); [gd]male;
Stew: [a]/stjuː/; [n](Stew) (英,美,加,俄)斯图(人名); [gd]male;
Steward: [a]/ˈstjuːəd/; [n](Steward)人名;(英)斯图尔德; [vt]管理; [gd]male;
Sting: [a]/stɪŋ/; [n](Sting)人名;(英)斯廷;(德)施廷; [vt]刺;驱使;使.苦恼;使.疼痛; vi. 刺痛;被刺痛;感到剧痛; [gd]male;
Stinky: [a]/ˈstɪŋki/; [n]斯丁(男子名); [gd]male;
Stu: [a]/stju:/; [n]斯图(男子名,等于Stuart); [gd]male;
Sully: [a]/ˈsʌli/; [vt]玷污;使丢脸; [n](Sully)人名;(英)萨利;(法)苏利; [gd]male;
Sunny: [a]/ˈsʌni/; [adj]阳光充足的,和煦的;快活的;性情开朗的; [gd]male;
Syd: [a]/sid/; [n]悉德(男子名); [gd]male;
Sydney: [a]/ˈsɪdni/; [n]悉尼(澳大利亚港市); [gd]male;
Sylvan: [a]/ˈsɪlvən/; [adj]森林的;农村的; [n](Sylvan)人名;(英,葡,瑞典)西尔万; [gd]male;
Tab: [a]/tæb/; [n]标签;制表;帐单; [vt]给.贴标签; [gd]male;
Tabby: [a]/ˈtæbi/; [n]平纹;斑猫;长舌妇; [adj]起波纹的;有斑纹的; [vt]使起波纹; [gd]male;
Tad: [a]/tæd/; [n](Tad)人名;(英)塔德; [gd]male;
Tailor: [a]/ˈteɪlə(r)/; [n](Tailor) (美,爱,英)泰勒(人名); [gd]male;
Tally: [a]/ˈtæli/; [n](Tally)人名;(英)塔利; [vt]使符合;计算;记录; vi. 一致;记分; [gd]male;
Tam: [a]/tæm/; [n](Tam)人名;(英,意,阿拉伯,尼日利)塔姆;(柬)丹; [gd]male;
Tamas: [a]/'təməs/; [n]答摩; [gd]male;
Tammy: [a]/'tæmɪ/; [n](Tammy)人名;(英)塔米; [gd]male;
Tan: [a]/tæn/; [n](Tan)人名;(俄,土,土库,吉尔)塔恩;(英)坦;(柬,老)丹; [vt]鞣(革);晒成褐色; vi. 晒成棕褐色; [adj]黄褐色的;鞣皮的; [gd]male;
Tarzan: [a]/ˈtɑːzæn/; [n]泰山(美国影片人猿泰山的主人公);健壮,灵活的男子; [gd]male;
Ted: [a]/ted/; [n](Ted) (美)泰德 (人名); [gd]male;
Teddy: [a]/'tedɪ/; [n](Teddy)人名;(罗)特迪; [gd]male;
Temple: [a]/ˈtempl/; [n](Temple)人名;(法)唐普勒;(英)坦普尔; [gd]male;
Terence: [a]/'terəns/; [n]特伦斯(男子名); [gd]male;
Terry: [a]/ˈteri/; [n](Terry)人名;(英,西,葡,法,塞)特里; [adj]起毛毛圈的; [gd]male;
Thaddeus: [a]/θæ'di:əs; 'θædi-/; [n]撒迪厄斯(男子名); [gd]male;
Thane: [a]/θeɪn/; [n](Thane)人名;(英)塞恩;(缅)丹; [gd]male;
Thatch: [a]/θætʃ/; [n](Thatch)人名;(英)萨奇; [vt]用茅草覆盖屋顶; [gd]male;
Thatcher: [a]/ˈθætʃə(r)/; [n]撒切尔(夫人)(英国前首相); [gd]male;
Thor: [a]/θɔː/; [n]托尔(北欧神话中司雷,战争及农业的神);《雷神》(电影名); [gd]male;
Thorn: [a]/θɔːn/; [n](Thorn)人名;(柬)通;(英)索恩;(法,德,丹,瑞典)托恩; [植]荆棘; [gd]male;
Thorny: [a]/ˈθɔːni/; [adj]多刺的;痛苦的;令人苦恼的; [gd]male;
Tiler: [a]/ˈtaɪlər/; [n](Tiler)人名;(土)蒂莱尔; [gd]male;
Tim: [a]/tɪm/; [n]蒂姆(男子名); [gd]male;
Timothy: [a]/'tɪməθɪ/; [n] [植]梯牧草; [gd]male;
Tito: [a]/'ti:təu/; [n]提托(男子名); [gd]male;
Tobit: [a]/'təubit/; [n]托比特书(《圣经旧约》中《外典》之一卷); [gd]male;
Toby: [a]/'təubi/; [n]矮胖老人形啤酒杯;托比(男子名); [gd]male;
Toddy: [a]/ˈtɒdi/; [n]棕榈汁;棕榈酒; [gd]male;
Tome: [a]/təʊm/; [n](Tome) (美,巴西,西,葡)托梅(人名); [gd]male;
Tommy: [a]/ˈtɒmi/; [n](Tommy)人名;(英,瑞典,法)汤米; [gd]male;
Tony: [a]/ˈtəʊni/; [n]托尼(男名); [gd]male;
Tore: [a]/tɔː(r)/; [vt]撕开(tear的过去式); [n](Tore)人名;(西,瑞典,挪,葡)托雷; [gd]male;
Torr: [a]/tɔː/; [n](Torr)人名;(英)托尔; [gd]male;
Town: [a]/taʊn/; [n](Town)人名;(英)汤; [gd]male;
Townie: [a]/ˈtaʊni/; [n](非正式)城里人;大学城里的普通居民;城市小流氓; [gd]male;
Towny: [a]/'taʊnɪ/; [n](非正式)城里人;大学城中的非学生居民;粗野(或好斗的)年轻人(等于 townie); [gd]male;
Trace: [a]/treɪs/; v. (trace)(通过调查)找到,发现;追溯,追究;追踪,跟踪;沿(特定路径)走;描绘(事物的过程或发展);追述,记述;画(线);勾画出(轮廓);复制,描摹; [n](Trace) (美)塔斯(人名); [gd]male;
Tray: [a]/treɪ/; [n]托盘;文件盒;隔底匣;(无线电的)发射箱; [gd]male;
Trenton: [a]/'trentən/; [n]特伦顿(美国新泽西州首府); [gd]male;
Trey: [a]/treɪ/; [n](Trey) 特雷(人名); [gd]male;
Trip: [a]/trɪp/; [n](Trip) (美)特里普(人名); [gd]male;
Tristan: [a]/'trɪstæn/; [n]特里斯坦(人名); [gd]male;
Troy: [a]/trɔɪ/; [n]特洛伊(小亚细亚西北部的古城);特洛伊(美国纽约州一城市); [gd]male;
Truman: [a]/'tru:mən/; [n]杜鲁门(男子名); [gd]male;
Tuck: [a]/tʌk/; [n](tuck) (衣服的)褶,裥;减脂手术; [gd]male;
Tudor: [a]/ˈtjuːdə(r)/; [adj]都铎王朝时代的;都铎式建筑式样的;都铎王室的; [n](Tudor) (英,罗,克)都铎(人名); [gd]male;
Tyrone: [a]/ti'rəun/; [n]蒂龙(男名); [gd]male;
Ulysses: [a]/ju(:)'lisi:z/; [n]尤里西斯(希腊神话中男子名,也是爱尔兰意识流文学作家詹姆斯-乔伊斯小说名); [gd]male;
Urban: [a]/ˈɜːrbən/; [n](美,德,波)乌尔班(人名); [adj](urban) (与)城市(有关)的;有城市特色的;住在都市的;黑人音乐的; [gd]male;
Uri: [a]/ˌjuː ɑːr ˈaɪ/; abbr. 上呼吸道感染(Upper Respiratory Infection);统一资源标识符(Uniform Resource Identifier); [n](Uri)人名;(英)尤里;(日)宇利(姓);(德,西,匈,以,意)乌里;(法)于里; [gd]male;
Uriah: [a]/,juə'raiə/; [n]尤赖亚(男子名); [gd]male;
Uriel: [a]/'juəriəl/; [n]乌列; [gd]male;
Vail: [a]/veɪl/; v. 放下,脱下;脱帽致敬;使下降(某物);(avail 的另一种拼写)有利; [n](Vail) (美,巴,俄)韦尔(人名); [gd]male;
Val: [a]/væl/; [n]瓦珥(女子名);瓦尔(男子名); [gd]male;
Vale: [a]/veɪl/; [n](Vale)人名;(葡,塞,意)瓦莱;(英)韦尔;(挪)瓦勒; [gd]male;
Valentine: [a]/ˈvæləntaɪn/; [n]瓦伦丁(姓氏); [gd]male;
Van: [a]/væn/; [n](Van)人名;(老,泰,柬,缅)万; [vt]用车搬运; [gd]male;
Verge: [a]/vɜːdʒ/; [n](Verge) (英,美,法,加,西)贝尔赫(人名); [gd]male;
Vic: [a]/vɪk/; [n](Vic)人名;(英,法)维克;(西)比克; [gd]male;
Victor: [a]/ˈvɪktə(r)/; [n](Victor)人名;(俄,罗,保,匈)维克托; [gd]male;
Vince: [a]/vins/; [n]文斯(男子名,Vincent的昵称); [gd]male;
Vladimir: [a]/ˈvlædɪˌmɪə/; [n]弗拉基米尔(古罗斯弗拉基米尔-苏兹达里公国的古都); [gd]male;
Voltaire: [a]/vɔl'ter/; [n]伏尔泰(法国启蒙思想家,哲学家,作家,历史学家); [gd]male;
Von: [a]/vɒn/; [n](Von) (美,菲)文(人名); [gd]male;
Wade: [a]/weɪd/; [n]韦德(男子名); [gd]male;
Wain: [a]/weɪn/; [n](Wain)人名;(英)韦恩; [gd]male;
Wait: [a]/weɪt/; [vt]等候;推迟;延缓; vi. 等待;耽搁;伺候用餐; [n](Wait)人名;(英)韦特;(捷)魏特; [gd]male;
Waiter: [a]/ˈweɪtə(r)/; [n]服务员,侍者; [gd]male;
Wake: [a]/weɪk/; vi. 醒来;唤醒;警觉; [vt]叫醒;激发; [n](Wake)(英)韦克(人名); [gd]male;
Waldo: [a]/'wɔːldəʊ/; [n]沃尔多(男子名); [gd]male;
Wally: [a]/ˈwɒli/; [n](Wally) (美,英,加,比,丹)沃利(人名); [adj]好的;第一流的;巨大的,高大的;强壮的;令人喜爱的;中国制造的; [gd]male;
Ward: [a]/wɔːd/; [n](Ward)人名;(英)沃德;(德,芬,瑞典,葡)瓦尔德; [vt]避开;保卫;守护; [gd]male;
Warden: [a]/ˈwɔːdn/; [n](Warden)人名;(德,瑞典)瓦尔登;(英)沃登; [gd]male;
Ware: [a]/weə(r)/; [n](Ware)人名;(罗)瓦雷;(英,加纳)韦尔;(日)吾(姓); [vt]留心;小心; [gd]male;
Warren: [a]/ˈwɒrən/; [n]沃伦(男子名);沃伦(美国密歇根州东南部城市);沃伦(美国俄亥俄州东北部城市); [gd]male;
Wash: [a]/wɒʃ/; v. 洗涤;洗澡;耐洗;洗刷;冲走;拍打;浸湿;(情绪)冲击;洗矿;粉刷;站得住脚;被冲蚀; [n](Wash) (美)瓦什(人名); [gd]male;
Wat: [a]/wat/; [n](Wat) 沃特(人名); [gd]male;
Way: [a]/weɪ/; [n](Way)人名;(中)见 Wei;(英,缅)韦; [adv]大大地;远远地; [adj]途中的; [gd]male;
Wayland: [a]/'weɪlənd/; [n]韦兰(日耳曼和英国民间传说中的隐身铁匠);卫兰德; [gd]male;
Web: [a]/web/; [n]网;卷筒纸;蹼;织物;圈套; [vt]用网缠住;使中圈套; vi. 形成网; [gd]male;
Weber: [a]/ˈveɪbə(r)/; [n](Weber)人名;(英,法,德,葡,罗,匈,捷,芬,瑞典)韦伯; [gd]male;
Welsh: [a]/welʃ/; [adj]威尔士(人)的,威尔士语的; [n]威尔士语;威尔士人; [gd]male;
Wes: [a]/wes/; [n]韦斯(Wesley的昵称,男子名); [gd]male;
West: [a]/west/; [n](West)人名;(英,德,芬,瑞典)韦斯特; [adj]西方的;朝西的; [adv]在西方;向西方;自西方; [gd]male;
Whit: [a]/wɪt/; [n](Whit)人名;(英)惠特; [gd]male;
Will: [a]/wɪl/; [n]威尔(男子名); [gd]male;
William: [a]/ˈwɪljəm/; [n]威廉(男子名);钞票,纸币; [gd]male;
Willy: [a]/ˈwɪli/; [n](Willy)人名;(英)威利;(法,德,罗,丹,葡,西)维利; [gd]male;
Wilt: [a]/wɪlt/; v. 枯萎,凋谢;变得萎靡不振,失去自信;将(草,饲料等)晒成半干; [n](Wilt) (美)威尔特(人名); [gd]male;
Win: [a]/wɪn/; [vt]赢得;在.中获胜;劝诱; vi. 赢;获胜;成功; [n](Win)人名;(德,荷,缅)温;(英)温(女子教名Winifred的昵称); [gd]male;
Wit: [a]/wɪt/; [n](Wit)人名;(泰)威;(英,德,波)威特; [gd]male;
Witty: [a]/ˈwɪti/; [adj]诙谐的;富于机智的; [n](Witty)人名;(英)威蒂; [gd]male;
Wolf: [a]/wʊlf/; [n](Wolf)人名;(以,捷,芬,瑞典,德,匈,法,罗,荷,英)沃尔夫; [vt]大吃;狼吞虎咽地吃; [gd]male;
Wolfgang: [a]/'wulfɡæŋ/; [n]沃尔夫冈(男子名); [gd]male;
Wolfram: [a]/'wʊlfrəm/; [n](Wolfram)人名;(英,匈,芬,德,瑞典)沃尔弗拉姆; [化学]钨(金属元素,符号 W);钨锰铁矿; [gd]male;
Wood: [a]/wʊd/; [n](Wood)人名;(英,法,西,葡,阿拉伯)伍德; [vt]植林于;给.添加木柴; [gd]male;
Woody: [a]/ˈwʊdi/; [n](woody) 阴茎勃起; [adj](woody) 木质的;多树木的;木头似的; [gd]male;
Worth: [a]/wɜːθ/; [adj]值.的; [n](Worth)人名;(英)沃思;(德)沃特; [gd]male;
Worthy: [a]/ˈwɜːði/; [adj]值得的;有价值的;配得上的,相称的;可尊敬的;应.的; [n](Worthy)人名;(英)沃西; [gd]male;
Wright: [a]/raɪt/; [n]赖特(姓氏); [gd]male;
Yank: [a]/jæŋk/; [n]美国人(等于Yankee); [gd]male;
Yankee: [a]/ˈjæŋki/; [n]美国佬,美国人;洋基队(美国棒球队名); [gd]male;
Yard: [a]/jɑːd/; [n](Yard)人名;(英)亚德; [vt]把.关进或围在畜栏里; [gd]male;
Yehudi: [a]/'jehudi/; [n]指向标触发发射机; [gd]male;
Yule: [a]/juːl/; [n](Yule)人名;(英)尤尔; [gd]male;
Zachary: [a]/'zækəri/; [n]圣扎迦利(等于Zacharias,Saint);扎卡里(男子名); [gd]male;
Zebedee: [a]/'zebidi/; [n]西庇太(《圣经-马太福音》中人物); [gd]male;
Zechariah: [a]/,zekə'raiə/; [n]撒迦利亚(希伯来一先知);撒迦利亚书(圣经旧约中一书);泽卡赖亚(男子名); [gd]male;
Zed: [a]/zed/; [n](Zed) (俄,美)泽德(人名); [gd]male;
Zedekiah: [a]/,zedi'kaiə/; [n]西底家(公元前6世纪犹太国末代国王); [gd]male;
Zerk: [a]/zə:k/; [n]加油嘴; [gd]male;
Zeus: [a]/zju:s/; [n]宙斯(希腊神话中的主神); [gd]male;
Zippy: [a]/ˈzɪpi/; [adj]敏捷的;活泼的;喜悦的; [n]齐皮士;齐皮派成员; [gd]male;
Abbe: [a]/'æbi, 'ɑ:bə/; [n](Abbe)人名;(英,德,瑞典)阿贝; [gd]female;
Abigail: [a]/'æbɪgeɪl/; [n]阿比盖尔(女名); [gd]female;
Acacia: [a]/əˈkeɪʃə/; [n](Acacia)人名;(意)阿卡恰; [gd]female;
Ada: [a]/e di e/; [n]艾达(女子名); [gd]female;
Adaline: [a]/'ædəlin/; [n]学习机,适应机;线性适应元; [gd]female;
Adelaide: [a]/ˈædəleɪd/; [n]阿德莱德(女子名,澳大利亚港市); [gd]female;
Adele: [a]/ə'del/; [n]阿黛尔(女子名); [gd]female;
Adina: [a]/ə'di:nə/; [n]艾迪娜(女子名); [gd]female;
Adore: [a]/əˈdɔː(r)/; [vt]崇拜;爱慕;喜爱;极喜欢; vi. 崇拜;爱慕; [n](Adore)人名;(法)阿多尔; [gd]female;
Ag: [a]/æx,ʌx/; abbr. 八月(August); symb. 银(silver); [gd]female;
Agnes: [a]/'æɡnɪs/; [n]艾格尼丝(女子名); [gd]female;
Aida: [a]/'eɪdə/; [n]阿伊达(女子名);《阿伊达》(意大利歌剧家威尔第的一部歌剧); [gd]female;
Alameda: [a]/,ælə'meɪdə/; [n](Alameda)人名;(西,葡)阿拉梅达; [gd]female;
Alberta: [a]/ælˈbɜːtə/; [n]亚伯达(加拿大西部的一个省); [gd]female;
Alexa: [a]/ə'leksə/; [n]一家专门发布网站世界排名的网站;亚莉克莎(女子名); [gd]female;
Alexandra: [a]/,ælɪɡ'zɑ:ndrə/; [n]亚历山德拉(女子名,义为男人的保护者); [gd]female;
Alexia: [a]/əˈleksiə; eɪˈleksiə/; [n](Alexia)人名;(英)亚历克西娅; [内科]失读症; [gd]female;
Alia: [a]/ˈeɪliːə/; [n]艾莉雅(人名); [gd]female;
Alice: [a]/'ælɪs/; [n]爱丽丝(女子名); [gd]female;
Aline: [a]/ə'laɪn/; [n](Aline) (法,英,葡,亚)艾琳(人名); [gd]female;
Alison: [a]/'ælisən/; [n]艾莉森(女子名); [gd]female;
Allene: [a]/'æli:n/; [n] [有化]丙二烯; [gd]female;
Ally: [a]/ˈælaɪ/; [n](Ally)人名;(巴基)阿利;(法)阿利;(英)艾丽(女子教名 Alice 的简称);(尼日利)阿利; [vt]使联盟;使联合; vi. 联合;结盟; [gd]female;
Alma: [a]/ælmə/; [n]阿尔玛(女子名);舞女;歌女; [gd]female;
Althea: [a]/æl'θi:ə/; [n](Althea)人名;(英)奥尔西娅; [gd]female;
Amanda: [a]/ə'mændə/; [n]阿曼达(女子名); [gd]female;
Amara: [a]/'æmərə/; [n](Amara)人名;(日)甘良(姓);(英,法,西,阿拉伯)阿玛拉 (女名), 阿马拉; [药]苦味药; [gd]female;
Amber: [a]/ˈæmbər/; [n]安布尔(女子名); [gd]female;
Ambrosia: [a]/æmˈbrəʊziə/; [n]特别美味的食物;神的食物; [gd]female;
Amelia: [a]/ə'miljə/; [n] [外科]缺肢; [gd]female;
Ami: [a]/ɑ:'mi:/; abbr. 高级材料情报(Advanced Material Information);美国食用肉类研究所(American Meat Institute);航空英里指示器(Air Mileage Indicator); [n](Ami)人名;(匈)奥米;(法,西,以,德)阿米; [gd]female;
Amie: [a]/ɑ:'mi:/; [n](Amie)人名;(南非)阿米; [gd]female;
Amity: [a]/ˈæməti/; [n](Amity)人名;(英,中非)阿米蒂; [gd]female;
Ana: [a]/'ɑːnə/; [n](Ana)人名;(土,葡,塞,西,罗)安娜 (女名), 阿纳; [gd]female;
Anastasia: [a]/,ænə'steizjə; ,ɑ:nə'stɑ:ʃə/; [n]阿纳斯塔西娅(女子名); [gd]female;
Andromache: [a]/æn'drɔməki/; [n]安德洛玛刻(赫克托耳的忠实妻子); [gd]female;
Andromeda: [a]/æn'drɒmɪdə/; [n] [天]仙女座;安德洛墨达(希腊神话中的埃塞俄比亚公主); [gd]female;
Angelica: [a]/ænˈdʒelɪkə/; [n](Angelica)人名;(葡)安热莉卡;(西)安赫莉卡;(罗,意,波)安杰莉卡; [gd]female;
Angelina: [a]/,ændʒi'li:nə/; [n]安吉莉娜(女子名); [gd]female;
Angelique: [a]/,ændʒə'li:k/; [n]安琪莉可(女子名);百劫红颜(电影名称); [gd]female;
Ann: [a]/æn/; [n]安(女子名); [gd]female;
Anna: [a]/ˈʌnə/; [n]安娜(女子名); [gd]female;
Antoinette: [a]/,æntwɑ:'net/; [n]安托瓦内特(女子名); [gd]female;
Antonia: [a]/æn'təuniə/; [n]安东尼娅(女子名); [gd]female;
Aphrodite: [a]/,æfrə'daɪti/; [n]阿佛洛狄特(司爱与美之女神); [gd]female;
April: [a]/ˈeɪprəl/; [n]四月; [gd]female;
Ara: [a]/'erə/; abbr. 非洲铁路协会(African Railway Association);机载雷达附件(Airborne Radar Attachment); [n](Ara)人名;(土,意,英,法,西,阿塞,土库)阿拉; [gd]female;
Ardella: [a]/ɑ:'delə/; [n]阿黛拉(女子名,等于Ardelle); [gd]female;
Arden: [a]/'a:dn/; [n]昔时阿尔丁的森林地带;浪漫的地方; [gd]female;
Ariadne: [a]/,æri'ædni/; [n]阿里阿德涅;阿丽雅德妮(女子名); [gd]female;
Asia: [a]/ˈeɪʒə; ˈeɪʃə/; [n]亚洲; [gd]female;
Atalanta: [a]/,ætə'læntə/; [n]阿塔兰特(捷足善走的美女,希腊神话中的一个形象); [gd]female;
Athena: [a]/əˈθiːnə/; [n]雅典娜(智慧与技艺的女神); [gd]female;
Athene: [a]/ə'θi:ni:/; [n]雅典娜(智慧与技艺的女神); [gd]female;
Atlanta: [a]/ætˈlæntə/; [n]亚特兰大(美国城市); [gd]female;
Audi: [a]/'ɔ:di:/; [n]奥迪公司;奥迪汽车; [gd]female;
Augusta: [a]/ɔːˈɡʌstə/; [n]奥古斯塔(美国一城市名); [gd]female;
Auguste: [a]/au'ɡu:st/; [n]奥古斯特(姓氏); [gd]female;
Aura: [a]/ˈɔːrə/; [n](Aura)人名;(芬,罗,阿拉伯,意,西,法,以)奥拉; [gd]female;
Aurelia: [a]/ɔ:'ri:ljə/; [n](Aurelia)人名;(俄)奥列利娅;(意,西,德,罗)奥雷利娅;(英)奥里莉亚; [gd]female;
Aurora: [a]/ɔː'rɔːrə/; [n]奥罗拉(女子名);奥罗拉(曙光女神);奥罗拉(美国城市); [gd]female;
Ava: [a]/əˈvɔː/; abbr. 自动话频警报器(automatic voice alarm);视听教具(audiovisual aids); [n](Ava)人名;(英)阿娃;(俄,加蓬,伊朗)阿瓦; [gd]female;
Babs: [a]/bæbz/; [n]芭布斯(女子名,等于Barbara,Babette); [gd]female;
Bambi: [a]/ˈbæmbɪɜ/; [n]小鹿斑比(动画片名); [gd]female;
Barb: [a]/bɑːb/; [n](Barb) (美,罗,法)巴尔布(人名); [gd]female;
Barbette: [a]/bɑː'bet/; [n] [军]炮座;炮塔; [gd]female;
Barbie: [a]/ˈbɑːrbi/; [n]芭比(女子名);芭比娃娃(商标名); [gd]female;
Bathsheba: [a]/bæθ'ʃibɚ/; [n]所罗门王; [gd]female;
Bea: [a]/bi:; biə/; abbr. 东亚银行有限公司(Bank of East Asia Ltd);美国劳工部劳工统计局(Bureau of Economic Analysis);英国欧洲航空公司(British European Airways Corporation); [n](Bea)人名;(德,西,意)贝亚; [gd]female;
Beatrice: [a]/'biətris; 'bi:tris/; [n]比阿特丽斯(女子名);碧翠斯(女子名); [gd]female;
Becky: [a]/'beki/; [n](Becky) (美)贝基(人名); [gd]female;
Bee: [a]/biː/; [n](Bee)人名;(赤几)贝埃;(东南亚国家华语)美;(英)比(女子教名Beatrix和Beatrice的昵称); [gd]female;
Bel: [a]/bel/; [n](Bel)人名;(英,法,德,西,葡); [物] [计量]贝尔; [gd]female;
Belinda: [a]/bə'lində/; [n]比琳达(女子名); [gd]female;
Bell: [a]/bel/; [n]铃,钟;钟声,铃声;钟状物; [vt]装钟于,系铃于; vi. 鸣钟;成钟状鼓起; [gd]female;
Belle: [a]/bel/; [n](Belle) (美,法)贝莱(人名); [gd]female;
Beret: [a]/ˈbereɪ/; [n](Beret)人名;(西)贝雷特; [gd]female;
Bernardine: [a]/'bə:nədin/; [n]伯尔纳会僧侣; [adj]伯尔纳会的;圣伯尔纳的; [gd]female;
Berry: [a]/ˈberi/; [n](Berry)人名;(法,英,德,意,葡)贝里;(匈)拜里; [gd]female;
Bertha: [a]/'bɜːθə/; [n]贝莎(女子名); [gd]female;
Beryl: [a]/ˈberəl/; [n]贝丽尔(女子名); [gd]female;
Bessie: [a]/ˈbesi/; [n]贝茜(女子名); [gd]female;
Beth: [a]/beiθ; beθ/; [n]贝丝(女子名,等于Elizabeth); [gd]female;
Betta: [a]/'betə/; [n](Betta)人名;(法,意)贝塔;(日)别田(姓); [鱼]搏鱼;搏鱼属的鱼; [gd]female;
Beulah: [a]/'bju:lə/; [n]比乌拉(《旧约》中的以色列的国土); [gd]female;
Bev: [a]/bev/; abbr. 十亿电子伏特(billion electron volts); [gd]female;
Bevvy: [a]/ˈbevi/; [n]饮料(尤指含酒精饮料); [gd]female;
Bianca: [a]/'bi'æŋk; 'bjɑ:ŋkə/; [n]比安卡(女子名); [gd]female;
Biddy: [a]/ˈbɪdi/; [n]小鸡;母鸡;女佣;唠叨的中年妇人; [gd]female;
Bird: [a]/bɜːd/; [n](Bird)人名;(英,西)伯德; [vt]向.喝倒彩;起哄; vi. 猎鸟;观察研究野鸟; [gd]female;
Birdie: [a]/ˈbɜːdi/; [n]小鸟;小鸟球(高尔夫中指某洞的杆数低于标准杆一杆); [vt]高尔夫中以低于标准杆一杆的成绩打进; [gd]female;
Blanch: [a]/blɑːntʃ/; [vt]漂白;使变白; vi. 漂白;发白;变白; [n](Blanch)人名;(英,西)布兰奇;(葡)布兰什;(瑞典)布兰克; [adj]漂白的;银白色的; [gd]female;
Bliss: [a]/blɪs/; [n]必列斯(化妆品品牌); [vt]使欣喜若狂; vi. 狂喜; [gd]female;
Blithe: [a]/blaɪð/; [adj]愉快的;快乐无忧的; [gd]female;
Bonny: [a]/ˈbɑːni/; [n]邦妮(女子名); [gd]female;
Bree: [a]/briː/; [n](Bree)人名;(德,葡)布雷;(英)布里; [gd]female;
Bride: [a]/braɪd/; [n](Bride)人名;(英)布赖德;(法)布里德; [gd]female;
Bridie: [a]/ˈbraɪdi/; [n]布赖迪(男子名); [gd]female;
Brier: [a]/ˈbraɪə(r)/; [n](Brier)人名;(法)布里耶;(西)布列尔;(英)布赖尔; [gd]female;
Briny: [a]/ˈbraɪni/; [adj]海水的;咸的;盐水的; [gd]female;
Brit: [a]/brɪt/; [n]英国人; [gd]female;
Brittany: [a]/'britəni/; [n]布列塔尼(法国西北部一地区); [gd]female;
Bunny: [a]/ˈbʌni/; [n](Bunny)人名;(英)邦尼;(柬)本尼; [gd]female;
Calla: [a]/'kælə/; [n](Calla)人名;(西)卡利亚;(法)卡拉; [gd]female;
Calypso: [a]/kəˈlɪpsəʊ/; [n]海中女神(荷马《奥德赛》中人物); [gd]female;
Camel: [a]/ˈkæml/; [n](Camel)人名;(法)卡梅尔;(阿拉伯)卡迈勒; [畜牧] [脊椎]骆驼;打捞浮筒;工作作风官僚; [adj]驼色的;暗棕色的; vi. 工作刻板平庸; [gd]female;
Camellia: [a]/kəˈmiːliə/; [n]卡梅莉亚(女子名); [gd]female;
Cameo: [a]/ˈkæmiəʊ/; [n](Cameo)人名;(西,意)卡梅奥; [gd]female;
Camilla: [a]/kə'milə/; [n]卡蜜拉(女子名); [gd]female;
Candida: [a]/ˈkændɪdə/; [n]假丝酵母;坎迪德(女子名);念珠菌属; [gd]female;
Candy: [a]/ˈkændi/; [n]坎迪(女子名); [gd]female;
Caprice: [a]/kəˈpriːs/; [n](Caprice)人名;(意)卡普里切; [gd]female;
Carina: [a]/kə'raɪnə; -'riː-/; [n] [天文学]船底(星)座; [生物学]龙骨瓣;龙骨状突起;隆线,脊,隆突;峰板; [gd]female;
Carline: [a]/'kɑːlɪn/; [n](Carline)人名;(英)卡莱恩; [gd]female;
Carmen: [a]/'kɑ:mən/; [n]卡门(女子名); [gd]female;
Carol: [a]/ˈkærəl/; [n](Carol) (英,美,瑞,罗)卡罗尔(人名); [gd]female;
Carolan: [a]/kə'rəulən/; [n]卡罗纶醋酯长丝;卡罗纶(姓氏); [gd]female;
Carolina: [a]/,kærə'laɪnə/; [n]卡罗莱纳州(在美国东南部); [gd]female;
Caroline: [a]/'kærə,laɪn/; [n](女子名)卡洛琳;卡罗琳; [gd]female;
Carrie: [a]/'kærɪ/; [n]卡丽(女名,Caroline的昵称); [gd]female;
Carry: [a]/ˈkæri/; [n](carry) 搬运;携带球;随身携带;水上运输的地方(或路线);进位;转记;球飞行距离;(枪等的)射程; [gd]female;
Cassandra: [a]/kəˈsændrə/; [n]凶事预言家;不为人所信的预言家;卡珊德拉(希腊神话人物); [gd]female;
Cassie: [a]/'kæsi/; [n]凯西(等于Cass,女子名); [gd]female;
Cate: [a]/keɪt/; [n](Cate)人名;(法,德,葡)卡特;(英)凯特; [gd]female;
Catherine: [a]/'kæθrɪn/; [n]凯瑟琳(女子名); [gd]female;
Ceil: [a]/siːl/; v. 给..抹灰泥或装镶板;(用熟石膏,木板等)装天花板; [gd]female;
Celesta: [a]/səˈlestə/; [n](Celesta)人名;(罗)切莱斯塔; [gd]female;
Celeste: [a]/sɪ'lest/; [n]天蓝色;风琴之音节栓; [adj]天蓝色的; [gd]female;
Celestine: [a]/sɪ'lɛstaɪn/; [n]塞莉斯泰因(女子名); [gd]female;
Celia: [a]/'si:ljə/; [n]西莉亚(女子名); [gd]female;
Charity: [a]/ˈtʃærəti/; [n]慈善;施舍;慈善团体;宽容;施舍物; [gd]female;
Charlotte: [a]/ˈʃɑːlət/; [n]法国水果奶油布丁; [gd]female;
Chastity: [a]/ˈtʃæstəti/; [n]贞洁;纯洁;简洁; [gd]female;
Chelsea: [a]/'tʃelsi/; [n]切尔西(伦敦自治城市,为文艺界人士聚居地); [gd]female;
Cherish: [a]/ˈtʃerɪʃ/; [vt]怀有(感情等);抱有(希望等); [gd]female;
Cherry: [a]/ˈtʃeri/; [n](Cherry)人名;(法,阿拉伯)谢里;(英)彻丽(女子教名Charity的昵称); [gd]female;
Chloe: [a]/'kləui/; [n]克洛伊(女子名); [gd]female;
Chrissie: [a]/'krisi/; [n]菊花;克里西(女子名);圣诞节(等于Christmas); [gd]female;
Christabel: [a]/'kristəbel/; [n]克丽斯特贝尔(女子名); [gd]female;
Christen: [a]/ˈkrɪsn/; [vt]为.命名;为.施洗礼; [n](Christen)人名;(法,德,西,丹,挪)克里斯滕;(英)克里森; [gd]female;
Chrysler: [a]/'kraislə/; [n]克莱斯勒(美国产轿车品牌名); [gd]female;
Cicely: [a]/'sɪsɪlɪ/; [n](Cicely) 西塞莉(人名); [gd]female;
Ciel: [a]/siːl/; [n](Ciel)人名;(葡)西埃尔; [gd]female;
Cinderella: [a]/ˌsɪndəˈrelə/; [n]灰姑娘(童话中的一个形象); [gd]female;
Cinnamon: [a]/ˈsɪnəmən/; [n](Cinnamon)人名;(英)辛纳蒙; [adj]肉桂色的,浅黄褐色的; [gd]female;
Cissy: [a]/ˈsɪsi/; [adj]有娘娘腔的,柔弱胆小的; [n](Cissy) (美,德,荷)锡西(人名); [gd]female;
Claudine: [a]/klɔ:'di:n/; [n]克劳丁(等于Claudia,女子名); [gd]female;
Clementine: [a]/ˈkleməntiːn/; [n]克莱芒蒂娜 (1994年发射的环月轨道探测器); [gd]female;
Cleopatra: [a]/,klɪə'pætrə/; [n]克利欧佩特拉(女子名);《埃及艳后》(电影名); [gd]female;
Clio: [a]/'klaiəu/; [n]克莱奥(女子名);克利俄(希腊神话中的缪斯之一); [gd]female;
Clovis: [a]/'kləuvis/; [n]克罗维斯;克洛维斯;克洛维(法国国王); [gd]female;
Colleen: [a]/kɒˈliːn/; [n](Colleen)人名;(英)科琳; [gd]female;
Collie: [a]/ˈkɒli/; [n](Collie) (美,加,澳)科利(人名); [gd]female;
Colly: [a]/'kɒlɪ/; v. 把..弄脏; [n](Colly) (法,美,英)科利(人名); [gd]female;
Con: [a]/kɒn/; v. 欺骗,哄骗;指挥(船)的驾驶;熟读,默记; [n](Con) (美,澳,加,英)措恩(人名); [adv]反面地; [adj]欺诈的; prep. 以..; [gd]female;
Concordia: [a]/'kɔŋkɔ:diə/; [n]肯考迪娅(女子名); [gd]female;
Constance: [a]/'kɔnstəns/; [n]康士坦茨湖(位于瑞士,德国和奥地利交界处); [gd]female;
Constancy: [a]/ˈkɒnstənsi/; [n]坚定不移;恒久不变; [gd]female;
Cookie: [a]/ˈkʊki/; [n]饼干;小甜点; [gd]female;
Cora: [a]/'kɔ:rə/; [n]科拉; [gd]female;
Coral: [a]/ˈkɒrəl/; [n](Coral)人名;(英,法,西,葡)科拉尔; [adj]珊瑚的;珊瑚色的; [gd]female;
Cordelia: [a]/kɔ:'di:ljə/; [n]科迪莉亚(女子名);天卫六(环绕天王星运行的一颗卫星); [gd]female;
Corella: [a]/kəˈrɛlə/; [n](Corella) (美)科雷拉(人名); [gd]female;
Corny: [a]/ˈkɔːni/; [adj]谷类的;粗野的;陈腐的;乡下味的; [n](Corny)人名;(法)科尔尼;(英)科尼(男子教名Connor,Cornelius 的昵称); [gd]female;
Crista: [a]/'krɪstə/; [n](Crista)人名;(英)克里斯塔,克丽丝塔(女名);(罗,葡)克里斯塔; [生物]脊,冠; [gd]female;
Crystal: [a]/ˈkrɪstl/; [n](Crystal)人名;(英)克里斯特尔,克丽丝特尔 (女名); [adj]水晶的;透明的,清澈的; [gd]female;
Cynthia: [a]/'sinθiə/; [n]月亮;月亮女神; [gd]female;
Dacia: [a]/'deiʃə/; [n]达契亚(今罗马尼亚中北部和西部的古王国);达契亚(汽车品牌名); [gd]female;
Dagmar: [a]/'dæɡmɑ:/; [n]达格玛(女子名); [gd]female;
Dahlia: [a]/ˈdeɪliə; ˈdɑːliə/; [n](Dahlia)人名;(英)戴利娅;(西)达利亚,达利娅(女名); [gd]female;
Daisy: [a]/ˈdeɪzi/; [n]黛西(女子名); [gd]female;
Damara: [a]/'də'mɑ:rə/; [n](住在纳米比亚达马拉兰的)达马拉人;达马拉语; [gd]female;
Daphne: [a]/'dæfnɪ/; [n]瑞香;达芙妮(女名); [gd]female;
Dari: [a]/'dɑ:ri:/; [n]达里语(现代波斯语的一种); [gd]female;
Davida: [a]/də'vi:də/; [n]黛维达; [gd]female;
Dawn: [a]/dɔːn/; [n](Dawn)人名;(西)道恩; [vt]破晓;出现;被领悟; [gd]female;
Deb: [a]/deb/; abbr. 初进上流社会社交场合的富家年轻女子;社交圈中首次亮相的女子  (debutante); [n](Deb) (美,尼泊尔)德布(人名); [gd]female;
Deborah: [a]/'debərə/; [n]黛博拉(女子名); [gd]female;
Deirdre: [a]/'diədri/; [n]迪尔德丽(女子名); [gd]female;
Delia: [a]/'di:ljə/; [n]迪莉娅(女子名); [gd]female;
Delilah: [a]/di'lailə/; [n]黛利拉;妖妇;不忠实的女人; [gd]female;
Delphine: [a]/dɛl'fin/; [n]戴尔芬(女子名); [gd]female;
Delphinia: [a]/de'finiə/; [n]黛尔芬妮娅(女子名); [gd]female;
Demeter: [a]/di'mi:tə/; [n]得墨忒耳(掌农业,结婚,丰饶之女神); [gd]female;
Deni: [a]/dɪˈnɪ/; 十数的; [n](Deni)人名;(俄)杰尼;(意,阿拉伯)德尼; [gd]female;
Deny: [a]/dɪˈnaɪ/; [vt]否定,否认;拒绝给予;拒绝.的要求; vi. 否认;拒绝; [gd]female;
Desdemona: [a]/,dezdi'məunə/; [n]苔丝狄蒙娜(女子名);苔丝狄蒙娜(莎士比亚悲剧奥赛罗中的女主人公);天卫十(环绕天王星运行的一颗卫星); [gd]female;
Deva: [a]/ˈdeɪvə/; [n](Deva)人名;(塞)德娃 (女名),德瓦;(泰,印,尼,土)德瓦; [gd]female;
Devi: [a]/ˈdeɪvi/; [n]提毗(梵语中"女神"的意思);井斜(测井曲线代号); [gd]female;
Dew: [a]/djuː/; [n](Dew)人名;(德)德夫;(英)迪尤; [vt](露水等)弄湿; vi. 结露水; [gd]female;
Diamond: [a]/ˈdaɪmənd/; [n](Diamond)人名;(英,意,葡)戴蒙德;(法)迪亚蒙; [adj]菱形的;金刚钻的; [gd]female;
Dian: [a]/daɪ'æn/; [n]黛安(女子名);月亮(诗歌用语); [gd]female;
Diana: [a]/daɪ'ænə/; [n]黛安娜(女子名,罗马神话中之处女性守护神);月; [gd]female;
Diane: [a]/dai'æn/; [n]黛安(等于Diana,女子名); [gd]female;
Dina: [a]/'di:nə/; [n](Dina)人名;(塞,葡,法,意,罗,阿拉伯)迪娜 (女名),迪纳;(俄)金娜; [军] [电子]第纳干扰器; [gd]female;
Dinah: [a]/dainə/; [n]黛娜(女子名); [gd]female;
Dione: [a]/dai'əuni/; [n] [天]土卫四(天文学专用词汇); [gd]female;
Dita: [a]/'di:tə/; [n]蒂她荔枝甜酒; [gd]female;
Dixie: [a]/ˈdɪksi/; [n]美国南部各州; [adj]美国南部; [gd]female;
Doe: [a]/dəʊ/; [n](Doe)人名;(缅)多;(英,利比,加纳)多伊;(日)土江 (姓); [脊椎]雌兔; [gd]female;
Doll: [a]/dɒl/; [n](Doll)人名;(英)多尔(女子教名Dorothea和Dorothy的昵称);(西)多利; [vt]把.打扮得花枝招展; [gd]female;
Dollie: [a]/'dɔli/; [n]小系缆桩; [gd]female;
Dolly: [a]/ˈdɒli/; [n]洋娃娃;滑动台架;移动式摄影车;洗衣搅棒;(板球)易接球;有魅力的时髦女郎; v. 用移动车移动;移动摄影车; [adj](女孩)时髦的;(板球)易接的; [gd]female;
Dominica: [a]/,dɔmi'ni:kə/; [n]多米尼加岛(拉丁美洲岛屿); [gd]female;
Dona: [a]/'dəunə/; [n](葡)夫人;小姐; [gd]female;
Donna: [a]/'dɑnə/; [n](意)女士(置于女士名字前的尊称,相当于Madam);堂娜(女子名); [gd]female;
Dorcas: [a]/'dɔ:kəs/; [n]缝制施舍贫民的衣服的妇女会;多尔卡丝(女子名); [gd]female;
Doris: [a]/'dɔris/; [n]桃瑞丝(女子名); [gd]female;
Dorothea: [a]/,dɔrə'θiə/; [n]多萝西娅(Dorothy的异体); [gd]female;
Dot: [a]/dɒt/; [n](Dot)人名;(中)多(广东话-威妥玛);(英)多特(女子教名 Dorothea 和 Dorothy 的昵称);(越)突; [vt]加小点于; [gd]female;
Dottie: [a]/'dɔti/; [n]多蒂(女子名,等于Dorothea,Dorothy); [gd]female;
Dotty: [a]/ˈdɒti/; [adj]薄弱的;多点的;精神不定的; [gd]female;
Dove: [a]/dʌv/; [n](Dove) (美)达夫 (人名); [gd]female;
Dulciana: [a]/,dʌlsɪ'ɑːnə/; [n]管风琴的柔音音栓;德尔西亚那音栓; [gd]female;
Dulcie: [a]/'dʌlsi/; [n]达尔西(女子名); [gd]female;
Dulcinea: [a]/,dʌlsi'niə/; [n]达尔西妮亚(女子名);理想中的爱人(出至堂吉柯德想象中美丽并与之相爱的普通农家姑娘); [gd]female;
Dusty: [a]/ˈdʌsti/; [adj]灰尘覆盖的;粉状的;似灰尘的;(颜色)土灰的;缺乏活力的;不能令人满意的; [n](Dusty) (美)杜史迪(人名); [gd]female;
Easter: [a]/ˈiːstə(r)/; [n]复活节; [gd]female;
Ebony: [a]/ˈebəni/; [n](Ebony) (美,英)埃博妮(人名); [adj]乌木制的,黑檀木制的;乌黑色的; [gd]female;
Eda: [a]/'edə/; abbr. 电子设计自动化(Electronic Design Automation);经济开发协会(美国) (Economic Development Association);经济开发署(美国)(Economic Development Administration);教育发展协会(英国)(Educational Development Association); [n](Eda)人名;(英,土)埃达; [gd]female;
Ede: [a]/ei'dei/; abbr. 等效剂量效应;电子设计工程师; [n](Ede)人名;(英)伊德;(德,法,匈,土,瑞典)埃德; [gd]female;
Eden: [a]/ˈiːdn/; [n]伊甸园(《圣经》中亚当和夏娃最初居住的地方); [gd]female;
Edi: [a]/ˌiː diː ˈaɪ/; abbr. 电子数据交换(Electronic Data Interchange);电子资料接口(Electronic Data Interface); [n](Edi)人名;(德,印尼)埃迪; [gd]female;
Edna: [a]/'ednə/; [n]埃德娜(女子名); [gd]female;
Effie: [a]/'efi/; [n]埃菲(女子名); [gd]female;
Eleanor: [a]/'ɛlənɔ/; [n]埃莉诺(女子名); [gd]female;
Electra: [a]/i'lektrə/; [n](Electra)人名;(英)伊莱克特拉; [希腊神话]厄勒克特拉; [gd]female;
Elisa: [a]/ɪ'laɪzə/; abbr. 酶联免疫吸附测定(enzyme-linked immuno sorbent assay); [n](Elisa)人名;(英)埃莉莎;(法,意,西,葡,芬,罗,德)埃莉萨; [gd]female;
Elise: [a]/ɪ'liz/; [n]伊莉斯(女子名); [gd]female;
Elizabeth: [a]/ɪ'lɪzəbəθ/; [n]伊丽莎白(女子名); [gd]female;
Ella: [a]/'ɛlɚ/; [n](Ella) (美)艾拉(人名); [gd]female;
Ellie: [a]/'eli/; [n]埃莉(女子名); [gd]female;
Elsa: [a]/'elsə/; [n]埃尔莎(女子名,等于Elizabeth); [gd]female;
Else: [a]/els/; [adv]其他;否则;另外; [adj]别的;其他的; [n](Else)人名;(英)埃尔斯;(德)埃尔泽;(芬,丹)埃尔塞; [gd]female;
Elsie: [a]/'elsi/; [n]埃尔希(女子名); [gd]female;
Elsinore: [a]/,ɛlsɪ'nɔ/; [n]埃尔西诺(丹麦城市); [gd]female;
Em: [a]/ɪm/; [n]他们(等于 them); [gd]female;
Emily: [a]/'eməlɪ/; [n]埃米莉(女子名); [gd]female;
Emma: [a]/'emə/; [n]艾玛(女子名); [gd]female;
Enid: [a]/'i:nid/; [n]伊妮德(女子名);伊尼德(美国一城市); [gd]female;
Erica: [a]/'εrikə/; [n]埃里卡(女子名); [gd]female;
Erma: [a]/'ə:mə/; [n]厄玛(女子名,Ermengarde的昵称); [gd]female;
Ernestine: [a]/'ə:nisti:n/; [n]欧内斯廷(女子名); [gd]female;
Estelle: [a]/e'stel/; [n]埃斯特尔(女子名); [gd]female;
Ester: [a]/ˈestə(r)/; [n](Ester)人名;(法)埃斯泰;(德,西,意,葡,罗,挪,丹,芬,爱沙)埃斯特尔; [有化]酯; [gd]female;
Esther: [a]/'estə/; [n]以斯帖(犹太女王名);以斯帖记;埃丝特(女子名); [gd]female;
Ethyl: [a]/ˈeθɪl; ˈiːθaɪl/; [n]乙烷基;含四乙铅的汽车燃料; [gd]female;
Eudora: [a]/ju:'dɔ:rə/; [n]Qualcomm公司出品的一种电子邮件软件;尤朵拉(女子名); [gd]female;
Eugenia: [a]/ju:'dʒi:niə/; [n]尤金伲亚(女子名); [gd]female;
Eula: [a]/ˈjuːlə/; abbr. 最终用户许可协议(End User License Agreement); [n](Eula)人名;(意)欧拉; [gd]female;
Eustacia: [a]/ju:'steiʃiə/; [n]尤斯塔西娅(女子名,意思是坚定的); [gd]female;
Eve: [a]/iːv/; [n](Eve)人名;(西)埃韦;(法)夏娃;(英)伊夫, 伊芙(女名); [gd]female;
Fae: [a]/feɪ/; [n](Fae) (巴,美,意,法,瑞,阿)法埃(人名); [gd]female;
Faith: [a]/feɪθ/; [n](Faith)人名;(匈)福伊特;(英)费思,费丝(女名);(瑞典)法伊特; [gd]female;
Fan: [a]/fæn/; [n](Fan) (美,法,俄)法恩(人名); [gd]female;
Fancy: [a]/ˈfænsi/; v. 想做;喜爱;自负;想象;设想,认为;(尤指速度竞赛)认为..要赢;(表示惊讶或反对) 真没想到; [n](Fancy) 范茜(人名); [adj]复杂的;昂贵的;精致的,花俏的;想象的;(食物)优质的;(花)杂色的;(动物)供观赏的; [gd]female;
Fanny: [a]/ˈfæni/; [n]范妮.英文名字.女性用.可单用,亦可做为Frances(弗朗西丝)的简称.此名亦在法国女性名字中出现.译为法妮.该名字有"自由"的含义.; [gd]female;
Faun: [a]/fɔːn/; [n](古罗马传说中)半人半羊的农牧神; [gd]female;
Fawn: [a]/fɔːn/; [n](Fawn) (美)福恩(人名); [adj]浅黄褐色的; [gd]female;
Fay: [a]/feɪ/; [n](Fay)人名;(德,西,葡)法伊;(英,法)费伊; [vt]接合; [gd]female;
Fedora: [a]/fɪˈdɔːrə/; [n](Fedora)人名;(俄)费奥多拉;(西,塞)费多拉; [gd]female;
Felicity: [a]/fəˈlɪsəti/; [n](Felicity)人名;(英)费利西蒂,费莉西蒂(女名); [gd]female;
Fern: [a]/fɜːrn/; [n]弗恩(女子名); [gd]female;
Fey: [a]/feɪ/; [adj]稀奇古怪的,非现世的;有超自然视力的;注定要死的,垂死的;(临死前)异常兴奋的; [n](Fey) (美,德)费(人名); [gd]female;
Fianna: [a]/'fi:ænə/; [n]芬尼安运动员;爱尔兰勇士; [gd]female;
Fidelity: [a]/fɪˈdeləti/; [n]保真度;忠诚;精确;尽责; [gd]female;
Fifi: [a]/'fi:fi:/; [n]菲菲(女名,等于Josephine); [gd]female;
Fleur: [a]/flɜ:/; [n](Fleur)人名;(英)弗勒; [gd]female;
Flo: [a]/fləu/; [n]弗洛(女子名); [gd]female;
Flora: [a]/ˈflɔːrə/; [n]植物区系;植物群; [gd]female;
Flore: [a]/'fləuə/; [n](Flore)人名;(法)弗洛尔(女子教名);(罗)弗洛雷; [化学]凝花(由升华得到的一种片状或粉末状的元素或化合物); [gd]female;
Florida: [a]/'flɔridə/; [n]佛罗里达(美国东南部的州); [gd]female;
Flory: [a]/'flɔri/; [n](Flory)人名;(俄,德,英,法)弗洛里; [gd]female;
Flossy: [a]/'flɒsɪ/; [adj]丝棉似的;迷人的;轻软的; [gd]female;
Flower: [a]/ˈflaʊə(r)/; [n](Flower)人名;(英)弗劳尔; [vt]使开花;用花装饰; [gd]female;
Fortuna: [a]/fɔ:'tju:nə/; [n]福耳图那(罗马神话中的命运女神); [gd]female;
Fortune: [a]/ˈfɔːtʃuːn/; [n](Fortune)人名;(英)福琼;(法)福蒂纳; [vt]给予财富; vi. 偶然发生; [gd]female;
Freda: [a]/'fri:də/; [n]弗雷达(女子名); [gd]female;
Gaby: [a]/ɡeɪbɪ/; [n](Gaby)人名;(法,罗,英)加比; [gd]female;
Gae: [a]/gei/; abbr. 肉芽肿性阿米巴脑炎(granulomatous amoebic encephalitis);裂隙; [n](Gae)人名;(罗)加埃; [gd]female;
Gael: [a]/ɡeil/; [n]盖尔人(苏格兰高地的居民); [gd]female;
Garland: [a]/ˈɡɑːlənd/; [n](Garland)人名;(英,西,瑞典)加兰; [vt]戴花环; [gd]female;
Garnet: [a]/ˈɡɑːnɪt/; [n](Garnet)人名;(西)加内特;(罗)加尔内特; [矿物]石榴石;深红色;装货用的滑车; [adj]深红色的;暗红色的; [gd]female;
Gen: [a]/dʒen/; [n](Gen)人名;(法)让;(土,阿塞,土库)根; [gd]female;
Gena: [a]/'dʒi:nə/; [n](Gena)人名;(塞)盖娜 (女名),盖纳;(英)吉纳; [解剖]颊; [gd]female;
Geneva: [a]/dʒi'ni:və/; [n]日内瓦(瑞士西南部城市); [gd]female;
Genny: [a]/'dʒini/; [n]珍妮(公司名称); [gd]female;
Georgette: [a]/ˌdʒɔːˈdʒet/; [n](Georgette)人名;(英)乔吉特;(法)若尔热特; [纺]乔其纱(一种极薄的透明细纱); [gd]female;
Georgina: [a]/,dʒɔ:'dʒinə/; [n]乔治娜(女子名,Georgia的昵称); [gd]female;
Georgine: [a]/dʒɔ:'dʒi:n/; [n](Georgine)人名;(英)乔金; [gd]female;
Gert: [a]/ɡɜːt/; abbr. 图形评审技术(Graphical Evaluation and Review Technique); [n](Gert)人名;(瑞典)耶特;(英,丹,德)格特;(荷)赫特; [gd]female;
Gertrude: [a]/'ɡə:tru:d/; [n]格特鲁德(女子名); [gd]female;
Gillie: [a]/ˈɡɪli/; [n](Gillie)人名;(英,法)吉利; [gd]female;
Gilly: [a]/'ɡili/; [n](Gilly)人名;(法,德,匈)吉利; [vt]以马戏团搬运车搬运; vi. 适宜用马戏团搬运车搬运; [gd]female;
Ginny: [a]/'dʒini/; [adj]杜松子酒的;有杜松子酒味的; [n](Ginny) (美,印,马,澳,新)金尼(人名); [gd]female;
Gipsy: [a]/ˈdʒɪpsi/; [n](Gipsy) (美,法)吉普赛(人名); [gd]female;
Gisela: [a]/'gi:zələ/; [n]吉塞拉(女子名,等于Giselle); [gd]female;
Giselle: [a]/dʒi'zel/; [n]吉塞尔(女子名); [gd]female;
Glad: [a]/ɡlæd/; [adj]高兴的;乐意的;令人高兴的;灿烂美丽的; [vt]使高兴; [n](Glad)人名;(塞,瑞典)格拉德;(英)格莱德;(法,挪)格拉; [gd]female;
Gladys: [a]/'ɡlædis/; [n]格拉迪斯(女子名); [gd]female;
Gloria: [a]/'ɡlɔ:riə/; [n](Gloria)人名;(英,法,葡,罗,德,意,西)格洛里亚,格洛丽亚(女名); [gd]female;
Glory: [a]/ˈɡlɔːri/; [n](Glory)人名;(法)格洛里; [gd]female;
Gray: [a]/ɡreɪ/; [n](gray) 灰色;灰色衣服;灰白头发;灰色物(等于 grey); v. (gray) (尤指头发)变成灰白色;变老;用灰色显示(等于 grey); [adj](gray) 灰色的;须发灰白的;灰白头发的;(非正式)老年人的;(天气)阴沉的;(面色)苍白的;平淡无奇的;(金融或贸易活动)灰色的;民族杂居区的(等于 grey);戈瑞(国际单位); [gd]female;
Gui: [a]/ˈɡuːi; ˌdʒiː juː ˈaɪ/; abbr. 图形用户界面(Graphical User Interface); [n](Gui)人名;(意)古伊;(法)居伊; [gd]female;
Guinevere: [a]/ˈɡwɪnɪvə/; [n]漂亮宝贝;吉娜薇; [gd]female;
Gussy: [a]/ˈɡʌsi/; [vt]装饰;粉饰; [n]装饰;粉饰; [gd]female;
Gusty: [a]/ˈɡʌsti/; [adj]阵风的;突发的;阵阵猛急的; [n](Gusty)人名;(英)古斯蒂; [gd]female;
Gypsy: [a]/ˈdʒɪpsi/; [n](Gypsy)人名;(英)吉普赛; [adj]象吉卜赛人的;吉卜赛人的;无照的; vi. 流浪; [gd]female;
Happy: [a]/ˈhæpi/; [adj]幸福的;高兴的;巧妙的; [n](Happy)人名;(英,瑞典,喀)哈皮; [gd]female;
Harmonia: [a]/hɑ:'məunjə/; [n]哈耳摩尼亚; [gd]female;
Harmony: [a]/ˈhɑːməni/; [n](Harmony)人名;(英)哈莫尼; [gd]female;
Heather: [a]/ˈheðə(r)/; [n](Heather) 希瑟(人名); [adj]杂色的;似石南的; [gd]female;
Helen: [a]/'helən/; [n]海伦(女子名,火把,光亮的之义); [gd]female;
Helena: [a]/hɛ'linɚ/; [n]海伦娜(女子名); [gd]female;
Helene: [a]/hə'li:n/; [n]海琳(等于Helen); [gd]female;
Hellene: [a]/ˈheliːn/; [n]希腊人; [gd]female;
Henrietta: [a]/,henri'etə/; [n]汉丽埃塔(女子名); [gd]female;
Hermia: [a]/'hə:miə/; [n]赫米娅(女子名); [gd]female;
Hermione: [a]/hə:'maiəni/; [n]赫尔迈厄尼(女子名);希腊神话Menelzus 与helen 之女; [gd]female;
Hestia: [a]/'hestiə/; [n]赫斯提(女灶神,罗马神话中称为Vesta); [gd]female;
Honey: [a]/ˈhʌni/; [n](Honey)人名;(英)霍尼; [adj]甘美的;蜂蜜似的; [vt]对.说甜言蜜语;加蜜使甜; vi. 奉承;说甜言蜜语; [gd]female;
Honor: [a]/ˈɒnə(r)/; [n]荣誉;信用;头衔; [vt]尊敬(等于honour);给.以荣誉; [gd]female;
Hope: [a]/həʊp/; v. 希望;希望能够; [n](Hope) (美)奥普(人名); [gd]female;
Hyacinth: [a]/ˈhaɪəsɪnθ/; [n]风信子; [宝]红锆石;紫蓝色; [gd]female;
Ida: [a]/'aidə/; [n]艾达(女子名); [gd]female;
Iris: [a]/ˈaɪrɪs/; [n]彩虹女神(希腊神话中的一个形象); [gd]female;
Irma: [a]/'ə:mə/; [n]厄玛(等于Erma,女子名); [gd]female;
Isabel: [a]/'izəbel/; [n]伊莎贝尔(人名); [gd]female;
Isabella: [a]/,izə'belə/; [n]伊莎贝拉(女子名); [gd]female;
Isis: [a]/'aisis/; [n]伊希斯(古埃及的丰饶女神); [gd]female;
Isobel: [a]/'izəbel/; [n]伊泽贝尔(女子名,等于Elizabeth); [gd]female;
Ivory: [a]/ˈaɪvəri/; [n](Ivory)人名;(英)艾沃里; [adj]乳白色的;象牙制的; [gd]female;
Ivy: [a]/ˈaɪvi/; [n](Ivy) (美,英)艾维(人名); [adj]常春藤联盟的; [gd]female;
Jacky: [a]/'dʒæki/; [n]水手;杜松子酒; [gd]female;
Jade: [a]/dʒeɪd/; [n](Jade)人名;(英)杰德;(法)雅德; [宝]碧玉;老马; [adj]玉制的;绿玉色的; vi. 疲倦; [vt]使疲倦; [gd]female;
Jane: [a]/dʒeɪn/; [n]简(女子名); [gd]female;
Janet: [a]/ʒane/; [n]珍妮特(女子名); [gd]female;
Jasmine: [a]/ˈdʒæzmɪn/; [n](Jasmine)人名;(英)贾丝明; [gd]female;
Jeanette: [a]/dʒə'net/; [n]珍妮特(女子名); [gd]female;
Jemmy: [a]/ˈdʒemi/; [n](Jemmy)人名;(英)杰米(男子教名James的昵称); [gd]female;
Jenny: [a]/ˈdʒeni/; [n]詹妮(女子名,等于Jennifer); [gd]female;
Jessamine: [a]/'dʒesəmɪn/; [n](Jessamine)人名;(英)贾斯明, 贾丝明(女名); [gd]female;
Jewel: [a]/ˈdʒuːəl/; [n]朱厄尔(女子名); [gd]female;
Jinny: [a]/'dʒini/; [n](Jinny)人名;(英)吉尼; [gd]female;
Joanna: [a]/dʒəʊ'ænə/; [n]乔安娜(女子名); [gd]female;
Joannes: [a]/dʒəu'æn/; [n]乔安妮(女子名); [gd]female;
Josephine: [a]/'dʒəuzifi:n/; [n]约瑟芬(女子名); [gd]female;
Joy: [a]/dʒɔɪ/; [n]乔伊(女子名); [gd]female;
Joyous: [a]/ˈdʒɔɪəs/; [adj]令人高兴的;充满欢乐的(等于joyful); [gd]female;
Juana: [a]/'hwɑ:nɑ:/; [n]胡安娜(女子名); [gd]female;
Julienne: [a]/,dʒuːlɪ'en/; [n](Julienne) (法)朱利恩(人名); [adj](蔬菜)切成细长条的; [gd]female;
Juliet: [a]/'dʒu:ljət/; [n]朱丽叶(莎士比亚剧女主人公); [gd]female;
June: [a]/dʒuːn/; [n]六月;琼(人名,来源于拉丁语,含义是"年轻气盛的六月"); [gd]female;
Kai: [a]/kaɪ/; [n]卡伊(姓氏); [gd]female;
Kali: [a]/'keɪlaɪ; 'kælɪ/; [n](Kali) (美,印度,法,匈牙利)卡利(人名); [gd]female;
Karen: [a]/'kærən/; [n]凯伦(人名);克伦邦(缅甸邦名); [gd]female;
Kari: [a]/'kærɪ/; [n]卡利(男子名);卡丽(女子名); [gd]female;
Kat: [a]/kɑt/; [n](Kat)人名;(中)吉(广东话-威妥玛); [gd]female;
Kata: [a]/'kɑtɑ/; 卡塔(人名); [gd]female;
Ki: [a]/,keɪ 'aɪ/; [n]基里巴斯共和国 (Kiribati); [gd]female;
Kiley: [a]/ˈkaɪlɪ/; [n](Kiley)人名;(英)基利,基莉(女名); [gd]female;
Kimberley: [a]/'kimbəli/; [n]金伯利(南非中部城市);金柏莉(女子名); [gd]female;
Kiri: [a]/'kiəri/; [n](Kiri)人名;(匈,芬,俄,斯里)基里; [gd]female;
Kitty: [a]/ˈkɪti/; [n]基蒂(女子名); [gd]female;
Kora: [a]/ˈkɔːrə/; [n](Kora)人名;(日)子等(姓); [gd]female;
Kylie: [a]/ˈkaɪli/; 凯莉(人名); [gd]female;
La: [a]/lɑː/; [n](La)人名;(中)辣(广东话-威妥玛);(越)罗;(朝)罗;(缅,老)拉; [gd]female;
Lacey: [a]/'leɪsɪ/; [adj]蕾丝的,花边的,有花边的(lacy 的另一种拼写); [n](Lacey) (美,英)莱西(人名); [gd]female;
Lacy: [a]/ˈleɪsi/; [adj]花边的;丝带的;蕾丝的;网眼状的; [n](Lacy) (美,巴)拉西(人名); [gd]female;
Lamb: [a]/læm/; [n](Lamb)人名;(英)兰姆;(德)兰布; [vt]生小羊,产羔羊; vi. 生小羊,产羔羊; [gd]female;
Lana: [a]/'lɑnə/; [n]羊毛;拉娜(Helen 的异体); [gd]female;
Lari: [a]/'lɑːriː/; [n]拉里(女子名);拉里(格鲁吉亚共和国货币单位); [gd]female;
Larine: [a]/'læraɪn/; [adj]鸥科的;鸥亚目的; [gd]female;
Lark: [a]/lɑːk/; [n](Lark)人名;(东南亚国家华语)六; [vt]愚弄; [gd]female;
Laurel: [a]/ˈlɒrəl/; [n](Laurel)人名;(法)洛雷尔;(英,西,意)劳雷尔; [vt]授予荣誉,使戴桂冠; [gd]female;
Lea: [a]/liː/; [n](Lea)人名;(西,意,罗,匈,挪,德,芬)莱亚;(英)利; [gd]female;
Leah: [a]/liə/; [n]利亚(女子名,雅各最初的妻子); [gd]female;
Leda: [a]/'li:də/; [n]勒达(女子名); [gd]female;
Lena: [a]/'li:nə/; [n]莉娜(女子名,等于Helena);勒拿河(西伯利亚中部河流); [gd]female;
Lia: [a]/æ'fi:ljə/; abbr. 铅工业协会(Lead Industries Association);美国皮革业联合会(Leather Industries of America); [n](Lia)人名;(罗,意,匈,柬)莉娅(女名),利亚;(俄)利阿; [gd]female;
Liana: [a]/lɪ'ɑːnə/; [n](Liana)人名;(罗,意)利亚娜(女名),利亚纳;(俄)利阿纳;(英)利安娜; [植]藤本植物; [gd]female;
Liane: [a]/li'a:n/; [n](Liane)人名;(法)利亚纳; [gd]female;
Lib: [a]/lɪb/; abbr. 自由党 (The Libertarian party);天秤座 (Libra); abbr. (lib) (用于组织名)解放,解放运动 (liberation);自由主义者 (liberal);图书馆 (library); [gd]female;
Lil: [a]/,ɛl aɪ 'ɛl/; abbr. 国际月球实验室(Lunar International Laboratory); [n](Lil)人名;(德)利尔; [gd]female;
Lila: [a]/'lailə/; [n]莱拉(Leila的异体); [gd]female;
Lilith: [a]/'liliθ/; [n]李莉斯(女子名); [gd]female;
Lily: [a]/ˈlɪli/; [n](Lily)人名;(罗)莉莉; [adj]洁白的,纯洁的; [gd]female;
Linda: [a]/'lɪndə/; [n]琳达(女子名); [gd]female;
Linet: [a]/'lainət/; [n](Linet)人名;(法)利内;(捷)利内特; [gd]female;
Linnet: [a]/ˈlɪnɪt/; [n](Linnet)人名;(英)琳内特; [gd]female;
Lira: [a]/ˈlɪərə/; [n](Lira)人名;(俄,西,葡,罗)利拉; [gd]female;
Lisa: [a]/li:zə/; [n]丽莎(女子名); [gd]female;
Liz: [a]/lɪz/; [n]莉兹;莉斯(女子名); [gd]female;
Lolita: [a]/loʊˈliːtə/; [n]洛丽塔(女子名);萝莉; [gd]female;
Lolly: [a]/ˈlɑːli/; [n]洛莉(女子名); [gd]female;
Lora: [a]/'ləurə/; [n]罗拉(女子名,等于Laura); [gd]female;
Lorain: [a]/lə'rein/; [n]洛雷恩(美国一城市名); [gd]female;
Lorelei: [a]/'lɔ:rəlai/; [n]罗蕾莱(德国文学及传说中的女妖); [gd]female;
Loretta: [a]/ləu'retə/; [n]洛雷塔(女子名); [gd]female;
Lorraine: [a]/lo'ren/; [n]洛林(法国东北部的一个地区);罗琳(人名); [gd]female;
Lorry: [a]/ˈlɒri/; [n](Lorry)人名;(法,德)洛里; [车辆]货车;运料车; [gd]female;
Lory: [a]/'lɔːrɪ/; [n](Lory)人名;(英,法,葡)洛里; [gd]female;
Lotta: [a]/ˈlɑːtə/; [n](Lotta)人名;(英,意,芬,瑞典)洛塔; [gd]female;
Love: [a]/lʌv/; [n](Love) (英,菲,瑞,美)洛夫(人名); [gd]female;
Lucina: [a]/lʊ'saɪnə/; [n]鲁西娜(罗马神话中司生育的女神); [gd]female;
Lucky: [a]/ˈlʌki/; [adj]幸运的;侥幸的; [gd]female;
Lucretia: [a]/luːˈkriːʃɪə/; [n]罗马传说中的贞妇名;卢克丽霞(女子名); [gd]female;
Lucy: [a]/ˈluːsɪ/; [n]露西(女子名); [gd]female;
Lulu: [a]/'luːluː/; [n](Lulu)人名;(英)露露;(罗)卢卢; [adj]特别出色的;第一流的; [gd]female;
Lust: [a]/lʌst/; [n](Lust)人名;(捷,匈,瑞典)卢斯特; [gd]female;
Lyssa: [a]/'lɪsə/; [n]狂犬病; [gd]female;
Mab: [a]/mæb/; abbr. 内存分配块(memory allocation block);海军航空基地(Marine Air base);材料咨询委员会(Materials Advisory Board); [n](Mab)人名;(英)马布; [gd]female;
Madeleine: [a]/ˈmædlɪn; ˈmædleɪn/; [n]玛德琳蛋糕;马德琳(女子名,等于Madelin); [gd]female;
Madonna: [a]/məˈdɒnə/; [n]圣母玛利亚;圣母像; [gd]female;
Mae: [a]/mei/; [n]梅(女子名,等于Mary); [gd]female;
Mag: [a]/'mæɡəzin/; [n]玛格(女子名)(Margaret的昵称); [gd]female;
Magdalen: [a]/'mægdəlɪn/; [n]从良的妓女;妓女收容所(等于Magdalene); [gd]female;
Magdalene: [a]/,mæɡdə'lini/; [n](Magdalene)人名;(德,西,英)玛格达莱妮; [gd]female;
Maggie: [a]/'mægɪ/; [n]马吉(女子名); [gd]female;
Magna: [a]/'mægnə/; [n]麦格纳(全名为麦格纳国际,为世界第三大汽车零部件供应商); [gd]female;
Maia: [a]/'maɪə/; [n]玛雅(希腊神话中女神);玛雅(女子名); [gd]female;
Maire: [a]/mɑːiːrə/; [n]莫雅(女子名); [gd]female;
Mala: [a]/'mɑːlɑː/; [n](Mala) (捷,美,印,俄)马拉(人名); [gd]female;
Malva: [a]/'mælvə/; [n]锦葵;锦葵属; [gd]female;
Malvina: [a]/mæl'vi:nə/; [n]玛尔维娜(等于Malvine女子名); [gd]female;
Mamie: [a]/'meimi/; [n]玛米(女子名); [gd]female;
Mandi: [a]/'mʌndi/; [n](Mandi)人名;(刚(金),罗,意,印,英)曼迪; [gd]female;
Mara: [a]/mə'rɑ:/; [n]玛拉(女子名); [gd]female;
Marcella: [a]/mɑ:'selə/; [n]凹凸纹细布;玛塞拉(女名); [gd]female;
Margaret: [a]/'mɑ:ɡrɪt/; [n]玛格利特(女子名); [gd]female;
Margarita: [a]/ˌmɑːɡəˈriːtə/; [n]玛格丽塔(Margaret的异体,女子名);玛格丽塔(一种鸡尾酒名); [gd]female;
Margaux: [a]/mɑ:r'ɡəu/; [n]玛尔戈红葡萄酒; [gd]female;
Marge: [a]/mɑ:dʒ/; [n]玛吉(女子名,Margaret 的昵称,等于Margie或 Marj); [gd]female;
Margie: [a]/'ma:dʒi/; [n]玛吉(女子名); [gd]female;
Marguerite: [a]/ˌmɑːɡəˈriːt/; [n](法)玛格丽特(女子名); [gd]female;
Mari: [a]/'mæri/; [n]毛伊岛(位于夏威夷中部); [gd]female;
Maria: [a]/'mærɪə/; [n]玛丽亚(女名); [gd]female;
Marian: [a]/ˈmeəriən/; [adj]圣母玛丽亚的;英国玛丽一世的; [n]圣母玛丽亚的信徒,圣母玛利亚崇拜者; [gd]female;
Marianne: [a]/,mεəri'æn/; [n]玛丽安(法兰西共和国或其政府的绰号,因以女性为其化身,故名); [gd]female;
Mariel: [a]/mɑ:'riəl/; [n]马里埃尔(古巴西部港市); [gd]female;
Marigold: [a]/ˈmærɪɡəʊld/; [n](Marigold)人名;(英)玛丽戈尔德; [gd]female;
Marin: [a]/'mærin/; [n]马林(姓氏); [gd]female;
Marina: [a]/məˈriːnə/; [n](Marina)人名;(罗,塞,葡,西,意,英)马里纳,玛丽娜(女名); [船]小艇船坞;散步道; [gd]female;
Marlene: [a]/mɑ:'li:n/; [n]马琳; [gd]female;
Marline: [a]/'mɑːlɪn/; [n]小绳;细索; [船]双股细缆; [gd]female;
Marne: [a]/mɑ:n/; [n]马恩(法国省名);马恩河(法国东北部河流); [gd]female;
Marry: [a]/ˈmæri/; [vt]嫁;娶;与..结婚; vi. 结婚; [n](Marry)人名;(阿拉伯)马雷;(法)马里; [gd]female;
Martha: [a]/'mɑ:θə/; [n]玛莎(女子名);马大(马利亚和拉撒路之姊); [gd]female;
Mary: [a]/ˈmɛərɪ/; [n]玛丽(女子名); [gd]female;
Mathilda: [a]/mə'tildə/; [n]玛蒂尔达(女子名,等于Matilda); [gd]female;
Matilda: [a]/məˈtɪldə/; [n]徒步旅行者的行囊;玛蒂尔达(女子名); [gd]female;
Maud: [a]/mɔːd/; [n](Maud)人名;(西,英)莫德(教名Magdalen,Matilda的昵称); [gd]female;
Maxi: [a]/ˈmæksi/; [n](Maxi)人名;(德)马克西; [adj]长及足踝的; [gd]female;
May: [a]/meɪ/; [n]五月; [gd]female;
Maya: [a]/'mɑːjə/; [n]玛雅人;玛雅语;玛耶女神,虚幻女神; [adj](与)玛雅人(有关)的;(与)玛雅语(有关)的; [gd]female;
Meg: [a]/meɡ/; [n]梅格(女子名,等于Margaret); [gd]female;
Mela: [a]/ˈmeɪlə/; [n]梅拉(女子名); [gd]female;
Melba: [a]/'melbə/; [n]梅尔巴(女子名); [gd]female;
Melissa: [a]/mə'lɪsə/; [n]蜜蜂花;梅利莎(女子名); [gd]female;
Melodie: [a]/meilɔ'di:/; [n](法)旋律;歌曲; [gd]female;
Melody: [a]/ˈmelədi/; [n](Melody)人名;(英)梅洛迪; [gd]female;
Mercy: [a]/ˈmɜːsi/; [n](Mercy)人名;(英)默西,默茜(女名);(法)梅西; [gd]female;
Merl: [a]/mə:l/; [n]乌鸫;山鸟(等于merle); [gd]female;
Merrily: [a]/ˈmerəli/; [adv]愉快地;高兴地(merry的副词形式); [gd]female;
Meta: [a]/ˈmetə/; pref. 表示"变化""变换"之义; [n](Meta)人名;(德,俄,罗,塞,葡,意,英)梅塔(女子教名Margaret的昵称); [gd]female;
Midge: [a]/mɪdʒ/; [n]蚊,蠓等小虫; [gd]female;
Mignon: [a]/'minjɔn, mi:'njuŋ/; [adj]小巧玲珑的; [n](Mignon) (美)米尼翁(人名); [gd]female;
Milli: [a]/ˈmɪli/; 毫,千分之一; [n](Milli)人名;(意,土)米利; [gd]female;
Millie: [a]/'mili/; [n]米莉(女子名); [gd]female;
Mimi: [a]/'mimi/; [n]米米(女子名,Miriam的昵称); [gd]female;
Min: [a]/mɪn/; abbr. 部长(Minister);部(Ministry); [gd]female;
Minerva: [a]/mi'nə:və/; [n]密涅瓦(智慧女神,即希腊神话中的雅典娜); [gd]female;
Minette: [a]/mi'net/; [n](Minette)人名;(法)米内特; [gd]female;
Minnie: [a]/'mini/; [n]明妮(女人名,等于Mary); [gd]female;
Mira: [a]/'mairə/; [n](鲸鱼星座中的)薴藁增二; [gd]female;
Mirabelle: [a]/'mɪrəbel/; [n](Mirabelle) (美)密拉伯丽(人名); [gd]female;
Miriam: [a]/'miriəm/; [n]米里亚姆(女子名);米里亚姆(希伯来女先知,摩西和亚伦的姐姐);苦难之洋; [gd]female;
Missy: [a]/ˈmɪsi/; [n](Missy)人名;(英)米西; [gd]female;
Misti: [a]/'misti/; [n]米斯提小羊驼; [gd]female;
Misty: [a]/ˈmɪsti/; [adj]模糊的;有雾的; [n](Misty)人名;(英)米斯蒂,米丝蒂(女名);(法)米斯蒂; [gd]female;
Mitra: [a]/'maitrə/; [n]密特拉;麦卓(女子名); [gd]female;
Modesty: [a]/ˈmɒdəsti/; [n]谦逊;质朴;稳重; [gd]female;
Moira: [a]/'mɔrə/; [n]莫伊拉(女子名); [gd]female;
Moll: [a]/mɒl/; [n]莫尔(女子名,Mary的昵称); [gd]female;
Molly: [a]/ˈmɒli/; [n]莫利(女子名); [gd]female;
Mommy: [a]/ˈmɒmi/; [n]妈咪; [gd]female;
Mona: [a]/'məʊnə/; [n]白腹长尾猴;莫娜(女子名); [gd]female;
Mora: [a]/'morɚ/; [n](Mora)人名;(法,捷,拉脱,罗,马达,尼日利,塞,葡,瑞典,泰,西,意,英)莫拉; [gd]female;
Moreen: [a]/mə'riːn/; [n] [纺]波纹织物; [gd]female;
Morgen: [a]/'mɔːg(ə)n/; [n](Morgen)人名;(英,西)摩根;(法)莫尔让; [gd]female;
Moya: [a]/'mɔiə/; [n](Moya)人名;(英,西,葡)莫亚;(日)母家(姓); [gd]female;
Myna: [a]/'mainə/; [n]家八哥,鹩哥; [gd]female;
Myrtle: [a]/ˈmɜːtl/; [n]桃金娘;桃金娘科植物; [adj]桃金娘科的; [gd]female;
Nada: [a]/ˈnɑːdə/; abbr. 美国汽车经销商联合会(the National Automobile Dealers Association); [n](Nada)人名;(塞,葡,俄,阿拉伯,英)娜达(女名),纳达; [gd]female;
Nan: [a]/næn/; [n](Nan)人名;(越)难;(日)难(姓);(东南亚国家华语)南;(柬,印尼)南; [gd]female;
Nancy: [a]/ˈnænsi/; [n]南希(女子名,等于Anna);南锡(法国东北部城市); [gd]female;
Nanny: [a]/ˈnæni/; [n]保姆;母山羊; [gd]female;
Naomi: [a]/'neiəmi/; [n]内奥米(女子名,圣经中人物); [gd]female;
Nara: [a]/nɑ:'rɑ:/; [n]奈良(日本一座城市); [gd]female;
Nari: [a]/'nɛəri/; [n](Nari)人名;(意)纳里; [gd]female;
Natty: [a]/ˈnæti/; [adj]整洁的;敏捷的;考虑周到的;清楚的; [n](Natty)人名;(英)纳蒂; [gd]female;
Nelly: [a]/'nelɪ/; [n]内丽(女子名,等于Eleanor,Ellen,Helen); [gd]female;
Nesta: [a]/ˈnɛstə/; [n]内斯塔(姓氏); [gd]female;
Nettie: [a]/'neti/; [n]内蒂(女子名,Janet的昵称); [gd]female;
Nettle: [a]/ˈnetl/; [n]荨麻,荨麻科; v. 惹怒,使恼火;用荨麻刺伤或鞭打(某人); [gd]female;
Netty: [a]/'netɪ/; [n](Netty) (美,荷,印尼)妮蒂(人名); [gd]female;
Nike: [a]/'naiki:/; [n]耐克(国际著名运动产品公司);胜利女神; [军] [航]奈克导弹(地对空导弹的一种); [gd]female;
Nil: [a]/nɪl/; [n](Nil)人名;(阿拉伯,土,土库,阿塞,哈萨,塔吉,吉尔,乌兹,匈)尼尔;(柬)尼; [gd]female;
Ninon: [a]/'niːnɒn/; [n](Ninon)人名;(罗,法)尼农;(英)妮农; [gd]female;
Nixie: [a]/'niksi/; [n]女水妖; [gd]female;
Noni: [a]/'nəʊnɪ/; [n]诺丽果汁(果汁品牌名); [gd]female;
Nora: [a]/'nɔ:rə/; [n]诺拉(女子名); [gd]female;
Noreen: [a]/'nɔ:ri:n; nɔ:'ri:n/; [n]诺琳(女子名,等于Nora); [gd]female;
Norma: [a]/'nɔrmə/; [n]矩尺星座;诺尔玛(女子名); [gd]female;
Nova: [a]/ˈnəʊvə/; [n](Nova)人名;(意,西,塞,葡)诺娃(女名),诺瓦;(英)诺瓦; [天]新星; [gd]female;
Olga: [a]/'ɔlɡə/; [n]奥尔加(女子名); [gd]female;
Olive: [a]/ˈɒlɪv/; [n](Olive) (美)奥利芙(人名); [adj]橄榄绿的;(面色,肤色)黄棕色的; [gd]female;
Olivette: [a]/'ɒlɪvet/; [电]强烈泛光灯; [gd]female;
Olympia: [a]/əu'limpiə/; [n]奥林匹亚(希腊一地名); [gd]female;
Opal: [a]/ˈəʊpl/; [n](Opal)人名;(英)奥珀尔;(土,法)奥帕尔; [gd]female;
Opaline: [a]/'əʊp(ə)laɪn; -lɪn/; [n]乳白色;乳白玻璃; [adj]蛋白石的,蛋白石状的;发乳光的;乳白色的; [gd]female;
Ophelia: [a]/ɔ'fi:ljə/; [n]奥菲莉娅(女子名); [gd]female;
Ora: [a]/'orɚ/; [n]奥拉(男子名); [gd]female;
Orel: [a]/ɔ'rjɔl/; [n]奥廖尔(前苏联城市); [gd]female;
Pacifica: [a]/pə'sifəkə/; [n]帕西菲卡(美国加利福尼亚州西部城市名);克莱斯勒太平洋(车名); [gd]female;
Pam: [a]/pæm/; abbr. 脉冲幅度调制; [n](Pam)人名;(英,尼日利)帕姆; [gd]female;
Pamela: [a]/'pæmilə/; [n]帕梅拉(女子名); [gd]female;
Pandora: [a]/pæn'dɔːrə/; [n]潘朵拉; [gd]female;
Pansy: [a]/ˈpænzi/; [n]潘西(女子名); [gd]female;
Patience: [a]/ˈpeɪʃns/; [n]耐性,耐心;忍耐,容忍; [gd]female;
Pauline: [a]/'pɔ:lin/; [adj]圣保罗的;圣保罗写的;圣保罗教义的; [n](美,英,法)宝林(人名); [gd]female;
Pearl: [a]/pɜːl/; [n]珀尔(女子名); [gd]female;
Peg: [a]/peɡ/; [n](Peg) (美)佩格(人名); [adj]越往下端越细的; [gd]female;
Penelope: [a]/pə'nɛləpi/; [n]佩内洛普(女子名);Odysseus的忠实妻子; [gd]female;
Penni: [a]/'penɪ/; [n](Penni)人名;(意)彭尼; [gd]female;
Peri: [a]/'pɪərɪ/; [n](Peri)人名;(英,西,俄,意,以)佩里; [gd]female;
Perl: [a]/pɜːl/; [n](Perl) (美,俄,印)佩尔(人名); [gd]female;
Perle: [a]/pə:l/; [n](Perle)人名;(英)珀尔; [gd]female;
Persis: [a]/ˈpɜːsɪs/; [n]珀西斯(女子名);波西斯(伊朗西南部古国); [gd]female;
Pet: [a]/pet/; [n](Pet)人名;(俄)佩特;(柬)贝; [vt]宠爱; vi. 生气;爱抚; [adj]宠爱的; [gd]female;
Peta: [a]/'pitə/; [n](Peta)人名;(意)佩塔; [gd]female;
Petunia: [a]/pəˈtjuːniə/; [n]矮牵牛花,碧冬茄;茄科; [gd]female;
Phaedra: [a]/'fɛdrɚ/; [n]菲德拉(Minos 之女); [gd]female;
Phebe: [a]/'fi:bi:/; [n]菲比(女子名); [gd]female;
Philippine: [a]/ˈfɪlɪpiːn/; [adj]菲律宾的;菲律宾人的; [n]菲律宾语; [gd]female;
Phoebe: [a]/'fiːbɪ/; [n]福柏(希腊神话中的月亮女神);菲比(女子名); [天]土卫九;月亮;(骰子戏)五点; [gd]female;
Pia: [a]/'paɪə; 'piːə/; [n](Pia) (美,意,英,法)皮亚(人名); [gd]female;
Pier: [a]/pɪə(r)/; [n](Pier)人名;(英,德)皮尔;(西)彼尔;(意)皮耶尔; [gd]female;
Polly: [a]/ˈpɒlɪ/; [n]波莉(女子名,等于Mary);鹦哥(鹦鹉的通称,等于poll parrot); [gd]female;
Pollyanna: [a]/ˌpɒliˈænə/; [n](美,英,澳,法,巴西)宝乐娅娜(人名);(美,瑞典,菲律宾)宝乐娅娜(姓氏); [gd]female;
Poppy: [a]/ˈpɒpi/; [n]罂粟花;罂粟属植物;深红色; [adj]罂粟科的; [gd]female;
Portia: [a]/'pɔ:ʃiə/; [n]波西亚(女子名); [gd]female;
Prudence: [a]/ˈpruːdns/; [n]普鲁登斯(女子名); [gd]female;
Prunella: [a]/prʊ'nelə/; [n](Prunella)人名;(英)普鲁内拉; [gd]female;
Quinta: [a]/'kwintə/; [n](Quinta)人名;(西,葡)金塔; [gd]female;
Rachel: [a]/'reɪtʃl/; [n]拉结(旧约圣经里雅各的妻子); [gd]female;
Rae: [a]/rei/; [n]瑞伊(女子名,Rachel的昵称); [gd]female;
Raf: [a]/ˌɑːr eɪ ˈef; ræf/; abbr. 英国皇家空军(Royal Air Force); [n](Raf)人名;(俄,德)拉夫; [gd]female;
Ranee: [a]/ˈrɑːniː; rɑːˈniː/; [n](Ranee)人名;(泰)拉尼; [gd]female;
Rani: [a]/ˈrɑːniː; rɑːˈniː/; [n](Rani)人名;(意)拉尼; [gd]female;
Raven: [a]/ˈreɪvn/; [n](Raven)人名;(英)雷文;(德)拉文; [adj]乌黑的; [vt]掠夺;狼吞虎咽; vi. 掠夺;狼吞虎咽; [gd]female;
Rebecca: [a]/rɪ'bekə/; [n]丽贝卡(女子名,寓意迷人的美); [gd]female;
Ree: [a]/riː/; v. 筛(面粉或颗粒较细的物质); [adj]不合理的;糊涂的; [n](Ree) (美)雷(人名); [gd]female;
Regina: [a]/rɪˈdʒaɪnə/; [n]女王;女王称号; [gd]female;
Rhea: [a]/ˈriːə/; [n]瑞亚(众神之母);土星的第五卫星; [gd]female;
Robbin: [a]/'rɔbin/; [n]梭心(等于roband); [gd]female;
Robinia: [a]/rə'bɪnɪə/; [n]刺槐;洋槐; [gd]female;
Ronda: [a]/'rɔndə/; [n]朗达(女子名); [gd]female;
Rosario: [a]/rəu'sɑ:riəu; rɔ:'sɑ:rijɔ:/; [n]罗萨里奥(阿根廷港市);萝莎丽奥(电影名); [gd]female;
Rose: [a]/rəʊz/; [n]玫瑰花;玫瑰红葡萄酒;玫瑰色;红润的肤色;莲蓬式喷嘴;玫瑰花形纹章; [adj]玫瑰的;玫瑰色的,粉红色的; v. 上升;达到较高水平;起立;起床;升起(rise 的过去式); [gd]female;
Rosella: [a]/rəu'zelə/; [n](Rosella)人名;(意)罗塞拉;(西)罗塞利亚; [gd]female;
Roselle: [a]/ro'zɛl/; [n](Roselle)人名;(英,法)罗塞尔; [gd]female;
Rosemary: [a]/ˈrəʊzməri/; [n] [植]迷迭香; [gd]female;
Rosette: [a]/rəʊˈzet/; [n](Rosette)人名;(法)罗塞特; [建]圆花饰; [gd]female;
Rosina: [a]/rəu'zi:nə/; [n]罗西娜(女子名); [gd]female;
Rosita: [a]/rəu'zi:tə/; [n]罗西塔(女子名,等于Rose); [gd]female;
Rosy: [a]/ˈrəʊzi/; [adj]蔷薇色的,玫瑰红色的;美好的;乐观的;涨红脸的; [n](Rosy)人名;(罗,意,瑞,典)罗茜(女名),罗西;(英)罗茜; [gd]female;
Row: [a]/rəʊ/; [n](Row)人名;(英)罗; [vt]划船;使..成排; vi. 划船;争吵; [gd]female;
Roxana: [a]/rɔk'sænə/; [n]罗克珊娜(女子名); [gd]female;
Rubia: [a]/'ru:biə/; [n] [植]茜草属; [gd]female;
Saba: [a]/'sɑ:bə/; [n]塞巴(阿拉伯南部的一个古国,今天的也门);萨巴岛(西印度群岛的背风群岛北部的岛);赛伯伊王国(经营黄金,香料和宝石的古代王国); [gd]female;
Sabina: [a]/sə'binɚ/; [n]萨拜娜(女子名); [gd]female;
Sabine: [a]/'seibain/; [n]萨宾人;萨宾语;色宾河(美国得克萨斯州东部河流); [adj]萨宾人的;萨宾语的; [gd]female;
Sabra: [a]/'sæbrə/; [n]出生在以色列的犹太人;土生土长的以色列人; [gd]female;
Sadie: [a]/'seidi/; [n]莎蒂(女子名); [gd]female;
Sally: [a]/ˈsæli/; [n](Sally)(美)莎莉(人名); [gd]female;
Salome: [a]/sə'ləumi/; [n](马太福音中的)萨洛米; [gd]female;
Samara: [a]/'sæmərə; sə'mɑːrə/; [n](Samara)人名;(葡,罗,阿尔巴)萨马拉; [植]翅果; [gd]female;
Sapphire: [a]/ˈsæfaɪə(r)/; [n]蓝宝石; [宝]青玉;天蓝色; [adj]天蓝色的; [gd]female;
Sarah: [a]/'serə/; [n]萨拉(《圣经》中的人物);莎拉(女子名); [gd]female;
Sari: [a]/ˈsɑːri/; [n](Sari) (法,爱,丹)萨里(人名); [gd]female;
Scarlet: [a]/ˈskɑːlət/; [adj]深红的;鲜红色的;罪孽深重的;淫荡的; [n](Scarlet)人名;(英)斯卡利特;(罗)斯卡尔莱特; [gd]female;
Selene: [a]/si'li:nə/; [n]月之女神(希腊神话中的一个形象); [gd]female;
Sella: [a]/'selə/; [n]萨拉(姓氏); [gd]female;
Sena: [a]/ˈseɪnɑː/; [n]塞纳(女子名); [gd]female;
Serene: [a]/səˈriːn/; [adj]平静的;安详的;清澈的;晴朗的; [n]平静;晴朗; [vt]使平静; [gd]female;
Shandy: [a]/ˈʃændi/; [n]搀柠檬汁的啤酒;一种搀干姜汁麦酒; [gd]female;
Sharia: [a]/ʃəˈriːə/; [n]伊斯兰教教法; [gd]female;
Sharon: [a]/'ʃærən/; [n]莎伦(女子名); [gd]female;
Shawnee: [a]/ʃɔːˈniː/; [n]肖尼(美国城市);美国萧尼族印第安人;萧尼语; [gd]female;
Sheba: [a]/'ʃi:bə/; [n]示巴(古代国家名);示巴女王;极具魅力的美女; [gd]female;
Sheila: [a]/ˈʃiːlə/; [n](Sheila)人名;(法)塞拉;(印)谢拉;(英)希拉; [gd]female;
Shelly: [a]/'ʃɛli/; [adj]多壳的,有壳的;贝壳般的; [n](Shelly) 雪莱(人名); [gd]female;
Sherry: [a]/ˈʃeri/; [n](Sherry)人名;(英)谢里; [gd]female;
Sib: [a]/sɪb/; [n](Sib)人名;(英)茜布(教名Sibyl,Sibylla,Sybil的昵称); [adj]近亲的,有血缘关系的; [gd]female;
Sile: [a]/sail/; v. 大雨如注;流下; [n](Sile) (拉脱维亚,美,英)西列(人名); [gd]female;
Sioux: [a]/suː/; [n]苏人,苏族(美洲土著,很多居于美国南达科他州); [adj]苏人的;苏语的; [gd]female;
Sissy: [a]/ˈsɪsi/; [n](Sissy)人名;(英)茜茜(教名Cecil,Cecilia,Cecily,Cicely,Sisley的昵称); [adj]女人气的,娘娘腔的;柔弱的; [gd]female;
Sophi: [a]/'səufi/; [n]萨非(16～17世纪波斯王的称号,等于Sophy);超皓鞋业(公司名称); [gd]female;
Sophia: [a]/səʊ'fɪə/; [n]索菲娅(女子名); [gd]female;
Sophie: [a]/'səʊfɪ/; [n]索菲(女子名); [gd]female;
Star: [a]/stɑː(r)/; [n](Star)人名;(瑞典)斯塔尔;(德)施塔尔; [vt]用星号标于;由.主演,由.担任主角; vi. 担任主角; [adj]明星的,主角的;星形的; [gd]female;
Storm: [a]/stɔːm/; [n](Storm)人名;(瑞典)斯托姆;(德)施托姆;(英,西,芬)斯托姆; [vt]猛攻;怒骂; [gd]female;
Stormy: [a]/ˈstɔːrmi/; 斯托米(人名); [gd]female;
Sue: [a]/suː; sjuː/; [vt]控告;请求; vi. 控告;提出请求; [n](Sue)人名;(日)末(名);(法)休;(英)休(女子教名Susan,Susanna的昵称); [gd]female;
Sukey: [a]/'su:ki/; [n](Sukey)人名;(英)苏姬(女子教名Susan,Susanna的昵称); [gd]female;
Sula: [a]/'su:lə/; [n]苏拉(小说名); [gd]female;
Sunshine: [a]/ˈsʌnʃaɪn/; [n](Sunshine)人名;(英)森夏恩; [gd]female;
Susan: [a]/'su:zn/; [n]苏珊(女子名); [gd]female;
Susanna: [a]/su:'zænə/; [n]苏珊娜(女子名); [gd]female;
Susi: [a]/'sʊsi/; [n](Susi) (美,瑞,印)苏西(人名); [gd]female;
Sylvia: [a]/'silviə/; [n]西尔维亚(女子名); [gd]female;
Taffy: [a]/ˈtæfi/; [n]威尔士人;太妃糖; [gd]female;
Tana: [a]/'tɑ:n; -nɑ:/; [n]塔纳湖(位于埃塞俄比亚西北部);塔纳河(肯尼亚东部河流); [gd]female;
Tansy: [a]/'tænzɪ/; [n]艾菊;艾菊属植物; [gd]female;
Tara: [a]/tə'rɑː/; [n](Tara) (英,印,塞,,伊,尼)塔拉(人名); [gd]female;
Tera: [a]/ˈterə/; pref. 表示"兆"的意思; [n](Tera)人名;(西,土)特拉; [gd]female;
Terra: [a]/'tɛrə/; [n]特拉(大地女神); [gd]female;
Tessa: [a]/'tesə/; abbr. 免税特别储蓄账户(tax exempt special savings account); [n](Tessa)人名;(日)铁佐 (姓);(喀)特萨;(意)泰萨;(英)特莎; [gd]female;
Thalia: [a]/θə'laiə; 'θeiliə/; [n]塔利亚(希腊神话中的缪斯之一); [gd]female;
Theodosia: [a]/,θiə'doʃɪr/; [n]西奥多西娅(女子名); [gd]female;
Theresa: [a]/tə'ri:sə/; [n]特丽萨(女子名); [gd]female;
Tiff: [a]/tɪf/; [n]淡酒;一口;口角;生气; vi. 生气;小争吵; [vt]啜;饮; [gd]female;
Tiffany: [a]/'tɪf(ə)nɪ/; [n](Tiffany) (美,英)蒂凡妮(人名); [gd]female;
Tina: [a]/'ti:nə/; [n]蒂娜(女子名); [gd]female;
Tine: [a]/taɪn/; [n](Tine)人名;(德,意)蒂内; [vt](英)丢失;浪费; vi. 被丢失;遭难; [gd]female;
Tootsie: [a]/'tʊtsɪ/; [n]亲爱的;聚会的女招待; [gd]female;
Tori: [a]/'tɔːrɪ/; [n](Tori)人名;(喀,意)托里;(英)托丽; [gd]female;
Tory: [a]/ˈtɔːri/; [n]保守党员; [adj]保守主义的; [gd]female;
Tuesday: [a]/ˈtjuːzdeɪ; ˈtjuːzdi/; [n]星期二; [gd]female;
Ula: [a]/'ju:lə/; [n]齿龈(等于gums); [gd]female;
Una: [a]/,ju: en 'eɪ/; [n](Una) (美,爱,塞)尤纳(人名); [gd]female;
Ursuline: [a]/'ə:sjulain/; [n]乌尔苏拉会的修女; [gd]female;
Valencia: [a]/və'lɛnʃɪə/; [n]巴伦西亚(西班牙城市); [gd]female;
Vanda: [a]/'vændə/; [n](Vanda)人名;(俄,罗,匈,塞,捷,意)万达; [园艺]万带兰; [gd]female;
Vanessa: [a]/vəˈnesə/; [n](Vanessa) (美,法)瓦内萨(人名); [gd]female;
Veda: [a]/ˈveɪdə; ˈviːdə/; [n]吠陀经;吠陀本集(印度最古老的宗教文献和文学作品的总称); [gd]female;
Velvet: [a]/ˈvelvɪt/; [n]天鹅绒,丝绒;天鹅绒似的东西; [adj]天鹅绒的; [gd]female;
Vena: [a]/'viːnə/; [n](Vena)人名;(罗,塞,意)韦娜(女名),韦纳; [解剖]静脉; [gd]female;
Venus: [a]/ˈviːnəs/; [n] [天]金星;维纳斯(爱与美的女神); [gd]female;
Vera: [a]/'vɪərə/; abbr. 通用实验性反应堆装置(Versatile Experimental Reactor Assembly ); [n](Vera)人名;(西)贝拉;(泰)威拉;(俄,塞,匈,罗,波)薇拉; [gd]female;
Veronica: [a]/və'rɒnɪkə/; [n]维罗妮卡(女子名);通过Gopher使用的一种自动搜索服务;印有耶稣面像的织物; [gd]female;
Vi: [a]/,vi 'aɪ/; abbr. 美国维尔京岛之邮递区号(Virgin Islands);垂直距离(vertial internal); [n](Vi)人名;(越)韦; [gd]female;
Victoria: [a]/vɪk'tɔːrɪə/; [n]维多利亚(女子名); [gd]female;
Vina: [a]/'vinɑ/; [n](Vina) (美,印尼)维娜(人名); [gd]female;
Viola: [a]/viˈəʊlə/; [n](Viola)人名;(俄,意,罗,匈,葡,塞,捷,瑞典)维奥拉;(西)比奥拉;(英)维奥拉,薇奥拉(女名); [gd]female;
Violet: [a]/ˈvaɪələt/; [n](Violet)人名;(西)比奥莱特;(法)维奥莱;(印,匈,英)维奥莱特; [adj]紫色的;紫罗兰色的; [gd]female;
Violetta: [a]/,vaiə'letə/; [n]维奥莱塔(女子名,等于Violet); [gd]female;
Virginia: [a]/və(:)'dʒinjə/; [n]弗吉尼亚(女子名);弗吉尼亚州; [adj]弗吉尼亚州的; [gd]female;
Vita: [a]/ˈviːtə/; [n](Vita)人名;(英,法,俄,意,葡,匈,捷,塞,芬,德)维塔;(西)比塔; [gd]female;
Viva: [a]/ˈviːvə; ˈvaɪvə/; int. 万岁(表示祝愿或赞成的欢呼声); [n](Viva) (美,俄)比瓦(人名); [gd]female;
Wilhelmina: [a]/,wɪlhɛl'minɚ/; [n]威廉敏娜(女子名); [gd]female;
Willow: [a]/ˈwɪləʊ/; [n](Willow)人名;(英)威洛,薇洛(女名); [林]柳树; [木]柳木制品; [adj]柳木制的; [gd]female;
Windy: [a]/ˈwɪndi/; [adj]多风的,有风的;腹胀的;吹牛的; [gd]female;
Wren: [a]/ren/; [n](Wren)人名;(英)雷恩; [gd]female;
Xenia: [a]/'zinjə/; [n]齐妮亚(女子名,等于Zenia); [gd]female;
Zea: [a]/'zi:ə/; [n] [植]玉蜀黍属; [gd]female;
Zoe: [a]/'zəui/; 佐伊; [gd]female;
Zola: [a]/'zəulə/; [n]左拉(法国作家,小说家); [gd]female;
Zonda: [a]/'zɔndə, 'sɔ:ndɑ:/; [n](Zonda)人名;(匈)宗道; [气象]佐达风(指自安第斯山脉吹越阿根廷草原的干热多尘北风);干热焚风; [gd]female;
