be of prime importance: phr. 极其重要; [acc] /bi ʌv praɪm ɪmˈpɔrtns/;
count down: phr. (发射火箭等时)倒读数; [acc] /kaʊnt daʊn/;
come in the form of: phr. 以..的形式; [acc] /kʌm ɪn ðə fɔːrm əv/;
feel up to: phr. 觉得能够胜任,觉得身体挺得住; [acc] /fiːl ʌp tu/;
be eager to do sth.: phr. 急欲,渴望做; [acc] /bi ˈiːɡər tu duː ˈsʌmθɪŋ/;
tidy up: phr. 整理;收拾; [acc] /ˈtaɪdi ʌp/;
at the risk of: phr. 冒着...的危险; [acc] /æt ði rɪsk ʌv/;
throw oneself into: phr. 热心投身于,开始努力干; [acc] /θro wʌnˈsɛlf ˈɪntu/;
in excess of: phr. 超过; [acc] /ɪn ˈekˌses əv/;
none the less: phr. 还是;尽管如此.仍然,依然; [acc] /nʌn ðə les/;
threaten to do sth.: phr. 扬言要.; [acc] /ˈθretn tu duː ˈsʌmθɪŋ/;
be suspicious of: phr. 怀疑; [acc] /bi səˈspɪʃəs ʌv/;
be made of: phr. 由..构成;由..组成; [acc] /bi meɪd əv/;
in contrast with: phr. 和.成对比;和.大不相同; [acc] /ɪn ˈkɑːntræst wɪθ/;
come around: phr. 顺便来访;苏醒;复苏; [acc] /kʌm əˈraʊnd/;
without fail: phr. 必定;一定; [acc] /wɪðˈaʊt feɪl/;
vantage point: phr. (观察事物的)有利地点;有利地位; [acc] /ˈvæntɪdʒ pɔɪnt/;
in and out: [adv]进进出出;  phr. 进进出出; [acc] /ɪn ənd aʊt/;
make a fortune: phr. 发财;赚钱; [acc] /meɪk eɪ ˈfɔːrtʃən/;
make fun of: phr. 嘲笑,取笑; [acc] /meɪk fʌn əv/;
take notice of: phr. 注意,留心;注意到; [acc] /teɪk ˈnoʊtɪs ɑv/;
usher in: phr. 迎接;传报;引发;产生,开创;引领; [acc] /ˈʌʃər ɪn/;
curl up: phr. 卷起,蜷曲,撅起; [acc] /kɜːrl ʌp/;
out of condition: phr. 健康不佳;身体不好;情况不佳; [acc] /aʊt əv kənˈdɪʃən/;
in an effort to: phr. 企图, 努力想;为了,努力; [acc] /ɪn ən ˈefərt tu/;
put...into practice: phr. 实施,实行; [acc] /pʊt ˈɪntu ˈpræktɪs/;
live up to: phr. 不辜负;做到; [acc] /lɪv ʌp tu/;
exert oneself: phr. 努力;尽力; [acc] /ɪɡˈzɜːrt wʌnˈself/;
ease in: phr. (小心翼翼地)把某物移入或放入某一位置,使逐步适应;逐步适应,放松自己; [acc] /iːz ɪn/;
fight for: phr. 为.而战斗;争斗,争取; [acc] /faɪt fɔr/;
be eager for: phr. 想得到;渴望; [acc] /biː ˈiːɡər fɔːr/;
can't help but do sth.: phr. 忍不住做某事; [acc] /kænt help bət du ˈsʌmθɪŋ/;
through thick and thin: phr. 不顾艰难险阻;在任何情况下;患难与共,风雨同舟; [acc] /θrʊ θɪk ənd θɪn/;
by the time: phr. 到.时候;直到.时候; [acc] /baɪ ðə taɪm/;
quite a number of: phr. 相当多的(许多); [acc] /kwaɪt ə ˈnʌmbər ʌv/;
and so forth: phr. 等等,诸如此类; [acc] /ənd soʊ fɔːrθ/;
take account of: phr. 考虑到;顾及;体谅; [acc] /teɪk əˈkaʊnt ʌv/;
be indifferent to: phr. 对...漠不关心;把...置之度外; [acc] /biː ɪnˈdɪfrənt tuː/;
be confident in: phr. 确信;深信;对.有信心;对..充满信心; [acc] /biˈkɑnfədənt ɪn/;
help oneself: phr. 自助,自取所需(食物); [acc] /help wʌnˈself/;
have a good appetite: phr. 胃口好;饭量大; [acc] /hæv eɪ ɡʊdˈæpɪtaɪt/;
credit to: phr. 赞赏,归功于,把.归于; [acc] /ˈkredɪt tu/;
be obliged to sb.: phr. 感激某人; [acc] /biː əˈblaɪdʒd tuː ˈsʌmbədi/;
under investigation: phr. 在调查研究中,正在调查中;在观察中; [acc] /ˈʌndər ɪnˌvestɪˈɡeɪʃn/;
be made up of: phr. 由.构成,由.组成; [acc] /bi meɪd ʌp əv/;
stand on one's feet: phr. 依靠自己,自力更生,自食其力;站起来; [acc] /stænd ɑːn wʌnz fiːt/;
build up: phr. 逐步增加(增强),逐渐增进;建立;聚集; [acc] /bɪld ʌp/;
catch a glimpse of: phr. 瞥一眼,瞥见了; [acc] /kætʃ ə ɡlɪmps əv/;
in competition with: phr. 在与.竞争之中;与..比赛; [acc] /ɪnˌkɑːmpəˈtɪʃn wɪð/;
put a halt to: phr. (使)停止,制止; [acc] /pʊt eɪ hɔːlt tu/;
point out: phr. 指出; [acc] /pɔɪnt aʊt/;
be sick of: phr. 对...感到厌烦的; [acc] /bi sɪk ʌv/;
narrow down to: phr. 缩减,缩小,收紧; [acc] /ˈnæroʊ daʊn tu/;
exert pressure on: phr. 对.施加压力; [acc] /ɪɡˈzɜːrt ˈpreʃər ɑːn/;
with reference to: phr. 关于,有关;根据; [acc] /wɪð ˈrefərəns tu/;
turn into: phr. (使)变成; [acc] /tɜːrn ɪntu/;
hang about: phr. 闲逛;徘徊;逗留; [acc] /hæŋ əˈbaʊt/;
have a ball: phr. 狂欢,玩得开心,享受; [acc] /hæv ə bɔːl/;
set off: phr. 出发; [acc] /set ɑf/;
water closet: phr. 盥洗室;盥洗室,厕所; [acc] /ˈwɔːtər klɑːzət/;
expand one's knowledge: phr. 增长知识; [acc] /ɪkˈspænd wʌnzˈnɑːlɪdʒ/;
green with envy: phr. 十分妒忌,非常嫉妒; [acc] /ɡrin wɪð ˈɛnvi/;
subject to: phr. 处于.中;易受...影响的;屈服于...的;取决于; [acc] /ˈsʌbdʒeɪkt tu/;
date back: phr. 回溯至,追溯; [acc] /det bæk/;
out of shape: phr. 身体状况不佳;变形,走样;身材不好; [acc] /aʊt əv ʃeɪp/;
come out with: phr. 出版;说出,泄露(秘密);提出,发表,讲出; [acc] /kʌm aʊt wɪð/;
gain a reputation for: phr. 以.而出名,赢得.的声誉; [acc] /ɡeɪn ə ˌrepjuˈteɪʃn fɔːr/;
lead to: phr. 导致,导向; [acc] /liːd tu/;
tend to: phr. 易于,往往会,倾向于,有助于; [acc] /tend tu/;
be discontent with: phr. 不满足于; [acc] /bi ˌdɪskənˈtent wɪð/;
tourist destination: phr. 目的地,旅游胜地,旅游目的地; [acc] /ˈtʊrɪst ˌdestɪˈneɪʃn/;
place emphasis on: phr. 强调;着重于;  [v]重视; [acc] /pleɪsˈemfəsɪs ɑːn/;
rely on: phr. 依靠; [acc] /rɪ'laɪ ɑːn/;
be tolerant of: phr. 对 ... 容忍(或宽容); [acc] /bi ˈtɑːlərənt əv/;
out of order: phr. 出毛病,运转不正常; [acc] /aʊt əv ˈɔːrdər/;
at the instance of: phr. 经.提议,应.之请; [acc] /æt ði ˈɪnstəns ʌv/;
be of benefit to: phr. 对.有益,有好处; [acc] /bi əv ˈbenɪfɪt tu/;
take...into account: phr. 把.考虑在内; [acc] /teɪk ˈɪntu əˈkaʊnt/;
range from...to...: phr. 从.到.的范围;在.中变化; [acc] /reɪndʒ frəm tu/;
have an eye for: phr. 有眼光,对.有鉴赏力; [acc] /hæv æn aɪ fɔːr/;
take over one's business: phr. 接管某人的生意; [acc] /teɪk ˈoʊvər wʌnz ˈbɪznəs/;
be engaged in: phr. 从事于,忙于;  [vt]致力于...; [acc] /bi ɪnˈɡeɪdʒd ɪn/;
ramp up: [v]巩固;  phr. 提高,斜升,提升; [acc] /ræmp ʌp/;
pull out of: phr. 离开,退出;取消; [acc] /pʊl aʊt ʌv/;
from that moment on: phr. 那时起,从那一刻起; [acc] /frəm ðæt ˈmoʊmənt ɔːn/;
come in sight: phr. 看见,出现,表示看见; [acc] /kʌm ɪn saɪt/;
be enthusiastic about: phr. 对.热情; [acc] /bi ɛnˌθuziˈæstɪk əˈbaʊt/;
devoid of: phr. 没有,缺乏的; [acc] /dɪˈvɔɪd əv/;
gain weight: phr. 增加体重,增肥,长胖了; [acc] /ɡeɪn weɪt/;
brand new: phr. 全新的,崭新的; [acc] /ˌbrænd ˈnuː/;
be fit to: phr. 适合; [acc] /bi fɪt tu/;
keep an eye on: phr. 密切注视; [acc] /kiːp æn aɪɑːn/;
tune out: phr. 关掉;无视,不理会; [acc] /tuːn aʊt/;
end up: phr. 以.告终; [acc] /end ʌp/;
set forth: [vt]陈述;阐明;  phr. 出发,启程; [acc] /set fɔːrθ/;
be resistant to: phr. 对...有抵御能力的,抗拒的,抵抗的;耐...的; [acc] /bi rɪˈzɪstənt tu/;
catch up with: phr. 赶上; [acc] /kætʃ ʌp wɪð/;
tell apart: phr. 辨别;区分,区别; [acc] /tel əˈpɑːrt/;
upside down: phr. 颠倒,混乱,倒转,翻转; [acc] /ˌʌpsaɪd ˈdaʊn/;
then and there: phr. 当场,立即; [acc] /ðen ænd ðer/;
run parallel to: phr. 与.平行; [acc] /rʌn ˈpærəˌlɛl tu/;
gain access to: phr. 接近,有接近.的权利; [acc] /ɡeɪn ˈækses tə/;
satisfy one's needs: phr. 满足某人的需要; [acc] /ˈsætɪsfaɪ wʌnz niːd/;
under control: phr. 被控制住,在...控制下; [acc] /ˈʌndər kənˈtroʊl/;
day off: phr. 休假日,休息日; [acc] /ˌdeɪ ˈɔːf/;
root for: phr. 全力支持,为.加油喝彩,赞助; [acc] /rut fɔr/;
in commemoration of: phr. 为纪念(为庆祝); [acc] /ɪn kəˌmɛməˈreʃən ʌv/;
career development: phr. 职业培训,职业发展; [acc] /kəˈrɪr dɪˈvɛləpmənt/;
collide with: phr. 碰撞;抵触; [acc] /kəˈlaɪd wɪð/;
show respect for: phr. 对...表示尊敬; [acc] /ʃo rɪˈspɛkt fɔr/;
wear away: phr. 磨去; [acc] /wer əˈweɪ/;
be attached to: phr. 依恋;附属于; [acc] /bi əˈtætʃt tu/;
throw up: phr. 呕吐;恶心;匆匆建造;产生;放弃; [acc] /θroʊ ʌp/;
take a photograph of: phr. 拍照; [acc] /teɪk ə ˈfoʊtəɡræf əv/;
free of charge: phr. 不收费,免费的,无偿的; [acc] /friː əv tʃɑːrdʒ/;
doze off: phr. 打瞌睡;打盹儿; [acc] /doʊz ɑːf/;
be dying to do sth.: phr. 渴望做某事; [acc] /biˈdaɪɪŋ tuː duːˈsʌmθɪŋ/;
adopted child: phr. 养子(女),义子; [acc] /əˈdɑːptɪd tʃaɪld/;
the Gold Rush: phr. 淘金热; [acc] /ðə ɡoʊld rʌʃ/;
fade into: phr. 逐渐消失而变成(无足轻重的东西),在.逐渐消失;渐渐融入于; [acc] /feɪd ɪntu/;
in great shape: phr. 身体状态好,身材好; [acc] /ɪn ɡreɪt ʃeɪp/;
step by step: phr. 一步步地,逐步地,逐渐地; [acc] /step baɪ step/;
get sick of: phr. 厌烦,对.感到厌恶; [acc] /ɡet sɪk əv/;
make an effort to do: phr. 努力(做).; [acc] /meɪk ən ˈefərt tə duː/;
keep pace with: phr. 跟上,与..齐步前进,跟上.的最新发展; [acc] /kiːp peɪs wɪð/;
take priority over: phr. 优先; [acc] /teɪk praɪˈɔːrəti ˈoʊvər/;
be equipped with: phr. 装备着; [acc] /bi ɪˈkwɪpt wɪð/;
all year round: phr. 一年到头,终年,四季;全年; [acc] /ɔl jɪr raʊnd/;
draw one's attention to: phr. 引起某人注意; [acc] /drɔː wʌnz əˈtenʃn tu/;
be determined to do sth.: phr. 下定决心要.; [acc] /bi dɪˈtɜːrmɪnd tu du ˈsʌmθɪŋ/;
confronted with: phr. 面临;对质; [acc] /kənˈfrʌnt wɪð/;
appeal for: phr. 要求,呼吁; [acc] /əˈpiːl fɔːr/;
conference room: phr. 会议厅,会议场所及教室会议室; [acc] /ˈkɑːnfərəns ruːm/;
be loyal to: phr. 对.忠诚,忠于;忠实于...; [acc] /bi ˈlɔɪəl tu/;
full refund: phr. 全额退款,全额偿还; [acc] /fʊl ˈriːfʌnd/;
without prejudice: phr. 没偏见;不使受损害; [acc] /wɪðˈaʊt ˈprɛdʒədɪs/;
turn a blind eye: phr. 视而不见,熟视无睹; [acc] /tɚn e blaɪnd aɪ/;
puzzle out: phr. 苦苦思索而弄清楚或解决,解决难题; [acc] /ˈpʌzəl aʊt/;
be inappropriate for: phr. 不合适的,不适当的; [acc] /bi ɪnəˈproʊpriət fɔːr/;
under consideration: phr. 在考虑之中; [acc] /ˈʌndɚ kənˌsɪdəˈreʃən/;
in contrast to: phr. 和...对比,相比之下;与...相反; [acc] /ɪn ˈkɑːntræst tu/;
be convinced of: phr. 确信,相信,深信; [acc] /bi kənˈvɪnst ʌv/;
volunteer to do: phr. 自愿做; [acc] /ˌvɑːlənˈtɪr tu du/;
straight away: phr. 立即,马上; [acc] /streɪt əˈweɪ/;
take an interest in: phr. 对.产生兴趣,过问; [acc] /tek ən ˈɪntrɪst ɪn/;
discriminate against: phr. 歧视,排斥;  [vt]虐待; [acc] /dɪˈskrɪməˌnet əˈɡenst/;
a shortage of: phr. 短缺,缺乏; [acc] /ə ˈʃɔːrtɪdʒ ʌv/;
to the delight of: phr. 令.感到喜悦; [acc] /tu ðə dɪˈlaɪt ʌv/;
struggle to do: phr. 奋斗,努力做某事;挣扎着做某事; [acc] /ˈstrʌɡl tə duː/;
be ill at ease: phr. 局促不安,心神不宁;困窘; [acc] /bi ɪl æt iːz/;
lose track of: phr. 失去线索,失去消息,失去联系; [acc] /luːz træk ʌv/;
tick away: phr. (时间一分一秒地)过去; [acc] /tɪk əˈwe/;
have taste in: phr. 有品位,有鉴赏力; [acc] /hæv teɪst ɪn/;
raise one's spirits: phr. 使人振奋,打起精神; [acc] /reɪz wʌnz ˈspɪrɪt/;
put up with: phr. 忍受,容忍; [acc] /pʊt ʌp wɪð/;
conform to: phr. 遵从,遵守;符合; [acc] /kənˈfɔrm tu/;
all day and all night: phr. 整日整夜; [acc] /ɔːl deɪ ænd ɔːl naɪt/;
stay in touch with: [v]与 ... 保持联系; [acc] /steɪ ɪn tʌtʃ wɪð/;
run out of: phr. 用完; [acc] /rʌn aʊt ɒv/;
bring forward: [v]提出;提前; [acc] /brɪŋ ˈfɔrwərd/;
be content with: phr. 满足于;以 ... 为满足; [acc] /bi ˈkɑnˌtɛnt wɪð/;
be strict about: phr. 对某事很严格,对某事严格要求; [acc] /biː strɪkt əˈbaʊt/;
infer from: phr. 从.中推测出.; [acc] /ɪnˈfɚ frʌm/;
burst into: phr. 突然开始;闯入; [acc] /bɜːrst ˈɪntʊ/;
on account of: phr. 因为; [acc] /ɑːn ə'kaʊnt əv/;
under the heel of: phr. 被.践踏(支配); [acc] /ˈʌndər ðə hiːl əv/;
keep in touch: phr. 与.保持联系; [acc] /kiːp in tʌtʃ/;
take one's place: phr. 取代某人; [acc] /teɪk wʌns pleɪs/;
face up: phr. 面对;正面朝上; [acc] /feɪs ʌp/;
think highly of: phr. 尊重;对.高度评价; [acc] /θɪŋk ˈhaɪli əv/;
set foot in: [vt]进入;  phr. 踏进; [acc] /set fʊt ɪn/;
be diverse from: phr. 和.不同; [acc] /bi daɪˈvɜːrs frʌm/;
expand on: phr. 进一步阐述,详述; [acc] /ɪkˈspænd ɑːn/;
consist of: phr. 由..组成; [acc] /kənˈsɪst ɑv/;
vote in: phr. 选举(选出来); [acc] /vot ɪn/;
pull in: phr. 停车;  [v]赚得;逮捕; [acc] /pʊl ɪn/;
be paved with: phr. 铺满,遍布; [acc] /biː peɪvd wɪð/;
no fewer than: phr. 不少于,至少;不下于;多至; [acc] /noʊ ˈfjuːə ðæn/;
beyond doubt: phr. 无疑地; [acc] /biːˈɑːnd daʊt/;
table tennis: [n]乒乓球; [acc] /ˈteɪbl tenɪs/;
figure in: phr. 算进去; [acc] /ˈfɪɡjər ɪn/;
career planning: phr. 职业生涯规划,职业规划; [acc] /kəˈrɪr ˈplænɪŋ/;
combine with: phr. 与...结合(联合); [acc] /kəmˈbaɪn wɪð/;
show signs of: phr. 显示...迹象; [acc] /ʃoʊ saɪnz əv/;
be delighted with: phr. 因...而十分高兴; [acc] /bi dɪˈlaɪtɪd wɪð/;
patch up: phr. 修补;平息;拼凑; [acc] /pætʃ ʌp/;
build confidence: phr. 树立信心; [acc] /bɪld ˈkɑnfɪdəns/;
at the rate of: phr. 以...速度或比率; [acc] /æt ði reɪt ʌv/;
take an active part in: phr. 积极参加; [acc] /tek ən ˈæktɪv pɑrt ɪn/;
within walking distance: phr. 步行可及,很近; [acc] /wɪˈðɪn ˈwɔːkɪŋ ˈdɪstəns/;
object to: phr. 反对; [acc] /əbˈdʒekt tu/;
take care: phr. 保重,当心,注意; [acc] /teɪk ker/;
one after the other: phr. 一个接着一个,陆续;  pro[n]相继); [acc] /wʌn ˈæftɚ ði ˈʌðər/;
get familiar with: phr. 变得熟悉,与..熟悉起来; [acc] /ɡɛt fəˈmɪljɚ wɪð/;
commit a crime: phr. 犯罪; [acc] /kəˈmɪt ə kraɪm/;
set up: phr. 设立,创立;提议,提倡;预备;(军事)训练; [acc] /set ʌp/;
beyond expression: phr. 无法表达(形容不出); [acc] /biˈɑnd ɪkˈsprɛʃən/;
warn sb. about: phr. 警告,警醒; [acc] /wɔːrn əˈbaʊt/;
come to an end: phr. 完结; [acc] /kʌm tu: æn end/;
make it difficult for sb.: phr. 难以,使.觉得困难; [acc] /meɪk ɪt ˈdɪfɪkəlt fɔːr ˈsʌmbədi/;
wrap up: phr. 包起来;完成某事; [acc] /ræp ʌp/;
put...into prison: phr. 关进监狱;把.投进监狱;使.坐牢; [acc] /pʊt ˈɪntu ˈprɪzn/;
become acquainted with: phr. 开始认识,开始了解,同.结识,熟悉; [acc] /bɪˈkʌm əˈkweɪntɪd wɪð/;
catch fire: phr. 着火,失火; [acc] /kætʃ ˈfaɪər/;
run off: phr. 逃跑;流掉;迅速离开; [acc] /ˈrʌnˌɔːf/;
a variety of: phr. 多种多样,种种; [acc] /ə vəˈraɪtiː əv/;
lead the way: phr. 引路,带路; [acc] /lid ðə weɪ/;
get tired of sth.: phr. 厌倦了某事; [acc] /ɡet ˈtaɪərd əv ˈsʌmθɪŋ/;
play a joke: phr. 开玩笑; [acc] /pleɪ eɪ dʒoʊk/;
strip down: phr. 脱去;拆开; [acc] /strɪp daʊn/;
have trouble in doing: phr. 做某事有困难; [acc] /hæv ˈtrʌbl ɪn ˈduːɪŋ/;
shear off: phr. 剪断,切掉; [acc] /ʃɪr ɔf/;
prop up: phr. 支撑;支持,支撑;给...撑腰;资助; [acc] /prɑp ʌp/;
think over: phr. 仔细考虑; [acc] /θɪŋk ˈoʊvər/;
in quest of: phr. 探索;寻求,寻找,探求;设法找到; [acc] /ɪn kwɛst ʌv/;
burst into laughter: phr. 突然笑起来,放声大笑; [acc] /bɜːrst 'ɪntʊ 'læftər/;
in the wrong: phr. 有错,错误的;负有责任; [acc] /ɪn ðə rɔːŋ/;
differ from: phr. 不同于,与..有区别; [acc] /ˈdɪfər frɑːm/;
indulge in: phr. 任凭自己沉溺于.,耽,耽于,醉; [acc] /ɪnˈdʌldʒ ɪn/;
at the head of: phr. 在.的最前面; [acc] /æt ði hɛd ʌv/;
be rid of: phr. 摆脱; [acc] /bi rɪd ʌv/;
out of style: phr. 不时髦的,过时的; [acc] /aʊt əv staɪl/;
a wealth of: phr. 很多的;大量的,丰富的; [acc] /eɪ welθəv/;
hold...in high esteem: phr. 十分尊敬,推崇; [acc] /hold ɪn haɪ ɪˈstim/;
inspire sth: phr. 激励,鼓舞,启迪; [acc] /ɪnˈspaɪər ˈsʌmθɪŋ/;
be worthy of: phr. 值得,配得上,当之无愧; [acc] /bi ˈwɚði ʌv/;
speak one's mind: phr. 直言不讳,吐露心声; [acc] /spik wʌnz maɪnd/;
in spite of: phr. 尽管,不管; [acc] /ɪn spaɪt ʌv/;
call up: phr. 打电话,号召;  quant. 使想起; [acc] /ˈkɔːlˌʌp/;
hold one's ground: phr. 坚持立场; [acc] /hold wʌnz ɡraʊnd/;
tear off: phr. 撕掉,扯下来,扯掉;匆匆离开; [acc] /ter ɔːf/;
tee off: phr. 开球;  [vi]发球; [acc] /tiː ɔːf/;
tear up: phr. 撕毁,撕掉撕成碎片; [acc] /tɛə ʌp/;
watch out for: phr. 密切注视,当心,提防; [acc] /wɑːtʃ aʊt fɔːr/;
be comparable to: phr. 和.相当,比得上,犹如; [acc] /biː ˈkɑːmpərəbl tuː/;
in possession of: phr. 控制;拥有,拥有某物; [acc] /ɪn pəˈzeʃən əv/;
bury oneself in: phr. 埋头于某事,对.入迷; [acc] /ˈbɛri wʌnˈsɛlf ɪn/;
construction site: phr. 建筑工地; [acc] /kənˈstrʌkʃn saɪt/;
offer opportunity to: phr. 给...提供机会; [acc] /ˈɔːfər ˌɑːpərˈtuːnəti tuː/;
rise to fame: phr. 成名,出名; [acc] /raɪz tu fem/;
throw up one's hands: phr. 绝望;放弃; [acc] /θroʊ ʌp wʌnz hænds/;
have no time to: phr. 没时间.; [acc] /hæv noʊ taɪm tə/;
on behalf of: phr. 代表.,为了.; [acc] /ɔn bɪˈhæf ɑv/;
make sense of: phr. 了解...的意义,理解; [acc] /mek sɛns ʌv/;
by comparison to: phr. 比较下,相比; [acc] /baɪ kəmˈpærɪsn tuː/;
be involved in: phr. 涉及到;与...有关联,参与; [acc] /bi ɪnˈvɑlvd ɪn/;
be keen on: phr. 渴望,喜爱,爱好,热衷于; [acc] /bi kin ɑn/;
be dependent on: phr. 取决于;依赖; [acc] /bi dɪˈpɛndənt ɑn/;
second to none: phr. 最好的,顶呱呱; [acc] /ˈsekənd tə nʌn/;
compliance with: phr. 遵守,遵从,顺从,符合; [acc] /kəmˈplaɪəns wɪð/;
out of tune: phr. 走调;不一致; [acc] /aʊt əv tuːn/;
feed on: phr. 以..为食; [acc] /fid ɔn/;
cultural environment: phr. 文化环境; [acc] /ˈkʌltʃərəl ɪnˈvaɪrənmənt/;
arouse one's curiosity: phr. 引起某人的好奇心; [acc] /əˈraʊz wʌnz ˌkjʊriˈɑːsəti/;
support one's argument: phr. 支持...的观点; [acc] /səˈpɔːrt wʌnz ˈɑːrɡjumənt/;
be annoyed with: phr. 被 ... 惹恼;对 ... 生气; [acc] /bi əˈnɔɪd wɪð/;
take...into consideration: phr. 考虑到; [acc] /teɪk ˈɪntuː kənˌsɪdəˈreɪʃn/;
turn to: phr. 求助于;变成,转向; [acc] /tɚn tu/;
come into effect: phr. 生效;实施; [acc] /kʌm ˈɪntʊ ɪˈfekt/;
be reluctant to: phr. 不愿意;不情愿;不愿做.的; [acc] /biː rɪˈlʌktənt tuː/;
bear on: phr. 压在.之上;与..有关;对..有影响;依靠; [acc] /ber ɑːn/;
not...but rather: phr. 不是...而是; [acc] /nɑːt bət ˈræðər/;
ought to: phr. 应该; [acc] /ˈɔːt tə/;
be piled with: phr. 堆积着.; [acc] /bi paɪld wɪð/;
tax free: [adj]免税的; [acc] /ˌtæks ˈfriː/;
sneer at: phr. 嘲笑;  [v]讥笑;轻视; [acc] /snɪr æt/;
fix on: phr. 注视,凝视; [acc] /fɪks  ɔːn/;
word of mouth: phr. 口头语,口碑; [acc] /wɚd ʌv maʊθ/;
catch up: phr. 赶上;很快拾起;缠住;了解近况,叙旧; [acc] /kætʃ ʌp/;
on the way out: phr. 即将灭亡;渐渐过时,正在离开; [acc] /ɑːn ðə weɪ aʊt/;
be laid off: phr. 下岗,被解雇; [acc] /biː leɪd ɔːf/;
tour guide: phr. 导游; [acc] /tʊr ɡaɪd/;
speak well of: [v]称赞; [acc] /spik wɛl ʌv/;
speak highly of: phr. 赞扬,高度赞美; [acc] /spiːk ˈhaɪli əv/;
get off with: phr. 与.要好;罚款; [acc] /ɡet ɔːf wɪð/;
out of control: phr. 失去控制; [acc] /aʊt əv kənˈtroʊl/;
in conflict with: phr. 和...有争执;不一致; [acc] /ɪn ˈkɑːnˌflɪkt wɪð/;
in compliance with: phr. 遵守,遵从;按照; [acc] /ɪn kəmˈplaɪəns wɪð/;
cooperate with sb.: phr. 和.合作; [acc] /koʊˈɑːpəreɪt wɪð ˈsʌmbədi/;
computer crime: phr. 电脑犯罪; [acc] /kəmˈpjuːtər kraɪm/;
keep fit: phr. 保持健康; [acc] /kiːp fɪt/;
take charge of: phr. 负责;照管;监理;担任; [acc] /teɪk tʃɑːrdʒ əv/;
cut off: phr. 切断; [acc] /kʌt ɔːf/;
at any moment: phr. 随时,在任何时候; [acc] /ət ˈeni ˈmoʊmənt/;
check in: phr. 报到,记录;登记入住; [acc] /tʃek ɪn/;
form the habit of: phr. 养成...的习惯; [acc] /fɔːrm ðə ˈhæbɪt əv/;
a case in point: phr. 恰当的例子; [acc] /ə keɪs ɪn pɔːɪnt/;
focus one's attention on: phr. 集中注意力在.上; [acc] /ˈfoʊkəs wʌnz əˈtenʃn ɔːn/;
teach sb. a lesson: phr. 给某人一个教训; [acc] /titʃ ˈsʌmˌwʌn e ˈlɛsən/;
result from: phr. 起因于; [acc] /rɪˈzʌlt frʌm/;
side effect: phr. 副作用; [acc] /ˈsaɪd ɪfekt/;
contrary to: phr. 与.相反; [acc] /ˈkɑːnˌtreriː tu/;
so much so that: phr. 达到这样的程度以至.; [acc] /soʊ mʌtʃ soʊ ðæt/;
make face: phr. 做鬼脸; [acc] /meɪk feɪs/;
break away: phr. 消散;拆毁;脱开;突然离开;逃脱; [acc] /breɪk əˈweɪ/;
take exception to: phr. 反对;表示异议; [acc] /teɪk ɪkˈsepʃən tu/;
be distinct from: phr. 与.有差别; [acc] /bi dɪˈstɪŋkt frəm/;
play a part: phr. 扮演角色; [acc] /pleɪ ə pɑrt/;
take pity on: phr. 怜悯; [acc] /tek ˈpɪti ɑn/;
major in: phr. 主修;专攻;专修(某课程); [acc] /ˈmedʒɚ ɪn/;
be proficient in: phr. 熟练;精通; [acc] /bi prəˈfɪʃənt ɪn/;
engaged to sb.: phr. 和.订婚; [acc] /ɪnˈɡeɪdʒd tuː ˈsʌmbədi/;
be unaware of: phr. 不知道,没有察觉到,没有意识到; [acc] /bi ˌʌnəˈwɛr ʌv/;
insufficient for: phr. 不足的; [acc] /ˌɪnsəˈfɪʃnt fɔːr/;
cast light on: phr. 使人们明白;阐明; [acc] /kæst laɪt ɑn/;
dispose of: phr. 解决;处理,安排; [acc] /dɪˈspoʊz ɑv/;
chase up: phr. 提醒某人快做某事;追上;设法(迅速)找到; [acc] /tʃeɪs ʌp/;
be wary of: phr. 提防,小心翼翼; [acc] /bi ˈweri əv/;
balance between...and...: phr. 平衡.和.; [acc] /ˈbæləns bɪˈtwiːn ənd/;
make up: phr. 组成;补足;化妆;编造; [acc] /meɪk, ʌp/;
lag behind: phr. 滞后;落在后面; [acc] /læɡ bɪˈhaɪnd/;
be limited to: phr. 局限于; [acc] /bi ˈlɪmɪtɪd tu/;
check off: phr. 核对;查对;扣款; [acc] /tʃek ɔːf/;
in cooperation with: phr. 与..合作; [acc] /ɪn koˌɑpəˈreʃən wɪð/;
be ignorant of: phr. 不知道,不了解; [acc] /bi ˈɪɡnərənt ʌv/;
keep up with: phr. 跟上,紧跟; [acc] /kiːp ʌp wɪð/;
give birth to: phr. 产生,形成; [acc] /ɡɪv bɜːrθ tu/;
official language: phr. 官方语言; [acc] /əˈfɪʃəl ˈlæŋɡwɪdʒ/;
in the manner of: phr. 照.的式样,做出.的样子; [acc] /ɪn ðə ˈmænər əv/;
be jealous of: phr. 嫉妒; [acc] /bi ˈdʒɛləs ʌv/;
take delight in: phr. 以..为乐; [acc] /teɪk dɪˈlaɪt ɪn/;
make oneself at home: phr. 不要拘束,别客气; [acc] /mek wʌnˈsɛlf æt hom/;
spy on: phr. 暗中监视,侦查; [acc] /spaɪ ɔn/;
have an insight into sth.: phr. 洞察某事; [acc] /hæv æn ˈɪnsaɪt ˈɪntu ˈsʌmθɪŋ/;
be made from: phr. 由..制造; [acc] /biː meɪd frəm/;
be furious with sb.: phr. 对..生气; [acc] /bi ˈfjʊriəs wɪθ ˈsʌmbədi/;
on the contrary: phr. 与此相反,正相反; [acc] /ɑːn ðə 'kɑːnˌtreri/;
out of curiosity: phr. 出于好奇心; [acc] /aʊt ʌv ˌkjʊriˈɑsɪti/;
fall back on: phr. 求助于; [acc] /fɔl bæk ɔn/;
come to nothing: phr. 失败,落空; [acc] /kʌm tu ˈnʌθɪŋ/;
look down: phr. 俯视;看不起;蔑视;低落; [acc] /lʊk daʊn/;
infringe on: phr. 侵犯;违反,违背; [acc] /ɪnˈfrɪndʒ ɔːn/;
settle down: phr. 定居,安定下来; [acc] /ˈset(ə)l daʊn/;
out of breath: phr. 上气不接下气; [acc] /aʊt əv breθ/;
take one's temperature: phr. 量体温; [acc] /teɪk wʌnz ˈtemprətʃər/;
dedicate...to: phr. 把(时间,力量等)用在..;题献; [acc] /ˈdedɪkeɪt tu/;
a hard nut to crack: phr. 棘手的问题;难对付的人; [acc] /ə hɑːrd nʌt tə kræk/;
pick up: phr. 捡起,接人;搭载,拿回;清理;学会; [acc] /pɪk ʌp/;
interference with: phr. 干涉,干扰; [acc] /ˌɪntərˈfɪrəns wɪð/;
lavish...on: phr. 大肆花费; [acc] /ˈlævɪʃ ɑn/;
sign a contract with: phr. 和..签合同; [acc] /saɪn ə ˈkɑːntrækt wɪð/;
puzzle over: phr. 苦苦思考;苦心思索; [acc] /ˈpʌzəl ˈovɚ/;
immerse oneself in: phr. 埋头于(专心于);陷入; [acc] /ɪˈmɜːrs wʌnˈself ɪn/;
come in for: phr. 得到;接受;遭到;受到; [acc] /kʌm ɪn fɔːr/;
dissatisfy with: phr. 对..不满意; [acc] /dɪsˈsætɪsfaɪ wɪð/;
take a chance: phr. 冒险; [acc] /teɪk ə tʃæns/;
fill out: [v]填写;长胖;充实; [acc] /fɪl aʊt/;
at all costs: phr. 不管多大代价,无论如何; [acc] /æt ɔːl kɔsts/;
beyond one's control: phr. 处于某人控制范围之外; [acc] / bɪ'jɑnd wʌns kənˈtrol /;
in terms of: phr. 就.而论;用..字眼;依据; [acc] /ɪn tɜːrmz əv/;
no other than: phr. 除...外没有;恰恰是; [acc] /noʊ ˈʌðər ðæn/;
lash out: phr. 痛打;狠批;挥霍; [acc] /læʃ aʊt/;
drain away: phr. 渐渐枯竭;流尽; [acc] /dreɪn əˈweɪ/;
with all one's heart: phr. 全心全意地;十分愿意地; [acc] /wɪð ɔːl wʌnz hɑːrt/;
find it difficult to do: phr. 觉得做某事很困难; [acc] /faɪnd ɪt ˈdɪfɪkəlt tə duː/;
build up one's confidence: phr. 树立信心; [acc] /bɪld ʌp wʌnz ˈkɑːnfɪdəns/;
pay back: phr. 偿还(借款等); [acc] /peɪ bæk/;
as poor as a church mouse: phr. 一贫如洗; [acc] /æz pʊr æz e tʃɚtʃ maʊs/;
in the circumstance: phr. 在这种情况下; [acc] /ɪn ðə ˈsɜːrkəmstæns/;
devote...to: phr. 把...献于; [acc] /dɪˈvot tu/;
in addition to: phr. 除..之外(还); [acc] /ɪn əˈdɪʃən tu/;
mix up: phr. 混和,混淆; [acc] /mɪks ʌp/;
in the mood: phr. 兴致勃勃; [acc] /ɪn ði mud/;
be dexterous in: phr. 灵敏于..; [acc] /bi ˈdɛkstərəs ɪn/;
be safe from: prep. 免受; [acc] /bi sef frʌm/;
be inadequate for: phr. 不够,缺乏; [acc] /bi ɪnˈædɪkwət fər/;
strive for: phr. 奋斗;争取; [acc] /straɪv fɔr/;
agree on: phr. 对.意见一致; [acc] /əˈɡriː ɑːn/;
have the advantage over: phr. 胜过,优于; [acc] /hæv ðə ədˈvæntɪdʒ ˈoʊvər/;
be replaced with: phr. 被..代替; [acc] /bi rɪˈpleɪst wɪð/;
put in order: phr. 整理,排列;检修; [acc] /pʊt ɪn ˈɔrdɚ/;
carve out of: phr. 用...雕刻出(引伸为修建); [acc] /kɑrv aʊt ʌv/;
feel at home: phr. 感到很舒服; [acc] /fi:l æt həum/;
queue up: phr. 排队; [acc] /kju ʌp/;
be urged to do: phr. 不得不做;受到敦促去做; [acc] /biː ɜːrdʒd tə duː/;
be obliged to do sth.: phr. 有义务做,不得不; [acc] /bi əˈblaɪdʒd tu du ˈsʌmθɪŋ/;
pop out: phr. 弹出;突出出现;突然退出; [acc] /pɑp aʊt/;
block out: phr. 挡住(光线); [acc] /blɑk aʊt/;
refrain from: phr. 抑制;制止;戒(烟); [acc] /rɪˈfreɪn frʌm/;
side by side: phr. 肩并肩,一起; [acc] /saɪd baɪ saɪd/;
plunge into: phr. 跳入;突然冲入,突然或仓促地开始某事; [acc] /plʌndʒ ˈɪntu/;
bring up: phr. 养育;呕出;提出; [acc] /brɪŋ ʌp/;
spend time on: phr. 花时间做某事; [acc] /spend taɪm ɔːn/;
burn down: phr. 烧成平地,烧毁,烧光; [acc] /bɜːrn daʊn/;
show off: phr. 炫耀,卖弄; [acc] /ʃəʊ ɒf/;
be well-known for: phr. 以.出名;因.而著名; [acc] /bi ˌwel ˈnoʊn fər/;
refer to: phr. 参考;涉及;指的是;适用于;谈到; [acc] /rɪˈfɜr tu/;
catch a cold: phr. 伤风;感冒; [acc] /kætʃ ə koʊld/;
specialize in: phr. 专攻; [acc] /ˈspɛʃəˌlaɪz ɪn/;
come up against: [v]碰到(困难,反对); [acc] /kʌm ʌp əˈɡenst/;
lend an ear: [vi]听(倾听); [acc] /lɛnd ən ɪr/;
in the balance: phr. (生命等)在危急状态中;(命运等)未定; [acc] /ɪn ðə ˈbæləns/;
make one's fortune: phr. 发财; [acc] /meɪk wʌnz ˈfɔːrtʃən/;
the more the better: phr. 多多益善; [acc] /ðə mɔːr ðəˈbetər/;
be fit for: phr. 适合于;胜任; [acc] /biː fɪt fɔːr/;
play a trick on: phr. 搞恶作剧,诈骗,开玩笑; [acc] /pleɪ ə trɪk ɑːn/;
play on the swing: phr. 荡秋千; [acc] /pleɪ ɑn ði swɪŋ/;
pull down: phr. 拉下;拆毁;<非正式>赚钱; [acc] /pʊl daʊn/;
chew up: phr. 损害;嚼碎; [acc] /tʃuː ʌp/;
fill in: phr. 填充; [acc] /fɪl ɪn/;
make a move: phr. 采取行动;动身; [acc] /meɪk ə mʊv/;
be skeptical of: phr. 怀疑; [acc] /bi ˈskeptɪkl əv/;
be ready to: phr. 准备好..; [acc] /biː ˈredi tuː duː/;
be worn out: phr. 累坏了; [acc] /bi ˌwɔːrn ˈaʊt/;
an amount of: phr. 相当数量的; [acc] /ən əˈmaʊnt ʌv/;
lose control of: [v]失控; [acc] /luz kənˈtrol ʌv/;
upper management: phr. 高层管理; [acc] /ˈʌpər ˈmænɪdʒmənt/;
have a good relationship with: phr. 和..关系好; [acc] /hæv ə ɡʊd rɪˈleɪʃnʃɪp wɪð/;
have a go: phr. 企图,尝试; [acc] /həv ə ɡoʊ/;
occupy one's time: phr. 占用某人的时间; [acc] /ˈɑːkjupaɪ wʌnz taɪm/;
send off: phr. [体]罚下场,给.送行;  [vt]寄出(逐出;欢送); [acc] /send ɔːf/;
get back at: phr. 报复; [acc] /ɡet bæk æt/;
be susceptible to: [vt]易感染(对...敏感); [acc] /bi səˈsɛptəbəl tu/;
in comparison to: phr. 与.相比; [acc] /in kəmˈpærɪsn tu/;
owing to: phr. 由于,因为; [acc] /ˈoʊɪŋ tə/;
make a complaint: phr. 抱怨; [acc] /mek e kəmˈplent/;
call in on: phr. 拜访,访问; [acc] /kɔːl ɪn ɑːn/;
in short supply: phr. 缺乏;短缺; [acc] /ɪn ʃɔrt səˈplaɪ/;
give rise to: phr. 引起,发生; [acc] /ɡɪv raɪz tu/;
pull over: [v]开到路边; [acc] /pʊl ˈoʊvər/;
would rather...than...: phr. 宁愿.而不愿.; [acc] /wʊd ˈræðər ðæn/;
preside at: phr. 主持; [acc] /prɪˈzaɪd æt/;
miss out on: phr. 失去...的好机会; [acc] /mɪs aʊt ɑn/;
debate over: phr. 辩论..; [acc] /dɪˈbeɪt ˈoʊvər/;
break through: phr. 突破;突围; [acc] /breɪk, θruː/;
on the quiet: phr. 秘密地;私下地; [acc] /ɑːn ðə ˈkwaɪt/;
wave down: phr. 挥手示意..停下; [acc] /weɪv daʊn/;
turn against: phr. 背叛; [acc] /tɜːrn əˈɡenst/;
fit into: phr. 适合; [acc] /fɪt ˈɪntʊ/;
give in: phr. 屈服,让步;投降; [acc] /ɡɪv ɪn/;
look out for: phr. 密切注意;  quant. 提防;小心,留神; [acc] /lʊk aʊt fɔːr/;
come down with: phr. 得(传染性的病),感染; [acc] /kʌm daʊn wɪθ/;
compensate for: phr. 弥补;赔偿; [acc] /ˈkɑmpənˌset fɔr/;
without reservation: [adj]无保留地,无条件地;坦白地); [acc] /wɪðˈaʊt ˌrɛzɚˈveʃən/;
much to one's surprise: phr. 令.相当吃惊的是; [acc] /mʌtʃ tu wʌnz sərˈpraɪz/;
get the better of: phr. 打败; [acc] /ɡet ðə ˈbetər ɑv/;
be infected with: phr. 感染(疾病); [acc] /biː ɪnˈfektɪd wɪð/;
keep one's fingers crossed: phr. 为.祈祷; [acc] /kiːp wʌnz ˈfɪŋɡərs krɔːst/;
look down on: phr. 轻视; [acc] /lʊk daʊn ɑːn/;
be terrified at: phr. 被..吓一大跳; [acc] /biː ˈterɪfaɪd æt/;
make one's acquaintance: phr. 与..相识; [acc] /meɪk wʌnz əˈkweɪntəns/;
knock down: phr. 击倒;拆除; [acc] /nɑːk daʊn/;
be incapable of: phr. 不会,不能; [acc] /bi ɪnˈkepəbəl ʌv/;
be subject to: phr. 服从;以...为条件;容易遭受; [acc] /biː ˈsʌbdʒeɪkt tu/;
be conducive to: phr. 有助于; [acc] /bi kənˈdusɪv tu/;
be tied up with: phr. 和..密切联系;和 ... 协作; [acc] /bi taɪd ʌp wɪð/;
a multitude of: phr. 许多,众多; [acc] /e ˈmʌltɪˌtud ʌv/;
think up: phr. 想出;设计出;发明;编造; [acc] /θɪŋk ʌp/;
reach out: phr. 伸出,伸展; [acc] /ritʃ aʊt/;
medium rare: phr. 3分熟; [acc] /ˈmidiəm rɛr/;
lung cancer: [n]肺癌; [acc] /lʌŋ ˈkænsɚ/;
pocket money: phr. 零用钱; [acc] /ˈpɑːkɪt mʌni/;
sea gull: phr. 海鸥; [acc] /si ɡʌl/;
sort out: phr. 整理分类;解决(问题或困难);让.意识到; [acc] /sɔːrt aʊt/;
take possession of: phr. 占有,占据,拥有; [acc] /teɪk pəˈzeʃn əv/;
be stressed out: phr. 紧张,有压力的; [acc] /bi strest aʊt/;
dip into: phr. 浸入;浏览;动用(款项等);掏取; [acc] /dɪp ˈɪntʊ/;
at an alarming rate: phr. 以惊人的速度; [acc] /ət ən əˈlɑːrmɪŋ reɪt/;
under attack: phr. 遭受攻击; [acc] /ˈʌndɚ əˈtæk/;
die out: phr. 灭绝,绝种; [acc] /daɪ aʊt/;
peep at: phr. 偷看...; [acc] /pip æt/;
at full speed: phr. 全速; [acc] /æt fʊl spiːd/;
proposal for: phr. 提案,提议; [acc] /prəˈpoʊzl fɔːr/;
to begin with: phr. 首先; [acc] /tu ˈbeɪɡɪn wɪð/;
close up: phr. 靠近;愈合;关闭; [acc] /kloʊz ʌp/;
fade away: phr. 逐渐消失;褪色; [acc] /feɪd əˈweɪ/;
waste away: phr. 日渐消瘦; [acc] /weɪst əˈweɪ/;
use up: phr. 用完; [acc] /juːz ʌp/;
be apparent to: phr. 清楚,明显; [acc] /bi əˈpærənt tə/;
come to light: phr. 显露;出现;为众人所知; [acc] /kʌm tə laɪt/;
chase out: phr. 赶走,驱散; [acc] /tʃeɪs aʊt/;
take a day off: phr. 放一天假; [acc] /teɪk ə deɪ ɔːf/;
be afraid of: phr. 害怕; [acc] /biː əˈfreɪd əv/;
date from: phr. 起源于; [acc] /deɪt frʌm/;
eat up: phr. 吃光; [acc] /iːt ʌp/;
in private: phr. 秘密地;私下地; [acc] /ɪn ˈpraɪvɪt/;
be occupied with: phr. 忙着做..,忙于某事物; [acc] /bi ˈɑːkjupaɪd wɪð/;
be mindful of: phr. 留意,注意; [acc] /bi ˈmaɪndfl əv/;
contrast with: phr. 与.形成对照; [acc] /kənˈtræst  wɪð/;
knock out: phr. 摧毁; [acc] /nɑːk aʊt/;
hand out: phr. 分发;施舍;把.拿出来; [acc] /hænd aʊt/;
dig out: phr. 掘出,发现; [acc] /dɪɡ aʊt/;
fill up...with...: phr. 用.把.装满;被 ... 填满; [acc] /fɪl ʌp wɪð/;
be approximate to: phr. 近似;接近于.的; [acc] /bi əˈprɑːksɪmət tu/;
carry out: phr. 执行,实行;实现;完成; [acc] /ˈkærɪ aʊt/;
interfere with: phr. 打扰;妨碍;与...抵触; [acc] /ˌɪntərˈfɪr wɪð/;
be similar to: phr. 和..相似; [acc] /bi ˈsɪmɪlər tu/;
be adapted to: [v]适合于;适应于; [acc] /bi əˈdæptid tu/;
dried food: phr. 干货,干制食品; [acc] /draɪd fuːd/;
[kk9: 489个]