preposterous: [x] adj. 荒谬的,可笑的; [acc] /prɪˈpɑːstərəs/; [or]sat;
flair: [x] n. 天资,特别的本领;敏锐的洞察力;嗜好;格调; [acc] /fler/; [or]sat;
dubious: [x] adj. 可疑的;怀疑的;无把握的; [acc] /ˈduːbiəs/; [or]sat;
wistful: [x] adj. 渴望的,向往的;深思的;留恋的; [acc] /ˈwɪstfl/; [or]sat;
prudent: [x] adj. 谨慎的,精明的; [acc] /ˈpruːdnt/; [or]sat;
default: [x] n. 违约;缺席;缺乏;默认;  vi. 不履行义务;拖欠;  vt. 不履行;不参加; [acc] /dɪˈfɔːlt/; [or]sat;
deplore: [x] v. 谴责;对...深感遗憾;悲悼;痛惜; [acc] /dɪˈplɔːr/; [or]sat;
redundant: [x] adj. 多余的,过剩的;被下岗的; [acc] /rɪˈdʌndənt/; [or]sat;
tantamount: [x] adj. 与.相等的; [acc] /ˈtæntəmaʊnt/; [or]sat;
assail: [x] v. 攻击;质问;着手解决; [acc] /əˈseɪl/; [or]sat;
quaff: [x] v. 痛饮; [acc] /kwæf/; [or]sat;
acknowledge: [x] v. 告知收到;对(人)打招呼,招呼(某人)以示相识,致意;就..表示谢忱,鸣谢,感谢,感激,答谢,对..表示感谢;承认(属实),承认(权威,地位); [acc] /əkˈnɑːlɪdʒ/; [or]sat;
negligible: [x] adj. 微不足道的,可忽略不计的; [acc] /ˈneɡlɪdʒəbl/; [or]sat;
tacit: [x] adj. 心照不宣的,静默的; [acc] /ˈtæsɪt/; [or]sat;
replenish: [x] v. 补充,再装满;把.装满;给.添加燃料; [acc] /rɪˈplenɪʃ/; [or]sat;
deluge: [x] n. 洪水;暴雨;泛滥;  v. 使泛滥;压倒; [acc] /ˈdeljuːdʒ/; [or]sat;
champion: [x] n. 冠军;拥护者,战士;  v. 拥护;保卫;为..而斗争;  adj. 夺得第一名的;优胜的; [acc] /ˈtʃæmpiən/; [or]sat;
comprehensive: [x] adj. 综合的;有充分理解力的,悟性好的;全面的,完整的;详尽的;广泛的,无所不包的;广义的;  n. 综合测验;综合学校; [acc] /ˌkɑːmprɪˈhensɪv/; [or]sat;
anecdote: [x] n. 轶事,趣闻; [acc] /ˈænɪkdoʊt/; [or]sat;
lofty: [x] adj. 极高的,巍峨的;崇高的;高傲的; [acc] /ˈlɔːfti/; [or]sat;
virtue: [x] n. 正直,善良;美德,德行;好处,优点; [acc] /ˈvɜːrtʃuː/; [or]sat;
noisome: [x] adj. 恶臭的;令人不快的; [acc] /ˈnɔɪsəm/; [or]sat;
sedentary: [x] adj. 久坐不动的;静止的;坐惯的,定栖的; [acc] /ˈsednteri/; [or]sat;
martial: [x] adj. 武术的;好战的;军事的; [acc] /ˈmɑːrʃl/; [or]sat;
glut: [x] n. 供过于求,过多;  vt. 使吃饱;使充斥;  vi. 过量地吃; [acc] /ɡlʌt/; [or]sat;
cupidity: [x] n. 贪婪; [acc] /kjuːˈpɪdəti/; [or]sat;
cache: [x] n. 隐藏处所,隐藏的粮食或物资,贮藏物;  vt. 贮藏;  vi. 躲藏; [acc] /kæʃ/; [or]sat;
carat: [x] n. 公制克拉;(金子)开; [acc] /ˈkærət/; [or]sat;
render: [x] v. 使成为,致使,使处于(某种状态);提供,给予,以.回报;(以某种方式)表达,表现;翻译;粉刷,往(墙上)抹灰;将(脂肪)熬成油,使熔化;  n. 粉刷,打底,交纳; [acc] /ˈrendər/; [or]sat;
projectile: [x] n. 抛射物,发射体,火箭,导弹;  adj. 发射的; [acc] /prəˈdʒektl/; [or]sat;
wastrel: [x] n. 败家子,挥霍无度的人; [acc] /ˈweɪstrəl/; [or]sat;
repel: [x] v. 击退,驱逐;排斥,抵制;使厌恶,使反感;使恐惧; [acc] /rɪˈpel/; [or]sat;
mire: [x] n. 泥沼,困境; [acc] /ˈmaɪər/; [or]sat;
log: [x] n. 原木;航海日志;  v. 伐木;航行;记录;登录; [acc] /lɔːɡ/; [or]sat;
optional: [x] adj. 可选择的; [acc] /ˈɑːpʃənl/; [or]sat;
compunction: [x] n. 懊悔,良心不安; [acc] /kəmˈpʌŋkʃn/; [or]sat;
procrastinate: [x] v. (因不愿意做或习惯性地)耽搁,拖延; [acc] /proʊˈkræstɪneɪt/; [or]sat;
inverse: [x] adj. 相反的;反面的;倒转的;  n. (the inverse)反面; [acc] /ˌɪnˈvɜːrs/; [or]sat;
panacea: [x] n. 灵丹妙药,万能药; [acc] /ˌpænəˈsiːə/; [or]sat;
chagrin: [x] n. 懊恼;委屈;气愤;  v. 使.懊恼; [acc] /ʃəˈɡrɪn/; [or]sat;
diverse: [x] adj. 不同的,差异的,多种多样的; [acc] /daɪˈvɜːrs/; [or]sat;
pariah: [x] n. 被排斥或鄙视的人; [acc] /pəˈraɪə/; [or]sat;
steadfast: [x] adj. 坚定的;不变的; [acc] /ˈstedfæst/; [or]sat;
facilitate: [x] v. 为他人提供方便;使便利;  vt. 促进; [acc] /fəˈsɪlɪteɪt/; [or]sat;
intrude: [x] vi. 闯入,侵入;  vt. 强挤入,把(自己的思想)强加于人; [acc] /ɪnˈtruːd/; [or]sat;
asylum: [x] n. 精神病院,疯人院;避难所; [acc] /əˈsaɪləm/; [or]sat;
hindrance: [x] n. 妨碍;障碍物; [acc] /ˈhɪndrəns/; [or]sat;
maritime: [x] adj. 海事的,海上的,沿海的,近海的;海员的,水手的; [acc] /ˈmærɪtaɪm/; [or]sat;
supersede: [x] v. 代替;紧接着而到来; [acc] /ˌsuːpərˈsiːd/; [or]sat;
eminent: [x] adj. 显赫的;杰出的;有名的;(品质)优良的; [acc] /ˈemɪnənt/; [or]sat;
incarcerate: [x] v. 把..关进监狱,监禁,幽闭; [acc] /ɪnˈkɑːrsəreɪt/; [or]sat;
irresolute: [x] adj. 优柔寡断的;踌躇不定的; [acc] /ɪˈrezəluːt/; [or]sat;
elicit: [x] v. 引出;诱出;探出; [acc] /iˈlɪsɪt/; [or]sat;
doldrums: [x] n. (海洋上的)无风带,情绪低沉; [acc] /ˈdoʊldrəmz/; [or]sat;
curator: [x] n. 馆长;监护人;管理者; [acc] /kjʊˈreɪtər/; [or]sat;
mitigate: [x] v. 减轻,缓和; [acc] /ˈmɪtɪɡeɪt/; [or]sat;
forum: [x] n. 论坛;讨论会; [acc] /ˈfɔːrəm/; [or]sat;
fundamental: [x] adj. 基本的,根本的;重要的;基础的;  n. 基本原理;基本原则; [acc] /ˌfʌndəˈmentl/; [or]sat;
orient: [x] n. [the Orient]东方;  v. 定..的方位;  adj. 东方的;(太阳等)上升的,新生的;闪闪发光的; [acc] /ˈɔːrient/; [or]sat;
exult: [x] v. 狂喜,欢欣鼓舞; [acc] /ɪɡˈzʌlt/; [or]sat;
sacrilegious: [x] adj. 该受天谴的,亵渎神明的; [acc] /ˌsækrəˈlɪdʒəs/; [or]sat;
phobia: [x] n. 恐惧症; [acc] /ˈfoʊbiə/; [or]sat;
aspire: [x] vi. 渴望,有志于(与to,for,after连用或后接不定式); [acc] /əˈspaɪər/; [or]sat;
opus: [x] n. 作品; [acc] /ˈoʊpəs/; [or]sat;
distinction: [x] n. 差别,区分;优秀,卓越,杰出;特性,独特,不同凡响;优等评分,荣誉分数,殊荣; [acc] /dɪˈstɪŋkʃn/; [or]sat;
surpass: [x] v. 胜过;超出; [acc] /sərˈpæs/; [or]sat;
objective: [x] n. 目标;目的;  adj. 客观的; [acc] /əbˈdʒektɪv/; [or]sat;
subdued: [x] adj. 减弱的;被制服的;被抑制的; [acc] /səbˈduːd/; [or]sat;
paltry: [x] adj. 不足取的,无价值的,琐碎的,卑鄙的; [acc] /ˈpɔːltri/; [or]sat;
implore: [x] v. 恳求; [acc] /ɪmˈplɔːr/; [or]sat;
roil: [x] v. 搅浑,惹怒,动荡,喧闹;  n. 小股汹涌的急流; [acc] /rɔɪl/; [or]sat;
appropriate: [x] adj. 合适的;适当的;  v. 挪用;拨款;私占; [acc] /əˈproʊpriət/; [or]sat;
morbid: [x] adj. 疾病的;(精神等)病态的;恐怖的; [acc] /ˈmɔːrbɪd/; [or]sat;
lunar: [x] adj. 月亮的; [acc] /ˈluːnər/; [or]sat;
chalice: [x] n. (高脚)酒杯;圣餐杯;［植］杯状花; [acc] /ˈtʃælɪs/; [or]sat;
libel: [x] n. 诽谤,中伤,诋毁;毁坏名誉的东西;控诉书;  v. 中伤;控告;对.进行诽谤; [acc] /ˈlaɪbl/; [or]sat;
trespass: [x] v. 侵入;犯罪;  n. 罪过;非法侵入; [acc] /ˈtrespæs/; [or]sat;
resolve: [x] n. 决心;  v. 解决,决定,表决; [acc] /rɪˈzɑːlv/; [or]sat;
goad: [x] vt. 驱赶;刺激;鼓励;  n. (赶牛用的)刺棒; [acc] /ɡoʊd/; [or]sat;
compile: [x] v. 收集,汇编; [acc] /kəmˈpaɪl/; [or]sat;
aquatic: [x] adj. 水生的,水栖的,水中的,水上的;  n. 水生动物,水生植物;水上运动; [acc] /əˈkwætɪk/; [or]sat;
subjective: [x] adj. 主观(上)的,个人的; [acc] /səbˈdʒektɪv/; [or]sat;
breach: [x] n. 破裂;裂痕;冲击;违反;  v. 使有裂口;破坏; [acc] /briːtʃ/; [or]sat;
calligraphy: [x] n. 笔迹,墨宝,书法; [acc] /kəˈlɪɡrəfi/; [or]sat;
casualty: [x] n. 伤亡人员,死伤者,受害人;急诊室(英); [acc] /ˈkæʒuəlti/; [or]sat;
distort: [x] v. 扭曲,使变形;歪曲,曲解; [acc] /dɪˈstɔːrt/; [or]sat;
embryonic: [x] adj. [生物学]胚胎的;初期的; [acc] /ˌembriˈɑːnɪk/; [or]sat;
frustrate: [x] v. 使灰心;挫败;阻挠; [acc] /ˈfrʌstreɪt/; [or]sat;
hamper: [x] v. 阻碍,妨碍,牵制;  n. (有盖的)大篮子; [acc] /ˈhæmpər/; [or]sat;
melancholy: [x] n. 忧郁,悲哀;  adj. 忧郁的,令人伤感的; [acc] /ˈmelənkɑːli/; [or]sat;
molten: [x] adj. 熔化的; [acc] /ˈmoʊltən/; [or]sat;
prodigy: [x] n. 天才; [acc] /ˈprɑːdədʒi/; [or]sat;
provocative: [x] adj. 挑衅的,煽动的,刺激的;挑逗的; [acc] /prəˈvɑːkətɪv/; [or]sat;
simulate: [x] v. 假装;模仿;模拟; [acc] /ˈsɪmjuleɪt/; [or]sat;
declivity: [x] n. 下坡;倾斜; [acc] /dɪ'klɪvətɪ/; [or]sat;
infraction: [x] n. 违法; [acc] /ɪnˈfrækʃn/; [or]sat;
inundate: [x] v. 淹没,泛滥; [acc] /ˈɪnʌndeɪt/; [or]sat;
languish: [x] v. 凋萎,衰弱,变得消瘦; [acc] /ˈlæŋɡwɪʃ/; [or]sat;
embroider: [x] v. 刺绣,绣花;润色,渲染; [acc] /ɪmˈbrɔɪdər/; [or]sat;
anthropoid: [x] adj. 像人类的,类人猿的;  n. 类人猿;灵长类动物的类人猿亚目; [acc] /ˈænθrəpɔɪd/; [or]sat;
filch: [x] vt. 偷窃; [acc] /fɪltʃ/; [or]sat;
vituperative: [x] adj. 责骂的,辱骂的; [acc] /vaɪˈtuːpəreɪtɪv/; [or]sat;
voyeur: [x] n. 窥淫狂者,窥隐私者; [acc] /vwaɪˈɜːr/; [or]sat;
berate: [x] v. 猛烈责骂; [acc] /bɪˈreɪt/; [or]sat;
bicker: [x] v. 斗嘴,流动,闪动;  n. 口角,流水声; [acc] /ˈbɪkər/; [or]sat;
frond: [x] n. (羊齿,棕榈等的)叶子;叶状体; [acc] /frɑːnd/; [or]sat;
laceration: [x] n. 撕裂,割破,裂口,伤口,痛苦; [acc] /ˌlæsəˈreɪʃn/; [or]sat;
revelry: [x] n. 狂欢;欢宴; [acc] /ˈrevlri/; [or]sat;
cadaver: [x] n. 尸体; [acc] /kəˈdævər/; [or]sat;
choreography: [x] n. 编舞艺术;舞蹈编排;舞蹈编排; [acc] /ˌkɔːriˈɑːɡrəfi/; [or]sat;
clapper: [x] n. 拍手者;铃舌;响板;唠唠叨叨的嘴巴; [acc] /ˈklæpər/; [or]sat;
disgorge: [x] v. 涌出,流出;吐出; [acc] /dɪsˈɡɔːrdʒ/; [or]sat;
olfactory: [x] adj. 嗅觉的; [acc] /ɑːlˈfæktəri/; [or]sat;
pusillanimous: [x] adj. 懦弱的,胆小的;优柔寡断的; [acc] /ˌpjuːsɪˈlænɪməs/; [or]sat;
circumvent: [x] v. 用计避免,规避; [acc] /ˌsɜːrkəmˈvent/; [or]sat;
glower: [x] v. 怒目而视; [acc] /ˈɡlaʊər/; [or]sat;
compute: [x] v. 计算,估计; [acc] /kəmˈpjuːt/; [or]sat;
rail: [x] n. 铁轨;扶手,栏杆;  v. 咒骂; [acc] /reɪl/; [or]sat;
spectrum: [x] n. 光谱,范围,系列; [acc] /ˈspektrəm/; [or]sat;
mammal: [x] n. 哺乳动物; [acc] /ˈmæml/; [or]sat;
bleak: [x] adj. 凄凉的;萧瑟的;阴郁的;无希望的; [acc] /bliːk/; [or]sat;
chisel: [x] v. 刻,凿;  n. 凿子; [acc] /ˈtʃɪzl/; [or]sat;
trigger: [x] n. (枪等的)扳机,诱因;  v. 触发,引起,激发,扣扳机; [acc] /ˈtrɪɡər/; [or]sat;
paramount: [x] n. 元首;最高;  adj. 最高的,至上的,首要的; [acc] /ˈpærəmaʊnt/; [or]sat;
manipulate: [x] v. 操纵,影响;正骨; [acc] /məˈnɪpjuleɪt/; [or]sat;
ardent: [x] adj. 热心的,热烈的; [acc] /ˈɑːrdnt/; [or]sat;
eclipse: [x] n. (日,月)食;黯然失色;  v. 掩盖..的重要性;使暗淡; [acc] /ɪˈklɪps/; [or]sat;
amphibian: [x] n. 两栖动物;水陆两用飞机和车辆;  adj. 两栖类的;[车辆]水陆两用的;具有双重性格的; [acc] /æmˈfɪbiən/; [or]sat;
complement: [x] v. 补充;与.相配;  n. 补充;互为补充的东西;补语; [acc] /ˈkɑːmplɪment/; [or]sat;
tedious: [x] adj. 沉闷的,冗长乏味的; [acc] /ˈtiːdiəs/; [or]sat;
illuminate: [x] vt. 照亮;阐释;说明; [acc] /ɪˈluːmɪneɪt/; [or]sat;
missile: [x] n. 导弹;投射出的物体或武器;  adj. 导弹的;可投掷的;用以发射导弹的; [acc] /ˈmɪsl/; [or]sat;
barricade: [x] n. 路障;障碍物;栅栏;  v. 设路障;挡住; [acc] /ˌbærɪˈkeɪd/; [or]sat;
chasm: [x] n. (地壳,冰上的)隐窟,深坑,峡谷;显著差距,巨大分歧; [acc] /ˈkæzəm/; [or]sat;
versatile: [x] adj. 万能的,综合的,多才多艺的; [acc] /ˈvɜːrsətl/; [or]sat;
anchor: [x] n. 担任(广播电视新闻节目)的主持人;支柱;锚;  v. 抛锚;  vt. 使固定; [acc] /ˈæŋkər/; [or]sat;
grill: [x] n. 烤架;  v. 烤;拷问; [acc] /ɡrɪl/; [or]sat;
lament: [x] v. 哀悼;惋惜;悲叹;  n. 悲叹;悼词; [acc] /ləˈment/; [or]sat;
steep: [x] v. 沉浸于..;  adj. 陡峭的;急剧的;过高的;  n. 陡坡; [acc] /stiːp/; [or]sat;
underlying: [x] adj. 基本的;潜在的;在下面的; [acc] /ˌʌndərˈlaɪɪŋ/; [or]sat;
embrace: [x] v. 拥抱;包含;欣然接受,乐意采纳;  n. 拥抱;接受;领会; [acc] /ɪmˈbreɪs/; [or]sat;
mushroom: [x] n. 蘑菇;  vi. 迅速发展;采蘑菇; [acc] /ˈmʌʃrʊm/; [or]sat;
barren: [x] adj. 贫瘠的,不孕的;  n. 荒原,不毛之地; [acc] /ˈbærən/; [or]sat;
exotic: [x] adj. 奇异的,珍奇的,来自异国的; [acc] /ɪɡˈzɑːtɪk/; [or]sat;
diverge: [x] v. 分歧,分开; [acc] /daɪˈvɜːrdʒ/; [or]sat;
bovine: [x] adj. (似)牛的,迟钝的;  n. 牛科动物; [acc] /ˈboʊvaɪn/; [or]sat;
collaborate: [x] v. 合作; [acc] /kəˈlæbəreɪt/; [or]sat;
gape: [x] n. 裂口,张嘴,打哈欠;  v. 目瞪口呆地凝视,打哈欠,张开,裂开; [acc] /ɡeɪp/; [or]sat;
precipice: [x] n. 危险的处境,灾难的边缘,濒危点;悬崖; [acc] /ˈpresəpɪs/; [or]sat;
divergent: [x] adj. 叉开的;分歧的; [acc] /daɪˈvɜːrdʒənt/; [or]sat;
hibernate: [x] vi. 冬眠,蛰居; [acc] /ˈhaɪbərneɪt/; [or]sat;
palette: [x] n. 调色板,一套颜料; [acc] /ˈpælət/; [or]sat;
clip: [x] n. 回形针,夹子;(电影,广播,电视节目的)片段;  v. 夹住;删剪;剪辑; [acc] /klɪp/; [or]sat;
arrest: [x] v. 逮捕,拘留;吸引;  n. 逮捕,拘留; [acc] /əˈrest/; [or]sat;
solicit: [x] v. 乞求,恳求给予(帮助,金钱); [acc] /səˈlɪsɪt/; [or]sat;
fester: [x] v. 溃烂;化脓;使..痛苦;使..恶化;  n. 溃烂;脓疮,脓疱; [acc] /ˈfestər/; [or]sat;
decomposition: [x] n. 腐败,腐烂;分解; [acc] /ˌdiːkɑːmpəˈzɪʃn/; [or]sat;
catastrophe: [x] n. 大灾难; [acc] /kəˈtæstrəfi/; [or]sat;
pigment: [x] n. 天然色素,颜料; [acc] /ˈpɪɡmənt/; [or]sat;
intrepid: [x] adj. 无畏的;刚毅的,勇敢的; [acc] /ɪnˈtrepɪd/; [or]sat;
squat: [x] adj. 蹲着的;  v. 蹲坐,蹲伏;  n. 蹲坐; [acc] /skwɑːt/; [or]sat;
corrode: [x] v. 受腐蚀;腐蚀,侵蚀; [acc] /kəˈroʊd/; [or]sat;
satellite: [x] n. 卫星;人造卫星;随体;  adj. 卫视的; [acc] /ˈsætəlaɪt/; [or]sat;
whittle: [x] v. 削(木头);削减;  n. 大刀,屠刀; [acc] /ˈwɪtl/; [or]sat;
cipher: [x] n. 密码,暗号,不重要的人; [acc] /ˈsaɪfər/; [or]sat;
precipitous: [x] adj. 险峻的;急躁的,鲁莽的; [acc] /prɪˈsɪpɪtəs/; [or]sat;
barb: [x] n. 箭头鱼钩等的倒钩;伤人的话;  v. 装倒钩于;  adj. 具倒刺的;(话)带刺的; [acc] /bɑːrb/; [or]sat;
dismember: [x] v. 肢解;瓜分; [acc] /dɪsˈmembər/; [or]sat;
repudiate: [x] v. 拒绝,否定,驳斥; [acc] /rɪˈpjuːdieɪt/; [or]sat;
emulate: [x] v. 努力赶上(超过),仿效;  n. 仿真; [acc] /ˈemjuleɪt/; [or]sat;
spate: [x] n. 洪水;一阵;大雨;突然迸发; [acc] /speɪt/; [or]sat;
repository: [x] n. 储藏室;仓库;智囊人物;知识库; [acc] /rɪˈpɑːzətɔːri/; [or]sat;
dismantle: [x] v. 拆开;拆除; [acc] /dɪsˈmæntl/; [or]sat;
gory: [x] adj. 血淋淋的,血污的,满是血的; [acc] /ˈɡɔːri/; [or]sat;
chameleon: [x] n. 蜥蜴;变色龙;善变的人; [acc] /kəˈmiːliən/; [or]sat;
vanguard: [x] n. 先锋,前锋;先驱;领导者; [acc] /ˈvænɡɑːrd/; [or]sat;
castigate: [x] v. 严惩;苛评;矫正;修订; [acc] /ˈkæstɪɡeɪt/; [or]sat;
precis: [x] n. 摘要,大纲;  vt. 〈法〉为.写摘要,概括.的大意; [acc] /preɪˈsiː/; [or]sat;
divine: [x] adj. 神的,神圣的;极好的;  v. (凭直觉)发现,猜到;  n. 神学家;圣职人员;教士;上帝; [acc] /dɪˈvaɪn/; [or]sat;
incisive: [x] adj. 一针见血的,敏锐的; [acc] /ɪnˈsaɪsɪv/; [or]sat;
idiom: [x] n. 习语;成语;惯用语法; [acc] /ˈɪdiəm/; [or]sat;
surfeit: [x] n. 饮食过度,过量; [acc] /ˈsɜːrfɪt/; [or]sat;
symbiosis: [x] n. 共生,共栖; [acc] /ˌsɪmbɪˈoʊsɪs/; [or]sat;
acidulous: [x] adj. 有酸味的,刻薄的; [acc] /əˈsɪdʒələs/; [or]sat;
ethnic: [x] adj. 种族的,少数民族的;  n. 少数民族成员;人种学; [acc] /ˈeθnɪk/; [or]sat;
vigilance: [x] n. 警戒;警惕;警戒; [acc] /ˈvɪdʒɪləns/; [or]sat;
upshot: [x] n. 结果,结局;要点; [acc] /'ʌpʃɑːt/; [or]sat;
attentive: [x] adj. 留意的,注意的,肯帮忙的; [acc] /əˈtentɪv/; [or]sat;
incessant: [x] adj. 无间断的,连续的; [acc] /ɪnˈsesnt/; [or]sat;
talon: [x] n. 猛禽的锐爪; [acc] /ˈtælən/; [or]sat;
wanton: [x] n. 水性杨花的人,任性的孩子,无节制的人;  v. 放肆,胡作非为,挥霍;  adj. 胡作非为的,淫荡的,无节制的; [acc] /ˈwɑːntən/; [or]sat;
heterogeneous: [x] adj. 多相的,异种的,不均匀的,由不同成分形成的; [acc] /ˌhetərəˈdʒiːniəs/; [or]sat;
abusive: [x] adj. 辱骂的;滥用的;虐待的; [acc] /əˈbjuːsɪv/; [or]sat;
uniformity: [x] n. 均匀性;一致,一致性;同样; [acc] /ˌjuːnɪˈfɔːrməti/; [or]sat;
anthropomorphic: [x] adj. 拟人的,拟人化; [acc] /ˌænθrəpəˈmɔːrfɪk/; [or]sat;
unearth: [x] vt. 发掘,掘出,揭露,发现;揭发; [acc] /ʌnˈɜːrθ/; [or]sat;
skirmish: [x] n. 小战役,小争吵;  v. 卷入战役(争论),搜索; [acc] /ˈskɜːrmɪʃ/; [or]sat;
assessment: [x] n. 评估;评价;估价; [acc] /əˈsesmənt/; [or]sat;
trajectory: [x] n. 弹道,航线;轨线; [acc] /trəˈdʒektəri/; [or]sat;
authoritarian: [x] adj. 独裁主义的,权力主义的;  n. 权力主义者,独裁主义者; [acc] /əˌθɔːrəˈteriən/; [or]sat;
dislodge: [x] v. 驱逐;移去;取出; [acc] /dɪsˈlɑːdʒ/; [or]sat;
pan: [x] n. 平底锅;  v. 严厉批评;淘金; [acc] /pæn/; [or]sat;
hydrophobia: [x] n. 狂犬病,恐水病; [acc] /ˌhaɪdrəˈfoʊbiə/; [or]sat;
limber: [x] adj. 松软的,柔软的;可塑的;  n. (炮车的)拖车; [acc] /ˈlɪmbər/; [or]sat;
droll: [x] adj. 滑稽的;好笑的;逗趣的;  n. 逗人发笑的人;滑稽演员;小丑;  v. 开玩笑;  adv. 古里古怪地,滑稽地; [acc] /droʊl/; [or]sat;
biennial: [x] adj. 两年一次的;二年生植物的;  n. 两年生植物;两年一次的事; [acc] /baɪˈeniəl/; [or]sat;
clique: [x] n. 朋党派系,小集团;  vi. 结派,结党; [acc] /kliːk/; [or]sat;
verge: [x] n. 边缘;边界;  v. 接近;濒临; [acc] /vɜːrdʒ/; [or]sat;
odyssey: [x] n. 长途冒险旅行;一连串的冒险;奥德赛; [acc] /ˈɑːdəsi/; [or]sat;
diagnosis: [x] n. 诊断; [acc] /ˌdaɪəɡˈnoʊsɪs/; [or]sat;
prostrate: [x] adj. 降伏的,沮丧的,衰竭的,俯卧的;  v. 弄倒,使屈服; [acc] /ˈprɑːstreɪt/; [or]sat;
defray: [x] v. 支出;支付; [acc] /dɪˈfreɪ/; [or]sat;
decrepitude: [x] n. 衰老,破旧; [acc] /dɪˈkrepɪtuːd/; [or]sat;
legerdemain: [x] n. 手法;骗术;巧妙的花招; [acc] /ˈledʒərdəmeɪn/; [or]sat;
addendum: [x] n. 附录,附件;补遗;附加物; [acc] /əˈdendəm/; [or]sat;
ramification: [x] n. 分枝;分枝(或分叉)的结果; [acc] /ˌræmɪfɪˈkeɪʃn/; [or]sat;
malediction: [x] n. 诅咒;坏话; [acc] /ˌmæləˈdɪkʃən/; [or]sat;
aberrant: [x] n. 离开正路的人,反常的人;  adj. 偏离正轨的;异常的,畸变的; [acc] /æˈberənt/; [or]sat;
facet: [x] n. (多面体的)面,小平面;琢面,侧面;  vt. 在.上琢面; [acc] /ˈfæsɪt/; [or]sat;
adjacent: [x] adj. 邻接的,毗连的;邻近的; [acc] /əˈdʒeɪsnt/; [or]sat;
carnal: [x] adj. 肉体的,肉欲的,性欲的,色欲的,淫荡的; [acc] /ˈkɑːrnl/; [or]sat;
disinterested: [x] adj. 公正的;不感兴趣的;无私的;廉洁的; [acc] /dɪsˈɪntrəstɪd/; [or]sat;
hypocritical: [x] adj. 虚伪的;伪善的; [acc] /ˌhɪpəˈkrɪtɪkl/; [or]sat;
douse: [x] v. 把.浸入水中,用水泼; [acc] /daʊs/; [or]sat;
provident: [x] adj. 节俭的,深谋远虑的,顾及未来的; [acc] /ˈprɑːvɪdənt/; [or]sat;
gargantuan: [x] adj. 巨大的,庞大的; [acc] /ɡɑːrˈɡæntʃuən/; [or]sat;
neutral: [x] adj. 中立的;中性的;  n. 中立国;中性色; [acc] /ˈnuːtrəl/; [or]sat;
discord: [x] n. 不和,争吵;(声音)不和谐; [acc] /ˈdɪskɔːrd/; [or]sat;
trite: [x] adj. 陈腐的;平庸的;老一套的; [acc] /traɪt/; [or]sat;
corpulent: [x] adj. 肥胖的; [acc] /ˈkɔːrpjələnt/; [or]sat;
stealth: [x] n. 隐秘,秘密; [acc] /stelθ/; [or]sat;
abeyance: [x] n. 中止,搁置; [acc] /əˈbeɪəns/; [or]sat;
worldly: [x] adj. 世间的,尘世的;世俗的;  adv. 世故地; [acc] /ˈwɜːrldli/; [or]sat;
inherent: [x] adj. 内在的,固有的;生来就有的; [acc] /ɪnˈhɪrənt/; [or]sat;
bourgeois: [x] n. 中产阶级;资产阶级;  adj. 中产阶级的; [acc] /ˌbʊrˈʒwɑː/; [or]sat;
reparable: [x] adj. 可修缮的;可挽回的; [acc] /'repərəbəl/; [or]sat;
quench: [x] v. 扑灭(火);止渴; [acc] /kwentʃ/; [or]sat;
irate: [x] adj. 发怒的,愤怒的; [acc] /aɪˈreɪt/; [or]sat;
underscore: [x] v. 强调,加强,划线于.下;  n. 底线; [acc] /ˌʌndərˈskɔːr/; [or]sat;
converse: [x] v. 交谈;  adj. 相反的,颠倒的;  n. 相反的事物; [acc] /kənˈvɜːrs/; [or]sat;
quarry: [x] n. 采石场;猎物;来源;  v. 挖出;努力挖掘; [acc] /ˈkwɔːri/; [or]sat;
conveyance: [x] n. 运输;运输工具;财产让与; [acc] /kənˈveɪəns/; [or]sat;
sanctuary: [x] n. 圣堂,避难所; [acc] /ˈsæŋktʃueri/; [or]sat;
exclaim: [x] v. 呼叫,惊叫; [acc] /ɪkˈskleɪm/; [or]sat;
hostility: [x] n. 虐待,敌意;不友善;敌对; [acc] /hɑːˈstɪləti/; [or]sat;
calorific: [x] adj. 发热的,富含卡路里的; [acc] /ˌkæləˈrɪfɪk/; [or]sat;
magnate: [x] n. 大人物;大亨,巨头;权贵; [acc] /ˈmæɡneɪt/; [or]sat;
retrieve: [x] v. 取回,重新得到,挽回,检索; [acc] /rɪˈtriːv/; [or]sat;
shimmer: [x] v. 闪烁,微微发亮;  n. 微光,闪光; [acc] /ˈʃɪmər/; [or]sat;
rally: [x] n. 集会;公路汽车赛;  v. 集合;恢复(健康等),重新振作; [acc] /ˈræli/; [or]sat;
epitome: [x] n. 摘要,缩影; [acc] /ɪˈpɪtəmi/; [or]sat;
obligatory: [x] adj. 强制性的;义务的;必须的; [acc] /əˈblɪɡətɔːri/; [or]sat;
limerick: [x] n. 五行打油诗; [acc] /ˈlɪmərɪk/; [or]sat;
authoritative: [x] adj. 权威性的;可信的;命令式的,专断的; [acc] /əˈθɔːrəteɪtɪv/; [or]sat;
ambiguous: [x] adj. 含糊不清的,引起歧义的,模棱两可的; [acc] /æmˈbɪɡjuəs/; [or]sat;
moratorium: [x] n. 暂停,中止;[金融]延期偿付; [acc] /ˌmɔːrəˈtɔːriəm/; [or]sat;
awry: [x] adj. 扭曲的,走样的;  adv. 歪曲地;歪斜地;错误地; [acc] /əˈraɪ/; [or]sat;
egress: [x] n. 出去,出口; [acc] /ˈiːɡres/; [or]sat;
acrid: [x] adj. 辛辣的,(言语或语调)刻薄的; [acc] /ˈækrɪd/; [or]sat;
indices: [x] n. 目录,指数; [acc] /ˈɪndɪsiːz/; [or]sat;
balmy: [x] adj. (气候)温和的; [acc] /ˈbɑːmi/; [or]sat;
amputate: [x] v. 切除;截肢;切断; [acc] /ˈæmpjuteɪt/; [or]sat;
nebulous: [x] adj. 朦胧的,星云的,星云状的; [acc] /ˈnebjələs/; [or]sat;
palatable: [x] adj. 美味的,合口味的,合心意的; [acc] /ˈpælətəbl/; [or]sat;
redress: [x] n. 纠正,革除,救济;  v. 修正,救济,革除; [acc] /rɪˈdres/; [or]sat;
stalwart: [x] n. 坚定的成员;健壮的人;  adj. 强壮的,坚定的,忠诚的; [acc] /ˈstɔːlwərt/; [or]sat;
sequester: [x] v. 使隔离,隔绝,使隐退,没收,扣押; [acc] /sɪˈkwestər/; [or]sat;
aspirant: [x] n. 有抱负的人,野心家;  adj. 上进的,有野心的; [acc] /əˈspaɪərənt/; [or]sat;
officious: [x] adj. 多管闲事的,非官方的;  adv. 过分殷勤地;  n. 过分殷勤,爱管闲事; [acc] /əˈfɪʃəs/; [or]sat;
dutiful: [x] adj. 顺从的,尽职的;有责任心的; [acc] /ˈduːtɪfl/; [or]sat;
licentious: [x] adj. 纵欲的,放肆的; [acc] /laɪˈsenʃəs/; [or]sat;
disputatious: [x] adj. 好争辩的; [acc] /ˌdɪspjʊ'teɪʃəs/; [or]sat;
recount: [x] v. 叙述;  n. 重新计算; [acc] /rɪˈkaʊnt/; [or]sat;
ablution: [x] n. (宗教的)净礼,沐浴; [acc] /əb'luːʃən/; [or]sat;
redoubtable: [x] adj. 可敬畏的,可怕的; [acc] /rɪˈdaʊtəbl/; [or]sat;
nullify: [x] v. 使无效,废弃,取消; [acc] /ˈnʌlɪfaɪ/; [or]sat;
invoke: [x] v. 调用,祈求,恳求,引起; [acc] /ɪnˈvoʊk/; [or]sat;
deposition: [x] n. 证言,沉积物,矿床,革职; [acc] /ˌdepəˈzɪʃn/; [or]sat;
efficacy: [x] n. 功效,效力; [acc] /ˈefɪkəsi/; [or]sat;
felon: [x] n. 重罪犯; [acc] /ˈfelən/; [or]sat;
averse: [x] adj. 不乐意的,不情愿的; [acc] /əˈvɜːrs/; [or]sat;
spat: [x] n. 口角,小争论;  v. 轻轻拍打;发生小争吵; [acc] /spæt/; [or]sat;
irksome: [x] adj. 令人厌烦的,讨厌的; [acc] /ˈɜːrksəm/; [or]sat;
raconteur: [x] n. 健谈者;善谈者;擅长讲故事的人; [acc] /ˌrækɑːnˈtɜːr/; [or]sat;
disparity: [x] n. 不同,不一致,不等; [acc] /dɪˈspærəti/; [or]sat;
incur: [x] v. 遭受;招致;引起; [acc] /ɪnˈkɜːr/; [or]sat;
virile: [x] adj. 成年男子的,有男子气概的,强壮的; [acc] /ˈvɪrəl/; [or]sat;
feral: [x] adj. 未驯服的,野生的;凶猛的; [acc] /ˈferəl/; [or]sat;
inane: [x] adj. 无意义的,空洞的;愚蠢的; [acc] /ɪˈneɪn/; [or]sat;
blandishment: [x] n. 甜言蜜语,奉承;谄媚;哄诱; [acc] /ˈblændɪʃmənt/; [or]sat;
devoid: [x] adj. 全无的,缺乏的; [acc] /dɪˈvɔɪd/; [or]sat;
ornithologist: [x] n. 鸟类学者; [acc] /ˌɔːrnɪˈθɑːlədʒɪst/; [or]sat;
withhold: [x] v. 抑制,拒绝给某事物; [acc] /wɪðˈhoʊld/; [or]sat;
monetary: [x] adj. 货币的,金融的;金钱的; [acc] /ˈmɑːnɪteri/; [or]sat;
ashen: [x] adj. 灰色; [acc] /ˈæʃn/; [or]sat;
deft: [x] adj. 灵巧的,敏捷的,熟练的; [acc] /deft/; [or]sat;
madrigal: [x] n. 情歌,小曲; [acc] /ˈmædrɪɡl/; [or]sat;
agnostic: [x] adj. 不可知论的;  n. 不可知论者; [acc] /æɡˈnɑːstɪk/; [or]sat;
tirade: [x] n. 长篇的攻击性演说; [acc] /ˈtaɪreɪd/; [or]sat;
solder: [x] v. 焊接;使联接在一起;  n. 焊接;接合物; [acc] /ˈsɑːdər/; [or]sat;
loll: [x] vi. 懒洋洋地倚靠;闲荡;  vt. 懒洋洋地倚靠着;使悬垂; [acc] /lɑːl/; [or]sat;
irrational: [x] adj. 无理性的,失去理性的; [acc] /ɪˈræʃənl/; [or]sat;
aggrandize: [x] v. 增大;夸大;吹捧; [acc] /ə'grænˌdaɪz/; [or]sat;
vitriolic: [x] adj. 刻薄的,强烈的,硫酸(盐)的,由硫酸制成的; [acc] /ˌvɪtriˈɑːlɪk/; [or]sat;
enthrall: [x] v. 迷惑,迷住; [acc] /ɪnˈθrɔl/; [or]sat;
unimpeachable: [x] adj. 可信的,无可挑剔的; [acc] /ˌʌnɪmˈpiːtʃəbl/; [or]sat;
perpetual: [x] adj. 永远的,永恒的;不断的; [acc] /pərˈpetʃuəl/; [or]sat;
acetic: [x] adj. 酸的,醋的; [acc] /ə'siːtɪk/; [or]sat;
wrath: [x] n. 愤怒; [acc] /ræθ/; [or]sat;
satiate: [x] v. 使饱足,生腻;  adj. 饱足的;厌腻的; [acc] /ˈseɪʃieɪt/; [or]sat;
conceit: [x] n. 自负;狂妄;想法,观点;构想,幻想; [acc] /kənˈsiːt/; [or]sat;
discount: [x] n. (价格,债款等)折扣;  v. 打折扣,不全信,怀疑地看待; [acc] /ˈdɪskaʊnt/; [or]sat;
austere: [x] adj. 严峻的;简朴的;苦行的;无装饰的; [acc] /ɔːˈstɪr/; [or]sat;
meander: [x] n. 蜿蜒曲折,迂回曲折的旅程;漫步;  v. 迂回曲折;漫步;漫谈; [acc] /miˈændər/; [or]sat;
conundrum: [x] n. (答案有双关意义的)谜语;机智问答;难题; [acc] /kəˈnʌndrəm/; [or]sat;
drivel: [x] n. 胡言乱语;  v. 胡言乱语,说傻话; [acc] /ˈdrɪvl/; [or]sat;
imply: [x] vt. 暗示;暗指;意味着; [acc] /ɪmˈplaɪ/; [or]sat;
vulnerable: [x] adj. 易受伤的;脆弱的;易受攻击的; [acc] /ˈvʌlnərəbl/; [or]sat;
taint: [x] n. 污点;感染;异味;  vi. 腐败,腐烂;  vt. 污染;玷污,使受不良影响; [acc] /teɪnt/; [or]sat;
stolid: [x] adj. 无动于衷的,感情麻木的; [acc] /ˈstɑːlɪd/; [or]sat;
fleece: [x] n. 羊毛,羊毛状物;  v. 剪羊毛,诈取; [acc] /fliːs/; [or]sat;
soporific: [x] adj. 催眠的;  n. 安眠药; [acc] /ˌsɑːpəˈrɪfɪk/; [or]sat;
lavish: [x] adj. 奢华的;铺张浪费的;  v. 浪费;慷慨给予; [acc] /ˈlævɪʃ/; [or]sat;
gratis: [x] adj. 免费的; [acc] /ˈɡrætɪs/; [or]sat;
aseptic: [x] adj. 无菌的,洁净的; [acc] /ˌeɪˈseptɪk/; [or]sat;
compound: [x] n. 复合物;[化学]化合物;  adj. 合成的;复合的;多功能的;  vi. 妥协;和解;  vt. 混合;调和;调停;使恶化; [acc] /ˈkɑːmpaʊnd/; [or]sat;
pulchritude: [x] n. 漂亮,标致; [acc] /ˈpʌlkrɪtjuːd/; [or]sat;
germane: [x] adj. 有密切关系的;贴切的;恰当的; [acc] /dʒɜːrˈmeɪn/; [or]sat;
flounder: [x] n. 比目鱼;踉跄前进;  v. 踉跄前行;(在水或泥浆中)挣扎,陷入困境; [acc] /ˈflaʊndər/; [or]sat;
degenerate: [x] v. 堕落,衰减;  adj. 腐化的,颓废的,退化的;变质的;  n. 堕落者; [acc] /dɪˈdʒenəreɪt/; [or]sat;
eclectic: [x] adj. 折衷主义的;选择的;  n. 折衷主义者,折衷派的人; [acc] /ɪˈklektɪk/; [or]sat;
overwrought: [x] adj. 过分紧张的,过度兴奋的; [acc] /ˌoʊvərˈrɔːt/; [or]sat;
prone: [x] adj. 易于.的;有.倾向的;俯卧的; [acc] /proʊn/; [or]sat;
privation: [x] n. 缺乏,贫困,丧失,被剥夺了某物的状态; [acc] /praɪˈveɪʃn/; [or]sat;
corroborate: [x] v. 支持或证实,强化;  n. 确证者,证物; [acc] /kəˈrɑːbəreɪt/; [or]sat;
pine: [x] n. 松树;  v. (因死亡,离别等)难过,悲伤; [acc] /paɪn/; [or]sat;
impede: [x] v. 妨碍,阻碍; [acc] /ɪmˈpiːd/; [or]sat;
curmudgeon: [x] n. 脾气暴躁之人; [acc] /kɜːrˈmʌdʒən/; [or]sat;
broach: [x] v. 提出;钻孔;开始讨论;给.开口; [acc] /broʊtʃ/; [or]sat;
censorious: [x] adj. 爱挑剔的,吹毛求疵的,严厉批评的; [acc] /senˈsɔːriəs/; [or]sat;
duplicity: [x] n. 口是心非;表里不一;不诚实; [acc] /duːˈplɪsəti/; [or]sat;
inculcate: [x] v. 灌输,谆谆教诲; [acc] /ɪnˈkʌlkeɪt/; [or]sat;
salutary: [x] adj. 有益的,有益健康的; [acc] /ˈsæljəteri/; [or]sat;
enduring: [x] adj. 持久的,不朽的;能忍受的; [acc] /ɪnˈdʊrɪŋ/; [or]sat;
dismiss: [x] v. 开除;解散;摒除,不再考虑; [acc] /dɪsˈmɪs/; [or]sat;
ramp: [x] n. 斜坡,坡道;倾斜装置;  v. 蔓延; [acc] /ræmp/; [or]sat;
lucid: [x] adj. 明晰的;透明的;易懂的;头脑清楚的; [acc] /ˈluːsɪd/; [or]sat;
frenetic: [x] adj. 狂乱的;非常激动的;  n. 疯子;狂人; [acc] /frəˈnetɪk/; [or]sat;
embody: [x] v. 包含;体现,象征; [acc] /ɪmˈbɑːdi/; [or]sat;
languor: [x] n. 身心疲惫;柔情;呆滞; [acc] /ˈlæŋɡər/; [or]sat;
relish: [x] v. 享受;享受.的味道;品味;  n. 乐趣;调味品; [acc] /ˈrelɪʃ/; [or]sat;
usurp: [x] vi. 篡夺,篡位;  vt. 篡夺,强夺; [acc] /juːˈzɜːrp/; [or]sat;
convention: [x] n. 会议;习俗;惯例; [acc] /kənˈvenʃn/; [or]sat;
venturesome: [x] adj. 好冒险的,大胆的;危险的; [acc] /ˈventʃərsəm/; [or]sat;
deranged: [x] adj. 不理智;疯狂的; [acc] /dɪˈreɪndʒd/; [or]sat;
nemesis: [x] n. 报应,天罚,主要敌人,强硬对手; [acc] /ˈneməsɪs/; [or]sat;
fraught: [x] adj. 担心的,忧虑的;充满.的;  n. 货物,装载物;  vt. 装货于; [acc] /frɔːt/; [or]sat;
ignite: [x] v. 点燃,发光,燃烧; [acc] /ɪɡˈnaɪt/; [or]sat;
benign: [x] adj. 仁慈的;慈祥的;(病)良性的; [acc] /bɪˈnaɪn/; [or]sat;
schism: [x] n. 分裂,(教派或政党的)分裂; [acc] /ˈsɪzəm/; [or]sat;
comatose: [x] adj. 昏迷的,昏睡状态的,麻木的,怠惰的; [acc] /ˈkoʊmətoʊs/; [or]sat;
provincial: [x] adj. 省的;地方性的;偏狭的;  n. 地方人民;乡下人;外地人; [acc] /prəˈvɪnʃl/; [or]sat;
tanner: [x] n. 制革工人,六便士; [acc] /ˈtænər/; [or]sat;
affinity: [x] n. 姻亲关系;密切关系;近似,类似关系;亲近; [acc] /əˈfɪnəti/; [or]sat;
thrifty: [x] adj. 节省的,节俭的; [acc] /ˈθrɪfti/; [or]sat;
ruse: [x] n. 诡计; [acc] /ruːz/; [or]sat;
stellar: [x] adj. 星的,星球的,主要的; [acc] /ˈstelər/; [or]sat;
derogatory: [x] adj. 不敬的,诽谤的; [acc] /dɪˈrɑːɡətɔːri/; [or]sat;
prosperity: [x] n. 繁荣,兴旺,发达; [acc] /prɑːˈsperəti/; [or]sat;
divest: [x] v. 剥夺;使脱去;迫使放弃; [acc] /daɪˈvest/; [or]sat;
veneer: [x] n. (镶于劣质东西上的)镶面板;掩饰;  v. 虚饰;给.镶以饰片; [acc] /vəˈnɪr/; [or]sat;
besiege: [x] v. 围攻,困扰; [acc] /bɪˈsiːdʒ/; [or]sat;
multiplicity: [x] n. 多样性;许多,大量; [acc] /ˌmʌltɪˈplɪsəti/; [or]sat;
filial: [x] adj. 子女的,孝顺的;[生物]子代的,后代的;  adv. 子女地; [acc] /ˈfɪliəl/; [or]sat;
surrogate: [x] n. 代替品,代理人,代孕妈妈;  adj. 代理的,替代的;  v. 代替,代理;指定为自己的代理人,接替; [acc] /ˈsɜːrəɡət/; [or]sat;
scoff: [x] vi. 讥笑;  v. 嘲笑;  n. 愚弄; [acc] /skɔːf/; [or]sat;
codify: [x] v. 编纂;将..编成法典; [acc] /ˈkɑːdɪfaɪ/; [or]sat;
gratuitous: [x] adj. 无根据的,无理由的,无报酬的,免费的,多余的; [acc] /ɡrəˈtuːɪtəs/; [or]sat;
somnolent: [x] adj. 思睡的,催眠的;  adv. 瞌睡地;昏昏欲睡地;使人瞌睡地;催眠地; [acc] /ˈsɑːmnələnt/; [or]sat;
dexterous: [x] adj. 灵巧的,熟练的; [acc] /ˈdekstrəs/; [or]sat;
hypothetical: [x] adj. 假设的,假定的; [acc] /ˌhaɪpəˈθetɪkl/; [or]sat;
compact: [x] adj. 小巧的,小型的,袖珍的,体积小的;紧密的,紧凑的,密集的;  v. 把..压紧;变得坚实;  n. 带镜小粉盒;合约,条约; [acc] /ˈkɑːmpækt/; [or]sat;
turbid: [x] adj. 混浊的,紊乱的; [acc] /ˈtɜːrbɪd/; [or]sat;
mote: [x] n. 微粒,微尘; [acc] /moʊt/; [or]sat;
pristine: [x] adj. 原始的;古时的;纯朴的;崭新的; [acc] /ˈprɪstiːn/; [or]sat;
sap: [x] n. 树液,汁液;易上当的人;  v. 削弱;逐渐耗竭;  vt. 使伤元气;  vi. 挖坑道进攻; [acc] /sæp/; [or]sat;
static: [x] adj. 静电的,静态的,静止的;  n. 静电,静电干扰; [acc] /ˈstætɪk/; [or]sat;
fop: [x] n. 花花公子,纨绔子弟; [acc] /fɑːp/; [or]sat;
fictitious: [x] adj. 虚构的; [acc] /fɪkˈtɪʃəs/; [or]sat;
endorse: [x] v. 赞同,认可;签注(文件); [acc] /ɪnˈdɔːrs/; [or]sat;
intimidate: [x] v. 恫吓,威胁; [acc] /ɪnˈtɪmɪdeɪt/; [or]sat;
resplendent: [x] adj. 华丽的,辉煌的; [acc] /rɪˈsplendənt/; [or]sat;
pathological: [x] adj. 病理学的;病态的;由疾病引起的(等于pathologic); [acc] /ˌpæθəˈlɑːdʒɪkl/; [or]sat;
equity: [x] n. 公平,公正;衡平法;普通股;抵押资产的净值; [acc] /ˈekwəti/; [or]sat;
conviction: [x] n. 定罪;信服;坚强信念; [acc] /kənˈvɪkʃn/; [or]sat;
paradigm: [x] n. 范例,示范; [acc] /ˈpærədaɪm/; [or]sat;
ultimate: [x] adj. 根本的;最后的,最终的; [acc] /ˈʌltɪmət/; [or]sat;
flit: [x] n. 轻快的飞行;迁移;  vi. 掠过;轻快地飞过;偷偷溜走;去世; [acc] /flɪt/; [or]sat;
purge: [x] v. 通便,净化,使(身,心)清净;  n. 驱赶,泻药,净化; [acc] /pɜːrdʒ/; [or]sat;
throng: [x] v. 群集,蜂拥;  n. 一大群人;  vt. 挤向; [acc] /θrɔːŋ/; [or]sat;
indulgent: [x] adj. 放纵的;宽容的;任性的; [acc] /ɪnˈdʌldʒənt/; [or]sat;
adverse: [x] adj. 不利的;(方向上)逆的;在相反的方向上移动(或运转);相反的; [acc] /ˈædvɜːrs/; [or]sat;
compliant: [x] adj. 顺从的,服从的,应允的; [acc] /kəmˈplaɪənt/; [or]sat;
onerous: [x] adj. 繁重的,麻烦的;负有义务的;负有法律责任的; [acc] /ˈɑːnərəs/; [or]sat;
requite: [x] v. 报答,酬谢,回报,补偿;报复; [acc] /rɪˈkwaɪt/; [or]sat;
remedial: [x] adj. 治疗的;补救的;矫正的; [acc] /rɪˈmiːdiəl/; [or]sat;
accommodate: [x] v. 向.提供住处(或膳宿);给.提供方便;容纳;使适应,顺应; [acc] /əˈkɑːmədeɪt/; [or]sat;
divulge: [x] v. 泄露,透露; [acc] /daɪˈvʌldʒ/; [or]sat;
annihilate: [x] v. 消灭; [acc] /əˈnaɪəleɪt/; [or]sat;
bungalow: [x] n. 平房,小屋; [acc] /ˈbʌŋɡəloʊ/; [or]sat;
parasite: [x] n. 寄生虫;靠他人为生的人; [acc] /ˈpærəsaɪt/; [or]sat;
indelible: [x] adj. (印记等)无法擦除的,无法忘怀的; [acc] /ɪnˈdeləbl/; [or]sat;
lechery: [x] n. 好色,纵欲; [acc] /ˈletʃəri/; [or]sat;
nocturnal: [x] adj. 夜晚的,夜间发生的; [acc] /nɑːkˈtɜːrnl/; [or]sat;
anthropologist: [x] n. 人类学家,人类学者; [acc] /ˌænθrəˈpɑːlədʒɪst/; [or]sat;
insidious: [x] adj. (暗中或逐渐)为害的; [acc] /ɪnˈsɪdiəs/; [or]sat;
catharsis: [x] n. 泻法,净化,精神发泄; [acc] /kəˈθɑːrsɪs/; [or]sat;
tout: [x] v. 招徕顾客,极力赞扬; [acc] /taʊt/; [or]sat;
squander: [x] n. 浪费,挥霍;  v. 浪费,挥霍; [acc] /ˈskwɑːndər/; [or]sat;
dote: [x] v. 溺爱;昏愦; [acc] /doʊt/; [or]sat;
evasive: [x] adj. 逃避的;托辞的,推托的; [acc] /ɪˈveɪsɪv/; [or]sat;
pervasive: [x] adj. 深入人心的,普遍的; [acc] /pərˈveɪsɪv/; [or]sat;
atrophy: [x] v. 萎缩;衰退;虚脱;  n. 萎缩;衰退;萎缩症; [acc] /ˈætrəfi/; [or]sat;
rider: [x] n. 骑士;附件,附文;扶手; [acc] /ˈraɪdər/; [or]sat;
mirth: [x] n. 欢乐,欢笑; [acc] /mɜːrθ/; [or]sat;
sanction: [x] n. 批准;制裁,处罚;  v. 批准,支持,对..实施制裁; [acc] /ˈsæŋkʃn/; [or]sat;
innate: [x] adj. 与生俱来的,天生的; [acc] /ɪˈneɪt/; [or]sat;
venerable: [x] adj. 令人尊敬的;(因历史悠久而) 神圣庄严的; [acc] /ˈvenərəbl/; [or]sat;
cordon: [x] n. 哨兵线,警戒线;饰带;  v. 布设警戒线;封锁交通; [acc] /ˈkɔːrdn/; [or]sat;
tractable: [x] adj. 易于管教的,易驾驭的,易处理的,驯良的; [acc] /ˈtræktəbl/; [or]sat;
concerted: [x] adj. 一致的,商定的; [acc] /kənˈsɜːrtɪd/; [or]sat;
caliber: [x] n. [军]口径;才干;水准(等于calibre);器量; [acc] /'kæləbə/; [or]sat;
propagate: [x] v. 繁殖,增殖;  vt. 传播,宣传; [acc] /ˈprɑːpəɡeɪt/; [or]sat;
quorum: [x] n. 法定人数; [acc] /ˈkwɔːrəm/; [or]sat;
chimerical: [x] adj. 空想的,妄想的;荒唐的; [acc] /kaɪ'merɪkəl/; [or]sat;
agenda: [x] n. 议事日程; [acc] /əˈdʒendə/; [or]sat;
linger: [x] v. 逗留,留恋; [acc] /ˈlɪŋɡər/; [or]sat;
enclave: [x] n. 飞地(指在本国境内的隶属另一国的一块领土),被包围的领土,被包围物; [acc] /ˈenkleɪv/; [or]sat;
slander: [x] n. 诽谤,诋毁;  v. 讲坏话,污蔑,诽谤; [acc] /ˈslændər/; [or]sat;
permeate: [x] v. 弥漫;普及;渗透; [acc] /ˈpɜːrmieɪt/; [or]sat;
document: [x] n. 文件,公文;(计算机的)文档;  v. 记录;证明; [acc] /ˈdɑːkjumənt/; [or]sat;
deference: [x] n. 尊敬,尊重;顺从; [acc] /ˈdefərəns/; [or]sat;
beget: [x] v. 产生,引起; [acc] /bɪˈɡet/; [or]sat;
vagrant: [x] n. 游民;  adj. 漂泊的; [acc] /ˈveɪɡrənt/; [or]sat;
combustible: [x] adj. 易燃的;易激动的;  n. 可燃物;易燃物; [acc] /kəmˈbʌstəbl/; [or]sat;
ethereal: [x] adj. 太空的,轻巧的,像空气的; [acc] /iˈθɪriəl/; [or]sat;
mural: [x] n. 壁画;壁饰;  adj. 墙壁的;挂在墙壁上的; [acc] /ˈmjʊrəl/; [or]sat;
hulking: [x] adj. 笨重的; [acc] /ˈhʌlkɪŋ/; [or]sat;
spawn: [x] n. 卵;菌丝;产物;  v. 产卵;酿成,造成;大量生产; [acc] /spɔːn/; [or]sat;
mishap: [x] n. 不幸的事,灾祸;晦气; [acc] /ˈmɪshæp/; [or]sat;
placid: [x] adj. 安静的,平和的; [acc] /ˈplæsɪd/; [or]sat;
enrapture: [x] v. 使狂喜,使高兴; [acc] /ɪnˈræptʃər/; [or]sat;
scrupulous: [x] adj. 小心谨慎的;严谨的;细心的; [acc] /ˈskruːpjələs/; [or]sat;
fervent: [x] adj. 热烈的,满怀热情的;狂热的; [acc] /ˈfɜːrvənt/; [or]sat;
tract: [x] n. 器官系统;一大片地;短文,小册子; [acc] /trækt/; [or]sat;
component: [x] n. 零件;  adj. 组成的; [acc] /kəmˈpoʊnənt/; [or]sat;
wince: [x] v. 避开,畏缩;  n. 畏缩;脸部肌肉的抽搐; [acc] /wɪns/; [or]sat;
accessory: [x] n. (妇女的)装饰品;附件;附属物;同谋;  adj. 附属的;辅助的;同谋的; [acc] /əkˈsesəri/; [or]sat;
renown: [x] n. 声誉;名望;  vt. 使有声望; [acc] /rɪˈnaʊn/; [or]sat;
stymie: [x] v. 从中作梗,阻挠;妨碍;  n. 妨碍球; [acc] /ˈstaɪmi/; [or]sat;
hybrid: [x] n. 杂种,混血儿,混合物;  adj. 混合的;杂种的; [acc] /ˈhaɪbrɪd/; [or]sat;
pore: [x] n. 毛孔,细孔;  v. 深思熟虑,仔细阅读,审视; [acc] /pɔːr/; [or]sat;
badinage: [x] n. 开玩笑,嘲弄,揶揄; [acc] /ˌbædənˈɑːʒ/; [or]sat;
bustle: [x] n. 喧闹,熙攘;腰垫;奔走,奔忙;  v. 喧闹;忙乱,奔忙; [acc] /ˈbʌsl/; [or]sat;
preeminent: [x] adj. 卓越的,超群的;  adv. 卓越地,杰出地; [acc] /priˈemɪnənt/; [or]sat;
discrete: [x] adj. 分开的;不连续的; [acc] /dɪˈskriːt/; [or]sat;
asymmetric: [x] adj. 不对称的,不匀称的; [acc] /ˌeɪsɪˈmetrɪk/; [or]sat;
canter: [x] n. 慢跑(多用于马); [acc] /ˈkæntər/; [or]sat;
tonic: [x] n. 补药;主调音或基音;  adj. 滋补的;声调的;使精神振作的; [acc] /ˈtɑːnɪk/; [or]sat;
matriculate: [x] n. 被录取者;  v. 准许.入学; [acc] /məˈtrɪkjuleɪt/; [or]sat;
forgo: [x] v. 放弃;停止;对.断念; [acc] /fɔːrˈɡoʊ/; [or]sat;
affiliation: [x] n. 联系,从属关系; [acc] /əˌfɪliˈeɪʃn/; [or]sat;
sacrosanct: [x] adj. (因十分重要,神圣)不可改变,批判的; [acc] /ˈsækroʊsæŋkt/; [or]sat;
apostate: [x] adj. 变节的,脱党的,背教的;  n. 脱党者,变节者,叛教者; [acc] /əˈpɑːsteɪt/; [or]sat;
gourmand: [x] n. 贪食者;  adj. 贪食的; [acc] /ˈɡʊrmɑːnd/; [or]sat;
demeanor: [x] n. 举止,行为,风度; [acc] /dɪ'miːnə/; [or]sat;
bulwark: [x] n. 堡垒,壁垒;保障;防波堤;  v. 防御,保护;筑垒保卫; [acc] /ˈbʊlwɜːrk/; [or]sat;
distraught: [x] adj. 发狂的;心烦意乱的; [acc] /dɪˈstrɔːt/; [or]sat;
grove: [x] n. 小树林;果园; [acc] /ɡroʊv/; [or]sat;
equable: [x] adj. 温和,平均,稳定的,不变的,(脾气)温和的; [acc] /ˈekwəbl/; [or]sat;
cistern: [x] n. 水箱;水池;贮水器; [acc] /ˈsɪstərn/; [or]sat;
fatalism: [x] n. 宿命论; [acc] /ˈfeɪtəlɪzəm/; [or]sat;
primordial: [x] adj. 原始的;根本的;原生的; [acc] /praɪˈmɔːrdiəl/; [or]sat;
plenitude: [x] n. 充分;丰富;大量; [acc] /ˈplenɪtuːd/; [or]sat;
nuance: [x] n. 细微差别; [acc] /ˈnuːɑːns/; [or]sat;
impartial: [x] adj. 公平的,不偏不倚的; [acc] /ɪmˈpɑːrʃl/; [or]sat;
propinquity: [x] n. 接近,邻近,近亲关系; [acc] /prəˈpɪŋkwəti/; [or]sat;
beatific: [x] adj. 祝福的,有福的; [acc] /ˌbiːəˈtɪfɪk/; [or]sat;
propitious: [x] adj. 适合的;吉利的;顺利的; [acc] /prəˈpɪʃəs/; [or]sat;
vernacular: [x] adj. 本国的,地方的,用本地语写成的;  n. 方言;土语;(建筑的)民间风格; [acc] /vərˈnækjələr/; [or]sat;
burly: [x] adj. 结实的;率直的;粗鲁的;  n. 〈美〉滑稽戏;〈美俚〉身材魁伟的人; [acc] /ˈbɜːrli/; [or]sat;
gaudy: [x] n. 华丽而俗气的廉价饰物;  adj. (服饰,装饰,文风等)华丽而俗气的;浮华的;过分显眼的; [acc] /ˈɡɔːdi/; [or]sat;
ecologist: [x] n. 生态学家,生态学者; [acc] /iˈkɑːlədʒɪst/; [or]sat;
vivacious: [x] adj. 活泼的,快活的(多指女性); [acc] /vɪˈveɪʃəs/; [or]sat;
dissolution: [x] n. (婚姻,组织,议会等的) 解散;毁灭,消失; [acc] /ˌdɪsəˈluːʃn/; [or]sat;
rendition: [x] n. 表演,演奏;译文;给予,提供; [acc] /renˈdɪʃn/; [or]sat;
extricate: [x] v. 拯救,救出;  n. 解脱;解脱者; [acc] /ˈekstrɪkeɪt/; [or]sat;
unique: [x] adj. 独特的,独一无二的;(唯一的)特有的;不同寻常的; [acc] /juˈniːk/; [or]sat;
clandestine: [x] adj. 秘密的,私下的,暗中的; [acc] /klænˈdestɪn/; [or]sat;
motif: [x] n. 基本图案;主题,中心思想,[音]乐旨; [acc] /moʊˈtiːf/; [or]sat;
trappings: [x] n. 服饰,礼服,外部标志,马饰; [acc] /ˈtræpɪŋz/; [or]sat;
provisional: [x] n. 临时邮票;  adj. 临时的,暂时的,暂定的; [acc] /prəˈvɪʒənl/; [or]sat;
remunerative: [x] adj. 有报酬的,有利可图的; [acc] /rɪˈmjuːnərətɪv/; [or]sat;
ruddy: [x] adj. 红的,红润的;  adv. 极度,非常;  vt. 使变红; [acc] /ˈrʌdi/; [or]sat;
remediable: [x] adj. 可治疗的,可矫正的,可补救的; [acc] /rɪˈmiːdiəbl/; [or]sat;
ornate: [x] adj. 装饰华丽的;修辞上极考究的; [acc] /ɔːrˈneɪt/; [or]sat;
chivalrous: [x] adj. 像骑士的,侠义的,大侠的; [acc] /ˈʃɪvəlrəs/; [or]sat;
reprimand: [x] n. (特指当权者进行的)严责,谴责,申斥;  v. 申斥,谴责,惩戒; [acc] /ˈreprɪmænd/; [or]sat;
profound: [x] adj. 深刻的;知识渊博的;深奥的;极度的,完全的;深远的;渊博的;  n. 深渊;深海; [acc] /prəˈfaʊnd/; [or]sat;
odium: [x] n. 憎恶,反感; [acc] /ˈoʊdiəm/; [or]sat;
gruel: [x] n. 稀粥;  v. 使极度疲劳;累垮; [acc] /ˈɡruːəl/; [or]sat;
adversity: [x] n. 逆境,不幸,灾难; [acc] /ədˈvɜːrsəti/; [or]sat;
futile: [x] adj. 无益的,无用的; [acc] /ˈfjuːtl/; [or]sat;
trenchant: [x] adj. 犀利的,锐利的,有力的,清晰的,一针见血的; [acc] /ˈtrentʃənt/; [or]sat;
stoke: [x] v. 添加燃料,把(火)拨旺,狼吞虎咽吃;  n. 斯托克;[物]沲; [acc] /stoʊk/; [or]sat;
sanguine: [x] adj. 乐观的,(脸色等)有血色的,多血质的;  n. 血红色,乐观; [acc] /ˈsæŋɡwɪn/; [or]sat;
evocative: [x] adj. 唤起的;唤出的; [acc] /ɪˈvɑːkətɪv/; [or]sat;
boycott: [x] vt. 抵制;  n. 抵制; [acc] /ˈbɔɪkɑːt/; [or]sat;
beatitude: [x] n. 祝福;至福; [acc] /bi'ætɪtuːd/; [or]sat;
luminous: [x] adj. 发光的;鲜艳的;明亮的;夜光的; [acc] /ˈluːmɪnəs/; [or]sat;
daunt: [x] v. 使气馁,使畏缩,威吓; [acc] /dɔːnt/; [or]sat;
prototype: [x] n. 原型,典型,样本; [acc] /ˈproʊtətaɪp/; [or]sat;
retentive: [x] adj. 保持的;吸(水)的;  adv. 有记性地,记性强地;  n. 保持力;〈物〉顽磁性; [acc] /rɪˈtentɪv/; [or]sat;
abolish: [x] v. 废除,废止;取消,革除; [acc] /əˈbɑːlɪʃ/; [or]sat;
potion: [x] n. 一剂,一服;毒药,魔药; [acc] /ˈpoʊʃn/; [or]sat;
venerate: [x] v. 崇敬,敬仰; [acc] /ˈvenəreɪt/; [or]sat;
equestrian: [x] adj. 骑马的;骑术的;  n. 骑手,马术家; [acc] /ɪˈkwestriən/; [or]sat;
glaze: [x] n. (浇在糕点上的)糖浆,蛋浆,釉;[气]雨淞;  v. (眼睛)变呆滞;浇浆汁于 (食物) 表面;给.安装玻璃; [acc] /ɡleɪz/; [or]sat;
coquette: [x] n. 调情的女子;  v. 不认真对待; [acc] /koʊˈket/; [or]sat;
founder: [x] n. 奠基者;创始人;  v. (船)沉没,浸水而沉没;(计划等)失败,受挫折; [acc] /ˈfaʊndər/; [or]sat;
recapitulate: [x] v. 扼要重述; [acc] /ˌriːkəˈpɪtʃuleɪt/; [or]sat;
faculty: [x] n. 教职工,全体教员;系;科;能力; [acc] /ˈfæklti/; [or]sat;
flourish: [x] vi. 繁荣,茂盛,兴旺;  vt. 挥舞;夸耀;  n. 兴旺;茂盛;炫耀;挥舞; [acc] /ˈflɜːrɪʃ/; [or]sat;
ascetic: [x] adj. 禁欲的;苦行的;  n. 禁欲者;苦行者; [acc] /əˈsetɪk/; [or]sat;
jocose: [x] adj. 开玩笑的,引人发笑的,诙谐的; [acc] /dʒoʊˈkoʊs/; [or]sat;
reputed: [x] adj. 名誉好的;被普遍认为.的; [acc] /rɪˈpjuːtɪd/; [or]sat;
incline: [x] n. 倾斜,斜坡,斜面;  v. (使)倾斜,(使)倾向于; [acc] /ɪnˈklaɪn/; [or]sat;
exhume: [x] v. 发掘,出土; [acc] /ɪɡˈzuːm/; [or]sat;
hallucination: [x] n. 幻觉,幻想; [acc] /həˌluːsɪˈneɪʃn/; [or]sat;
saturnine: [x] adj. 忧郁的,阴沉的,讥讽的; [acc] /ˈsætərnaɪn/; [or]sat;
insightful: [x] adj. 有深刻见解的,富有洞察力的; [acc] /ˈɪnsaɪtfʊl/; [or]sat;
retract: [x] v. 缩回;收回;取消;  n. 收缩核; [acc] /rɪˈtrækt/; [or]sat;
penury: [x] n. 贫穷; [acc] /ˈpenjəri/; [or]sat;
baffle: [x] v. 使困惑;难住;阻碍;  n. 挡板; [acc] /ˈbæfl/; [or]sat;
stint: [x] n. 节约;从事某工作的时间;固定;  v. 节省;限制; [acc] /stɪnt/; [or]sat;
decimate: [x] v. 大量杀死,十中抽一,大量毁灭; [acc] /ˈdesɪmeɪt/; [or]sat;
banal: [x] adj. 陈腐的;平庸的;老一套的; [acc] /bəˈnɑːl/; [or]sat;
seethe: [x] v. 沸腾;汹涌;激动; [acc] /siːð/; [or]sat;
incorporeal: [x] adj. 灵魂的,无实体的,非物质的; [acc] /ˌɪnkɔːrˈpɔːriəl/; [or]sat;
regime: [x] n. 政权;政治制度;养生法,生活规则; [acc] /reɪˈʒiːm/; [or]sat;
translucent: [x] adj. 半透明的;透亮的,有光泽的;易懂的;真实的; [acc] /trænsˈluːsnt/; [or]sat;
pivotal: [x] adj. 关键的,枢轴的; [acc] /ˈpɪvətl/; [or]sat;
incantation: [x] n. 咒语; [acc] /ˌɪnkænˈteɪʃn/; [or]sat;
harrowing: [x] adj. 悲痛的,难受的; [acc] /ˈhæroʊɪŋ/; [or]sat;
compatible: [x] adj. 可和谐共存的;兼容的; [acc] /kəmˈpætəbl/; [or]sat;
audit: [x] v. 审计,查账;旁听;  n. 审计;查帐; [acc] /ˈɔːdɪt/; [or]sat;
avow: [x] vt. 公开宣称,坦率承认;断言;  adj. 可明言的;公开声明的,承认的;  n. 公开宣布; [acc] /əˈvaʊ/; [or]sat;
exodus: [x] n. 大批离去,成群外出; [acc] /ˈeksədəs/; [or]sat;
proxy: [x] n. 代理权,代表权,代理人;  adj. 代理的; [acc] /ˈprɑːksi/; [or]sat;
tenet: [x] n. 信念,原则,教条; [acc] /ˈtenɪt/; [or]sat;
enigma: [x] n. 谜,哑谜;闷葫芦; [acc] /ɪˈnɪɡmə/; [or]sat;
deadlock: [x] vt. (使)相持不下;  vi. 僵持;  n. 僵局;不分胜负; [acc] /ˈdedlɑːk/; [or]sat;
cliche: [x] n. 陈腐思想,陈词滥调;  adj. 陈腐的; [acc] /klɪˈʃeɪ/; [or]sat;
ewe: [x] n. [畜牧]母羊; [acc] /juː/; [or]sat;
vertigo: [x] n. 晕头转向;眩晕; [acc] /ˈvɜːrtɪɡoʊ/; [or]sat;
arbitrator: [x] n. 公断人; [acc] /ˈɑːrbɪtreɪtər/; [or]sat;
quixotic: [x] adj. 空想的,堂吉诃德式的;  n. 同"quixotism"; [acc] /kwɪkˈsɑːtɪk/; [or]sat;
extrinsic: [x] adj. 外在的,外部的; [acc] /eksˈtrɪnzɪk/; [or]sat;
wheedle: [x] v. 以甜言蜜语诱惑,用甜言蜜语欺骗; [acc] /ˈwiːdl/; [or]sat;
rampant: [x] adj. 猖獗的,蔓生的; [acc] /ˈræmpənt/; [or]sat;
caucus: [x] n. 政党高层会议,核心人物; [acc] /ˈkɔːkəs/; [or]sat;
multifarious: [x] adj. 多种的,各式各样的; [acc] /ˌmʌltɪˈferiəs/; [or]sat;
partial: [x] adj. 偏爱的,特别喜欢的;偏袒的,不公平的,有偏见的;部分的;不完全的;  n. [数学]偏微商; [acc] /ˈpɑːrʃl/; [or]sat;
stodgy: [x] adj. 平凡的;塞满的;庸俗的; [acc] /ˈstɑːdʒi/; [or]sat;
pomposity: [x] n. 自大,傲慢,摆架子; [acc] /pɑːmˈpɑːsəti/; [or]sat;
friction: [x] n. 摩擦,摩擦力;争执,冲突; [acc] /ˈfrɪkʃn/; [or]sat;
nostalgia: [x] n. 怀旧之情,思乡病; [acc] /nəˈstældʒə/; [or]sat;
voracious: [x] adj. 狼吞虎咽的,贪婪的;  adv. 贪婪地;  n. 贪婪,贪吃; [acc] /vəˈreɪʃəs/; [or]sat;
irrevocable: [x] adj. 不可改变的;不能取消的;不能挽回的; [acc] /ɪˈrevəkəbl/; [or]sat;
entitlement: [x] n. 权利,津贴; [acc] /ɪnˈtaɪtlmənt/; [or]sat;
lope: [x] n. 轻快的步伐,大步慢跑;  v. 轻快地迈着大步; [acc] /loʊp/; [or]sat;
prologue: [x] n. 开场白,序幕; [acc] /ˈproʊlɔːɡ/; [or]sat;
indomitable: [x] adj. 不屈不挠的;不服输的;不气馁的; [acc] /ɪnˈdɑːmɪtəbl/; [or]sat;
reprove: [x] v. 责骂,申斥; [acc] /rɪˈpruːv/; [or]sat;
compelling: [x] adj. 引人注目的;紧迫的;令人信服的; [acc] /kəmˈpelɪŋ/; [or]sat;
relent: [x] v. 变温和,变宽厚;减弱;缓和;终于答应;不再拒绝; [acc] /rɪˈlent/; [or]sat;
metamorphosis: [x] n. 变形,变质,变异;[生物学]变态; [acc] /ˌmetəˈmɔːrfəsɪs/; [or]sat;
dolt: [x] n. 笨蛋,傻瓜; [acc] /doʊlt/; [or]sat;
animated: [x] adj. 有活力的,活生生的;活泼的,充满生气的;有生命的;动画(片)的; [acc] /ˈænɪmeɪtɪd/; [or]sat;
seismic: [x] adj. 地震的;地震引起的;剧烈的; [acc] /ˈsaɪzmɪk/; [or]sat;
hierarchy: [x] n. 阶层,等级制度; [acc] /ˈhaɪərɑːrki/; [or]sat;
verisimilitude: [x] n. 逼真,真实性; [acc] /ˌverɪsɪˈmɪlɪtuːd/; [or]sat;
circuitous: [x] adj. 迂回的,绕圈子的; [acc] /sərˈkjuːɪtəs/; [or]sat;
leaven: [x] n. 发酵剂,影响力;  v. 发酵,影响,渐变; [acc] /ˈlevn/; [or]sat;
abut: [x] v. 紧靠; [acc] /əˈbʌt/; [or]sat;
spatula: [x] n. (调和,涂抹用)抹刀,小铲;[医]压舌板; [acc] /ˈspætʃələ/; [or]sat;
sycophant: [x] n. 马屁精; [acc] /ˈsɪkəfænt/; [or]sat;
propound: [x] v. 提出(问题,计划)供考虑; [acc] /prəˈpaʊnd/; [or]sat;
indict: [x] v. 控诉,起诉; [acc] /ɪnˈdaɪt/; [or]sat;
astute: [x] adj. 机敏的,精明的,狡猾的; [acc] /əˈstuːt/; [or]sat;
necromancy: [x] n. 巫术,通灵术; [acc] /ˈnekroʊmænsi/; [or]sat;
knotty: [x] adj. 有节疤的,有结的;棘手的; [acc] /ˈnɑːti/; [or]sat;
archaic: [x] adj. 古代的;陈旧的,过时的,老式的;已不通用的; [acc] /ɑːrˈkeɪɪk/; [or]sat;
aesthetic: [x] n. 美感;审美观;  adj. 美学的;审美的;悦目的;雅致的; [acc] /esˈθetɪk/; [or]sat;
muster: [x] vi. 集合;聚集;  vt. 集合;召集;  n. 集合;集合人员; [acc] /ˈmʌstər/; [or]sat;
incoherent: [x] adj. 语无伦次的;不合逻辑的;不连贯的; [acc] /ˌɪnkoʊˈhɪrənt/; [or]sat;
vociferous: [x] adj. (表达意见或感情等)大声的,有力的; [acc] /voʊˈsɪfərəs/; [or]sat;
toxic: [x] n. 毒物;  adj. 有毒的;中毒的; [acc] /ˈtɑːksɪk/; [or]sat;
aphorism: [x] n. 格言,警句; [acc] /ˈæfərɪzəm/; [or]sat;
outstrip: [x] v. 比.优越,胜过,比.跑得快; [acc] /ˌaʊtˈstrɪp/; [or]sat;
doff: [x] v. 脱掉(外衣,帽子); [acc] /dɑːf/; [or]sat;
denounce: [x] v. 谴责,斥责; [acc] /dɪˈnaʊns/; [or]sat;
tender: [x] adj. 温柔的;嫩的;柔弱的,脆弱的;痛的;  n. 煤水车,附属船;投标;  v. 提出(希望对方接受的意见等); [acc] /ˈtendər/; [or]sat;
requiem: [x] n. 安魂曲;追思弥撒; [acc] /ˈrekwiəm/; [or]sat;
obliterate: [x] v. 消灭;涂去;冲刷;忘掉; [acc] /əˈblɪtəreɪt/; [or]sat;
savant: [x] n. 博学之士,大学士; [acc] /sæˈvɑːnt/; [or]sat;
censor: [x] n. 检查员;  vt. 审查,检查;修改; [acc] /ˈsensər/; [or]sat;
mock: [x] v. 嘲笑;轻蔑,蔑视;  adj. 不真诚的;伪造的;  n. 模拟考; [acc] /mɑːk/; [or]sat;
lassitude: [x] n. 困乏,厌倦,无精打采; [acc] /ˈlæsɪtuːd/; [or]sat;
subpoena: [x] n. (法律)传票;  v. 传讯;传审; [acc] /səˈpiːnə/; [or]sat;
paradox: [x] n. 矛盾;似矛盾而正确的说法; [acc] /ˈpærədɑːks/; [or]sat;
fugitive: [x] adj. 逃亡的,易逝的;  n. 逃犯,逃亡者; [acc] /ˈfjuːdʒətɪv/; [or]sat;
tepid: [x] adj. 微温的,不热烈的; [acc] /ˈtepɪd/; [or]sat;
subservient: [x] adj. 屈从的;奉承的;有用的,有帮助的; [acc] /səbˈsɜːrviənt/; [or]sat;
extant: [x] adj. 现存的;显著的; [acc] /ekˈstænt/; [or]sat;
avalanche: [x] n. 雪崩;大量拥至;  vi. 崩塌; [acc] /ˈævəlæntʃ/; [or]sat;
repertoire: [x] n. (剧团,演员等的)全部节目;全部才能; [acc] /ˈrepərtwɑːr/; [or]sat;
pliant: [x] adj. 易弯的,柔软的;  n. 顺从; [acc] /ˈplaɪənt/; [or]sat;
discourse: [x] n. 交谈,演讲,论述,讲道;  v. 演讲,谈论; [acc] /ˈdɪskɔːrs/; [or]sat;
stipulate: [x] v. 规定;保证;保证;要求以.为条件; [acc] /ˈstɪpjuleɪt/; [or]sat;
eccentricity: [x] n. 古怪;怪癖;[数]离心率; [acc] /ˌeksenˈtrɪsəti/; [or]sat;
babble: [x] v. 呀呀学语,喋喋不休,作潺潺声;泄露(秘密);  n. 儿语,胡言乱语,潺潺声; [acc] /ˈbæbl/; [or]sat;
soluble: [x] adj. 可溶解的;可解决的; [acc] /ˈsɑːljəbl/; [or]sat;
jollity: [x] n. 欢乐,酒宴,欢庆; [acc] /ˈdʒɑːləti/; [or]sat;
corrugated: [x] adj. 褶皱的; [acc] /ˈkɔːrəɡeɪtɪd/; [or]sat;
verbiage: [x] n. 罗嗦,冗长,措辞方式; [acc] /ˈvɜːrbiɪdʒ/; [or]sat;
exalt: [x] v. 提升,提拔,赞扬,使得意; [acc] /ɪɡˈzɔːlt/; [or]sat;
feign: [x] v. 假装,装作; [acc] /feɪn/; [or]sat;
brittle: [x] adj. 易碎的;脆弱的;靠不住的;  n. 薄片脆糖; [acc] /ˈbrɪtl/; [or]sat;
asperity: [x] n. (表面的)粗糙;(气候等的)严酷;艰苦的条件;(性格)粗暴; [acc] /æˈsperəti/; [or]sat;
infusion: [x] n. 灌输;注入物;输入; [acc] /ɪnˈfjuːʒn/; [or]sat;
pertinent: [x] adj. 有关的;适当的;中肯的;  n. 附属物;参考; [acc] /ˈpɜːrtnənt/; [or]sat;
infernal: [x] adj. 地狱的;恶魔的;可憎的; [acc] /ɪnˈfɜːrnl/; [or]sat;
turbulence: [x] n. 骚乱,动荡;狂暴;(空气或水的)乱流; [acc] /ˈtɜːrbjələns/; [or]sat;
abstract: [x] adj. 抽象的;  n. 摘要,抽象;  v. 提取; [acc] /ˈæbstrækt/; [or]sat;
insurmountable: [x] adj. 不能克服的,不能超越的,难以对付的; [acc] /ˌɪnsərˈmaʊntəbl/; [or]sat;
epithet: [x] n. 外号,绰号; [acc] /ˈepɪθet/; [or]sat;
precipitate: [x] v. 促成,使..沉淀,猛摔;[气象]凝结;  n. 沉淀物,冷凝物;  adj. 突如其来的,仓促的,迅猛的;感情用事的; [acc] /prɪˈsɪpɪteɪt/; [or]sat;
foster: [x] adj. 收养的;  vt. 养育;培养,促进; [acc] /ˈfɔːstər/; [or]sat;
berserk: [x] adj. 狂暴的,疯的的;  adv. 狂暴地,狂怒地;  n. 同"berserker"; [acc] /bərˈzɜːrk/; [or]sat;
genesis: [x] n. (事物的)起源,发生; [acc] /ˈdʒenəsɪs/; [or]sat;
amnesia: [x] n. [医学]遗忘症; [acc] /æmˈniːʒə/; [or]sat;
absolve: [x] v. 赦免,宽恕;免除,解除; [acc] /əbˈzɑːlv/; [or]sat;
balk: [x] v. 畏缩;阻止;停止;  n. 障碍;错误; [acc] /bɔːk/; [or]sat;
besmirch: [x] v. 诽谤,玷污; [acc] /bɪˈsmɜːrtʃ/; [or]sat;
tarry: [x] n. 逗留,短期滞在;  v. 耽搁,踌躇(等待),拖延;  adj. 柏油的,涂柏油的; [acc] /ˈtæri/; [or]sat;
frivolous: [x] adj. 轻佻的,不重要的,缺乏基础的; [acc] /ˈfrɪvələs/; [or]sat;
plaintive: [x] adj. 表示悲痛的,伤心的; [acc] /ˈpleɪntɪv/; [or]sat;
unwitting: [x] adj. 不知情的;无意的; [acc] /ʌnˈwɪtɪŋ/; [or]sat;
sheaf: [x] n. 一捆,一束;  v. 捆,束; [acc] /ʃiːf/; [or]sat;
impinge: [x] v. 侵犯,撞击,碰撞; [acc] /ɪmˈpɪndʒ/; [or]sat;
cantata: [x] n. 大合唱;清唱剧;(一种声乐套曲)康塔塔; [acc] /kænˈtɑːtə/; [or]sat;
impecunious: [x] adj. 贫困的,一文不名的; [acc] /ˌɪmpɪˈkjuːniəs/; [or]sat;
forestall: [x] v. 领先;占先一步;先发制人,阻止,妨碍;垄断;占先一步; [acc] /fɔːrˈstɔːl/; [or]sat;
herbivorous: [x] adj. 食草的; [acc] /ɜːrˈbɪvərəs/; [or]sat;
bluff: [x] adj. 直率的;  v. 虚张声势,吓唬;  n. 虚张声势;吓唬;断崖,绝壁; [acc] /blʌf/; [or]sat;
insensible: [x] adj. 昏迷的,无知觉的,麻木不仁的; [acc] /ɪnˈsensəbl/; [or]sat;
insipid: [x] adj. 淡而无味的;枯燥乏味的; [acc] /ɪnˈsɪpɪd/; [or]sat;
entice: [x] v. 怂恿,引诱; [acc] /ɪnˈtaɪs/; [or]sat;
hovel: [x] n. 茅舍,肮脏的小屋; [acc] /ˈhʌvl/; [or]sat;
implicit: [x] adj. 隐含的;盲目的;完全的,绝对的;成为一部分的; [acc] /ɪmˈplɪsɪt/; [or]sat;
drab: [x] adj. 枯黄色的,无聊的,单调的;  n. 单调;淡褐色;[印,纺]淡褐色厚呢;邋遢女人; [acc] /dræb/; [or]sat;
indifferent: [x] adj. 不感兴趣的,不关心的;平庸的;冷漠的; [acc] /ɪnˈdɪfrənt/; [or]sat;
incidence: [x] n. 发生率,入射角度; [acc] /ˈɪnsɪdəns/; [or]sat;
specious: [x] adj. 外表美观,华而不实的,徒有其表的; [acc] /ˈspiːʃəs/; [or]sat;
dissertation: [x] n. (博士学位)论文;学术演讲;专题; [acc] /ˌdɪsərˈteɪʃn/; [or]sat;
qualified: [x] adj. 有资格的;保留的,有限度的;  vt. 描述,形容;使合适;授权予;有权,达标;  vi. 合格,成为合格;取得.的资格; [acc] /ˈkwɑːlɪfaɪd/; [or]sat;
effusive: [x] adj. 流出的;感情奔放的; [acc] /ɪˈfjuːsɪv/; [or]sat;
fanaticism: [x] n. 狂热,盲信; [acc] /fəˈnætɪsɪzəm/; [or]sat;
subside: [x] vi. 平息,减弱;减弱;(建筑)下陷;(尤指洪水的水位) 回落; [acc] /səbˈsaɪd/; [or]sat;
remiss: [x] adj. 疏忽的,怠慢的; [acc] /rɪˈmɪs/; [or]sat;
quay: [x] n. 码头; [acc] /kiː/; [or]sat;
montage: [x] n. 蒙太奇(电影的基本结构手段和叙事方式),混合画,拼集的照片; [acc] /ˌmɑːnˈtɑːʒ/; [or]sat;
nicety: [x] n. 细节,讲究; [acc] /ˈnaɪsəti/; [or]sat;
clench: [x] v. 紧握,(拳头)牢牢地抓住;确定;敲弯;咬紧(牙关);  n. 紧抓;咬紧牙关;咬牙切齿;敲弯的钉头; [acc] /klentʃ/; [or]sat;
vaporize: [x] v. (使)蒸发;使.蒸发; [acc] /ˈveɪpəraɪz/; [or]sat;
impunity: [x] n. 不受惩罚;无患; [acc] /ɪmˈpjuːnəti/; [or]sat;
facetious: [x] adj. 滑稽的,诙谐的,开玩笑的; [acc] /fəˈsiːʃəs/; [or]sat;
lucrative: [x] adj. 合算的;获利的;有利可图的; [acc] /ˈluːkrətɪv/; [or]sat;
attest: [x] vt. 证明;证实;为.作证;  vi. 证明;作证; [acc] /əˈtest/; [or]sat;
prey: [x] n. 被掠食者,猎物;牺牲者;  v. 使..苦恼;  vi. 捕食;受..控制; [acc] /preɪ/; [or]sat;
navigable: [x] adj. (江河,海洋)可航行的,可通航的;(船)适航的; [acc] /ˈnævɪɡəbl/; [or]sat;
pragmatic: [x] adj. 国事的,团体事务的;实际的,注重实效的;  n. 爱管闲事的人;专断的人;国事诏书;实际家; [acc] /præɡˈmætɪk/; [or]sat;
homage: [x] n. 敬意;尊敬;效忠; [acc] /ˈhɑːmɪdʒ/; [or]sat;
splice: [x] n. 接合,衔接处;  v. 接头,捻接(线头等); [acc] /splaɪs/; [or]sat;
query: [x] n. 质问,询问,怀疑;  v. 询问,表示怀疑; [acc] /ˈkwɪri/; [or]sat;
rummage: [x] n. 杂物,翻寻;  v. 彻底搜查,翻箱倒柜; [acc] /ˈrʌmɪdʒ/; [or]sat;
unseemly: [x] adj. 不适宜的;不得体的;  adv. 不适当地; [acc] /ʌnˈsiːmli/; [or]sat;
demur: [x] n. 异议;  v. 异议,反对,拒绝; [acc] /dɪˈmɜːr/; [or]sat;
acclaim: [x] n. 欢呼,赞扬,称赞;  v. 欢呼,喝彩,鼓掌欢迎;  vt. 鼓掌欢迎,向.欢呼,为.喝彩;推选; [acc] /əˈkleɪm/; [or]sat;
vindictive: [x] adj. 报复性的,怀恨的,惩罚的; [acc] /vɪnˈdɪktɪv/; [or]sat;
prolong: [x] v. 延长;拉长;拖延; [acc] /prəˈlɔːŋ/; [or]sat;
collage: [x] n. 抽象拚贴画(用报纸,布,压平的花等碎片拼合而成的); [acc] /kəˈlɑːʒ/; [or]sat;
pensive: [x] adj. 沉思的,心事重重的,忧郁的; [acc] /ˈpensɪv/; [or]sat;
migrant: [x] n. 候鸟;移民; [acc] /ˈmaɪɡrənt/; [or]sat;
truism: [x] n. 自明之理,真理,不言而喻的道理; [acc] /ˈtruːɪzəm/; [or]sat;
euphoria: [x] n. 幸福愉快感; [acc] /juːˈfɔːriə/; [or]sat;
penchant: [x] n. 倾向,爱好; [acc] /ˈpentʃənt/; [or]sat;
flinch: [x] v. 畏缩,退缩;  n. 退缩,畏惧; [acc] /flɪntʃ/; [or]sat;
oaf: [x] n. 愚蠢的人; [acc] /oʊf/; [or]sat;
tensile: [x] adj. 可拉长的,可伸长的,[物]张力的,拉力的; [acc] /ˈtensl/; [or]sat;
frigid: [x] adj. 寒冷的,冷淡的,死板的,呆板的,性冷淡的; [acc] /ˈfrɪdʒɪd/; [or]sat;
quip: [x] n. 妙语,嘲弄,讽刺语;  v. 嘲弄,讥讽; [acc] /kwɪp/; [or]sat;
germinate: [x] v. 发芽,发展,生长; [acc] /ˈdʒɜːrmɪneɪt/; [or]sat;
lurid: [x] adj. (暴力,性爱等)耸人听闻的; [acc] /ˈlʊrɪd/; [or]sat;
application: [x] n. 运用;申请(书);应用程序; [acc] /ˌæplɪˈkeɪʃn/; [or]sat;
inevitable: [x] adj. 不可避免的,必然的;  n. 必然发生的事; [acc] /ɪnˈevɪtəbl/; [or]sat;
aquiline: [x] adj. 鹰的,似鹰的;钩状的; [acc] /ˈækwɪlaɪn/; [or]sat;
snicker: [x] vi. 偷笑,窃笑;  vt. 窃笑着说;  n. 窃笑; [acc] /ˈsnɪkər/; [or]sat;
check: [x] v. 检查;阻止;  n. 支票;阻止;检查;阻止物; [acc] /tʃek/; [or]sat;
parry: [x] v. 挡开,避开(武器,问题等); [acc] /ˈpæri/; [or]sat;
expiate: [x] v. 赎罪,补偿; [acc] /ˈekspieɪt/; [or]sat;
benediction: [x] n. 祝福,祈祷; [acc] /ˌbenɪˈdɪkʃn/; [or]sat;
probe: [x] v. 探测,探索;  n. 探索,调查;探针,探测器; [acc] /proʊb/; [or]sat;
rehabilitate: [x] v. 使康复,使恢复名誉,使恢复原状; [acc] /ˌriːəˈbɪlɪteɪt/; [or]sat;
perspicacious: [x] adj. 独具慧眼的,聪颖的; [acc] /ˌpɜːrspɪˈkeɪʃəs/; [or]sat;
abridge: [x] v. 删节;削减; [acc] /əˈbrɪdʒ/; [or]sat;
holster: [x] n. 手枪皮套; [acc] /ˈhoʊlstər/; [or]sat;
incumbent: [x] n. 在职者,现任者;  adj. 现任的;依靠的;负有职责的; [acc] /ɪnˈkʌmbənt/; [or]sat;
nip: [x] v. 咬;捏;剪断;冻伤;阻止;  n. 夹;捏;刺骨;小饮; [acc] /nɪp/; [or]sat;
vex: [x] v. 使烦恼,使苦恼,使恼怒; [acc] /veks/; [or]sat;
encumber: [x] v. 阻塞,妨害,拖累; [acc] /ɪnˈkʌmbər/; [or]sat;
proscribe: [x] v. 剥夺..的公权,禁止; [acc] /proʊˈskraɪb/; [or]sat;
natty: [x] adj. 整洁的,干净的,潇洒的; [acc] /ˈnæti/; [or]sat;
camouflage: [x] n. 伪装;掩饰;  v. 使改头换面,伪装,掩饰;欺瞒; [acc] /ˈkæməflɑːʒ/; [or]sat;
purveyor: [x] n. 承办者;供应粮食者; [acc] /pərˈveɪər/; [or]sat;
pachyderm: [x] n. 迟钝的人;厚脸皮的人;厚皮类动物; [acc] /ˈpækidɜːrm/; [or]sat;
fauna: [x] n. 动物区系,动物群; [acc] /ˈfɔːnə/; [or]sat;
militant: [x] adj. 好战的,好暴力的;  n. 激进分子,斗士; [acc] /ˈmɪlɪtənt/; [or]sat;
precept: [x] n. 箴言,格言; [acc] /ˈpriːsept/; [or]sat;
fruition: [x] n. 享有;最后完成,实现,取得成果; [acc] /fruˈɪʃn/; [or]sat;
proponent: [x] n. 支持者;提议者;主张者;提出认证遗嘱者;  adj. 建议的;支持的;辩护的; [acc] /prəˈpoʊnənt/; [or]sat;
platitude: [x] n. 陈词滥调,老生常谈;单调; [acc] /ˈplætɪtuːd/; [or]sat;
Catholic: [x] adj. (兴趣等)广泛的,(C大写)天主教的;  n. (C大写)天主教徒; [acc] /ˈkæθlɪk/; [or]sat;
interminable: [x] adj. 没完没了的,无穷无尽的,冗长的; [acc] /ɪnˈtɜːrmɪnəbl/; [or]sat;
seclusion: [x] n. 隐遁,隐蔽的地方; [acc] /sɪˈkluːʒn/; [or]sat;
nutrient: [x] n. 营养物;滋养物;  adj. 营养的;滋养的; [acc] /ˈnuːtriənt/; [or]sat;
opalescent: [x] adj. 乳白色的;发乳白光的; [acc] /ˌoʊpəˈlesnt/; [or]sat;
sublime: [x] adj. 雄伟的,崇高的,极端的,超群的;(行为,态度)极端的,漠不关心的;  n. 顶峰,崇高;  v. 使.纯化,使.升华,变高尚; [acc] /səˈblaɪm/; [or]sat;
monolithic: [x] adj. 巨石的,庞大的;千篇一律的; [acc] /ˌmɑːnəˈlɪθɪk/; [or]sat;
anathema: [x] n. (基督教的)咒诅,被诅咒者,令人厌恶的人; [acc] /əˈnæθəmə/; [or]sat;
lunge: [x] n. 突然刺(入);突然向前冲〔扑等);套马索;  v. (用剑等)刺,戳;猛向前冲,猛扑; [acc] /lʌndʒ/; [or]sat;
sate: [x] v. 使心满意足,使厌足; [acc] /seɪt/; [or]sat;
raze: [x] v. 夷为平地,破坏,消除;拆毁; [acc] /reɪz/; [or]sat;
purchase: [x] v. 购买;  n. 购买;所购之物; [acc] /ˈpɜːrtʃəs/; [or]sat;
benevolent: [x] adj. 慈爱的,仁慈的;乐善好施的;慈善的; [acc] /bəˈnevələnt/; [or]sat;
dabble: [x] v. 涉足;浅赏,溅湿;浸入水中; [acc] /ˈdæbl/; [or]sat;
enterprising: [x] adj. 有事业心的,有进取心的,有魅力的,有胆量的;有魄力的; [acc] /ˈentərpraɪzɪŋ/; [or]sat;
proliferation: [x] n. 增殖;增加; [acc] /prəˌlɪfəˈreɪʃn/; [or]sat;
coercion: [x] n. 胁迫,威压; [acc] /koʊˈɜːrʒn/; [or]sat;
ceremonious: [x] adj. 隆重的;讲究仪式的;正式的; [acc] /ˌserəˈmoʊniəs/; [or]sat;
integral: [x] adj. (用于构成整体)必需的,不可缺少的,必不可少的;基本的,作为组成部分的,内置的;整体的,完整的; [acc] /ˈɪntɪɡrəl/; [or]sat;
malign: [x] v. 诽谤,中伤;  adj. 邪恶的;有害的; [acc] /məˈlaɪn/; [or]sat;
savory: [x] adj. 口感好的,味道好的,令人愉悦的; [acc] /ˈseɪvəri/; [or]sat;
desecrate: [x] v. 亵渎,玷污; [acc] /ˈdesɪkreɪt/; [or]sat;
inhibit: [x] v. 阻碍;阻止,防止;抑制,约束; [acc] /ɪnˈhɪbɪt/; [or]sat;
valid: [x] adj. 有效的,正式认可的;合理的,有根据的; [acc] /ˈvælɪd/; [or]sat;
rant: [x] n. 咆哮,痛骂;  v. 咆哮,痛骂,大声责骂; [acc] /rænt/; [or]sat;
anarchist: [x] n. 无政府主义者; [acc] /ˈænərkɪst/; [or]sat;
implacable: [x] adj. 难以满足的,难平息的; [acc] /ɪmˈplækəbl/; [or]sat;
temperament: [x] n. 气质,性格,喜怒无常; [acc] /ˈtemprəmənt/; [or]sat;
gruff: [x] adj. 粗暴的,粗哑的,脾气坏的;  vt. 粗鲁地说,生硬地说;  vi. 粗鲁地说,生硬地说话; [acc] /ɡrʌf/; [or]sat;
deify: [x] v. 奉为神;崇拜; [acc] /ˈdeɪɪfaɪ/; [or]sat;
appreciate: [x] v. 赏识;为..表示感激;领会;使增值;增值; [acc] /əˈpriːʃieɪt/; [or]sat;
seep: [x] v. (液体等)渗漏,(观念等)渗入,(疾病恐惧等)扩散;  n. 小泉,水陆两用的吉普车; [acc] /siːp/; [or]sat;
subsequent: [x] adj. 随后的; [acc] /ˈsʌbsɪkwənt/; [or]sat;
impair: [x] v. 损害;削弱; [acc] /ɪmˈper/; [or]sat;
ogle: [x] v. 送秋波,施媚眼;  n. 秋波,媚眼; [acc] /ˈoʊɡl/; [or]sat;
salient: [x] adj. 显著的;突出的;跳跃的;  n. 凸角;突出部分; [acc] /ˈseɪliənt/; [or]sat;
instigate: [x] v. 发起,煽动; [acc] /ˈɪnstɪɡeɪt/; [or]sat;
recurrent: [x] adj. 复发的;周期性的,经常发生的; [acc] /rɪˈkɜːrənt/; [or]sat;
slovenly: [x] adj. 不整洁的,马虎的; [acc] /ˈslʌvnli/; [or]sat;
zealot: [x] n. 狂热份子,犹太教狂热信徒; [acc] /ˈzelət/; [or]sat;
collusion: [x] n. 勾结;共谋; [acc] /kəˈluːʒn/; [or]sat;
flick: [x] n. 轻弹,轻打;轻弹声;  v. 轻弹;轻轻拂去;(翅)拍动;(旗)飘扬; [acc] /flɪk/; [or]sat;
expunge: [x] v. 删除; [acc] /ɪkˈspʌndʒ/; [or]sat;
idiosyncrasy: [x] n. 特殊癖性或行为; [acc] /ˌɪdiəˈsɪŋkrəsi/; [or]sat;
maternal: [x] adj. 母亲的,母性的;母方的,母系的; [acc] /məˈtɜːrnl/; [or]sat;
affable: [x] adj. 易于交谈的,和蔼的; [acc] /ˈæfəbl/; [or]sat;
optimist: [x] n. 乐天派,乐观者; [acc] /ˈɑːptɪmɪst/; [or]sat;
burlesque: [x] adj. 滑稽的,可笑的;  v. 讥笑;  n. 脱衣舞,打油诗,滑稽戏,笑剧,杂耍,漫画; [acc] /bɜːrˈlesk/; [or]sat;
cogitate: [x] v. 慎重思考,思索; [acc] /ˈkɑːdʒɪteɪt/; [or]sat;
oblivious: [x] adj. 不在意的;忘却的,健忘的; [acc] /əˈblɪviəs/; [or]sat;
grotesque: [x] adj. 奇形怪状的,奇异的;  n. 奇形怪状的人(或物,图案等);奇异风格; [acc] /ɡroʊˈtesk/; [or]sat;
daub: [x] v. 涂抹,乱画;  n. 涂抹,涂料,拙劣的画; [acc] /dɔːb/; [or]sat;
lilliputian: [x] adj. 小人国的,气量小的;  n. 侏儒,小人国居民; [acc] /ˌlɪlɪˈpjuːʃn/; [or]sat;
atone: [x] v. 赎罪,补偿; [acc] /əˈtoʊn/; [or]sat;
liability: [x] n. 责任;债务;倾向;可能性;不利因素;惹麻烦的人(或事); [acc] /ˌlaɪəˈbɪləti/; [or]sat;
prattle: [x] v. 闲聊;胡说;小孩般说话;  n. 无聊话;咿咿呀呀声; [acc] /ˈprætl/; [or]sat;
proclivity: [x] n. 倾向,怪癖; [acc] /prəˈklɪvəti/; [or]sat;
tactile: [x] adj. 有触觉的;能触知的; [acc] /ˈtæktl/; [or]sat;
haggard: [x] adj. 憔悴的,消瘦的;  n. 哈格德;未驯服的鹰;悍鹰; [acc] /ˈhæɡərd/; [or]sat;
neophyte: [x] n. 新信徒;新入教者;初学者; [acc] /ˈniːəfaɪt/; [or]sat;
pundit: [x] n. 博学者,评论家; [acc] /ˈpʌndɪt/; [or]sat;
manifest: [x] adj. 显然的,明白无误的,明了的;  v. 使显现,使显露,表明;  n. 货单,旅客名单; [acc] /ˈmænɪfest/; [or]sat;
remonstrance: [x] n. 抗议,抱怨,谏书; [acc] /rɪˈmɑːnstrəns/; [or]sat;
strew: [x] vt. 撒;把.撒在.上;散播,点缀; [acc] /struː/; [or]sat;
multifaceted: [x] adj. 多层面的; [acc] /ˌmʌltiˈfæsɪtɪd/; [or]sat;
obfuscate: [x] v. 使复杂;使迷乱,使模糊;弄暗; [acc] /ˈɑːbfʌskeɪt/; [or]sat;
maladroit: [x] adj. 笨拙的; [acc] /ˌmæləˈdrɔɪt/; [or]sat;
polyglot: [x] n. 通晓数种语言的人;用通晓数种语言记载的书;  adj. 通数国语言,数国语言的; [acc] /ˈpɑːliɡlɑːt/; [or]sat;
potential: [x] n. 潜力,潜能;  adj. 潜在的,可能的; [acc] /pəˈtenʃl/; [or]sat;
jargon: [x] n. 行话,术语;黄锆石; [acc] /ˈdʒɑːrɡən/; [or]sat;
iniquitous: [x] adj. 邪恶的;不公正的; [acc] /ɪˈnɪkwɪtəs/; [or]sat;
avarice: [x] n. 贪财,贪婪; [acc] /ˈævərɪs/; [or]sat;
livid: [x] adj. 气急败坏的,铅色的; [acc] /ˈlɪvɪd/; [or]sat;
laud: [x] v. 赞美,称赞; [acc] /lɔːd/; [or]sat;
detached: [x] adj. 孤立的,分开的,超然公平的; [acc] /dɪˈtætʃt/; [or]sat;
outmoded: [x] adj. 不再流行的,过时的; [acc] /ˌaʊtˈmoʊdɪd/; [or]sat;
predator: [x] n. 掠夺者,食肉动物; [acc] /ˈpredətər/; [or]sat;
irremediable: [x] adj. 不能挽回的,不能补救的; [acc] /ˌɪrɪˈmiːdiəbl/; [or]sat;
abstinence: [x] n. 节制,禁欲; [acc] /ˈæbstɪnəns/; [or]sat;
allegory: [x] n. 讽喻;寓意;寓言; [acc] /ˈæləɡɔːri/; [or]sat;
allure: [x] v. 吸引;诱使;  n. 诱惑力; [acc] /əˈlʊr/; [or]sat;
lout: [x] n. 粗人,笨拙的人; [acc] /laʊt/; [or]sat;
abortive: [x] adj. 无结果的,失败的; [acc] /əˈbɔːrtɪv/; [or]sat;
narrative: [x] n. 叙述;  adj. 叙述的; [acc] /ˈnærətɪv/; [or]sat;
allocate: [x] v. 分配,配给; [acc] /ˈæləkeɪt/; [or]sat;
piquant: [x] adj. 辛辣的,开胃的;活泼有趣的; [acc] /ˈpiːkənt/; [or]sat;
itinerant: [x] n. 巡回工作者;  adj. 巡回的;流动的; [acc] /aɪˈtɪnərənt/; [or]sat;
rectify: [x] v. 纠正;修复; [acc] /ˈrektɪfaɪ/; [or]sat;
outspoken: [x] adj. 直言的,坦率的; [acc] /aʊtˈspoʊkən/; [or]sat;
shrewd: [x] adj. 精明的;机灵的;  n. 精明;精明者; [acc] /ʃruːd/; [or]sat;
numismatist: [x] n. 钱币学家,钱币收藏家; [acc] /nuːˈmɪzmətɪst/; [or]sat;
browse: [x] v. 浏览;随意翻阅;(牛,羊等)吃草; [acc] /braʊz/; [or]sat;
canto: [x] n. (长诗的)分篇; [acc] /ˈkæntoʊ/; [or]sat;
arbitrary: [x] adj. 随意的,任性的,随心所欲的;霸道的,专制的,专横的;主观的,武断的; [acc] /ˈɑːrbətreri/; [or]sat;
contrived: [x] adj. 人为的;做作的;不自然的; [acc] /kənˈtraɪvd/; [or]sat;
comprise: [x] v. 包含,包括;构成; [acc] /kəmˈpraɪz/; [or]sat;
transcribe: [x] v. 抄写,转录; [acc] /trænˈskraɪb/; [or]sat;
excerpt: [x] n. 摘录,节选;  v. 摘,选;引用; [acc] /ˈeksɜːrpt/; [or]sat;
collateral: [x] adj. 间接的,旁系的;  n. 抵押品; [acc] /kəˈlætərəl/; [or]sat;
expatriate: [x] v. (使)移居国外;(使)放弃国籍;流放,放逐;  n. 被流放者;移居国外者;  adj. 移居国外的;被流放的; [acc] /ˌeksˈpeɪtriət/; [or]sat;
arsenal: [x] n. 兵工厂,军械库;储藏; [acc] /ˈɑːrsənl/; [or]sat;
espouse: [x] v. 支持,拥护; [acc] /ɪˈspaʊz/; [or]sat;
rectitude: [x] n. 正直,公正,正确; [acc] /ˈrektɪtuːd/; [or]sat;
hoary: [x] adj. 年纪高迈的;(头发等)灰白的;古老的; [acc] /ˈhɔːri/; [or]sat;
intractable: [x] adj. 棘手的;难治的;倔强的;不听话的; [acc] /ɪnˈtræktəbl/; [or]sat;
gusto: [x] n. 由衷的高兴;爱好,嗜好; [acc] /ˈɡʌstoʊ/; [or]sat;
lexicon: [x] n. 词典,语言,文字; [acc] /ˈleksɪkən/; [or]sat;
insomnia: [x] n. 失眠; [acc] /ɪnˈsɑːmniə/; [or]sat;
debacle: [x] n. 解冻,崩溃;灾害; [acc] /dɪˈbɑːkl/; [or]sat;
sustenance: [x] n. 生计;食物,粮食; [acc] /ˈsʌstənəns/; [or]sat;
spurn: [x] v. 轻蔑地拒绝,摒弃,唾弃,一脚踢开; [acc] /spɜːrn/; [or]sat;
engaging: [x] adj. 迷人的; [acc] /ɪnˈɡeɪdʒɪŋ/; [or]sat;
stem: [x] n. 茎,(树)干;  v. 阻止;起源于;遏制,抑制; [acc] /stem/; [or]sat;
ostentatious: [x] adj. 浮华的,虚饰的,外观美丽的; [acc] /ˌɑːstenˈteɪʃəs/; [or]sat;
stagnant: [x] adj. 不流动的;停滞的;萧条的; [acc] /ˈstæɡnənt/; [or]sat;
obstreperous: [x] adj. 吵闹的,喧嚣的;难驾驭的; [acc] /əbˈstrepərəs/; [or]sat;
irony: [x] n. 反语;冷嘲;具有讽刺意味的事; [acc] /ˈaɪrəni/; [or]sat;
lurk: [x] n. 潜伏,潜行;  vi. 潜伏;潜藏;鬼鬼祟祟地走; [acc] /lɜːrk/; [or]sat;
stupor: [x] n. 恍惚,昏迷,不醒人事; [acc] /ˈstuːpər/; [or]sat;
deviate: [x] v. 偏离;背离;  adj. 脱离常轨的;  n. 脱离常轨的人; [acc] /ˈdiːvieɪt/; [or]sat;
savor: [x] n. 味道,气味,特点,趣味;  v. 调味,品尝,欣赏,玩味; [acc] /ˈseɪvər/; [or]sat;
opaque: [x] adj. 不透明的;难懂的; [acc] /oʊˈpeɪk/; [or]sat;
misrepresent: [x] vi. 作虚假陈述;  vt. 歪曲;误传; [acc] /ˌmɪsˌreprɪˈzent/; [or]sat;
monochromatic: [x] adj. [物]单色的; [acc] /ˌmɑːnəkroʊˈmætɪk/; [or]sat;
equanimity: [x] n. 平静,镇定,沉着; [acc] /ˌekwəˈnɪməti/; [or]sat;
tenuous: [x] adj. 纤细的;稀薄的;贫乏的;脆弱的; [acc] /ˈtenjuəs/; [or]sat;
flippant: [x] adj. 无礼的,轻率的,随意的; [acc] /ˈflɪpənt/; [or]sat;
summit: [x] n. 山顶,顶点;(政府间的)峰会; [acc] /ˈsʌmɪt/; [or]sat;
munificent: [x] adj. 慷慨的,大方的; [acc] /mjuːˈnɪfɪsnt/; [or]sat;
stratum: [x] n. 层次;薄层;地层;阶层; [acc] /ˈstreɪtəm/; [or]sat;
satirical: [x] adj. 讽刺性的,讥讽的,爱挖苦人的; [acc] /səˈtɪrɪkl/; [or]sat;
ostensible: [x] adj. 表面上的,伪装的; [acc] /ɑːˈstensəbl/; [or]sat;
myriad: [x] n. 无数;极大数量;  adj. 无数的; [acc] /ˈmɪriəd/; [or]sat;
quiver: [x] n. 颤抖;箭袋;  vi. 颤抖; [acc] /ˈkwɪvər/; [or]sat;
importunate: [x] adj. 讨厌的,急切的,缠扰不休的; [acc] /ɪmˈpɔːrtʃənət/; [or]sat;
levy: [x] v. 征收(税等);  n. 征税;税款; [acc] /ˈlevi/; [or]sat;
elliptical: [x] adj. 椭圆的;省略的; [acc] /ɪˈlɪptɪkl/; [or]sat;
pliable: [x] adj. 易弯的;柔韧的;圆滑的; [acc] /ˈplaɪəbl/; [or]sat;
predecessor: [x] n. 前辈;(被取代的)原有事物; [acc] /ˈpredəsesər/; [or]sat;
dearth: [x] n. 缺乏,供应不足; [acc] /dɜːrθ/; [or]sat;
gentility: [x] n. 上流阶层;文雅;有教养; [acc] /dʒenˈtɪləti/; [or]sat;
ruminate: [x] v. 反刍,再嚼,深思; [acc] /ˈruːmɪneɪt/; [or]sat;
charlatan: [x] n. 骗子;假内行; [acc] /ˈʃɑːrlətən/; [or]sat;
bauble: [x] n. 廉价珠宝;小玩意; [acc] /ˈbɔːbl/; [or]sat;
reputable: [x] adj. 声誉好的;受尊敬的;卓越的; [acc] /ˈrepjətəbl/; [or]sat;
plumage: [x] n. 全身羽毛; [acc] /ˈpluːmɪdʒ/; [or]sat;
concession: [x] n. 让步;特许,特许权;承认; [acc] /kənˈseʃn/; [or]sat;
wane: [x] n. 衰退(期);月亏(期);减少;  v. (月)缺损;(光,势力,治理等)衰落;减少; [acc] /weɪn/; [or]sat;
patronize: [x] v. 惠顾;赞助,资助; [acc] /ˈpeɪtrənaɪz/; [or]sat;
authenticate: [x] v. 鉴定;证明.是真实的; [acc] /ɔːˈθentɪkeɪt/; [or]sat;
ethos: [x] n. 民族精神,气质,社会思潮; [acc] /ˈiːθɑːs/; [or]sat;
commodious: [x] adj. 宽敞的; [acc] /kəˈmoʊdiəs/; [or]sat;
glacial: [x] adj. 冰的;冰冷的;冰河时代的; [acc] /ˈɡleɪʃl/; [or]sat;
anthem: [x] n. 国歌,赞美诗,圣歌; [acc] /ˈænθəm/; [or]sat;
palliate: [x] v. 减轻,掩饰,辩解; [acc] /ˈpælieɪt/; [or]sat;
detrimental: [x] adj. 有害的,不利的; [acc] /ˌdetrɪˈmentl/; [or]sat;
mobile: [x] n. 风铃,悬挂饰物;手机,移动电话;  adj. 可移动的;行动方便的; [acc] /ˈmoʊbl/; [or]sat;
quandary: [x] n. 困惑;窘境;为难; [acc] /ˈkwɑːndəri/; [or]sat;
boon: [x] n. 恩惠,福利,利益;  adj. 愉快的; [acc] /buːn/; [or]sat;
debonair: [x] adj. 温文尔雅的; [acc] /ˌdebəˈner/; [or]sat;
foreshadow: [x] v. 预示;  n. 预兆; [acc] /fɔːrˈʃædoʊ/; [or]sat;
effigy: [x] n. 肖像,模拟像; [acc] /ˈefɪdʒi/; [or]sat;
shroud: [x] n. 寿衣,覆盖物;  v. 覆盖,包以尸衣; [acc] /ʃraʊd/; [or]sat;
curtail: [x] vt. 截短;削减;剥夺.特权; [acc] /kɜːrˈteɪl/; [or]sat;
posterity: [x] n. 子孙,后裔,后代; [acc] /pɑːˈsterəti/; [or]sat;
succor: [x] n. 救援,援助者,救援人员;  v. 援助,救援; [acc] /ˈsʌkər/; [or]sat;
lewd: [x] adj. 好色的,淫荡的,猥亵的; [acc] /luːd/; [or]sat;
initiate: [x] v. 开始,发动;  n. 新加入组织的人; [acc] /ɪˈnɪʃieɪt/; [or]sat;
laconic: [x] adj. (用词)简洁的;简明的;  adv. 简短地,简洁地; [acc] /ləˈkɑːnɪk/; [or]sat;
infamous: [x] adj. 声名狼藉的,无耻的; [acc] /ˈɪnfəməs/; [or]sat;
convene: [x] v. 集合,召集,召唤; [acc] /kənˈviːn/; [or]sat;
patina: [x] n. 绿锈,光亮的外表,神态,圣餐盘; [acc] /pəˈtiːnə/; [or]sat;
arrogance: [x] n. 自大;傲慢态度; [acc] /ˈærəɡəns/; [or]sat;
fusion: [x] n. 融合,合并,核聚变; [acc] /ˈfjuːʒn/; [or]sat;
gambit: [x] n. (常指带风险的)策略,弃兵局(指国际象棋开局弃一卒以取得优势),话题,开始,开场白; [acc] /ˈɡæmbɪt/; [or]sat;
augment: [x] v. 增加;助长; [acc] /ɔːɡˈment/; [or]sat;
inclement: [x] adj. 险恶的;气候严酷的;狂风暴雨的; [acc] /ɪnˈklemənt/; [or]sat;
fathom: [x] n. 英寻(=6英尺);  vi. 测量深度;  vt. 彻底了解,测深; [acc] /ˈfæðəm/; [or]sat;
bountiful: [x] adj. 充足的,慷慨的,丰裕的; [acc] /ˈbaʊntɪfl/; [or]sat;
genre: [x] n. 类型,流派;  adj. 风俗画的,以日常情景为主题的; [acc] /ˈʒɑːnrə/; [or]sat;
aggregate: [x] n. 合计;总数;混凝料;总计;  v. 集合;聚集;合计;  adj. 总的,总数的;集合的; [acc] /ˈæɡrɪɡət/; [or]sat;
synthesis: [x] n. 合成; [acc] /ˈsɪnθəsɪs/; [or]sat;
dwindle: [x] v. 日渐减少,变小,缩小; [acc] /ˈdwɪndl/; [or]sat;
surmise: [x] v. 猜测,推测,认为;  n. 推测,猜度; [acc] /sərˈmaɪz/; [or]sat;
dauntless: [x] adj. 勇敢的,无畏的;不屈不挠的; [acc] /ˈdɔːntləs/; [or]sat;
uncouth: [x] adj. 笨拙的;粗野的;不舒适的;陌生的; [acc] /ʌnˈkuːθ/; [or]sat;
turncoat: [x] n. 叛徒; [acc] /ˈtɜːrnkoʊt/; [or]sat;
ratiocination: [x] n. 推理,推论; [acc] /ˌreɪʃioʊsɪˈneɪʃn/; [or]sat;
mischance: [x] n. 不幸,灾难; [acc] /ˌmɪsˈtʃæns/; [or]sat;
precise: [x] adj. 精确的;恰好的; [acc] /prɪˈsaɪs/; [or]sat;
ambidextrous: [x] adj. 双手都灵巧; [acc] /ˌæmbiˈdekstrəs/; [or]sat;
engage: [x] vt. 吸引住(注意力,兴趣);雇,聘;  vi. 使加入,使融入;订婚;  v. (军队)交战;啮合; [acc] /ɪnˈɡeɪdʒ/; [or]sat;
pact: [x] n. 合同;协约; [acc] /pækt/; [or]sat;
scanty: [x] adj. 少的,小的,缺乏的; [acc] /ˈskænti/; [or]sat;
ominous: [x] adj. 不祥的,不吉利的; [acc] /ˈɑːmɪnəs/; [or]sat;
intangible: [x] adj. 不可捉摸的,无形的;  n. 无形的东西; [acc] /ɪnˈtændʒəbl/; [or]sat;
invidious: [x] adj. 惹人反感的,招人嫉妒的,令人厌恶的,诽谤的,不公平的; [acc] /ɪnˈvɪdiəs/; [or]sat;
bullion: [x] n. (造币用)金块;纯金,纯银;条形金属; [acc] /ˈbʊliən/; [or]sat;
foresight: [x] n. 先见,预见;远见,深谋远虑; [acc] /ˈfɔːrsaɪt/; [or]sat;
latent: [x] adj. 潜在的,隐伏的,不易察觉的; [acc] /ˈleɪtnt/; [or]sat;
pedagogy: [x] n. 教育学,教学法; [acc] /ˈpedəɡɑːdʒi/; [or]sat;
practicable: [x] adj. 能实行的,行得通的;适用的,能用的;可通行的; [acc] /ˈpræktɪkəbl/; [or]sat;
beneficial: [x] adj. 有益的,有利的; [acc] /ˌbenɪˈfɪʃl/; [or]sat;
fervid: [x] adj. 热的;热心的; [acc] /ˈfɜːrvɪd/; [or]sat;
scale: [x] n. 天平,磅秤;刻度,尺度,标度;等级,级别, 等级体系;鳞片,鳞状物;规模;水垢,牙垢;  v. 攀登;按比例决定;称重;刮鳞,剥落; [acc] /skeɪl/; [or]sat;
trifling: [x] adj. 细微的,不重要的; [acc] /ˈtraɪflɪŋ/; [or]sat;
sinister: [x] adj. 不吉祥的,险恶的; [acc] /ˈsɪnɪstər/; [or]sat;
precocious: [x] adj. 早慧的;早熟的;过早发育的; [acc] /prɪˈkoʊʃəs/; [or]sat;
prodigious: [x] adj. 异常的,奇妙的;巨大的; [acc] /prəˈdɪdʒəs/; [or]sat;
loom: [x] n. 织布机;  v. 阴森地逼近;隐现;即将来临; [acc] /luːm/; [or]sat;
incompatible: [x] adj. 不兼容的,矛盾的,不调和的; [acc] /ˌɪnkəmˈpætəbl/; [or]sat;
tether: [x] n. 范围,系链,拴绳;  v. 用绳或链拴住; [acc] /ˈteðər/; [or]sat;
slacken: [x] v. (使)慢下来,放松,松懈; [acc] /ˈslækən/; [or]sat;
browbeat: [x] v. 恫吓,吓唬;欺侮; [acc] /ˈbraʊbiːt/; [or]sat;
depict: [x] v. 描绘,描写; [acc] /dɪˈpɪkt/; [or]sat;
circumspect: [x] adj. 慎重的,仔细的; [acc] /ˈsɜːrkəmspekt/; [or]sat;
erotic: [x] adj. 性爱的,性欲的,色情的;  n. 好色之徒;  adv. 引起性欲地; [acc] /ɪˈrɑːtɪk/; [or]sat;
flamboyant: [x] adj. 辉耀的;华丽的,艳丽的;火焰似的; [acc] /flæmˈbɔɪənt/; [or]sat;
saga: [x] n. 传奇故事;冒险故事;一连串的事件(或经历); [acc] /ˈsɑːɡə/; [or]sat;
parable: [x] n. 寓言,比喻; [acc] /ˈpærəbl/; [or]sat;
implication: [x] n. 暗示;含意;牵连;卷入;可能的后果; [acc] /ˌɪmplɪˈkeɪʃn/; [or]sat;
addiction: [x] n. 沉溺,上瘾; [acc] /əˈdɪkʃn/; [or]sat;
membrane: [x] n. 膜;薄膜;羊皮纸; [acc] /ˈmembreɪn/; [or]sat;
perceptive: [x] adj. 感知的,知觉的;有知觉力的; [acc] /pərˈseptɪv/; [or]sat;
illusion: [x] n. 假象,幻象;幻想;错误观念; [acc] /ɪˈluːʒn/; [or]sat;
ordeal: [x] n. 严峻考验,苦难的经历,折磨; [acc] /ɔːrˈdiːl/; [or]sat;
colossal: [x] adj. 巨像(似)的;巨大的,庞大的; [acc] /kəˈlɑːsl/; [or]sat;
avocation: [x] n. 业余爱好;副业;嗜好; [acc] /ˌævoʊˈkeɪʃn/; [or]sat;
absorb: [x] vt. 吸收;汲取;吸引..的注意;理解,掌握;承受; [acc] /əbˈzɔːrb/; [or]sat;
somnambulist: [x] n. 梦游症患者; [acc] /sɑːmˈnæmbjəlɪst/; [or]sat;
rave: [x] n. 热切赞扬,喧闹的宴会;胡言乱语;  v. 咆哮;胡言乱语;语无伦次地说;  adj. 赞扬的; [acc] /reɪv/; [or]sat;
superfluous: [x] adj. 多余的,过剩的;不必要的; [acc] /suːˈpɜːrfluəs/; [or]sat;
embezzlement: [x] n. 贪污;侵占;挪用; [acc] /ɪmˈbezlmənt/; [or]sat;
facsimile: [x] n. 复制本,摹本;  adj. 复制的;  v. 传真;临摹; [acc] /fækˈsɪməli/; [or]sat;
somber: [x] adj. 忧郁的;昏暗的,阴天的; [acc] /'sɒmbə/; [or]sat;
decorum: [x] n. 礼节,礼貌,端庄,正派; [acc] /dɪˈkɔːrəm/; [or]sat;
scapegoat: [x] n. 替罪羊; [acc] /ˈskeɪpɡoʊt/; [or]sat;
arduous: [x] adj. 艰巨的;努力的;陡峭的; [acc] /ˈɑːrdʒuəs/; [or]sat;
comely: [x] adj. 动人的,美丽的; [acc] /ˈkʌmli/; [or]sat;
patrician: [x] n. 贵族;  adj. 贵族的;显贵的;(相貌等)贵族似的; [acc] /pəˈtrɪʃn/; [or]sat;
dawdle: [x] v. 闲荡,浪费时间; [acc] /ˈdɔːdl/; [or]sat;
treatise: [x] n. 论述;论文;专著; [acc] /ˈtriːtɪs/; [or]sat;
dormant: [x] adj. 睡眠的,休眠的;静止的,隐伏的; [acc] /ˈdɔːrmənt/; [or]sat;
noncommittal: [x] adj. 态度不明朗的;不承担义务的;无明确意义的; [acc] /ˌnɒnkə'mɪtəl/; [or]sat;
irascible: [x] adj. 易怒的,性情暴躁的; [acc] /ɪˈræsəbl/; [or]sat;
amulet: [x] n. 护身符; [acc] /ˈæmjʊlət/; [or]sat;
reprehensible: [x] adj. 应受谴责的; [acc] /ˌreprɪˈhensəbl/; [or]sat;
incubate: [x] v. 孵卵; [acc] /ˈɪŋkjubeɪt/; [or]sat;
porous: [x] adj. 可渗透的,多孔的,可穿越的; [acc] /ˈpɔːrəs/; [or]sat;
causal: [x] adj. 因果关系的,有原因的;  n. 表示原因的连词; [acc] /ˈkɔːzl/; [or]sat;
conversant: [x] adj. 熟悉的;精通的;亲近的; [acc] /kənˈvɜːrsnt/; [or]sat;
artisan: [x] n. 工匠,手艺人; [acc] /ˈɑːrtəzn/; [or]sat;
mercurial: [x] adj. (情绪)善变的; [acc] /mɜːrˈkjʊriəl/; [or]sat;
pontifical: [x] adj. 罗马教宗的,主教的; [acc] /pɑːnˈtɪfɪkl/; [or]sat;
propensity: [x] n. 嗜好,习性;倾向; [acc] /prəˈpensəti/; [or]sat;
sordid: [x] adj. 卑鄙的,肮脏的,色彩死气沉沉暗淡的; [acc] /ˈsɔːrdɪd/; [or]sat;
preternatural: [x] adj. 超自然的;不可思议的; [acc] /ˌpriːtərˈnætʃrəl/; [or]sat;
filament: [x] n. 灯丝,细丝; [acc] /ˈfɪləmənt/; [or]sat;
prosaic: [x] adj. 平凡的,乏味的,散文体的; [acc] /prəˈzeɪɪk/; [or]sat;
intuition: [x] n. 直觉;感觉; [acc] /ˌɪntuˈɪʃn/; [or]sat;
aria: [x] n. 独唱曲,咏叹调; [acc] /ˈɑːriə/; [or]sat;
chary: [x] adj. 小心的,谨慎的; [acc] /ˈtʃeri/; [or]sat;
infantile: [x] adj. 婴儿的,幼稚的,初期的; [acc] /ˈɪnfəntaɪl/; [or]sat;
ancestry: [x] n. 祖先;血统; [acc] /ˈænsestri/; [or]sat;
ironic: [x] adj. 讽刺的; [acc] /aɪˈrɑːnɪk/; [or]sat;
wither: [x] v. 枯萎;凋谢;  vt. 使枯萎,使凋谢,萎缩;使人感觉羞惭或迷惑; [acc] /ˈwɪðər/; [or]sat;
opiate: [x] n. 鸦片制剂,麻醉剂,镇静剂;  adj. 含鸦片的,安眠的;  v. 用鸦片麻醉,使缓和; [acc] /ˈoʊpiət/; [or]sat;
hardy: [x] adj. (植物)耐寒的;能吃苦耐劳的;勇敢的;  n. 强壮的人; [acc] /ˈhɑːrdi/; [or]sat;
maudlin: [x] adj. 感情脆弱的;容易流泪的;酒后伤感的; [acc] /ˈmɔːdlɪn/; [or]sat;
therapeutic: [x] adj. 治疗的;治疗学的;有益于健康的;  n. 治疗剂;治疗学家; [acc] /ˌθerəˈpjuːtɪk/; [or]sat;
nomadic: [x] adj. 游牧的;流浪的;游动的; [acc] /noʊˈmædɪk/; [or]sat;
smolder: [x] v. 无火焰地闷烧,(仇恨,嫉妒,愤怒等)在心里郁积;  n. 焖烧,文火,冒烟; [acc] /ˈsmoʊldər/; [or]sat;
elated: [x] adj. 得意洋洋的;振奋的; [acc] /iˈleɪtɪd/; [or]sat;
portend: [x] v. 预兆,预示; [acc] /pɔːrˈtend/; [or]sat;
defunct: [x] adj. 已故的,不复存在的;不再使用的; [acc] /dɪˈfʌŋkt/; [or]sat;
heresy: [x] n. 异端邪说;异教; [acc] /ˈherəsi/; [or]sat;
halting: [x] adj. 犹豫的,蹒跚的,迟缓的;  v. 停止;蹒跚,犹豫; [acc] /ˈhɔːltɪŋ/; [or]sat;
breadth: [x] n. 宽度;广度; [acc] /bredθ/; [or]sat;
correlation: [x] n. 相互关系,相关(性); [acc] /ˌkɔːrəˈleɪʃn/; [or]sat;
rote: [x] n. 死记硬背,机械的做法,生搬硬套; [acc] /roʊt/; [or]sat;
disconsolate: [x] adj. 郁郁不乐的,孤独的,前途黯淡的; [acc] /dɪsˈkɑːnsələt/; [or]sat;
brevity: [x] n. 简短,短小,精炼; [acc] /ˈbrevəti/; [or]sat;
bumptious: [x] adj. 专横傲慢的,自以为是的; [acc] /ˈbʌmpʃəs/; [or]sat;
belated: [x] adj. 迟来的;误期的; [acc] /bɪˈleɪtɪd/; [or]sat;
ingenious: [x] adj. 聪明的;有发明天才的;有独创性的,别出心裁的; [acc] /ɪnˈdʒiːniəs/; [or]sat;
stalemate: [x] n. 和棋局面,僵局;  v. 使陷入僵局; [acc] /ˈsteɪlmeɪt/; [or]sat;
strident: [x] adj. 尖声的,刺耳的; [acc] /ˈstraɪdnt/; [or]sat;
depreciate: [x] v. 贬低,轻视;贬值;折旧; [acc] /dɪˈpriːʃieɪt/; [or]sat;
arbiter: [x] n. [法]仲裁者;裁决人; [acc] /ˈɑːrbɪtər/; [or]sat;
annuity: [x] n. 年金,养老金;年金保险;年金享受权; [acc] /əˈnuːəti/; [or]sat;
mesmerize: [x] v. 施催眠术;吸引,使神魂颠倒; [acc] /ˈmezməraɪz/; [or]sat;
foolhardy: [x] adj. 莽撞的,有勇无谋的; [acc] /ˈfuːlhɑːrdi/; [or]sat;
marquee: [x] n. 选取框;大天幕;华盖;  adj. 〈美〉最重要的; [acc] /mɑːrˈkiː/; [or]sat;
dupe: [x] n. 受骗的人,上当者;  v. 欺骗,愚弄; [acc] /duːp/; [or]sat;
solvent: [x] adj. 有偿付能力的;有溶解力的;  n. 溶剂;解决方法; [acc] /ˈsɑːlvənt/; [or]sat;
subliminal: [x] adj. 潜意识的,下意识的; [acc] /ˌsʌbˈlɪmɪnl/; [or]sat;
extort: [x] vt. 敲诈,勒索; [acc] /ɪkˈstɔːrt/; [or]sat;
antiseptic: [x] n. 杀菌剂;  adj. 防腐的,抗菌的; [acc] /ˌæntiˈseptɪk/; [or]sat;
incapacitate: [x] v. 使不能;使瘫痪;使无能力;使不适合; [acc] /ˌɪnkəˈpæsɪteɪt/; [or]sat;
terrestrial: [x] adj. 地球的,陆地的;  n. 陆地生物;地球上的人; [acc] /təˈrestriəl/; [or]sat;
cognate: [x] adj. 同词源的,同类的; [acc] /ˈkɑːɡneɪt/; [or]sat;
analogous: [x] adj. 类似的,可比拟的;[昆]同功的; [acc] /əˈnæləɡəs/; [or]sat;
nettle: [x] v. 刺激;惹恼;用荨麻刺;  n. 荨麻; [acc] /ˈnetl/; [or]sat;
malleable: [x] adj. (金属)可锻的;有延展性的;(性格)可训练的;易适应的; [acc] /ˈmæliəbl/; [or]sat;
prod: [x] n. 刺针;刺棒;签子;  v. 刺;戳;刺激; [acc] /prɑːd/; [or]sat;
garner: [x] v. 收藏,积累,储存;  n. 积蓄,积累物; [acc] /ˈɡɑːrnər/; [or]sat;
sluggish: [x] adj. 行动迟缓的,迟钝的;偷懒的; [acc] /ˈslʌɡɪʃ/; [or]sat;
bemoan: [x] v. 哀悼;为..恸哭;哀叹,对..表示惋惜; [acc] /bɪˈmoʊn/; [or]sat;
fleck: [x] n. 斑点,斑纹;雀斑;微粒,小片;  v. 使起斑点;使有斑纹; [acc] /flek/; [or]sat;
immune: [x] adj. 免疫的,有免疫力的;不受影响的;免除的; [acc] /ɪˈmjuːn/; [or]sat;
piecemeal: [x] n. 片;块;  v. 粉碎;  adv. 零碎地;逐个地;  adj. 零碎的;逐渐的; [acc] /ˈpiːsmiːl/; [or]sat;
collate: [x] v. 核对,校对;校勘; [acc] /kəˈleɪt/; [or]sat;
rife: [x] adj. 普遍的;流行的; [acc] /raɪf/; [or]sat;
fabricate: [x] v. 建造,制造,伪造(文件等),捏造,编造(谎言,借口等); [acc] /ˈfæbrɪkeɪt/; [or]sat;
provoke: [x] v. 激怒;对.挑衅;引起; [acc] /prəˈvoʊk/; [or]sat;
offensive: [x] adj. 冒犯的,进攻的,无礼的,令人不快的,得罪人的;  n. 进攻; [acc] /əˈfensɪv/; [or]sat;
gourmet: [x] n. 美食家,讲究吃喝的人;  adj. 菜肴精美的; [acc] /ˈɡʊrmeɪ/; [or]sat;
ornithology: [x] n. 鸟类学;鸟学论文; [acc] /ˌɔːrnɪˈθɑːlədʒi/; [or]sat;
evince: [x] v. 表明,表示,引起; [acc] /ɪˈvɪns/; [or]sat;
rudimentary: [x] adj. 基本的,初期的;发育不完全的;退化的; [acc] /ˌruːdɪˈmentri/; [or]sat;
Utopia: [x] n. 乌托邦(理想中最美好的社会),理想国; [acc] /juːˈtoʊpiə/; [or]sat;
glossy: [x] adj. 光泽的,光滑的; [acc] /ˈɡlɑːsi/; [or]sat;
caulk: [x] v. 填隙使不渗水,捻缝,凿密;  n. 捻缝材料,填料; [acc] /kɔːk/; [or]sat;
chronic: [x] adj. (疾病)慢性的;长期的;(人)久病的;积习难改的;严重的; [acc] /ˈkrɑːnɪk/; [or]sat;
finicky: [x] adj. 苛求的,过份讲究的; [acc] /ˈfɪnɪki/; [or]sat;
torpor: [x] n. 麻木;无感觉;不活泼; [acc] /ˈtɔːrpər/; [or]sat;
accolade: [x] n. 同意,赞赏;  v. 赞扬; [acc] /ˈækəleɪd/; [or]sat;
archaeology: [x] n. 考古学; [acc] /ˌɑːrkiˈɑːlədʒi/; [or]sat;
dogged: [x] adj. 顽强的;顽固的;  vt. 跟踪;尾随; [acc] /ˈdɔːɡɪd/; [or]sat;
implement: [x] n. 工具;器具;  v. 实施,执行;执行; [acc] /ˈɪmplɪment/; [or]sat;
riveting: [x] adj. 非常精彩的;  n. 铆接(法; [acc] /ˈrɪvɪtɪŋ/; [or]sat;
grate: [x] n. 壁炉;格栅;  v. 磨碎,使人烦燥; [acc] /ɡreɪt/; [or]sat;
obstinate: [x] adj. 顽固的;较难治愈的; [acc] /ˈɑːbstɪnət/; [or]sat;
franchise: [x] n. 特许(经营权),公民权,选举权;  v. 赋予特权,赋予公民权; [acc] /ˈfræntʃaɪz/; [or]sat;
flora: [x] n. 植物群; [acc] /ˈflɔːrə/; [or]sat;
perjury: [x] n. 伪证,假誓; [acc] /ˈpɜːrdʒəri/; [or]sat;
rancor: [x] n. 深仇,怨恨; [acc] /ˈræŋkər/; [or]sat;
marital: [x] adj. 婚姻的; [acc] /ˈmærɪtl/; [or]sat;
toady: [x] n. 谄媚者,拍马屁的人;  v. 谄媚,拍马屁; [acc] /ˈtoʊdi/; [or]sat;
chafe: [x] v. 擦破;擦热;擦痛;激怒;  n. 急躁;摩擦,擦伤;(防止擦伤马的)马鞍环套皮; [acc] /tʃeɪf/; [or]sat;
excise: [x] v. 切除,删去;  n. 消费税,货物税,国产税; [acc] /ˈeksaɪz/; [or]sat;
admonish: [x] v. 训诫,警告; [acc] /ədˈmɑːnɪʃ/; [or]sat;
beneficiary: [x] n. [金融]受益人,受惠者;封臣;  adj. 拥有封地的;受圣俸的; [acc] /ˌbenɪˈfɪʃieri/; [or]sat;
prodigal: [x] adj. 挥霍的,十分慷慨的;  n. 浪子,挥霍者; [acc] /ˈprɑːdɪɡl/; [or]sat;
accretion: [x] n. 自然的增加,增加物; [acc] /əˈkriːʃn/; [or]sat;
quagmire: [x] n. 沼泽地,困境; [acc] /ˈkwæɡmaɪər/; [or]sat;
endemic: [x] adj. 地方性的;  n. 地方病; [acc] /enˈdemɪk/; [or]sat;
rostrum: [x] n. 讲坛,讲台; [acc] /ˈrɑːstrəm/; [or]sat;
commensurate: [x] adj. 相称的,相应的;同量的;同样大小的; [acc] /kəˈmenʃərət/; [or]sat;
agitate: [x] v. (尤指为法律,社会状况的改变而)激烈争论,鼓动,煽动;搅动(液体);激怒; [acc] /ˈædʒɪteɪt/; [or]sat;
prestige: [x] n. 威望,声望; [acc] /preˈstiːʒ/; [or]sat;
draconian: [x] adj. 严峻的,苛刻的; [acc] /drəˈkoʊniən/; [or]sat;
inclined: [x] adj. 倾向..的,有..意向的;斜着的; [acc] /ɪnˈklaɪnd/; [or]sat;
deciduous: [x] adj. 落叶性的,脱落性的;非永久性的; [acc] /dɪˈsɪdʒuəs/; [or]sat;
deface: [x] v. 损伤外观,丑化; [acc] /dɪˈfeɪs/; [or]sat;
aperture: [x] n. 孔,穴;(照相机,望远镜等的)光圈,孔径;缝隙; [acc] /ˈæpərtʃər/; [or]sat;
appellation: [x] n. 称呼,名称,名目; [acc] /ˌæpəˈleɪʃn/; [or]sat;
convoke: [x] v. 召集会议; [acc] /kənˈvoʊk/; [or]sat;
cavil: [x] v. 吹毛求疵,挑剔,无端指摘;挑毛病,无端抱怨;  n. 吹毛求疵,苛责,无端的指责; [acc] /ˈkævl/; [or]sat;
unprecedented: [x] adj. 前所未有的,空前的,无前例的; [acc] /ʌnˈpresɪdentɪd/; [or]sat;
replicate: [x] v. 复制;重复,反复; [acc] /ˈreplɪkeɪt/; [or]sat;
satire: [x] n. 讽刺(作品); [acc] /ˈsætaɪər/; [or]sat;
misapprehension: [x] n. 错误的理解,错误的判断; [acc] /ˌmɪsæprɪˈhenʃn/; [or]sat;
emollient: [x] n. 润肤剂; [acc] /iˈmɑːliənt/; [or]sat;
caricature: [x] n. 讽刺画,滑稽模仿;扭曲,夸张的描述; [acc] /ˈkærɪkətʃər/; [or]sat;
approbation: [x] n. 称赞,认可;批准; [acc] /ˌæprəˈbeɪʃn/; [or]sat;
random: [x] adj. 随机的;任意的;胡乱的; [acc] /ˈrændəm/; [or]sat;
miserly: [x] adj. 贪财的,吝啬的; [acc] /ˈmaɪzərli/; [or]sat;
subsidiary: [x] adj. 辅助的,次要的,附属的;  n. 子公司,附属机构; [acc] /səbˈsɪdieri/; [or]sat;
trinket: [x] n. 小装饰品,不值钱的珠宝; [acc] /ˈtrɪŋkɪt/; [or]sat;
irreparable: [x] adj. 不能修复的;不可弥补的; [acc] /ɪˈrepərəbl/; [or]sat;
unbridled: [x] adj. 无拘束的;激烈的;放纵的;放纵的,无约束的; [acc] /ʌnˈbraɪdld/; [or]sat;
wrench: [x] n. 扳手;痛苦,难受;猛扭,猛拉;  v. 猛拧;挣脱;使扭伤; [acc] /rentʃ/; [or]sat;
intimate: [x] adj. 亲密的,密切的;详细的;  v. 暗示;宣布,通知;  n. 密友,知己; [acc] /ˈɪntɪmət/; [or]sat;
nauseate: [x] v. 使作呕,产生恶感; [acc] /ˈnɔːzieɪt/; [or]sat;
retain: [x] v. 保持,保留,保存;聘请; [acc] /rɪˈteɪn/; [or]sat;
dehydrate: [x] v. 除去水份,脱水; [acc] /diːˈhaɪdreɪt/; [or]sat;
lap: [x] n. 腰以下及大腿的前面部分;(跑道的)一圈;  v. (赛跑中)比(某人)领先一圈;轻拍; [acc] /læp/; [or]sat;
anoint: [x] v. 神圣化; [acc] /əˈnɔɪnt/; [or]sat;
patriarch: [x] n. 家长;族长;创办人;最年长者; [acc] /ˈpeɪtriɑːrk/; [or]sat;
detergent: [x] n. 洗涤剂,清洁剂; [acc] /dɪˈtɜːrdʒənt/; [or]sat;
levity: [x] n. 轻率,轻浮,多变,不稳定; [acc] /ˈlevəti/; [or]sat;
unwieldy: [x] adj. 使用不便的,不灵巧的,难处理的;笨重的; [acc] /ʌnˈwiːldi/; [or]sat;
libretto: [x] n. 歌词,歌剧剧本,剧本,歌词集; [acc] /lɪˈbretoʊ/; [or]sat;
adherent: [x] n. 拥护者;党徒;提倡者; [acc] /ədˈhɪrənt/; [or]sat;
petrify: [x] v. 石化,使僵化,使惊呆; [acc] /ˈpetrɪfaɪ/; [or]sat;
polygamist: [x] n. 多配偶的人;多配偶论者; [acc] /pəˈlɪɡəmɪst/; [or]sat;
dissident: [x] n. 唱反调者;持不同政见者,意见不同的人;  adj. 持不同政见的,意见不同的; [acc] /ˈdɪsɪdənt/; [or]sat;
renounce: [x] vt. 宣布放弃,与...断绝关系;抛弃;  vi. 垫牌;  n. 垫牌; [acc] /rɪˈnaʊns/; [or]sat;
querulous: [x] adj. 抱怨的,挑剔的; [acc] /ˈkwerələs/; [or]sat;
sententious: [x] adj. 好说教的,简要的,警句的; [acc] /senˈtenʃəs/; [or]sat;
imbibe: [x] v. 喝,饮;吸收,接受; [acc] /ɪmˈbaɪb/; [or]sat;
acme: [x] n. 顶点,极点; [acc] /ˈækmi/; [or]sat;
increment: [x] n. 增长;增值; [acc] /ˈɪŋkrəmənt/; [or]sat;
revile: [x] v. 辱骂,诽谤,批判; [acc] /rɪˈvaɪl/; [or]sat;
respite: [x] n. 缓解;暂缓;暂时的休息;缓期执行;  v. 使缓解;使暂缓;使延期;缓期执行; [acc] /ˈrespɪt/; [or]sat;
inimical: [x] adj. 敌意的,有害的; [acc] /ɪˈnɪmɪkl/; [or]sat;
atrocity: [x] n. 残暴,暴行; [acc] /əˈtrɑːsəti/; [or]sat;
pillage: [x] n. 掠夺;掠夺物;  vt. 掠夺,抢劫; [acc] /ˈpɪlɪdʒ/; [or]sat;
mite: [x] n. 极小量,小虫; [acc] /maɪt/; [or]sat;
puerile: [x] adj. 幼稚的,孩子气的; [acc] /ˈpjʊrəl/; [or]sat;
ramshackle: [x] adj. 摇摇欲坠的; [acc] /ˈræmʃækl/; [or]sat;
vortex: [x] n. 旋涡,气旋;涡流; [acc] /ˈvɔːrteks/; [or]sat;
boundless: [x] adj. 无限的;无边无际的; [acc] /ˈbaʊndləs/; [or]sat;
outlandish: [x] adj. 稀奇古怪的,奇特的;异国风情的; [acc] /aʊtˈlændɪʃ/; [or]sat;
orthodox: [x] adj. 正统的;传统的;(Orthodox)东正教的; [acc] /ˈɔːrθədɑːks/; [or]sat;
fledgling: [x] n. 刚学飞的幼鸟,无经验的人;  adj. 刚开始的;无经验的; [acc] /ˈfledʒlɪŋ/; [or]sat;
subterfuge: [x] n. 托词,借口,诡计; [acc] /ˈsʌbtərfjuːdʒ/; [or]sat;
shambles: [x] n. 混乱,废墟,屠宰场;  v. 蹒跚而行,拖着脚走,踉跄地走; [acc] /ˈʃæmblz/; [or]sat;
dappled: [x] adj. 有斑点的,斑驳的; [acc] /ˈdæpld/; [or]sat;
recumbent: [x] adj. 斜倚的;休息的;  n. 〈口〉座位斜靠式自行车; [acc] /rɪˈkʌmbənt/; [or]sat;
aviary: [x] n. 鸟类饲养场,大型鸟舍; [acc] /ˈeɪvieri/; [or]sat;
conception: [x] n. 怀孕,构想,设想,思想,观念; [acc] /kənˈsepʃn/; [or]sat;
presentiment: [x] n. 不祥的预感; [acc] /prɪˈzentɪmənt/; [or]sat;
shackle: [x] n. 枷锁,羁绊(物);  v. 给..上手铐(脚镣),用钩链连结,束缚; [acc] /ˈʃækl/; [or]sat;
pejorative: [x] n. 轻蔑语;  adj. 带有轻蔑意义的,贬低的; [acc] /pɪˈdʒɔːrətɪv/; [or]sat;
compensatory: [x] adj. 补偿的,赔偿的; [acc] /kəmˈpensətɔːri/; [or]sat;
nondescript: [x] adj. 没有特征的,难以形容的,难以归类的;  n. 难以名状,不属任何型类的人; [acc] /ˈnɑːndɪskrɪpt/; [or]sat;
stigma: [x] n. [植]柱头,耻辱,污名,烙印,特征; [acc] /ˈstɪɡmə/; [or]sat;
theoretical: [x] adj. 理论(上)的; [acc] /ˌθiːəˈretɪkl/; [or]sat;
unkempt: [x] adj. (衣服,头发)不整洁的;蓬乱的; [acc] /ˌʌnˈkempt/; [or]sat;
prompt: [x] v. 提示;激起;促进,推动;敦促;  adj. 迅速的,及时的;  n. 提示; [acc] /prɑːmpt/; [or]sat;
stanza: [x] n. 诗节; [acc] /ˈstænzə/; [or]sat;
surly: [x] adj. 乖戾的;无礼的;阴沉的; [acc] /ˈsɜːrli/; [or]sat;
pandemic: [x] adj. 全国流行的;普遍的; [acc] /pænˈdemɪk/; [or]sat;
mandate: [x] n. 授权;命令,指令;委托管理;受命进行的工作;  v. 授权;托管; [acc] /ˈmændeɪt/; [or]sat;
alcove: [x] n. 凹室,壁龛; [acc] /ˈælkoʊv/; [or]sat;
perennial: [x] adj. 终年的,永久的;四季不断的;反复的;  n. 多年生植物; [acc] /pəˈreniəl/; [or]sat;
skeptic: [x] n. 怀疑论者;怀疑者;无神论者; [acc] /ˈskeptɪk/; [or]sat;
pedestrian: [x] n. 步行者,行人;  adj. 步行的;平庸无奇的,无聊的; [acc] /pəˈdestriən/; [or]sat;
deterrent: [x] n. 威慑物;  v. 威慑的; [acc] /dɪˈtɜːrənt/; [or]sat;
fracas: [x] n. 喧嚷,吵闹,争论,论战; [acc] /ˈfreɪkəs/; [or]sat;
extent: [x] n. 范围;程度;宽度;长度; [acc] /ɪkˈstent/; [or]sat;
detonation: [x] n. 爆炸;爆炸声;爆发; [acc] /ˌdetəˈneɪʃn/; [or]sat;
transition: [x] n. 转变,过渡时期;  v. (从某一状态或活动)转变,过渡(到另一状态或活动); [acc] /trænˈzɪʃn/; [or]sat;
dossier: [x] n. 档案,卷宗;病历表册; [acc] /ˈdɔːsieɪ/; [or]sat;
hoax: [x] n. 骗局;恶作剧;  vt. 愚弄;欺骗; [acc] /hoʊks/; [or]sat;
oblique: [x] adj. 斜的,非直角的,隐射的;  v. 倾斜;  n. [解]斜肌(尤指腹部的肌肉);倾斜物;[军]倾斜航空照片;  adv. [军]以45度角; [acc] /əˈbliːk/; [or]sat;
virtuoso: [x] n. 艺术品鉴赏家,古董收藏家,艺术大师;  adj. 行家里手的,艺术爱好者的; [acc] /ˌvɜːrtʃuˈoʊsoʊ/; [or]sat;
autopsy: [x] n. 验尸;[病理][特医]剖检; [acc] /ˈɔːtɑːpsi/; [or]sat;
impermeable: [x] adj. 不渗透的;(水等)不能渗透的; [acc] /ɪmˈpɜːrmiəbl/; [or]sat;
stifle: [x] v. 抑制,压制,使窒息; [acc] /ˈstaɪfl/; [or]sat;
belie: [x] vt. 与.不符;矛盾,误解; [acc] /bɪˈlaɪ/; [or]sat;
aghast: [x] adj. 惊骇的,吓呆的; [acc] /əˈɡæst/; [or]sat;
quail: [x] n. 鹌鹑;  v. 畏缩;感到恐惧; [acc] /kweɪl/; [or]sat;
thespian: [x] adj. 悲剧的;戏剧的;  n. 演员;悲剧演员; [acc] /ˈθespiən/; [or]sat;
promiscuous: [x] adj. 滥交的,杂乱的,混杂的; [acc] /prəˈmɪskjuəs/; [or]sat;
burnish: [x] v. 擦亮,磨光; [acc] /ˈbɜːrnɪʃ/; [or]sat;
windfall: [x] n. 风吹落果;意外的收获,意外幸运; [acc] /ˈwɪndfɔːl/; [or]sat;
sojourn: [x] n. 逗留,旅居;  vi. 逗留,旅居; [acc] /ˈsoʊdʒɜːrn/; [or]sat;
bucolic: [x] adj. 乡村的;牧羊的; [acc] /bjuːˈkɑːlɪk/; [or]sat;
facade: [x] n. 建筑物的正面,外表; [acc] /fəˈsɑːd/; [or]sat;
pittance: [x] n. 微薄的收入,小额津贴,少量; [acc] /ˈpɪtns/; [or]sat;
withdrawn: [x] adj. 孤独的,孤僻的,内向的,离群的,沉默寡言的; [acc] /wɪðˈdrɔːn/; [or]sat;
diversion: [x] n. 绕行路;转移,改变方向;分心,消遣;分水渠; [acc] /daɪˈvɜːrʒn/; [or]sat;
industrious: [x] adj. 勤劳的,勤奋的; [acc] /ɪnˈdʌstriəs/; [or]sat;
odious: [x] adj. 可憎的,讨厌的;  adv. 令人作呕地;  n. 可憎,讨厌; [acc] /ˈoʊdiəs/; [or]sat;
horde: [x] n. 一大群,群,游牧部落;  v. 成群;结成部落而居; [acc] /hɔːrd/; [or]sat;
ignominy: [x] n. 耻辱,不体面,丑行; [acc] /ˈɪɡnəmɪni/; [or]sat;
filibuster: [x] n. 冗长演说;  v. 拖延议事; [acc] /ˈfɪlɪbʌstər/; [or]sat;
impeach: [x] v. 指摘,弹劾; [acc] /ɪmˈpiːtʃ/; [or]sat;
vicissitude: [x] n. 变迁,沧桑,兴衰; [acc] /vɪˈsɪsɪtuːd/; [or]sat;
magnitude: [x] n. 巨大;震级;重要性;[数]量值; [acc] /ˈmæɡnɪtuːd/; [or]sat;
repellent: [x] adj. 令人厌恶的;  n. 消肿药,驱虫剂; [acc] /rɪˈpelənt/; [or]sat;
vie: [x] v. 竞争;使针锋相对;以..作较量; [acc] /vaɪ/; [or]sat;
substantiate: [x] v. 证实;使实体化; [acc] /səbˈstænʃieɪt/; [or]sat;
restive: [x] adj. 不耐烦的,焦躁不安的,倔强的; [acc] /ˈrestɪv/; [or]sat;
virulent: [x] adj. 剧毒的;恶性的;有恶意的; [acc] /ˈvɪrələnt/; [or]sat;
peerless: [x] adj. 无与伦比的;无可匹敌的; [acc] /ˈpɪrləs/; [or]sat;
venal: [x] adj. 唯利是图的;贪赃枉法; [acc] /ˈviːnl/; [or]sat;
indentation: [x] n. 空格,缩进;呈锯齿形;海岸线凹入处; [acc] /ˌɪndenˈteɪʃn/; [or]sat;
prate: [x] v. 大谈特谈,唠叨;  n. 唠叨,多嘴,无聊话; [acc] /preɪt/; [or]sat;
genealogy: [x] n. 宗谱,血统,家系,系谱学; [acc] /ˌdʒiːniˈælədʒi/; [or]sat;
subsistence: [x] n. 存在,生存;生活;  adj. 收成仅够自身口粮的; [acc] /səbˈsɪstəns/; [or]sat;
orator: [x] n. 演说者,演讲者,雄辩家,原告; [acc] /ˈɔːrətər/; [or]sat;
atlas: [x] n. 地图集; [acc] /ˈætləs/; [or]sat;
categorical: [x] adj. 绝对的;直接了当的;无条件的;属于某一范畴的; [acc] /ˌkætəˈɡɔːrɪkl/; [or]sat;
ascribe: [x] v. 把.归因于;把.归属于; [acc] /əˈskraɪb/; [or]sat;
avuncular: [x] adj. 伯父的;叔伯的;慈祥的; [acc] /əˈvʌŋkjələr/; [or]sat;
finesse: [x] n. 技巧,计谋,策略;  v. 以技巧取胜; [acc] /fɪˈnes/; [or]sat;
shear: [x] vt. 剪羊毛;剪头发;  n. (复数)大剪刀; [acc] /ʃɪr/; [or]sat;
subjugate: [x] v. 征服,使服从; [acc] /ˈsʌbdʒuɡeɪt/; [or]sat;
amend: [x] v. 改进;修订;修正; [acc] /əˈmend/; [or]sat;
volatile: [x] adj. 易气化的;爆炸性的;反复无常的;短暂的;不稳定的; [acc] /ˈvɑːlətl/; [or]sat;
garrulous: [x] adj. 唠叨的,喋喋不休的;聒噪的; [acc] /ˈɡærələs/; [or]sat;
temper: [x] n. 脾气,性情;调和剂;  v. 锻炼,缓和; [acc] /ˈtempər/; [or]sat;
eloquence: [x] n. 雄辩,口才;文采; [acc] /ˈeləkwəns/; [or]sat;
auditory: [x] adj. 听觉的; [acc] /ˈɔːdətɔːri/; [or]sat;
bogus: [x] adj. 假的,假装的;  n. 伪币;冒牌货; [acc] /ˈboʊɡəs/; [or]sat;
malaise: [x] n. 不舒服;心神不安; [acc] /məˈleɪz/; [or]sat;
magnanimous: [x] adj. 宽宏大量的,大度的;慷慨的; [acc] /mæɡˈnænɪməs/; [or]sat;
inchoate: [x] adj. 早期的;刚开始的;未充分发展的; [acc] /ɪnˈkoʊət/; [or]sat;
adamant: [x] adj. 强硬的,固执的;  n. 坚硬的东西;坚石; [acc] /ˈædəmənt/; [or]sat;
voluble: [x] adj. 健谈的,缠绕的,易旋转的; [acc] /ˈvɑːljəbl/; [or]sat;
relinquish: [x] v. 放弃,让出(权利,财产等),撤回; [acc] /rɪˈlɪŋkwɪʃ/; [or]sat;
zenith: [x] n. 顶点,顶峰;全盛; [acc] /ˈziːnɪθ/; [or]sat;
abdicate: [x] adj. 放弃权力的;退位的;  n. 放弃权力者;退位者;  vi. 退位,辞职;  vt. 辞;放弃; [acc] /ˈæbdɪkeɪt/; [or]sat;
temperate: [x] adj. 温和的;适度的,有节制的; [acc] /ˈtempərət/; [or]sat;
panoramic: [x] adj. 全景的; [acc] /ˌpænəˈræmɪk/; [or]sat;
multilingual: [x] n. 懂多种语言的人;  adj. 使用多种语言的,懂几国文字的; [acc] /ˌmʌltiˈlɪŋɡwəl/; [or]sat;
aloof: [x] adj. 远离的;冷漠的,冷淡的;  adv. 远离,避开; [acc] /əˈluːf/; [or]sat;
anonymity: [x] n. 匿名,作者不明(或不详),无名之辈; [acc] /ˌænəˈnɪməti/; [or]sat;
addle: [x] v. 使腐坏,使昏乱;  adj. 腐坏的;糊涂的,昏乱的; [acc] /ˈædl/; [or]sat;
transparent: [x] adj. 透明的,清澈的,明净的;易识破的,显而易见的; [acc] /trænsˈpærənt/; [or]sat;
accessible: [x] adj. 可使用的;可到达的;可进入的;易懂的; [acc] /əkˈsesəbl/; [or]sat;
sardonic: [x] adj. 讽刺的,嘲笑的; [acc] /sɑːrˈdɑːnɪk/; [or]sat;
venom: [x] n. 毒液;恶意;怨恨;  vt. 使有毒;放毒; [acc] /ˈvenəm/; [or]sat;
defer: [x] v. 使推迟,使延期;听从,顺从;  vi. 延期; [acc] /dɪˈfɜːr/; [or]sat;
foil: [x] n. 箔;锡箔纸;衬托;  v. 挫败;使受挫折; [acc] /fɔɪl/; [or]sat;
erode: [x] v. 腐蚀;遭侵蚀,腐蚀,侵蚀;削弱;  vt. 损害; [acc] /ɪˈroʊd/; [or]sat;
engross: [x] v. 独占;正式誊写;使全神贯注于;用大字体书写; [acc] /ɪnˈɡroʊs/; [or]sat;
transient: [x] adj. 短暂的,路过的;转瞬即逝的;  n. 过客; [acc] /ˈtrænʃnt/; [or]sat;
robust: [x] adj. 健壮的,强壮的;精力充沛的;坚固的;粗鲁的; [acc] /roʊˈbʌst/; [or]sat;
rift: [x] n. 裂缝,裂口; [acc] /rɪft/; [or]sat;
sham: [x] n. 假货;虚假;欺诈;  v. 假装;  adj. 虚假的,假装的; [acc] /ʃæm/; [or]sat;
oscillate: [x] v. 摆动,犹豫; [acc] /ˈɑːsɪleɪt/; [or]sat;
figment: [x] n. 空想;虚构的理论,故事等; [acc] /ˈfɪɡmənt/; [or]sat;
slake: [x] v. 解渴,消渴; [acc] /sleɪk/; [or]sat;
disconcert: [x] v. 使仓皇失措;使困惑;破坏; [acc] /ˌdɪskənˈsɜːrt/; [or]sat;
spatial: [x] adj. 空间的,关于空间的; [acc] /ˈspeɪʃl/; [or]sat;
extol: [x] v. 赞美,称赞,颂扬; [acc] /ɪkˈstoʊl/; [or]sat;
distend: [x] v. 膨胀;胀大;扩张; [acc] /dɪˈstend/; [or]sat;
mortician: [x] n. 丧事承办人; [acc] /mɔːrˈtɪʃn/; [or]sat;
virtual: [x] adj. (计算机)虚拟的;十分接近的;实质上的; [acc] /ˈvɜːrtʃuəl/; [or]sat;
intimacy: [x] n. 亲密,亲近;亲昵行为;<婉>性行为;[婉辞]私通; [acc] /ˈɪntɪməsi/; [or]sat;
monumental: [x] adj. 纪念碑的;不朽的;非常的; [acc] /ˌmɑːnjuˈmentl/; [or]sat;
sluggard: [x] n. 懒鬼;游手好闲的人; [acc] /ˈslʌɡərd/; [or]sat;
thermal: [x] adj. 保暖的;温泉的;热的;  n. 保暖内衣裤; [acc] /ˈθɜːrml/; [or]sat;
improvident: [x] adj. 浪费的,无远见的,无先见之明的; [acc] /ɪmˈprɑːvɪdənt/; [or]sat;
repast: [x] n. 宴;就餐;  vi. 就餐,设宴; [acc] /rɪˈpæst/; [or]sat;
dissuade: [x] v. 劝阻,阻止; [acc] /dɪˈsweɪd/; [or]sat;
ubiquitous: [x] adj. 普遍存在的;无所不在的; [acc] /juːˈbɪkwɪtəs/; [or]sat;
sibling: [x] n. 兄弟姊妹;同胞;(生物)同科,同属; [acc] /ˈsɪblɪŋ/; [or]sat;
clump: [x] n. 土块;  v. 丛生; [acc] /klʌmp/; [or]sat;
exasperate: [x] vt. 激怒;加剧; [acc] /ɪɡˈzæspəreɪt/; [or]sat;
predicament: [x] n. 困境,穷境,尴尬的处境; [acc] /prɪˈdɪkəmənt/; [or]sat;
pandemonium: [x] n. 地狱,混乱; [acc] /ˌpændəˈmoʊniəm/; [or]sat;
inalienable: [x] adj. 不可分割的; [acc] /ɪnˈeɪliənəbl/; [or]sat;
esteem: [x] n. 尊敬;尊重;  vt. 尊敬;认为;考虑;估计; [acc] /ɪˈstiːm/; [or]sat;
thrive: [x] v. 茁壮成长;繁荣,兴旺; [acc] /θraɪv/; [or]sat;
gaunt: [x] adj. 憔悴的,瘦削的;  n. 憔悴,荒凉; [acc] /ɡɔːnt/; [or]sat;
buoyant: [x] adj. 有浮力的;愉快的;(股市)保持高价的; [acc] /ˈbɔɪənt/; [or]sat;
hermetic: [x] adj. 密封的;与外界隔绝的;不透气的;炼金术的; [acc] /hɜːrˈmetɪk/; [or]sat;
Titanic: [x] adj. 巨人的,力大无比的;  n. 泰坦尼克号; [acc] /taɪˈtænɪk/; [or]sat;
analogy: [x] n. 比拟,比喻;类比;相似;类似; [acc] /əˈnælədʒi/; [or]sat;
ensconce: [x] v. 安置;安顿下来;使.隐藏; [acc] /ɪnˈskɑːns/; [or]sat;
rebuke: [x] v. 指责;  n. 谴责; [acc] /rɪˈbjuːk/; [or]sat;
expertise: [x] n. 专门知识,专门技能; [acc] /ˌekspɜːrˈtiːz/; [or]sat;
untenable: [x] adj. 防守不住的,站不住脚的; [acc] /ʌnˈtenəbl/; [or]sat;
obviate: [x] v. 排除,避免,消除; [acc] /ˈɑːbvieɪt/; [or]sat;
brochure: [x] n. 手册,小册子; [acc] /broʊˈʃʊr/; [or]sat;
mutinous: [x] adj. 加入叛变的,反抗的; [acc] /ˈmjuːtənəs/; [or]sat;
totter: [x] n. 蹒跚,踉跄;  vi. 蹒跚,踉跄,动摇,摇摇欲坠; [acc] /ˈtɑːtər/; [or]sat;
warble: [x] n. 鸟啭鸣,颤声;  v. 鸟鸣,用柔和的颤声唱; [acc] /ˈwɔːrbl/; [or]sat;
apocalyptic: [x] adj. 预示灾祸的,启示的; [acc] /əˌpɑːkəˈlɪptɪk/; [or]sat;
arid: [x] adj. (土地或气候)干燥的,干旱的,贫瘠的,荒芜的;无创见的,无新意的; [acc] /ˈærɪd/; [or]sat;
incipient: [x] adj. 初期的;刚出现的; [acc] /ɪnˈsɪpiənt/; [or]sat;
exhort: [x] vt. 敦促,劝告;  vi. 规劝,劝告; [acc] /ɪɡˈzɔːrt/; [or]sat;
infuriate: [x] v. 使(人)极为愤怒; [acc] /ɪnˈfjʊrieɪt/; [or]sat;
veer: [x] n. 方向的转变;  v. 转向,改变(话题等),放松(绳,缆等); [acc] /vɪr/; [or]sat;
regimen: [x] n. 养生法,生活规则; [acc] /ˈredʒɪmən/; [or]sat;
informal: [x] adj. 非正式的;不拘礼节的;通俗的; [acc] /ɪnˈfɔːrml/; [or]sat;
caustic: [x] adj. 腐蚀性的;苛性的;刻薄的;焦散的;  n. 腐蚀剂;苛性钠;焦散曲线; [acc] /ˈkɔːstɪk/; [or]sat;
prerogative: [x] n. 权利;特权; [acc] /prɪˈrɑːɡətɪv/; [or]sat;
furor: [x] n. 狂热;激怒;喧闹;感动; [acc] /ˈfjʊˌrɔr/; [or]sat;
monastic: [x] n. 僧侣;  adj. 修道院的,寺院的;僧侣的;克己的; [acc] /məˈnæstɪk/; [or]sat;
minuscule: [x] adj. 极小的,微型的; [acc] /ˈmɪnəskjuːl/; [or]sat;
distill: [x] v. 抽出..的精华;蒸馏; [acc] /dɪˈstɪl/; [or]sat;
dross: [x] n. 废料,浮渣,渣滓;  vt. 除去.上的浮渣; [acc] /drɔːs/; [or]sat;
plasticity: [x] n. 可塑性;适应性;柔软性; [acc] /plæˈstɪsəti/; [or]sat;
defile: [x] v. 污损,弄脏;以纵队前进;  n. 狭谷;隘路; [acc] /dɪˈfaɪl/; [or]sat;
partisan: [x] adj. 党派的;效忠的;偏袒的;盲目推崇的;  n. 党羽;虔诚信徒;游击队; [acc] /ˈpɑːrtəzn/; [or]sat;
arousal: [x] n. 觉醒,激励,唤起; [acc] /əˈraʊzl/; [or]sat;
inert: [x] adj. 不动的,惰性的;行动迟钝的;无生气的; [acc] /ɪˈnɜːrt/; [or]sat;
optimum: [x] adj. 最适宜的;最佳的;  n. 最适条件;最适宜; [acc] /ˈɑːptɪməm/; [or]sat;
tome: [x] n. 册,卷,本,大本书; [acc] /toʊm/; [or]sat;
bacchanalian: [x] adj. 狂欢的,行为放纵的; [acc] /ˌbækəˈneɪliən/; [or]sat;
heed: [x] vt. 注意;留心;  v. 注意;  vi. 留心;  n. 注意;留心; [acc] /hiːd/; [or]sat;
wan: [x] adj. 虚弱的,病态的; [acc] /wɑːn/; [or]sat;
disengage: [x] v. 分开; [acc] /ˌdɪsɪnˈɡeɪdʒ/; [or]sat;
assiduous: [x] adj. 勤勉的,刻苦的; [acc] /əˈsɪdʒuəs/; [or]sat;
plagiarize: [x] v. 剽窃,抄袭(别人学说,著作); [acc] /ˈpleɪdʒəraɪz/; [or]sat;
polarize: [x] v. (使)极化,(使)偏振,(使)两极分化; [acc] /ˈpoʊləraɪz/; [or]sat;
wean: [x] v. 断奶,戒掉(off/from),(从早年开始)使用;  n. 〈英〉婴儿;小儿; [acc] /wiːn/; [or]sat;
perquisite: [x] n. 固定津贴,福利; [acc] /ˈpɜːrkwɪzɪt/; [or]sat;
ghastly: [x] adj. 苍白的,可怕的,令人不快的;  adv. 恐怖地,惨白地; [acc] /ˈɡæstli/; [or]sat;
pellucid: [x] adj. 透明的,清晰的,明了的; [acc] /pəˈluːsɪd/; [or]sat;
concise: [x] adj. 简明的,简要的;简洁的,简要的; [acc] /kənˈsaɪs/; [or]sat;
novice: [x] n. 生手,新手; [acc] /ˈnɑːvɪs/; [or]sat;
jaunt: [x] v. 远足;做短程游览;  n. 短途游览; [acc] /dʒɔːnt/; [or]sat;
variegated: [x] n. 使富有变化,使成为杂色;  adj. 斑驳的,多色的,富于变化的; [acc] /ˈverɪɡeɪtɪd/; [or]sat;
epoch: [x] n. 时期;新时代; [acc] /ˈepək/; [or]sat;
cynical: [x] adj. 愤世嫉俗的;恶意的;悲观的; [acc] /ˈsɪnɪkl/; [or]sat;
attenuate: [x] v. 变薄,变弱,变纤细;  adj. 稀薄的;细小的;减弱的;减少的; [acc] /əˈtenjueɪt/; [or]sat;
plummet: [x] v. 垂直或突然地堕下,骤然下降;  n. 测锤(钓丝的)坠子;线锤;铅锤线;锤规; [acc] /ˈplʌmɪt/; [or]sat;
levitate: [x] v. (使)轻轻浮起,(使)飘浮空中; [acc] /ˈlevɪteɪt/; [or]sat;
vogue: [x] n. 时髦,时尚;  adj. 流行的; [acc] /voʊɡ/; [or]sat;
incandescent: [x] adj. 白热的,热烈的; [acc] /ˌɪnkænˈdesnt/; [or]sat;
glutton: [x] n. 贪吃者,对..贪婪的人; [acc] /ˈɡlʌtn/; [or]sat;
gravity: [x] n. 重力,引力;严重性;庄重,严肃; [acc] /ˈɡrævəti/; [or]sat;
unravel: [x] v. 解开;拆开;阐明;解释; [acc] /ʌnˈrævl/; [or]sat;
renege: [x] v. 食言,否认; [acc] /rɪˈniːɡ/; [or]sat;
solicitous: [x] adj. 热切期望的;热心的;挂念的; [acc] /səˈlɪsɪtəs/; [or]sat;
cavalier: [x] n. 骑士,武士;  adj. 满不在乎的,无忧无虑的,漫不经心的,目中无人的; [acc] /ˌkævəˈlɪr/; [or]sat;
mettle: [x] n. 勇气,毅力,耐力; [acc] /ˈmetl/; [or]sat;
disdain: [x] n. 蔑视,鄙视;  vt. 鄙视;不屑; [acc] /dɪsˈdeɪn/; [or]sat;
tycoon: [x] n. 有钱有势的企业家,大亨; [acc] /taɪˈkuːn/; [or]sat;
discordant: [x] adj. 不和谐的,刺耳的,不一致的; [acc] /dɪsˈkɔːrdənt/; [or]sat;
unrequited: [x] adj. 无回报的;无报酬的; [acc] /ˌʌnrɪˈkwaɪtɪd/; [or]sat;
ordination: [x] n. 神职授任; [acc] /ˌɔːrdnˈeɪʃn/; [or]sat;
venial: [x] adj. 可原谅的,(罪过)轻微的,可宽恕的; [acc] /ˈviːniəl/; [or]sat;
erroneous: [x] adj. 错误的; [acc] /ɪˈroʊniəs/; [or]sat;
avid: [x] adj. 渴望的,贪婪的;热心的; [acc] /ˈævɪd/; [or]sat;
palpitate: [x] v. (心脏)悸动,发抖; [acc] /ˈpælpɪteɪt/; [or]sat;
reiterate: [x] vt. 反复讲,重申,反复做; [acc] /riˈɪtəreɪt/; [or]sat;
omnipresent: [x] adj. 无所不在的; [acc] /ˌɑːmnɪˈpreznt/; [or]sat;
commiserate: [x] v. 同情,怜悯; [acc] /kəˈmɪzəreɪt/; [or]sat;
woe: [x] n. 悲哀;痛苦;  int. 唉(表示痛苦,悲伤或悔恨);咳; [acc] /woʊ/; [or]sat;
behemoth: [x] n. 怪物;怪兽; [acc] /bɪˈhiːmɔːθ/; [or]sat;
intermittent: [x] adj. 断断续续的,间歇的; [acc] /ˌɪntərˈmɪtənt/; [or]sat;
extrude: [x] v. 挤压出;伸出;逐出; [acc] /ɪkˈstruːd/; [or]sat;
sleight: [x] n. 巧妙手法,巧计,灵巧; [acc] /slaɪt/; [or]sat;
susceptible: [x] adj. 易受感染的;易受影响的;多情的; [acc] /səˈseptəbl/; [or]sat;
amble: [x] v. 漫步,缓行;  n. 缓行,漫步; [acc] /ˈæmbl/; [or]sat;
whet: [x] v. 刺激;磨快;促进;  n. 磨;开胃物;刺激物; [acc] /wet/; [or]sat;
forswear: [x] v. 誓绝,放弃; [acc] /fɔːrˈswer/; [or]sat;
disquiet: [x] n. 担心,焦虑;  v. 使不安,使忧虑; [acc] /dɪsˈkwaɪət/; [or]sat;
voluptuous: [x] adj. 撩人的,沉溺酒色的,骄奢淫逸的; [acc] /vəˈlʌptʃuəs/; [or]sat;
amenable: [x] adj. 愿意的,顺从的,服从的;经得起检验的; [acc] /əˈmiːnəbl/; [or]sat;
chastise: [x] v. 严厉惩罚,遣责; [acc] /tʃæˈstaɪz/; [or]sat;
fret: [x] v. 使烦恼,使焦急;使腐蚀;使磨损;  n. (斑卓琴,吉他,曼陀林琴等弦乐器指板上定音的)档;侵蚀; [acc] /fret/; [or]sat;
agrarian: [x] adj. 耕地的; [acc] /əˈɡreriən/; [or]sat;
fulcrum: [x] n. [机]支点,(植)叶附属物; [acc] /ˈfʊlkrəm/; [or]sat;
auxiliary: [x] adj. 备用的,辅助的,协助的; [acc] /ɔːɡˈzɪliəri/; [or]sat;
lithe: [x] adj. 轻盈的(等于lithesome);柔软的;易弯曲的; [acc] /laɪð/; [or]sat;
alloy: [x] n. 合金;  v. 使成合金; [acc] /ˈælɔɪ/; [or]sat;
jeopardize: [x] v. 危及,损害(也作jeopardise); [acc] /ˈdʒepərdaɪz/; [or]sat;
imperious: [x] adj. 傲慢的,专横的; [acc] /ɪmˈpɪriəs/; [or]sat;
infinitesimal: [x] adj. 无穷小的,无限小的,极小的;  adv. 无限小地;  n. 无限小;极微量;极小量; [acc] /ˌɪnfɪnɪˈtesɪml/; [or]sat;
bilious: [x] adj. 多胆汁的,坏脾气的; [acc] /ˈbɪliəs/; [or]sat;
pitfall: [x] n. 陷阱,未料到的危险或困难; [acc] /ˈpɪtfɔːl/; [or]sat;
reconcile: [x] v. 和解;调解;调和; [acc] /ˈrekənsaɪl/; [or]sat;
eulogy: [x] n. 颂词,赞美词; [acc] /ˈjuːlədʒi/; [or]sat;
prurient: [x] adj. 好色的;淫乱的;渴望的; [acc] /ˈprʊriənt/; [or]sat;
betray: [x] v. 背叛;失信于;泄露(秘密等);(非故意地)暴露; [acc] /bɪˈtreɪ/; [or]sat;
phoenix: [x] n. 凤凰;死而复生的人; [acc] /ˈfiːnɪks/; [or]sat;
heyday: [x] n. 全盛期;  int. 嘿(表喜悦或惊奇等); [acc] /ˈheɪdeɪ/; [or]sat;
motley: [x] adj. 混杂的,杂色的;  n. 混杂;杂色衣服;小丑; [acc] /ˈmɑːtli/; [or]sat;
rapport: [x] n. 密切关系,交往;和谐一致;意见一致; [acc] /ræˈpɔːr/; [or]sat;
infirmity: [x] n. 虚弱; [acc] /ɪnˈfɜːrməti/; [or]sat;
lethal: [x] adj. 致命的,致死的;杀伤性的;  n. 致死因子; [acc] /ˈliːθl/; [or]sat;
despise: [x] vt. 轻视,蔑视,看不起; [acc] /dɪˈspaɪz/; [or]sat;
lustrous: [x] adj. 有光泽的;光辉的; [acc] /ˈlʌstrəs/; [or]sat;
beset: [x] v. 困扰;镶嵌;围绕; [acc] /bɪˈset/; [or]sat;
gnome: [x] n. 地下宝藏的守护神,土地神;格言;侏儒; [acc] /noʊm/; [or]sat;
modulate: [x] v. 调整(音调);变调;调节(使平衡); [acc] /ˈmɑːdʒəleɪt/; [or]sat;
abysmal: [x] adj. 极低的或极可怜的,(程度)很深的,极端的; [acc] /əˈbɪzməl/; [or]sat;
requisite: [x] n. 必需品;  adj. 需要的,必不可少的,必备的; [acc] /ˈrekwɪzɪt/; [or]sat;
doodle: [x] v. (无目的地)乱画,漫无目的地打发时光;  n. 涂鸦; [acc] /ˈduːdl/; [or]sat;
haphazard: [x] adj. 偶然的;随意的;凑合的;胡乱的; [acc] /hæpˈhæzərd/; [or]sat;
prune: [x] n. 梅干;  v. 修剪;削减; [acc] /pruːn/; [or]sat;
refurbish: [x] v. 刷新,再磨光; [acc] /ˌriːˈfɜːrbɪʃ/; [or]sat;
ponderous: [x] adj. 笨重的,笨拙的,沉闷的; [acc] /ˈpɑːndərəs/; [or]sat;
deliberate: [x] adj. 故意的;深思熟虑的;从容不迫的;  v. 仔细考虑;研讨; [acc] /dɪˈlɪbərət/; [or]sat;
Armada: [x] n. (西班牙的)无敌舰队; [acc] /ɑːrˈmɑːdə/; [or]sat;
gainsay: [x] v. 否认,否定,反驳;  n. 否认,反驳; [acc] /ˌɡeɪnˈseɪ/; [or]sat;
ephemeral: [x] adj. 短暂的,短命的;  n. 生存极短时间的事物; [acc] /ɪˈfemərəl/; [or]sat;
luster: [x] n. 光泽,光彩;  v. (使)有光泽;发亮; [acc] /ˈlʌstər/; [or]sat;
putrid: [x] adj. 腐臭的;讨人厌的; [acc] /ˈpjuːtrɪd/; [or]sat;
dissipate: [x] v. 消散,消失;浪费; [acc] /ˈdɪsɪpeɪt/; [or]sat;
cogent: [x] adj. 有说服力的; [acc] /ˈkoʊdʒənt/; [or]sat;
asteroid: [x] n. 小行星;  adj. 星状的; [acc] /ˈæstərɔɪd/; [or]sat;
alliteration: [x] n. 头韵; [acc] /əˌlɪtəˈreɪʃn/; [or]sat;
yoke: [x] n. 牛轭;枷锁;纽带;  v. 结合;连结; [acc] /joʊk/; [or]sat;
asunder: [x] adv. 分离;化为碎片; [acc] /əˈsʌndər/; [or]sat;
rend: [x] v. 撕碎;分裂;强夺; [acc] /rend/; [or]sat;
burgeon: [x] v. 发芽,迅速成长;  n. 嫩枝; [acc] /ˈbɜːrdʒən/; [or]sat;
tremor: [x] n. (小)地震;[医]震颤,战栗,发抖; [acc] /ˈtremər/; [or]sat;
ford: [x] v. 涉水,渡河;  n. 浅滩; [acc] /fɔːrd/; [or]sat;
mode: [x] n. 模式;方式; [acc] /moʊd/; [or]sat;
amiss: [x] adj. 有毛病的,有缺陷的;出差错的;  adv. 错误地; [acc] /əˈmɪs/; [or]sat;
allude: [x] v. 间接提到,暗指,暗示; [acc] /əˈluːd/; [or]sat;
fanfare: [x] n. 夸耀,嘹亮的喇叭声;  v. 热闹地介绍[宣布]; [acc] /ˈfænfer/; [or]sat;
muse: [x] v. 沉思;冥想;  n. [希神]缪斯女神,灵感; [acc] /mjuːz/; [or]sat;
assumption: [x] n. 假定,设想;采取;承担; [acc] /əˈsʌmpʃn/; [or]sat;
snivel: [x] v. 流鼻涕;啜泣; [acc] /ˈsnɪvl/; [or]sat;
waggish: [x] adj. 诙谐的,滑稽的; [acc] /ˈwæɡɪʃ/; [or]sat;
fortuitous: [x] adj. 偶然的;幸运的; [acc] /fɔːrˈtuːɪtəs/; [or]sat;
tumult: [x] n. 骚动;骚乱;吵闹;激动; [acc] /ˈtuːmʌlt/; [or]sat;
squalor: [x] n. 肮脏,邋遢,(道德品质等的)卑劣; [acc] /ˈskwɑːlər/; [or]sat;
quell: [x] v. 镇压,消除,减轻(激动,恐惧等);  n. 镇压,平息,减轻; [acc] /kwel/; [or]sat;
paucity: [x] n. 小量,缺乏; [acc] /ˈpɔːsəti/; [or]sat;
laggard: [x] adj. 缓慢的,落后的;  n. 落后者;迟钝者; [acc] /ˈlæɡərd/; [or]sat;
bestow: [x] v. 给予; [acc] /bɪˈstoʊ/; [or]sat;
gingerly: [x] adv. 小心翼翼地,慎重地;  adj. 小心翼翼的;兢兢业业的; [acc] /ˈdʒɪndʒərli/; [or]sat;
retrograde: [x] vi. 倒退,退步;  adj. 后退的,退步的,退化的;  vt. 使倒退; [acc] /ˈretrəɡreɪd/; [or]sat;
kindred: [x] n. 亲戚,家族,亲属关系,相似;  adj. 有血缘关系的,同宗的,同源的,类似的; [acc] /ˈkɪndrəd/; [or]sat;
allay: [x] v. 减轻;使缓和;使平静; [acc] /əˈleɪ/; [or]sat;
seminary: [x] n. 神学院,学校,发源地,高级中学; [acc] /ˈsemɪneri/; [or]sat;
tempo: [x] n. [音]节奏,拍子;行进速度; [acc] /ˈtempoʊ/; [or]sat;
doleful: [x] adj. 寂寞的;悲哀的;阴沉的; [acc] /ˈdoʊlfl/; [or]sat;
pallid: [x] adj. 苍白的,病态的,无生气的; [acc] /ˈpælɪd/; [or]sat;
reek: [x] v. 散发;冒烟;放出臭气;  n. 恶臭;水蒸汽;雾;烟; [acc] /riːk/; [or]sat;
grouse: [x] v. 埋怨;  n. 松鸡;雷鸟科的猎鸟;怨言; [acc] /ɡraʊs/; [or]sat;
arrears: [x] n. 债,欠债; [acc] /əˈrɪrz/; [or]sat;
recourse: [x] n. 求援(对象),求助(对象,[商][律]追索权; [acc] /ˈriːkɔːrs/; [or]sat;
acclivity: [x] n. 向上的陡坡; [acc] /ə'klɪvətɪ/; [or]sat;
complacency: [x] n. 自满,自鸣得意;满足; [acc] /kəmˈpleɪsnsi/; [or]sat;
omnipotent: [x] adj. 全能的,万能的;  n. 全能者; [acc] /ɑːmˈnɪpətənt/; [or]sat;
solace: [x] n. 慰藉,给予安慰的人或事物;  v. 安慰,缓和,使开心; [acc] /ˈsɑːləs/; [or]sat;
affix: [x] v. 粘上;署名;将罪责加之于;  n. 词缀;附加物; [acc] /əˈfɪks/; [or]sat;
bolster: [x] n. 枕垫;  v. 支持,鼓励,增强; [acc] /ˈboʊlstər/; [or]sat;
delete: [x] v. 删除; [acc] /dɪˈliːt/; [or]sat;
biased: [x] adj. 有偏见的,结果偏倚的,有偏的; [acc] /ˈbaɪəst/; [or]sat;
refractory: [x] adj. 难治的,难熔的,不听话的; [acc] /rɪˈfræktəri/; [or]sat;
resolution: [x] n. 决心,决定,解决,决议,分辨率; [acc] /ˌrezəˈluːʃn/; [or]sat;
admonition: [x] n. 告诫,劝告,警告; [acc] /ˌædməˈnɪʃn/; [or]sat;
concede: [x] v. 承认;承认失败;让给,让与;让步; [acc] /kənˈsiːd/; [or]sat;
demean: [x] v. 贬抑,降低; [acc] /dɪˈmiːn/; [or]sat;
illusory: [x] adj. 错觉的,幻影的,虚假的,产生幻觉的; [acc] /ɪˈluːsəri/; [or]sat;
loath: [x] adj. 不愿意的; [acc] /loʊθ/; [or]sat;
coincidence: [x] n. 一致;巧合,巧事;同时发生; [acc] /koʊˈɪnsɪdəns/; [or]sat;
laborious: [x] adj. 费时费力的,辛苦的;艰苦的; [acc] /ləˈbɔːriəs/; [or]sat;
fitful: [x] adj. 发作的,间歇的,不定的; [acc] /ˈfɪtfl/; [or]sat;
subversive: [x] n. 颠覆分子,破坏分子;  adj. 颠覆性的,破坏性的; [acc] /səbˈvɜːrsɪv/; [or]sat;
deprecate: [x] v. 反对;轻视; [acc] /ˈdeprəkeɪt/; [or]sat;
defiance: [x] n. 蔑视;反抗;挑战; [acc] /dɪˈfaɪəns/; [or]sat;
annotate: [x] v. 注释,评注;  n. 注释者; [acc] /ˈænəteɪt/; [or]sat;
cloister: [x] n. 修道院;  adj. 隐居的;躲开尘世纷争的; [acc] /ˈklɔɪstər/; [or]sat;
dissemble: [x] v. 掩饰;假装;隐藏,掩饰; [acc] /dɪˈsembl/; [or]sat;
cascade: [x] n. 层叠;小瀑布;喷流;  v. 像瀑布般冲下或倾泻; [acc] /kæˈskeɪd/; [or]sat;
autonomous: [x] adj. 自动驾驶的;自治的,独立自主的;自主的; [acc] /ɔːˈtɑːnəməs/; [or]sat;
postulate: [x] v. 假定.是真的;  n. 假定; [acc] /ˈpɑːstʃəleɪt/; [or]sat;
alienate: [x] v. 疏远;挑拨; [acc] /ˈeɪliəneɪt/; [or]sat;
hover: [x] v. (鸟,直升机)盘旋,翱翔;(人)逗留在附近,徘徊; [acc] /ˈhʌvər/; [or]sat;
relic: [x] n. 遗迹;神圣的遗物;纪念物; [acc] /ˈrelɪk/; [or]sat;
egregious: [x] adj. 非常恶劣的,过分的;恶名昭彰的;惊人的; [acc] /ɪˈɡriːdʒiəs/; [or]sat;
exacerbate: [x] v. 加重;恶化;激怒; [acc] /ɪɡˈzæsərbeɪt/; [or]sat;
humid: [x] adj. 潮湿的;湿润的;多湿气的; [acc] /ˈhjuːmɪd/; [or]sat;
superficial: [x] adj. 肤浅的;表面的;微不足道的;  n. 表面文章; [acc] /ˌsuːpərˈfɪʃl/; [or]sat;
parched: [x] adj. 干旱的,干渴的; [acc] /pɑːrtʃt/; [or]sat;
infidel: [x] n. 不信教者,异教徒; [acc] /ˈɪnfɪdəl/; [or]sat;
latitude: [x] n. 纬度;地区;(言论,行动的)自由; [acc] /ˈlætɪtuːd/; [or]sat;
obsolete: [x] adj. 已过时的;已废弃的;  v. 使过时;使作废;  n. 废词;被废弃的事物; [acc] /ˌɑːbsəˈliːt/; [or]sat;
escapade: [x] n. 越轨行为,恶作剧; [acc] /ˌeskəˈpeɪd/; [or]sat;
amphitheater: [x] n. 竞技场,圆形露天剧场,古罗马剧场; [acc] /ˈæmfɪˌθiətər/; [or]sat;
cede: [x] v. 放弃;割让(领土); [acc] /siːd/; [or]sat;
destitute: [x] adj. 贫穷的,缺乏的; [acc] /ˈdestɪtuːt/; [or]sat;
rhetoric: [x] n. 修辞学,浮夸的言语;雄辩术; [acc] /ˈretərɪk/; [or]sat;
misconception: [x] n. 误解;错误想法; [acc] /ˌmɪskənˈsepʃn/; [or]sat;
foreboding: [x] n. 预感,预兆;  adj. 预感的,不祥之兆的; [acc] /fɔːrˈboʊdɪŋ/; [or]sat;
dispirited: [x] adj. 沮丧的;消沉的;情绪低落的;灰心的; [acc] /dɪˈspɪrɪtɪd/; [or]sat;
refrain: [x] v. 抑制,避免;  n. 歌曲的反复句,叠句; [acc] /rɪˈfreɪn/; [or]sat;
forensic: [x] adj. 科学手段的,法庭的,辩论的;  n. 辩论练习;辩论学,辩论术; [acc] /fəˈrensɪk/; [or]sat;
embed: [x] v. 把.嵌入;使嵌入; [acc] /ɪmˈbed/; [or]sat;
abrogate: [x] v. 废止,废除;  n. 取消,废除; [acc] /ˈæbrəɡeɪt/; [or]sat;
receptive: [x] adj. 善于接受的;能容纳的; [acc] /rɪˈseptɪv/; [or]sat;
maxim: [x] n. 格言;准则;座右铭; [acc] /ˈmæksɪm/; [or]sat;
gusty: [x] adj. 多阵风的,起大风的,迸发的; [acc] /ˈɡʌsti/; [or]sat;
misanthrope: [x] n. 愤世嫉俗者;厌世者;厌恶人类的人; [acc] /ˈmɪsənθroʊp/; [or]sat;
placebo: [x] n. 安慰剂;为死者所诵的晚祷词; [acc] /pləˈsiːboʊ/; [or]sat;
inanimate: [x] adj. 无生命的;无生气的; [acc] /ɪnˈænɪmət/; [or]sat;
circumlocution: [x] n. 婉转曲折的说法,累赘的陈述,遁辞; [acc] /ˌsɜːrkəmləˈkjuːʃn/; [or]sat;
ratify: [x] vt. 批准,认可,签署生效; [acc] /ˈrætɪfaɪ/; [or]sat;
superimpose: [x] v. 添加;重叠;附加;安装; [acc] /ˌsuːpərɪmˈpoʊz/; [or]sat;
unanimity: [x] n. 一致同意; [acc] /ˌjuːnəˈnɪməti/; [or]sat;
molt: [x] v. 脱毛,换毛;  n. 换羽期,脱毛期; [acc] /moʊlt/; [or]sat;
fissure: [x] v. 裂开,龟裂;  n. 裂缝,裂隙; [acc] /ˈfɪʃər/; [or]sat;
belligerent: [x] adj. (国家等)交战的,挑斗的;  n. 交战国,交战者;参加斗殴的人或集团; [acc] /bəˈlɪdʒərənt/; [or]sat;
boisterous: [x] adj. 喧闹的,欢闹的; [acc] /ˈbɔɪstərəs/; [or]sat;
sparse: [x] adj. 稀少的;稀疏的; [acc] /spɑːrs/; [or]sat;
retiring: [x] adj. 退休的,不善社交的,过隐居生活的;  v. 退休; [acc] /rɪˈtaɪərɪŋ/; [or]sat;
skimp: [x] vt. 少给,克扣,不足量地供给;对.草率从事;  vi. 克俭,节省;  adj. 少的,不足的; [acc] /skɪmp/; [or]sat;
residue: [x] n. 剩余物;残渣;渣;残数; [acc] /ˈrezɪduː/; [or]sat;
tyro: [x] n. 新手; [acc] /ˈtaɪroʊ/; [or]sat;
gorge: [x] n. 峡谷;胃;暴食;咽喉;障碍物;  v. 拼命吃;吞下,狼吞虎咽;塞满,填满; [acc] /ɡɔːrdʒ/; [or]sat;
impervious: [x] adj. 不能渗透的,不为所动的; [acc] /ɪmˈpɜːrviəs/; [or]sat;
ambivalence: [x] n. 矛盾心理; [acc] /æmˈbɪvələns/; [or]sat;
captivate: [x] v. 吸引,迷惑; [acc] /ˈkæptɪveɪt/; [or]sat;
stratagem: [x] n. 谋略,策略; [acc] /ˈstrætədʒəm/; [or]sat;
fluster: [x] n. 慌乱,狼狈,混乱;  v. 使困惑,慌乱; [acc] /ˈflʌstər/; [or]sat;
intemperate: [x] adj. 放纵的;酗酒的;酷烈的; [acc] /ɪnˈtempərət/; [or]sat;
obsessive: [x] adj. 强迫性的;着迷的;分神的;  n. 强迫症患者; [acc] /əbˈsesɪv/; [or]sat;
sully: [x] v. 玷污,污染; [acc] /ˈsʌli/; [or]sat;
exemplify: [x] v. 举例说明;例示,是..的典范; [acc] /ɪɡˈzemplɪfaɪ/; [or]sat;
depredation: [x] n. 掠夺,破坏; [acc] /ˌdeprəˈdeɪʃn/; [or]sat;
acerbity: [x] n. 苦涩,刻薄; [acc] /əˈsɜːrbəti/; [or]sat;
arboretum: [x] n. 植物园; [acc] /ˌɑːrbəˈriːtəm/; [or]sat;
title: [x] n. 标题;头衔;权利;  vt. 加标题于;授予.称号;  adj. 标题的,题目的;称呼的; [acc] /ˈtaɪtl/; [or]sat;
impostor: [x] n. 骗子;冒充者; [acc] /ɪmˈpɑːstər/; [or]sat;
undermine: [x] v. 暗中破坏;逐渐削弱;侵蚀.的基础;在...下挖坑道,从根基处损害; [acc] /ˌʌndərˈmaɪn/; [or]sat;
furtive: [x] adj. 偷偷的,秘密的,鬼鬼祟祟的,; [acc] /ˈfɜːrtɪv/; [or]sat;
indiscretion: [x] n. 轻率;言行失检; [acc] /ˌɪndɪˈskreʃn/; [or]sat;
fraudulent: [x] adj. 欺诈的,欺骗性的,骗得的; [acc] /ˈfrɔːdʒələnt/; [or]sat;
turpitude: [x] n. 邪恶,卑鄙(行为); [acc] /ˈtɜːrpətuːd/; [or]sat;
pinnacle: [x] n. (哥德式建筑的)小尖塔,顶峰;  v. 置于尖顶上,置于高处; [acc] /ˈpɪnəkl/; [or]sat;
withstand: [x] v. 忍受;抵挡; [acc] /wɪðˈstænd/; [or]sat;
articulate: [x] adj. 善于表达的;发音清晰的;  v. 清晰地发音;清楚地讲话;连接,接合;与.合成整体 ,使相互连贯; [acc] /ɑːrˈtɪkjuleɪt/; [or]sat;
anemia: [x] n. 贫血,贫血症; [acc] /ə'niːmiːə/; [or]sat;
rhetorical: [x] adj. 语言上的,文字上的,言辞华丽(却往往无内涵的); [acc] /rɪˈtɔːrɪkl/; [or]sat;
sanctimonious: [x] adj. 伪装虔诚的;道貌岸然的; [acc] /ˌsæŋktɪˈmoʊniəs/; [or]sat;
pernicious: [x] adj. 有害的,恶性的,致命的; [acc] /pərˈnɪʃəs/; [or]sat;
viscous: [x] adj. 黏的;黏稠的;黏滞的;有黏性的; [acc] /ˈvɪskəs/; [or]sat;
intricate: [x] adj. 错综复杂的; [acc] /ˈɪntrɪkət/; [or]sat;
apparition: [x] n. 幽灵,神奇的现象; [acc] /ˌæpəˈrɪʃn/; [or]sat;
frugality: [x] n. 节约,节俭; [acc] /fruˈɡæləti/; [or]sat;
diva: [x] n. 著名女歌唱家,歌剧女主角; [acc] /ˈdiːvə/; [or]sat;
forthright: [x] adj. 直接的,直率的,坦白的,豪爽的;  adv. 马上,立即;  n. 直路; [acc] /ˈfɔːrθraɪt/; [or]sat;
trepidation: [x] n. 恐惧,惶恐; [acc] /ˌtrepɪˈdeɪʃn/; [or]sat;
empathy: [x] n. 共鸣,同感;移情作用; [acc] /ˈempəθi/; [or]sat;
serendipity: [x] n. 机缘巧合; [acc] /ˌserənˈdɪpəti/; [or]sat;
angular: [x] adj. 消瘦的;有角的;笨拙的; [acc] /ˈæŋɡjələr/; [or]sat;
ameliorate: [x] v. 改善,减轻(痛苦等),改良; [acc] /əˈmiːliəreɪt/; [or]sat;
impenetrable: [x] adj. 难以渗透的,坚不可摧的; [acc] /ɪmˈpenɪtrəbl/; [or]sat;
wily: [x] adj. 狡猾的; [acc] /ˈwaɪli/; [or]sat;
material: [x] n. 材料,原料,资料;  adj. 物质的,实体的; [acc] /məˈtɪriəl/; [or]sat;
voluminous: [x] adj. 大量的;长篇的,多产的;庞大的;  adv. 宽松地;容量大地;篇幅长地;  n. 宽松;容量大,篇幅长; [acc] /vəˈluːmɪnəs/; [or]sat;
tawdry: [x] adj. 非常华丽的,廉价而俗丽的;  n. 俗丽的东西,廉价而俗丽之物;  adv. 俗丽地,华而不实地; [acc] /ˈtɔːdri/; [or]sat;
potentate: [x] n. 统治者,君主;有权势的人; [acc] /ˈpoʊtnteɪt/; [or]sat;
pendant: [x] n. 吊坠,下垂物; [acc] /ˈpendənt/; [or]sat;
embark: [x] v. 上船或飞机;开始,着手,从事; [acc] /ɪmˈbɑːrk/; [or]sat;
peripheral: [x] adj. 外围的;  n. 外围设备; [acc] /pəˈrɪfərəl/; [or]sat;
relevant: [x] adj. 有关的;恰当的;贴切的; [acc] /ˈreləvənt/; [or]sat;
dais: [x] n. 主席台,嘉宾席; [acc] /ˈdeɪɪs/; [or]sat;
secrete: [x] v. 藏匿;私下侵吞;分泌; [acc] /sɪˈkriːt/; [or]sat;
morose: [x] adj. 脾气坏的,乖戾的,不高兴的; [acc] /məˈroʊs/; [or]sat;
adapt: [x] vi. 适应不同情况;  vt. 使适合;改编; [acc] /əˈdæpt/; [or]sat;
percussion: [x] n. 撞击,敲击;敲打乐器; [acc] /pərˈkʌʃn/; [or]sat;
linguistic: [x] adj. 语言的,语言上的; [acc] /lɪŋˈɡwɪstɪk/; [or]sat;
pretext: [x] n. 借口,托词; [acc] /ˈpriːtekst/; [or]sat;
maverick: [x] n. 独行者,想法与众不同的人;  adj. 行为不合常规的;  v. 用不正当手段获取;迷路; [acc] /ˈmævərɪk/; [or]sat;
espionage: [x] n. 间谍活动,侦查,监视; [acc] /ˈespiənɑːʒ/; [or]sat;
doggerel: [x] n. 糟糕的诗歌; [acc] /ˈdɔːɡərəl/; [or]sat;
wax: [x] n. 蜡;蜡状物;  v. 给.上蜡;给.打蜡,给.上蜡;渐渐变大;变为;(月亮)渐圆,渐盈;  adj. 蜡制的; [acc] /wæks/; [or]sat;
neologism: [x] n. 新生词; [acc] /niˈɑːlədʒɪzəm/; [or]sat;
termination: [x] n. 终端;结果;结束,终止; [acc] /ˌtɜːrmɪˈneɪʃn/; [or]sat;
belittle: [x] v. 轻视,贬抑; [acc] /bɪˈlɪtl/; [or]sat;
pedant: [x] n. 学究式人物,书呆子,卖弄学问的人; [acc] /ˈpednt/; [or]sat;
languid: [x] adj. 没精打采的,倦怠的; [acc] /ˈlæŋɡwɪd/; [or]sat;
reciprocal: [x] adj. 相互的,互惠的;  n. 倒数;互相关联的事物; [acc] /rɪˈsɪprəkl/; [or]sat;
prognosis: [x] n. [医]预后;预知; [acc] /prɑːɡˈnoʊsɪs/; [or]sat;
anachronistic: [x] adj. 时代错误的; [acc] /əˌnækrəˈnɪstɪk/; [or]sat;
ebb: [x] n. 退潮;退潮期;衰退;  v. 退潮;衰退; [acc] /eb/; [or]sat;
academic: [x] adj. 学术的;学院的,大学的;理论的;  n. 学者; [acc] /ˌækəˈdemɪk/; [or]sat;
fickle: [x] adj. (在感情等方面)反复无常的,轻浮的,善变的; [acc] /ˈfɪkl/; [or]sat;
nurture: [x] v. 养育,培育;培植;  n. 养育,培养;教养;营养物; [acc] /ˈnɜːrtʃər/; [or]sat;
replete: [x] adj. 充满的,装满的;  n. [昆]贮蜜蚁; [acc] /rɪˈpliːt/; [or]sat;
inept: [x] adj. 无能的;不称职的;笨拙的; [acc] /ɪˈnept/; [or]sat;
novelty: [x] n. 新奇;新奇的事物;新颖小巧而廉价的小物品;  adj. 新奇的;风格独特的; [acc] /ˈnɑːvlti/; [or]sat;
hurtle: [x] v. 猛冲,猛烈碰撞,使冲向;  n. 碰撞;碰撞声;猛冲; [acc] /ˈhɜːrtl/; [or]sat;
buxom: [x] adj. 体态丰满的; [acc] /ˈbʌksəm/; [or]sat;
lumber: [x] v. 缓慢地移动;拖累,迫使担负;伐木;杂乱地堆积;隆隆地行进;  n. 木材;废旧家具,不用的大件物品;无用的杂物;隆隆声; [acc] /ˈlʌmbər/; [or]sat;
heckler: [x] n. 激烈质问者; [acc] /ˈheklər/; [or]sat;
fancy: [x] adj. 华丽装饰的,别致的,引人注目的;昂贵的,阔气的;  n. 喜爱,幻想,想像力;  vt. 想象,幻想;迷恋; [acc] /ˈfænsi/; [or]sat;
grandiose: [x] adj. 浮夸的,夸大的,宏伟的; [acc] /ˈɡrændioʊs/; [or]sat;
zeal: [x] n. 热情,热心; [acc] /ziːl/; [or]sat;
augury: [x] n. 预言,征兆,占卜; [acc] /ˈɔːɡjʊri/; [or]sat;
absolute: [x] adj. 完全的;绝对的;纯粹的; [acc] /ˈæbsəluːt/; [or]sat;
adjunct: [x] n. 附属物,配件,添加剂;助手,部下;  adj. 附加的,辅助的,下级的; [acc] /ˈædʒʌŋkt/; [or]sat;
rustic: [x] n. 乡巴佬,庄稼汉,粗人;  adj. 乡村的;质朴的;不精致的; [acc] /ˈrʌstɪk/; [or]sat;
suppress: [x] v. 镇压;禁止发表;抑制(感情等);阻止.的生长; [acc] /səˈpres/; [or]sat;
mirage: [x] n. 幻影,海市蜃楼; [acc] /məˈrɑːʒ/; [or]sat;
faze: [x] v. 打扰,折磨,使狼狈,使担忧; [acc] /feɪz/; [or]sat;
chaff: [x] n. 谷物的皮壳,米糠;草料,干草;小玩笑;  v. 开玩笑; [acc] /tʃæf/; [or]sat;
pretentious: [x] adj. 做作的,自命不凡的,炫耀的; [acc] /prɪˈtenʃəs/; [or]sat;
fractious: [x] adj. 易怒的;难以对待的;倔强的;好争吵的; [acc] /ˈfrækʃəs/; [or]sat;
avert: [x] v. 转移(目光,注意力等);防止;避开; [acc] /əˈvɜːrt/; [or]sat;
pathetic: [x] adj. 可怜的;不足的; [acc] /pəˈθetɪk/; [or]sat;
molecule: [x] n. 分子,微粒; [acc] /ˈmɑːlɪkjuːl/; [or]sat;
terse: [x] adj. 简洁的,简明的; [acc] /tɜːrs/; [or]sat;
exude: [x] v. 慢慢流出,四溢,渗出,散发; [acc] /ɪɡˈzuːd/; [or]sat;
headstrong: [x] adj. 任性的;顽固的; [acc] /ˈhedstrɔːŋ/; [or]sat;
supplant: [x] v. 代替;排挤掉; [acc] /səˈplænt/; [or]sat;
booming: [x] adj. 快速增长的,欣欣向荣;深刻的; [acc] /ˈbuːmɪŋ/; [or]sat;
grisly: [x] adj. 恐怖的;令人震惊的;厉害的; [acc] /ˈɡrɪzli/; [or]sat;
slag: [x] n. 炉渣,矿渣; [acc] /slæɡ/; [or]sat;
mundane: [x] adj. 普通的,平凡的;单调的;现世的,世俗的; [acc] /mʌnˈdeɪn/; [or]sat;
invigorate: [x] v. 鼓舞;提神,使精力充沛;  adj. 生气勃勃的,精力充沛的,健壮的;  n. 滋补;鼓舞; [acc] /ɪnˈvɪɡəreɪt/; [or]sat;
gavel: [x] n. 小木槌;  v. 敲小槌(催促通过议案,要求注意等);要求(注意); [acc] /ˈɡævl/; [or]sat;
convivial: [x] adj. 欢乐的;欢宴的;酒宴的; [acc] /kənˈvɪviəl/; [or]sat;
malicious: [x] adj. 怀恶意的,恶毒的; [acc] /məˈlɪʃəs/; [or]sat;
exonerate: [x] v. 使免罪; [acc] /ɪɡˈzɑːnəreɪt/; [or]sat;
torrent: [x] n. 湍流,洪流,奔流;迸发,连发,爆发;倾盆大雨; [acc] /ˈtɔːrənt/; [or]sat;
annex: [x] n. 附加物;附属的建筑物;  vt. 附加;并吞,强行占取;获得; [acc] /əˈneks/; [or]sat;
acoustics: [x] n. 声学; [acc] /əˈkuːstɪks/; [or]sat;
indiscriminate: [x] adj. 任意的;不加区别的,不加选择的; [acc] /ˌɪndɪˈskrɪmɪnət/; [or]sat;
warrant: [x] n. 逮捕证;正当理由;凭证;  v. 使正当; [acc] /ˈwɔːrənt/; [or]sat;
portly: [x] n. 肥胖的人;特大号服装;  adj. 肥胖的;魁伟的; [acc] /ˈpɔːrtli/; [or]sat;
mammoth: [x] n. 长毛象,猛犸象,庞然大物;  adj. 巨大的,庞大的,猛犸似的; [acc] /ˈmæməθ/; [or]sat;
fresco: [x] n. 壁画;壁画法;  v. 在..上做壁画;用壁画法画出; [acc] /ˈfreskoʊ/; [or]sat;
fidelity: [x] n. 忠诚;逼真度,保真度; [acc] /fɪˈdeləti/; [or]sat;
encompass: [x] vt. 环绕,包围;包含;完成; [acc] /ɪnˈkʌmpəs/; [or]sat;
adversary: [x] n. 对手,敌手; [acc] /ˈædvərseri/; [or]sat;
obituary: [x] n. 讣告;  adj. 关于死者的,讣告的; [acc] /oʊˈbɪtʃueri/; [or]sat;
meditation: [x] n. 沉思,冥想; [acc] /ˌmedɪˈteɪʃn/; [or]sat;
astringent: [x] adj. 止血的,收敛性的;涩的;严厉的;  n. 收缩剂,止血药; [acc] /əˈstrɪndʒənt/; [or]sat;
reverent: [x] adj. 虔诚的,恭敬的; [acc] /ˈrevərənt/; [or]sat;
materialism: [x] n. 唯物主义,物质主义; [acc] /məˈtɪriəlɪzəm/; [or]sat;
irreverence: [x] n. 无礼;不敬的行为;  adj. 不尊敬的; [acc] /ɪˈrevərəns/; [or]sat;
pugnacity: [x] n. 好斗,好战; [acc] /pʌɡˈnæsəti/; [or]sat;
protege: [x] n. 被保护人,门徒,门生; [acc] /ˈproʊtəʒeɪ/; [or]sat;
carnivorous: [x] adj. 食肉的,肉食性的; [acc] /kɑːrˈnɪvərəs/; [or]sat;
deplete: [x] v. 使大大减少;耗尽,用尽; [acc] /dɪˈpliːt/; [or]sat;
impromptu: [x] adj. 一触即发的;即席的,即兴的;  adv. 即席地,即兴地;  n. 即兴之作; [acc] /ɪmˈprɑːmptuː/; [or]sat;
archetype: [x] n. 原型,典型; [acc] /ˈɑːrkitaɪp/; [or]sat;
bloated: [x] adj. 浮肿的,发胀的,傲慢的; [acc] /ˈbloʊtɪd/; [or]sat;
execute: [x] v. 处决;完成(动作);实行;执行(计划); [acc] /ˈeksɪkjuːt/; [or]sat;
cordial: [x] adj. 热情友好的,衷心的; [acc] /ˈkɔːrdʒəl/; [or]sat;
protocol: [x] n. 外交礼节;草案;外交议定书;  vi. 拟定议定书;  vt. 把.写入议定书; [acc] /ˈproʊtəkɔːl/; [or]sat;
commemorate: [x] v. 纪念,庆祝; [acc] /kəˈmeməreɪt/; [or]sat;
entrepreneur: [x] n. 企业家,演出承包人; [acc] /ˌɑːntrəprəˈnɜːr/; [or]sat;
stratify: [x] v. 分层,成层,阶层化; [acc] /ˈstrætɪfaɪ/; [or]sat;
circumscribe: [x] v. 限制;在.周围画线;[数]使外接,使外切; [acc] /ˈsɜːrkəmskraɪb/; [or]sat;
gouge: [x] n. 半圆凿,洞;  v. 挖洞,敲竹杠; [acc] /ɡaʊdʒ/; [or]sat;
docile: [x] adj. 驯服的,温顺的; [acc] /ˈdɑːsl/; [or]sat;
bombardment: [x] n. 炮轰; [acc] /bɑːmˈbɑːrdmənt/; [or]sat;
replica: [x] n. 复制品; [acc] /ˈreplɪkə/; [or]sat;
emancipate: [x] v. 解放;释放; [acc] /ɪˈmænsɪpeɪt/; [or]sat;
reimburse: [x] v. 偿还;赔偿;退还(钱),付还; [acc] /ˌriːɪmˈbɜːrs/; [or]sat;
devious: [x] adj. 迂回弯曲的,狡猾的; [acc] /ˈdiːviəs/; [or]sat;
genteel: [x] adj. 有教养的,文雅的;高雅的;假斯文的,装作体面的; [acc] /dʒenˈtiːl/; [or]sat;
martinet: [x] n. 纪律严明之人; [acc] /ˌmɑːrtnˈet/; [or]sat;
elixir: [x] n. 不老长寿药;万能药;炼金药; [acc] /ɪˈlɪksər/; [or]sat;
complementary: [x] adj. 补足的,补充的,互补的; [acc] /ˌkɑːmplɪˈmentri/; [or]sat;
pied: [x] adj. 杂色的;斑驳的;穿花衣服的; [acc] /paɪd/; [or]sat;
remnant: [x] n. 遗迹;边角剩料; [acc] /ˈremnənt/; [or]sat;
supple: [x] adj. 柔软的;柔顺的; [acc] /ˈsʌpl/; [or]sat;
abrasive: [x] adj. 粗糙的;有研磨作用的;伤人感情的;  n. 研磨料; [acc] /əˈbreɪsɪv/; [or]sat;
hermitage: [x] n. 隐士生活;隐士住处; [acc] /ˈhɜːrmɪtɪdʒ/; [or]sat;
hone: [x] n. 细磨刀石;  v. 磨刀; [acc] /hoʊn/; [or]sat;
indefatigable: [x] adj. 不知疲倦的;不屈不挠的;有耐性的; [acc] /ˌɪndɪˈfætɪɡəbl/; [or]sat;
adhere: [x] v. 遵守;坚持;粘附;附着,粘在..上; [acc] /ədˈhɪr/; [or]sat;
debauch: [x] v. 诱骗;使堕落;  n. 放荡; [acc] /dɪ'bɔːtʃ/; [or]sat;
reprieve: [x] v. 暂缓处罚,免罪,维持运行;  n. [法]死缓,缓刑,暂缓; [acc] /rɪˈpriːv/; [or]sat;
antithesis: [x] n. 对立面,对照; [acc] /ænˈtɪθəsɪs/; [or]sat;
perturb: [x] vt. 使不安;烦扰;使紊乱; [acc] /pərˈtɜːrb/; [or]sat;
fluctuate: [x] v. 波动;起伏;涨落; [acc] /ˈflʌktʃueɪt/; [or]sat;
dissonance: [x] n. 不一致;不调和;不和谐音; [acc] /ˈdɪsənəns/; [or]sat;
etymology: [x] n. 语源,语源学; [acc] /ˌetɪˈmɑːlədʒi/; [or]sat;
invasive: [x] adj. 扩散性的;[医]开刀的; [acc] /ɪnˈveɪsɪv/; [or]sat;
florid: [x] adj. 涨红的,华丽的,红润的; [acc] /ˈflɔːrɪd/; [or]sat;
jettison: [x] v. 向外抛弃,投弃(船舶遇难时投弃货物以为减轻负载);  n. 抛弃的货物; [acc] /ˈdʒetɪsn/; [or]sat;
recluse: [x] n. 隐士;  adj. 隐士的,隐遁的; [acc] /ˈrekluːs/; [or]sat;
manifesto: [x] n. 宣言,声明;告示;  v. 发表宣言; [acc] /ˌmænɪˈfestoʊ/; [or]sat;
viable: [x] adj. 可行的;能养活的;能生育的; [acc] /ˈvaɪəbl/; [or]sat;
petty: [x] adj. 价值不大的;小的;器量小的;琐碎的; [acc] /ˈpeti/; [or]sat;
erratic: [x] adj. 古怪的;反复无常的,不稳定的; [acc] /ɪˈrætɪk/; [or]sat;
grievance: [x] n. 牢骚,委屈,抱怨; [acc] /ˈɡriːvəns/; [or]sat;
unobtrusive: [x] adj. 不唐突的,谦虚的,不引人注目的; [acc] /ˌʌnəbˈtruːsɪv/; [or]sat;
parody: [x] n. 嘲弄文章,拙劣的模仿;  v. 拙劣模仿; [acc] /ˈpærədi/; [or]sat;
stultify: [x] v. 使显得愚蠢,愚弄,使无效,使无价值; [acc] /ˈstʌltɪfaɪ/; [or]sat;
revoke: [x] v. 撤回,取消;废除;  n. 有牌不跟; [acc] /rɪˈvoʊk/; [or]sat;
swerve: [x] v. 转弯,突然改变方向;  n. 转向;滑出;逸出;背离; [acc] /swɜːrv/; [or]sat;
address: [x] n. 地址;致词;  v. 致函;写姓名地址;向..讲话;处理; [acc] /əˈdres/; [or]sat;
composure: [x] n. 镇静,沉着; [acc] /kəmˈpoʊʒər/; [or]sat;
explicit: [x] adj. 充分表达清楚的,明确的;直率的,直截了当的;〔描绘性或暴力的语言或画面〕清晰露骨的; [acc] /ɪkˈsplɪsɪt/; [or]sat;
talisman: [x] n. 护身符,避邪物; [acc] /ˈtælɪzmən/; [or]sat;
nefarious: [x] adj. 违法的,邪恶的; [acc] /nɪˈferiəs/; [or]sat;
engender: [x] v. 产生; [acc] /ɪnˈdʒendər/; [or]sat;
apprise: [x] v. 通知,报告; [acc] /əˈpraɪz/; [or]sat;
stamina: [x] n. 耐力,持久力; [acc] /ˈstæmɪnə/; [or]sat;
sybarite: [x] n. 沉于奢侈逸乐者,酒色之徒; [acc] /'sɪbəˌraɪt/; [or]sat;
expedient: [x] n. 权宜之计,手段;  adj. 有利的,方便的;权宜之计的; [acc] /ɪkˈspiːdiənt/; [or]sat;
waive: [x] v. 放弃;不坚持;推迟;搁置;  vt. 抑制;搁置; [acc] /weɪv/; [or]sat;
harbinger: [x] n. 先驱,先兆;  vt. 预告;充做.的前驱; [acc] /ˈhɑːrbɪndʒər/; [or]sat;
calumny: [x] n. 诽谤,中伤; [acc] /ˈkæləmni/; [or]sat;
cosmopolitan: [x] n. 游历四方的人;  adj. 见多识广的;多元的;广泛分布的; [acc] /ˌkɑːzməˈpɑːlɪtən/; [or]sat;
beseech: [x] v. 恳求,哀求;  adj. 恳求的;哀求的;乞求的; [acc] /bɪˈsiːtʃ/; [or]sat;
expedite: [x] v. 加快;促进;发出;  adj. 畅通的;迅速的;方便的; [acc] /ˈekspədaɪt/; [or]sat;
epicure: [x] n. 美食家;享乐主义者; [acc] /ˈepɪkjʊr/; [or]sat;
allusion: [x] n. 暗示;提及; [acc] /əˈluːʒn/; [or]sat;
spontaneity: [x] n. 自发性,自然行为;自然发生; [acc] /ˌspɑːntəˈneɪəti/; [or]sat;
microcosm: [x] n. 微观世界,缩影; [acc] /ˈmaɪkroʊkɑːzəm/; [or]sat;
incendiary: [x] n. 放火者,纵火者,燃烧弹,煽动者;  adj. 放火的,纵火的,能燃烧的,煽动性的; [acc] /ɪnˈsendieri/; [or]sat;
cataract: [x] n. [眼科]白内障,大瀑布,暴雨,洪水,奔流;  v. 倾注; [acc] /ˈkætərækt/; [or]sat;
prevaricate: [x] v. 支吾,搪塞,说谎; [acc] /prɪˈværɪkeɪt/; [or]sat;
abundant: [x] adj. 丰富的;大量的; [acc] /əˈbʌndənt/; [or]sat;
watershed: [x] n. (美)流域;分水岭;集水区;转折点;重要关头;  adj. 标志转折点的; [acc] /ˈwɔːtərʃed/; [or]sat;
paranoia: [x] n. (心理)偏执狂,多疑症; [acc] /ˌpærəˈnɔɪə/; [or]sat;
jabber: [x] v. 急急忙忙地说,急促不清地说;  n. 急促不清地话,无意义的话; [acc] /ˈdʒæbər/; [or]sat;
aggressor: [x] n. 侵略者,侵略国,挑衅者; [acc] /əˈɡresər/; [or]sat;
emaciated: [x] adj. 瘦弱的;憔悴的; [acc] /ɪˈmeɪʃieɪtɪd/; [or]sat;
aversion: [x] n. 厌恶;讨厌的人,(或东西); [acc] /əˈvɜːrʒn/; [or]sat;
pious: [x] adj. 虔诚的;难以实现的;尽责的; [acc] /ˈpaɪəs/; [or]sat;
amiable: [x] adj. 和蔼的,亲切的;温和的; [acc] /ˈeɪmiəbl/; [or]sat;
degradation: [x] n. 降级,降格;退化;恶化; [acc] /ˌdeɡrəˈdeɪʃn/; [or]sat;
profusion: [x] n. 丰富; [acc] /prəˈfjuːʒn/; [or]sat;
ordinance: [x] n. 法令;条例;条例;圣餐式; [acc] /ˈɔːrdɪnəns/; [or]sat;
flux: [x] n. 流动,不断的变动; [acc] /flʌks/; [or]sat;
chortle: [x] v. 咯咯笑;  n. 得意的高笑; [acc] /ˈtʃɔːrtl/; [or]sat;
stereotype: [x] n. 老套的模式,陈规,成见;  v. 对..产生成见; [acc] /ˈsteriətaɪp/; [or]sat;
azure: [x] adj. 天蓝色的;  n. 碧空;  v. 使成天蓝色; [acc] /ˈæʒər/; [or]sat;
interrogate: [x] v. 审问,审讯; [acc] /ɪnˈterəɡeɪt/; [or]sat;
refraction: [x] n. 折射;折光; [acc] /rɪˈfrækʃn/; [or]sat;
impetus: [x] n. 推动力;促进; [acc] /ˈɪmpɪtəs/; [or]sat;
paragon: [x] n. 模范;完美之物;优秀之人;  adj. 完美的; [acc] /ˈpærəɡɑːn/; [or]sat;
bellicose: [x] adj. 好战的,好斗的; [acc] /ˈbelɪkoʊs/; [or]sat;
anonymous: [x] adj. 匿名的;无名的;不具名的;无特色的;无个性特征; [acc] /əˈnɑːnɪməs/; [or]sat;
patent: [x] n. 专利;  adj. 显然的,明显的;专利的;独创的;  v. 取得.的专利权; [acc] /ˈpætnt/; [or]sat;
festive: [x] adj. 庆祝的,喜庆的,欢乐的,节日似的; [acc] /ˈfestɪv/; [or]sat;
invocation: [x] n. 祈祷;咒语;(法权的)行驶; [acc] /ˌɪnvəˈkeɪʃn/; [or]sat;
unwarranted: [x] adj. 未经保证的,无根据的,不合适的; [acc] /ʌnˈwɔːrəntɪd/; [or]sat;
vicarious: [x] adj. 代替别人做的;代理的,代替的;发同感的; [acc] /vaɪˈkeriəs/; [or]sat;
cameo: [x] n. 石雕,贝雕;浮雕玉石;文学小品; [acc] /ˈkæmioʊ/; [or]sat;
thwart: [x] n. [船]横坐板;  v. 阻挠,阻碍,横过;  adj. 横放的;  adv. 横过;  prep. 〈古〉横跨,横过; [acc] /θwɔːrt/; [or]sat;
felicity: [x] n. 幸福,快乐,幸运; [acc] /fəˈlɪsəti/; [or]sat;
memento: [x] n. 纪念品; [acc] /məˈmentoʊ/; [or]sat;
wary: [x] adj. 谨慎的,小心的,提防的;考虑周到的; [acc] /ˈweri/; [or]sat;
gamut: [x] n. 全音阶,长音域,整个领域,全体; [acc] /'ɡæmət/; [or]sat;
vestige: [x] n. 遗迹,(生)退化的器官,残余,微量(一般用于否定句); [acc] /ˈvestɪdʒ/; [or]sat;
mottled: [x] adj. 有杂色的,斑驳的; [acc] /ˈmɑːtld/; [or]sat;
generate: [x] v. 产生(热,电等能量),创造; [acc] /ˈdʒenəreɪt/; [or]sat;
enumerate: [x] v. 列举; [acc] /ɪˈnuːməreɪt/; [or]sat;
sodden: [x] adj. 浑身湿透的;浸透的;浸过酒的; [acc] /ˈsɑːdn/; [or]sat;
arable: [x] adj. 可耕的,适合种植的;  n. 耕地; [acc] /ˈærəbl/; [or]sat;
smelt: [x] v. 熔解,熔炼;  n. 香鱼;胡瓜鱼; [acc] /smelt/; [or]sat;
callous: [x] adj. 无情的,铁石心肠的,硬结的;  vt. (使)变硬,(使)起茧;(使)冷酷无情; [acc] /ˈkæləs/; [or]sat;
equivocate: [x] v. 模棱两可地说,支吾其词; [acc] /ɪˈkwɪvəkeɪt/; [or]sat;
promote: [x] v. 提升;促进;发扬;促销; [acc] /prəˈmoʊt/; [or]sat;
prim: [x] adj. 拘谨的,呆板的;端庄的;整洁的;  adv. 循规蹈矩地,整洁地;  v. (使)一本正经;使整洁; [acc] /prɪm/; [or]sat;
scintillate: [x] v. 闪烁,(淡吐)流露机智; [acc] /'sɪntlˌeɪt/; [or]sat;
beam: [x] n. 光线;(房屋等)大梁;(横)梁;  v. 发光;照射;发射,播送;微笑;用梁支撑; [acc] /biːm/; [or]sat;
grandeur: [x] n. 壮观,宏伟,庄严; [acc] /ˈɡrændʒər/; [or]sat;
subsidy: [x] n. 补助金,津贴; [acc] /ˈsʌbsədi/; [or]sat;
incite: [x] v. 刺激;煽动; [acc] /ɪnˈsaɪt/; [or]sat;
denigrate: [x] v. 抹黑,贬低; [acc] /ˈdenɪɡreɪt/; [or]sat;
efface: [x] v. 擦掉,抹去;消去; [acc] /ɪˈfeɪs/; [or]sat;
devise: [x] v. 设计,想出;密谋;遗赠(不动产);  n. 设计,发明,遗赠; [acc] /dɪˈvaɪz/; [or]sat;
shyster: [x] n. 奸诈的人(尤指政客),讼棍; [acc] /ˈʃaɪstər/; [or]sat;
plutocracy: [x] n. 富豪,财阀统治; [acc] /pluːˈtɑːkrəsi/; [or]sat;
alleviate: [x] v. 减轻;缓解;缓和; [acc] /əˈliːvieɪt/; [or]sat;
ideology: [x] n. 意识形态,思想(体系); [acc] /ˌaɪdiˈɑːlədʒi/; [or]sat;
astronomical: [x] adj. 天文学的; [acc] /ˌæstrəˈnɑːmɪkl/; [or]sat;
miscellany: [x] n. 混合物,混杂; [acc] /ˈmɪsəleɪni/; [or]sat;
negate: [x] vt. 取消,使无效;否定,否认;  n. 反面,对立面;  vi. 否定,否认; [acc] /nɪˈɡeɪt/; [or]sat;
doctrine: [x] n. 教条,学说,信条,原则; [acc] /ˈdɑːktrɪn/; [or]sat;
recipient: [x] n. 接受者;容器;间接宾语;  adj. 接受的;善于接受的;接受能力强的; [acc] /rɪˈsɪpiənt/; [or]sat;
potable: [x] adj. 适于饮用的;  n. 饮料; [acc] /ˈpoʊtəbl/; [or]sat;
artifice: [x] n. 诡计;欺骗;巧妙的办法; [acc] /ˈɑːrtɪfɪs/; [or]sat;
bolt: [x] n. 门栓,螺栓;闪电;弩箭;  v. 闩门;(马受惊)脱缰;  adv. 突然地;像箭似地;直立地; [acc] /boʊlt/; [or]sat;
scourge: [x] n. 鞭笞,磨难,带来灾难的事物或人;  v. 鞭笞,折磨,使苦恼; [acc] /skɜːrdʒ/; [or]sat;
lull: [x] v. 使平静,使安静,哄骗;  n. 间歇,暂停,暂时平静; [acc] /lʌl/; [or]sat;
spurious: [x] adj. 假的,伪造的,欺骗的; [acc] /ˈspjʊriəs/; [or]sat;
agility: [x] n. 敏捷;灵活; [acc] /əˈdʒɪləti/; [or]sat;
presumptuous: [x] adj. 专横的,自以为是的,冒昧的;  adv. 自以为是地,专横地,冒失地;  n. 自以为是,专横,冒失; [acc] /prɪˈzʌmptʃuəs/; [or]sat;
parochial: [x] adj. 教区的;地方范围的; [acc] /pəˈroʊkiəl/; [or]sat;
devout: [x] adj. 虔诚的,真挚的,诚恳的;  n. 虔诚;真挚,诚恳; [acc] /dɪˈvaʊt/; [or]sat;
portent: [x] n. 征兆,预兆;迹象; [acc] /ˈpɔːrtent/; [or]sat;
compromise: [x] n. 妥协;折中;  v. 妥协;使遭受危害; [acc] /ˈkɑːmprəmaɪz/; [or]sat;
terminology: [x] n. 术语,术语学; [acc] /ˌtɜːrməˈnɑːlədʒi/; [or]sat;
timidity: [x] n. 胆怯; [acc] /tɪˈmɪdəti/; [or]sat;
comeuppance: [x] n. 应得的惩罚,因果报应; [acc] /kʌmˈʌpəns/; [or]sat;
disseminate: [x] v. 宣传,传播;散布; [acc] /dɪˈsemɪneɪt/; [or]sat;
saunter: [x] n. 漫步,闲逛;  v. 闲逛,漫步; [acc] /ˈsɔːntər/; [or]sat;
impending: [x] adj. 即将到来的;迫在眉睫的,紧急的; [acc] /ɪmˈpendɪŋ/; [or]sat;
exhaustive: [x] adj. 详尽的;彻底的;消耗的; [acc] /ɪɡˈzɔːstɪv/; [or]sat;
eddy: [x] n. 漩涡;  v. 旋转;起漩涡; [acc] /ˈedi/; [or]sat;
stipend: [x] n. 奖学金;固定薪金;定期津贴;养老金; [acc] /ˈstaɪpend/; [or]sat;
reminiscence: [x] n. 回忆,怀旧,引起联想的相似事物; [acc] /ˌremɪˈnɪsns/; [or]sat;
sheer: [x] adj. 陡峭的;纯粹的;  v. (off)急转向,偏离;  n. 透明薄纱,透明布料的衣服;  adv. 完全地,全然;垂直地,陡峭地; [acc] /ʃɪr/; [or]sat;
slur: [x] n. 含糊的发音,藐视,污点,连线符;  vi. 含糊地说;  vt. 对.忽略,含糊不清地说出,贬低; [acc] /slɜːr/; [or]sat;
ostracize: [x] v. 放逐,排斥,(古希腊)按贝壳流放法放逐; [acc] /ˈɑːstrəsaɪz/; [or]sat;
embroil: [x] v. 使卷入;使混乱; [acc] /ɪmˈbrɔɪl/; [or]sat;
reprobate: [x] n. 混蛋,恶棍;  adj. 邪恶的;堕落的;  v. 谴责,指责; [acc] /ˈreprəbeɪt/; [or]sat;
anguish: [x] n. 痛苦;苦恼;  v. 感到极度痛苦; [acc] /ˈæŋɡwɪʃ/; [or]sat;
erudite: [x] adj. 博学的,有学问的;  n. 饱学之士,有学问的人; [acc] /ˈerudaɪt/; [or]sat;
nomenclature: [x] n. 术语,命名系统; [acc] /ˈnoʊmənkleɪtʃər/; [or]sat;
hoodwink: [x] v. 欺骗,遮眼,蒙蔽; [acc] /ˈhʊdwɪŋk/; [or]sat;
potent: [x] adj. 强有力的;有权势的;有说服力的; [acc] /ˈpoʊtnt/; [or]sat;
transitory: [x] adj. 短暂的,暂时的,瞬息的; [acc] /ˈtrænsətɔːri/; [or]sat;
decipher: [x] n. 密电译文;  vt. 解释;破译; [acc] /dɪˈsaɪfər/; [or]sat;
acute: [x] adj. (疼痛,妒忌等)剧烈的,严重的;敏锐的;急性的;尖声的; [acc] /əˈkjut/; [or]sat;
anthology: [x] n. (诗,文,曲,画等的)选集; [acc] /ænˈθɑːlədʒi/; [or]sat;
clairvoyant: [x] n. 千里眼,透视眼;有洞察力的人;  adj. 千里眼的;有洞察力的;透视的;有洞察力的; [acc] /klerˈvɔɪənt/; [or]sat;
practical: [x] adj. 实际的,实用的,实践的,切合实际的;〔人〕注重实际的,务实的;〔计划,方法等〕有效的,切实可行的;心灵手巧的;  n. 实习课;实践课;实验考核; [acc] /ˈpræktɪkl/; [or]sat;
insuperable: [x] adj. 难以克服的,无敌的; [acc] /ɪnˈsuːpərəbl/; [or]sat;
badger: [x] n. 獾;獾皮毛;  v. 纠缠;烦扰(反复提提出问题或要求); [acc] /ˈbædʒər/; [or]sat;
epic: [x] adj. 史诗的,叙事诗的;壮丽的,宏大的;  n. 史诗;叙事诗;史诗般的作品; [acc] /ˈepɪk/; [or]sat;
rile: [x] v. 刺激,惹怒; [acc] /raɪl/; [or]sat;
rejoinder: [x] n. 回答,反驳,第二次答辩; [acc] /rɪˈdʒɔɪndər/; [or]sat;
discredit: [x] v. 使不相信,使怀疑;败坏.的名声;  n. 丧失信誉,丧失名誉;败坏名声的人或事,耻辱; [acc] /dɪsˈkredɪt/; [or]sat;
virus: [x] n. 病毒;(计算机) 病毒;病毒性疾病; [acc] /ˈvaɪrəs/; [or]sat;
ascertain: [x] v. 探知,弄清,查明(真相等); [acc] /ˌæsərˈteɪn/; [or]sat;
malefactor: [x] n. 罪犯,犯人; [acc] /ˈmælɪfæktər/; [or]sat;
harbor: [x] n. 海港;港口;避风港;  v. 庇护;藏匿;心怀(怨恨等); [acc] /'hɑːbə/; [or]sat;
mediocre: [x] adj. 普通的;平凡的;中等的; [acc] /ˌmiːdiˈoʊkər/; [or]sat;
compliance: [x] n. 遵守,依从;承诺,答应; [acc] /kəmˈplaɪəns/; [or]sat;
vilify: [x] v. 辱骂,诽谤; [acc] /ˈvɪlɪfaɪ/; [or]sat;
suture: [x] n. 缝合;  v. 缝合; [acc] /ˈsuːtʃər/; [or]sat;
transmute: [x] v. 使改变,使变形; [acc] /trænzˈmjuːt/; [or]sat;
recast: [x] v. 重建; [acc] /ˌriːˈkæst/; [or]sat;
slough: [x] n. (蛇等)蜕皮,要脱落或抛弃的东西,绝境;  v. (蛇等)蜕皮,陷入泥沼,顽强地前进; [acc] /slʌf/; [or]sat;
passive: [x] adj. 被动的;消极的;  n. 被动语态; [acc] /ˈpæsɪv/; [or]sat;
aptitude: [x] n. 天资;自然倾向;适宜; [acc] /ˈæptɪtuːd/; [or]sat;
acumen: [x] n. 聪明,敏锐; [acc] /ˈækjəmən/; [or]sat;
ferret: [x] n. 雪貂;白鼬;侦探;  v. 搜寻;查获;驱出;用雪貂猎取;  adj. 雪貂似的;搜索者般的;爱窥探的; [acc] /ˈferɪt/; [or]sat;
cadaverous: [x] adj. 像尸体的,(形容)枯槁的; [acc] /kəˈdævərəs/; [or]sat;
shirk: [x] v. 逃避;规避(义务,责任等);  n. 偷懒者; [acc] /ʃɜːrk/; [or]sat;
topography: [x] n. 地形学;地形,地貌;局部解剖学;地形图,地势图; [acc] /təˈpɑːɡrəfi/; [or]sat;
amorous: [x] adj. 容易动情的,情爱的; [acc] /ˈæmərəs/; [or]sat;
paraphrase: [x] v. 解释,释义;  n. 转述,释义; [acc] /ˈpærəfreɪz/; [or]sat;
farce: [x] n. 闹剧;胡闹;笑剧; [acc] /fɑːrs/; [or]sat;
shun: [x] v. (有意或习惯性地)避开,躲开; [acc] /ʃʌn/; [or]sat;
nirvana: [x] n. 涅槃,心灵的平静,极乐; [acc] /nɪrˈvɑːnə/; [or]sat;
clasp: [x] v. 握紧;扣紧;扣住;抱紧;  n. 扣子;钩子;紧抱;紧握; [acc] /klæsp/; [or]sat;
infer: [x] vt. 做出推论,推断;推理;暗示;  vi. 推断; [acc] /ɪnˈfɜːr/; [or]sat;
brunt: [x] n. 冲击,主要冲力; [acc] /brʌnt/; [or]sat;
figurine: [x] n. 小塑像,小雕像; [acc] /ˌfɪɡjəˈriːn/; [or]sat;
spendthrift: [x] adj. 挥霍无度的;浪费的;  n. 挥霍无度的人;浪费的人; [acc] /ˈspendθrɪft/; [or]sat;
practitioner: [x] n. (医生或律师等)开业者;实践者,从事者; [acc] /prækˈtɪʃənər/; [or]sat;
ravenous: [x] adj. 贪婪的;渴望的,极饿的;狼吞虎咽的; [acc] /ˈrævənəs/; [or]sat;
ungainly: [x] adj. 笨拙的,不雅的;  adv. 笨拙地;不雅地; [acc] /ʌnˈɡeɪnli/; [or]sat;
claustrophobia: [x] n. 幽闭恐怖症; [acc] /ˌklɔːstrəˈfoʊbiə/; [or]sat;
Spartan: [x] adj. 斯巴达式的,简朴的,刻苦的;  n. 斯巴达人;勇士; [acc] /ˈspɑːrtn/; [or]sat;
impotent: [x] adj. 无力的,无能的,阳痿的;  n. 虚弱者;阳痿者; [acc] /ˈɪmpətənt/; [or]sat;
limpid: [x] adj. 清澈的,透明的,平静的; [acc] /ˈlɪmpɪd/; [or]sat;
sustain: [x] v. 维持;支撑,承受;供养;忍受;遭受,蒙受; [acc] /səˈsteɪn/; [or]sat;
retrench: [x] v. 节省,削减;紧缩; [acc] /rɪˈtrentʃ/; [or]sat;
censure: [x] v. 责难,责备;  n. 责难,责备; [acc] /ˈsenʃər/; [or]sat;
expansive: [x] adj. 广阔的,扩张的,豪爽的; [acc] /ɪkˈspænsɪv/; [or]sat;
artifact: [x] n. 人工制品;手工艺品; [acc] /ˈɑːrtɪfækt/; [or]sat;
pummel: [x] v. 击;打;用拳头连续揍; [acc] /ˈpʌml/; [or]sat;
deadpan: [x] adj. 面无表情的;  adv. 面无表情地; [acc] /ˈdedpæn/; [or]sat;
plumb: [x] n. 铅锤,测锤;  vi. 垂直悬挂;  adj. 垂直的;  vt. 用铅锤测量;  adv. 垂直地; [acc] /plʌm/; [or]sat;
generic: [x] n. 无注册商标产品;通名;  adj. 一般的;非商标的;属的,类的; [acc] /dʒəˈnerɪk/; [or]sat;
dispatch: [x] v. 派遣,调遣;发送(信件,电报等);结束,摆脱掉;匆匆办完;  vt. 处决;  n. 派遣,调遣;发送;快信,急件;迅速,敏捷; [acc] /dɪˈspætʃ/; [or]sat;
giddy: [x] adj. 眼花缭乱的,头晕的,轻率的;  v. (使)眼花,(使)眩晕; [acc] /ˈɡɪdi/; [or]sat;
pediatrician: [x] n. 儿科医师(等于pediatrist); [acc] /ˌpiːdiəˈtrɪʃn/; [or]sat;
trek: [x] n. 艰苦跋涉;  v. 拉(货车),搬运; [acc] /trek/; [or]sat;
charisma: [x] n. 魅力; [acc] /kəˈrɪzmə/; [or]sat;
seamy: [x] adj. 丑恶的,露出线缝的; [acc] /ˈsiːmi/; [or]sat;
kernel: [x] n. 子粒,谷粒;核心; [acc] /ˈkɜːrnl/; [or]sat;
foment: [x] v. 煽动,助长(坏事); [acc] /foʊˈment/; [or]sat;
centigrade: [x] adj. 百分度的;摄氏的;  n. 摄氏度; [acc] /ˈsentɪɡreɪd/; [or]sat;
sever: [x] vt. 割断,断绝;分开;使分离;  vi. 断;裂开;分离; [acc] /ˈsevər/; [or]sat;
anesthetic: [x] n. 麻醉剂,麻药;  adj. 麻醉的,感觉缺失的; [acc] /ˌænəs'θetɪk/; [or]sat;
pauper: [x] n. 贫民,乞丐; [acc] /ˈpɔːpər/; [or]sat;
warranty: [x] n. 授权;根据;保证书;担保书,保单; [acc] /ˈwɔːrənti/; [or]sat;
itinerary: [x] n. 旅程,路线;旅行计划; [acc] /aɪˈtɪnəreri/; [or]sat;
economy: [x] n. 经济,经济制度;节约; [acc] /ɪˈkɑːnəmi/; [or]sat;
gaffe: [x] n. (社交上令人不快的)失言,失态,失礼; [acc] /ɡæf/; [or]sat;
migratory: [x] adj. 迁移的;流浪的; [acc] /ˈmaɪɡrətɔːri/; [or]sat;
meager: [x] adj. 瘦的;贫乏的;粗劣的;少量的; [acc] /ˈmiːɡər/; [or]sat;
autocratic: [x] adj. 独裁的,专断的; [acc] /ˌɔːtəˈkrætɪk/; [or]sat;
Baroque: [x] adj. 巴洛克式的,结构复杂的,形式怪样的;  n. 巴洛克风格,巴洛克艺术; [acc] /bəˈroʊk/; [or]sat;
preamble: [x] n. 序文,电报报头,先兆;  v. 作序言[绪论]; [acc] /priˈæmbl/; [or]sat;
rig: [x] n. 钻井架;装备;帆具;成套器械;  v. 操纵;装配;欺骗; [acc] /rɪɡ/; [or]sat;
cosmic: [x] adj. 宇宙的;广大无边的; [acc] /ˈkɑːzmɪk/; [or]sat;
rent: [x] n. 租金;  v. 租用,出租; [acc] /rent/; [or]sat;
impious: [x] adj. 不敬神的,不虔诚的,不孝的; [acc] /ɪmˈpaɪəs/; [or]sat;
irreproachable: [x] adj. 不可指责的;无过失的;无缺点的; [acc] /ˌɪrɪˈproʊtʃəbl/; [or]sat;
canvass: [x] v. 仔细检查或详尽地讨论;审查,游说;  n. 讨论;细查;劝诱; [acc] /ˈkænvəs/; [or]sat;
sinecure: [x] n. 闲职,挂名职务; [acc] /ˈsaɪnɪkjʊr/; [or]sat;
predilection: [x] n. 偏好; [acc] /ˌpredlˈekʃn/; [or]sat;
lexicographer: [x] n. 词典编纂人; [acc] /ˌleksɪˈkɑːɡrəfər/; [or]sat;
panegyric: [x] n. 颂词,赞词; [acc] /ˌpænəˈdʒɪrɪk/; [or]sat;
strut: [x] n. 高视阔步,抗压装置;  v. 昂首阔步地走,趾高气昂地走; [acc] /strʌt/; [or]sat;
ordain: [x] v. 注定;规定;任命(牧师);颁布命令; [acc] /ɔːrˈdeɪn/; [or]sat;
appease: [x] v. 抚慰;平息; [acc] /əˈpiːz/; [or]sat;
corrosive: [x] adj. 腐蚀的;腐蚀性的;蚀坏的;  n. 腐蚀剂; [acc] /kəˈroʊsɪv/; [or]sat;
disinter: [x] v. 掘出;发掘;显露; [acc] /ˌdɪsɪnˈtɜːr/; [or]sat;
archives: [x] n. 档案室,档案; [acc] /ˈɑːrkaɪvz/; [or]sat;
protract: [x] v. 绘制;延长;伸展; [acc] /proʊ'trækt/; [or]sat;
ruthless: [x] adj. 无情的;残忍的; [acc] /ˈruːθləs/; [or]sat;
acrimonious: [x] adj. 严厉的;辛辣的;刻薄的; [acc] /ˌækrɪˈmoʊniəs/; [or]sat;
peremptory: [x] adj. 专横的,不容反抗的; [acc] /pəˈremptəri/; [or]sat;
impale: [x] v. 刺穿,刺住; [acc] /ɪmˈpeɪl/; [or]sat;
automaton: [x] n. 自动机;机器人; [acc] /ɔːˈtɑːmətən/; [or]sat;
acquittal: [x] n. 宣告无罪,开释; [acc] /əˈkwɪtl/; [or]sat;
missive: [x] n. 公文,公函;  adj. 送出的; [acc] /ˈmɪsɪv/; [or]sat;
zephyr: [x] n. 和风,西风; [acc] /ˈzefər/; [or]sat;
mawkish: [x] adj. 令人厌恶的,伤感的; [acc] /ˈmɔːkɪʃ/; [or]sat;
symmetry: [x] n. 对称;均衡; [acc] /ˈsɪmətri/; [or]sat;
marshal: [x] v. 整理,排列,集结;  n. 元帅;司仪,主持人; [acc] /ˈmɑːrʃl/; [or]sat;
importune: [x] v. 强求,胡搅蛮缠;  adj. 同"importunate"; [acc] /ˌɪmpɔːrˈtuːn/; [or]sat;
nonentity: [x] n. 不存在,虚无;无能力之人,无足轻重的人; [acc] /nɑːˈnentəti/; [or]sat;
impugn: [x] v. 指责,对.表示怀疑; [acc] /ɪmˈpjuːn/; [or]sat;
skiff: [x] n. 小艇;小型帆船;轻舟; [acc] /skɪf/; [or]sat;
repulsion: [x] n. 排斥;厌恶;反驳; [acc] /rɪˈpʌlʃn/; [or]sat;
exigency: [x] n. 紧急(状态);危急(关头);事变; [acc] /ˈeksɪdʒənsi/; [or]sat;
host: [x] n. 东道主,主持人;大量;  v. 主持,主办; [acc] /hoʊst/; [or]sat;
dulcet: [x] adj. 美妙的;悦耳的;怡人的; [acc] /ˈdʌlsɪt/; [or]sat;
malady: [x] n. 疾病,弊病; [acc] /ˈmælədi/; [or]sat;
rout: [x] v. 击溃;搜寻;  n. 溃败;暴动; [acc] /raʊt/; [or]sat;
apprehend: [x] vt. 理解,领会;逮捕;对.忧虑;把.视作;  vi. 忧虑; [acc] /ˌæprɪˈhend/; [or]sat;
arcane: [x] adj. 神秘的;秘传的;晦涩难解的; [acc] /ɑːrˈkeɪn/; [or]sat;
impasse: [x] n. 僵局;死路; [acc] /ˈɪmpæs/; [or]sat;
flaunt: [x] n. 招摇;飘扬;藐视;  vi. 炫耀;飘扬;  vt. 炫耀; [acc] /flɔːnt/; [or]sat;
quarantine: [x] v. 检疫;隔离;使隔离;  n. 检疫;隔离;检疫期;封锁; [acc] /ˈkwɔːrəntiːn/; [or]sat;
propitiate: [x] v. 讨好,抚慰; [acc] /prəˈpɪʃieɪt/; [or]sat;
nepotism: [x] n. 偏袒的人(亲戚); [acc] /ˈnepətɪzəm/; [or]sat;
diurnal: [x] adj. 白天的;每日的;日间活动的; [acc] /daɪˈɜːrnl/; [or]sat;
intrinsic: [x] adj. 固有的; [acc] /ɪnˈtrɪnsɪk/; [or]sat;
dwarf: [x] n. 侏儒;  v. 变矮;发育不全;  adj. 矮生动物或植物的;矮小的;发育不全的;  vt. 使矮小;阻碍.的发育; [acc] /dwɔːrf/; [or]sat;
demise: [x] n. 死亡,终结; [acc] /dɪˈmaɪz/; [or]sat;
rivulet: [x] n. 小溪,小河; [acc] /ˈrɪvjələt/; [or]sat;
inclusive: [x] adj. 包含..在内的,包罗广泛的; [acc] /ɪnˈkluːsɪv/; [or]sat;
valor: [x] n. 勇猛,英勇; [acc] /'vælə/; [or]sat;
hazy: [x] adj. 朦胧的,烟雾弥漫的,模糊的; [acc] /ˈheɪzi/; [or]sat;
garish: [x] adj. 炫耀的;过分装饰的;过分鲜艳的; [acc] /ˈɡerɪʃ/; [or]sat;
execrable: [x] adj. 极坏的; [acc] /ˈeksɪkrəbl/; [or]sat;
impertinent: [x] adj. 不恰当的,粗鲁的; [acc] /ɪmˈpɜːrtnənt/; [or]sat;
threadbare: [x] adj. 磨破的,衣衫褴褛的,乏味的,俗套的; [acc] /ˈθredber/; [or]sat;
arcade: [x] n. 拱廊;有拱廊的街道;游乐场所,游戏厅; [acc] /ɑːrˈkeɪd/; [or]sat;
indignation: [x] n. 愤慨; [acc] /ˌɪndɪɡˈneɪʃn/; [or]sat;
inter: [x] v. 埋葬;  prep. 在内; [acc] /ɪnˈtɜːr/; [or]sat;
muddle: [x] n. 混乱,杂乱,(头脑的)糊涂;  v. (使)混乱,(使)迷惑,混淆;  adj. 引起困惑的;使人糊涂的;难以理解的; [acc] /ˈmʌdl/; [or]sat;
pulverize: [x] v. 粉碎;使成粉末;彻底击败;彻底毁坏; [acc] /ˈpʌlvəraɪz/; [or]sat;
affirmation: [x] n. 肯定;断言;主张; [acc] /ˌæfərˈmeɪʃn/; [or]sat;
marked: [x] adj. 有记号的;显著的;被监视的;引人注目的;  v. 作记号; [acc] /mɑːrkt/; [or]sat;
physiological: [x] adj. 生理的,生理学的; [acc] /ˌfɪziəˈlɑːdʒɪkl/; [or]sat;
fatuous: [x] adj. 愚昧而不自知的; [acc] /ˈfætʃuəs/; [or]sat;
accentuate: [x] v. 强调;重读; [acc] /əkˈsentʃueɪt/; [or]sat;
problematic: [x] adj. 问题的;有疑问的;不确定的; [acc] /ˌprɑːbləˈmætɪk/; [or]sat;
primp: [x] v. 精心打扮;装饰; [acc] /prɪmp/; [or]sat;
restitution: [x] n. 归还,赔偿; [acc] /ˌrestɪˈtuːʃn/; [or]sat;
grudging: [x] adj. 勉强的,吝啬的; [acc] /ˈɡrʌdʒɪŋ/; [or]sat;
complaisant: [x] adj. 彬彬有礼的,殷勤的,柔顺的; [acc] /kəmˈpleɪzənt/; [or]sat;
frolicsome: [x] adj. 快活的;爱闹着玩的; [acc] /ˈfrɑːlɪksəm/; [or]sat;
convex: [x] adj. 中凸的;凸圆的;凸面的;  n. 凸面体;凸状; [acc] /ˈkɑːnveks/; [or]sat;
vagabond: [x] n. 流浪者;  v. 漂泊,流浪;  adj. 流浪的,流浪者的,漂泊的; [acc] /ˈvæɡəbɑːnd/; [or]sat;
dissent: [x] v. 不同意;不信奉国教;  n. 异议;(大写)不信奉国教; [acc] /dɪˈsent/; [or]sat;
caprice: [x] n. 任性,反复无常,随想曲; [acc] /kəˈpriːs/; [or]sat;
incriminate: [x] v. 控告,暗示..有罪; [acc] /ɪnˈkrɪmɪneɪt/; [or]sat;
agent: [x] n. 政府特工;代理商,代理人; [acc] /ˈeɪdʒənt/; [or]sat;
plight: [x] n. 困境;  v. 宣誓,保证; [acc] /plaɪt/; [or]sat;
allege: [x] v. 断言;硬说; [acc] /əˈledʒ/; [or]sat;
improvise: [x] v. 即席创作,临时凑成; [acc] /ˈɪmprəvaɪz/; [or]sat;
renegade: [x] n. 叛教者,脱党者,叛徒;  v. 背叛,背教,变节;  adj. 叛教的,背叛的,变节的; [acc] /ˈrenɪɡeɪd/; [or]sat;
innovative: [x] adj. 创新的,革新的; [acc] /ˈɪnəveɪtɪv/; [or]sat;
entomology: [x] n. 昆虫学; [acc] /ˌentəˈmɑːlədʒi/; [or]sat;
papyrus: [x] n. 纸莎草;纸莎草纸; [acc] /pəˈpaɪrəs/; [or]sat;
prude: [x] n. 过分守礼的人,故作正经的人; [acc] /pruːd/; [or]sat;
redolent: [x] adj. 气味强烈的,芬芳的,令人想起..的; [acc] /ˈredələnt/; [or]sat;
enunciate: [x] v. 发音,阐明,宣布; [acc] /əˈnʌnsieɪt/; [or]sat;
aloft: [x] adv. 在空中,在高处,在上面;  prep. 在 ... 上; [acc] /əˈlɔːft/; [or]sat;
corollary: [x] n. 推论;必然的结果; [acc] /ˈkɔːrəleri/; [or]sat;
inviolable: [x] adj. 神圣的;不可侵犯的,不可亵渎的;不可违背的; [acc] /ɪnˈvaɪələbl/; [or]sat;
saturate: [x] v. 使充满,使饱和,使湿透; [acc] /ˈsætʃəreɪt/; [or]sat;
cumbersome: [x] adj. 笨重的;麻烦的; [acc] /ˈkʌmbərsəm/; [or]sat;
muggy: [x] adj. (天气)闷热而潮湿的; [acc] /ˈmʌɡi/; [or]sat;
realm: [x] n. 王国;领域;国土; [acc] /relm/; [or]sat;
anomaly: [x] n. 异常,不规则,反常事物; [acc] /əˈnɑːməli/; [or]sat;
retaliation: [x] n. 反击;回敬;报复; [acc] /rɪˌtæliˈeɪʃn/; [or]sat;
nominal: [x] adj. 名义上的;象征性的,很少的;名词性的; [acc] /ˈnɑːmɪnl/; [or]sat;
eschew: [x] v. 避开;戒绝; [acc] /ɪsˈtʃuː/; [or]sat;
enfranchise: [x] v. 给予选举权,释放(奴隶); [acc] /ɪnˈfræntʃaɪz/; [or]sat;
recrimination: [x] n. 反责,反控,揭丑; [acc] /rɪˌkrɪmɪˈneɪʃn/; [or]sat;
retort: [x] v. 反驳;  n. 反驳,反击,回嘴; [acc] /rɪˈtɔːrt/; [or]sat;
array: [x] n. 一系列;陈列;编队;  v. 排列;部署; [acc] /əˈreɪ/; [or]sat;
annul: [x] v. 取消,废除,宣告无效; [acc] /əˈnʌl/; [or]sat;
amorphous: [x] adj. 无定形的;无组织的;[物]非晶形的; [acc] /əˈmɔːrfəs/; [or]sat;
assert: [x] v. 断言;肯定地说;坚持;维护; [acc] /əˈsɜːrt/; [or]sat;
gregarious: [x] adj. 群居的,爱社交的; [acc] /ɡrɪˈɡeriəs/; [or]sat;
indignity: [x] n. 侮辱,有伤尊严,无礼举动; [acc] /ɪnˈdɪɡnəti/; [or]sat;
nascent: [x] adj. 初生的,萌芽的;发生中的; [acc] /ˈnæsnt/; [or]sat;
elegy: [x] n. 挽歌,哀歌; [acc] /ˈelədʒi/; [or]sat;
aphasia: [x] n. 失语症; [acc] /əˈfeɪziə/; [or]sat;
convoluted: [x] adj. 旋绕的,费解的; [acc] /ˈkɑːnvəluːtɪd/; [or]sat;
slither: [x] v. (蛇)滑动,滑行;  n. 滑动;滑行; [acc] /ˈslɪðər/; [or]sat;
galvanize: [x] v. 镀锌,通电,刺激; [acc] /ˈɡælvənaɪz/; [or]sat;
affluence: [x] n. 丰富,富裕,流入; [acc] /ˈæfluəns/; [or]sat;
expletive: [x] n. 填补物;咒骂语;  adj. 附加的;填补的; [acc] /ˈeksplətɪv/; [or]sat;
merger: [x] n. (企业等的)合并;并购;吸收(如刑法中重罪吸收轻罪); [acc] /ˈmɜːrdʒər/; [or]sat;
dowdy: [x] adj. 懒散的,过时的,寒酸的;  n. 邋遢女人; [acc] /ˈdaʊdi/; [or]sat;
loathe: [x] v. 憎恨,厌恶; [acc] /loʊð/; [or]sat;
sinewy: [x] adj. 多腱的,强壮有力的; [acc] /ˈsɪnjuːi/; [or]sat;
cessation: [x] n. 停止,中止,中断; [acc] /seˈseɪʃn/; [or]sat;
interim: [x] n. 中间时期,过渡时期;  adj. 暂时的; [acc] /ˈɪntərɪm/; [or]sat;
humdrum: [x] adj. 单调的;乏味的;  n. 平凡;单调;  vi. 单调乏味地进行; [acc] /ˈhʌmdrʌm/; [or]sat;
raucous: [x] adj. (声音)沙哑的,刺耳的,吵闹的; [acc] /ˈrɔːkəs/; [or]sat;
balm: [x] n. 香油,止痛膏,安慰物,香气; [acc] /bɑːm/; [or]sat;
graft: [x] n. 嫁接;嫁接株;移植;  vi. 接枝;  vt. 将.嫁接;移植(器官); [acc] /ɡræft/; [or]sat;
retrospective: [x] adj. 回顾的;怀旧的;可追溯的;  n. 作品回顾展出; [acc] /ˌretrəˈspektɪv/; [or]sat;
converge: [x] v. (向某一点)相交,会合;汇集,聚集,集中; [acc] /kənˈvɜːrdʒ/; [or]sat;
indigenous: [x] adj. 土生土长的,本土的; [acc] /ɪnˈdɪdʒənəs/; [or]sat;
retinue: [x] n. 侍从,随员; [acc] /ˈretənuː/; [or]sat;
universal: [x] adj. 普遍存在的;全体的;通用的;宇宙的;  n. 普遍原则; [acc] /ˌjuːnɪˈvɜːrsl/; [or]sat;
smirk: [x] n. 傻笑;假笑;得意的笑;  vi. 傻笑;假笑;  vt. 以假笑表示;以傻笑表示; [acc] /smɜːrk/; [or]sat;
deride: [x] v. 嘲弄,愚弄; [acc] /dɪˈraɪd/; [or]sat;
quaint: [x] adj. 精巧的;古雅的; [acc] /kweɪnt/; [or]sat;
prowess: [x] n. 勇敢,不凡的能力;超凡技术; [acc] /ˈpraʊəs/; [or]sat;
bask: [x] vi. 晒太阳(享受温暖),感到温暖,愉快或舒适;  n. 晒太阳,取暖;沉浸于; [acc] /bæsk/; [or]sat;
demolition: [x] n. 拆除(等于demolishment);破坏,毁坏; [acc] /ˌdeməˈlɪʃn/; [or]sat;
allegiance: [x] n. 忠诚,拥护; [acc] /əˈliːdʒəns/; [or]sat;
winsome: [x] adj. 迷人的;可爱的;漂亮的; [acc] /ˈwɪnsəm/; [or]sat;
waffle: [x] n. 华夫饼干;动听而无意义的话;无聊话;  v. 胡扯,含糊其辞; [acc] /ˈwɑːfl/; [or]sat;
reaper: [x] n. 收割者;收割机; [acc] /ˈriːpər/; [or]sat;
acquire: [x] v. (尤指靠自己的努力或行动或经过一个过程)获得;学到;取得; [acc] /əˈkwaɪər/; [or]sat;
accelerate: [x] v. 加速,增长;使增速,促进; [acc] /əkˈseləreɪt/; [or]sat;
civil: [x] adj. 公民的,民用的;国内的;有礼貌的,客气的; [acc] /ˈsɪvl/; [or]sat;
concentric: [x] adj. 同中心的;  adv. 同一中心地;同轴地; [acc] /kənˈsentrɪk/; [or]sat;
despondent: [x] adj. 失望的,意气消沉的,没有精神的; [acc] /dɪˈspɑːndənt/; [or]sat;
frantic: [x] adj. 疯狂的;狂乱的;慌乱的; [acc] /ˈfræntɪk/; [or]sat;
marsupial: [x] n. 有袋哺乳动物(袋鼠,袋熊,袋狼); [acc] /mɑːrˈsuːpiəl/; [or]sat;
jovial: [x] adj. 天性快活的,主神朱庇特的;  n. 左威尔牌手表; [acc] /ˈdʒoʊviəl/; [or]sat;
lugubrious: [x] adj. 闷闷不乐的;郁郁寡欢的,悲哀的; [acc] /ləˈɡuːbriəs/; [or]sat;
distant: [x] adj. 遥远的;远方的;疏远的; [acc] /ˈdɪstənt/; [or]sat;
prevalent: [x] adj. 普遍的,流行的; [acc] /ˈprevələnt/; [or]sat;
unequivocal: [x] adj. 明确的,不含糊的; [acc] /ˌʌnɪˈkwɪvəkl/; [or]sat;
elucidate: [x] v. 阐明,说明; [acc] /iˈluːsɪdeɪt/; [or]sat;
gale: [x] n. 狂风,一阵(笑声); [acc] /ɡeɪl/; [or]sat;
sinuous: [x] adj. 弯曲的,蜿蜒的; [acc] /ˈsɪnjuəs/; [or]sat;
noxious: [x] adj. 有害的,有毒的; [acc] /ˈnɑːkʃəs/; [or]sat;
periphery: [x] n. 外围,不重要的部份; [acc] /pəˈrɪfəri/; [or]sat;
wake: [x] v. 醒来,使觉醒;激发,引起;  n. 守灵,守夜;(船航过时的)尾波;年度假期; [acc] /weɪk/; [or]sat;
impenitent: [x] adj. 不悔悟的; [acc] /ɪmˈpenɪtənt/; [or]sat;
cartographer: [x] n. 制图师;地图制作者; [acc] /kɑːrˈtɑːɡrəfər/; [or]sat;
adept: [x] n. 专家,能手;  adj. 熟练的;巧妙的; [acc] /əˈdept/; [or]sat;
depose: [x] v. 免职,废黜,作证; [acc] /dɪˈpoʊz/; [or]sat;
permeable: [x] adj. 可渗透的;可穿透的; [acc] /ˈpɜːrmiəbl/; [or]sat;
dispassionate: [x] adj. 平心静气的,不带感情的; [acc] /dɪsˈpæʃənət/; [or]sat;
grandiloquent: [x] adj. (语言等)夸张的,夸大的; [acc] /ɡrænˈdɪləkwənt/; [or]sat;
obese: [x] adj. 肥胖的;过胖的; [acc] /oʊˈbiːs/; [or]sat;
tortuous: [x] adj. 弯弯曲曲的,蜿蜒的; [acc] /ˈtɔːrtʃuəs/; [or]sat;
cohesion: [x] n. 凝聚,凝聚力;结合;[力]内聚力; [acc] /koʊˈhiːʒn/; [or]sat;
lethargic: [x] adj. 困倦的,无力的,无兴趣的; [acc] /ləˈθɑːrdʒɪk/; [or]sat;
invert: [x] v. 倒置;倒转;颠倒; [acc] /ɪnˈvɜːrt/; [or]sat;
labyrinth: [x] n. 迷宫; [acc] /ˈlæbərɪnθ/; [or]sat;
humility: [x] n. 谦逊,谦恭; [acc] /hjuːˈmɪləti/; [or]sat;
shoddy: [x] adj. 劣等的;假的;冒充的;虚有其表的;  n. 赝品,不值钱的东西; [acc] /ˈʃɑːdi/; [or]sat;
nadir: [x] n. 最低点,无底; [acc] /ˈneɪdɪr/; [or]sat;
iridescent: [x] adj. 彩虹色的;闪光的,闪色的; [acc] /ˌɪrɪˈdesnt/; [or]sat;
fray: [x] n. 吵架,打斗,磨损处;  v. 磨损,摩擦,使关系紧张; [acc] /freɪ/; [or]sat;
equitable: [x] adj. 公正的,公平的; [acc] /ˈekwɪtəbl/; [or]sat;
resigned: [x] adj. 逆来顺受的;已辞职的;已放弃的; [acc] /rɪˈzaɪnd/; [or]sat;
knoll: [x] n. 小圆丘,小山;土墩; [acc] /noʊl/; [or]sat;
abstain: [x] v. 戒掉(烟\酒等);避开;弃权; [acc] /əbˈsteɪn/; [or]sat;
ambience: [x] n. 气氛,环境,氛围; [acc] /ˈæmbiəns/; [or]sat;
monotony: [x] n. 单调乏味,无聊;无变化; [acc] /məˈnɑːtəni/; [or]sat;
decapitate: [x] vt. 将.斩首;把.强行解雇;使无效;  n. 斩首,杀头;刽子手; [acc] /dɪˈkæpɪteɪt/; [or]sat;
exorcise: [x] v. 驱邪;除怪; [acc] /ˈeksɔːrsaɪz/; [or]sat;
partition: [x] n. 划分;隔开物,隔墙,隔板;  v. 隔开;  vt. 瓜分;分割; [acc] /pɑːrˈtɪʃn/; [or]sat;
recuperate: [x] v. 恢复(健康),重新得到,复兴; [acc] /rɪˈkuːpəreɪt/; [or]sat;
jurisprudence: [x] n. 法律学,法学,法律体系,法学分支; [acc] /ˌdʒʊrɪsˈpruːdns/; [or]sat;
exhilarating: [x] adj. 令人高兴的;  v. 使高兴;使兴奋; [acc] /ɪɡˈzɪləreɪtɪŋ/; [or]sat;
subordinate: [x] n. 部下;下属;  adj. 次要的;从属的;下级的;  v. 使从属于;使处于次要地位; [acc] /səˈbɔːrdɪnət/; [or]sat;
preen: [x] v. 打扮;用嘴整理;赞扬; [acc] /priːn/; [or]sat;
discursive: [x] adj. (谈话内容)杂乱的,东拉西扯的,无层次的; [acc] /dɪsˈkɜːrsɪv/; [or]sat;
colloquial: [x] adj. 口语的,白话的,通俗的,口语体; [acc] /kəˈloʊkwiəl/; [or]sat;
cataclysm: [x] n. 灾难(常指大洪水或地震),剧变; [acc] /ˈkætəklɪzəm/; [or]sat;
cavalcade: [x] n. 行列,队伍,骑兵队; [acc] /ˌkævlˈkeɪd/; [or]sat;
tundra: [x] n. 冻土地带; [acc] /ˈtʌndrə/; [or]sat;
substantive: [x] adj. 有实质的;大量的;真实的;独立存在的;  n. 实词,名词,名词性词组; [acc] /səbˈstæntɪv/; [or]sat;
protrude: [x] v. 伸出,突出,凸出; [acc] /proʊˈtruːd/; [or]sat;
insolvent: [x] n. 无力清偿债务者,破产者;  adj. 无清偿能力的,破产的; [acc] /ɪnˈsɑːlvənt/; [or]sat;
amplify: [x] v. 放大(声音等);扩大;增强;详述;进一步阐述; [acc] /ˈæmplɪfaɪ/; [or]sat;
murky: [x] adj. 黑暗的,朦胧的;  adv. 阴暗地,混浊地,可疑地;  n. 阴暗;昏暗;混浊;可疑; [acc] /ˈmɜːrki/; [or]sat;
abbreviate: [x] v. 缩写,使省略,使用缩写词;  n. 使用缩写词的人;缩短,缩写(词,短语,名字,名称); [acc] /əˈbriːvieɪt/; [or]sat;
furlough: [x] n. (军人,官吏的)休假;暂时解雇;放假;  v. 准假;暂时解雇; [acc] /ˈfɜːrloʊ/; [or]sat;
sultry: [x] adj. 闷热的,狂暴的,淫荡的; [acc] /ˈsʌltri/; [or]sat;
sedate: [x] adj. 沉着的,镇定的,平和的;  v. 使服镇静剂而安静下来; [acc] /sɪˈdeɪt/; [or]sat;
inimitable: [x] adj. 独特的,无比的,无法仿效的; [acc] /ɪˈnɪmɪtəbl/; [or]sat;
mannered: [x] adj. 装模作样的,矫揉造作的,墨守成规的,中规中矩的; [acc] /ˈmænərd/; [or]sat;
sagacious: [x] adj. 有洞察力的,有远见的,精明的,敏锐的; [acc] /səˈɡeɪʃəs/; [or]sat;
abyss: [x] n. 深渊;深不可测的事物,绝境;深海;深邃;炼狱; [acc] /əˈbɪs/; [or]sat;
supplicate: [x] v. 恳求,乞求; [acc] /'sʌplɪˌkeɪt/; [or]sat;
galaxy: [x] n. 星系; [acc] /ˈɡæləksi/; [or]sat;
phenomena: [x] n. 现象; [acc] /fə'nɒmɪnə/; [or]sat;
exorbitant: [x] adj. 要价过高的,过分的; [acc] /ɪɡˈzɔːrbɪtənt/; [or]sat;
equine: [x] adj. 马的;似马的;马科的;  n. 马;马科动物; [acc] /ˈiːkwaɪn/; [or]sat;
reserve: [x] n. 储备;保留;保护区;  v. 保留;预定;储备; [acc] /rɪˈzɜːrv/; [or]sat;
gruesome: [x] adj. 阴森的;可怕的; [acc] /ˈɡruːsəm/; [or]sat;
foible: [x] n. 弱点,小缺点,癖好; [acc] /ˈfɔɪbl/; [or]sat;
raspy: [x] adj. 声音沙哑的,容易生气的; [acc] /ˈræspi/; [or]sat;
bane: [x] n. 祸根; [acc] /beɪn/; [or]sat;
pantomime: [x] n. 哑剧,〈英〉(圣诞节上演的)童话剧;  vi. 打手势,演哑剧; [acc] /ˈpæntəmaɪm/; [or]sat;
posthumous: [x] adj. 遗腹的;著作者死后出版的;死后的; [acc] /ˈpɑːstʃəməs/; [or]sat;
maim: [x] v. 使残废; [acc] /meɪm/; [or]sat;
ventriloquist: [x] n. 口技表演者; [acc] /venˈtrɪləkwɪst/; [or]sat;
travesty: [x] n. 滑稽模仿;拙劣的模仿作品;歪曲;  vt. 滑稽地模仿;歪曲; [acc] /ˈtrævəsti/; [or]sat;
denizen: [x] n. 居民,外籍居民; [acc] /ˈdenɪzn/; [or]sat;
pecuniary: [x] adj. 金钱(上)的; [acc] /pɪˈkjuːnieri/; [or]sat;
notable: [x] n. 著名人士;  adj. 值得注意的,显著的,显要的; [acc] /ˈnoʊtəbl/; [or]sat;
demoniac: [x] n. 着魔的人;  adj. 魔鬼的;着魔的; [acc] /dɪˈmoʊnɪæk/; [or]sat;
glimmer: [x] n. 微光;闪光;少许;  v. 闪烁;发微光; [acc] /ˈɡlɪmər/; [or]sat;
buttress: [x] n. 扶墙,拱壁;  v. 支持; [acc] /ˈbʌtrəs/; [or]sat;
maelstrom: [x] n. 大漩涡;灾祸;不可抗的破坏力; [acc] /ˈmeɪlstrɑːm/; [or]sat;
indicative: [x] adj. 指示的;暗示的;陈述的;  n. 陈述语气; [acc] /ɪnˈdɪkətɪv/; [or]sat;
renovate: [x] v. 更新,修复;  adj. 恢复的,革新的,翻新的; [acc] /ˈrenəveɪt/; [or]sat;
incense: [x] n. 焚香时的烟,香味;  v. 激怒; [acc] /ˈɪnsens/; [or]sat;
ductile: [x] adj. (某些金属)有延展性的;可塑的;易受影响的; [acc] /ˈdʌktaɪl/; [or]sat;
legacy: [x] n. 遗赠(物);遗产; [acc] /ˈleɡəsi/; [or]sat;
euphonious: [x] adj. 悦耳的;好听的;声音和谐的; [acc] /juːˈfoʊniəs/; [or]sat;
cadence: [x] n. (声音的)抑扬顿挫;韵律;  vt. 使有节奏; [acc] /ˈkeɪdns/; [or]sat;
animus: [x] n. 憎恨,敌意; [acc] /ˈænɪməs/; [or]sat;
amicable: [x] adj. 友善的,温和的,平心静气的; [acc] /ˈæmɪkəbl/; [or]sat;
faction: [x] n. 派别,小集团,小派系;派系斗争,内讧; [acc] /ˈfækʃn/; [or]sat;
inflated: [x] adj. 通货膨胀的,充了气的,价格飞涨的,(植物)肿胀的; [acc] /ɪnˈfleɪtɪd/; [or]sat;
demure: [x] adj. 严肃的;端庄的,娴静的;假装正直的; [acc] /dɪˈmjʊr/; [or]sat;
tyranny: [x] n. 暴政,苛政,虐待; [acc] /ˈtɪrəni/; [or]sat;
rue: [x] v. 后悔,遗憾; [acc] /ruː/; [or]sat;
decelerate: [x] v. (使)减速; [acc] /ˌdiːˈseləreɪt/; [or]sat;
invective: [x] n. 猛烈抨击,恶言漫骂;  adj. 谩骂的;恶言的;诽谤的; [acc] /ɪnˈvektɪv/; [or]sat;
salvage: [x] n. 抢救;从灾难中抢救出的物资;  vt. 拯救;打捞; [acc] /ˈsælvɪdʒ/; [or]sat;
guile: [x] n. 狡猾,诡计,欺诈; [acc] /ɡaɪl/; [or]sat;
fallow: [x] adj. 休耕的;不活跃的;休闲地,休闲的;  n. 休耕地;休耕;  v. 使(翻耕后的土地)休闲; [acc] /ˈfæloʊ/; [or]sat;
prominent: [x] adj. 突起的,显眼的;突出的,杰出的; [acc] /ˈprɑːmɪnənt/; [or]sat;
inexorable: [x] adj. 不为所动的,坚决不变的;  n. 坚定不移的人; [acc] /ɪnˈeksərəbl/; [or]sat;
affidavit: [x] n. [法律]宣誓书,书面陈述; [acc] /ˌæfəˈdeɪvɪt/; [or]sat;
intellect: [x] n. 智力,理解力;非凡的才智;才华出众的人; [acc] /ˈɪntəlekt/; [or]sat;
resonant: [x] adj. 洪亮的,共振的,共鸣的; [acc] /ˈrezənənt/; [or]sat;
rationale: [x] n. 基本原理;原理的阐述; [acc] /ˌræʃəˈnæl/; [or]sat;
resentment: [x] n. 憎恨; [acc] /rɪˈzentmənt/; [or]sat;
orientation: [x] n. 信仰;倾向;[计]定向;(学生)迎新会;定向,方向;(任职,上学等之前的) 情况介绍;训练; [acc] /ˌɔːriənˈteɪʃn/; [or]sat;
entrance: [x] n. 入口,通道,大门口;出场,登场;进入权;  v. 使出神,使入迷; [acc] /ˈentrəns/; [or]sat;
debris: [x] n. 废墟,残骸; [acc] /dəˈbriː/; [or]sat;
opportunist: [x] n. 机会主义者;投机取巧者;  adj. 机会主义的;投机的;见风转舵的; [acc] /ˌɑːpərˈtuːnɪst/; [or]sat;
scrutinize: [x] v. 仔细检查,细看; [acc] /ˈskruːtənaɪz/; [or]sat;
equilibrium: [x] n. (心态情感等)平静;平衡; [acc] /ˌiːkwɪˈlɪbriəm/; [or]sat;
kudos: [x] n. 荣誉;名望;称赞; [acc] /ˈkuːdəʊs/; [or]sat;
sentinel: [x] n. 哨兵,看守;  v. 守卫,放哨; [acc] /ˈsentɪnl/; [or]sat;
progeny: [x] n. 子孙,后代,成果; [acc] /ˈprɑːdʒəni/; [or]sat;
negligence: [x] n. 疏忽; [acc] /ˈneɡlɪdʒəns/; [or]sat;
lionize: [x] v. 崇拜,把..奉为名人; [acc] /ˈlaɪənaɪz/; [or]sat;
perforate: [x] vt. 穿孔于,打孔穿透;在.上打齿孔;  vi. 穿过,贯穿;穿孔; [acc] /ˈpɜːrfəreɪt/; [or]sat;
actuate: [x] v. 开动(机器);激励,驱使; [acc] /ˈæktʃueɪt/; [or]sat;
peruse: [x] v. 详细考察;精读; [acc] /pəˈruːz/; [or]sat;
skinflint: [x] n. 吝啬鬼; [acc] /ˈskɪnflɪnt/; [or]sat;
adorn: [x] v. 装饰; [acc] /əˈdɔːrn/; [or]sat;
rankle: [x] v. 怨恨,使痛苦,化脓; [acc] /ˈræŋkl/; [or]sat;
incursion: [x] n. 入侵,侵犯; [acc] /ɪnˈkɜːrʒn/; [or]sat;
grueling: [x] n. 惩罚,劳累;  adj. 累垮人的,折磨人的; [acc] /'gruːəlɪŋ/; [or]sat;
transport: [x] v. 运输;使狂喜;流放;  n. 运输;运输工具;流放犯; [acc] /ˈtrænspɔːrt/; [or]sat;
meticulous: [x] adj. 谨小慎微的;一丝不苟的; [acc] /məˈtɪkjələs/; [or]sat;
swarm: [x] n. 蜂群;一群,一批人;  v. 蜂拥;密集;  vt. 蜂拥;挤满; [acc] /swɔːrm/; [or]sat;
saccharine: [x] adj. 像糖一样的,有甜味的,做作的,矫情的; [acc] /ˈsækəriːn/; [or]sat;
accrue: [x] v. (利息等)增大,增多; [acc] /əˈkruː/; [or]sat;
entreat: [x] v. 恳求,请求; [acc] /ɪnˈtriːt/; [or]sat;
vigor: [x] n. 生命力,活力; [acc] /ˈvɪɡər/; [or]sat;
decadence: [x] n. 堕落,颓废;衰落; [acc] /ˈdekədəns/; [or]sat;
larceny: [x] n. 盗窃; [acc] /ˈlɑːrsəni/; [or]sat;
roster: [x] n. 值勤表,花名册;  v. 将(姓名)列入值勤名单; [acc] /ˈrɑːstər/; [or]sat;
penitent: [x] adj. 后悔的,忏悔的;  n. 改过迁善的人;忏悔的人;悔罪者; [acc] /ˈpenɪtənt/; [or]sat;
analgesic: [x] n. 镇痛药;  adj. 止痛的; [acc] /ˌænəlˈdʒiːzɪk/; [or]sat;
disinclination: [x] n. 不感兴趣,厌恶; [acc] /ˌdɪsˌɪnklɪˈneɪʃn/; [or]sat;
onus: [x] n. 义务,责任,负担; [acc] /ˈoʊnəs/; [or]sat;
pacifist: [x] n. 和平主义者;  adj. 非战主义的; [acc] /ˈpæsɪfɪst/; [or]sat;
temporal: [x] adj. 现世的,世俗的;当时的,暂时的;[解]颞的;时间的;  n. 世间万物;教会财产; [acc] /ˈtempərəl/; [or]sat;
spangle: [x] n. (缝在衣服上的)金属亮片;闪光装饰;  v. 是闪烁发光;用闪光饰物装饰; [acc] /ˈspæŋɡl/; [or]sat;
metaphor: [x] n. 暗喻,隐喻; [acc] /ˈmetəfər/; [or]sat;
despoil: [x] v. 掠夺,剥夺;夺取; [acc] /dɪˈspɔɪl/; [or]sat;
malodorous: [x] adj. 有恶臭的;令人极为反感的;不合法的; [acc] /ˌmælˈoʊdərəs/; [or]sat;
aboriginal: [x] adj. 土著的,原来的;  n. 土著居民; [acc] /ˌæbəˈrɪdʒənl/; [or]sat;
prolific: [x] adj. 多育的,多产的;丰富的,富饶的; [acc] /prəˈlɪfɪk/; [or]sat;
irrelevant: [x] adj. 不相关的; [acc] /ɪˈreləvənt/; [or]sat;
countenance: [x] n. 面容,表情,气色;  v. 支持,赞成; [acc] /ˈkaʊntənəns/; [or]sat;
outskirts: [x] n. (尤指城市)郊区; [acc] /ˈaʊtskɜːrts/; [or]sat;
epilogue: [x] n. 收场白;尾声; [acc] /ˈepɪlɔːɡ/; [or]sat;
abjure: [x] v. 发誓放弃,公开放弃,避免; [acc] /əbˈdʒʊr/; [or]sat;
conventional: [x] adj. 普通的,常规的;依照惯例的,依照传统的; [acc] /kənˈvenʃənl/; [or]sat;
revulsion: [x] n. 剧变,厌恶,强烈反感; [acc] /rɪˈvʌlʃn/; [or]sat;
affliction: [x] n. 苦恼,折磨;痛苦; [acc] /əˈflɪkʃn/; [or]sat;
cleft: [x] n. 裂缝;  adj. 分裂的;劈开的; [acc] /kleft/; [or]sat;
enhance: [x] v. 提高(强度,力量,数量等);增加,加强; [acc] /ɪnˈhæns/; [or]sat;
explicate: [x] v. 详细解说; [acc] /ˈeksplɪkeɪt/; [or]sat;
verve: [x] n. 热情,神韵,活力,气魄; [acc] /vɜːrv/; [or]sat;
presage: [x] v. 预示;  n. 预感,不祥感,前兆,预言; [acc] /ˈpresɪdʒ/; [or]sat;
ludicrous: [x] adj. 荒谬的,可笑的,滑稽的; [acc] /ˈluːdɪkrəs/; [or]sat;
viscid: [x] adj. 黏的,黏质的; [acc] /ˈvɪsɪd/; [or]sat;
pathos: [x] n. 悲怆,哀婉;痛苦; [acc] /ˈpeɪθɑːs/; [or]sat;
abnegation: [x] n. 克制,自我克制,放弃; [acc] /ˌæbnɪˈɡeɪʃn/; [or]sat;
bawdy: [x] adj. 说黄色笑话的;淫猥的,下流的; [acc] /ˈbɔːdi/; [or]sat;
altercation: [x] n. 争吵,争论; [acc] /ˌɔːltərˈkeɪʃn/; [or]sat;
coalition: [x] n. 结合;联盟;联合; [acc] /ˌkoʊəˈlɪʃn/; [or]sat;
dynamic: [x] adj. 有活力的,有生气的;不断变化的;动态的;  n. 活力,动力; [acc] /daɪˈnæmɪk/; [or]sat;
bereft: [x] adj. 丧失的;被剥夺的;失去亲人的; [acc] /bɪˈreft/; [or]sat;
oracular: [x] adj. 神谕的,意义模糊的,玄妙深奥的; [acc] /əˈrækjələr/; [or]sat;
chide: [x] v. 叱责,指责; [acc] /tʃaɪd/; [or]sat;
edict: [x] n. 法令,布告; [acc] /ˈiːdɪkt/; [or]sat;
fetter: [x] n. 脚镣;束缚;  vt. 给.上脚镣;束缚; [acc] /ˈfetər/; [or]sat;
gadfly: [x] n. 牛虻,令人生厌的人; [acc] /ˈɡædflaɪ/; [or]sat;
convert: [x] v. 可转变为,可变换成;改变,转变,转化;使改变信仰;  n. 皈依者;改变宗教信仰者; [acc] /kənˈvɜːrt/; [or]sat;
lackadaisical: [x] adj. 懒散的,无精打采的;无兴趣的;伤感的; [acc] /ˌlækəˈdeɪzɪkl/; [or]sat;
advocacy: [x] n. 主张;拥护;辩护; [acc] /ˈædvəkəsi/; [or]sat;
delve: [x] v. 钻研;探究;挖;  n. 穴;洞; [acc] /delv/; [or]sat;
sumptuous: [x] adj. 奢侈的;华丽的; [acc] /ˈsʌmptʃuəs/; [or]sat;
tenure: [x] n. 任期;终身职位; [acc] /ˈtenjər/; [or]sat;
plagiarism: [x] n. 剽窃,抄袭; [acc] /ˈpleɪdʒərɪzəm/; [or]sat;
glib: [x] adj. 口齿伶俐的;油嘴滑舌的; [acc] /ɡlɪb/; [or]sat;
slight: [x] adj. 轻微的,微小的;纤细的,瘦弱的;少量的;  n. 轻视,蔑视;  vt. 轻视,忽略; [acc] /slaɪt/; [or]sat;
proselytize: [x] v. 使皈依; [acc] /ˈprɑːsələtaɪz/; [or]sat;
theocracy: [x] n. 神权政治; [acc] /θiˈɑːkrəsi/; [or]sat;
affected: [x] adj. 受到影响的,受(疾病)侵袭的;假装的,做作的; [acc] /əˈfektɪd/; [or]sat;
methodical: [x] adj. 有系统的,有方法的; [acc] /məˈθɑːdɪkl/; [or]sat;
puny: [x] adj. 弱小的,微不足道的; [acc] /ˈpjuːni/; [or]sat;
retroactive: [x] adj. 追溯的;有追溯效力的;反动的; [acc] /ˌretroʊˈæktɪv/; [or]sat;
ovation: [x] n. 热烈欢迎,欢呼; [acc] /oʊˈveɪʃn/; [or]sat;
compress: [x] v. 压紧,压缩,压榨; [acc] /kəmˈpres/; [or]sat;
celerity: [x] n. 快速,敏捷; [acc] /sə'lerətɪ/; [or]sat;
cursive: [x] n. 草书;草书原稿;  adj. 草书的;草书体的; [acc] /ˈkɜːrsɪv/; [or]sat;
exacting: [x] adj. 苛求的,要求严格的,强索的; [acc] /ɪɡˈzæktɪŋ/; [or]sat;
equivocal: [x] adj. 模棱两可的,不明确的,可疑的; [acc] /ɪˈkwɪvəkl/; [or]sat;
forlorn: [x] adj. 被遗弃的; [acc] /fərˈlɔːrn/; [or]sat;
perfunctory: [x] adj. 草率的,敷衍搪塞的; [acc] /pərˈfʌŋktəri/; [or]sat;
chaste: [x] adj. 贞洁的;纯洁的;朴素的; [acc] /tʃeɪst/; [or]sat;
preclude: [x] v. 阻止;排除; [acc] /prɪˈkluːd/; [or]sat;
timorous: [x] adj. 胆小的,胆怯的,羞怯的; [acc] /ˈtɪmərəs/; [or]sat;
malevolent: [x] adj. 有恶意的,恶毒的; [acc] /məˈlevələnt/; [or]sat;
diversity: [x] n. 多样性,差异,分集; [acc] /daɪˈvɜːrsəti/; [or]sat;
decrepit: [x] adj. 衰老的,破旧的; [acc] /dɪˈkrepɪt/; [or]sat;
martyr: [x] n. 烈士;受难者;乞怜者;  v. 迫害,折磨; [acc] /ˈmɑːrtər/; [or]sat;
apprenticeship: [x] n. 学徒期;学徒身份;学徒期;学徒身份; [acc] /əˈprentɪʃɪp/; [or]sat;
descry: [x] v. 远远看到,望见; [acc] /dɪˈskraɪ/; [or]sat;
denouement: [x] n. 结局,终场; [acc] /ˌdeɪnuːˈmɑ̃ː/; [or]sat;
psyche: [x] n. 灵魂;心智; [acc] /ˈsaɪki/; [or]sat;
exploit: [x] v. 剥削,利用;开发,开拓;  n. 辉煌功绩; [acc] /ɪkˈsplɔɪt/; [or]sat;
precinct: [x] n. 管理区,管辖区;选区;界限,范围; [acc] /ˈpriːsɪŋkt/; [or]sat;
brandish: [x] v. 挥舞;炫耀的挥舞(武器);  n. 挥舞; [acc] /ˈbrændɪʃ/; [or]sat;
perpetuate: [x] adj. 长存的;  vt. 使永久存在,使不朽; [acc] /pərˈpetʃueɪt/; [or]sat;
assent: [x] v. 同意,赞成;  n. 同意;赞成; [acc] /əˈsent/; [or]sat;
winnow: [x] v. 把(谷物)的杂质吹掉;簸;精选;扬谷; [acc] /ˈwɪnoʊ/; [or]sat;
brindled: [x] adj. 有斑纹的; [acc] /ˈbrɪnd(ə)ld/; [or]sat;
beguile: [x] v. 欺骗,迷住,吸引; [acc] /bɪˈɡaɪl/; [or]sat;
blare: [x] v. 高声鸣叫,发嘟嘟声;  n. 嘟嘟声,号声,巨响; [acc] /bler/; [or]sat;
capacity: [x] n. 产能;容量;本领;才能;负载量;职位; [acc] /kəˈpæsəti/; [or]sat;
sovereign: [x] adj. 至高无上的,具有独立主权的,有最高统治权的;  n. 最高统治者,君主,元首; [acc] /ˈsɑːvrən/; [or]sat;
imperturbable: [x] adj. 冷静的,沉着的; [acc] /ˌɪmpərˈtɜːrbəbl/; [or]sat;
sportive: [x] adj. 运动的;嬉戏的;适合运动穿戴的; [acc] /'spɔːtɪv/; [or]sat;
assimilate: [x] v. 使同化;吸收;消化; [acc] /əˈsɪməleɪt/; [or]sat;
dishearten: [x] v. 使灰心,使沮丧; [acc] /dɪsˈhɑːrtn/; [or]sat;
kindle: [x] v. 点燃,激起;着火;照亮;煽动; [acc] /ˈkɪndl/; [or]sat;
secession: [x] n. 脱离,退出; [acc] /sɪˈseʃn/; [or]sat;
ineffable: [x] adj. 不可言喻的,不应说出的,难以形容的; [acc] /ɪnˈefəbl/; [or]sat;
ruffian: [x] n. 流氓,无赖,恶棍;  adj. 凶狠的,残暴的,无法无天的; [acc] /ˈrʌfiən/; [or]sat;
apiary: [x] n. 蜂房;养蜂场; [acc] /ˈeɪpieri/; [or]sat;
writhe: [x] v. 扭动(身体);扭曲变形;缠绕打结;  n. 扭动;翻腾;苦恼; [acc] /raɪð/; [or]sat;
liberator: [x] n. 解放者;释放者; [acc] /ˈlɪbəreɪtər/; [or]sat;
typhoon: [x] n. 台风,强热带风暴; [acc] /taɪˈfuːn/; [or]sat;
desolate: [x] adj. 荒凉的;孤单寂寞的; [acc] /ˈdesələt/; [or]sat;
scuffle: [x] v. 混战,扭打,拖着脚步快速行走;  n. 混战,扭打; [acc] /ˈskʌfl/; [or]sat;
reproach: [x] v. 责备,指责;  n. 指责; [acc] /rɪˈproʊtʃ/; [or]sat;
accede: [x] v. 同意,就任,加入; [acc] /əkˈsiːd/; [or]sat;
cleave: [x] v. 劈开,分裂; [acc] /kliːv/; [or]sat;
opportune: [x] adj. 适当的,恰好的,合时宜的; [acc] /ˌɑːpərˈtuːn/; [or]sat;
icon: [x] n. 图标,肖像,偶像; [acc] /ˈaɪkɑːn/; [or]sat;
invincible: [x] adj. 无敌的;不能征服的; [acc] /ɪnˈvɪnsəbl/; [or]sat;
deducible: [x] adj. 可推论的; [acc] /dɪˈduːsəbl/; [or]sat;
wallow: [x] v. 打滚;沉迷,沉溺;颠簸;  n. 打滚;堕落;泥坑; [acc] /ˈwɑːloʊ/; [or]sat;
don: [x] n. 指导教师,大学教师;先生,阁下;  vt. 穿上; [acc] /dɑːn/; [or]sat;
induce: [x] v. 引导,劝诱,诱导; [acc] /ɪnˈduːs/; [or]sat;
recant: [x] v. 宣布放弃,公开认错; [acc] /rɪˈkænt/; [or]sat;
premonition: [x] n. 预告,征兆,预感; [acc] /ˌpriːməˈnɪʃn/; [or]sat;
humane: [x] adj. 人道的;仁慈的; [acc] /hjuːˈmeɪn/; [or]sat;
edify: [x] vt. 教诲,启发,熏陶; [acc] /ˈedɪfaɪ/; [or]sat;
grovel: [x] v. 摇尾乞怜;奴颜婢膝;匍匐; [acc] /ˈɡrɑːvl/; [or]sat;
perfidious: [x] adj. 不忠的,背信弃义的; [acc] /pərˈfɪdiəs/; [or]sat;
yield: [x] v. 出产;屈服;弯曲;让行;  n. 收益; [acc] /jiːld/; [or]sat;
excoriate: [x] v. 严厉批评,擦伤(皮肤等); [acc] /ˌeksˈkɔːrieɪt/; [or]sat;
hedonist: [x] n. 享乐主义者,［心］欢乐主义者;  adj. 享乐主义者的; [acc] /ˈhiːdənɪst/; [or]sat;
bureaucracy: [x] n. 官僚主义;政府机构; [acc] /bjʊˈrɑːkrəsi/; [or]sat;
repeal: [x] n. 撤销;  v. 废除;废止; [acc] /rɪˈpiːl/; [or]sat;
bequeath: [x] v. 遗赠(留); [acc] /bɪˈkwiːð/; [or]sat;
expenditure: [x] n. (时间,金钱等的)花费,支出,消耗; [acc] /ɪkˈspendɪtʃər/; [or]sat;
communal: [x] adj. 公社的;公共的; [acc] /kəˈmjuːnl/; [or]sat;
bravado: [x] n. 故作勇敢,逞能; [acc] /brəˈvɑːdoʊ/; [or]sat;
valedictory: [x] n. 告别辞;  adj. 告别的; [acc] /ˌvælɪˈdɪktəri/; [or]sat;
tenacious: [x] adj. 坚忍不拔的,固执的,顽强的; [acc] /təˈneɪʃəs/; [or]sat;
whiff: [x] n. 一吹,一吸,一阵香气,一点点,香烟的一口;  v. 轻轻地吹,喷气,[棒]三击出局; [acc] /wɪf/; [or]sat;
discomposure: [x] n. 不安,心乱,狼狈; [acc] /ˌdɪskəmˈpoʊʒər/; [or]sat;
equinox: [x] n. 春分;秋分;昼夜平分点; [acc] /ˈiːkwɪnɑːks/; [or]sat;
abrade: [x] v. 磨损,擦伤; [acc] /əˈbreɪd/; [or]sat;
defame: [x] v. 诽谤,中伤; [acc] /dɪˈfeɪm/; [or]sat;
incongruous: [x] adj. 不调和的,不相称的; [acc] /ɪnˈkɑːŋɡruəs/; [or]sat;
forte: [x] n. 长处,特长;  adj. 强音的;响的;  adv. 响亮地; [acc] /fɔːrt/; [or]sat;
reconnaissance: [x] n. 侦察,勘测,搜索,事先考查; [acc] /rɪˈkɑːnɪsns/; [or]sat;
vapid: [x] adj. 索然无味的;无生气的;  adv. 乏味地;无滋味地;无趣味地;无生气地; [acc] /ˈvæpɪd/; [or]sat;
sarcasm: [x] n. 讽刺,挖苦,嘲笑; [acc] /ˈsɑːrkæzəm/; [or]sat;
dispel: [x] v. 驱散,驱逐;消除(烦恼等); [acc] /dɪˈspel/; [or]sat;
mosaic: [x] n. 镶嵌细工,马赛克;  adj. 摩西的;拼花的;  vt. 镶嵌;用马赛克装饰; [acc] /moʊˈzeɪɪk/; [or]sat;
scenario: [x] n. 剧情梗概;情况,情节;设想; [acc] /səˈnærioʊ/; [or]sat;
promontory: [x] n. 岬,海角,隆突; [acc] /ˈprɑːməntɔːri/; [or]sat;
devotee: [x] n. 爱好者;信徒; [acc] /ˌdevəˈtiː/; [or]sat;
proximity: [x] n. 接近;邻近; [acc] /prɑːkˈsɪməti/; [or]sat;
liaison: [x] n. 联系,暧昧关系; [acc] /ˈliːəzɑːn/; [or]sat;
aristocracy: [x] n. 贵族;贵族统治;贵族政治;贵族品质; [acc] /ˌærɪˈstɑːkrəsi/; [or]sat;
judicious: [x] adj. 有判断力的;明智的; [acc] /dʒuˈdɪʃəs/; [or]sat;
jaunty: [x] adj. 愉快的,满足的;斯文的;时髦的;  adv. 心满意足地,洋洋得意地;  n. 心满意足;洋洋得意; [acc] /ˈdʒɔːnti/; [or]sat;
hypochondriac: [x] n. 疑病患者,忧郁症患者; [acc] /ˌhaɪpəˌkɑːnˈdraɪəkl/; [or]sat;
homogeneous: [x] adj. 同类的,同质的,有相同特征的; [acc] /ˌhoʊməˈdʒiːniəs/; [or]sat;
desultory: [x] adj. 散漫的,无目的的,断断续续的; [acc] /ˈdesəltɔːri/; [or]sat;
centrifugal: [x] adj. 离心的;远中的;  n. 离心机; [acc] /ˌsentrɪˈfjuːɡl/; [or]sat;
gloat: [x] v. 幸灾乐祸地看,窃喜; [acc] /ɡloʊt/; [or]sat;
appraise: [x] v. 评价,鉴定;估价; [acc] /əˈpreɪz/; [or]sat;
touchy: [x] adj. (人或话题)敏感的,易发脾气的;  adv. 易动气地,过分敏感地,小心眼地;  n. 易动气,过分敏感; [acc] /ˈtʌtʃi/; [or]sat;
recidivism: [x] n. 再犯,累犯; [acc] /rɪˈsɪdɪvɪzəm/; [or]sat;
arraign: [x] v. 指责,控告; [acc] /əˈreɪn/; [or]sat;
callow: [x] adj. (鸟)未生羽毛的;年轻而无经验的; [acc] /ˈkæloʊ/; [or]sat;
innocuous: [x] adj. 无伤大雅的;无害的; [acc] /ɪˈnɑːkjuəs/; [or]sat;
sedulous: [x] adj. 聚精会神的,勤勉的; [acc] /ˈsedʒələs/; [or]sat;
exposure: [x] n. 暴露,受寒;揭露,揭发;亮相,报道;曝光,曝光时间; [acc] /ɪkˈspoʊʒər/; [or]sat;
advent: [x] n. 来临;到来;出现; [acc] /ˈædvent/; [or]sat;
gawk: [x] v. 张着嘴呆看; [acc] /ɡɔːk/; [or]sat;
rubble: [x] n. 碎石,瓦砾; [acc] /ˈrʌbl/; [or]sat;
capacious: [x] adj. 宽敞的;广阔的;容积大的; [acc] /kəˈpeɪʃəs/; [or]sat;
overbearing: [x] adj. 专横的,独断的,傲慢的; [acc] /ˌoʊvərˈberɪŋ/; [or]sat;
travail: [x] n. 分娩的痛苦,艰苦劳动;  v. 辛勤努力,经受分娩的阵痛; [acc] /trəˈveɪl/; [or]sat;
barrage: [x] n. 大量;阻塞;齐射式攻击;[水利]拦河坝;  v. 以密集火力阻击; [acc] /bəˈrɑːʒ/; [or]sat;
energize: [x] v. 使活跃;给予精力;使兴奋; [acc] /ˈenərdʒaɪz/; [or]sat;
insatiable: [x] adj. 不能满足的,贪得无厌的; [acc] /ɪnˈseɪʃəbl/; [or]sat;
expurgate: [x] v. 净化,删去; [acc] /ˈekspərɡeɪt/; [or]sat;
concave: [x] adj. 凹面的;  n. 凹面;  vt. 使成凹形; [acc] /kɑːnˈkeɪv/; [or]sat;
perverse: [x] adj. 邪恶的;堕落的;倔强的;违反常情的; [acc] /pərˈvɜːrs/; [or]sat;
meek: [x] adj. 温顺的,逆来顺受的;谦恭的;  n. 温顺的人;谦恭的人; [acc] /miːk/; [or]sat;
cerebration: [x] n. 思考,精神活动,脑髓作用; [acc] /ˌserə'breɪʃən/; [or]sat;
decry: [x] v. 谴责,责难,诽谤; [acc] /dɪˈkraɪ/; [or]sat;
archipelago: [x] n. 群岛; [acc] /ˌɑːrkɪˈpeləɡoʊ/; [or]sat;
nautical: [x] adj. 航海的;海上的;海员的; [acc] /ˈnɔːtɪkl/; [or]sat;
delude: [x] v. 欺骗,哄骗; [acc] /dɪˈluːd/; [or]sat;
geniality: [x] n. 和蔼,温和,亲切; [acc] /ˌdʒiːniˈæləti/; [or]sat;
alimony: [x] n. (法)赡养费,生活费; [acc] /ˈælɪmoʊni/; [or]sat;
adroit: [x] adj. 熟练的,灵巧的; [acc] /əˈdrɔɪt/; [or]sat;
mimicry: [x] n. 模仿;拟态; [acc] /ˈmɪmɪkri/; [or]sat;
tribute: [x] n. 致敬;悼念;贡品;称赞; [acc] /ˈtrɪbjuːt/; [or]sat;
impart: [x] v. 传授,给予,将(某性质)给予或赋予某事物; [acc] /ɪmˈpɑːrt/; [or]sat;
decoy: [x] n. 诱饵;诱骗;  v. 诱骗; [acc] /dɪˈkɔɪ/; [or]sat;
injurious: [x] adj. 有害的,造成伤害的; [acc] /ɪnˈdʒʊriəs/; [or]sat;
dismay: [x] n. 失望;沮丧;惊愕;  v. 使惊恐; [acc] /dɪsˈmeɪ/; [or]sat;
poseur: [x] n. 装模作样的人; [acc] /poʊˈzɜːr/; [or]sat;
indoctrinate: [x] v. 灌输思想; [acc] /ɪnˈdɑːktrɪneɪt/; [or]sat;
deflect: [x] v. (使)偏斜,(使)偏转; [acc] /dɪˈflekt/; [or]sat;
seedy: [x] adj. 多种子的,结籽的,破旧的,褴褛的; [acc] /ˈsiːdi/; [or]sat;
cerebral: [x] adj. 大脑的,深思的; [acc] /səˈriːbrəl/; [or]sat;
graphic: [x] adj. 形象的;图表的;  n. 图,图表; [acc] /ˈɡræfɪk/; [or]sat;
mandatory: [x] adj. 命令的,强制性的; [acc] /ˈmændətɔːri/; [or]sat;
salvo: [x] n. 齐射,齐鸣,齐声欢呼喝彩,保留条款,遁辞;  v. 齐鸣; [acc] /ˈsælvoʊ/; [or]sat;
asinine: [x] adj. 愚笨的;固执的; [acc] /ˈæsɪnaɪn/; [or]sat;
delirium: [x] n. 神志不清,极度兴奋; [acc] /dɪˈlɪriəm/; [or]sat;
tenacity: [x] n. 坚韧不拔,顽强精神; [acc] /təˈnæsəti/; [or]sat;
celestial: [x] adj. 天体的,天上的;  n. 天人,神仙;(指封建时代的)中国人,天朝之人; [acc] /səˈlestʃl/; [or]sat;
obscure: [x] v. 隐藏,使.模糊;使变暗;遮掩;  adj. 不清楚的;难以理解的;  n. 某种模糊的或不清楚的东西; [acc] /əbˈskjʊr/; [or]sat;
discretion: [x] n. 自由裁量权;谨慎;判断力;判定;考虑周到; [acc] /dɪˈskreʃn/; [or]sat;
surveillance: [x] n. 监视;检查; [acc] /sɜːrˈveɪləns/; [or]sat;
bluster: [x] v. 咆哮;狂吹;夸口;威吓;气势汹汹地说;  n. 怒号;吓唬; [acc] /ˈblʌstər/; [or]sat;
mores: [x] n. 风俗习惯,道德观念; [acc] /ˈmɔːreɪz/; [or]sat;
accord: [x] n. 协议;  v. 授予; [acc] /əˈkɔːrd/; [or]sat;
haughtiness: [x] n. 傲慢; [acc] /ˈhɔːtinəs/; [or]sat;
delusion: [x] n. 错觉; [acc] /dɪˈluːʒn/; [or]sat;
legend: [x] n. 传说,传奇人物;(奖章纪念牌等的)铭文;地图的图例,插图的说明; [acc] /ˈledʒənd/; [or]sat;
rigor: [x] n. 严厉;精确;困难境地; [acc] /'rɪgə/; [or]sat;
lateral: [x] n. 侧面部分;支线;  adj. 侧面的;横向的; [acc] /ˈlætərəl/; [or]sat;
stigmatize: [x] v. 诬蔑,玷污; [acc] /ˈstɪɡmətaɪz/; [or]sat;
defuse: [x] vi. 平息,变弱;  vt. 拆除;使消除危险性,平息; [acc] /ˌdiːˈfjuːz/; [or]sat;
squabble: [x] v. 发生口角,大声争吵;  n. 争吵,口角; [acc] /ˈskwɑːbl/; [or]sat;
colander: [x] n. 滤器,漏勺; [acc] /ˈkɑːləndər/; [or]sat;
clamor: [x] n. 喧闹;强烈的要求;  v. 喧嚷;强烈的要求; [acc] /ˈklæmər/; [or]sat;
buffet: [x] n. 自助餐,(火车内)餐室,冷餐桌;  v. 反复敲打,打击,重击; [acc] /bəˈfeɪ/; [or]sat;
pungent: [x] adj. 刺激性的;刺鼻的;尖锐的; [acc] /ˈpʌndʒənt/; [or]sat;
affront: [x] v. 冒犯,有意冒犯,公开侮辱;面对;  n. 轻蔑;公开侮辱; [acc] /əˈfrʌnt/; [or]sat;
advocate: [x] v. 提倡;主张;为.辩护;  n. 辩护者;提倡者;律师; [acc] /ˈædvəkeɪt/; [or]sat;
oust: [x] v. 罢免,驱逐,剥夺,取代; [acc] /aʊst/; [or]sat;
rigorous: [x] adj. 严厉的,严格的; [acc] /ˈrɪɡərəs/; [or]sat;
misconstrue: [x] v. 误解,曲解; [acc] /ˌmɪskənˈstruː/; [or]sat;
xenophobia: [x] n. 仇外,对外国人的恐惧或憎恨; [acc] /ˌzenəˈfoʊbiə/; [or]sat;
onset: [x] n. 开始;攻击,袭击; [acc] /ˈɑːnset/; [or]sat;
accomplice: [x] n. 同谋者,帮凶; [acc] /əˈkɑːmplɪs/; [or]sat;
visionary: [x] n. 有远见的人;幻想家;  adj. 有远见的;爱幻想的; [acc] /ˈvɪʒəneri/; [or]sat;
abase: [x] v. 贬抑;使卑下;降低.的地位;  n. 贬低;屈辱;贬低别人的人; [acc] /əˈbeɪs/; [or]sat;
persona: [x] n. 人物,角色; [acc] /pərˈsoʊnə/; [or]sat;
countermand: [x] vt. 撤回,取消; [acc] /ˈkaʊntərmænd/; [or]sat;
grapple: [x] v. 抓住;格斗;  n. 抓住;格斗; [acc] /ˈɡræpl/; [or]sat;
pacify: [x] v. 使平静,安慰,抚慰; [acc] /ˈpæsɪfaɪ/; [or]sat;
implicate: [x] vt. 使牵连其中,暗示,含有.的意思;  n. 包含的东西; [acc] /ˈɪmplɪkeɪt/; [or]sat;
obstetrician: [x] n. 产科医师; [acc] /ˌɑːbstəˈtrɪʃn/; [or]sat;
aftermath: [x] n. 不幸事件之后果,余波; [acc] /ˈæftərmæθ/; [or]sat;
cite: [x] v. 引用,引证;传唤,传讯;表彰,嘉奖; [acc] /saɪt/; [or]sat;
embargo: [x] v. 禁止出入港口;禁止或限制贸易;征用或扣押;  n. 禁令;禁止;封港令; [acc] /ɪmˈbɑːrɡoʊ/; [or]sat;
innovation: [x] n. 创新,革新,新设施,新发明; [acc] /ˌɪnəˈveɪʃn/; [or]sat;
vindicate: [x] vt. 证明.无辜;维护,辩护; [acc] /ˈvɪndɪkeɪt/; [or]sat;
vantage: [x] n. 优势;有利情况; [acc] /'vɑːntɪdʒ/; [or]sat;
inaugurate: [x] v. 为..揭幕;为.举行就职典礼;开展; [acc] /ɪˈnɔːɡjəreɪt/; [or]sat;
urbane: [x] adj. 温文尔雅的,懂礼的;都[城]市气派的; [acc] /ɜːrˈbeɪn/; [or]sat;
lachrymose: [x] adj. 落泪的,好哭的;催泪的;悲哀的; [acc] /ˈlækrɪmoʊs/; [or]sat;
verbalize: [x] v. 唠叨;以言语表述;使.变成动词; [acc] /ˈvɜːrbəlaɪz/; [or]sat;
audacious: [x] adj. 大胆的,鲁莽的,大胆创新的; [acc] /ɔːˈdeɪʃəs/; [or]sat;
stoic: [x] n. 斯多葛学派哲学家;禁欲主义者;坚守克己之人;  adj. 斯多葛派的;禁欲主义的; [acc] /ˈstoʊɪkl/; [or]sat;
comparable: [x] adj. 类似的,比得上的,可比较的; [acc] /ˈkɑːmpərəbl/; [or]sat;
riddle: [x] n. 谜,谜语;  v. 解谜,出谜题,满是弹孔; [acc] /ˈrɪdl/; [or]sat;
aromatic: [x] adj. 芳香的;  n. 芳香植物;芳香族化合物; [acc] /ˌærəˈmætɪk/; [or]sat;
deign: [x] v. 屈尊,惠允(做某事); [acc] /deɪn/; [or]sat;
rapacious: [x] adj. 贪婪的;掠夺的; [acc] /rəˈpeɪʃəs/; [or]sat;
irreconcilable: [x] adj. 不能妥协的,不能和解的,不能协调的;  n. 不能和解的人,(政治上的)死硬派; [acc] /ɪˈrekənsaɪləbl/; [or]sat;
fastidious: [x] adj. 难讨好的,爱挑剔的; [acc] /fæˈstɪdiəs/; [or]sat;
velocity: [x] n. 速度;迅速,快速; [acc] /vəˈlɑːsəti/; [or]sat;
milieu: [x] n. 周围环境;背景;周围;出身背景; [acc] /mɪlˈjuː/; [or]sat;
malcontent: [x] n. 不满分子,反抗者;  adj. 不满的,不服的; [acc] /ˌmælkənˈtent/; [or]sat;
sporadic: [x] adj. 不定时发生的;零星的;分散的; [acc] /spəˈrædɪk/; [or]sat;
begrudge: [x] v. 嫉妒,吝惜,舍不得给; [acc] /bɪˈɡrʌdʒ/; [or]sat;
inkling: [x] n. 轻微暗示,小提示,略知; [acc] /ˈɪŋklɪŋ/; [or]sat;
impeccable: [x] adj. 无瑕疵的,没有缺点的; [acc] /ɪmˈpekəbl/; [or]sat;
disperse: [x] v. 使散开;分散,散开; [acc] /dɪˈspɜːrs/; [or]sat;
brazen: [x] adj. 厚脸皮的,厚颜无耻的;黄铜(制)的;  v. 厚着脸皮干,使变得无耻; [acc] /ˈbreɪzn/; [or]sat;
capitulate: [x] vi. 有条件投降,认输,屈服,让步,停止抵抗; [acc] /kəˈpɪtʃuleɪt/; [or]sat;
antediluvian: [x] adj. 史前的,陈旧的;  n. 大洪水以前的人;年迈的人;不合时宜的人; [acc] /ˌæntidɪˈluːviən/; [or]sat;
fervor: [x] n. 强烈感情,激情,热情; [acc] /ˈfɜrvər/; [or]sat;
scavenge: [x] v. (在废物中)寻觅;(动物)食腐肉;打扫;排除废气; [acc] /ˈskævɪndʒ/; [or]sat;
deleterious: [x] adj. 有害的;有毒的; [acc] /ˌdeləˈtɪriəs/; [or]sat;
inconsequential: [x] adj. 不重要的,不合理的,不合逻辑的; [acc] /ɪnˌkɑːnsɪˈkwenʃl/; [or]sat;
leery: [x] adj. 机警的,狡猾的; [acc] /ˈlɪri/; [or]sat;
tantalize: [x] v. 逗弄,挑逗,使(看到拿不到而)焦急; [acc] /ˈtæntəlaɪz/; [or]sat;
precarious: [x] adj. 不稳定的;危险的;可疑的;说不定的; [acc] /prɪˈkeriəs/; [or]sat;
animosity: [x] n. 憎恶,仇恨; [acc] /ˌænɪˈmɑːsəti/; [or]sat;
panache: [x] n. 羽饰,神气十足; [acc] /pəˈnæʃ/; [or]sat;
gibe: [x] n. 嘲弄,讥笑;  v. 嘲笑; [acc] /dʒaɪb/; [or]sat;
fallible: [x] adj. 会犯错的,易犯错的; [acc] /ˈfæləbl/; [or]sat;
immobility: [x] n. 不动,固定; [acc] /ˌɪməˈbɪləti/; [or]sat;
impel: [x] v. 推进,驱使; [acc] /ɪmˈpel/; [or]sat;
slothful: [x] adj. 偷懒的,懒惰的; [acc] /ˈsloʊθfl/; [or]sat;
feasible: [x] adj. 可行的,行得通的; [acc] /ˈfiːzəbl/; [or]sat;
eerie: [x] adj. 胆怯的,引起恐惧的; [acc] /ˈɪri/; [or]sat;
rescind: [x] v. 废除;取消;撤回; [acc] /rɪˈsɪnd/; [or]sat;
falter: [x] v. 蹒跚,摇摆;踌躇;畏缩;  n. 踌躇;支吾;颤抖; [acc] /ˈfɔːltər/; [or]sat;
glossary: [x] n. 词汇表,术语汇编; [acc] /ˈɡlɑːsəri/; [or]sat;
apolitical: [x] adj. 不问政治的; [acc] /ˌeɪpəˈlɪtɪkl/; [or]sat;
schematic: [x] adj. 图示的,扼要的;  n. 简图; [acc] /skiːˈmætɪk/; [or]sat;
corporeal: [x] adj. 物质的,有形的,肉体的; [acc] /kɔːrˈpɔːriəl/; [or]sat;
exceptionable: [x] adj. 引起反感的,可反对的,会引起抗议的; [acc] /ɪk'sepʃənəbəl/; [or]sat;
malignant: [x] adj. 恶性的,恶毒的,充满恨意的;  n. 怀有恶意的人;保王党员; [acc] /məˈlɪɡnənt/; [or]sat;
calamity: [x] n. 大灾祸,不幸之事; [acc] /kəˈlæməti/; [or]sat;
centurion: [x] n. 百夫长;百人队队长; [acc] /senˈtʃʊriən/; [or]sat;
unruly: [x] adj. 不守规矩的;任性的;难驾驭的; [acc] /ʌnˈruːli/; [or]sat;
careen: [x] n. (船的)倾侧;  v. (船)倾斜,使倾斜; [acc] /kəˈriːn/; [or]sat;
catalyst: [x] n. 催化剂;造成变化的人或事; [acc] /ˈkætəlɪst/; [or]sat;
sleeper: [x] n. 睡眠者;卧车,卧铺;枕木; [acc] /ˈsliːpər/; [or]sat;
plausible: [x] adj. 似乎有理的;巧嘴的; [acc] /ˈplɔːzəbl/; [or]sat;
bait: [x] n. 饵,诱惑物;  v. 装饵;辱骂,欺侮; [acc] /beɪt/; [or]sat;
haggle: [x] n. 讨价还价;  v. 争论,讨价还价; [acc] /ˈhæɡl/; [or]sat;
blunder: [x] n. 愚蠢之举;大错;  vi. 犯大错;  v. 失策;绊倒; [acc] /ˈblʌndər/; [or]sat;
prevail: [x] v. 流行,盛行;战胜,压倒; [acc] /prɪˈveɪl/; [or]sat;
antiquated: [x] adj. 陈旧的,过时的;  v. 使古旧,废弃; [acc] /ˈæntɪkweɪtɪd/; [or]sat;
attain: [x] v. 获得;达到(某个年纪,水平,条件);实现;  n. 成就; [acc] /əˈteɪn/; [or]sat;
premise: [x] n. 前提;房屋地基;  v. 假定; [acc] /ˈpremɪs/; [or]sat;
solitude: [x] n. 孤独; [acc] /ˈsɑːlətuːd/; [or]sat;
opulence: [x] n. 富裕,丰富; [acc] /ˈɑːpjələns/; [or]sat;
abominable: [x] adj. 讨厌的,令人憎恶的,糟透的;  n. 讨厌,可恶;  adv. 恶劣地,令人厌恶地; [acc] /əˈbɑːmɪnəbl/; [or]sat;
vehement: [x] adj. 猛烈的,强烈的; [acc] /ˈviːəmənt/; [or]sat;
sadistic: [x] adj. 虐待狂的;残忍成性的; [acc] /səˈdɪstɪk/; [or]sat;
overt: [x] adj. 明显的;公开的;公然的; [acc] /oʊˈvɜːrt/; [or]sat;
metaphysical: [x] adj. 形而上学的;超自然的;玄学派诗歌的; [acc] /ˌmetəˈfɪzɪkl/; [or]sat;
validate: [x] v. 使.生效,使合法化;证明正确; [acc] /ˈvælɪdeɪt/; [or]sat;
turmoil: [x] n. 骚动,骚乱; [acc] /ˈtɜːrmɔɪl/; [or]sat;
auspicious: [x] adj. 吉兆的,幸运的; [acc] /ɔːˈspɪʃəs/; [or]sat;
antecede: [x] v. 胜过,居前; [acc] /ˌæntɪ'siːd/; [or]sat;
innuendo: [x] n. 暗讽,讽刺,影射;  vt. 暗示,旁敲侧击地表达;  vi. 影射,说讽刺话; [acc] /ˌɪnjuˈendoʊ/; [or]sat;
carnage: [x] n. 大屠杀,残杀,大量绝灭; [acc] /ˈkɑːrnɪdʒ/; [or]sat;
gibberish: [x] n. 乱语;快速而不清楚的言语; [acc] /ˈdʒɪbərɪʃ/; [or]sat;
kinetic: [x] adj. 运动的; [acc] /kɪˈnetɪk/; [or]sat;
gullible: [x] adj. 易受骗的;轻信的; [acc] /ˈɡʌləbl/; [or]sat;
scaffold: [x] n. 支架;断头台;脚手架;脚手架材料;  vt. 给.搭脚手架; [acc] /ˈskæfoʊld/; [or]sat;
mollify: [x] v. 安慰,安抚; [acc] /ˈmɑːlɪfaɪ/; [or]sat;
liquidate: [x] vt. 清理,清算,停业清理;清偿,清理,清算(破产的公司等),变卖,杀戮,废除; [acc] /ˈlɪkwɪdeɪt/; [or]sat;
indolent: [x] adj. 懒惰的,懒洋洋的; [acc] /ˈɪndələnt/; [or]sat;
remorse: [x] n. 懊悔,自责,同情,怜悯; [acc] /rɪˈmɔːrs/; [or]sat;
vent: [x] n. 发泄;通风口,排气口;(上衣背部或两侧的)开衩;(小型动物的)排泄口;  v. 发泄(情绪),开孔,泄露; [acc] /vent/; [or]sat;
exemplary: [x] adj. 模范的,可仿效的; [acc] /ɪɡˈzempləri/; [or]sat;
dissolute: [x] adj. 无节制的;放荡的; [acc] /ˈdɪsəluːt/; [or]sat;
verbose: [x] adj. 冗长的,啰嗦的; [acc] /vɜːrˈboʊs/; [or]sat;
bizarre: [x] adj. 稀奇古怪的; [acc] /bɪˈzɑːr/; [or]sat;
choleric: [x] adj. 易怒的,暴躁的,胆汁质的; [acc] /ˈkɑːlərɪk/; [or]sat;
enmity: [x] n. 敌意,憎恨; [acc] /ˈenməti/; [or]sat;
juncture: [x] n. 连接;交接处,交界;关键时刻;形势; [acc] /ˈdʒʌŋktʃər/; [or]sat;
shard: [x] n. (陶器等)碎片,破片; [acc] /ʃɑːrd/; [or]sat;
abstruse: [x] adj. 难懂的,深奥的; [acc] /əbˈstruːs/; [or]sat;
respiration: [x] n. 呼吸; [acc] /ˌrespəˈreɪʃn/; [or]sat;
mercenary: [x] n. 外国雇佣兵;唯利是图者;  adj. 唯利是图的;雇佣的; [acc] /ˈmɜːrsəneri/; [or]sat;
vital: [x] adj. 生命所必需的;必不可少的;至关重要的;有活力的;生命攸关的;  n. 要害;重要部分; [acc] /ˈvaɪtl/; [or]sat;
bicameral: [x] adj. 两院制的; [acc] /ˌbaɪˈkæmərəl/; [or]sat;
punitive: [x] adj. 给予惩罚,刑罚的; [acc] /ˈpjuːnətɪv/; [or]sat;
debase: [x] v. 贬值,降低; [acc] /dɪˈbeɪs/; [or]sat;
jocular: [x] adj. 搞笑的,欢乐的; [acc] /ˈdʒɑːkjələr/; [or]sat;
guffaw: [x] n. 哄笑;大笑;  v. 哄笑;大笑; [acc] /ɡəˈfɔː/; [or]sat;
enigmatic: [x] adj. 神秘的,高深莫测的,谜一般的; [acc] /ˌenɪɡˈmætɪk/; [or]sat;
precedent: [x] n. 先例,范例;惯例;  adj. 在前的,前面的; [acc] /ˈpresɪdənt/; [or]sat;
fodder: [x] n. 饲料,草料;(创作的)素材;弹药;  v. 喂; [acc] /ˈfɑːdər/; [or]sat;
bode: [x] v. 预示,为.的兆头,停留,继续,遭到; [acc] /boʊd/; [or]sat;
forbearance: [x] n. 自制,忍耐;宽容; [acc] /fɔːrˈberəns/; [or]sat;
longevity: [x] n. 长寿,长命;寿命; [acc] /lɔːnˈdʒevəti/; [or]sat;
insurgent: [x] n. 叛乱分子;  adj. 叛乱的,起事的; [acc] /ɪnˈsɜːrdʒənt/; [or]sat;
impoverished: [x] adj. 穷困的,用尽了的,无创造性的; [acc] /ɪmˈpɑːvərɪʃt/; [or]sat;
anarchy: [x] n. 无政府状态,政治混乱; [acc] /ˈænərki/; [or]sat;
succinct: [x] adj. 简明的,简洁的,没有废话的; [acc] /səkˈsɪŋkt/; [or]sat;
abet: [x] vt. 唆使,怂恿;支持; [acc] /əˈbet/; [or]sat;
impetuous: [x] adj. 冲动的,鲁莽的; [acc] /ɪmˈpetʃuəs/; [or]sat;
harangue: [x] n. 长篇大论;  v. 高谈阔论;大声训斥; [acc] /həˈræŋ/; [or]sat;
celebrated: [x] adj. 著名的,有名望的;  v. 庆祝; [acc] /ˈselɪbreɪtɪd/; [or]sat;
drudgery: [x] n. 苦工;苦差事;单调乏味的工作; [acc] /ˈdrʌdʒəri/; [or]sat;
severity: [x] n. 严格,严肃; [acc] /sɪˈverəti/; [or]sat;
bent: [x] adj. 弯曲的,决心的,不诚实的;  v. 弯腰,弯曲(bend过去式);  n. 爱好,癖好; [acc] /bent/; [or]sat;
pique: [x] v. 引起(好奇心,兴趣等),不悦,愤怒;  n. 不悦,生气; [acc] /piːk/; [or]sat;
infiltrate: [x] v. 渗入,潜入 (某地方或组织);(气,液)渗透;  n. 渗透物; [acc] /ˈɪnfɪltreɪt/; [or]sat;
nuptial: [x] adj. 婚姻的,婚礼的;  n. 婚礼; [acc] /ˈnʌpʃl/; [or]sat;
apprehension: [x] n. 忧虑,担心,疑惧;逮捕;理解; [acc] /ˌæprɪˈhenʃn/; [or]sat;
mortify: [x] v. 使屈辱;抑制;苦修;约束; [acc] /ˈmɔːrtɪfaɪ/; [or]sat;
amass: [x] vi. 聚集;  vt. 收集;积累,积聚; [acc] /əˈmæs/; [or]sat;
repress: [x] vt. 抑制;镇压;约束; [acc] /rɪˈpres/; [or]sat;
synoptic: [x] adj. 天气的,概要的,一览无余的; [acc] /sɪˈnɑːptɪk/; [or]sat;
delectable: [x] adj. 令人愉快的;美味的; [acc] /dɪˈlektəbl/; [or]sat;
gratify: [x] v. 使高兴,使满足; [acc] /ˈɡrætɪfaɪ/; [or]sat;
illicit: [x] adj. 违法的,违禁的; [acc] /ɪˈlɪsɪt/; [or]sat;
succumb: [x] v. 屈从,屈服,因.死亡(to); [acc] /səˈkʌm/; [or]sat;
citadel: [x] n. 堡垒;避难所; [acc] /ˈsɪtədəl/; [or]sat;
hue: [x] n. 色彩;色度,颜色;叫声; [acc] /hjuː/; [or]sat;
fortitude: [x] n. 坚强意志(精神),坚忍,刚毅; [acc] /ˈfɔːrtətuːd/; [or]sat;
swagger: [x] n. 傲慢的态度,大摇大摆;  v. 大摇大摆地走,吹牛,傲慢;  adj. 豪华时髦的; [acc] /ˈswæɡər/; [or]sat;
derivative: [x] n. 派生物;[化学]衍生物;  adj. 被引申出的,被诱导的;衍生的;第二手的; [acc] /dɪˈrɪvətɪv/; [or]sat;
impediment: [x] n. 妨碍,阻碍;障碍物;(言语)障碍;口吃; [acc] /ɪmˈpedɪmənt/; [or]sat;
dogmatic: [x] adj. 教条的,武断的; [acc] /dɔːɡˈmætɪk/; [or]sat;
apparatus: [x] n. 装置,仪器;设备;组织,机构; [acc] /ˌæpəˈrætəs/; [or]sat;
lineage: [x] n. 血统,世系,门第,宗族;传承; [acc] /ˈlɪniɪdʒ/; [or]sat;
elusive: [x] adj. 难懂的;难捉摸的;难找的;难懂的;易忘的;逃避的;难捉摸的; [acc] /iˈluːsɪv/; [or]sat;
trough: [x] n. 水槽,水槽;低谷期;饲料槽;低气压; [acc] /trɔːf/; [or]sat;
benefactor: [x] n. 恩人;捐助者;施主; [acc] /ˈbenɪfæktər/; [or]sat;
plethora: [x] n. 过多,过剩,多血症; [acc] /ˈpleθərə/; [or]sat;
recession: [x] n. (经济)衰退,不景气;后退,撤回;凹处; [acc] /rɪˈseʃn/; [or]sat;
antagonism: [x] n. 对抗,敌对;敌意; [acc] /ænˈtæɡənɪzəm/; [or]sat;
integrity: [x] n. 正直,真诚;完整; [acc] /ɪnˈteɡrəti/; [or]sat;
coddle: [x] v. 溺爱;用文火煮;  n. 〈口〉娇生惯养的人; [acc] /ˈkɑːdl/; [or]sat;
profane: [x] adj. 亵渎神圣的,不敬的,粗俗的,污秽的;  v. 亵渎,玷污(神圣),滥用;  n. 未受秘传的人; [acc] /prəˈfeɪn/; [or]sat;
philology: [x] n. 语言学; [acc] /fɪˈlɑːlədʒi/; [or]sat;
knit: [x] v. 编结,针织;  n. 编织的衣服;针织衫; [acc] /nɪt/; [or]sat;
pessimism: [x] n. 悲观,悲观主义; [acc] /ˈpesɪmɪzəm/; [or]sat;
imbalance: [x] n. 不平衡,不均衡;失调; [acc] /ɪmˈbæləns/; [or]sat;
sage: [x] adj. 贤明的,审慎的;  n. 圣人,年高望重的人; [acc] /seɪdʒ/; [or]sat;
incredulous: [x] adj. 怀疑的,不轻信的; [acc] /ɪnˈkredʒələs/; [or]sat;
assurance: [x] n. 信心,自信;保证;保险; [acc] /əˈʃʊrəns/; [or]sat;
luxuriant: [x] adj. 繁茂的;多产的;绚烂的;奢华的; [acc] /lʌɡˈʒʊriənt/; [or]sat;
bland: [x] vi. 变得平淡无奇,变得枯燥无味;  adj. 温和的;(食物等)清淡的;漠不关心的;  vt. 使变得淡而无味,使变得枯燥无味;除掉.的特性; [acc] /blænd/; [or]sat;
embellish: [x] vt. 装饰;  v. 吹嘘;润色(文章);  vi. 装饰起来;加以润色;添加细节,对...添枝加叶; [acc] /ɪmˈbelɪʃ/; [or]sat;
capricious: [x] adj. 变化无常的,任性的; [acc] /kəˈprɪʃəs/; [or]sat;
inception: [x] n. 起初;获得学位; [acc] /ɪnˈsepʃn/; [or]sat;
scabbard: [x] n. (刀,剑)鞘,枪套;  v. 把.插入鞘中; [acc] /ˈskæbərd/; [or]sat;
imminent: [x] adj. 迫近的,紧迫的,即将来临的; [acc] /ˈɪmɪnənt/; [or]sat;
listless: [x] adj. 无精打采的,倦怠的,情绪低落的;冷漠的; [acc] /ˈlɪstləs/; [or]sat;
swill: [x] n. 泔水;冲洗;痛饮;  v. 冲洗,痛饮; [acc] /swɪl/; [or]sat;
mediate: [x] v. 调解,调停,斡旋; [acc] /ˈmiːdieɪt/; [or]sat;
hyperbole: [x] n. 夸张的语句;夸张法; [acc] /haɪˈpɜːrbəli/; [or]sat;
omniscient: [x] adj. 无所不知的,博识的;  n. 无所不知者,上帝; [acc] /ɑːmˈnɪsiənt/; [or]sat;
adulation: [x] n. 奉承,恭维; [acc] /ˌædʒəˈleɪʃn/; [or]sat;
scurvy: [x] n. 坏血病;  adj. 卑鄙的,下流的; [acc] /ˈskɜːrvi/; [or]sat;
surmount: [x] v. 克服,战胜,越过; [acc] /sərˈmaʊnt/; [or]sat;
monarchy: [x] n. 君主,最高统治者;君主政体;君主国; [acc] /ˈmɑːnərki/; [or]sat;
flout: [x] n. 表示轻蔑的言行;嘲弄;嘲笑;  vi. 藐视;嘲弄;嘲笑;  vt. 嘲弄;嘲笑;藐视; [acc] /flaʊt/; [or]sat;
propriety: [x] n. 正当(的行为);礼节;适当; [acc] /prəˈpraɪəti/; [or]sat;
obnoxious: [x] adj. 非常讨厌的;可憎的; [acc] /əbˈnɑːkʃəs/; [or]sat;
cardinal: [x] adj. 主要的;基本的;  n. [天主教]枢机主教,红衣主教;基数; [acc] /ˈkɑːrdɪnl/; [or]sat;
jubilation: [x] n. 喜悦,欢呼,庆祝; [acc] /ˌdʒuːbɪˈleɪʃn/; [or]sat;
formality: [x] n. 得体;程序;拘谨;礼节;一丝不苟;单纯为形式而做的事; [acc] /fɔːrˈmæləti/; [or]sat;
promulgate: [x] v. 公布;传播;发表; [acc] /ˈprɑːmlɡeɪt/; [or]sat;
foliage: [x] n. 叶子(总称); [acc] /ˈfoʊliɪdʒ/; [or]sat;
hiatus: [x] n. 空隙,裂缝,中断; [acc] /haɪˈeɪtəs/; [or]sat;
ape: [x] n. 无尾猿,类人猿;模仿者;粗野的大汉;  adj. 〈俚〉疯狂的;  v. 模仿; [acc] /eɪp/; [or]sat;
metropolis: [x] n. 大城市; [acc] /məˈtrɑːpəlɪs/; [or]sat;
frail: [x] adj. 脆弱的,不坚实的;  n. 少妇;灯心草篓;灯心草篓的容量; [acc] /freɪl/; [or]sat;
influx: [x] n. 流入,涌入;河口; [acc] /ˈɪnflʌks/; [or]sat;
duration: [x] n. 持续;持续期间;持续的时间; [acc] /duˈreɪʃn/; [or]sat;
disparate: [x] adj. 迥然不同的; [acc] /ˈdɪspərət/; [or]sat;
harass: [x] v. 使困扰,使烦恼,反复袭击; [acc] /həˈræs/; [or]sat;
alias: [x] n. 别名,化名;  adv. 别名为,化名为; [acc] /ˈeɪliəs/; [or]sat;
junta: [x] n. 团体,派别; [acc] /ˈhʊntə/; [or]sat;
hackneyed: [x] adj. 陈腐的,平常的; [acc] /ˈhæknid/; [or]sat;
litigation: [x] n. 诉讼;起诉; [acc] /ˌlɪtɪˈɡeɪʃn/; [or]sat;
esoteric: [x] adj. 秘传的,神秘的,限于少数人的;  n. 受秘传的人; [acc] /ˌesəˈterɪk/; [or]sat;
codicil: [x] n. 遗嘱的附录,附加条款; [acc] /ˈkɑːdəsl/; [or]sat;
coagulate: [x] v. 凝结,使凝结; [acc] /koʊˈæɡjuleɪt/; [or]sat;
imperial: [x] adj. 帝王的,壮丽的,至尊的;  n. 帝国,皇家; [acc] /ɪmˈpɪriəl/; [or]sat;
imperative: [x] adj. 必要的;祈使的;急需的;  n. 命令;必要的事;义务;驱使; [acc] /ɪmˈperətɪv/; [or]sat;
scruple: [x] n. 顾虑,不安;  vi. 有顾虑,良心上感到不安; [acc] /ˈskruːpl/; [or]sat;
alchemy: [x] n. 炼金术;魔力; [acc] /ˈælkəmi/; [or]sat;
intervene: [x] v. 干涉;介入;调停;干预,阻挠; [acc] /ˌɪntərˈviːn/; [or]sat;
prelate: [x] n. 高级教士;高位神职者; [acc] /ˈprelət/; [or]sat;
salubrious: [x] adj. 清爽的;气候有益健康的; [acc] /səˈluːbriəs/; [or]sat;
incentive: [x] n. 刺激,激励;鼓励; [acc] /ɪnˈsentɪv/; [or]sat;
immaculate: [x] adj. 完美的,无瑕疵的;洁净的; [acc] /ɪˈmækjələt/; [or]sat;
quiescent: [x] adj. 静止的,沉寂的,不活动的; [acc] /kwaɪˈesnt/; [or]sat;
demagogue: [x] n. 煽动者; [acc] /ˈdeməɡɑːɡ/; [or]sat;
sophisticated: [x] adj. (仪器)精密的,复杂的;老于世故的,老练的,富有经验的;高雅的,精致的; [acc] /səˈfɪstɪkeɪtɪd/; [or]sat;
rigid: [x] adj. 坚硬的;僵硬的;死板的; [acc] /ˈrɪdʒɪd/; [or]sat;
figurative: [x] adj. 比喻的,修饰丰富的,形容多的; [acc] /ˈfɪɡərətɪv/; [or]sat;
quack: [x] n. 庸医;鸭叫声;  v. 嘎嘎叫;吹嘘;大声闲聊;  adj. 骗人的,江湖医生的; [acc] /kwæk/; [or]sat;
drone: [x] n. 无人机,无人驾驶飞机;雄蜂;单调的低音;  v. 嗡嗡地响;  vi. 混日子; [acc] /droʊn/; [or]sat;
unscathed: [x] adj. 未受损伤的;未遭伤害的; [acc] /ʌnˈskeɪðd/; [or]sat;
dank: [x] adj. 潮湿的,阴湿的;透水的; [acc] /dæŋk/; [or]sat;
tantrum: [x] n. (孩子气的)脾气发作; [acc] /ˈtæntrəm/; [or]sat;
cloying: [x] adj. 甜得发腻的;厌烦的;倒胃口的; [acc] /ˈklɔɪɪŋ/; [or]sat;
rejuvenate: [x] v. 使..年轻;使..恢复精神;变年轻;  vi. 返老还童,恢复活力,复原; [acc] /rɪˈdʒuːvəneɪt/; [or]sat;
prelude: [x] n. 序幕,前奏; [acc] /ˈpreljuːd/; [or]sat;
pastoral: [x] adj. 田园生活的,牧师的;  n. 牧歌;田园诗;田园景色;牧师写给教区居民的公开信; [acc] /ˈpæstərəl/; [or]sat;
heinous: [x] adj. 可憎的;极凶恶的; [acc] /ˈheɪnəs/; [or]sat;
myopic: [x] n. 近视;  adj. 近视的;目光短浅的; [acc] /maɪˈɑːpɪk/; [or]sat;
clamber: [x] v. 攀登,爬上;  n. 攀登,攀爬; [acc] /ˈklæmbər/; [or]sat;
defoliate: [x] v. 落叶;  adj. 〈罕〉落了叶的; [acc] /ˌdiːˈfoʊlieɪt/; [or]sat;
momentum: [x] n. (物理)动量;势头;动力; [acc] /moʊˈmentəm/; [or]sat;
amity: [x] n. 友好,亲善关系,友好关系; [acc] /ˈæməti/; [or]sat;
serrated: [x] adj. 呈锯齿状的; [acc] /səˈreɪtɪd/; [or]sat;
unpalatable: [x] adj. 不可口的,不好吃的;令人不愉快的; 使人难以接受的; [acc] /ʌnˈpælətəbl/; [or]sat;
lax: [x] adj. 松懈的;松弛的;[语]松弛元音的;  n. 松元音;泻肚; [acc] /læks/; [or]sat;
sonorous: [x] adj. 响亮的,作响的,能发出响亮声音的;  adv. 圆润低沉地;感人地,堂皇地;  n. 感人,堂皇; [acc] /ˈsɑːnərəs/; [or]sat;
canine: [x] adj. 犬的,似犬的,犬科的,犬齿的;  n. [解剖]犬齿; [acc] /ˈkeɪnaɪn/; [or]sat;
knave: [x] n. 不诚实的人;无赖;<古>仆人;(纸牌中的)杰克; [acc] /neɪv/; [or]sat;
ensemble: [x] n. 合唱团,表演团体;总效果;全套服装;全套家具; [acc] /ɑːnˈsɑːmbl/; [or]sat;
gall: [x] n. 粗鲁,无礼;  v. 使恼怒; [acc] /ɡɔːl/; [or]sat;
waft: [x] v. 使飘荡;吹送;  n. 飘荡;吹拂; [acc] /wɑːft/; [or]sat;
complicity: [x] n. 同谋关系,共犯关系; [acc] /kəmˈplɪsəti/; [or]sat;
emanate: [x] v. 发出;放射; [acc] /ˈeməneɪt/; [or]sat;
belabor: [x] v. 抨击;反复讨论,啰啰嗦嗦地说明; [acc] /bɪˈleɪbər/; [or]sat;
ample: [x] adj. 富足的,丰满的,宽敞的; [acc] /ˈæmpl/; [or]sat;
invalidate: [x] v. 使无效;使无价值; [acc] /ɪnˈvælɪdeɪt/; [or]sat;
introspective: [x] adj. 内省的,反省的; [acc] /ˌɪntrəˈspektɪv/; [or]sat;
ramble: [x] vi. 瞎扯;溜达;漫步于;  n. 漫步; [acc] /ˈræmbl/; [or]sat;
succulent: [x] n. 肉质植物;  adj. 多汁鲜美的;丰富多彩的; [acc] /ˈsʌkjələnt/; [or]sat;
exertion: [x] n. 用力;运用; [acc] /ɪɡˈzɜːrʃn/; [or]sat;
delineate: [x] v. 描画;画出..轮廓; [acc] /dɪˈlɪnieɪt/; [or]sat;
hazardous: [x] adj. 有危险的;碰运气的;  adv. 冒险地,有危险地;  n. 冒险,危险; [acc] /ˈhæzərdəs/; [or]sat;
amoral: [x] adj. 不知是非的; [acc] /ˌeɪˈmɔːrəl/; [or]sat;
chaotic: [x] adj. 混沌的,混乱的;混乱的;无秩序的; [acc] /keɪˈɑːtɪk/; [or]sat;
debunk: [x] v. 揭穿真面目,证明为假; [acc] /ˌdiːˈbʌŋk/; [or]sat;
submissive: [x] adj. 顺从的,惟命是从的,谦恭的; [acc] /səbˈmɪsɪv/; [or]sat;
reciprocate: [x] v. 互给;酬答;互换;报答; [acc] /rɪˈsɪprəkeɪt/; [or]sat;
flaccid: [x] adj. 软弱的,无活力的,没气力的,松弛的; [acc] /ˈflæsɪd/; [or]sat;
boorish: [x] adj. 粗野的;乡土气的;笨拙的; [acc] /ˈbʊrɪʃ/; [or]sat;
statute: [x] n. 法令,法规,条例; [acc] /ˈstætʃuːt/; [or]sat;
antidote: [x] n. [药]解毒剂,解药;矫正方法; [acc] /ˈæntidoʊt/; [or]sat;
phlegmatic: [x] adj. 冷淡的;迟钝的; [acc] /fleɡˈmætɪk/; [or]sat;
traverse: [x] v. 横越;穿过;  n. 横越; [acc] /trəˈvɜːrs/; [or]sat;
oligarchy: [x] n. 寡头政治; [acc] /ˈɑːləɡɑːrki/; [or]sat;
cumulative: [x] adj. 渐增的;累积的; [acc] /ˈkjuːmjəleɪtɪv/; [or]sat;
abhor: [x] v. 痛恨;憎恶; [acc] /əbˈhɔːr/; [or]sat;
precursor: [x] n. 先兆,先驱,前体; [acc] /priːˈkɜːrsər/; [or]sat;
insinuate: [x] v. 暗指,暗示; [acc] /ɪnˈsɪnjueɪt/; [or]sat;
apathy: [x] n. 冷漠,无兴趣;漠不关心,无感情; [acc] /ˈæpəθi/; [or]sat;
apex: [x] n. 顶点;尖端; [acc] /ˈeɪpeks/; [or]sat;
seemly: [x] adj. 适当的,有礼的,好看的;  adv. 适当地; [acc] /ˈsiːmli/; [or]sat;
unassailable: [x] adj. 无可争辩的,无懈可击的,不可亵渎的; [acc] /ˌʌnəˈseɪləbl/; [or]sat;
determination: [x] n. 决定;确定;决心; [acc] /dɪˌtɜːrmɪˈneɪʃn/; [or]sat;
coalesce: [x] v. 联合,合并,结合; [acc] /ˌkoʊəˈles/; [or]sat;
placate: [x] vt. 安抚,抚慰; [acc] /ˈpleɪkeɪt/; [or]sat;
whimsical: [x] adj. 古怪的,异想天开的; [acc] /ˈwɪmzɪkl/; [or]sat;
perimeter: [x] n. 周长;周界; [acc] /pəˈrɪmɪtər/; [or]sat;
formidable: [x] adj. 令人畏惧的;可怕的;难以克服的;难应付的; [acc] /ˈfɔːrmɪdəbl/; [or]sat;
wry: [x] adj. 歪斜的,扭歪的,歪曲的;  v. 歪曲,扭曲;扭转; [acc] /raɪ/; [or]sat;
vendor: [x] n. 小贩,卖主,供应商; [acc] /ˈvendər/; [or]sat;
cursory: [x] adj. 匆忙的,不注意细节的;草率地;粗略地; [acc] /ˈkɜːrsəri/; [or]sat;
stringent: [x] adj. 严厉的;迫切的;银根紧的; [acc] /ˈstrɪndʒənt/; [or]sat;
baleful: [x] adj. 邪恶的,恶意的;  adv. 凶恶地,有害地; [acc] /ˈbeɪlfl/; [or]sat;
regal: [x] adj. 帝王的,豪华的,帝王般的; [acc] /ˈriːɡl/; [or]sat;
diabolical: [x] adj. 恶毒的,狠毒的; [acc] /ˌdaɪəˈbɑːlɪkl/; [or]sat;
discrepancy: [x] n. 不一致,差异,不符; [acc] /dɪsˈkrepənsi/; [or]sat;
blithe: [x] adj. 愉快的;快乐无忧的; [acc] /blaɪð/; [or]sat;
parity: [x] n. 相等;同等;平价; [acc] /ˈpærəti/; [or]sat;
copious: [x] adj. 丰富的,多产的; [acc] /ˈkoʊpiəs/; [or]sat;
wispy: [x] adj. 象小束状的,纤细的;脆弱的; [acc] /ˈwɪspi/; [or]sat;
avenge: [x] v. 报复,报仇; [acc] /əˈvendʒ/; [or]sat;
acrophobia: [x] n. 恐高症; [acc] /ˌækrə'foʊbɪə/; [or]sat;
dermatologist: [x] n. 皮肤科; [acc] /ˌdɜːrməˈtɑːlədʒɪst/; [or]sat;
gentry: [x] n. 人们(多用贬义),贵族们,(英)上流社会人士; [acc] /ˈdʒentri/; [or]sat;
optician: [x] n. 光学仪器商,眼镜商; [acc] /ɑːpˈtɪʃn/; [or]sat;
guise: [x] n. 外观,姿态,装束,伪装;  v. 伪装; [acc] /ɡaɪz/; [or]sat;
rabid: [x] adj. 激烈的;狂暴的;偏激的;患狂犬病的; [acc] /ˈræbɪd/; [or]sat;
medley: [x] adj. 大杂烩,混合物;  n. 混合;混杂;混合物; [acc] /ˈmedli/; [or]sat;
reverie: [x] n. 幻想,沉思,幻想曲; [acc] /ˈrevəri/; [or]sat;
inequity: [x] n. 不公平; [acc] /ɪnˈekwəti/; [or]sat;
chicanery: [x] n. 诡计,诈骗,欺骗; [acc] /ʃɪˈkeɪnəri/; [or]sat;
camaraderie: [x] n. 友情; [acc] /ˌkɑːməˈrɑːdəri/; [or]sat;
awe: [x] n. 敬畏;畏怯;(壮观等引起的)惊叹,惊奇;  vt. 使敬畏,令人敬畏,使充满畏惧; [acc] /ɔː/; [or]sat;
assuage: [x] v. 缓和,减轻;  n. 缓和,减轻;减轻.的人; [acc] /əˈsweɪdʒ/; [or]sat;
accost: [x] v. 搭讪;引诱;面对;勾引; [acc] /əˈkɔːst/; [or]sat;
inordinate: [x] adj. 过度的,无节制的;紊乱的; [acc] /ɪnˈɔːrdɪnət/; [or]sat;
histrionic: [x] adj. 戏剧的,装腔作势的,作戏的;  n. 演员;戏剧表演;舞台艺术;戏剧似的言行; [acc] /ˌhɪstriˈɑːnɪk/; [or]sat;
rancid: [x] adj. 腐臭的;令人作呕的,讨厌的; [acc] /ˈrænsɪd/; [or]sat;
taut: [x] adj. 拉紧的;紧张的;整洁的; [acc] /tɔːt/; [or]sat;
quibble: [x] n. 谬论;双关语;遁辞;  v. 诡辩;挑剔;说模棱两可的话; [acc] /ˈkwɪbl/; [or]sat;
disheveled: [x] adj. 不整洁的;凌乱的;  v. 使(头发等)蓬松; [acc] /dɪ'ʃevəld/; [or]sat;
misdemeanor: [x] n. 轻罪,品行不端; [acc] /ˌmɪsdɪ'miːnə/; [or]sat;
inadvertently: [x] adv. 不经意地;不经意的; [acc] /ˌɪnədˈvɜːrtəntli/; [or]sat;
prophetic: [x] adj. 预言的,预示的; [acc] /prəˈfetɪk/; [or]sat;
swindler: [x] n. 骗子; [acc] /ˈswɪndlər/; [or]sat;
bastion: [x] n. 堡垒;棱堡; [acc] /ˈbæstiən/; [or]sat;
catapult: [x] n. 弹弓;石弩;飞机弹射器;(飞机上的)座椅弹射器;  v. 用弹弓射;用弹射器发射;猛投;快速移动; [acc] /ˈkætəpʌlt/; [or]sat;
annals: [x] n. 年报;年鉴; [acc] /ˈænlz/; [or]sat;
nonplus: [x] v. 使窘困;使迷惑;狼狈不堪;  n. 迷惑,困惑; [acc] /ˌnɒn'plʌs/; [or]sat;
canny: [x] adj. 精明的,谨慎的,节约的;  adv. <苏格兰>仔细地; [acc] /ˈkæni/; [or]sat;
blatant: [x] adj. 喧哗的;露骨的;公然的;明目张胆的; [acc] /ˈbleɪtnt/; [or]sat;
taciturn: [x] adj. 沉默寡言的; [acc] /ˈtæsɪtɜːrn/; [or]sat;
torso: [x] n. (人体的)躯干,躯干像; [acc] /ˈtɔːrsoʊ/; [or]sat;
chronicle: [x] n. 编年史,年代记,记录;  v. 记录,把.载入编年史; [acc] /ˈkrɑːnɪkl/; [or]sat;
enamored: [x] adj. 迷恋的;倾心的; [acc] /ɪˈnæmə(r)d/; [or]sat;
rebuff: [x] n. 断然拒绝,回绝,漠不关心;  v. 断然拒绝; [acc] /rɪˈbʌf/; [or]sat;
jaded: [x] adj. 疲倦的,精疲力竭的;厌倦的; [acc] /ˈdʒeɪdɪd/; [or]sat;
fluency: [x] n. 流畅,流利; [acc] /ˈfluːənsi/; [or]sat;
invulnerable: [x] adj. 无法伤害的;无懈可击的; [acc] /ɪnˈvʌlnərəbl/; [or]sat;
simian: [x] n. 类人猴,猴子;  adj. 猿的,猴的; [acc] /ˈsɪmiən/; [or]sat;
lampoon: [x] n. 讽刺文章;  v. 讽刺,写文章讽刺; [acc] /læmˈpuːn/; [or]sat;
paean: [x] n. 欢乐颂,赞美歌; [acc] /ˈpiːən/; [or]sat;
pertinacious: [x] adj. 顽固的,执拗的; [acc] /ˌpɜːrtnˈeɪʃəs/; [or]sat;
palpable: [x] adj. 明显的,易觉察的,可触知的; [acc] /ˈpælpəbl/; [or]sat;
hoard: [x] v. 贮藏,秘藏;  n. 贮藏物; [acc] /hɔːrd/; [or]sat;
unctuous: [x] adj. 油腔滑调的,虚情假意的; [acc] /ˈʌŋktʃuəs/; [or]sat;
impassive: [x] adj. 无动于衷的,冷漠的; [acc] /ɪmˈpæsɪv/; [or]sat;
deploy: [x] v. 部署,设置;展开,散开; [acc] /dɪˈplɔɪ/; [or]sat;
coronation: [x] n. 加冕,加冕礼; [acc] /ˌkɔːrəˈneɪʃn/; [or]sat;
reprisal: [x] n. 报复;报复性劫掠; [acc] /rɪˈpraɪzl/; [or]sat;
blighted: [x] adj. 完蛋了的,生病了的; [acc] /ˈblaɪtɪd/; [or]sat;
definitive: [x] adj. 可靠的,明确的,权威的;决定性的; [acc] /dɪˈfɪnətɪv/; [or]sat;
stanch: [x] v. 制止(血液),止住;  adj. 坚固的;坚定的;可靠的;不漏水的; [acc] /stɔːntʃ/; [or]sat;
swarthy: [x] adj. (皮肤等)黝黑的; [acc] /ˈswɔːrði/; [or]sat;
remission: [x] n. 缓解;宽恕;豁免; [acc] /rɪˈmɪʃn/; [or]sat;
uncanny: [x] adj. 神秘的,不可思议的; [acc] /ʌnˈkæni/; [or]sat;
regale: [x] v. 盛情款待,享用,享受;  n. 盛宴,佳肴,款待; [acc] /rɪˈɡeɪl/; [or]sat;
prank: [x] n. 恶作剧,玩笑; [acc] /præŋk/; [or]sat;
domicile: [x] n. 住宅;永久居住地;期票支付场所;  v. 居住;使在指定的场所支付(期票等;  adj. 定居;在固定住所生活; [acc] /ˈdɑːmɪsaɪl/; [or]sat;
menial: [x] adj. 仆人的,乏味的;  n. 家仆; [acc] /ˈmiːniəl/; [or]sat;
dregs: [x] n. 渣滓;少量;沉淀物; [acc] /dreɡz/; [or]sat;
gnarled: [x] adj. 多节的,粗糙的;多瘤的;弯曲的; [acc] /nɑːrld/; [or]sat;
abject: [x] adj. 糟糕透顶的;可怜的,不幸的; [acc] /ˈæbdʒekt/; [or]sat;
reactionary: [x] adj. 保守的,反动的;  n. 反动分子; [acc] /riˈækʃəneri/; [or]sat;
supercilious: [x] adj. 目中无人的,高傲的; [acc] /ˌsuːpərˈsɪliəs/; [or]sat;
effrontery: [x] n. 厚颜无耻; [acc] /ɪˈfrʌntəri/; [or]sat;
dapper: [x] adj. 干净利落的,衣冠楚楚的; [acc] /ˈdæpər/; [or]sat;
bilk: [x] v. 骗; [acc] /bɪlk/; [or]sat;
chassis: [x] n. 底盘; [acc] /ˈʃæsi/; [or]sat;
sunder: [x] v. 切开;分裂,分离; [acc] /ˈsʌndər/; [or]sat;
paroxysm: [x] n. 突发,阵发;  adj. 发作性的,爆发性的; [acc] /ˈpærəksɪzəm/; [or]sat;
ecstasy: [x] n. 狂喜,心醉神怡; [acc] /ˈekstəsi/; [or]sat;
indigent: [x] adj. 贫困的,贫穷的; [acc] /ˈɪndɪdʒənt/; [or]sat;
temerity: [x] n. 鲁莽,大胆,蛮勇; [acc] /təˈmerəti/; [or]sat;
loiter: [x] v. 虚度,闲荡,徘徊,走走停停; [acc] /ˈlɔɪtər/; [or]sat;
extrovert: [x] v. 变成外向性格;使成外向性格;  n. 性格外向者;  adj. 性格外向的; [acc] /ˈekstrəvɜːrt/; [or]sat;
feint: [x] v. 佯攻,虚击;  n. 佯攻;  adj. 虚假的; [acc] /feɪnt/; [or]sat;
adulterate: [x] v. 掺假;  adj. 通奸的;搀杂的;  n. 掺假; [acc] /əˈdʌltəreɪt/; [or]sat;
moribund: [x] adj. 濒临失败的,垂死的;  n. 垂死的人; [acc] /ˈmɔːrɪbʌnd/; [or]sat;
downcast: [x] adj. 意志消沉的,垂头丧气的,朝下的;  n. 没落;俯视;[地]下落;[矿]通风井; [acc] /ˈdaʊnkæst/; [or]sat;
derelict: [x] adj. 渎职的,荒废的,被弃置的;  n. 失业贫穷的无家可归者; [acc] /ˈderəlɪkt/; [or]sat;
assay: [x] n. 化验,试验;  v. 分析,化验,鉴定; [acc] /əˈseɪ/; [or]sat;
amnesty: [x] n. 赦免;  v. 对.实行大赦; [acc] /ˈæmnəsti/; [or]sat;
fiasco: [x] n. 大失败,惨败; [acc] /fiˈæskoʊ/; [or]sat;
piebald: [x] adj. 花斑的;杂色的; [acc] /ˈpaɪbɔːld/; [or]sat;
verdant: [x] adj. 青葱的,翠绿的; [acc] /ˈvɜːrdnt/; [or]sat;
mystify: [x] v. 使神秘化,使迷惑,使困惑; [acc] /ˈmɪstɪfaɪ/; [or]sat;
kaleidoscope: [x] n. 万花筒;千变万化; [acc] /kəˈlaɪdəskoʊp/; [or]sat;
prescience: [x] n. 先见;预知; [acc] /ˈpresiəns/; [or]sat;
acquiesce: [x] v. 默许;勉强同意;  adj. 默认的; [acc] /ˌækwiˈes/; [or]sat;
desiccate: [x] v. (使)完全干涸,脱水; [acc] /'desɪˌkeɪt/; [or]sat;
grimace: [x] v. 做鬼脸,面部歪扭;  n. 愁眉苦脸,怪相,鬼脸; [acc] /ˈɡrɪməs/; [or]sat;
immutable: [x] adj. 永远不变的,永恒的; [acc] /ɪˈmjuːtəbl/; [or]sat;
incarnation: [x] n. 赋与肉体,具人形,化身; [acc] /ˌɪnkɑːrˈneɪʃn/; [or]sat;
pithy: [x] adj. 精练的,简洁有力的,多髓的; [acc] /ˈpɪθi/; [or]sat;
orgy: [x] n. 狂欢;放荡; [acc] /ˈɔːrdʒi/; [or]sat;
gist: [x] n. 主旨,要点;依据; [acc] /dʒɪst/; [or]sat;
clientele: [x] n. 顾客,常客; [acc] /ˌklaɪənˈtel/; [or]sat;
garnish: [x] v. 装饰(于食品上);  n. 为增加色香味而添加的配菜;装饰品; [acc] /ˈɡɑːrnɪʃ/; [or]sat;
servile: [x] adj. 奴颜婢膝的,卑屈的,隶属的;  n. 奴隶; [acc] /ˈsɜːrvl/; [or]sat;
bemused: [x] adj. 困惑的,发呆的; [acc] /bɪˈmjuːzd/; [or]sat;
personable: [x] adj. 英俊的,风度好的; [acc] /ˈpɜːrsənəbl/; [or]sat;
discomfit: [x] v. 挫败,扰乱,破坏,使.为难; [acc] /dɪsˈkʌmfɪt/; [or]sat;
obsequious: [x] adj. 逢迎的,谄媚的; [acc] /əbˈsiːkwiəs/; [or]sat;
inscrutable: [x] adj. 高深莫测的,神秘的; [acc] /ɪnˈskruːtəbl/; [or]sat;
resilient: [x] adj. 能复原的,弹回的,有弹性的; [acc] /rɪˈzɪliənt/; [or]sat;
ancillary: [x] adj. 辅助的,副的;  n. 助手;辅助设备; [acc] /ˈænsəleri/; [or]sat;
cherubic: [x] adj. 可爱的;天使的;无邪的; [acc] /tʃəˈruːbɪk/; [or]sat;
traumatic: [x] adj. (精神)受创伤的,外伤的; [acc] /traʊˈmætɪk/; [or]sat;
profligate: [x] adj. 放荡的;不检点的;恣意挥霍的;  n. 放荡的人,浪子,肆意挥霍者; [acc] /ˈprɑːflɪɡət/; [or]sat;
betroth: [x] v. 同.订婚,许配; [acc] /bɪ'trɔːθ/; [or]sat;
temporize: [x] v. 拖延,妥协,顺应时势,迎合潮流; [acc] /ˈtempəraɪz/; [or]sat;
ebullient: [x] adj. 热情洋溢的,沸腾的; [acc] /ɪˈbʌliənt/; [or]sat;
tutelage: [x] n. 监护,指导; [acc] /ˈtuːtəlɪdʒ/; [or]sat;
gauche: [x] adj. 笨拙的,不会社交的,偏转的; [acc] /ɡoʊʃ/; [or]sat;
enervate: [x] v. 使虚弱;使无力; [acc] /ˈenərveɪt/; [or]sat;
churlish: [x] adj. 脾气暴躁的;没有礼貌的; [acc] /ˈtʃɜːrlɪʃ/; [or]sat;
vampire: [x] n. 吸血鬼; [acc] /ˈvæmpaɪər/; [or]sat;
axiom: [x] n. 公理,定理; [acc] /ˈæksiəm/; [or]sat;
servitude: [x] n. 劳役,奴役; [acc] /ˈsɜːrvətuːd/; [or]sat;
turgid: [x] adj. 肿胀的;浮夸的;浮肿的; [acc] /ˈtɜːrdʒɪd/; [or]sat;
pall: [x] n. 幕;棺罩;遮盖物;  v. 覆盖;使乏味;走味; [acc] /pɔːl/; [or]sat;
emissary: [x] n. 代理,信使,使者; [acc] /ˈemɪseri/; [or]sat;
caption: [x] n. (报刊的)标题;(插图,照片等的)说明文字;  v. 给(图片,照片等)加说明文字; [acc] /ˈkæpʃn/; [or]sat;
prehensile: [x] adj. 适于抓握的;善于领会的; [acc] /prɪˈhensl/; [or]sat;
testy: [x] adj. 性急的,暴躁的; [acc] /ˈtesti/; [or]sat;
bevy: [x] n. 一群(少女或鸟); [acc] /ˈbevi/; [or]sat;
anomalous: [x] adj. 反常的,不规则的,不恰当的; [acc] /əˈnɑːmələs/; [or]sat;
imprudent: [x] adj. 轻率的,鲁莽的; [acc] /ɪmˈpruːdnt/; [or]sat;
encomium: [x] n. 赞美; [acc] /enˈkoʊmiəm/; [or]sat;
debilitate: [x] v. 使衰弱; [acc] /dɪˈbɪlɪteɪt/; [or]sat;
outwit: [x] v. 以机智胜过; [acc] /ˌaʊtˈwɪt/; [or]sat;
ballast: [x] n. (船等)压舱物;稳定因素;<比喻>沉着;  vt. 给某物装上压舱物;给.铺道渣;使稳定;使沉着; [acc] /ˈbæləst/; [or]sat;
insurrection: [x] n. 造反,叛乱; [acc] /ˌɪnsəˈrekʃn/; [or]sat;
petulant: [x] adj. 性急的,易怒的,爱闹气的; [acc] /ˈpetʃələnt/; [or]sat;
adventitious: [x] adj. 外来的,偶然的; [acc] /ˌædvenˈtɪʃəs/; [or]sat;
blurt: [x] v. 突然说出,冲动地说; [acc] /blɜːrt/; [or]sat;
depravity: [x] n. n. 恶劣行为;堕落,腐败,邪恶;腐败;邪恶;恶劣行为,腐化堕落的行为; [acc] /dɪˈprævəti/; [or]sat;
enormity: [x] n. 巨大;暴行;极恶; [acc] /ɪˈnɔːrməti/; [or]sat;
epitaph: [x] n. 碑文,墓志铭; [acc] /ˈepɪtæf/; [or]sat;
meddlesome: [x] adj. 爱管闲事的,好事的,好插手的; [acc] /ˈmedlsəm/; [or]sat;
disfigure: [x] v. 损伤外貌,使变丑; [acc] /dɪsˈfɪɡjər/; [or]sat;
ossify: [x] v. 硬化,骨化; [acc] /ˈɑːsɪfaɪ/; [or]sat;
cornucopia: [x] n. 象征丰收的羊角;装满花果及谷穗表丰饶的羊角状物;丰饶的象征; [acc] /ˌkɔːrnjuˈkoʊpiə/; [or]sat;
welter: [x] n. 混乱;滚浪;翻滚;起伏;  v. 翻滚;沉溺;起伏;  adj. 负重赛马的; [acc] /ˈweltər/; [or]sat;
alacrity: [x] n. 反应迅速,乐意; [acc] /əˈlækrəti/; [or]sat;
pseudonym: [x] n. 笔名,假名; [acc] /ˈsuːdənɪm/; [or]sat;
billowing: [x] adj. 波涛翻滚; [acc] /ˈbɪloʊɪŋ/; [or]sat;
stricture: [x] n. 谴责;严厉;束缚; [acc] /ˈstrɪktʃər/; [or]sat;
certitude: [x] n. 确实;确信;必然性; [acc] /ˈsɜːrtɪtuːd/; [or]sat;
protean: [x] adj. 变化多端的,能够变化的; [acc] /ˈproʊtiən/; [or]sat;
tremulous: [x] adj. 胆小的,颤动的,不安的; [acc] /ˈtremjələs/; [or]sat;
simile: [x] n. 直喻,明喻; [acc] /ˈsɪməli/; [or]sat;
volition: [x] n. 决定;自主;意志力;下决心;意志力; [acc] /voʊˈlɪʃn/; [or]sat;
torrid: [x] adj. 酷热的,热烈; [acc] /ˈtɔːrɪd/; [or]sat;
nonchalance: [x] n. 无动于衷,冷淡; [acc] /ˌnɑːnʃəˈlɑːns/; [or]sat;
mentor: [x] n. 导师,指导;  vt. 做.的良师;指导; [acc] /ˈmentɔːr/; [or]sat;
celibate: [x] n. 独身者,独身主义者;  adj. 独身的,未婚的,禁欲的; [acc] /ˈselɪbət/; [or]sat;
upbraid: [x] v. 斥责,责骂; [acc] /ʌpˈbreɪd/; [or]sat;
omnivorous: [x] adj. 杂食的,兴趣广泛的; [acc] /ɑːmˈnɪvərəs/; [or]sat;
solemnity: [x] n. 庄严,肃穆,庄严的仪式; [acc] /səˈlemnəti/; [or]sat;
painstaking: [x] adj. (不辞)劳苦的,辛勤的;  n. 辛劳,煞费苦心; [acc] /ˈpeɪnzteɪkɪŋ/; [or]sat;
quizzical: [x] adj. 困惑的,引人发笑的,嘲弄的,探询的;  adv. 疑问地,戏弄地; [acc] /ˈkwɪzɪkl/; [or]sat;
doctrinaire: [x] adj. 教条主义的,空谈理论的;  n. 空论家,纯理论家; [acc] /ˌdɑːktrəˈner/; [or]sat;
extenuate: [x] v. 减轻,低估,为.找借口,使人原谅; [acc] /ɪk'stenjʊˌeɪt/; [or]sat;
incontrovertible: [x] adj. 无可争议的; [acc] /ˌɪnkɑːntrəˈvɜːrtəbl/; [or]sat;
amalgamate: [x] v. 合并,混合; [acc] /əˈmælɡəmeɪt/; [or]sat;
fallacious: [x] adj. 谬误的,易误解的,虚妄的; [acc] /fəˈleɪʃəs/; [or]sat;
altruistic: [x] adj. 利他的;无私心的; [acc] /ˌæltruˈɪstɪk/; [or]sat;
bard: [x] n. 吟游诗人; [acc] /bɑːrd/; [or]sat;
vignette: [x] n. 装饰图案;小插图;  v. 把..印放为虚光照,晕映; [acc] /vɪnˈjet/; [or]sat;
mendacious: [x] adj. 撒谎的,虚假的; [acc] /menˈdeɪʃəs/; [or]sat;
abscond: [x] v. 逃匿,潜逃;避债; [acc] /əbˈskɑːnd/; [or]sat;
fluke: [x] n. 侥幸成功;意外的挫折;  v. 侥幸做成;意外受挫; [acc] /fluːk/; [or]sat;
sartorial: [x] adj. 裁缝匠的,裁缝的;缝纫的; [acc] /sɑːrˈtɔːriəl/; [or]sat;
askew: [x] adj. 歪斜的;  adv. 歪斜地,斜地; [acc] /əˈskjuː/; [or]sat;
lackluster: [x] n. 无光泽;暗淡;  adj. 无光泽的;平凡的; [acc] /ˈlækˌlʌstər/; [or]sat;
stupefy: [x] v. (使)茫然,吓呆; [acc] /ˈstuːpɪfaɪ/; [or]sat;
fetid: [x] adj. 有恶臭的; [acc] /ˈfetɪd/; [or]sat;
tempestuous: [x] adj. 有暴风雨的,暴乱的,剧烈的; [acc] /temˈpestʃuəs/; [or]sat;
beleaguer: [x] v. 围攻; [acc] /bɪ'liːgə/; [or]sat;
cajole: [x] v. 以甜言蜜语哄骗,勾引; [acc] /kəˈdʒoʊl/; [or]sat;
demented: [x] adj. 发狂的,精神错乱的;  v. 精神错乱;变得痴呆; [acc] /dɪˈmentɪd/; [or]sat;
indisputable: [x] adj. 没有争论余地,非常清楚的; [acc] /ˌɪndɪˈspjuːtəbl/; [or]sat;
astigmatism: [x] n. 散光; [acc] /əˈstɪɡmətɪzəm/; [or]sat;
acclimate: [x] v. 服水土,适应新环境; [acc] /ˈækləmeɪt/; [or]sat;
flagrant: [x] adj. 罪恶昭彰的,残暴的,丑恶可耻的,明目张胆的; [acc] /ˈfleɪɡrənt/; [or]sat;
piety: [x] n. 虔诚,虔诚的行为或语言; [acc] /ˈpaɪəti/; [or]sat;
euphemism: [x] n. 婉言,委婉的说法; [acc] /ˈjuːfəmɪzəm/; [or]sat;
mellifluous: [x] adj. (曲调)优美的;流畅的;如蜜般的; [acc] /meˈlɪfluəs/; [or]sat;
raiment: [x] n. 衣服; [acc] /ˈreɪmənt/; [or]sat;
unsightly: [x] adj. 难看的; [acc] /ʌnˈsaɪtli/; [or]sat;
singular: [x] adj. 单独的,单个的;奇怪的;非凡的,卓越的,显著的;  n. 单数;单数形式; [acc] /ˈsɪŋɡjələr/; [or]sat;
surreptitious: [x] adj. 鬼鬼祟祟的,暗中的,秘密的; [acc] /ˌsɜːrəpˈtɪʃəs/; [or]sat;
sensual: [x] adj. 感官的;色情的,肉欲的; [acc] /ˈsenʃuəl/; [or]sat;
rapt: [x] adj. 全神贯注的,着迷的;狂喜的; [acc] /ræpt/; [or]sat;
tendentious: [x] adj. 有偏见的,有倾向的;宣传性的;  adv. 宣传性地,不公平地,有倾向性地;  n. 倾向性小说; [acc] /tenˈdenʃəs/; [or]sat;
imperceptible: [x] adj. 极细微的,觉察不到的,感觉不到的,; [acc] /ˌɪmpərˈseptəbl/; [or]sat;
antipathy: [x] n. 反感,厌恶,憎恶; [acc] /ænˈtɪpəθi/; [or]sat;
epigram: [x] n. 机智的言语; [acc] /ˈepɪɡræm/; [or]sat;
queasy: [x] adj. 呕吐的;不稳定的; [acc] /ˈkwiːzi/; [or]sat;
bludgeon: [x] v. 用棍棒击打;恫吓;  n. 大头狼牙棒; [acc] /ˈblʌdʒən/; [or]sat;
repugnant: [x] adj. 令人厌恶的; [acc] /rɪˈpʌɡnənt/; [or]sat;
soliloquy: [x] n. 自言自语,独白; [acc] /səˈlɪləkwi/; [or]sat;
aplomb: [x] n. 沉着,镇静; [acc] /əˈplɑːm/; [or]sat;
hallowed: [x] adj. 神圣的; [acc] /ˈhæloʊd/; [or]sat;
vacuous: [x] adj. 空的,空虚的,空洞的,无意义的; [acc] /ˈvækjuəs/; [or]sat;
forsake: [x] v. 放弃;抛弃,离开; [acc] /fərˈseɪk/; [or]sat;
politic: [x] adj. 策略性的,政治上的,国家的; [acc] /ˈpɑːlətɪk/; [or]sat;
retribution: [x] n. 报应,惩罚,报答,报偿; [acc] /ˌretrɪˈbjuːʃn/; [or]sat;
blanch: [x] v. 变白;漂白;  n. 铅矿石;  adj. 漂白的;银白色的; [acc] /blæntʃ/; [or]sat;
gait: [x] n. 步态,步法,速度; [acc] /ɡeɪt/; [or]sat;
exculpate: [x] v. 声明无罪,开脱,使无罪; [acc] /ˈekskʌlpeɪt/; [or]sat;
candor: [x] n. 坦白,直率,诚挚; [acc] /'kændə/; [or]sat;
abstemious: [x] adj. (吃喝等)有节制的,节俭的; [acc] /əbˈstiːmiəs/; [or]sat;
scurry: [x] v. 快速疾走,急跑,急躁不安地来回走动;  n. 快步急跑;疾走;仓皇奔跑声;骤雨; [acc] /ˈskɜːri/; [or]sat;
recalcitrant: [x] adj. 顽抗的,不顺从的; [acc] /rɪˈkælsɪtrənt/; [or]sat;
unassuming: [x] adj. 谦逊的,不装腔作势的; [acc] /ˌʌnəˈsuːmɪŋ/; [or]sat;
incorrigible: [x] adj. 积习难改的,不可救药的; [acc] /ɪnˈkɔːrɪdʒəbl/; [or]sat;
disparage: [x] v. 蔑视;贬损; [acc] /dɪˈspærɪdʒ/; [or]sat;
obdurate: [x] adj. 固执的,冷酷无情的; [acc] /ˈɑːbdərət/; [or]sat;
punctilious: [x] adj. 一丝不苟的,精密细心的,拘泥形式的; [acc] /pʌŋkˈtɪliəs/; [or]sat;
abash: [x] v. 使局促不安;使羞愧;  adj. 窘迫的,尴尬的;  adv. 窘迫地,尴尬地;  n. 窘迫,尴尬; [acc] /ə'bæʃ/; [or]sat;
repercussion: [x] n. 反响;弹回;反射; [acc] /ˌriːpərˈkʌʃn/; [or]sat;
serenity: [x] n. 平静; [acc] /səˈrenəti/; [or]sat;
truncate: [x] adj. 截短的;被删节的;  v. 把(某物)截短,去尾; [acc] /ˈtrʌŋkeɪt/; [or]sat;
perpetrate: [x] vt. 犯罪,作恶;干坏事; [acc] /ˈpɜːrpətreɪt/; [or]sat;
luminary: [x] n. 杰出人物,发光体; [acc] /ˈluːmɪneri/; [or]sat;
verbatim: [x] adj. 逐字的;  adv. 逐字地; [acc] /vɜːrˈbeɪtɪm/; [or]sat;
cognitive: [x] adj. 认识能力的;认知的; [acc] /ˈkɑːɡnətɪv/; [or]sat;
jingoist: [x] n. 沙文主义者,侵略主义者; [acc] /dʒɪŋɡə'ʊɪst/; [or]sat;
entourage: [x] n. 随从,周围,环境; [acc] /ˈɑːnturɑːʒ/; [or]sat;
disjointed: [x] adj. 杂乱的,无逻辑的,脱节的; [acc] /dɪsˈdʒɔɪntɪd/; [or]sat;
disembark: [x] vi. 上岸,登陆,下车,下飞机;  vt. 使上岸;使登陆; [acc] /ˌdɪsɪmˈbɑːrk/; [or]sat;
swathe: [x] n. 带子,绷带;包装品;  vt. 包围;紧绑;裹; [acc] /sweɪð/; [or]sat;
preempt: [x] v. 制止,以先买权取得,取代;  n. 〔经〕优先占有; [acc] /priː'empt/; [or]sat;
impropriety: [x] n. 不当行为;不适当;不正确; [acc] /ˌɪmprəˈpraɪəti/; [or]sat;
brusque: [x] adj. 唐突的,直率的,无礼的; [acc] /brʌsk/; [or]sat;
waylay: [x] v. 埋伏,伏击; [acc] /weɪˈleɪ/; [or]sat;
apocryphal: [x] adj. 伪的;可疑; [acc] /əˈpɑːkrɪfl/; [or]sat;
despot: [x] n. 专制君主,暴君;独裁者; [acc] /ˈdespɑːt/; [or]sat;
obtuse: [x] adj. 迟钝的;圆头的;不锋利的; [acc] /əbˈtuːs/; [or]sat;
menagerie: [x] n. 形形色色,动物园,野生动物(总称); [acc] /məˈnædʒəri/; [or]sat;
bungle: [x] v. 办糟,失败;  n. 粗劣,失败,笨拙; [acc] /ˈbʌŋɡl/; [or]sat;
evanescent: [x] adj. 短暂的,容易消散的,(印象等)逐渐消失的,会凋零的; [acc] /ˌevəˈnesnt/; [or]sat;
staccato: [x] adj. (音乐)断音的,不连贯的;  n. 断奏;断续的一段音乐;不连贯的东西(如说话,发动机的声音等);  adv. 断音地;不连接地; [acc] /stəˈkɑːtoʊ/; [or]sat;
willful: [x] adj. 有意的,任性的,故意的; [acc] /ˈwɪlfl/; [or]sat;
hodgepodge: [x] n. 大杂烩,混煮,一团糟; [acc] /ˈhɑːdʒpɑːdʒ/; [or]sat;
impregnable: [x] adj. 攻不破的,征服不了的; [acc] /ɪmˈpreɡnəbl/; [or]sat;
cantankerous: [x] adj. 脾气坏的,好争吵的; [acc] /kænˈtæŋkərəs/; [or]sat;
luscious: [x] adj. 美味的;满足感官的; [acc] /ˈlʌʃəs/; [or]sat;
apotheosis: [x] n. 神化,典范,崇拜,颂扬; [acc] /əˌpɑːθiˈoʊsɪs/; [or]sat;
ellipsis: [x] n. 省略,省略符号; [acc] /ɪˈlɪpsɪs/; [or]sat;
[kk9: sat/2947]