conform: [x] vi. 一致;遵照,顺从;符合;  vt. 使一致;使遵照;  adj. 一致的; [acc] /kənˈfɔːrm/; [or]gmat;
fracture: [x] n. 骨折;折断;裂口;  v. 使折断;使骨折; [acc] /ˈfræktʃər/; [or]gmat;
appropriate: [x] adj. 合适的;适当的;  v. 挪用;拨款;私占; [acc] /əˈproʊpriət/; [or]gmat;
aspire: [x] vi. 渴望,有志于(与to,for,after连用或后接不定式); [acc] /əˈspaɪər/; [or]gmat;
appliance: [x] n. 家用器具;家用电器;装置;应用; [acc] /əˈplaɪəns/; [or]gmat;
exonerate: [x] v. 使免罪; [acc] /ɪɡˈzɑːnəreɪt/; [or]gmat;
tropical: [x] adj. 热带的; [acc] /ˈtrɑːpɪkl/; [or]gmat;
tag: [x] n. 附加语;标签;  v. 装包头于(鞋带等);加标签于;连接,合并; [acc] /tæɡ/; [or]gmat;
biography: [x] n. 传记文学,传记; [acc] /baɪˈɑːɡrəfi/; [or]gmat;
detach: [x] v. 使分开,拆卸;派遣; [acc] /dɪˈtætʃ/; [or]gmat;
facilitate: [x] v. 为他人提供方便;使便利;  vt. 促进; [acc] /fəˈsɪlɪteɪt/; [or]gmat;
neuron: [x] n. 神经元,神经细胞; [acc] /ˈnʊrɑːn/; [or]gmat;
appeal: [x] vi. 呼吁,请求;申诉;有吸引力;  n. 呼吁;恳求;(为慈善或好的事业所做的) 筹款努力;(人或物的)吸引力; [acc] /əˈpiːl/; [or]gmat;
correspond: [x] v. 符合;相符,一致;通信; [acc] /ˌkɔːrəˈspɑːnd/; [or]gmat;
conversion: [x] n. 转变,转换;宗教,信仰上的转变;[经济学]兑换; [acc] /kənˈvɜːrʒn/; [or]gmat;
conduct: [x] v. 指挥;进行;实施;处理;传导(电,热等);护送;  n. 行为,举止;指挥,带领; [acc] /kənˈdʌkt/; [or]gmat;
context: [x] n. 上下文,语境;背景; [acc] /ˈkɑːntekst/; [or]gmat;
default: [x] n. 违约;缺席;缺乏;默认;  vi. 不履行义务;拖欠;  vt. 不履行;不参加; [acc] /dɪˈfɔːlt/; [or]gmat;
intense: [x] adj. 强烈的,激烈的;紧张的;认真的;热情的; [acc] /ɪnˈtens/; [or]gmat;
contemplate: [x] v. 沉思;对..周密考虑;注视; [acc] /ˈkɑːntəmpleɪt/; [or]gmat;
sedentary: [x] adj. 久坐不动的;静止的;坐惯的,定栖的; [acc] /ˈsednteri/; [or]gmat;
metaphor: [x] n. 暗喻,隐喻; [acc] /ˈmetəfər/; [or]gmat;
grim: [x] adj. 严酷的,无情的;令人沮丧的,令人失望的;讨厌的,糟糕的; [acc] /ɡrɪm/; [or]gmat;
leaven: [x] n. 发酵剂,影响力;  v. 发酵,影响,渐变; [acc] /ˈlevn/; [or]gmat;
potent: [x] adj. 强有力的;有权势的;有说服力的; [acc] /ˈpoʊtnt/; [or]gmat;
monarch: [x] n. 君主;帝王;统治者; [acc] /ˈmɑːnərk/; [or]gmat;
hail: [x] n. 冰雹;一阵;  v. 下冰雹;歌颂; [acc] /heɪl/; [or]gmat;
shed: [x] v. 流出(眼泪);蜕皮;脱落;使清晰;流下;去除,摆脱;  n. 棚屋; [acc] /ʃed/; [or]gmat;
eminent: [x] adj. 显赫的;杰出的;有名的;(品质)优良的; [acc] /ˈemɪnənt/; [or]gmat;
succumb: [x] v. 屈从,屈服,因.死亡(to); [acc] /səˈkʌm/; [or]gmat;
pharmaceutical: [x] adj. 制药的,药物的;  n. 药物; [acc] /ˌfɑːrməˈsuːtɪkl/; [or]gmat;
allowance: [x] v. 定量供应(食物,饮料等物品);配给;  n. 零用钱;津贴,补贴;限额;免税额;允许,容忍,让步;考虑; [acc] /əˈlaʊəns/; [or]gmat;
pinpoint: [x] v. 准确地解释或说明;  adj. 精确的;  n. 针尖,极小之物,极不重要的事物; [acc] /ˈpɪnpɔɪnt/; [or]gmat;
diverse: [x] adj. 不同的,差异的,多种多样的; [acc] /daɪˈvɜːrs/; [or]gmat;
prime number: [x] phr. 质数; [acc] /ˌpraɪm ˈnʌmbər/; [or]gmat;
entitle: [x] v. 给(书)题名;给予.权利; [acc] /ɪnˈtaɪtl/; [or]gmat;
overview: [x] n. 综述,概观; [acc] /ˈoʊvərvjuː/; [or]gmat;
fodder: [x] n. 饲料,草料;(创作的)素材;弹药;  v. 喂; [acc] /ˈfɑːdər/; [or]gmat;
methane: [x] n. [有化]甲烷,[能源]沼气; [acc] /ˈmeθeɪn/; [or]gmat;
assess: [x] v. 评估;估值; [acc] /əˈses/; [or]gmat;
gentry: [x] n. 人们(多用贬义),贵族们,(英)上流社会人士; [acc] /ˈdʒentri/; [or]gmat;
genuine: [x] adj. 真正的;真的;真诚的; [acc] /ˈdʒenjuɪn/; [or]gmat;
deluge: [x] n. 洪水;暴雨;泛滥;  v. 使泛滥;压倒; [acc] /ˈdeljuːdʒ/; [or]gmat;
errand: [x] n. 差使;差事;使命; [acc] /ˈerənd/; [or]gmat;
resent: [x] v. 愤恨; [acc] /rɪˈzent/; [or]gmat;
livestock: [x] n. 家畜,牲畜; [acc] /ˈlaɪvstɑːk/; [or]gmat;
pluralistic: [x] adj. 兼职的,［哲］多元论的; [acc] /ˌplʊərə'lɪstɪk/; [or]gmat;
snapdragon: [x] n. ［植］金鱼草属植物,金鱼草; [acc] /ˈsnæpdræɡən/; [or]gmat;
possess: [x] v. 拥有,占有;缠住,迷住;支配; [acc] /pəˈzes/; [or]gmat;
deplete: [x] v. 使大大减少;耗尽,用尽; [acc] /dɪˈpliːt/; [or]gmat;
parish: [x] n. 教区; [acc] /ˈpærɪʃ/; [or]gmat;
sympathetic: [x] adj. 有同情心的,同情的;支持的;称心的; [acc] /ˌsɪmpəˈθetɪk/; [or]gmat;
resolve: [x] n. 决心;  v. 解决,决定,表决; [acc] /rɪˈzɑːlv/; [or]gmat;
elicit: [x] v. 引出;诱出;探出; [acc] /iˈlɪsɪt/; [or]gmat;
interact: [x] v. 交流,沟通,互动;互相作用,互相影响; [acc] /ˌɪntərˈækt/; [or]gmat;
expulsion: [x] n. 驱逐;开除; [acc] /ɪkˈspʌlʃn/; [or]gmat;
motion: [x] n. 运动,移动;手势;提议;  v. 示意; [acc] /ˈmoʊʃn/; [or]gmat;
retard: [x] v. 延迟,使减速;  n. 妨碍,阻碍; [acc] /rɪˈtɑːrd/; [or]gmat;
prudent: [x] adj. 谨慎的,精明的; [acc] /ˈpruːdnt/; [or]gmat;
supersede: [x] v. 代替;紧接着而到来; [acc] /ˌsuːpərˈsiːd/; [or]gmat;
saline: [x] adj. 咸的,含盐的; [acc] /ˈseɪliːn/; [or]gmat;
glacier: [x] n. 冰川,冰河; [acc] /ˈɡleɪʃər/; [or]gmat;
martial: [x] adj. 武术的;好战的;军事的; [acc] /ˈmɑːrʃl/; [or]gmat;
vacuum: [x] n. 真空吸尘器;真空;空虚,茫然若失;  v. 用吸尘器打扫; [acc] /ˈvækjuəm/; [or]gmat;
preservative: [x] n. 防腐剂;预防法;防护层;  adj. 有保存力的;防腐的;有保存力的;有保护性的; [acc] /prɪˈzɜːrvətɪv/; [or]gmat;
illegal: [x] adj. 不合法的,非法的;  n. 非法移民,非法劳工;间谍; [acc] /ɪˈliːɡl/; [or]gmat;
subconscious: [x] adj. 下意识的;  n. 潜意识; [acc] /ˌsʌbˈkɑːnʃəs/; [or]gmat;
apparent: [x] adj. 显然的,明白的,清晰可见的;表面上的,貌似(真实)的; [acc] /əˈpærənt/; [or]gmat;
excise: [x] v. 切除,删去;  n. 消费税,货物税,国产税; [acc] /ˈeksaɪz/; [or]gmat;
accidental: [x] adj. 偶然的,意外的;非本质的; [acc] /ˌæksɪˈdentl/; [or]gmat;
vicious: [x] adj. 罪恶的;恶意的;凶猛的,残忍的; [acc] /ˈvɪʃəs/; [or]gmat;
stationary: [x] adj. 静止的;固定的;  n. 定居者,驻军; [acc] /ˈsteɪʃəneri/; [or]gmat;
lag: [x] n. 落后,延迟;  v. 落后;缓慢进行,减退; [acc] /læɡ/; [or]gmat;
peripheral: [x] adj. 外围的;  n. 外围设备; [acc] /pəˈrɪfərəl/; [or]gmat;
endowment: [x] n. 捐赠,捐助,捐款;(人的)天赋,天资; [acc] /ɪnˈdaʊmənt/; [or]gmat;
concentrate: [x] v. 全神贯注于,集中于;浓缩;  n. 浓缩物; [acc] /ˈkɑːnsntreɪt/; [or]gmat;
dialect: [x] n. 方言;语调;  adj. 方言的; [acc] /ˈdaɪəlekt/; [or]gmat;
fade: [x] vi. 褪色,褪去;失去;逐渐消失;  vt. 使褪色;  n. 淡入,淡出;  adj. 乏味的; [acc] /feɪd/; [or]gmat;
optimal: [x] adj. 最佳的,最理想的; [acc] /ˈɑːptɪməl/; [or]gmat;
pledge: [x] v. 发誓,保证,以.抵押,向.祝酒;  n. 保证,誓言; [acc] /pledʒ/; [or]gmat;
sculpture: [x] n. 雕刻艺术;雕刻,雕塑; [acc] /ˈskʌlptʃər/; [or]gmat;
radiant: [x] adj. 光芒四射的,绚丽的;喜悦的; [acc] /ˈreɪdiənt/; [or]gmat;
protoplasm: [x] n. 原生质,原浆,细胞质;  adj. 〈生〉原生质的; [acc] /ˈproʊtəplæzəm/; [or]gmat;
overall: [x] adj. 全面的,全部的;  n. 罩衫,工装裤;  adv. 总的来说;总共; [acc] /ˌoʊvərˈɔːl/; [or]gmat;
interfere: [x] v. 干涉,妨碍;妨碍;干涉;  vi. 妨碍; [acc] /ˌɪntərˈfɪr/; [or]gmat;
coriander: [x] n. ［植］芫荽,香菜; [acc] /ˌkɔːriˈændər/; [or]gmat;
crunch: [x] n. 嘎吱嘎吱的声音;  vt. 嘎吱嘎吱地咀嚼;  vi. 嘎吱嘎吱地咀嚼;嘎吱嘎吱地动;发嘎吱嘎吱声; [acc] /krʌntʃ/; [or]gmat;
proceeds: [x] n. 收入;  v. 进行;前进;(沿特定路线)行进;(尤指打断后)继续说; [acc] /ˈproʊsiːdz/; [or]gmat;
segment: [x] n. 部分;片段;(橘子等的)瓣;  v. 分割; [acc] /ˈseɡmənt/; [or]gmat;
collective: [x] adj. 集体的,共同的;  n. 集体; [acc] /kəˈlektɪv/; [or]gmat;
ingenuity: [x] n. 机灵,心灵手巧,富于创造天赋; [acc] /ˌɪndʒəˈnuːəti/; [or]gmat;
psychotherapy: [x] n. 心理疗法,精神疗法; [acc] /ˌsaɪkoʊˈθerəpi/; [or]gmat;
anthology: [x] n. (诗,文,曲,画等的)选集; [acc] /ænˈθɑːlədʒi/; [or]gmat;
undertake: [x] v. 保证;承担,承包; [acc] /ˌʌndərˈteɪk/; [or]gmat;
standpoint: [x] n. 立场,观点; [acc] /ˈstændpɔɪnt/; [or]gmat;
positive: [x] adj. 积极的;肯定的,明确的;正面的;阳性的;  n. 正面;肯定;优点;正数; [acc] /ˈpɑːzətɪv/; [or]gmat;
mitigate: [x] v. 减轻,缓和; [acc] /ˈmɪtɪɡeɪt/; [or]gmat;
objective: [x] n. 目标;目的;  adj. 客观的; [acc] /əbˈdʒektɪv/; [or]gmat;
dubious: [x] adj. 可疑的;怀疑的;无把握的; [acc] /ˈduːbiəs/; [or]gmat;
ratio: [x] n. 比率,比例; [acc] /ˈreɪʃioʊ/; [or]gmat;
lunar: [x] adj. 月亮的; [acc] /ˈluːnər/; [or]gmat;
nominate: [x] v. 提名;任命;  adj. 有特定名字的;被提名的;被指定的; [acc] /ˈnɑːmɪneɪt/; [or]gmat;
pedagogical: [x] adj. 教育的;教学法的; [acc] /ˌpedəˈɡɑdʒɪk(ə)l/; [or]gmat;
treaty: [x] n. 条约;协议;协定; [acc] /ˈtriːti/; [or]gmat;
mint: [x] n. 薄荷,薄荷糖,造币厂;  v. 铸造(硬币); [acc] /mɪnt/; [or]gmat;
transform: [x] v. 将..变形,改变,转换; [acc] /trænsˈfɔːrm/; [or]gmat;
liability: [x] n. 责任;债务;倾向;可能性;不利因素;惹麻烦的人(或事); [acc] /ˌlaɪəˈbɪləti/; [or]gmat;
inherent: [x] adj. 内在的,固有的;生来就有的; [acc] /ɪnˈhɪrənt/; [or]gmat;
distribute: [x] v. 分发,分配,配送;散布; [acc] /dɪˈstrɪbjuːt/; [or]gmat;
overlord: [x] n. 封建领主; [acc] /ˈoʊvərlɔːrd/; [or]gmat;
consistency: [x] n. 连结,结合;坚固性;浓度,密度;一致性;连贯性; [acc] /kənˈsɪstənsi/; [or]gmat;
compile: [x] v. 收集,汇编; [acc] /kəmˈpaɪl/; [or]gmat;
round: [x] adj. 圆的,球形的;  n. 圆,圆形物;  adv. 围绕着,循环地;  v. 使成圆形;  prep. 围着,绕过,在周围; [acc] /raʊnd/; [or]gmat;
circle: [x] n. 周期;范围;圆圈;  v. 围绕; [acc] /ˈsɜːrkl/; [or]gmat;
circuit: [x] n. 电路,线路;巡游,环形; [acc] /ˈsɜːrkɪt/; [or]gmat;
era: [x] n. 时代,年代;纪元; [acc] /ˈɪrə/; [or]gmat;
subject: [x] n. 科目;主题;受试者;国民;  adj. 易患的,服从的;  vt. 使服从,使隶属,使遭遇; [acc] /ˈsʌbdʒɪkt/; [or]gmat;
circular: [x] adj. 圆形的;环形的;  n. 通知; [acc] /ˈsɜːrkjələr/; [or]gmat;
character: [x] n. 人物,角色;性格;(书写或印刷)符号,(汉)字;特点;人格,品性; [acc] /ˈkærəktər/; [or]gmat;
status: [x] n. 地位;状态;身份; [acc] /ˈsteɪtəs/; [or]gmat;
charter: [x] n. 宪章;特权,豁免权;契约,证书;租赁;  v. 包,租(飞机,汽车等);  adj. 包租的,租用的; [acc] /ˈtʃɑːrtər/; [or]gmat;
note: [x] n. 笔记,便条,注释;纸币;音符;  v. 注意,记录; [acc] /noʊt/; [or]gmat;
comment: [x] n. 评论,议论;批评,意见;注解;  vt. 评论;  vi. 进行评论;为.作评语; [acc] /ˈkɑːment/; [or]gmat;
pad: [x] n. 衬垫;护具;便笺簿;(动物的)脚;浮叶;  v. 填塞; [acc] /pæd/; [or]gmat;
circulation: [x] n. 流传,传播;发行,发行量;(体液的)循环;(水,空气等的)流通;(货币等的)流通; [acc] /ˌsɜːrkjəˈleɪʃn/; [or]gmat;
desire: [x] n. 渴望;欲望;愿望;要求;  vi. 有希望,期望,愿望;  vt. 希望,渴望;请求,要求; [acc] /dɪˈzaɪər/; [or]gmat;
length: [x] n. 长,长度,持续时间;一段 (绳子,布,木头等); [acc] /leŋθ/; [or]gmat;
faith: [x] n. 信任;信心;信仰;  int. 实在,确实; [acc] /feɪθ/; [or]gmat;
charge: [x] v. 充电,充值;索价;控告;向.冲去;  n. 费用;主管;控告; [acc] /tʃɑːrdʒ/; [or]gmat;
various: [x] adj. 各种各样的;不同的; [acc] /ˈveriəs/; [or]gmat;
particular: [x] adj. 特殊的;特定的;特别的;不寻常的;挑剔的;  n. 详细情况; [acc] /pərˈtɪkjələr/; [or]gmat;
evil: [x] adj. 邪恶的,罪恶的;  n. 邪恶,罪恶; [acc] /ˈiːvl/; [or]gmat;
property: [x] n. 房产;财产;特性;性能; [acc] /ˈprɑːpərti/; [or]gmat;
bound: [x] adj. 受约束的;有义务的;一定的;  v. 束缚;跳跃着前行;  n. 跳跃;范围;界限; [acc] /baʊnd/; [or]gmat;
authority: [x] n. 权威;威信;当局,官方;权力,职权; [acc] /əˈθɔːrəti/; [or]gmat;
spring: [x] n. 春天;弹簧,弹性;泉,泉源;跳跃;  v. 反弹,跳,跃,(使)跳起,(使)弹开;生长,涌出,跃出; [acc] /sprɪŋ/; [or]gmat;
produce: [x] v. 生产;创作;产生;  vi. 创作;生产;产生;  n. 农产品; [acc] /prəˈduːs/; [or]gmat;
domain: [x] n. 域名;领土;管区,势力圈; [acc] /doʊˈmeɪn/; [or]gmat;
religious: [x] adj. 宗教的;虔诚的; [acc] /rɪˈlɪdʒəs/; [or]gmat;
minute: [x] adj. 微小的;详细的;  n. 一分钟,瞬间;  v. 记录; [acc] /ˈmɪnɪt/; [or]gmat;
access: [x] n. 进入;使用权;通道;  v. 进入;访问; [acc] /ˈækses/; [or]gmat;
movement: [x] n. 动作,移动;运动;(交响乐)乐章; [acc] /ˈmuːvmənt/; [or]gmat;
rate: [x] n. 比率,率;速率;价格;频率;  v. 评估;认为; [acc] /reɪt/; [or]gmat;
species: [x] n. (单复同)物种;种类;人类;  adj. 物种上的; [acc] /ˈspiːʃiːz/; [or]gmat;
illuminate: [x] vt. 照亮;阐释;说明; [acc] /ɪˈluːmɪneɪt/; [or]gmat;
surface: [x] v. 浮上水面;显露;  n. 表面,面,水面;外表,外观;  adj. 表面的;水面的;外观的;(对高架及地下铁路说的)平地上的; [acc] /ˈsɜːrfɪs/; [or]gmat;
file: [x] n. 文件夹,档案,文件;  vi. 把文件归档,提交(申请等);  vt. 把(文件等)归档; [acc] /faɪl/; [or]gmat;
distribution: [x] n. 分布;分配;分发;散布; [acc] /ˌdɪstrɪˈbjuːʃn/; [or]gmat;
peculiar: [x] adj. 奇怪的,古怪的;特有的,特别的; [acc] /pɪˈkjuːliər/; [or]gmat;
secure: [x] adj. 安心的;安全的;  v. 使安全;保卫,保护;确保;获得; [acc] /səˈkjʊr/; [or]gmat;
stage: [x] n. 阶段;舞台;戏剧;  v. 举行;展现;上演;筹划;适于上演;适合在舞台上演出;乘公交车(或驿车)旅行;[军事]中间集结;扎营; [acc] /steɪdʒ/; [or]gmat;
claim: [x] v. 声称;要求;断言;主张;认领;索赔;  n. 索赔;主张;声称;断言;要求; [acc] /kleɪm/; [or]gmat;
mass: [x] n. 众多;大多数;[物]质量;群众;  adj. 大量的,大规模的;  v. 聚集; [acc] /mæs/; [or]gmat;
check: [x] v. 检查;阻止;  n. 支票;阻止;检查;阻止物; [acc] /tʃek/; [or]gmat;
divine: [x] adj. 神的,神圣的;极好的;  v. (凭直觉)发现,猜到;  n. 神学家;圣职人员;教士;上帝; [acc] /dɪˈvaɪn/; [or]gmat;
principal: [x] n. 校长,负责人;本金,资本;  adj. 主要的,首要的; [acc] /ˈprɪnsəpl/; [or]gmat;
slight: [x] adj. 轻微的,微小的;纤细的,瘦弱的;少量的;  n. 轻视,蔑视;  vt. 轻视,忽略; [acc] /slaɪt/; [or]gmat;
pointed: [x] adj. 尖锐的;率直的; [acc] /ˈpɔɪntɪd/; [or]gmat;
immediate: [x] adj. 直系的;立即的,立刻的;紧邻的; [acc] /ɪˈmiːdiət/; [or]gmat;
consequence: [x] n. 结果,后果;重要性; [acc] /ˈkɑːnsɪkwens/; [or]gmat;
sacred: [x] adj. 神圣的,宗教(性)的;神圣不可侵犯的; [acc] /ˈseɪkrɪd/; [or]gmat;
priest: [x] n. 教士,神父; [acc] /priːst/; [or]gmat;
fault: [x] n. 过失,过错;弱点,缺点;故障,缺陷;(地质学)断层;发球失误;  v. 责备,挑错; [acc] /fɔːlt/; [or]gmat;
edge: [x] n. (悬崖,峭壁的)边缘;边缘;锋利,尖锐;刀口,刃;优势;  v. 徐徐移动;给.开刃,使锐利; [acc] /edʒ/; [or]gmat;
vessel: [x] n. 船,容器,血管; [acc] /ˈvesl/; [or]gmat;
square: [x] n. 正方形;广场;  adj. 正方形的;平方的;直角的;  v. 把..弄成方形;  adv. 直接地; [acc] /skwer/; [or]gmat;
previous: [x] adj. 以前的;早先的;过早的; [acc] /ˈpriːviəs/; [or]gmat;
constant: [x] adj. 不变的,始终如一的;持续不断的;  n. 常数,恒量; [acc] /ˈkɑːnstənt/; [or]gmat;
credit: [x] n. 信用;荣誉;学分;信贷;称赞;债权;  v. 信赖;归因于;记学分; [acc] /ˈkredɪt/; [or]gmat;
control: [x] n. 控制;对照实验;控制装置;  vt. 控制,管理; [acc] /kənˈtroʊl/; [or]gmat;
superior: [x] n. 上级,高手;  adj. 较高级的,上层的,出众的; [acc] /suːˈpɪriər/; [or]gmat;
increase: [x] v. 增加,提高;  n. 增加,增强,提高; [acc] /ɪnˈkriːs/; [or]gmat;
admit: [x] v. 承认;准许.进入,允许.加入;容许,可容纳; [acc] /ədˈmɪt/; [or]gmat;
delicate: [x] adj. 易碎的,易坏的,脆弱的;(人)娇弱的,体弱多病的;精美的,精致的,精巧的;微妙的,需要谨慎处理的;优美的,优雅的;柔和的,清淡的,淡雅的; [acc] /ˈdelɪkət/; [or]gmat;
release: [x] v. 释放;解放;发行;  n. 解除;免除;发表; [acc] /rɪˈliːs/; [or]gmat;
addition: [x] n. 加法;添加;附加物; [acc] /əˈdɪʃn/; [or]gmat;
chamber: [x] n. 会议室;(作特殊用途的)房间;议院; [acc] /ˈtʃeɪmbər/; [or]gmat;
sacrifice: [x] vt. 牺牲;祭献;  vi. 奉献;做出牺牲;  n. 祭品;牺牲; [acc] /ˈsækrɪfaɪs/; [or]gmat;
conscience: [x] n. 良心,良知; [acc] /ˈkɑːnʃəns/; [or]gmat;
description: [x] n. 描写,形容,叙述;种类,类型; [acc] /dɪˈskrɪpʃn/; [or]gmat;
throne: [x] n. 王座;君主; [acc] /θroʊn/; [or]gmat;
total: [x] adj. 完全的;整个的,总体的;  n. 总数,总额; [acc] /ˈtoʊtl/; [or]gmat;
extreme: [x] adj. 极端的;极远的;极限的;极度的;偏激的;  n. 极端;极度(状态),最大程度; [acc] /ɪkˈstriːm/; [or]gmat;
intention: [x] n. 意图,意向,目的,打算; [acc] /ɪnˈtenʃn/; [or]gmat;
civil: [x] adj. 公民的,民用的;国内的;有礼貌的,客气的; [acc] /ˈsɪvl/; [or]gmat;
comply: [x] vi. 依从,服从,遵守; [acc] /kəmˈplaɪ/; [or]gmat;
evident: [x] adj. 显然的,明显的,明白的; [acc] /ˈevɪdənt/; [or]gmat;
rare: [x] adj. 罕见的,稀有的,难得的;半熟的;不寻常的;美好的; [acc] /rer/; [or]gmat;
stock: [x] n. 股票;股份;存货;储备;家畜;  v. 给..装满;储存;  adj. 储备的; [acc] /stɑːk/; [or]gmat;
accustomed: [x] adj. 通常的,惯常的;独特的;习惯的,适应了的(to); [acc] /əˈkʌstəmd/; [or]gmat;
flat: [x] adj. 平坦的;浅的;平面的;单调的;  n. 平面;公寓;  adv. 平直地; [acc] /flæt/; [or]gmat;
ruin: [x] v. 毁灭,毁坏;(使)破产;(使)堕落;  n. 毁灭;废墟; [acc] /ˈruːɪn/; [or]gmat;
consent: [x] n. 同意,准许;赞成;  v. 同意; [acc] /kənˈsent/; [or]gmat;
bold: [x] adj. 大胆的,勇敢的;无耻的,放肆的;醒目的;  n. 粗体字; [acc] /boʊld/; [or]gmat;
severe: [x] adj. 严重的;严厉的;严酷的;剧烈的; [acc] /sɪˈvɪr/; [or]gmat;
triumph: [x] n. 喜悦,狂喜;凯旋,胜利;  v. 成功,获胜; [acc] /ˈtraɪʌmf/; [or]gmat;
eternal: [x] adj. 永恒的,永不改变的; [acc] /ɪˈtɜːrnl/; [or]gmat;
base: [x] n. 地基,基础;底座;[化]碱;  adj. 卑鄙的,无耻的;  vt. 以..作基础; [acc] /beɪs/; [or]gmat;
fierce: [x] adj. 凶猛的;激烈的;猛烈的; [acc] /fɪrs/; [or]gmat;
rage: [x] n. 极怒;盛怒;  v. 迅速蔓延,快速扩散;(战争等)激烈地进行; [acc] /reɪdʒ/; [or]gmat;
confess: [x] v. (向神父或上帝)忏悔;承认,坦白; [acc] /kənˈfes/; [or]gmat;
expedition: [x] n. 远征队;探险;短途旅行;迅速; [acc] /ˌekspəˈdɪʃn/; [or]gmat;
doctrine: [x] n. 教条,学说,信条,原则; [acc] /ˈdɑːktrɪn/; [or]gmat;
estate: [x] n. 地产,(上有大片建筑物的)土地,住宅,财产,遗产; [acc] /ɪˈsteɪt/; [or]gmat;
reign: [x] v. 占主导地位,统治,当政;  n. (君主)统治时期; [acc] /reɪn/; [or]gmat;
humble: [x] adj. 卑微的;(级别或地位)低下的,简陋的;谦逊的;  v. 使⋯谦逊,使⋯卑下;轻松打败(尤指强大的对手); [acc] /ˈhʌmbl/; [or]gmat;
compliance: [x] n. 遵守,依从;承诺,答应; [acc] /kəmˈplaɪəns/; [or]gmat;
philosophy: [x] n. 哲学,哲学体系;哲学思想; [acc] /fəˈlɑːsəfi/; [or]gmat;
melancholy: [x] n. 忧郁,悲哀;  adj. 忧郁的,令人伤感的; [acc] /ˈmelənkɑːli/; [or]gmat;
suspicion: [x] n. 怀疑,猜疑,疑心;少许; [acc] /səˈspɪʃn/; [or]gmat;
indicate: [x] vt. 指出,指示,标示;表明,表示,显示; [acc] /ˈɪndɪkeɪt/; [or]gmat;
donate: [x] v. 捐献;捐赠;  vi. 捐献;捐赠; [acc] /ˈdoʊneɪt/; [or]gmat;
proceed: [x] v. 前进(尤指停止后继续进行);继续进行,继续做;  n. 收入,获利; [acc] /proʊˈsiːd/; [or]gmat;
rapid: [x] adj. 迅速的;急促的; [acc] /ˈræpɪd/; [or]gmat;
distinct: [x] adj. 截然不同的;独特的;明显的;清晰的; [acc] /dɪˈstɪŋkt/; [or]gmat;
doubtless: [x] adv. 无疑地;肯定地;  adj. 无疑的;肯定的; [acc] /ˈdaʊtləs/; [or]gmat;
fatal: [x] adj. 致命的;毁灭性的;决定性的; [acc] /ˈfeɪtl/; [or]gmat;
render: [x] v. 使成为,致使,使处于(某种状态);提供,给予,以.回报;(以某种方式)表达,表现;翻译;粉刷,往(墙上)抹灰;将(脂肪)熬成油,使熔化;  n. 粉刷,打底,交纳; [acc] /ˈrendər/; [or]gmat;
commercial: [x] adj. 商业性的,贸易的;  n. 商业广告; [acc] /kəˈmɜːrʃl/; [or]gmat;
domestic: [x] adj. 国产的;国内的;家庭的;驯养的;  n. 家仆;家庭纷争; [acc] /dəˈmestɪk/; [or]gmat;
profit: [x] n. 利润,盈利;益处;  v. 得益,有益于; [acc] /ˈprɑːfɪt/; [or]gmat;
hitherto: [x] adv. 到目前为止,迄今为止; [acc] /ˌhɪðərˈtuː/; [or]gmat;
frame: [x] n. 构架,框,结构,体格;  v. 表达;制定;拟订;陷害;构成,制定,给..装框架;使..适合; [acc] /freɪm/; [or]gmat;
substance: [x] n. 物质;实质,本质;药物; [acc] /ˈsʌbstəns/; [or]gmat;
division: [x] n. 分,分配,除法,部门,分裂; [acc] /dɪˈvɪʒn/; [or]gmat;
rear: [x] n. 后部;  adj. 背面的;  v. 抚养,举起; [acc] /rɪr/; [or]gmat;
community: [x] n. 社区;团体;(生)群落;人群,很多个体的集合体; [acc] /kəˈmjuːnəti/; [or]gmat;
scheme: [x] n. 方案,计划;阴谋,诡计;  v. 图谋,密谋;  adj. 计划的; [acc] /skiːm/; [or]gmat;
equivalent: [x] adj. 相等的;等值的;  n. 同义词;等价物; [acc] /ɪˈkwɪvələnt/; [or]gmat;
drastic: [x] adj. 极端的;猛烈的;激烈的; [acc] /ˈdræstɪk/; [or]gmat;
cabin: [x] n. (简陋的)小屋;船舱;客舱,机舱;  v. 住在小屋里; [acc] /ˈkæbɪn/; [or]gmat;
cease: [x] v. 停止,结束;  n. 停止,停息; [acc] /siːs/; [or]gmat;
permanent: [x] adj. 永久的,持久的;  n. 电烫发; [acc] /ˈpɜːrmənənt/; [or]gmat;
preserve: [x] v. 贮鲜,保鲜;保存;保护;  n. 独揽之事,独占的活动; [acc] /prɪˈzɜːrv/; [or]gmat;
burden: [x] n. 负担,重担;  v. 使负重,装载;烦扰; [acc] /ˈbɜːrdn/; [or]gmat;
district: [x] n. 地区;区域;  vt. 把..划分成区; [acc] /ˈdɪstrɪkt/; [or]gmat;
sentiment: [x] n. 感情;情绪; [acc] /ˈsentɪmənt/; [or]gmat;
grant: [x] v. 给予,许可,授予;承认;  n. 许可;拨款,补助金; [acc] /ɡrænt/; [or]gmat;
enormous: [x] adj. 极大的,极大量的;巨大的;庞大的; [acc] /ɪˈnɔːrməs/; [or]gmat;
conviction: [x] n. 定罪;信服;坚强信念; [acc] /kənˈvɪkʃn/; [or]gmat;
yield: [x] v. 出产;屈服;弯曲;让行;  n. 收益; [acc] /jiːld/; [or]gmat;
instrument: [x] n. 仪器;工具;乐器;手段; [acc] /ˈɪnstrəmənt/; [or]gmat;
idle: [x] adj. 空闲的;懒散的;  v. 无所事事;虚度;空转;使空转;  vt. 虚度; [acc] /ˈaɪdl/; [or]gmat;
permit: [x] vt. 允许,许可;  n. 执照;  v. 使可能; [acc] /pərˈmɪt/; [or]gmat;
sovereign: [x] adj. 至高无上的,具有独立主权的,有最高统治权的;  n. 最高统治者,君主,元首; [acc] /ˈsɑːvrən/; [or]gmat;
shelter: [x] n. 隐蔽处,躲避处(常用来指住处);庇护;  v. 遮蔽,掩护,庇护; [acc] /ˈʃeltər/; [or]gmat;
territory: [x] n. 地区,领土;版图;领域;范围;属地; [acc] /ˈterətɔːri/; [or]gmat;
prospect: [x] n. 前景,展望;视野;景象;  v. 勘察;有前途;勘探;对..进行仔细调查; [acc] /ˈprɑːspekt/; [or]gmat;
profound: [x] adj. 深刻的;知识渊博的;深奥的;极度的,完全的;深远的;渊博的;  n. 深渊;深海; [acc] /prəˈfaʊnd/; [or]gmat;
exceedingly: [x] adv. 过分地;非常; [acc] /ɪkˈsiːdɪŋli/; [or]gmat;
folly: [x] n. 愚蠢; [acc] /ˈfɑːli/; [or]gmat;
uniform: [x] n. 制服,军服;  adj. 相同的,一致的,统一的; [acc] /ˈjuːnɪfɔːrm/; [or]gmat;
venture: [x] n. 企业;(商业)冒险;投机,风险投资;  vi. 冒险前进;  vt. 冒.的危险;以.做赌注; [acc] /ˈventʃər/; [or]gmat;
perceive: [x] v. 意识到,察觉,发觉;看待,理解; [acc] /pərˈsiːv/; [or]gmat;
version: [x] n. 版本;译文;(某人对于某件事不同于其他人的)描述,说法; [acc] /ˈvɜːrʒn/; [or]gmat;
vague: [x] adj. 含糊的,模糊的,不明确的,茫然的;  n. 模糊不定状态; [acc] /veɪɡ/; [or]gmat;
odd: [x] adj. 奇怪的;古怪的;奇数的;多种多样的;临时的;  n. 奇特的事物;怪人;[高尔夫球]多于对方的一次击球;  adv. (用于数字后)大约,左右,略多; [acc] /ɑːd/; [or]gmat;
sensible: [x] adj. 明智的,理智的;可觉察的;实用耐穿的; [acc] /ˈsensəbl/; [or]gmat;
capacity: [x] n. 产能;容量;本领;才能;负载量;职位; [acc] /kəˈpæsəti/; [or]gmat;
council: [x] n. 议会;理事会;委员会; [acc] /ˈkaʊnsl/; [or]gmat;
charity: [x] n. 慈善团体;慈善;仁慈;施舍; [acc] /ˈtʃærəti/; [or]gmat;
bar: [x] n. 酒吧;(金属)棒;闩;障碍;柜台;  vt. 阻挡;禁止;闩住;  prep. 除.之外; [acc] /bɑːr/; [or]gmat;
derive: [x] v. 获取;得自;起源; [acc] /dɪˈraɪv/; [or]gmat;
bid: [x] n. 出价;投标;努力争取;  v. 出价;投标;问候;道别;吩咐; [acc] /bɪd/; [or]gmat;
interior: [x] adj. 内部的;  n. 内部,内心; [acc] /ɪnˈtɪriər/; [or]gmat;
scarce: [x] adj. 缺乏的,不足的;稀少的,罕见的;  adv. 仅仅,几乎不; [acc] /skers/; [or]gmat;
supreme: [x] adj. 至高的;最重要的;极度的; [acc] /suːˈpriːm/; [or]gmat;
strain: [x] n. 负担;紧张;拉力;(生物体)品种,种类;  v. 拉紧;劳累;过分使用; [acc] /streɪn/; [or]gmat;
intimate: [x] adj. 亲密的,密切的;详细的;  v. 暗示;宣布,通知;  n. 密友,知己; [acc] /ˈɪntɪmət/; [or]gmat;
enterprise: [x] n. 企业(或事业)单位,公司;事业;事业心; [acc] /ˈentərpraɪz/; [or]gmat;
format: [x] n. 版式;设计;格式;  v. 设计一个版式;使格式化;设计.的版面; [acc] /ˈfɔːrmæt/; [or]gmat;
scale: [x] n. 天平,磅秤;刻度,尺度,标度;等级,级别, 等级体系;鳞片,鳞状物;规模;水垢,牙垢;  v. 攀登;按比例决定;称重;刮鳞,剥落; [acc] /skeɪl/; [or]gmat;
average: [x] n. 平均数,平均水平;  adj. 通常的,一般的;平均的;  v. 平均为; [acc] /ˈævərɪdʒ/; [or]gmat;
concern: [x] n. 关心,担忧;  v. 感兴趣,涉及,关心,(使)担忧; [acc] /kənˈsɜːrn/; [or]gmat;
campaign: [x] n. (社会性,政治性)活动,运动;战役;  v. 从事活动,参加运动; [acc] /kæmˈpeɪn/; [or]gmat;
indignation: [x] n. 愤慨; [acc] /ˌɪndɪɡˈneɪʃn/; [or]gmat;
gloomy: [x] adj. 愁容满面的,阴暗的,没有希望的; [acc] /ˈɡluːmi/; [or]gmat;
victim: [x] n. 牺牲品,受害者,替罪羊; [acc] /ˈvɪktɪm/; [or]gmat;
absurd: [x] adj. 荒唐的;可笑的;不合理的;  n. 荒唐; [acc] /əbˈsɜːrd/; [or]gmat;
pronounced: [x] adj. 非常明显的;显著的;断然的;  v. 发音;宣告;断言; [acc] /prəˈnaʊnst/; [or]gmat;
obedience: [x] n. 服从,顺从; [acc] /oʊˈbiːdiəns/; [or]gmat;
succession: [x] n. 连续,继续;一连串;继承权; [acc] /səkˈseʃn/; [or]gmat;
resist: [x] v. 抗拒;抵抗,抵制; [acc] /rɪˈzɪst/; [or]gmat;
commission: [x] n. 委员会;任务;权限;委任;销售佣金;  v. 委任; [acc] /kəˈmɪʃn/; [or]gmat;
merchant: [x] n. 商人;批发商; [acc] /ˈmɜːrtʃənt/; [or]gmat;
solitary: [x] adj. 孤独的,单独的,隐居的;  n. 独居者,隐士;单独禁闭; [acc] /ˈsɑːləteri/; [or]gmat;
vanity: [x] n. 自负;无价值的东西;(带镜子的)梳妆台; [acc] /ˈvænəti/; [or]gmat;
lane: [x] n. 小径,巷,行车道; [acc] /leɪn/; [or]gmat;
testimony: [x] n. 证据,证词;表明,说明;见证,证明; [acc] /ˈtestɪmoʊni/; [or]gmat;
suspect: [x] n. 嫌疑犯,可疑分子;  v. 怀疑,猜疑;推测;  adj. 可疑的; [acc] /səˈspekt/; [or]gmat;
feeble: [x] adj. 虚弱的; [acc] /ˈfiːbl/; [or]gmat;
prophet: [x] n. 先知,预言者; [acc] /ˈprɑːfɪt/; [or]gmat;
rival: [x] n. 竞争者,对手;  v. 与.竞争,与.匹敌;  adj. 竞争的,敌对的; [acc] /ˈraɪvl/; [or]gmat;
foe: [x] n. 敌人,敌军;危害物; [acc] /foʊ/; [or]gmat;
recall: [x] v. 回想起,记起,回忆;召回;  n. 召回(有问题的产品); [acc] /rɪˈkɔːl/; [or]gmat;
novel: [x] n. 小说,长篇故事;  adj. 新奇的,新颖的,不同的; [acc] /ˈnɑːvl/; [or]gmat;
inferior: [x] adj. (等级,地位等)下等的,低等的;低劣的;  n. 部下,地位低的人;次品; [acc] /ɪnˈfɪriər/; [or]gmat;
portrait: [x] n. 肖像,(人物)描写,标本; [acc] /ˈpɔːrtrət/; [or]gmat;
responsible: [x] adj. 有责任,负责的; [acc] /rɪˈspɑːnsəbl/; [or]gmat;
vengeance: [x] n. 复仇,报仇; [acc] /ˈvendʒəns/; [or]gmat;
indifference: [x] n. 不关心,冷淡; [acc] /ɪnˈdɪfrəns/; [or]gmat;
assume: [x] v. 猜想;以为,假设;呈现;就职;(想当然地)认为;承担(责任); [acc] /əˈsuːm/; [or]gmat;
estimate: [x] v. 估价,估计,评价;  n. 估计,评价; [acc] /ˈestɪmət/; [or]gmat;
steep: [x] v. 沉浸于..;  adj. 陡峭的;急剧的;过高的;  n. 陡坡; [acc] /stiːp/; [or]gmat;
mutual: [x] adj. 互相的;彼此的;共同的; [acc] /ˈmjuːtʃuəl/; [or]gmat;
scorn: [x] n. 鄙视;  v. 轻蔑;对.不屑一顾; [acc] /skɔːrn/; [or]gmat;
external: [x] adj. 外面的,外部的;外国的; [acc] /ɪkˈstɜːrnl/; [or]gmat;
receipt: [x] n. 收据,收条;收入;收到; [acc] /rɪˈsiːt/; [or]gmat;
discipline: [x] n. 纪律;学科;训练;  v. 训练;惩罚;管制; [acc] /ˈdɪsəplɪn/; [or]gmat;
slip: [x] v. 滑倒,跌落,溜走,疏忽;偷偷地给;被遗忘;  n. 溜走;疏忽,错误;纸条;  adj. 打有活结的;可拆卸的;滑动的; [acc] /slɪp/; [or]gmat;
revolution: [x] n. 革命;旋转; [acc] /ˌrevəˈluːʃn/; [or]gmat;
stroke: [x] n. 击打;一击,一次,一举;中风;抚摸;笔画;  v. 拭去;轻抚; [acc] /stroʊk/; [or]gmat;
exquisite: [x] adj. 精致的,精选的;细腻的;强烈的;  n. 过分讲究穿戴的人; [acc] /ɪkˈskwɪzɪt/; [or]gmat;
platform: [x] n. 站台;平台;讲台;舞台;论坛; [acc] /ˈplætfɔːrm/; [or]gmat;
privilege: [x] n. 特权,优待;荣幸;  v. 给..特权; [acc] /ˈprɪvəlɪdʒ/; [or]gmat;
convey: [x] v. 传送,运送;表达,传达; [acc] /kənˈveɪ/; [or]gmat;
sensation: [x] n. 感觉;知觉;轰动; [acc] /senˈseɪʃn/; [or]gmat;
submit: [x] v. 提交;屈服,使...服从;建议,主张; [acc] /səbˈmɪt/; [or]gmat;
tragedy: [x] n. 悲剧; [acc] /ˈtrædʒədi/; [or]gmat;
specific: [x] adj. 具体的,明确的;特定的;特殊的;针对..的;  n. 详情;特性; [acc] /spəˈsɪfɪk/; [or]gmat;
virgin: [x] n. 处女;处男;贞女;  adj. 处女的; [acc] /ˈvɜːrdʒɪn/; [or]gmat;
proprietary: [x] adj. 所有的;专利的;私人拥有的;  n. 所有权;所有物;所有人; [acc] /prəˈpraɪəteri/; [or]gmat;
customs: [x] n. 海关;风俗;关税;  adj. 定做的;专做定货的; [acc] /ˈkʌstəmz/; [or]gmat;
inevitable: [x] adj. 不可避免的,必然的;  n. 必然发生的事; [acc] /ɪnˈevɪtəbl/; [or]gmat;
reserve: [x] n. 储备;保留;保护区;  v. 保留;预定;储备; [acc] /rɪˈzɜːrv/; [or]gmat;
bark: [x] v. 狗吠;厉声发令;  n. 树皮;吠声; [acc] /bɑːrk/; [or]gmat;
reception: [x] n. 前台,接待处,接收,欢迎,招待会; [acc] /rɪˈsepʃn/; [or]gmat;
abruptly: [x] adv. 突然地,无礼地; [acc] /əˈbrʌptli/; [or]gmat;
dwelling: [x] n. 住所; [acc] /ˈdwelɪŋ/; [or]gmat;
depart: [x] v. 离开;起程;出发;起程;出发;离职; [acc] /dɪˈpɑːrt/; [or]gmat;
reverence: [x] n. 崇敬,尊严,敬礼;  v. 敬畏,尊敬; [acc] /ˈrevərəns/; [or]gmat;
conceive: [x] v. 怀孕;设想,想出; [acc] /kənˈsiːv/; [or]gmat;
fetch: [x] v. 取来;接来;使发出;售得;带来;接住;  n. 拿来,取来;诡计;风浪区; [acc] /fetʃ/; [or]gmat;
hint: [x] v. 作暗示;透露;  n. 暗示,示意;建议; [acc] /hɪnt/; [or]gmat;
solicit: [x] v. 乞求,恳求给予(帮助,金钱); [acc] /səˈlɪsɪt/; [or]gmat;
derivative: [x] n. 派生物;[化学]衍生物;  adj. 被引申出的,被诱导的;衍生的;第二手的; [acc] /dɪˈrɪvətɪv/; [or]gmat;
primitive: [x] adj. 原始的;简陋的;  n. 原始人; [acc] /ˈprɪmətɪv/; [or]gmat;
deserve: [x] v. 值得,应得;应受; [acc] /dɪˈzɜːrv/; [or]gmat;
plot: [x] n. 情节,阴谋,小块土地;  v. 密谋,计划,为小说写情节; [acc] /plɑːt/; [or]gmat;
modest: [x] adj. 谦虚的,谦逊的;端庄的,羞怯的;不太大(或太贵,太重要)的,适度的; [acc] /ˈmɑːdɪst/; [or]gmat;
tremendous: [x] adj. 巨大的;极大的;惊人的; [acc] /trəˈmendəs/; [or]gmat;
treasury: [x] n. 国库,金库;财政部;宝库; [acc] /ˈtreʒəri/; [or]gmat;
shield: [x] n. 盾牌;防护物;  v. 保护; [acc] /ʃiːld/; [or]gmat;
distinguish: [x] v. 区别,识别,辨别,使显著; [acc] /dɪˈstɪŋɡwɪʃ/; [or]gmat;
esteem: [x] n. 尊敬;尊重;  vt. 尊敬;认为;考虑;估计; [acc] /ɪˈstiːm/; [or]gmat;
restore: [x] v. 恢复;修补;归还; [acc] /rɪˈstɔːr/; [or]gmat;
temporary: [x] adj. 暂时的,临时的; [acc] /ˈtempəreri/; [or]gmat;
reproach: [x] v. 责备,指责;  n. 指责; [acc] /rɪˈproʊtʃ/; [or]gmat;
federal: [x] adj. 联邦制的;联邦政府的; [acc] /ˈfedərəl/; [or]gmat;
remedy: [x] v. 治疗;恢复;补救;  n. 治疗;补救;矫正; [acc] /ˈremədi/; [or]gmat;
pursue: [x] v. 进行,从事;追求,追赶; [acc] /pərˈsuː/; [or]gmat;
representative: [x] n. 代表;代理;  adj. 典型的,有代表性的; [acc] /ˌreprɪˈzentətɪv/; [or]gmat;
siege: [x] n. 围困;包围; [acc] /siːdʒ/; [or]gmat;
modification: [x] n. 修改,改进,改造; [acc] /ˌmɑːdɪfɪˈkeɪʃn/; [or]gmat;
brass: [x] n. 黄铜(器);铜管乐器;[口语]厚脸皮;高级将领官员;黄铜;  v. 付(款); [acc] /bræs/; [or]gmat;
obscure: [x] v. 隐藏,使.模糊;使变暗;遮掩;  adj. 不清楚的;难以理解的;  n. 某种模糊的或不清楚的东西; [acc] /əbˈskjʊr/; [or]gmat;
summit: [x] n. 山顶,顶点;(政府间的)峰会; [acc] /ˈsʌmɪt/; [or]gmat;
center: [x] n. 中央,中心;  v. 集中;居中; [acc] /ˈsentər/; [or]gmat;
alter: [x] v. 改变;改动,使变样;改做; [acc] /ˈɔːltər/; [or]gmat;
contract: [x] n. 合同,契约;  v. 感染(疾病);招致;订合同;订立(婚约);缩减; [acc] /ˈkɑːntrækt/; [or]gmat;
combination: [x] n. 结合,联合,组合;(保险锁等的)暗码; [acc] /ˌkɑːmbɪˈneɪʃn/; [or]gmat;
intent: [x] adj. 全神贯注的;专心致志的;  n. 意图;意向;目的; [acc] /ɪnˈtent/; [or]gmat;
corps: [x] n. (由两个或以上师组成的)军,兵团;一群人;特别小组; [acc] /kɔːr/; [or]gmat;
institution: [x] n. 机构;制度;惯例;习俗;建立,设立,制定; [acc] /ˌɪnstɪˈtuːʃn/; [or]gmat;
capture: [x] v. 捕获,俘获;俘虏;掌控;使迷住;捕捉,留存;  n. 战利品; [acc] /ˈkæptʃər/; [or]gmat;
ample: [x] adj. 富足的,丰满的,宽敞的; [acc] /ˈæmpl/; [or]gmat;
identify: [x] v. 认出,联系;识别;确定,鉴定,发现;认为.等同,认为.关系紧密;表明.的身份;认同,有共鸣,有同感; [acc] /aɪˈdentɪfaɪ/; [or]gmat;
discharge: [x] n. 发射;释放;解雇;放电;  v. 卸掉负担;发射;放电;卸(货);使爆炸;履行;解雇;允许.离开;排出,放出;清偿(债务); [acc] /dɪsˈtʃɑːrdʒ/; [or]gmat;
interval: [x] n. 间隔;中场休息,幕间休息;间距; [acc] /ˈɪntərvl/; [or]gmat;
occupy: [x] v. 占领,占据,侵占;住在,居住,住进;担任(职务),任职;占用(时间,空间等),占有;使用(房屋,建筑); [acc] /ˈɑːkjupaɪ/; [or]gmat;
foul: [x] adj. 难闻的,发臭的;糟透了的;污秽的;犯规的;  n. 犯规;  vi. 犯规;  vt. 弄脏,使污秽;使纠缠; [acc] /faʊl/; [or]gmat;
subsequent: [x] adj. 随后的; [acc] /ˈsʌbsɪkwənt/; [or]gmat;
formidable: [x] adj. 令人畏惧的;可怕的;难以克服的;难应付的; [acc] /ˈfɔːrmɪdəbl/; [or]gmat;
product: [x] n. 产品,产物;(乘)积; [acc] /ˈprɑːdʌkt/; [or]gmat;
economic: [x] adj. 经济上的,经济学的;合算的;有利可图的; [acc] /ˌekəˈnɑːmɪk/; [or]gmat;
subtle: [x] adj. 微妙的;敏锐的;不明显的;精细的;狡猾的; [acc] /ˈsʌtl/; [or]gmat;
slope: [x] n. 山坡,斜坡,倾斜;  v. 倾斜; [acc] /sloʊp/; [or]gmat;
heed: [x] vt. 注意;留心;  v. 注意;  vi. 留心;  n. 注意;留心; [acc] /hiːd/; [or]gmat;
calculate: [x] vt. 计算;估计;计划;  vi. 计算;估计; [acc] /ˈkælkjuleɪt/; [or]gmat;
dine: [x] v. 吃饭,用餐;招待..吃饭;用正餐(晚餐); [acc] /daɪn/; [or]gmat;
sensitive: [x] adj. 敏感的,过敏的;灵敏的;善解人意的,体恤的; [acc] /ˈsensətɪv/; [or]gmat;
robin: [x] n. 欧鸲,知更鸟; [acc] /ˈrɑːbɪn/; [or]gmat;
appetite: [x] n. 食欲,胃口;欲望; [acc] /ˈæpɪtaɪt/; [or]gmat;
courtesy: [x] n. 礼貌; [acc] /ˈkɜːrtəsi/; [or]gmat;
sphere: [x] n. 球;球形;领域; [acc] /sfɪr/; [or]gmat;
welfare: [x] n. 福利;幸福,健康; [acc] /ˈwelfer/; [or]gmat;
perish: [x] vi. 死去;毁灭,灭亡;  v. 脆裂,老化,腐烂; [acc] /ˈperɪʃ/; [or]gmat;
encounter: [x] v. 邂逅,遭遇,偶遇;  n. 偶然碰见,遭遇; [acc] /ɪnˈkaʊntər/; [or]gmat;
amiable: [x] adj. 和蔼的,亲切的;温和的; [acc] /ˈeɪmiəbl/; [or]gmat;
economy: [x] n. 经济,经济制度;节约; [acc] /ɪˈkɑːnəmi/; [or]gmat;
parallel: [x] adj. 平行的;相似的;  n. 相似物;平行线;  v. 与..相似;与..匹配;  adv. 并行地,平行地; [acc] /ˈpærəlel/; [or]gmat;
frontier: [x] n. 边境,边疆;新领域;<美>边远地区,边界地区;  adj. 开拓的; [acc] /frʌnˈtɪr/; [or]gmat;
decent: [x] adj. 体面的;像样的;合宜的;正直的; [acc] /ˈdiːsnt/; [or]gmat;
artificial: [x] adj. 人造的,人工的,假的;假装的,虚伪的;  n. 人造肥料;<美>假花; [acc] /ˌɑːrtɪˈfɪʃl/; [or]gmat;
naval: [x] adj. 海军的,军舰的; [acc] /ˈneɪvl/; [or]gmat;
abundant: [x] adj. 丰富的;大量的; [acc] /əˈbʌndənt/; [or]gmat;
clergy: [x] n. 教牧人员,神职人员; [acc] /ˈklɜːrdʒi/; [or]gmat;
mount: [x] v. 登上;爬上;骑上;增长;组织,安排;  n. 山;峰; [acc] /maʊnt/; [or]gmat;
array: [x] n. 一系列;陈列;编队;  v. 排列;部署; [acc] /əˈreɪ/; [or]gmat;
landscape: [x] n. 风景;风景画;景观;横向打印格式;  v. 美化环境; [acc] /ˈlændskeɪp/; [or]gmat;
sue: [x] v. 控告,提起诉讼;控告;起诉;  n. 女子名(Sue); [acc] /suː/; [or]gmat;
maximum: [x] n. 最大值;最大限度;  adj. 最大的; [acc] /ˈmæksɪməm/; [or]gmat;
commit: [x] v. 犯(罪);进行 (自杀);调拨 (钱,资源);监禁;送交 (到精神病院,监狱等);承诺,保证; [acc] /kəˈmɪt/; [or]gmat;
miracle: [x] n. 奇迹; [acc] /ˈmɪrəkl/; [or]gmat;
tariff: [x] n. 关税,价目表;  vt. 征收关税;定税率;定收费标准; [acc] /ˈtærɪf/; [or]gmat;
extend: [x] v. 伸展,展开;延伸;涉及;扩展;提供;使.竭尽全力; [acc] /ɪkˈstend/; [or]gmat;
copper: [x] n. 铜;铜币;警官;铜色;铜(制); [acc] /ˈkɑːpər/; [or]gmat;
imperial: [x] adj. 帝王的,壮丽的,至尊的;  n. 帝国,皇家; [acc] /ɪmˈpɪriəl/; [or]gmat;
victor: [x] n. 胜利者;  adj. 胜利者的; [acc] /ˈvɪktər/; [or]gmat;
bargain: [x] n. 交易,特价商品;便宜货;契约;  vi. 讨价还价,讲价;成交;  vt. 经讨价还价成交;用.交换;  adj. (价格),低廉的; [acc] /ˈbɑːrɡən/; [or]gmat;
sketch: [x] n. 梗概,素描;  v. 速写,打草稿; [acc] /sketʃ/; [or]gmat;
virtuous: [x] adj. 善良的,有德行的,贞洁的; [acc] /ˈvɜːrtʃuəs/; [or]gmat;
retain: [x] v. 保持,保留,保存;聘请; [acc] /rɪˈteɪn/; [or]gmat;
mob: [x] n. 乌合之众,(尤指)暴民;  v. (指民众)包围(为攻击或赞赏); [acc] /mɑːb/; [or]gmat;
palm: [x] n. 手掌,手心,棕榈树; [acc] /pɑːm/; [or]gmat;
tribute: [x] n. 致敬;悼念;贡品;称赞; [acc] /ˈtrɪbjuːt/; [or]gmat;
procure: [x] vt. (努力)取得;获得;导致;完成;  vi. 介绍娼妓;拉皮条; [acc] /prəˈkjʊr/; [or]gmat;
relieve: [x] v. 消除,减轻;换班; [acc] /rɪˈliːv/; [or]gmat;
project: [x] n. 项目,工程;专题研究;课题方案;  v. 映射,放映;计划,设计,打算,拟订方案;投掷,发射,喷射;表明..的特性,使呈现特性;阐述;突出,伸出;估计,预估; [acc] /ˈprɑːdʒekt/; [or]gmat;
threshold: [x] n. 门槛;开端; [acc] /ˈθreʃhoʊld/; [or]gmat;
session: [x] n. 一段时间的(活动);(法庭的)开庭;(议会等的)开会;学期;讲习会;  adj. 为录音的歌手或乐队伴奏的; [acc] /ˈseʃn/; [or]gmat;
torture: [x] v. 对.施以酷刑,拷问,折磨;  n. 酷刑,折磨;  adj. 遭受重创的;饱受煎熬的; [acc] /ˈtɔːrtʃər/; [or]gmat;
ridge: [x] n. 脊,岭,山脉,垄; [acc] /rɪdʒ/; [or]gmat;
spoil: [x] v. 溺爱;娇惯;(食物)变质;毁坏;  n. 溺爱;战利品;犒劳;成功所带来的好处; [acc] /spɔɪl/; [or]gmat;
liable: [x] adj. (for)有责任的;有义务的;(to)有.倾向的;易于.的,有可能.; [acc] /ˈlaɪəbl/; [or]gmat;
ardent: [x] adj. 热心的,热烈的; [acc] /ˈɑːrdnt/; [or]gmat;
prejudice: [x] n. 偏见;成见;损害;侵害;  vt. 使抱偏见; [acc] /ˈpredʒudɪs/; [or]gmat;
probability: [x] n. 可能性;几率,概率; [acc] /ˌprɑːbəˈbɪləti/; [or]gmat;
strife: [x] n. 纷争,倾轧; [acc] /straɪf/; [or]gmat;
disturb: [x] v. 打扰,妨碍;弄乱;使烦恼; [acc] /dɪˈstɜːrb/; [or]gmat;
flock: [x] n. (鸟兽)群;一群人;(对牧师而言的)教徒;  v. 聚集,成群而行; [acc] /flɑːk/; [or]gmat;
faculty: [x] n. 教职工,全体教员;系;科;能力; [acc] /ˈfæklti/; [or]gmat;
cannon: [x] n. 大炮;机关炮;  v. 相撞;开炮; [acc] /ˈkænən/; [or]gmat;
manuscript: [x] n. 手稿;底稿;手抄本; [acc] /ˈmænjuskrɪpt/; [or]gmat;
warrior: [x] n. 战士,武士,勇士; [acc] /ˈwɔːriər/; [or]gmat;
combat: [x] n. 战斗,格斗;  v. 与.战斗,与.斗争;  adj. 战斗的; [acc] /ˈkɑːmbæt/; [or]gmat;
cliff: [x] n. 悬崖;峭壁; [acc] /klɪf/; [or]gmat;
adopt: [x] v. 收养;采纳,采用; [acc] /əˈdɑːpt/; [or]gmat;
revenue: [x] n. 收入;财政收入;国家的税收; [acc] /ˈrevənuː/; [or]gmat;
subscribe: [x] vi. 捐款;订阅;认购(股份);  vt. 申请; [acc] /səbˈskraɪb/; [or]gmat;
transcribe: [x] v. 抄写,转录; [acc] /trænˈskraɪb/; [or]gmat;
descend: [x] vi. 走下;降临;  v. 下降,下来;突然访问;下移,下降; [acc] /dɪˈsend/; [or]gmat;
disaster: [x] n. 灾难,天灾; [acc] /dɪˈzæstər/; [or]gmat;
entertainment: [x] n. 娱乐;招待,款待; [acc] /ˌentərˈteɪnmənt/; [or]gmat;
engage: [x] vt. 吸引住(注意力,兴趣);雇,聘;  vi. 使加入,使融入;订婚;  v. (军队)交战;啮合; [acc] /ɪnˈɡeɪdʒ/; [or]gmat;
herd: [x] n. 兽群,牧群;  v. 放牧,群集; [acc] /hɜːrd/; [or]gmat;
attain: [x] v. 获得;达到(某个年纪,水平,条件);实现;  n. 成就; [acc] /əˈteɪn/; [or]gmat;
convert: [x] v. 可转变为,可变换成;改变,转变,转化;使改变信仰;  n. 皈依者;改变宗教信仰者; [acc] /kənˈvɜːrt/; [or]gmat;
outline: [x] n. 外形,轮廓;大纲,概要;  v. 描绘,画出..的轮廓; [acc] /ˈaʊtlaɪn/; [or]gmat;
comprehend: [x] v. 由.组成;了解;领会;包含; [acc] /ˌkɑːmprɪˈhend/; [or]gmat;
withdraw: [x] v. 取款;撤退,收回,撤离; [acc] /wɪðˈdrɔː/; [or]gmat;
compassion: [x] n. 同情;怜悯; [acc] /kəmˈpæʃn/; [or]gmat;
latitude: [x] n. 纬度;地区;(言论,行动的)自由; [acc] /ˈlætɪtuːd/; [or]gmat;
betray: [x] v. 背叛;失信于;泄露(秘密等);(非故意地)暴露; [acc] /bɪˈtreɪ/; [or]gmat;
disguise: [x] v. 伪装;掩饰;  n. 伪装物;伪装; [acc] /dɪsˈɡaɪz/; [or]gmat;
block: [x] v. 阻挡;妨碍;阻塞;  n. 街区;块状物;积木;阻碍;大厦; [acc] /blɑːk/; [or]gmat;
barren: [x] adj. 贫瘠的,不孕的;  n. 荒原,不毛之地; [acc] /ˈbærən/; [or]gmat;
dense: [x] adj. (物质) 密度大的;稠密的,浓密的;愚钝的;难懂的,费解的; [acc] /dens/; [or]gmat;
fiction: [x] n. 虚构;想象;小说; [acc] /ˈfɪkʃn/; [or]gmat;
recommend: [x] v. 推荐,介绍;劝告,建议; [acc] /ˌrekəˈmend/; [or]gmat;
lodge: [x] v. 住宿;存放,保管;  n. 小屋;兽穴; [acc] /lɑːdʒ/; [or]gmat;
disorder: [x] n. 混乱;紊乱;动乱;  vt. 使混乱;使紊乱; [acc] /dɪsˈɔːrdər/; [or]gmat;
sheer: [x] adj. 陡峭的;纯粹的;  v. (off)急转向,偏离;  n. 透明薄纱,透明布料的衣服;  adv. 完全地,全然;垂直地,陡峭地; [acc] /ʃɪr/; [or]gmat;
fare: [x] n. 交通费;票价;食物;出租车乘客;  v. (事情)进行得(好或坏); [acc] /fer/; [or]gmat;
binary: [x] adj. 二进位的,二元的;  n. 一双;双体;二进制数;双子星; [acc] /ˈbaɪnəri/; [or]gmat;
elaborate: [x] adj. 精心设计的,精巧的;复杂的;  v. 详细说明,详尽阐述;  vt. 变得复杂; [acc] /ɪˈlæbəreɪt/; [or]gmat;
essence: [x] n. 本质,实质;精髓,精华; [acc] /ˈesns/; [or]gmat;
realm: [x] n. 王国;领域;国土; [acc] /relm/; [or]gmat;
accord: [x] n. 协议;  v. 授予; [acc] /əˈkɔːrd/; [or]gmat;
exile: [x] n. 流亡国外;流放,充军;  vt. 使流亡,放逐;使离乡背井; [acc] /ˈeksaɪl/; [or]gmat;
arch: [x] n. 拱洞;拱门;拱起;  v. 做成拱形;  adj. 调皮的,淘气的; [acc] /ɑːrtʃ/; [or]gmat;
respective: [x] adj. 各自的; [acc] /rɪˈspektɪv/; [or]gmat;
consult: [x] v. 请教,咨询;查阅;商量; [acc] /kənˈsʌlt/; [or]gmat;
doom: [x] v. 注定;命定;  n. 毁灭;厄运;劫数; [acc] /duːm/; [or]gmat;
scent: [x] n. 气味;香味;迹象;  v. 嗅到;察觉; [acc] /sent/; [or]gmat;
cultivation: [x] n. 耕种,种植;培养,教化;文雅; [acc] /ˌkʌltɪˈveɪʃn/; [or]gmat;
rigid: [x] adj. 坚硬的;僵硬的;死板的; [acc] /ˈrɪdʒɪd/; [or]gmat;
venerable: [x] adj. 令人尊敬的;(因历史悠久而) 神圣庄严的; [acc] /ˈvenərəbl/; [or]gmat;
swell: [x] v. (使)膨胀,(使)鼓起;  n. 增大,膨胀,肿胀,汹涌;  adj. 时髦的;一流的;很好的; [acc] /swel/; [or]gmat;
wreck: [x] n. 沉船,失事船;失事;(事故中)遭严重损坏的汽车(飞机等);  v. 破坏,使毁灭; [acc] /rek/; [or]gmat;
convince: [x] v. 使确信;使信服; [acc] /kənˈvɪns/; [or]gmat;
congregation: [x] n. 集合在一起的群众; [acc] /ˌkɑːŋɡrɪˈɡeɪʃn/; [or]gmat;
theme: [x] n. 主题;主旨;主旋律;  adj. 主题的;  v. 赋予.某种主题; [acc] /θiːm/; [or]gmat;
eloquent: [x] adj. 有口才的;雄辩的;演说动人的; [acc] /ˈeləkwənt/; [or]gmat;
rational: [x] adj. 理性的;理智的;合理的; [acc] /ˈræʃnəl/; [or]gmat;
accurate: [x] adj. 精确的;正确的;符合标准的; [acc] /ˈækjərət/; [or]gmat;
resort: [x] vi. 采取;求助;  n. 求助;凭借;诉诸,采取;度假胜地; [acc] /rɪˈzɔːrt/; [or]gmat;
bond: [x] n. 束缚物,联结物;凝聚力;债券;保释金;联系;  vi. 结合;团结一致; [acc] /bɑːnd/; [or]gmat;
vicinity: [x] n. 附近地区;近邻;附近; [acc] /vəˈsɪnəti/; [or]gmat;
ingenious: [x] adj. 聪明的;有发明天才的;有独创性的,别出心裁的; [acc] /ɪnˈdʒiːniəs/; [or]gmat;
vacant: [x] adj. 空的,未被占用的;闲置的;空缺的;茫然的; [acc] /ˈveɪkənt/; [or]gmat;
antiquity: [x] n. 古代,古时候(尤指古希腊和古罗马时期);古代的遗物,古物; [acc] /ænˈtɪkwəti/; [or]gmat;
despise: [x] vt. 轻视,蔑视,看不起; [acc] /dɪˈspaɪz/; [or]gmat;
ultimate: [x] adj. 根本的;最后的,最终的; [acc] /ˈʌltɪmət/; [or]gmat;
entry: [x] n. 入口处;登记;进入; [acc] /ˈentri/; [or]gmat;
hardy: [x] adj. (植物)耐寒的;能吃苦耐劳的;勇敢的;  n. 强壮的人; [acc] /ˈhɑːrdi/; [or]gmat;
captive: [x] adj. 被捕获的;被俘虏的;  n. 俘虏; [acc] /ˈkæptɪv/; [or]gmat;
adjoining: [x] adj. 毗邻的; [acc] /əˈdʒɔɪnɪŋ/; [or]gmat;
cathedral: [x] n. 大教堂;  adj. 有权威的;大教堂的; [acc] /kəˈθiːdrəl/; [or]gmat;
plague: [x] n. 瘟疫;灾难;麻烦;  v. 折磨;烦扰;造成麻烦; [acc] /pleɪɡ/; [or]gmat;
apparatus: [x] n. 装置,仪器;设备;组织,机构; [acc] /ˌæpəˈrætəs/; [or]gmat;
assert: [x] v. 断言;肯定地说;坚持;维护; [acc] /əˈsɜːrt/; [or]gmat;
dismay: [x] n. 失望;沮丧;惊愕;  v. 使惊恐; [acc] /dɪsˈmeɪ/; [or]gmat;
navy: [x] n. 海军; [acc] /ˈneɪvi/; [or]gmat;
fortress: [x] n. 堡垒;要塞; [acc] /ˈfɔːrtrəs/; [or]gmat;
acquire: [x] v. (尤指靠自己的努力或行动或经过一个过程)获得;学到;取得; [acc] /əˈkwaɪər/; [or]gmat;
mask: [x] n. 面具;遮蔽物;伪装;  v. 隐藏(感情);掩盖,掩饰,掩护;伪装; [acc] /mæsk/; [or]gmat;
parlor: [x] n. 店,营业室,客厅;  adj. 客厅的; [acc] /'pɑːlə/; [or]gmat;
perception: [x] n. 洞察力,理解力;洞察力,理解力,认识,观念,看法; [acc] /pərˈsepʃn/; [or]gmat;
function: [x] n. 功能,作用;函数;应变量;盛大聚会;职务,职责;  v. 起作用;正常运转; [acc] /ˈfʌŋkʃn/; [or]gmat;
excessive: [x] adj. 过多的; [acc] /ɪkˈsesɪv/; [or]gmat;
bind: [x] v. 捆绑;装订;约束;结合;  n. 窘境,困境;讨厌的事情;捆绑;植物的藤蔓; [acc] /baɪnd/; [or]gmat;
identical: [x] adj. 相同的,同样的,一模一样的;相似的;  n. 完全相同的事物; [acc] /aɪˈdentɪkl/; [or]gmat;
superstition: [x] n. 迷信,盲目恐惧; [acc] /ˌsuːpərˈstɪʃn/; [or]gmat;
bulk: [x] n. 大批;容量;体积;大块;  adj. 大量的;散装的;  v. 膨胀;显得重要; [acc] /bʌlk/; [or]gmat;
bunch: [x] n. 束;串;群,伙;  v. 集中,挤在一起;使成一束(或一群等); [acc] /bʌntʃ/; [or]gmat;
debate: [x] n. 辩论;讨论;  v. 辩论;争论;议论; [acc] /dɪˈbeɪt/; [or]gmat;
corruption: [x] n. 腐败,受贿,贪污,堕落;词的变体,变化了的形式; [acc] /kəˈrʌpʃn/; [or]gmat;
partial: [x] adj. 偏爱的,特别喜欢的;偏袒的,不公平的,有偏见的;部分的;不完全的;  n. [数学]偏微商; [acc] /ˈpɑːrʃl/; [or]gmat;
cabinet: [x] n. 橱;柜;内阁; [acc] /ˈkæbɪnət/; [or]gmat;
surgeon: [x] n. 外科医生; [acc] /ˈsɜːrdʒən/; [or]gmat;
abstract: [x] adj. 抽象的;  n. 摘要,抽象;  v. 提取; [acc] /ˈæbstrækt/; [or]gmat;
bestow: [x] v. 给予; [acc] /bɪˈstoʊ/; [or]gmat;
legitimate: [x] adj. 合法的;合理的;  vt. 使合法;授权;宣布..为合法; [acc] /lɪˈdʒɪtɪmət/; [or]gmat;
approve: [x] v. 称许,赞成,批准; [acc] /əˈpruːv/; [or]gmat;
petition: [x] n. 请愿;请愿书;祈求;  v. 请愿; [acc] /pəˈtɪʃn/; [or]gmat;
crack: [x] v. 敲出裂痕,敲破;垮掉;断裂,折断;说(笑话);  n. 裂缝;破裂声;挖苦话;强效纯可卡因;  adj. 最好的,一流的;  adv. 尖锐地;  vi. 断裂,折断; [acc] /kræk/; [or]gmat;
reverse: [x] n. 失败,挫折,倒退;相反,背面;  v. 颠倒,翻转;  adj. 相反的,反面的,颠倒的; [acc] /rɪˈvɜːrs/; [or]gmat;
survey: [x] n. 调查;测量;鉴定;  v. 测量,勘测;鉴定;调查; [acc] /ˈsɜːrveɪ/; [or]gmat;
contemporary: [x] adj. 同时代的;当代的,现代的;  n. 同龄人,同时代的人; [acc] /kənˈtempəreri/; [or]gmat;
deliberate: [x] adj. 故意的;深思熟虑的;从容不迫的;  v. 仔细考虑;研讨; [acc] /dɪˈlɪbərət/; [or]gmat;
precise: [x] adj. 精确的;恰好的; [acc] /prɪˈsaɪs/; [or]gmat;
negative: [x] adj. 消极的,负面的;否定的;  n. 否定,否定词;底片; [acc] /ˈneɡətɪv/; [or]gmat;
exclusively: [x] adv. 专门地;特定地;排外地;仅仅; [acc] /ɪkˈskluːsɪvli/; [or]gmat;
stem: [x] n. 茎,(树)干;  v. 阻止;起源于;遏制,抑制; [acc] /stem/; [or]gmat;
shrill: [x] adj. 尖声的,刺耳的;  vi. 尖叫;  vt. 尖叫着说;  n. 尖叫声;  adv. 尖声地,无节制地; [acc] /ʃrɪl/; [or]gmat;
reduce: [x] v. 减少,减小,降低,精简; [acc] /rɪˈduːs/; [or]gmat;
code: [x] n. 编码,代码;准则,法典;密码;  v. 将.编码; [acc] /koʊd/; [or]gmat;
dismal: [x] n. 低落的情绪;  adj. 惨淡的;沉闷的,凄凉的; [acc] /ˈdɪzməl/; [or]gmat;
concert: [x] n. 音乐会;一致;和谐,合作; [acc] /ˈkɑːnsərt/; [or]gmat;
prompt: [x] v. 提示;激起;促进,推动;敦促;  adj. 迅速的,及时的;  n. 提示; [acc] /prɑːmpt/; [or]gmat;
paperwork: [x] n. 日常文书工作; [acc] /ˈpeɪpərwɜːrk/; [or]gmat;
inherited: [x] adj. 遗传的(病等),继承权的,通过继承得到的; [acc] /ɪnˈherɪtɪd/; [or]gmat;
bronze: [x] n. 青铜,青铜色,青铜器; [acc] /brɑːnz/; [or]gmat;
garment: [x] n. 服装;  vt. 给 ... 披上衣服;覆上...; [acc] /ˈɡɑːrmənt/; [or]gmat;
hue: [x] n. 色彩;色度,颜色;叫声; [acc] /hjuː/; [or]gmat;
envelope: [x] n. 信封;包装物,外壳,膜;气囊; [acc] /ˈenvəloʊp/; [or]gmat;
startling: [x] adj. 令人吃惊的;颜色极鲜亮的; [acc] /ˈstɑːrtlɪŋ/; [or]gmat;
acute: [x] adj. (疼痛,妒忌等)剧烈的,严重的;敏锐的;急性的;尖声的; [acc] /əˈkjut/; [or]gmat;
offspring: [x] n. 后代; [acc] /ˈɔːfsprɪŋ/; [or]gmat;
indispensable: [x] adj. 必不可少的;必需的; [acc] /ˌɪndɪˈspensəbl/; [or]gmat;
grip: [x] v. 握紧,抓牢;  n. 紧握,握力; [acc] /ɡrɪp/; [or]gmat;
blast: [x] n. 一阵(疾风等);爆炸;冲击波;  v. (用炸药)炸,摧毁; [acc] /blæst/; [or]gmat;
diameter: [x] n. 直径; [acc] /daɪˈæmɪtər/; [or]gmat;
brutal: [x] adj. 残忍的,粗鲁的;严酷的,难以忍受的;严峻的; [acc] /ˈbruːtl/; [or]gmat;
penalty: [x] n. 惩罚,处罚,不利,罚球;  adj. 处罚的; [acc] /ˈpenəlti/; [or]gmat;
corridor: [x] n. 走廊,长条地带,回廊,通道; [acc] /ˈkɔːrɪdɔːr/; [or]gmat;
alternate: [x] adj. 交替的,轮流的,间隔的;  v. (使)交替,(使)轮流;  n. 代替者; [acc] /ˈɔːltərnət/; [or]gmat;
identity: [x] n. 身份;特性;一致; [acc] /aɪˈdentəti/; [or]gmat;
screen: [x] n. 屏幕,荧光屏;纱窗;  v. 遮蔽;放映;检查; [acc] /skriːn/; [or]gmat;
shrewd: [x] adj. 精明的;机灵的;  n. 精明;精明者; [acc] /ʃruːd/; [or]gmat;
alternative: [x] adj. 可供选择的;替代的;不寻常的;  n. 可供选择的事物; [acc] /ɔːlˈtɜːrnətɪv/; [or]gmat;
compact: [x] adj. 小巧的,小型的,袖珍的,体积小的;紧密的,紧凑的,密集的;  v. 把..压紧;变得坚实;  n. 带镜小粉盒;合约,条约; [acc] /ˈkɑːmpækt/; [or]gmat;
kin: [x] n. 亲属; [acc] /kɪn/; [or]gmat;
transport: [x] v. 运输;使狂喜;流放;  n. 运输;运输工具;流放犯; [acc] /ˈtrænspɔːrt/; [or]gmat;
manufacture: [x] v. 生产;制造;  n. 制造,生产;制造业;(复)产品; [acc] /ˌmænjuˈfæktʃər/; [or]gmat;
quest: [x] n. 探索,寻求;  v. 寻找,搜索; [acc] /kwest/; [or]gmat;
crest: [x] n. 鸟冠,盔上的装饰(如羽毛),顶部,顶峰;  v. 到达绝顶,加以顶饰; [acc] /krest/; [or]gmat;
constitute: [x] v. 构成,组成;任命; [acc] /ˈkɑːnstətuːt/; [or]gmat;
complex: [x] adj. 复杂的,难解的;复合的;  n. 情结;建筑群;综合体,集合体; [acc] /ˈkɑːmpleks/; [or]gmat;
controversy: [x] n. 争论,辩论; [acc] /ˈkɑːntrəvɜːrsi/; [or]gmat;
conspiracy: [x] n. 密谋,阴谋; [acc] /kənˈspɪrəsi/; [or]gmat;
restrain: [x] v. 制止(做);抑制(愤怒等),控制;监禁; [acc] /rɪˈstreɪn/; [or]gmat;
grove: [x] n. 小树林;果园; [acc] /ɡroʊv/; [or]gmat;
candidate: [x] n. (官职,获奖资格等的)候选人;投考人;申请求职者; [acc] /ˈkændɪdət/; [or]gmat;
patron: [x] n. 老主顾;赞助人;支持者; [acc] /ˈpeɪtrən/; [or]gmat;
celestial: [x] adj. 天体的,天上的;  n. 天人,神仙;(指封建时代的)中国人,天朝之人; [acc] /səˈlestʃl/; [or]gmat;
modify: [x] v. 改装,修改,更改;修饰,限定; [acc] /ˈmɑːdɪfaɪ/; [or]gmat;
inspection: [x] n. 检查,细看; [acc] /ɪnˈspekʃn/; [or]gmat;
substitute: [x] v. 代替;  n. 代替者,代用品,替补队员; [acc] /ˈsʌbstɪtuːt/; [or]gmat;
jurisdiction: [x] n. 司法权,审判权;管辖权;权限,权力; [acc] /ˌdʒʊrɪsˈdɪkʃn/; [or]gmat;
primary: [x] adj. 初等教育的;初级的;基本的;首要的;主要的;  n. 首选;(美)初选; [acc] /ˈpraɪmeri/; [or]gmat;
beam: [x] n. 光线;(房屋等)大梁;(横)梁;  v. 发光;照射;发射,播送;微笑;用梁支撑; [acc] /biːm/; [or]gmat;
hereditary: [x] adj. 世袭的,遗传的; [acc] /həˈredɪteri/; [or]gmat;
suffice: [x] v. 足够; [acc] /səˈfaɪs/; [or]gmat;
accuracy: [x] n. 准确(性);准确度; [acc] /ˈækjərəsi/; [or]gmat;
plead: [x] v. 恳求,辩护,(不)认罪;提出.为理由; [acc] /pliːd/; [or]gmat;
hinder: [x] v. 阻碍,妨碍;  adj. 后面的,后方的; [acc] /ˈhɪndər/; [or]gmat;
cord: [x] n. 细绳,索,(电工学)电绳;索,(电工学)电绳; [acc] /kɔːrd/; [or]gmat;
extract: [x] v. 取出;提取;摘录;设法得到;索取;  n. 摘录;提出物; [acc] /ɪkˈstrækt/; [or]gmat;
pint: [x] n. 品脱(液量,干量名〈美〉液量=0.47升,干量=0.55升); [acc] /paɪnt/; [or]gmat;
mute: [x] n. 弱音器;  adj. 缄默的;哑的;  vt. 减弱.的声音; [acc] /mjuːt/; [or]gmat;
cargo: [x] n. 货物; [acc] /ˈkɑːrɡoʊ/; [or]gmat;
compromise: [x] n. 妥协;折中;  v. 妥协;使遭受危害; [acc] /ˈkɑːmprəmaɪz/; [or]gmat;
rugged: [x] adj. 崎岖的,不平的,强壮的,艰苦的; [acc] /ˈrʌɡɪd/; [or]gmat;
refrain: [x] v. 抑制,避免;  n. 歌曲的反复句,叠句; [acc] /rɪˈfreɪn/; [or]gmat;
consumption: [x] n. 消耗,消费,耗尽;肺痨; [acc] /kənˈsʌmpʃn/; [or]gmat;
sustain: [x] v. 维持;支撑,承受;供养;忍受;遭受,蒙受; [acc] /səˈsteɪn/; [or]gmat;
resemble: [x] v. 像,相像,相似; [acc] /rɪˈzembl/; [or]gmat;
quote: [x] v. 报价;引用,援引;  n. 引用; [acc] /kwoʊt/; [or]gmat;
aristocracy: [x] n. 贵族;贵族统治;贵族政治;贵族品质; [acc] /ˌærɪˈstɑːkrəsi/; [or]gmat;
gradual: [x] adj. 逐渐的,逐步的,平缓的; [acc] /ˈɡrædʒuəl/; [or]gmat;
detached: [x] adj. 孤立的,分开的,超然公平的; [acc] /dɪˈtætʃt/; [or]gmat;
execute: [x] v. 处决;完成(动作);实行;执行(计划); [acc] /ˈeksɪkjuːt/; [or]gmat;
strive: [x] v. 斗争;努力,奋斗; [acc] /straɪv/; [or]gmat;
endeavor: [x] n. 尝试,努力,尽力;  v. 努力,尽力; [acc] /ɪnˈdevər/; [or]gmat;
barrier: [x] n. 障碍;屏障;隔阂;壁垒;  v. 用栅栏围住; [acc] /ˈbæriər/; [or]gmat;
flora: [x] n. 植物群; [acc] /ˈflɔːrə/; [or]gmat;
mantle: [x] n. 外壳;披风;地幔;  v. 覆盖; [acc] /ˈmæntl/; [or]gmat;
judicial: [x] adj. 司法的,法庭的,法律的,审判(上)的; [acc] /dʒuˈdɪʃl/; [or]gmat;
ridicule: [x] v. 嘲笑,愚弄;  n. 嘲笑,愚弄; [acc] /ˈrɪdɪkjuːl/; [or]gmat;
barrel: [x] n. 桶;枪管;  vi. 快速移动; [acc] /ˈbærəl/; [or]gmat;
tedious: [x] adj. 沉闷的,冗长乏味的; [acc] /ˈtiːdiəs/; [or]gmat;
expedient: [x] n. 权宜之计,手段;  adj. 有利的,方便的;权宜之计的; [acc] /ɪkˈspiːdiənt/; [or]gmat;
genial: [x] adj. 愉快的,脾气好的,友好的; [acc] /ˈdʒiːniəl/; [or]gmat;
hostility: [x] n. 虐待,敌意;不友善;敌对; [acc] /hɑːˈstɪləti/; [or]gmat;
obstacle: [x] n. 障碍;障碍物;妨碍; [acc] /ˈɑːbstəkl/; [or]gmat;
posterity: [x] n. 子孙,后裔,后代; [acc] /pɑːˈsterəti/; [or]gmat;
mason: [x] n. 泥瓦匠,共济会会员(等于freemason); [acc] /ˈmeɪsn/; [or]gmat;
patriotic: [x] adj. 爱国的,有爱国心的,显示爱国精神的; [acc] /ˌpeɪtriˈɑːtɪk/; [or]gmat;
foster: [x] adj. 收养的;  vt. 养育;培养,促进; [acc] /ˈfɔːstər/; [or]gmat;
patch: [x] n. 补丁;眼罩;斑点;  v. 打补丁;修补;匆忙拼凑; [acc] /pætʃ/; [or]gmat;
skull: [x] n. 颅骨;脑壳; [acc] /skʌl/; [or]gmat;
legislature: [x] n. 立法机关,立法机构; [acc] /ˈledʒɪsleɪtʃər/; [or]gmat;
famine: [x] n. 饥荒;严重的缺乏; [acc] /ˈfæmɪn/; [or]gmat;
fuel: [x] v. 给.加燃料;  n. 燃料;刺激因素; [acc] /ˈfjuːəl/; [or]gmat;
plunge: [x] v. 跳进,(使)投入;使陷入;暴跌;  n. 卷入,参与;暴跌,骤减; [acc] /plʌndʒ/; [or]gmat;
subordinate: [x] n. 部下;下属;  adj. 次要的;从属的;下级的;  v. 使从属于;使处于次要地位; [acc] /səˈbɔːrdɪnət/; [or]gmat;
patent: [x] n. 专利;  adj. 显然的,明显的;专利的;独创的;  v. 取得.的专利权; [acc] /ˈpætnt/; [or]gmat;
compel: [x] v. 强迫;迫使屈服;(使)不得已; [acc] /kəmˈpel/; [or]gmat;
margin: [x] n. 页边的空白,边缘;优势;利润; [acc] /ˈmɑːrdʒən/; [or]gmat;
resume: [x] n. 简历;  v. 重新开始;继续;  vt. 回到;恢复;重新开始; [acc] /ˈrezəmeɪ/; [or]gmat;
compound: [x] n. 复合物;[化学]化合物;  adj. 合成的;复合的;多功能的;  vi. 妥协;和解;  vt. 混合;调和;调停;使恶化; [acc] /ˈkɑːmpaʊnd/; [or]gmat;
imitate: [x] v. 模仿; [acc] /ˈɪmɪteɪt/; [or]gmat;
depression: [x] n. 抑郁,沮丧;不景气,萧条(期);洼地,凹陷; [acc] /dɪˈpreʃn/; [or]gmat;
prodigious: [x] adj. 异常的,奇妙的;巨大的; [acc] /prəˈdɪdʒəs/; [or]gmat;
vegetation: [x] n. 植被; [acc] /ˌvedʒəˈteɪʃn/; [or]gmat;
superb: [x] adj. 极好的;壮丽的; [acc] /suːˈpɜːrb/; [or]gmat;
confidential: [x] adj. 机密的;表示信任的;悄悄的; [acc] /ˌkɑːnfɪˈdenʃl/; [or]gmat;
sturdy: [x] adj. 结实的;坚固的;强壮的;健壮的;  n. (羊的)晕倒病; [acc] /ˈstɜːrdi/; [or]gmat;
verdict: [x] n. (陪审团)裁决;定论;意见; [acc] /ˈvɜːrdɪkt/; [or]gmat;
penetrate: [x] v. 刺穿,穿透;进入;了解; [acc] /ˈpenətreɪt/; [or]gmat;
spark: [x] n. 火花,火星;丝毫,微量;  v. 发出火花;发动;激励; [acc] /spɑːrk/; [or]gmat;
ally: [x] n. 盟友;同盟国;(二战时的) 同盟国;  v. 结盟; [acc] /ˈælaɪ/; [or]gmat;
tract: [x] n. 器官系统;一大片地;短文,小册子; [acc] /trækt/; [or]gmat;
plus: [x] prep. 加,加上;  n. 加号;有利因素;  adj. 正的,多的;有利的;阳性的;  conj. 此外,而且,况且; [acc] /plʌs/; [or]gmat;
condemn: [x] v. 谴责,责备;判(某人某罪); [acc] /kənˈdem/; [or]gmat;
unique: [x] adj. 独特的,独一无二的;(唯一的)特有的;不同寻常的; [acc] /juˈniːk/; [or]gmat;
navigation: [x] n. 导航,航行,航海; [acc] /ˌnævɪˈɡeɪʃn/; [or]gmat;
verge: [x] n. 边缘;边界;  v. 接近;濒临; [acc] /vɜːrdʒ/; [or]gmat;
sanction: [x] n. 批准;制裁,处罚;  v. 批准,支持,对..实施制裁; [acc] /ˈsæŋkʃn/; [or]gmat;
approbation: [x] n. 称赞,认可;批准; [acc] /ˌæprəˈbeɪʃn/; [or]gmat;
allegiance: [x] n. 忠诚,拥护; [acc] /əˈliːdʒəns/; [or]gmat;
expressly: [x] adv. 清楚地,明显地;特别地,专门地; [acc] /ɪkˈspresli/; [or]gmat;
dispose: [x] v. 处理,处置,除去;使愿意; [acc] /dɪˈspoʊz/; [or]gmat;
precaution: [x] n. 预防措施; [acc] /prɪˈkɔːʃn/; [or]gmat;
stature: [x] n. 身高,身材;(精神,道德等的)高度; [acc] /ˈstætʃər/; [or]gmat;
shift: [x] n. 转移;替换;轮值;  v. 移动;售卖(难卖的物品);换挡;改换,替换; [acc] /ʃɪft/; [or]gmat;
factor: [x] n. 因素;[数]因子,商; [acc] /ˈfæktər/; [or]gmat;
sanctuary: [x] n. 圣堂,避难所; [acc] /ˈsæŋktʃueri/; [or]gmat;
shrink: [x] v. 收缩;缩小;退缩;  n. (非正式用法)心理医生,精神病医生; [acc] /ʃrɪŋk/; [or]gmat;
crude: [x] adj. 天然的;粗糙的;粗鲁的;简陋的;  n. 原油; [acc] /kruːd/; [or]gmat;
bolt: [x] n. 门栓,螺栓;闪电;弩箭;  v. 闩门;(马受惊)脱缰;  adv. 突然地;像箭似地;直立地; [acc] /boʊlt/; [or]gmat;
captivity: [x] n. 囚禁;被关; [acc] /kæpˈtɪvəti/; [or]gmat;
vein: [x] n. 静脉;血管;叶脉;纹理;迹象;风格,性情; [acc] /veɪn/; [or]gmat;
passive: [x] adj. 被动的;消极的;  n. 被动语态; [acc] /ˈpæsɪv/; [or]gmat;
mystic: [x] adj. 神秘的,神秘主义的;  n. 神秘主义者; [acc] /ˈmɪstɪk/; [or]gmat;
infancy: [x] n. 婴儿期,幼年; [acc] /ˈɪnfənsi/; [or]gmat;
censure: [x] v. 责难,责备;  n. 责难,责备; [acc] /ˈsenʃər/; [or]gmat;
monotonous: [x] adj. 单调的,无聊的; [acc] /məˈnɑːtənəs/; [or]gmat;
catastrophe: [x] n. 大灾难; [acc] /kəˈtæstrəfi/; [or]gmat;
furnace: [x] n. 炉子,熔炉; [acc] /ˈfɜːrnɪs/; [or]gmat;
deem: [x] v. 认为,视为;知道,相信; [acc] /diːm/; [or]gmat;
punctuation: [x] n. 标点;全部标点符号; [acc] /ˌpʌŋktʃuˈeɪʃn/; [or]gmat;
pamphlet: [x] n. 小册子; [acc] /ˈpæmflət/; [or]gmat;
phase: [x] n. (月等的)变相;盈亏;方面;阶段; [acc] /feɪz/; [or]gmat;
discern: [x] v. 辨别;识别;看出; [acc] /dɪˈsɜːrn/; [or]gmat;
arbitrary: [x] adj. 随意的,任性的,随心所欲的;霸道的,专制的,专横的;主观的,武断的; [acc] /ˈɑːrbətreri/; [or]gmat;
parliament: [x] n. 议会;国会; [acc] /ˈpɑːrləmənt/; [or]gmat;
emergency: [x] n. 紧急情况;突发事件; [acc] /iˈmɜːrdʒənsi/; [or]gmat;
synonymous: [x] adj. 同义的;同义词的;同义突变的; [acc] /sɪˈnɑːnɪməs/; [or]gmat;
advocate: [x] v. 提倡;主张;为.辩护;  n. 辩护者;提倡者;律师; [acc] /ˈædvəkeɪt/; [or]gmat;
confirm: [x] v. 确认;证实;批准; [acc] /kənˈfɜːrm/; [or]gmat;
resign: [x] v. 辞职; [acc] /rɪˈzaɪn/; [or]gmat;
fragment: [x] n. 片段;碎片;  v. 使成碎片; [acc] /ˈfræɡmənt/; [or]gmat;
balcony: [x] n. 阳台,剧院楼厅; [acc] /ˈbælkəni/; [or]gmat;
hypothesis: [x] n. 假说;假设; [acc] /haɪˈpɑːθəsɪs/; [or]gmat;
width: [x] n. 宽度,广度,宽阔; [acc] /wɪdθ/; [or]gmat;
outrage: [x] n. 残暴;暴行,愤怒;  v. 使震怒,使愤慨; [acc] /ˈaʊtreɪdʒ/; [or]gmat;
attorney: [x] n. (辩护)律师; [acc] /əˈtɜːrni/; [or]gmat;
vent: [x] n. 发泄;通风口,排气口;(上衣背部或两侧的)开衩;(小型动物的)排泄口;  v. 发泄(情绪),开孔,泄露; [acc] /vent/; [or]gmat;
ranch: [x] n. 大农场; [acc] /ræntʃ/; [or]gmat;
ascending: [x] adj. 上升的; [acc] /əˈsendɪŋ/; [or]gmat;
odds: [x] n. 几率;可能性;投注赔率;优势;差异,不平等; [acc] /ɑːdz/; [or]gmat;
pension: [x] n. 养老金,抚恤金;廉租屋;  v. 发给..养老金; [acc] /ˈpenʃn/; [or]gmat;
hazard: [x] n. 公害;危险;危险的事物;机会;  v. 使冒危险;冒险做; [acc] /ˈhæzərd/; [or]gmat;
marine: [x] adj. 海洋的,航海的,海产的,海军的;  n. 海军士兵; [acc] /məˈriːn/; [or]gmat;
antique: [x] n. 古董;古玩;古物;  adj. 古代的;古董的; [acc] /ænˈtiːk/; [or]gmat;
orthodox: [x] adj. 正统的;传统的;(Orthodox)东正教的; [acc] /ˈɔːrθədɑːks/; [or]gmat;
alien: [x] n. 外国人;外星人;  adj. 陌生的;外国的,外星(人)的;异己的,不相容的; [acc] /ˈeɪliən/; [or]gmat;
recourse: [x] n. 求援(对象),求助(对象,[商][律]追索权; [acc] /ˈriːkɔːrs/; [or]gmat;
illustrate: [x] v. 举例说明,阐明;图解,加插图; [acc] /ˈɪləstreɪt/; [or]gmat;
clumsy: [x] adj. 笨拙的,不灵活的;拙劣的,不得体的; [acc] /ˈklʌmzi/; [or]gmat;
odor: [x] n. 气味; [acc] /ˈoʊdər/; [or]gmat;
prairie: [x] n. 大草原,(尤指)北美大草原;草原地带; [acc] /ˈpreri/; [or]gmat;
feudal: [x] adj. 领地的;封建制度的;封建时代的;世仇的; [acc] /ˈfjuːdl/; [or]gmat;
adoption: [x] n. 收养,采用,采纳; [acc] /əˈdɑːpʃn/; [or]gmat;
notorious: [x] adj. 臭名昭著的,声名狼藉的; [acc] /noʊˈtɔːriəs/; [or]gmat;
pasture: [x] n. 牧场,草地;生活状况;  v. 放牧; [acc] /ˈpæstʃər/; [or]gmat;
confinement: [x] n. 限制;监禁;分娩; [acc] /kənˈfaɪnmənt/; [or]gmat;
outfit: [x] n. 装备,全部用品,(协同工作)的一组人;  v. 提供装备; [acc] /ˈaʊtfɪt/; [or]gmat;
adjacent: [x] adj. 邻接的,毗连的;邻近的; [acc] /əˈdʒeɪsnt/; [or]gmat;
exceptional: [x] adj. 优越的,杰出的;异常的; [acc] /ɪkˈsepʃənl/; [or]gmat;
deposit: [x] v. 存款,存放;沉淀;  n. 存款,定金;沉积物,矿床; [acc] /dɪˈpɑːzɪt/; [or]gmat;
fragrance: [x] n. 香水;香味;芳香; [acc] /ˈfreɪɡrəns/; [or]gmat;
call for: [x] v. 需要;邀请;呼吁; [acc] /kɔːl fɔr/; [or]gmat;
superficial: [x] adj. 肤浅的;表面的;微不足道的;  n. 表面文章; [acc] /ˌsuːpərˈfɪʃl/; [or]gmat;
extinct: [x] adj. 灭绝的;破灭了的,消亡了的; [acc] /ɪkˈstɪŋkt/; [or]gmat;
excursion: [x] n. 远足;短途旅行; [acc] /ɪkˈskɜːrʒn/; [or]gmat;
lump: [x] n. 团;肿块;粗笨的人;一小方块 (糖);  v. 成团,成堆;使成块; [acc] /lʌmp/; [or]gmat;
magnitude: [x] n. 巨大;震级;重要性;[数]量值; [acc] /ˈmæɡnɪtuːd/; [or]gmat;
coral: [x] n. 珊瑚; [acc] /ˈkɔːrəl/; [or]gmat;
bondage: [x] n. 奴役,束缚; [acc] /ˈbɑːndɪdʒ/; [or]gmat;
hospitable: [x] adj. 好客的;有利的;宜人的; [acc] /hɑːˈspɪtəbl/; [or]gmat;
harness: [x] n. 挽具,马具,降落伞背带;  v. 上挽具;治理(河流等);利用; [acc] /ˈhɑːrnɪs/; [or]gmat;
syllable: [x] n. 音节; [acc] /ˈsɪləbl/; [or]gmat;
spur: [x] v. 策马,用踢马刺驱马前进;激励,鞭策;推动;  n. 踢马刺,靴刺;刺激,鞭策,鼓励;尖坡; [acc] /spɜːr/; [or]gmat;
neutral: [x] adj. 中立的;中性的;  n. 中立国;中性色; [acc] /ˈnuːtrəl/; [or]gmat;
vine: [x] n. 藤,蔓; [acc] /vaɪn/; [or]gmat;
compose: [x] v. 创作,作曲,形成,构成; [acc] /kəmˈpoʊz/; [or]gmat;
crust: [x] n. 外壳,面包皮,硬外皮; [acc] /krʌst/; [or]gmat;
sting: [x] v. 叮;刺疼;使苦闷;蜇;  n. (因被刺而引起的)疼痛;(警方为抓捕罪犯精心设计的)圈套; [acc] /stɪŋ/; [or]gmat;
episode: [x] n. 插曲,片断;连续剧的一集;一段经历; [acc] /ˈepɪsoʊd/; [or]gmat;
habitation: [x] n. 住处; [acc] /ˌhæbɪˈteɪʃn/; [or]gmat;
flourish: [x] vi. 繁荣,茂盛,兴旺;  vt. 挥舞;夸耀;  n. 兴旺;茂盛;炫耀;挥舞; [acc] /ˈflɜːrɪʃ/; [or]gmat;
underline: [x] v. 划线于.之下;突出显示;强调;  n. 下划线;下期节目预告;图下说明文字; [acc] /ˌʌndərˈlaɪn/; [or]gmat;
impose: [x] v. 把.强加;强制实行,强迫接受; [acc] /ɪmˈpoʊz/; [or]gmat;
accommodation: [x] n. 住宿,食宿;调解;住处; [acc] /əˌkɑːməˈdeɪʃn/; [or]gmat;
anonymous: [x] adj. 匿名的;无名的;不具名的;无特色的;无个性特征; [acc] /əˈnɑːnɪməs/; [or]gmat;
calf: [x] n. 小牛,小牛皮,小腿; [acc] /kæf/; [or]gmat;
manual: [x] n. 手册;指南;  adj. 手的;手制的;手工的;体力的; [acc] /ˈmænjuəl/; [or]gmat;
pang: [x] n. 剧痛,痛苦;  v. 使剧痛,折磨; [acc] /pæŋ/; [or]gmat;
masculine: [x] adj. 男性的;男子气概的; [acc] /ˈmæskjəlɪn/; [or]gmat;
remnant: [x] n. 遗迹;边角剩料; [acc] /ˈremnənt/; [or]gmat;
ale: [x] n. 麦芽啤酒; [acc] /eɪl/; [or]gmat;
truce: [x] n. 停战;休战;休战协定; [acc] /truːs/; [or]gmat;
aversion: [x] n. 厌恶;讨厌的人,(或东西); [acc] /əˈvɜːrʒn/; [or]gmat;
lapse: [x] n. 失误,过失;行为失检;(时间)流逝;  v. 退步,倒退,衰退;失效;背弃,放弃(宗教信仰); [acc] /læps/; [or]gmat;
enforce: [x] v. 实施;执行;强制; [acc] /ɪnˈfɔːrs/; [or]gmat;
skeleton: [x] n. 骨骼,梗概;骨瘦如柴的人或动物; [acc] /ˈskelɪtn/; [or]gmat;
confine: [x] v. 限制;监禁;  n. 范围,界限,约束,限制; [acc] /kənˈfaɪn/; [or]gmat;
reconcile: [x] v. 和解;调解;调和; [acc] /ˈrekənsaɪl/; [or]gmat;
appoint: [x] v. 委派,任命;约定;确定,指定; [acc] /əˈpɔɪnt/; [or]gmat;
suppress: [x] v. 镇压;禁止发表;抑制(感情等);阻止.的生长; [acc] /səˈpres/; [or]gmat;
mature: [x] adj. 成熟的;到期的;  vt. 使成熟;  vi. 成熟; [acc] /məˈtʃʊr/; [or]gmat;
guarantee: [x] v. 保证;担保;提供保修;  n. 保证;担保;保修单;保证金; [acc] /ˌɡærənˈtiː/; [or]gmat;
procedure: [x] n. 步骤,过程;程序;手续; [acc] /prəˈsiːdʒər/; [or]gmat;
futile: [x] adj. 无益的,无用的; [acc] /ˈfjuːtl/; [or]gmat;
baptism: [x] n. 洗礼;严峻考验; [acc] /ˈbæptɪzəm/; [or]gmat;
intrigue: [x] n. 阴谋;诡计;  v. 密谋;欺骗;引起极大兴趣; [acc] /ɪnˈtriːɡ/; [or]gmat;
imply: [x] vt. 暗示;暗指;意味着; [acc] /ɪmˈplaɪ/; [or]gmat;
absurdity: [x] n. 荒谬,谬论,荒谬的言行; [acc] /əbˈsɜːrdəti/; [or]gmat;
beset: [x] v. 困扰;镶嵌;围绕; [acc] /bɪˈset/; [or]gmat;
radical: [x] n. 激进分子;基础;原子团;根数,根式;  adj. 重大的,彻底的;激进的; [acc] /ˈrædɪkl/; [or]gmat;
concrete: [x] n. 混凝土;  adj. 具体的,实质性的;  v. 给 (道路等) 浇混凝土; [acc] /ˈkɑːŋkriːt/; [or]gmat;
combine: [x] v. 使混合(结合,组合,联合);结合;联合;组合;  n. 联合体,联合企业;联合收割机; [acc] /kəmˈbaɪn/; [or]gmat;
peak: [x] n. 顶峰;山顶;尖端;  v. 达到最高点;  adj. 最高度的;高峰时期的;巅峰状态的; [acc] /piːk/; [or]gmat;
currency: [x] n. 货币;流通;流行; [acc] /ˈkɜːrənsi/; [or]gmat;
reluctant: [x] adj. 不情愿的;勉强的; [acc] /rɪˈlʌktənt/; [or]gmat;
patronage: [x] n. 惠顾;赞助;任免权; [acc] /ˈpætrənɪdʒ/; [or]gmat;
mound: [x] n. 堆,高地,护堤;  v. 堆起,积成堆; [acc] /maʊnd/; [or]gmat;
confer: [x] v. 授予(奖项,学位,荣誉或权利);商讨,协商; [acc] /kənˈfɜːr/; [or]gmat;
tempt: [x] v. 诱惑;吸引;冒..的风险,不顾; [acc] /tempt/; [or]gmat;
renown: [x] n. 声誉;名望;  vt. 使有声望; [acc] /rɪˈnaʊn/; [or]gmat;
peer: [x] n. 同龄人,同等地位的人;贵族;  v. 仔细看,费力地看; [acc] /pɪr/; [or]gmat;
outcome: [x] n. 结果,后果; [acc] /ˈaʊtkʌm/; [or]gmat;
strand: [x] n. (线等的)股,缕;一个组成部分;海滨,河岸,海滩,湖滨;  v. 使陷入困境;使滞留,使搁浅; [acc] /strænd/; [or]gmat;
Spaniard: [x] n. 西班牙人; [acc] /ˈspænjərd/; [or]gmat;
hum: [x] v. 发出嗡嗡声,哼(歌曲);  n. 轰鸣声,嗡嗡营营声; [acc] /hʌm/; [or]gmat;
acquisition: [x] n. 并购;获得;掌握;获得物;取得物; [acc] /ˌækwɪˈzɪʃn/; [or]gmat;
trench: [x] n. 沟;壕沟,战壕;海沟; [acc] /trentʃ/; [or]gmat;
exert: [x] v. 尽(力),运用,发挥; [acc] /ɪɡˈzɜːrt/; [or]gmat;
veteran: [x] n. 老兵;退役军人;  adj. 经验丰富的;老练的; [acc] /ˈvetərən/; [or]gmat;
meek: [x] adj. 温顺的,逆来顺受的;谦恭的;  n. 温顺的人;谦恭的人; [acc] /miːk/; [or]gmat;
judicious: [x] adj. 有判断力的;明智的; [acc] /dʒuˈdɪʃəs/; [or]gmat;
testify: [x] vt. 作证;  vi. 证明;  v. 声明;见证(上帝的存在);证实; [acc] /ˈtestɪfaɪ/; [or]gmat;
orchestra: [x] n. 管弦乐队;  adj. 管弦乐队的; [acc] /ˈɔːrkɪstrə/; [or]gmat;
maternal: [x] adj. 母亲的,母性的;母方的,母系的; [acc] /məˈtɜːrnl/; [or]gmat;
strata: [x] n. 层;地层;阶层; [acc] /ˈstreɪtə/; [or]gmat;
miniature: [x] adj. 小型的,微小的;  n. 微小的模型,缩影,微型人物像;  vt. 使成小型;把.画成纤细画;缩写; [acc] /ˈmɪnətʃər/; [or]gmat;
flavor: [x] n. 味,风味;调味品;  v. 给..调味; [acc] /ˈfleɪvər/; [or]gmat;
inconsistent: [x] adj. 不一致的,前后矛盾的; [acc] /ˌɪnkənˈsɪstənt/; [or]gmat;
emancipation: [x] n. 释放;解放; [acc] /ɪˌmænsɪˈpeɪʃn/; [or]gmat;
asunder: [x] adv. 分离;化为碎片; [acc] /əˈsʌndər/; [or]gmat;
bustle: [x] n. 喧闹,熙攘;腰垫;奔走,奔忙;  v. 喧闹;忙乱,奔忙; [acc] /ˈbʌsl/; [or]gmat;
pastoral: [x] adj. 田园生活的,牧师的;  n. 牧歌;田园诗;田园景色;牧师写给教区居民的公开信; [acc] /ˈpæstərəl/; [or]gmat;
specimen: [x] n. 标本,样本,样品; [acc] /ˈspesɪmən/; [or]gmat;
fabric: [x] n. 布料,织物;质地,结构; [acc] /ˈfæbrɪk/; [or]gmat;
preface: [x] n. 序言,前言,开端; [acc] /ˈprefəs/; [or]gmat;
outdated: [x] adj. 过时的,老式的;落伍的; [acc] /ˌaʊtˈdeɪtɪd/; [or]gmat;
pecuniary: [x] adj. 金钱(上)的; [acc] /pɪˈkjuːnieri/; [or]gmat;
dire: [x] adj. 可怕的;悲惨的;极端的; [acc] /ˈdaɪər/; [or]gmat;
instruct: [x] v. 指导;教;指示;通知; [acc] /ɪnˈstrʌkt/; [or]gmat;
Puritan: [x] n. 清教徒,极端拘谨的人;  adj. 清教徒的; [acc] /ˈpjʊrɪtən/; [or]gmat;
intermediate: [x] adj. 中间的,居间的;中级的;  n. 中间体,媒介物;  v. 调解,干涉; [acc] /ˌɪntərˈmiːdiət/; [or]gmat;
formula: [x] n. 公式,方程式;配方;方案;方法;配方奶; [acc] /ˈfɔːrmjələ/; [or]gmat;
ore: [x] n. 矿石;矿砂;矿,矿石; [acc] /ɔːr/; [or]gmat;
haunt: [x] v. 常去,萦绕于..;(鬼,魂)常出没于;(思想)萦绕;  n. 常去的地方; [acc] /hɔːnt/; [or]gmat;
faction: [x] n. 派别,小集团,小派系;派系斗争,内讧; [acc] /ˈfækʃn/; [or]gmat;
architect: [x] n. 设计师;建筑师; [acc] /ˈɑːrkɪtekt/; [or]gmat;
ransom: [x] n. 赎金,赎身;  v. 赎回,解救; [acc] /ˈrænsəm/; [or]gmat;
surplus: [x] adj. 过剩的,多余的;  n. 过剩,盈余;顺差; [acc] /ˈsɜːrplʌs/; [or]gmat;
contemptuous: [x] adj. 藐视的,倨傲的; [acc] /kənˈtemptʃuəs/; [or]gmat;
reef: [x] n. 礁;  v. 收帆,缩帆; [acc] /riːf/; [or]gmat;
tissue: [x] n. 面巾纸,(动植物的)组织,纱布; [acc] /ˈtɪʃuː/; [or]gmat;
epic: [x] adj. 史诗的,叙事诗的;壮丽的,宏大的;  n. 史诗;叙事诗;史诗般的作品; [acc] /ˈepɪk/; [or]gmat;
impart: [x] v. 传授,给予,将(某性质)给予或赋予某事物; [acc] /ɪmˈpɑːrt/; [or]gmat;
statute: [x] n. 法令,法规,条例; [acc] /ˈstætʃuːt/; [or]gmat;
girdle: [x] n. 腰带;妇女紧身褡;  v. 围,包围,环绕; [acc] /ˈɡɜːrdl/; [or]gmat;
tenant: [x] n. 承租人,租客,佃户; [acc] /ˈtenənt/; [or]gmat;
humane: [x] adj. 人道的;仁慈的; [acc] /hjuːˈmeɪn/; [or]gmat;
fertility: [x] n. 多产;肥沃;[农经]生产力;丰饶; [acc] /fərˈtɪləti/; [or]gmat;
millennium: [x] n. 千禧年;太平盛世; [acc] /mɪˈleniəm/; [or]gmat;
spectator: [x] n. 旁观者;观众;目击者; [acc] /ˈspekteɪtər/; [or]gmat;
imperative: [x] adj. 必要的;祈使的;急需的;  n. 命令;必要的事;义务;驱使; [acc] /ɪmˈperətɪv/; [or]gmat;
steer: [x] v. 操纵,驾驶,掌舵,引导;  n. 公牛,食用牛; [acc] /stɪr/; [or]gmat;
imminent: [x] adj. 迫近的,紧迫的,即将来临的; [acc] /ˈɪmɪnənt/; [or]gmat;
apprehend: [x] vt. 理解,领会;逮捕;对.忧虑;把.视作;  vi. 忧虑; [acc] /ˌæprɪˈhend/; [or]gmat;
hem: [x] n. 边,缘;摺边;  v. 给..缝边;包围; [acc] /hem/; [or]gmat;
renounce: [x] vt. 宣布放弃,与...断绝关系;抛弃;  vi. 垫牌;  n. 垫牌; [acc] /rɪˈnaʊns/; [or]gmat;
commend: [x] v. 称赞;推荐;委托保管; [acc] /kəˈmend/; [or]gmat;
revive: [x] v. (使)苏醒;(使)复苏;再兴起;重做; [acc] /rɪˈvaɪv/; [or]gmat;
intervention: [x] n. 介入;调停;干涉,干预; [acc] /ˌɪntərˈvenʃn/; [or]gmat;
susceptible: [x] adj. 易受感染的;易受影响的;多情的; [acc] /səˈseptəbl/; [or]gmat;
subsistence: [x] n. 存在,生存;生活;  adj. 收成仅够自身口粮的; [acc] /səbˈsɪstəns/; [or]gmat;
disciple: [x] n. 信徒,门徒;耶稣的信徒(或门徒,使徒); [acc] /dɪˈsaɪpl/; [or]gmat;
revival: [x] n. 复活,复兴; [acc] /rɪˈvaɪvl/; [or]gmat;
mechanism: [x] n. 机械装置;机制,机理,原理; [acc] /ˈmekənɪzəm/; [or]gmat;
loaf: [x] n. (一条)面包;  v. 虚度光阴; [acc] /loʊf/; [or]gmat;
index: [x] n. 索引;指标,标志;指数;  v. 附以索引,编入索引; [acc] /ˈɪndeks/; [or]gmat;
transmit: [x] v. 传送;传播,传导;发射; [acc] /trænsˈmɪt/; [or]gmat;
liver: [x] n. 肝脏;(供食用的动物)肝脏; [acc] /ˈlɪvər/; [or]gmat;
dip: [x] v. 浸,蘸;  n. 倾斜,下降;调味汁; [acc] /dɪp/; [or]gmat;
inexplicable: [x] adj. 无法解释的,难理解的,莫名其妙的; [acc] /ˌɪnɪkˈsplɪkəbl/; [or]gmat;
diminish: [x] v. 减少;失势,削弱.的权势, 减弱.的权势; [acc] /dɪˈmɪnɪʃ/; [or]gmat;
rim: [x] n. (圆形物体的)边;轮辋,轮缘,轮圈;  v. 形成边缘; [acc] /rɪm/; [or]gmat;
monopoly: [x] n. 垄断;专卖;垄断商品;专卖商品; [acc] /məˈnɑːpəli/; [or]gmat;
temperate: [x] adj. 温和的;适度的,有节制的; [acc] /ˈtempərət/; [or]gmat;
amber: [x] n. 琥珀,琥珀色;  v. 使呈琥珀色;  adj. 琥珀色的,琥珀制的; [acc] /ˈæmbər/; [or]gmat;
howl: [x] v. (狼,狗等)嗥叫;(风等)呼啸;(因愤怒,痛苦等)吼叫,哀号;  n. 嚎叫,哀号; [acc] /haʊl/; [or]gmat;
submarine: [x] n. 潜水艇;  adj. 水底的,海底的; [acc] /ˈsʌbməriːn/; [or]gmat;
perpendicular: [x] adj. 成直角的,垂直的;直立的;  n. 垂直线; [acc] /ˌpɜːrpənˈdɪkjələr/; [or]gmat;
fervent: [x] adj. 热烈的,满怀热情的;狂热的; [acc] /ˈfɜːrvənt/; [or]gmat;
wreath: [x] n. 花圈;花环;圈状物; [acc] /riːθ/; [or]gmat;
undergo: [x] v. 经历;遭受; [acc] /ˌʌndərˈɡoʊ/; [or]gmat;
haze: [x] n. 阴霾;薄雾;疑惑,迷糊;  v. (使)变朦胧;(使)变糊涂; [acc] /heɪz/; [or]gmat;
concession: [x] n. 让步;特许,特许权;承认; [acc] /kənˈseʃn/; [or]gmat;
caste: [x] n. (印度社会中的)种姓;(具有严格等级差别的)社会地位;(排他的)社会团体; [acc] /kæst/; [or]gmat;
fortitude: [x] n. 坚强意志(精神),坚忍,刚毅; [acc] /ˈfɔːrtətuːd/; [or]gmat;
anticipate: [x] v. 预测;期待;提早(做); [acc] /ænˈtɪsɪpeɪt/; [or]gmat;
discord: [x] n. 不和,争吵;(声音)不和谐; [acc] /ˈdɪskɔːrd/; [or]gmat;
vehement: [x] adj. 猛烈的,强烈的; [acc] /ˈviːəmənt/; [or]gmat;
wage: [x] n. 薪水,报酬;  v. 开展,进行(战争,运动); [acc] /weɪdʒ/; [or]gmat;
drain: [x] vi. 排出,排水;  v. 流干,沥干;喝光,耗尽,减少,消逝;  vt. 使流出,排掉水;  n. 下水道,排水管;消耗,排水; [acc] /dreɪn/; [or]gmat;
frivolous: [x] adj. 轻佻的,不重要的,缺乏基础的; [acc] /ˈfrɪvələs/; [or]gmat;
provoke: [x] v. 激怒;对.挑衅;引起; [acc] /prəˈvoʊk/; [or]gmat;
reside: [x] v. 居住; [acc] /rɪˈzaɪd/; [or]gmat;
apparel: [x] n. 服装,衣服;  vt. 给.穿衣服(尤指华丽或特殊的服装); [acc] /əˈpærəl/; [or]gmat;
colossal: [x] adj. 巨像(似)的;巨大的,庞大的; [acc] /kəˈlɑːsl/; [or]gmat;
stimulus: [x] n. 刺激物;鼓励;促进因素; [acc] /ˈstɪmjələs/; [or]gmat;
digest: [x] v. 消化;领会,理解;  n. 摘要; [acc] /daɪˈdʒest/; [or]gmat;
plateau: [x] n. 高原;  vi. 到达平稳阶段; [acc] /plæˈtoʊ/; [or]gmat;
presentation: [x] n. 演讲;报告;介绍;颁奖仪式; [acc] /ˌpriːzenˈteɪʃn/; [or]gmat;
devise: [x] v. 设计,想出;密谋;遗赠(不动产);  n. 设计,发明,遗赠; [acc] /dɪˈvaɪz/; [or]gmat;
exclude: [x] vt. 不包括;排挤;排除;驱逐,赶出; [acc] /ɪkˈskluːd/; [or]gmat;
inflict: [x] v. 使遭受(损伤,痛苦等);使承担(负担等); [acc] /ɪnˈflɪkt/; [or]gmat;
explore: [x] v. 探险,探索,尝试; [acc] /ɪkˈsplɔːr/; [or]gmat;
whirl: [x] v. 回旋;使旋转;  n. 回旋;一个接一个的活动; [acc] /wɜːrl/; [or]gmat;
ballad: [x] n. 歌谣;小曲; [acc] /ˈbæləd/; [or]gmat;
cylinder: [x] n. 圆柱体,圆筒;汽缸,泵(或桶)体; [acc] /ˈsɪlɪndər/; [or]gmat;
maxim: [x] n. 格言;准则;座右铭; [acc] /ˈmæksɪm/; [or]gmat;
bust: [x] n. 半身塑像;胸部;  v. 打碎;搜捕;降级;终止;  adj. 破产的;打碎的; [acc] /bʌst/; [or]gmat;
intuition: [x] n. 直觉;感觉; [acc] /ˌɪntuˈɪʃn/; [or]gmat;
mingle: [x] v. 使混合,使相混;  vi. 相交往,相往来; [acc] /ˈmɪŋɡl/; [or]gmat;
client: [x] n. 委托人,当事人,主顾,客户;客户端; [acc] /ˈklaɪənt/; [or]gmat;
tenor: [x] n. 男高音,要点,要旨,稳定的进程;  adj. (乐器)次中音的;(组钟中的)最低音的;男高音的; [acc] /ˈtenər/; [or]gmat;
strenuous: [x] adj. 费力的;奋发的;热心的;艰苦的;紧张的; [acc] /ˈstrenjuəs/; [or]gmat;
analogy: [x] n. 比拟,比喻;类比;相似;类似; [acc] /əˈnælədʒi/; [or]gmat;
infer: [x] vt. 做出推论,推断;推理;暗示;  vi. 推断; [acc] /ɪnˈfɜːr/; [or]gmat;
launch: [x] v. 发射;出海;创办,开始从事;  n. 发射,投放市场;(游艇,汽艇)下水;发行; [acc] /lɔːntʃ/; [or]gmat;
adverse: [x] adj. 不利的;(方向上)逆的;在相反的方向上移动(或运转);相反的; [acc] /ˈædvɜːrs/; [or]gmat;
strait: [x] n. 海峡;窘迫; [acc] /streɪt/; [or]gmat;
scrap: [x] n. 碎片;口角,吵架;小块,小片;废金属;残羹冷炙;  v. 报废;舍弃;打架; [acc] /skræp/; [or]gmat;
pirate: [x] n. 海盗;剽窃者;  v. 剽窃; [acc] /ˈpaɪrət/; [or]gmat;
prevalent: [x] adj. 普遍的,流行的; [acc] /ˈprevələnt/; [or]gmat;
snap: [x] v. 使喀嚓一声折断,使发出吧嗒一声(关上或打开);  n. 吧嗒声;快照;  adj. 仓促的,突然的; [acc] /snæp/; [or]gmat;
geese: [x] n. 鹅; [acc] /ɡiːs/; [or]gmat;
magnetic: [x] adj. 有磁性的;有吸引力的; [acc] /mæɡˈnetɪk/; [or]gmat;
predecessor: [x] n. 前辈;(被取代的)原有事物; [acc] /ˈpredəsesər/; [or]gmat;
impartial: [x] adj. 公平的,不偏不倚的; [acc] /ɪmˈpɑːrʃl/; [or]gmat;
wig: [x] n. 假发;呵斥;  v. 呵斥;  adj. 戴假发的; [acc] /wɪɡ/; [or]gmat;
feat: [x] n. 绝技,功绩,武艺; [acc] /fiːt/; [or]gmat;
sultan: [x] n. 苏丹(某些伊斯兰国家最高统治者称号); [acc] /ˈsʌltən/; [or]gmat;
certificate: [x] n. 合格证书,文凭;证明,证明书;  v. 给..发证书; [acc] /sərˈtɪfɪkət/; [or]gmat;
subdue: [x] v. 征服,压制,减轻; [acc] /səbˈduː/; [or]gmat;
ancestor: [x] n. 祖宗;祖先;原型; [acc] /ˈænsestər/; [or]gmat;
cluster: [x] n. 一串;一簇;  v. 群集;丛生; [acc] /ˈklʌstər/; [or]gmat;
plausible: [x] adj. 似乎有理的;巧嘴的; [acc] /ˈplɔːzəbl/; [or]gmat;
rhetoric: [x] n. 修辞学,浮夸的言语;雄辩术; [acc] /ˈretərɪk/; [or]gmat;
scrape: [x] n. 擦伤;刮,擦;  v. 刮,擦; [acc] /skreɪp/; [or]gmat;
congenial: [x] adj. 意气相投的,令人愉快的,意气相投的,协调的; [acc] /kənˈdʒiːniəl/; [or]gmat;
bureau: [x] n. 局,司,处,社,所; [acc] /ˈbjʊroʊ/; [or]gmat;
slice: [x] v. 把..切成片;大幅度削减;切开;  n. 薄片;份额,部分; [acc] /slaɪs/; [or]gmat;
renaissance: [x] n. 新生,复兴;文艺复兴; [acc] /ˈrenəsɑːns/; [or]gmat;
perspiration: [x] n. 汗水;出汗; [acc] /ˌpɜːrspəˈreɪʃn/; [or]gmat;
courier: [x] n. 快递员,通讯员,导游; [acc] /ˈkʊriər/; [or]gmat;
womb: [x] n. 子宫,发源地;  vi. 容纳;  vt. 容纳; [acc] /wuːm/; [or]gmat;
mortality: [x] n. 死亡数,死亡率;必死的命运; [acc] /mɔːrˈtæləti/; [or]gmat;
envious: [x] adj. 羡慕的,嫉妒的; [acc] /ˈenviəs/; [or]gmat;
sojourn: [x] n. 逗留,旅居;  vi. 逗留,旅居; [acc] /ˈsoʊdʒɜːrn/; [or]gmat;
amateur: [x] n. 业余爱好者;外行;  adj. 外行的;业余爱好的,业余(身份)的; [acc] /ˈæmətʃər/; [or]gmat;
originality: [x] n. 创造性;独创性; [acc] /əˌrɪdʒəˈnæləti/; [or]gmat;
isolation: [x] n. 孤独,孤立状态;孤立;隔离;[电]绝缘;[化学]离析; [acc] /ˌaɪsəˈleɪʃn/; [or]gmat;
perspective: [x] n. 角度,视角,观点,想法;(对事物的)合理判断,正确认识;远景;透视图,透视法,透视效果;  adj. 透视的; [acc] /pərˈspektɪv/; [or]gmat;
withstand: [x] v. 忍受;抵挡; [acc] /wɪðˈstænd/; [or]gmat;
robust: [x] adj. 健壮的,强壮的;精力充沛的;坚固的;粗鲁的; [acc] /roʊˈbʌst/; [or]gmat;
allude: [x] v. 间接提到,暗指,暗示; [acc] /əˈluːd/; [or]gmat;
psychological: [x] adj. 心理的,心理学的; [acc] /ˌsaɪkəˈlɑːdʒɪkl/; [or]gmat;
intricate: [x] adj. 错综复杂的; [acc] /ˈɪntrɪkət/; [or]gmat;
limestone: [x] n. [地质学]石灰岩;石灰石; [acc] /ˈlaɪmstoʊn/; [or]gmat;
foresee: [x] v. 预知,预料,预测; [acc] /fɔːrˈsiː/; [or]gmat;
clan: [x] n. 家族;氏族;部落;宗派;亲族; [acc] /klæn/; [or]gmat;
Canon: [x] n. 标准,教规,正典圣经,教士; [acc] /ˈkænən/; [or]gmat;
oval: [x] adj. 椭圆形的;  n. 椭圆形; [acc] /ˈoʊvl/; [or]gmat;
cedar: [x] n. 雪松,香柏,西洋杉木; [acc] /ˈsiːdər/; [or]gmat;
contradict: [x] v. 与..发生矛盾,与..抵触,与..对立; [acc] /ˌkɑːntrəˈdɪkt/; [or]gmat;
advent: [x] n. 来临;到来;出现; [acc] /ˈædvent/; [or]gmat;
gear: [x] n. 档位;齿轮;装备;衣物;  v. 使适合; [acc] /ɡɪr/; [or]gmat;
accompaniment: [x] n. 伴奏;伴随物; [acc] /əˈkʌmpənimənt/; [or]gmat;
lumber: [x] v. 缓慢地移动;拖累,迫使担负;伐木;杂乱地堆积;隆隆地行进;  n. 木材;废旧家具,不用的大件物品;无用的杂物;隆隆声; [acc] /ˈlʌmbər/; [or]gmat;
sentinel: [x] n. 哨兵,看守;  v. 守卫,放哨; [acc] /ˈsentɪnl/; [or]gmat;
bower: [x] n. 凉亭,树荫下凉快之处; [acc] /ˈbaʊər/; [or]gmat;
scout: [x] v. 侦察;监视;嘲笑;  n. 童子军,侦察员,守卫; [acc] /skaʊt/; [or]gmat;
heritage: [x] n. 遗产;继承物;传统;文化遗产; [acc] /ˈherɪtɪdʒ/; [or]gmat;
battalion: [x] n. 营,军营;军队,部队; [acc] /bəˈtæliən/; [or]gmat;
persist: [x] v. 坚持,固执;继续存留; [acc] /pərˈsɪst/; [or]gmat;
outlet: [x] n. 出口;插座;表现机会,发泄方法;廉价经销店; [acc] /ˈaʊtlet/; [or]gmat;
inherit: [x] v. 经遗传而得(特性等);接受遗产;沿袭;继任; [acc] /ɪnˈherɪt/; [or]gmat;
velocity: [x] n. 速度;迅速,快速; [acc] /vəˈlɑːsəti/; [or]gmat;
chart: [x] n. 图表,表格;航海图;每周排行榜;  v. 制成图表;制航海图; [acc] /tʃɑːrt/; [or]gmat;
omen: [x] n. 征兆,预兆;  vt. 预示;预告;有.的前兆; [acc] /ˈoʊmən/; [or]gmat;
bleak: [x] adj. 凄凉的;萧瑟的;阴郁的;无希望的; [acc] /bliːk/; [or]gmat;
clerical: [x] adj. 书记的;牧师的;办事员的;  n. 牧师; [acc] /ˈklerɪkl/; [or]gmat;
ordinance: [x] n. 法令;条例;条例;圣餐式; [acc] /ˈɔːrdɪnəns/; [or]gmat;
pallid: [x] adj. 苍白的,病态的,无生气的; [acc] /ˈpælɪd/; [or]gmat;
ritual: [x] n. (宗教等的)仪式,例行公事,老规矩;  adj. 作为仪式一部分的,例行的; [acc] /ˈrɪtʃuəl/; [or]gmat;
fiscal: [x] adj. 会计的;财政的;国库的; [acc] /ˈfɪskl/; [or]gmat;
cynical: [x] adj. 愤世嫉俗的;恶意的;悲观的; [acc] /ˈsɪnɪkl/; [or]gmat;
turbulent: [x] adj. 湍急的;混乱的,动荡的;骚动的; [acc] /ˈtɜːrbjələnt/; [or]gmat;
chant: [x] v. 吟唱;诵扬;  n. 圣歌;赞美诗;旋律; [acc] /tʃænt/; [or]gmat;
initial: [x] adj. 第一的;最初的;开始的;  n. 首字母; [acc] /ɪˈnɪʃl/; [or]gmat;
minimum: [x] adj. 最少的,最低程度的;  n. 最低限度,最小量; [acc] /ˈmɪnɪməm/; [or]gmat;
overlook: [x] v. 忽视,未注意到;眺望,俯视;  n. 忽视,远眺; [acc] /ˌoʊvərˈlʊk/; [or]gmat;
inhabit: [x] v. 居住于; [acc] /ɪnˈhæbɪt/; [or]gmat;
tout: [x] v. 招徕顾客,极力赞扬; [acc] /taʊt/; [or]gmat;
stroll: [x] n. 漫步;散步;闲荡;溜达;  vi. 散步;  vt. 溜达;游荡;在.散步;在.漫步; [acc] /stroʊl/; [or]gmat;
temperance: [x] n. 自制;节制;禁酒; [acc] /ˈtempərəns/; [or]gmat;
austere: [x] adj. 严峻的;简朴的;苦行的;无装饰的; [acc] /ɔːˈstɪr/; [or]gmat;
administer: [x] v. 管理;执行;实施;给予;用(药); [acc] /ədˈmɪnɪstər/; [or]gmat;
benefactor: [x] n. 恩人;捐助者;施主; [acc] /ˈbenɪfæktər/; [or]gmat;
scatter: [x] v. (使)分散,撒开,散播; [acc] /ˈskætər/; [or]gmat;
dexterity: [x] n. 纯熟;灵巧; [acc] /dekˈsterəti/; [or]gmat;
pernicious: [x] adj. 有害的,恶性的,致命的; [acc] /pərˈnɪʃəs/; [or]gmat;
economical: [x] adj. 节约的;经济的;合算的; [acc] /ˌekəˈnɑːmɪkl/; [or]gmat;
brazen: [x] adj. 厚脸皮的,厚颜无耻的;黄铜(制)的;  v. 厚着脸皮干,使变得无耻; [acc] /ˈbreɪzn/; [or]gmat;
mythology: [x] n. 神话,神话学; [acc] /mɪˈθɑːlədʒi/; [or]gmat;
stride: [x] v. 大步走;越过;跨越;  vt. 大步走过;跨骑在.上;  n. 大步;阔步行走的姿势;一大步;跨越;正常的进展; [acc] /straɪd/; [or]gmat;
circumference: [x] n. 圆周长度,圆周;周围; [acc] /sərˈkʌmfərəns/; [or]gmat;
secluded: [x] adj. 隐遁的,隔绝的; [acc] /sɪˈkluːdɪd/; [or]gmat;
reliable: [x] adj. 可靠的;可信赖的;确实的; [acc] /rɪˈlaɪəbl/; [or]gmat;
collapse: [x] v. (使)倒塌,(使)崩溃,(使)瓦解;  n. 倒塌,崩溃,暴跌; [acc] /kəˈlæps/; [or]gmat;
lore: [x] n. 传说;(专门的)知识,学问; [acc] /lɔːr/; [or]gmat;
scrupulous: [x] adj. 小心谨慎的;严谨的;细心的; [acc] /ˈskruːpjələs/; [or]gmat;
redress: [x] n. 纠正,革除,救济;  v. 修正,救济,革除; [acc] /rɪˈdres/; [or]gmat;
solar: [x] adj. 太阳的;太阳系的;日光的;  n. 日光浴室; [acc] /ˈsoʊlər/; [or]gmat;
raid: [x] n. 突袭;袭击;  v. 袭击;劫掠;攫取;突然搜捕; [acc] /reɪd/; [or]gmat;
Quaker: [x] n. 夸克党,教友派信徒; [acc] /ˈkweɪkər/; [or]gmat;
lease: [x] v. 出租,租得;  n. 租约,租契; [acc] /liːs/; [or]gmat;
friction: [x] n. 摩擦,摩擦力;争执,冲突; [acc] /ˈfrɪkʃn/; [or]gmat;
stale: [x] adj. 不新鲜的;走了味的;陈腐的;  v. 变得不新鲜;使陈旧;  n. (猎人做掩蔽用的)假马;笑柄;受人愚弄成为笑谈的人;畜尿; [acc] /steɪl/; [or]gmat;
intermittent: [x] adj. 断断续续的,间歇的; [acc] /ˌɪntərˈmɪtənt/; [or]gmat;
wholesale: [x] n. 批发;  adv. 大批大批地;  adj. 大规模的;批发的;  v. 批发; [acc] /ˈhoʊlseɪl/; [or]gmat;
recreation: [x] n. 娱乐活动,消遣; [acc] /ˌrekriˈeɪʃn/; [or]gmat;
rivalry: [x] n. 竞争,敌对; [acc] /ˈraɪvlri/; [or]gmat;
whim: [x] n. 一时的兴致,心血来潮,奇想,幻想; [acc] /wɪm/; [or]gmat;
ceremonial: [x] n. 宗教仪式;礼节;  adj. 仪式的;礼仪的,正式的; [acc] /ˌserɪˈmoʊniəl/; [or]gmat;
sample: [x] n. 样品,样本;(用于检验,分析的) 试样;  adj. 样品的,作为例子的;  vi. 抽样检查;  vt. 抽取.的试样;  v. 品尝;体验,尝试; [acc] /ˈsæmpl/; [or]gmat;
mutiny: [x] n. 兵变,叛乱,暴动;  v. 反叛,暴动,参加叛乱; [acc] /ˈmjuːtəni/; [or]gmat;
farce: [x] n. 闹剧;胡闹;笑剧; [acc] /fɑːrs/; [or]gmat;
pair: [x] n. 一对;  v. 成对,配对; [acc] /per/; [or]gmat;
profile: [x] n. 侧面像;外形,轮廓;  v. 描绘..的轮廓,扼要描述; [acc] /ˈproʊfaɪl/; [or]gmat;
lessen: [x] v. 减少;减轻; [acc] /ˈlesn/; [or]gmat;
capricious: [x] adj. 变化无常的,任性的; [acc] /kəˈprɪʃəs/; [or]gmat;
paltry: [x] adj. 不足取的,无价值的,琐碎的,卑鄙的; [acc] /ˈpɔːltri/; [or]gmat;
periodical: [x] n. 期刊;杂志; [acc] /ˌpɪriˈɑːdɪkl/; [or]gmat;
premature: [x] adj. 早产的,过早的,早熟的;  n. 早产儿; [acc] /ˌpriːməˈtʃʊr/; [or]gmat;
multiply: [x] v. 乘;繁殖;增加; [acc] /ˈmʌltɪplaɪ/; [or]gmat;
prosper: [x] v. (生意等)成功;(城市,文化,植物生长等)繁荣; [acc] /ˈprɑːspər/; [or]gmat;
subscription: [x] n. 订阅;捐款;签署;同意;会费;  adj. 收费的; [acc] /səbˈskrɪpʃn/; [or]gmat;
particle: [x] n. 粒子,微粒;[语]小品词; [acc] /ˈpɑːrtɪkl/; [or]gmat;
innate: [x] adj. 与生俱来的,天生的; [acc] /ɪˈneɪt/; [or]gmat;
clump: [x] n. 土块;  v. 丛生; [acc] /klʌmp/; [or]gmat;
emerald: [x] n. 祖母绿,翡翠;  adj. 翠绿色的; [acc] /ˈemərəld/; [or]gmat;
foresight: [x] n. 先见,预见;远见,深谋远虑; [acc] /ˈfɔːrsaɪt/; [or]gmat;
ape: [x] n. 无尾猿,类人猿;模仿者;粗野的大汉;  adj. 〈俚〉疯狂的;  v. 模仿; [acc] /eɪp/; [or]gmat;
span: [x] n. 跨度;时间段;范围;持续时间;  v. 持续;横跨;包括; [acc] /spæn/; [or]gmat;
snuff: [x] v. (伤风鼻阻时)用鼻子使劲地吸,扑灭;  n. 灯花,烛花,鼻吸气息,气息; [acc] /snʌf/; [or]gmat;
inquisitive: [x] adj. 好奇的,好打听的; [acc] /ɪnˈkwɪzətɪv/; [or]gmat;
affirmative: [x] adj. 肯定的,积极的;  n. 肯定语,赞成的一方; [acc] /əˈfɜːrmətɪv/; [or]gmat;
dispense: [x] v. 分发,分配,免除,执行; [acc] /dɪˈspens/; [or]gmat;
demonstrate: [x] vt. (用实例,实验)论证;演示,展示;示范;  vi. 示威; [acc] /ˈdemənstreɪt/; [or]gmat;
arithmetic: [x] n. 计算;算术; [acc] /əˈrɪθmətɪk/; [or]gmat;
impunity: [x] n. 不受惩罚;无患; [acc] /ɪmˈpjuːnəti/; [or]gmat;
remainder: [x] n. 剩下的人;剩余物,残留部分;  v. 减价出售,削价处理;  adj. 剩余的;留存下的; [acc] /rɪˈmeɪndər/; [or]gmat;
tinge: [x] n. 淡淡的(颜色,神色),轻微,少量;  v. 给.染色,轻微地影响; [acc] /tɪndʒ/; [or]gmat;
trait: [x] n. 特征; [acc] /treɪt/; [or]gmat;
quarry: [x] n. 采石场;猎物;来源;  v. 挖出;努力挖掘; [acc] /ˈkwɔːri/; [or]gmat;
abnormal: [x] adj. 反常的;畸形的; [acc] /æbˈnɔːrml/; [or]gmat;
omission: [x] n. 省略;遗漏,疏忽; [acc] /əˈmɪʃn/; [or]gmat;
sequence: [x] n. 顺序,次序;连续,继续; [acc] /ˈsiːkwəns/; [or]gmat;
canopy: [x] n. 华盖;天篷;顶篷;苍穹;  vt. 用天篷遮盖;遮蔽; [acc] /ˈkænəpi/; [or]gmat;
assign: [x] v. 布置;分配;指定;指派;归因;确定; [acc] /əˈsaɪn/; [or]gmat;
curb: [x] v. 勒住;抑制;控制;约束;  n. 路缘;控制;约束; [acc] /kɜːrb/; [or]gmat;
lever: [x] n. 杠杆;控制杆;施加影响的手段;  v. 用杠杆移动;撬开; [acc] /ˈlevər/; [or]gmat;
mortgage: [x] n. 按揭贷款,抵押贷款;  v. 抵押; [acc] /ˈmɔːrɡɪdʒ/; [or]gmat;
spouse: [x] n. 配偶,夫妇;夫,妻;  v. 和.结婚; [acc] /spaʊs/; [or]gmat;
proximity: [x] n. 接近;邻近; [acc] /prɑːkˈsɪməti/; [or]gmat;
derision: [x] n. 嘲笑,嘲笑的目标,笑柄; [acc] /dɪˈrɪʒn/; [or]gmat;
accommodate: [x] v. 向.提供住处(或膳宿);给.提供方便;容纳;使适应,顺应; [acc] /əˈkɑːmədeɪt/; [or]gmat;
relic: [x] n. 遗迹;神圣的遗物;纪念物; [acc] /ˈrelɪk/; [or]gmat;
vocal: [x] n. 声乐作品;  adj. 畅言无忌的;声音的; [acc] /ˈvoʊkl/; [or]gmat;
undue: [x] adj. 过分的,不适当的;过度的;尚未到期的; [acc] /ˌʌnˈduː/; [or]gmat;
explicit: [x] adj. 充分表达清楚的,明确的;直率的,直截了当的;〔描绘性或暴力的语言或画面〕清晰露骨的; [acc] /ɪkˈsplɪsɪt/; [or]gmat;
well-being: [x] n. 健康,幸福,福利; [acc] /ˈwel biːɪŋ/; [or]gmat;
turmoil: [x] n. 骚动,骚乱; [acc] /ˈtɜːrmɔɪl/; [or]gmat;
blot: [x] n. 墨水渍;污点;缺点;  v. 涂污;(用吸水纸)吸干墨水;遮暗; [acc] /blɑːt/; [or]gmat;
cessation: [x] n. 停止,中止,中断; [acc] /seˈseɪʃn/; [or]gmat;
laurel: [x] n. 月桂树,桂冠,殊荣;  v. 使戴桂冠;给以荣誉; [acc] /ˈlɔːrəl/; [or]gmat;
livelihood: [x] n. 生活,生计;谋生方式; [acc] /ˈlaɪvlihʊd/; [or]gmat;
wary: [x] adj. 谨慎的,小心的,提防的;考虑周到的; [acc] /ˈweri/; [or]gmat;
brace: [x] n. [医学]牙齿定位器;  v. 支柱;支撑;加固;使绷紧; [acc] /breɪs/; [or]gmat;
variable: [x] adj. 易变的,可变的;  n. 变量,可变物; [acc] /ˈveriəbl/; [or]gmat;
wrap: [x] v. 裹,包,捆;覆盖;  n. 包裹物,覆盖物;外衣; [acc] /ræp/; [or]gmat;
prestige: [x] n. 威望,声望; [acc] /preˈstiːʒ/; [or]gmat;
negligence: [x] n. 疏忽; [acc] /ˈneɡlɪdʒəns/; [or]gmat;
discrimination: [x] n. 歧视,偏见; [acc] /dɪˌskrɪmɪˈneɪʃn/; [or]gmat;
dictate: [x] v. 规定;命令;口授;听写;  n. 命令;指令; [acc] /ˈdɪkteɪt/; [or]gmat;
grievance: [x] n. 牢骚,委屈,抱怨; [acc] /ˈɡriːvəns/; [or]gmat;
rabble: [x] n. 下层社会;乌合之众;暴民; [acc] /ˈræbl/; [or]gmat;
rally: [x] n. 集会;公路汽车赛;  v. 集合;恢复(健康等),重新振作; [acc] /ˈræli/; [or]gmat;
rumor: [x] n. 谣言;传闻; [acc] /'ruːmə/; [or]gmat;
unscrupulous: [x] adj. 肆无忌惮的,无天理的; [acc] /ʌnˈskruːpjələs/; [or]gmat;
outrageous: [x] adj. 粗暴的,无礼的; [acc] /aʊtˈreɪdʒəs/; [or]gmat;
appropriation: [x] n. 挪用,拨款; [acc] /əˌproʊpriˈeɪʃn/; [or]gmat;
hurricane: [x] n. 飓风; [acc] /ˈhɜːrəkeɪn/; [or]gmat;
smite: [x] n. 重击,猛打;  vi. 打,重击,猛烈撞击;  vt. 猛打,杀死,惩罚; [acc] /smaɪt/; [or]gmat;
apprentice: [x] v. 使当学徒;  n. 学徒; [acc] /əˈprentɪs/; [or]gmat;
grind: [x] v. 磨碎,碾碎;折磨;摩擦得吱吱作响;  n. 苦差事,苦活儿;磨; [acc] /ɡraɪnd/; [or]gmat;
injunction: [x] n. [法]指令,禁令; [acc] /ɪnˈdʒʌŋkʃn/; [or]gmat;
scarcity: [x] n. 缺乏,不足; [acc] /ˈskersəti/; [or]gmat;
outright: [x] adj. 完全的,彻底的,全部地;直率的;  adv. 完全地;直率地,痛快地;直截了当地; [acc] /ˈaʊtraɪt/; [or]gmat;
fraction: [x] n. 部分,片断,碎片;分数; [acc] /ˈfrækʃn/; [or]gmat;
aggregate: [x] n. 合计;总数;混凝料;总计;  v. 集合;聚集;合计;  adj. 总的,总数的;集合的; [acc] /ˈæɡrɪɡət/; [or]gmat;
inexorable: [x] adj. 不为所动的,坚决不变的;  n. 坚定不移的人; [acc] /ɪnˈeksərəbl/; [or]gmat;
sap: [x] n. 树液,汁液;易上当的人;  v. 削弱;逐渐耗竭;  vt. 使伤元气;  vi. 挖坑道进攻; [acc] /sæp/; [or]gmat;
assassination: [x] n. 暗杀; [acc] /əˌsæsəˈneɪʃn/; [or]gmat;
pompous: [x] adj. 傲慢的,浮华的; [acc] /ˈpɑːmpəs/; [or]gmat;
exploit: [x] v. 剥削,利用;开发,开拓;  n. 辉煌功绩; [acc] /ɪkˈsplɔɪt/; [or]gmat;
vacancy: [x] n. 空,空白,空房;(职位)空缺;空虚; [acc] /ˈveɪkənsi/; [or]gmat;
executioner: [x] n. 刽子手,死刑执行人; [acc] /ˌeksɪˈkjuːʃənər/; [or]gmat;
needy: [x] adj. 贫困的;贫穷的;生活艰苦的; [acc] /ˈniːdi/; [or]gmat;
affinity: [x] n. 姻亲关系;密切关系;近似,类似关系;亲近; [acc] /əˈfɪnəti/; [or]gmat;
immoral: [x] adj. 不道德的;邪恶的;淫荡的; [acc] /ɪˈmɔːrəl/; [or]gmat;
birch: [x] n. 桦木,桦树,赤杨; [acc] /bɜːrtʃ/; [or]gmat;
embark: [x] v. 上船或飞机;开始,着手,从事; [acc] /ɪmˈbɑːrk/; [or]gmat;
apiece: [x] adv. 每人;每个;各自地; [acc] /əˈpiːs/; [or]gmat;
invade: [x] v. 侵略;侵犯;侵害;涌入;渗透;侵略,侵犯; [acc] /ɪnˈveɪd/; [or]gmat;
sequel: [x] n. 续集;结局;继续;后果; [acc] /ˈsiːkwəl/; [or]gmat;
havoc: [x] n. (天灾,战争等造成的)大破坏,大毁灭;  vi. 损毁;  vt. 严重破坏; [acc] /ˈhævək/; [or]gmat;
distraction: [x] n. 分心,分神;分心的事物;消遣,娱乐; [acc] /dɪˈstrækʃn/; [or]gmat;
tablet: [x] n. 药片;便笺簿;碑,匾; [acc] /ˈtæblət/; [or]gmat;
publicity: [x] n. 公开(性),公众的关注;宣传;名声; [acc] /pʌbˈlɪsəti/; [or]gmat;
tumble: [x] v. 翻滚;不由自主地卷入;(价格等)暴跌;跌倒,摔下,滚下;  n. 跌倒,摔倒; [acc] /ˈtʌmbl/; [or]gmat;
forge: [x] n. 熔炉;锻工车间;铁匠店;  v. 锻造;经锻炼而形成;伪造;推进,加强; [acc] /fɔːrdʒ/; [or]gmat;
degenerate: [x] v. 堕落,衰减;  adj. 腐化的,颓废的,退化的;变质的;  n. 堕落者; [acc] /dɪˈdʒenəreɪt/; [or]gmat;
underlying: [x] adj. 基本的;潜在的;在下面的; [acc] /ˌʌndərˈlaɪɪŋ/; [or]gmat;
fossil: [x] n. 化石;  adj. 从地下发掘出来的;化石的;属于旧时代的;陈腐的; [acc] /ˈfɑːsl/; [or]gmat;
constraint: [x] n. 限制;强迫,拘束;强制; [acc] /kənˈstreɪnt/; [or]gmat;
aurora: [x] n. 极光;曙光; [acc] /ɔːˌrɔːrə/; [or]gmat;
triple: [x] v. 使成三倍,三倍于;  adj. 三倍的; [acc] /ˈtrɪpl/; [or]gmat;
pyramid: [x] n. 金字塔; [acc] /ˈpɪrəmɪd/; [or]gmat;
crater: [x] n. 火山口;弹坑;  v. 在.上形成坑;毁坏; [acc] /ˈkreɪtər/; [or]gmat;
shrub: [x] n. 灌木; [acc] /ʃrʌb/; [or]gmat;
boom: [x] n. 隆隆声;繁荣;景气;激增;  v. 发出低沉有回响的声音;迅速发展,蓬勃发展;以低沉有回响的声音发出; [acc] /buːm/; [or]gmat;
traverse: [x] v. 横越;穿过;  n. 横越; [acc] /trəˈvɜːrs/; [or]gmat;
forthcoming: [x] adj. 即将出现的,即将到来的;唾手可得的,可用的;乐于提供信息的; [acc] /ˌfɔːrθˈkʌmɪŋ/; [or]gmat;
congress: [x] n. 国会(美);代表大会;议会;立法机关; [acc] /ˈkɑːŋɡrəs/; [or]gmat;
haven: [x] n. 港湾;避难所;  vt. 为.提供庇护所; [acc] /ˈheɪvn/; [or]gmat;
equity: [x] n. 公平,公正;衡平法;普通股;抵押资产的净值; [acc] /ˈekwəti/; [or]gmat;
visionary: [x] n. 有远见的人;幻想家;  adj. 有远见的;爱幻想的; [acc] /ˈvɪʒəneri/; [or]gmat;
archives: [x] n. 档案室,档案; [acc] /ˈɑːrkaɪvz/; [or]gmat;
decrease: [x] v. 减少;减;  n. 减;减少; [acc] /dɪˈkriːs/; [or]gmat;
incur: [x] v. 遭受;招致;引起; [acc] /ɪnˈkɜːr/; [or]gmat;
antagonism: [x] n. 对抗,敌对;敌意; [acc] /ænˈtæɡənɪzəm/; [or]gmat;
slander: [x] n. 诽谤,诋毁;  v. 讲坏话,污蔑,诽谤; [acc] /ˈslændər/; [or]gmat;
spruce: [x] n. 云杉;  v. (弄)整洁,(把)打扮漂亮;  adj. 整洁的,潇洒的; [acc] /spruːs/; [or]gmat;
panel: [x] n. 讨论小组;仪表板;面,板;  v. 嵌镶; [acc] /ˈpænl/; [or]gmat;
relentless: [x] adj. 顽强的;持续的;坚定地;冷酷的; [acc] /rɪˈlentləs/; [or]gmat;
fictitious: [x] adj. 虚构的; [acc] /fɪkˈtɪʃəs/; [or]gmat;
anatomy: [x] n. 人体;解剖学;剖析; [acc] /əˈnætəmi/; [or]gmat;
preoccupied: [x] adj. 全神贯注的,心事重重的,被先占的; [acc] /priˈɑːkjupaɪd/; [or]gmat;
astronomy: [x] n. 天文学; [acc] /əˈstrɑːnəmi/; [or]gmat;
rupture: [x] n. 破裂;割裂;  v. 使破裂;断绝(关系); [acc] /ˈrʌptʃər/; [or]gmat;
hazardous: [x] adj. 有危险的;碰运气的;  adv. 冒险地,有危险地;  n. 冒险,危险; [acc] /ˈhæzərdəs/; [or]gmat;
blockade: [x] n. 封锁,阻碍物;  v. 封锁; [acc] /blɑːˈkeɪd/; [or]gmat;
altitude: [x] n. 海拔,高度; [acc] /ˈæltɪtuːd/; [or]gmat;
stew: [x] v. 炖,焖,受闷热;使焦虑不安;  n. 炖肉(或菜);鱼塘; [acc] /stuː/; [or]gmat;
denote: [x] v. 是.的标志;指出;  vt. 指示;代表(或表示); [acc] /dɪˈnoʊt/; [or]gmat;
thrive: [x] v. 茁壮成长;繁荣,兴旺; [acc] /θraɪv/; [or]gmat;
export: [x] v. 出口,输出;  n. 输出,出口,输出品; [acc] /ˈekspɔːrt/; [or]gmat;
abolish: [x] v. 废除,废止;取消,革除; [acc] /əˈbɑːlɪʃ/; [or]gmat;
adjust: [x] v. 调整,调节;校正;改变.以适应; [acc] /əˈdʒʌst/; [or]gmat;
terrestrial: [x] adj. 地球的,陆地的;  n. 陆地生物;地球上的人; [acc] /təˈrestriəl/; [or]gmat;
adhere: [x] v. 遵守;坚持;粘附;附着,粘在..上; [acc] /ədˈhɪr/; [or]gmat;
triangle: [x] n. 三角形; [acc] /ˈtraɪæŋɡl/; [or]gmat;
compulsory: [x] adj. 强制的,必修的; [acc] /kəmˈpʌlsəri/; [or]gmat;
hydrogen: [x] n. 氢,氢气; [acc] /ˈhaɪdrədʒən/; [or]gmat;
fragile: [x] adj. 易碎的;易损坏的;虚弱的;脆弱的; [acc] /ˈfrædʒl/; [or]gmat;
contingent: [x] n. 分遣队;  adj. 意外的,视情况条件而定的; [acc] /kənˈtɪndʒənt/; [or]gmat;
chronic: [x] adj. (疾病)慢性的;长期的;(人)久病的;积习难改的;严重的; [acc] /ˈkrɑːnɪk/; [or]gmat;
dilemma: [x] n. 进退两难的窘境; [acc] /dɪˈlemə/; [or]gmat;
contraction: [x] n. 收缩,紧缩;缩写式; [acc] /kənˈtrækʃn/; [or]gmat;
symptom: [x] n. 症状;征兆; [acc] /ˈsɪmptəm/; [or]gmat;
bouquet: [x] n. 花束,(酒的)芳香; [acc] /buˈkeɪ/; [or]gmat;
sluggish: [x] adj. 行动迟缓的,迟钝的;偷懒的; [acc] /ˈslʌɡɪʃ/; [or]gmat;
lure: [x] v. 引诱;以诱饵吸引;  n. 诱惑力;诱惑物;鱼饵; [acc] /lʊr/; [or]gmat;
outlaw: [x] n. 歹徒,逃犯,丧失公权者;  v. 将..放逐,宣布..为不合法; [acc] /ˈaʊtlɔː/; [or]gmat;
spiral: [x] n. 螺旋,螺线;  v. 不断急剧地上升(或下降),螺旋形行进;  adj. 螺旋的; [acc] /ˈspaɪrəl/; [or]gmat;
wayside: [x] n. 路边;  adj. 路边的; [acc] /ˈweɪsaɪd/; [or]gmat;
partisan: [x] adj. 党派的;效忠的;偏袒的;盲目推崇的;  n. 党羽;虔诚信徒;游击队; [acc] /ˈpɑːrtəzn/; [or]gmat;
precipitous: [x] adj. 险峻的;急躁的,鲁莽的; [acc] /prɪˈsɪpɪtəs/; [or]gmat;
ripple: [x] n. 涟漪,波纹;  v. (使)泛起层层细浪; [acc] /ˈrɪpl/; [or]gmat;
celebrity: [x] n. 名人;名流;  adj. 有名望的;名人的; [acc] /səˈlebrəti/; [or]gmat;
eligible: [x] adj. 适合被选的,符合条件的;(尤指婚姻等)合适的,合意的; [acc] /ˈelɪdʒəbl/; [or]gmat;
prosecute: [x] v. 起诉;做检察官;从事; [acc] /ˈprɑːsɪkjuːt/; [or]gmat;
relinquish: [x] v. 放弃,让出(权利,财产等),撤回; [acc] /rɪˈlɪŋkwɪʃ/; [or]gmat;
repeal: [x] n. 撤销;  v. 废除;废止; [acc] /rɪˈpiːl/; [or]gmat;
violate: [x] v. 违反,违背;侵犯,妨碍;亵渎; [acc] /ˈvaɪəleɪt/; [or]gmat;
intact: [x] adj. 原封未动的,未受损的,完整无缺的; [acc] /ɪnˈtækt/; [or]gmat;
incumbent: [x] n. 在职者,现任者;  adj. 现任的;依靠的;负有职责的; [acc] /ɪnˈkʌmbənt/; [or]gmat;
tack: [x] n. 平头钉;行动步骤;  v. 钉住;使(船)抢风转变航向; [acc] /tæk/; [or]gmat;
surpass: [x] v. 胜过;超出; [acc] /sərˈpæs/; [or]gmat;
marginal: [x] adj. 微小的,不重要的;仅以微弱多数票获胜的;  n. (议会或地方委员会的)边缘席位; [acc] /ˈmɑːrdʒɪnl/; [or]gmat;
spine: [x] n. 脊椎; [acc] /spaɪn/; [or]gmat;
chord: [x] n. 和弦;和音;心弦;(数学)弦; [acc] /kɔːrd/; [or]gmat;
focus: [x] n. 焦点,聚焦;焦距;关注;  v. 使聚焦,集中注意力; [acc] /ˈfoʊkəs/; [or]gmat;
detection: [x] n. 察觉;侦察;检测,检验; [acc] /dɪˈtekʃn/; [or]gmat;
nocturnal: [x] adj. 夜晚的,夜间发生的; [acc] /nɑːkˈtɜːrnl/; [or]gmat;
porcelain: [x] adj. 瓷的;精美的;易碎的;  n. 瓷,瓷器; [acc] /ˈpɔːrsəlɪn/; [or]gmat;
arid: [x] adj. (土地或气候)干燥的,干旱的,贫瘠的,荒芜的;无创见的,无新意的; [acc] /ˈærɪd/; [or]gmat;
loom: [x] n. 织布机;  v. 阴森地逼近;隐现;即将来临; [acc] /luːm/; [or]gmat;
overflow: [x] v. 满得外溢,外流,泛滥;充满,洋溢;  n. 溢流口,溢流管;容纳不下的物(或人);溢出,满出;超出额;  adj. 充满的; [acc] /ˌoʊvərˈfloʊ/; [or]gmat;
stitch: [x] v. 缝,绣;  n. 一针,线迹;缝法,编结法;(肋部的)突然剧痛;缝合(伤口); [acc] /stɪtʃ/; [or]gmat;
ascribe: [x] v. 把.归因于;把.归属于; [acc] /əˈskraɪb/; [or]gmat;
stark: [x] adj. 完全的,明显的,荒凉的;  adv. 完全,明显地; [acc] /stɑːrk/; [or]gmat;
animosity: [x] n. 憎恶,仇恨; [acc] /ˌænɪˈmɑːsəti/; [or]gmat;
shroud: [x] n. 寿衣,覆盖物;  v. 覆盖,包以尸衣; [acc] /ʃraʊd/; [or]gmat;
moth: [x] n. 蛾; [acc] /mɔːθ/; [or]gmat;
budget: [x] n. 预算;  v. 预算,安排;  adj. 廉价的; [acc] /ˈbʌdʒɪt/; [or]gmat;
strategy: [x] n. 谋略,策略,计谋; [acc] /ˈstrætədʒi/; [or]gmat;
rigorous: [x] adj. 严厉的,严格的; [acc] /ˈrɪɡərəs/; [or]gmat;
civic: [x] adj. 城市的;公民的,市民的; [acc] /ˈsɪvɪk/; [or]gmat;
obnoxious: [x] adj. 非常讨厌的;可憎的; [acc] /əbˈnɑːkʃəs/; [or]gmat;
paramount: [x] n. 元首;最高;  adj. 最高的,至上的,首要的; [acc] /ˈpærəmaʊnt/; [or]gmat;
insert: [x] vt. 插入,嵌入;  n. 插入物;插页; [acc] /ɪnˈsɜːrt/; [or]gmat;
listless: [x] adj. 无精打采的,倦怠的,情绪低落的;冷漠的; [acc] /ˈlɪstləs/; [or]gmat;
pollen: [x] n. 花粉; [acc] /ˈpɑːlən/; [or]gmat;
flexible: [x] adj. 易曲的,柔软的,灵活的; [acc] /ˈfleksəbl/; [or]gmat;
switch: [x] n. 开关;转变;转向;转辙器;  v. 转换,转变;调换;转移;打开,关上;  vt. 交换; [acc] /swɪtʃ/; [or]gmat;
aspiration: [x] n. 抱负,志向;发 h 音; [acc] /ˌæspəˈreɪʃn/; [or]gmat;
decade: [x] n. 十年,十年间; [acc] /ˈdekeɪd/; [or]gmat;
multiple: [x] adj. 多重的,复合的,倍数的;  n. 倍数; [acc] /ˈmʌltɪpl/; [or]gmat;
counterfeit: [x] n. 仿制品,伪造物;  adj. 仿造的.假冒的;  v. 伪造,仿造; [acc] /ˈkaʊntərfɪt/; [or]gmat;
cripple: [x] n. 跛子,伤残人(或动物);  v. 使跛;使受伤致残;严重削弱; [acc] /ˈkrɪpl/; [or]gmat;
patrol: [x] n. 巡逻兵;巡逻;  v. 巡逻;巡查,巡游; [acc] /pəˈtroʊl/; [or]gmat;
marrow: [x] n. 骨髓,精华; [acc] /ˈmæroʊ/; [or]gmat;
tenure: [x] n. 任期;终身职位; [acc] /ˈtenjər/; [or]gmat;
absorb: [x] vt. 吸收;汲取;吸引..的注意;理解,掌握;承受; [acc] /əbˈzɔːrb/; [or]gmat;
cone: [x] n. 圆锥体;球果;甜筒;  vt. 使成锥形; [acc] /koʊn/; [or]gmat;
latch: [x] n. 闩,碰锁,弹簧锁;  v. 用闩把..闩上; [acc] /lætʃ/; [or]gmat;
corral: [x] n. 畜栏,环形车阵;  v. 把.关进畜栏,捕捉,把.布成车阵; [acc] /kəˈræl/; [or]gmat;
uneven: [x] adj. 不平坦的;不均匀的,不规则的;不公正的; [acc] /ʌnˈiːvn/; [or]gmat;
chronicle: [x] n. 编年史,年代记,记录;  v. 记录,把.载入编年史; [acc] /ˈkrɑːnɪkl/; [or]gmat;
lateral: [x] n. 侧面部分;支线;  adj. 侧面的;横向的; [acc] /ˈlætərəl/; [or]gmat;
defendant: [x] n. 被告; [acc] /dɪˈfendənt/; [or]gmat;
mosque: [x] n. 伊斯兰教寺院;清真寺; [acc] /mɑːsk/; [or]gmat;
exhaust: [x] v. 使筋疲力尽;耗尽;详尽论述;  n. 排气装置;废气; [acc] /ɪɡˈzɔːst/; [or]gmat;
penitence: [x] n. 后悔,忏悔; [acc] /ˈpenɪtəns/; [or]gmat;
nucleus: [x] n. 原子核,核心,细胞核; [acc] /ˈnuːkliəs/; [or]gmat;
disperse: [x] v. 使散开;分散,散开; [acc] /dɪˈspɜːrs/; [or]gmat;
stumble: [x] v. 绊跌,绊倒;结结巴巴说话;  n. 绊倒;失足;失误;失败; [acc] /ˈstʌmbl/; [or]gmat;
evade: [x] v. 躲避,回避; [acc] /ɪˈveɪd/; [or]gmat;
dogma: [x] n. 教条;武断的意见;  adj. 教义的,教条的,信条的; [acc] /ˈdɔːɡmə/; [or]gmat;
mite: [x] n. 极小量,小虫; [acc] /maɪt/; [or]gmat;
tyrannical: [x] adj. 暴君的,专制的,残酷的; [acc] /tɪˈrænɪkl/; [or]gmat;
impersonal: [x] adj. 客观的,没有人情味的,不及物的;  n. [语]非人称动词;非人称代名词;不具人格的事物; [acc] /ɪmˈpɜːrsənl/; [or]gmat;
auction: [x] n. 拍卖;  v. 拍卖; [acc] /ˈɔːkʃn/; [or]gmat;
reservation: [x] n. (住处,席位的)预订;保留态度,保留意见;(美国印第安部落的)居留地; [acc] /ˌrezərˈveɪʃn/; [or]gmat;
sterile: [x] adj. 不孕的,无细菌的,贫瘠的; [acc] /ˈsterəl/; [or]gmat;
unprecedented: [x] adj. 前所未有的,空前的,无前例的; [acc] /ʌnˈpresɪdentɪd/; [or]gmat;
lounge: [x] n. 候机室,休息室,酒吧间;沙发,躺椅;懒散的步子;  v. (懒散地)倚,躺;闲逛; [acc] /laʊndʒ/; [or]gmat;
onset: [x] n. 开始;攻击,袭击; [acc] /ˈɑːnset/; [or]gmat;
fickle: [x] adj. (在感情等方面)反复无常的,轻浮的,善变的; [acc] /ˈfɪkl/; [or]gmat;
magnet: [x] n. 磁体,磁铁; [acc] /ˈmæɡnət/; [or]gmat;
carcass: [x] n. (动物,人)尸体;(屠宰后)兽体;(废屋,废船等的)骨架,遗骸; [acc] /ˈkɑːrkəs/; [or]gmat;
transit: [x] n. 运输;运送;  v. 运送;通过; [acc] /ˈtrænzɪt/; [or]gmat;
enlist: [x] v. 得到.的赞助或帮助,应募,招募,参加,加入; [acc] /ɪnˈlɪst/; [or]gmat;
census: [x] n. 人口普查,人口调查;统计;  v. 调查(某地区等的)人口数字;统计.的数字; [acc] /ˈsensəs/; [or]gmat;
sustenance: [x] n. 生计;食物,粮食; [acc] /ˈsʌstənəns/; [or]gmat;
extinguish: [x] v. 熄灭,扑灭;根除,消灭; [acc] /ɪkˈstɪŋɡwɪʃ/; [or]gmat;
membrane: [x] n. 膜;薄膜;羊皮纸; [acc] /ˈmembreɪn/; [or]gmat;
hoary: [x] adj. 年纪高迈的;(头发等)灰白的;古老的; [acc] /ˈhɔːri/; [or]gmat;
complacency: [x] n. 自满,自鸣得意;满足; [acc] /kəmˈpleɪsnsi/; [or]gmat;
commodity: [x] n. 商品,货物; [acc] /kəˈmɑːdəti/; [or]gmat;
reciprocal: [x] adj. 相互的,互惠的;  n. 倒数;互相关联的事物; [acc] /rɪˈsɪprəkl/; [or]gmat;
enrich: [x] v. 使丰富;使富裕; [acc] /ɪnˈrɪtʃ/; [or]gmat;
starch: [x] n. 淀粉;  v. 给.上浆; [acc] /stɑːrtʃ/; [or]gmat;
intrinsic: [x] adj. 固有的; [acc] /ɪnˈtrɪnsɪk/; [or]gmat;
bias: [x] n. 倾斜;偏心;偏见;  v. 使有偏见; [acc] /ˈbaɪəs/; [or]gmat;
ensue: [x] v. 跟着发生,接踵而来;因而产生; [acc] /ɪnˈsuː/; [or]gmat;
pulp: [x] n. 果肉;果肉酱;纸浆;  v. 去除果肉,捣成浆状; [acc] /pʌlp/; [or]gmat;
levy: [x] v. 征收(税等);  n. 征税;税款; [acc] /ˈlevi/; [or]gmat;
utilize: [x] v. 利用;使用; [acc] /ˈjuːtəlaɪz/; [or]gmat;
finite: [x] adj. 有限的;限定的; [acc] /ˈfaɪnaɪt/; [or]gmat;
scramble: [x] v. 争夺,攀登; [acc] /ˈskræmbl/; [or]gmat;
academic: [x] adj. 学术的;学院的,大学的;理论的;  n. 学者; [acc] /ˌækəˈdemɪk/; [or]gmat;
inveterate: [x] adj. 积习已深的,根深蒂固的,长期形成的; [acc] /ɪnˈvetərət/; [or]gmat;
validity: [x] n. 正确(性);有效(性),效力; [acc] /vəˈlɪdəti/; [or]gmat;
prosaic: [x] adj. 平凡的,乏味的,散文体的; [acc] /prəˈzeɪɪk/; [or]gmat;
soar: [x] v. 高飞,翱翔;飞腾;猛增;高飞越过;  n. 高飞;高涨; [acc] /sɔːr/; [or]gmat;
bereft: [x] adj. 丧失的;被剥夺的;失去亲人的; [acc] /bɪˈreft/; [or]gmat;
adapt: [x] vi. 适应不同情况;  vt. 使适合;改编; [acc] /əˈdæpt/; [or]gmat;
admonition: [x] n. 告诫,劝告,警告; [acc] /ˌædməˈnɪʃn/; [or]gmat;
exodus: [x] n. 大批离去,成群外出; [acc] /ˈeksədəs/; [or]gmat;
animate: [x] v. 使有生气,使活泼;鼓舞,推动;  adj. 有生命的; [acc] /ˈænɪmeɪt/; [or]gmat;
saturated: [x] adj. 湿透的;充满的;饱和的; [acc] /ˈsætʃəreɪtɪd/; [or]gmat;
buoyant: [x] adj. 有浮力的;愉快的;(股市)保持高价的; [acc] /ˈbɔɪənt/; [or]gmat;
ancestry: [x] n. 祖先;血统; [acc] /ˈænsestri/; [or]gmat;
broker: [x] n. 经纪人,掮客;  v. 作为经纪人进行谈判,以中间人等身份安排; [acc] /ˈbroʊkər/; [or]gmat;
staple: [x] v. 用订书钉订;  n. 订书钉;主食;主要产品;  adj. 主要的;基本的;标准的; [acc] /ˈsteɪpl/; [or]gmat;
abstinence: [x] n. 节制,禁欲; [acc] /ˈæbstɪnəns/; [or]gmat;
molten: [x] adj. 熔化的; [acc] /ˈmoʊltən/; [or]gmat;
niche: [x] n. 壁龛;合适的职业,生活方式;(有利可图的)市场,商机;  vt. 放在适当的位置; [acc] /nɪtʃ/; [or]gmat;
designate: [x] adj. 已受委派而尚未上任的;  v. 标出,说出;委任,任命,提名;指定; [acc] /ˈdezɪɡneɪt/; [or]gmat;
exemplary: [x] adj. 模范的,可仿效的; [acc] /ɪɡˈzempləri/; [or]gmat;
projection: [x] n. 预测,投射,投影规划; [acc] /prəˈdʒekʃn/; [or]gmat;
tease: [x] v. 取笑;挑逗;逗弄;使..渴望;逆梳;  n. 爱戏弄别人者; [acc] /tiːz/; [or]gmat;
maize: [x] n. 玉米;  adj. 黄色的,玉米色的; [acc] /meɪz/; [or]gmat;
recipe: [x] n. 方法;食谱; [acc] /ˈresəpi/; [or]gmat;
enclose: [x] v. 围住;圈起;装入信封;附有; [acc] /ɪnˈkloʊz/; [or]gmat;
laudable: [x] adj. 值得称赞的; [acc] /ˈlɔːdəbl/; [or]gmat;
simultaneous: [x] adj. 同时发生的; [acc] /ˌsaɪmlˈteɪniəs/; [or]gmat;
plow: [x] v. 犁,耕;  n. 犁; [acc] /plau/; [or]gmat;
wither: [x] v. 枯萎;凋谢;  vt. 使枯萎,使凋谢,萎缩;使人感觉羞惭或迷惑; [acc] /ˈwɪðər/; [or]gmat;
physiological: [x] adj. 生理的,生理学的; [acc] /ˌfɪziəˈlɑːdʒɪkl/; [or]gmat;
category: [x] n. 类别;范畴; [acc] /ˈkætəɡɔːri/; [or]gmat;
comet: [x] n. 彗星; [acc] /ˈkɑːmət/; [or]gmat;
vestige: [x] n. 遗迹,(生)退化的器官,残余,微量(一般用于否定句); [acc] /ˈvestɪdʒ/; [or]gmat;
confront: [x] v. 与某人对峙;与..对抗;正视; [acc] /kənˈfrʌnt/; [or]gmat;
medieval: [x] adj. 中世纪的,中古(时代)的; [acc] /ˌmediˈiːvl/; [or]gmat;
propensity: [x] n. 嗜好,习性;倾向; [acc] /prəˈpensəti/; [or]gmat;
docile: [x] adj. 驯服的,温顺的; [acc] /ˈdɑːsl/; [or]gmat;
lobby: [x] n. 门厅,大厅;休息室;游说团;投票厅;  vt. 向(议员,政府官员等)进行游说(或疏通); [acc] /ˈlɑːbi/; [or]gmat;
compensate: [x] v. 补偿,赔偿,给..报酬; [acc] /ˈkɑːmpenseɪt/; [or]gmat;
carol: [x] v. 欢唱,歌颂;  n. 颂歌,赞美诗,欢乐之歌; [acc] /ˈkærəl/; [or]gmat;
aggression: [x] n. 侵略;侵犯行为;攻击行为,(挑衅)行为;攻击性; [acc] /əˈɡreʃn/; [or]gmat;
propitious: [x] adj. 适合的;吉利的;顺利的; [acc] /prəˈpɪʃəs/; [or]gmat;
thwart: [x] n. [船]横坐板;  v. 阻挠,阻碍,横过;  adj. 横放的;  adv. 横过;  prep. 〈古〉横跨,横过; [acc] /θwɔːrt/; [or]gmat;
prescribe: [x] v. 给..开药;命令,指示; [acc] /prɪˈskraɪb/; [or]gmat;
novice: [x] n. 生手,新手; [acc] /ˈnɑːvɪs/; [or]gmat;
frugal: [x] adj. 节俭的,俭朴的;不昂贵的,廉价的,花钱少的,不充足的; [acc] /ˈfruːɡl/; [or]gmat;
impetus: [x] n. 推动力;促进; [acc] /ˈɪmpɪtəs/; [or]gmat;
paralysis: [x] n. 瘫痪(症),麻痹(症); [acc] /pəˈræləsɪs/; [or]gmat;
reservoir: [x] n. 水库;贮藏量; [acc] /ˈrezərvwɑːr/; [or]gmat;
contagious: [x] adj. (病)有传染性的;(人)患传染病的;有感染力的; [acc] /kənˈteɪdʒəs/; [or]gmat;
trigger: [x] n. (枪等的)扳机,诱因;  v. 触发,引起,激发,扣扳机; [acc] /ˈtrɪɡər/; [or]gmat;
counterpart: [x] n. 对应的人(物);副本;对手; [acc] /ˈkaʊntərpɑːrt/; [or]gmat;
instantaneous: [x] adj. 瞬间的;即刻的;猝发的; [acc] /ˌɪnstənˈteɪniəs/; [or]gmat;
responsive: [x] adj. 反应积极的,反应敏捷的;反应热烈的;响应的; [acc] /rɪˈspɑːnsɪv/; [or]gmat;
mold: [x] vt. 塑造;使形成;  v. 把..塑造成;  n. 霉菌;模子;气质; [acc] /moʊld/; [or]gmat;
chip: [x] n. 木屑,碎片;缺口;圆形筹码;芯片;炸薯条,炸薯片;  v. 碎裂;削,凿;将.削成,凿成; [acc] /tʃɪp/; [or]gmat;
mole: [x] n. [动]鼹鼠;黑痣;[化]克分子(量),摩尔;长期潜伏的间谍,内奸;防波堤; [acc] /moʊl/; [or]gmat;
pottery: [x] n. 陶器;陶艺;陶艺厂; [acc] /ˈpɑːtəri/; [or]gmat;
surge: [x] n. 波涛汹涌;波动;激增;  v. 波浪般汹涌奔腾;激增; [acc] /sɜːrdʒ/; [or]gmat;
perennial: [x] adj. 终年的,永久的;四季不断的;反复的;  n. 多年生植物; [acc] /pəˈreniəl/; [or]gmat;
beverage: [x] n. (水,酒等之外的)饮料; [acc] /ˈbevərɪdʒ/; [or]gmat;
articulate: [x] adj. 善于表达的;发音清晰的;  v. 清晰地发音;清楚地讲话;连接,接合;与.合成整体 ,使相互连贯; [acc] /ɑːrˈtɪkjuleɪt/; [or]gmat;
amend: [x] v. 改进;修订;修正; [acc] /əˈmend/; [or]gmat;
wield: [x] v. 运用,行使;挥;  vt. 使用; [acc] /wiːld/; [or]gmat;
embryo: [x] n. [动物学]胚胎; [acc] /ˈembrioʊ/; [or]gmat;
democrat: [x] n. 民主党人,民主主义者; [acc] /ˈdeməkræt/; [or]gmat;
inlet: [x] n. 水湾,小湾;进口,入口; [acc] /ˈɪnlet/; [or]gmat;
juvenile: [x] n. 青少年;雏鸟;  adj. 青少年的;幼稚的; [acc] /ˈdʒuːvənl/; [or]gmat;
overwhelm: [x] v. 压垮;不知所措;淹没;打败,压倒; [acc] /ˌoʊvərˈwelm/; [or]gmat;
overrun: [x] v. 溢出,泛滥;(侵略军)横行;  n. 泛滥成灾;超出限度; [acc] /ˈoʊvərʌn/; [or]gmat;
predicament: [x] n. 困境,穷境,尴尬的处境; [acc] /prɪˈdɪkəmənt/; [or]gmat;
elevate: [x] v. 上升;提高;举起;提拔; [acc] /ˈelɪveɪt/; [or]gmat;
irrational: [x] adj. 无理性的,失去理性的; [acc] /ɪˈræʃənl/; [or]gmat;
outlying: [x] adj. 远离中心的;边远的; [acc] /ˈaʊtlaɪɪŋ/; [or]gmat;
indicative: [x] adj. 指示的;暗示的;陈述的;  n. 陈述语气; [acc] /ɪnˈdɪkətɪv/; [or]gmat;
paradox: [x] n. 矛盾;似矛盾而正确的说法; [acc] /ˈpærədɑːks/; [or]gmat;
exaggerate: [x] vi. 夸张;  vt. 夸大,夸张;使扩大; [acc] /ɪɡˈzædʒəreɪt/; [or]gmat;
intercept: [x] v. 中途拦截,截取;  n. 拦截;[数]截距;侦听; [acc] /ˌɪntərˈsept/; [or]gmat;
cue: [x] n. 提示;暗号;球杆;  v. 给.提示; [acc] /kjuː/; [or]gmat;
restitution: [x] n. 归还,赔偿; [acc] /ˌrestɪˈtuːʃn/; [or]gmat;
runner: [x] n. 跑步者;信差;蔓藤植物; [acc] /ˈrʌnər/; [or]gmat;
dormant: [x] adj. 睡眠的,休眠的;静止的,隐伏的; [acc] /ˈdɔːrmənt/; [or]gmat;
negotiate: [x] v. 谈判,交涉,商议;成功越过,渡过; [acc] /nɪˈɡoʊʃieɪt/; [or]gmat;
premium: [x] adj. 高级的;高价的;(汽油)辛烷值高的;  n. 额外费用,溢价;保险金; [acc] /ˈpriːmiəm/; [or]gmat;
inducement: [x] n. 诱因;刺激物;犯罪动因; [acc] /ɪnˈduːsmənt/; [or]gmat;
regime: [x] n. 政权;政治制度;养生法,生活规则; [acc] /reɪˈʒiːm/; [or]gmat;
voluminous: [x] adj. 大量的;长篇的,多产的;庞大的;  adv. 宽松地;容量大地;篇幅长地;  n. 宽松;容量大,篇幅长; [acc] /vəˈluːmɪnəs/; [or]gmat;
crusade: [x] n. 改革运动,十字军东侵;  v. 加入十字军,从事改革运动; [acc] /kruːˈseɪd/; [or]gmat;
epidemic: [x] adj. 流行性的,传染的;  n. 流行病,传染病,(犯罪等的)盛行; [acc] /ˌepɪˈdemɪk/; [or]gmat;
mishap: [x] n. 不幸的事,灾祸;晦气; [acc] /ˈmɪshæp/; [or]gmat;
output: [x] n. 产量,输出;  vt. 生产,出产,制造;输出;  vi. 生产,出产,制造;输出; [acc] /ˈaʊtpʊt/; [or]gmat;
bankruptcy: [x] n. 破产; [acc] /ˈbæŋkrʌptsi/; [or]gmat;
anterior: [x] adj. 前面的,先前的; [acc] /ænˈtɪriər/; [or]gmat;
impediment: [x] n. 妨碍,阻碍;障碍物;(言语)障碍;口吃; [acc] /ɪmˈpedɪmənt/; [or]gmat;
antiquated: [x] adj. 陈旧的,过时的;  v. 使古旧,废弃; [acc] /ˈæntɪkweɪtɪd/; [or]gmat;
oblique: [x] adj. 斜的,非直角的,隐射的;  v. 倾斜;  n. [解]斜肌(尤指腹部的肌肉);倾斜物;[军]倾斜航空照片;  adv. [军]以45度角; [acc] /əˈbliːk/; [or]gmat;
cult: [x] n. 异教;风尚,热潮;信徒;  adj. 流行的;风靡一时的; [acc] /kʌlt/; [or]gmat;
insidious: [x] adj. (暗中或逐渐)为害的; [acc] /ɪnˈsɪdiəs/; [or]gmat;
hatch: [x] n. 船舱盖;  v. 孵出,孵;策划; [acc] /hætʃ/; [or]gmat;
brevity: [x] n. 简短,短小,精炼; [acc] /ˈbrevəti/; [or]gmat;
recruit: [x] v. 招募(新兵),招收(新成员);  n. 新兵,新成员; [acc] /rɪˈkruːt/; [or]gmat;
coalition: [x] n. 结合;联盟;联合; [acc] /ˌkoʊəˈlɪʃn/; [or]gmat;
sensational: [x] adj. 轰动性的;使人感动的,非常好的;引起哗然的; [acc] /senˈseɪʃənl/; [or]gmat;
concede: [x] v. 承认;承认失败;让给,让与;让步; [acc] /kənˈsiːd/; [or]gmat;
insatiable: [x] adj. 不能满足的,贪得无厌的; [acc] /ɪnˈseɪʃəbl/; [or]gmat;
prevalence: [x] n. 盛行;广泛分布;普遍; [acc] /ˈprevələns/; [or]gmat;
bout: [x] n. 一回合,较量,一阵; [acc] /baʊt/; [or]gmat;
stagnant: [x] adj. 不流动的;停滞的;萧条的; [acc] /ˈstæɡnənt/; [or]gmat;
venom: [x] n. 毒液;恶意;怨恨;  vt. 使有毒;放毒; [acc] /ˈvenəm/; [or]gmat;
ambiguous: [x] adj. 含糊不清的,引起歧义的,模棱两可的; [acc] /æmˈbɪɡjuəs/; [or]gmat;
caricature: [x] n. 讽刺画,滑稽模仿;扭曲,夸张的描述; [acc] /ˈkærɪkətʃər/; [or]gmat;
kinship: [x] n. [法]亲属关系,家属关系;亲密关系; [acc] /ˈkɪnʃɪp/; [or]gmat;
gut: [x] n. (pl.)内脏,(幽门到直肠间的)肠子,勇气,剧情,内容,肚子,内脏,海峡;  adj. 情感的;直觉的,本能的;  vt. 取出内脏,摧毁(房屋等的)内部装置; [acc] /ɡʌt/; [or]gmat;
counteract: [x] v. 抵消;中和;阻碍; [acc] /ˌkaʊntərˈækt/; [or]gmat;
florid: [x] adj. 涨红的,华丽的,红润的; [acc] /ˈflɔːrɪd/; [or]gmat;
reptile: [x] n. 爬行动物,爬虫;  adj. 爬行的,爬虫类的; [acc] /ˈreptaɪl/; [or]gmat;
natal: [x] adj. 出生的;分娩的;与生俱来的; [acc] /ˈneɪtl/; [or]gmat;
spleen: [x] n. 脾,脾气,怒气; [acc] /spliːn/; [or]gmat;
residue: [x] n. 剩余物;残渣;渣;残数; [acc] /ˈrezɪduː/; [or]gmat;
irrelevant: [x] adj. 不相关的; [acc] /ɪˈreləvənt/; [or]gmat;
preside: [x] v. 主持; [acc] /prɪˈzaɪd/; [or]gmat;
forage: [x] v. 搜寻,翻寻,觅食;  n. (牛马的)饲料,粮草; [acc] /ˈfɔːrɪdʒ/; [or]gmat;
bland: [x] vi. 变得平淡无奇,变得枯燥无味;  adj. 温和的;(食物等)清淡的;漠不关心的;  vt. 使变得淡而无味,使变得枯燥无味;除掉.的特性; [acc] /blænd/; [or]gmat;
extricate: [x] v. 拯救,救出;  n. 解脱;解脱者; [acc] /ˈekstrɪkeɪt/; [or]gmat;
verify: [x] v. 查证,证明,证实; [acc] /ˈverɪfaɪ/; [or]gmat;
tribal: [x] adj. 部落的;  n. 部落成员; [acc] /ˈtraɪbl/; [or]gmat;
dissent: [x] v. 不同意;不信奉国教;  n. 异议;(大写)不信奉国教; [acc] /dɪˈsent/; [or]gmat;
bog: [x] n. 沼泽;泥塘;  v. 陷于泥沼;动弹不得; [acc] /bɑːɡ/; [or]gmat;
illiterate: [x] n. 文盲,目不识丁者;  adj. 不识字的;缺乏(某方面)知识的;语法错误的; [acc] /ɪˈlɪtərət/; [or]gmat;
speculate: [x] vi. 推测,猜测;投机,做投机买卖;  vt. 推测; [acc] /ˈspekjuleɪt/; [or]gmat;
combustion: [x] n. 燃烧; [acc] /kəmˈbʌstʃən/; [or]gmat;
allay: [x] v. 减轻;使缓和;使平静; [acc] /əˈleɪ/; [or]gmat;
cocoa: [x] n. 可可粉; [acc] /ˈkoʊkoʊ/; [or]gmat;
lucrative: [x] adj. 合算的;获利的;有利可图的; [acc] /ˈluːkrətɪv/; [or]gmat;
blemish: [x] v. 损害,玷污;  n. 瑕疵,缺点; [acc] /ˈblemɪʃ/; [or]gmat;
nitrogen: [x] n. 氮; [acc] /ˈnaɪtrədʒən/; [or]gmat;
afflict: [x] v. 使痛苦;使苦恼; [acc] /əˈflɪkt/; [or]gmat;
fortify: [x] v. 设防于;增强; [acc] /ˈfɔːrtɪfaɪ/; [or]gmat;
invoke: [x] v. 调用,祈求,恳求,引起; [acc] /ɪnˈvoʊk/; [or]gmat;
mimic: [x] v. 模仿,戏弄;  n. 模仿者;  adj. 模拟的;假的,伪装的; [acc] /ˈmɪmɪk/; [or]gmat;
impoverished: [x] adj. 穷困的,用尽了的,无创造性的; [acc] /ɪmˈpɑːvərɪʃt/; [or]gmat;
perpetuate: [x] adj. 长存的;  vt. 使永久存在,使不朽; [acc] /pərˈpetʃueɪt/; [or]gmat;
volatile: [x] adj. 易气化的;爆炸性的;反复无常的;短暂的;不稳定的; [acc] /ˈvɑːlətl/; [or]gmat;
accumulate: [x] vi. 聚积,堆积;  vt. 积攒,积累; [acc] /əˈkjuːmjəleɪt/; [or]gmat;
immaterial: [x] adj. 非实体的,无关紧要的; [acc] /ˌɪməˈtɪriəl/; [or]gmat;
quail: [x] n. 鹌鹑;  v. 畏缩;感到恐惧; [acc] /kweɪl/; [or]gmat;
implication: [x] n. 暗示;含意;牵连;卷入;可能的后果; [acc] /ˌɪmplɪˈkeɪʃn/; [or]gmat;
pop: [x] v. 发出(砰的响声),突然出现,爆开,开枪;  n. 砰的一声爆破声;流行音乐;汽水;  adj. 流行的,大众的; [acc] /pɑːp/; [or]gmat;
incentive: [x] n. 刺激,激励;鼓励; [acc] /ɪnˈsentɪv/; [or]gmat;
degrade: [x] v. 贬低;降低品格(身价,价值等);分解;降低; [acc] /dɪˈɡreɪd/; [or]gmat;
recipient: [x] n. 接受者;容器;间接宾语;  adj. 接受的;善于接受的;接受能力强的; [acc] /rɪˈsɪpiənt/; [or]gmat;
indigenous: [x] adj. 土生土长的,本土的; [acc] /ɪnˈdɪdʒənəs/; [or]gmat;
rudimentary: [x] adj. 基本的,初期的;发育不完全的;退化的; [acc] /ˌruːdɪˈmentri/; [or]gmat;
complement: [x] v. 补充;与.相配;  n. 补充;互为补充的东西;补语; [acc] /ˈkɑːmplɪment/; [or]gmat;
constituent: [x] adj. 组成的;有选举权的;  n. 选民;成分; [acc] /kənˈstɪtʃuənt/; [or]gmat;
specious: [x] adj. 外表美观,华而不实的,徒有其表的; [acc] /ˈspiːʃəs/; [or]gmat;
seductive: [x] adj. 有魅力的;性感的;引人注意的; [acc] /sɪˈdʌktɪv/; [or]gmat;
villainy: [x] n. 邪恶,恶行,腐化堕落,道德败坏,(复)犯罪行为; [acc] /ˈvɪləni/; [or]gmat;
contingency: [x] n. 偶然性;[安全]意外事故;可能性;[审计]意外开支; [acc] /kənˈtɪndʒənsi/; [or]gmat;
terminate: [x] adj. 终止的;可结尾的;  vi. 结束;结尾;  v. 使结束,终止; [acc] /ˈtɜːrmɪneɪt/; [or]gmat;
opulent: [x] adj. 富裕的,充足的; [acc] /ˈɑːpjələnt/; [or]gmat;
qualify: [x] v. 胜任,使具有资格;描述,形容; [acc] /ˈkwɑːlɪfaɪ/; [or]gmat;
corporate: [x] adj. 公司的;全体的;共同的;(法人)团体的; [acc] /ˈkɔːrpərət/; [or]gmat;
originate: [x] vi. 起源;开始;  vt. 开创; [acc] /əˈrɪdʒɪneɪt/; [or]gmat;
marshy: [x] adj. 沼泽的;湿地的; [acc] /ˈmɑːrʃi/; [or]gmat;
retail: [x] adj. 零售的;  n. 零售;  v. 零售,零售价是;  adv. 以零售方式,以零售形式; [acc] /ˈriːteɪl/; [or]gmat;
fallacy: [x] n. 谬论,谬见;错误,谬误; [acc] /ˈfæləsi/; [or]gmat;
chisel: [x] v. 刻,凿;  n. 凿子; [acc] /ˈtʃɪzl/; [or]gmat;
compatible: [x] adj. 可和谐共存的;兼容的; [acc] /kəmˈpætəbl/; [or]gmat;
tinker: [x] n. (流动的)补锅工人;  v. 做拙劣修补; [acc] /ˈtɪŋkər/; [or]gmat;
sanitary: [x] adj. 卫生的;清洁的; [acc] /ˈsænəteri/; [or]gmat;
physiology: [x] n. 生理机能,生理学; [acc] /ˌfɪziˈɑːlədʒi/; [or]gmat;
bead: [x] n. 珠子;水珠; [acc] /biːd/; [or]gmat;
decorous: [x] adj. 端庄稳重的,正派得体的,有礼貌的,高雅的; [acc] /ˈdekərəs/; [or]gmat;
dispel: [x] v. 驱散,驱逐;消除(烦恼等); [acc] /dɪˈspel/; [or]gmat;
duplicate: [x] n. 复制品;  v. 复制;重复;  adj. 完全一样的; [acc] /ˈduːplɪkeɪt/; [or]gmat;
lobster: [x] n. 龙虾;  v. 捕龙虾; [acc] /ˈlɑːbstər/; [or]gmat;
booth: [x] n. 小舍;隔开的小间;公用电话亭;有篷的售货摊;窝棚; [acc] /buːθ/; [or]gmat;
portfolio: [x] n. 公文包,文件夹,投资组合;股份单; [acc] /pɔːrtˈfoʊlioʊ/; [or]gmat;
opaque: [x] adj. 不透明的;难懂的; [acc] /oʊˈpeɪk/; [or]gmat;
acquiesce: [x] v. 默许;勉强同意;  adj. 默认的; [acc] /ˌækwiˈes/; [or]gmat;
polar: [x] adj. 极地的;南北两极的;截然对立的,正好相反的; [acc] /ˈpoʊlər/; [or]gmat;
consecutive: [x] adj. 连续的,连贯的; [acc] /kənˈsekjətɪv/; [or]gmat;
discount: [x] n. (价格,债款等)折扣;  v. 打折扣,不全信,怀疑地看待; [acc] /ˈdɪskaʊnt/; [or]gmat;
acupuncture: [x] n. 针刺(疗法);  vt. 用针灸术治疗;用针刺法麻醉,对.施行针灸治疗; [acc] /ˈækjupʌŋktʃər/; [or]gmat;
predict: [x] v. 预言,预告,预测; [acc] /prɪˈdɪkt/; [or]gmat;
hierarchy: [x] n. 阶层,等级制度; [acc] /ˈhaɪərɑːrki/; [or]gmat;
vernacular: [x] adj. 本国的,地方的,用本地语写成的;  n. 方言;土语;(建筑的)民间风格; [acc] /vərˈnækjələr/; [or]gmat;
outlay: [x] v. 花费;  n. [会计]费用;支出;经费; [acc] /ˈaʊtleɪ/; [or]gmat;
contiguous: [x] adj. 相接的;邻近的,附近的; [acc] /kənˈtɪɡjuəs/; [or]gmat;
tentative: [x] adj. 试探性的;不确定的;暂时的;犹豫不决的; [acc] /ˈtentətɪv/; [or]gmat;
arable: [x] adj. 可耕的,适合种植的;  n. 耕地; [acc] /ˈærəbl/; [or]gmat;
plumb: [x] n. 铅锤,测锤;  vi. 垂直悬挂;  adj. 垂直的;  vt. 用铅锤测量;  adv. 垂直地; [acc] /plʌm/; [or]gmat;
endanger: [x] v. 危及,危害; [acc] /ɪnˈdeɪndʒər/; [or]gmat;
expire: [x] v. 期满,(期限)终止;断气,死亡; [acc] /ɪkˈspaɪər/; [or]gmat;
hover: [x] v. (鸟,直升机)盘旋,翱翔;(人)逗留在附近,徘徊; [acc] /ˈhʌvər/; [or]gmat;
debris: [x] n. 废墟,残骸; [acc] /dəˈbriː/; [or]gmat;
lizard: [x] n. 蜥蜴; [acc] /ˈlɪzərd/; [or]gmat;
obeisance: [x] n. 鞠躬,敬礼;尊敬; [acc] /oʊˈbiːsns/; [or]gmat;
poke: [x] v. 刺,戳;拨开,拨(弄);探(出),露出;  n. 戳,捅; [acc] /poʊk/; [or]gmat;
deter: [x] v. 防止,阻止,使踌躇; [acc] /dɪˈtɜːr/; [or]gmat;
elude: [x] v. 逃避,躲避;使.错过,使.找不到;使.不记得;把.难住; [acc] /iˈluːd/; [or]gmat;
salient: [x] adj. 显著的;突出的;跳跃的;  n. 凸角;突出部分; [acc] /ˈseɪliənt/; [or]gmat;
immutable: [x] adj. 永远不变的,永恒的; [acc] /ɪˈmjuːtəbl/; [or]gmat;
inflection: [x] n. 弯曲,变形,音调变化; [acc] /ɪnˈflekʃn/; [or]gmat;
retaliation: [x] n. 反击;回敬;报复; [acc] /rɪˌtæliˈeɪʃn/; [or]gmat;
pinnacle: [x] n. (哥德式建筑的)小尖塔,顶峰;  v. 置于尖顶上,置于高处; [acc] /ˈpɪnəkl/; [or]gmat;
impact: [x] n. 碰撞,冲击;冲击力;影响;  v. 冲击;压紧;产生影响;塞满; [acc] /ˈɪmpækt/; [or]gmat;
fiber: [x] n. 纤维(物质);纤维组织;(植物) 纤维; [acc] /ˈfaɪbər/; [or]gmat;
sip: [x] v. 啜饮;  n. 一小口; [acc] /sɪp/; [or]gmat;
persecute: [x] v. (尤指因宗教或政治信仰不同)迫害;烦扰,纠缠; [acc] /ˈpɜːrsɪkjuːt/; [or]gmat;
omnipotent: [x] adj. 全能的,万能的;  n. 全能者; [acc] /ɑːmˈnɪpətənt/; [or]gmat;
annuity: [x] n. 年金,养老金;年金保险;年金享受权; [acc] /əˈnuːəti/; [or]gmat;
visual: [x] adj. 看的,视觉的;  n. 视觉资料(指说明性的图片,影片等); [acc] /ˈvɪʒuəl/; [or]gmat;
impartiality: [x] n. 公正,公平;不偏不倚; [acc] /ˌɪmˌpɑːrʃiˈæləti/; [or]gmat;
parole: [x] n. 特别口令;假释;  v. 有条件释放,假释;使假释出狱;宣誓后释放;  adj. 假释的; [acc] /pəˈroʊl/; [or]gmat;
apothecary: [x] n. 药剂师; [acc] /əˈpɑːθəkeri/; [or]gmat;
mosquito: [x] n. 蚊子; [acc] /məˈskiːtoʊ/; [or]gmat;
plaintiff: [x] n. 原告; [acc] /ˈpleɪntɪf/; [or]gmat;
feasible: [x] adj. 可行的,行得通的; [acc] /ˈfiːzəbl/; [or]gmat;
elusive: [x] adj. 难懂的;难捉摸的;难找的;难懂的;易忘的;逃避的;难捉摸的; [acc] /iˈluːsɪv/; [or]gmat;
wrestle: [x] v. 摔跤,角斗;斗争,努力;  n. 摔跤,角力,扭斗; [acc] /ˈresl/; [or]gmat;
minus: [x] prep. 减(去);  adj. 负的;  n. 减号;劣势; [acc] /ˈmaɪnəs/; [or]gmat;
symmetrical: [x] adj. 对称的; [acc] /sɪˈmetrɪkl/; [or]gmat;
mosaic: [x] n. 镶嵌细工,马赛克;  adj. 摩西的;拼花的;  vt. 镶嵌;用马赛克装饰; [acc] /moʊˈzeɪɪk/; [or]gmat;
effigy: [x] n. 肖像,模拟像; [acc] /ˈefɪdʒi/; [or]gmat;
infectious: [x] adj. 传染的;感染性的;易传播的; [acc] /ɪnˈfekʃəs/; [or]gmat;
condescending: [x] adj. 贬低的;有优越感的; [acc] /ˌkɑːndɪˈsendɪŋ/; [or]gmat;
memoir: [x] n. 回忆录,自传(memoirs);传略; [acc] /ˈmemwɑːr/; [or]gmat;
coinage: [x] n. 铸币造币(权);货币,货币制度; [acc] /ˈkɔɪnɪdʒ/; [or]gmat;
smallpox: [x] n. 天花; [acc] /ˈsmɔːlpɑːks/; [or]gmat;
authorize: [x] v. 批准;授权; [acc] /ˈɔːθəraɪz/; [or]gmat;
tilt: [x] v. (使)倾斜;  n. 倾斜,斜坡; [acc] /tɪlt/; [or]gmat;
digit: [x] n. 阿拉伯数字,手指,足趾,一指之宽; [acc] /ˈdɪdʒɪt/; [or]gmat;
antidote: [x] n. [药]解毒剂,解药;矫正方法; [acc] /ˈæntidoʊt/; [or]gmat;
noxious: [x] adj. 有害的,有毒的; [acc] /ˈnɑːkʃəs/; [or]gmat;
constellation: [x] n. 星座,星群,一系列,一群; [acc] /ˌkɑːnstəˈleɪʃn/; [or]gmat;
herring: [x] n. 鲱鱿; [acc] /ˈherɪŋ/; [or]gmat;
preoccupation: [x] n. 抢先占据;全神贯注;首先要做的事,急务; [acc] /priˌɑːkjuˈpeɪʃn/; [or]gmat;
fraudulent: [x] adj. 欺诈的,欺骗性的,骗得的; [acc] /ˈfrɔːdʒələnt/; [or]gmat;
inordinate: [x] adj. 过度的,无节制的;紊乱的; [acc] /ɪnˈɔːrdɪnət/; [or]gmat;
proportional: [x] adj. 成比例的,相称的;  n. [数]比例项,比例量; [acc] /prəˈpɔːrʃənl/; [or]gmat;
astute: [x] adj. 机敏的,精明的,狡猾的; [acc] /əˈstuːt/; [or]gmat;
bountiful: [x] adj. 充足的,慷慨的,丰裕的; [acc] /ˈbaʊntɪfl/; [or]gmat;
fatality: [x] n. 死亡;宿命;致命性;不幸,灾祸; [acc] /fəˈtæləti/; [or]gmat;
approximate: [x] adj. 近似的,约略的;  v. 接近,近似; [acc] /əˈprɑːksɪmət/; [or]gmat;
erudition: [x] n. 博学,学识,学问; [acc] /ˌeruˈdɪʃn/; [or]gmat;
betrayal: [x] n. 背叛;辜负;暴露; [acc] /bɪˈtreɪəl/; [or]gmat;
fraternal: [x] adj. 兄弟的,兄弟般的,友爱的; [acc] /frəˈtɜːrnl/; [or]gmat;
enumeration: [x] n. 列举; [acc] /ɪˌnuːməˈreɪʃn/; [or]gmat;
artery: [x] n. 动脉;干线; [acc] /ˈɑːrtəri/; [or]gmat;
precipitation: [x] n. 猛然摔下;促使;急促;沉淀;降水; [acc] /prɪˌsɪpɪˈteɪʃn/; [or]gmat;
sloth: [x] n. 懒惰;树懒; [acc] /slɑːθ/; [or]gmat;
erratic: [x] adj. 古怪的;反复无常的,不稳定的; [acc] /ɪˈrætɪk/; [or]gmat;
forecast: [x] n. 预测;预报;  v. 预报,预测; [acc] /ˈfɔːrkæst/; [or]gmat;
knack: [x] n. 诀窍;本领;熟练技术;巧妙手法; [acc] /næk/; [or]gmat;
exotic: [x] adj. 奇异的,珍奇的,来自异国的; [acc] /ɪɡˈzɑːtɪk/; [or]gmat;
drab: [x] adj. 枯黄色的,无聊的,单调的;  n. 单调;淡褐色;[印,纺]淡褐色厚呢;邋遢女人; [acc] /dræb/; [or]gmat;
lyrical: [x] adj. 抒情诗调的;感情丰富的;充满愉悦的; [acc] /ˈlɪrɪkl/; [or]gmat;
enhance: [x] v. 提高(强度,力量,数量等);增加,加强; [acc] /ɪnˈhæns/; [or]gmat;
enumerate: [x] v. 列举; [acc] /ɪˈnuːməreɪt/; [or]gmat;
poll: [x] n. 投票,投票数;投票站;民意测验;  v. 获得(票数);  adj. [法]当事人一方作成的; [acc] /poʊl/; [or]gmat;
rigor: [x] n. 严厉;精确;困难境地; [acc] /'rɪgə/; [or]gmat;
caliph: [x] n. 哈里发(伊斯兰国家政教合一的领袖称号); [acc] /ˈkeɪlɪf/; [or]gmat;
component: [x] n. 零件;  adj. 组成的; [acc] /kəmˈpoʊnənt/; [or]gmat;
pendant: [x] n. 吊坠,下垂物; [acc] /ˈpendənt/; [or]gmat;
decorate: [x] v. 装饰,布置;把(勋章)授给(某人); [acc] /ˈdekəreɪt/; [or]gmat;
confederation: [x] n. 同盟,联盟; [acc] /kənˌfedəˈreɪʃn/; [or]gmat;
secretion: [x] n. 分泌,分泌物;隐藏; [acc] /sɪˈkriːʃn/; [or]gmat;
coincide: [x] v. 巧合,一致,相符; [acc] /ˌkoʊɪnˈsaɪd/; [or]gmat;
purge: [x] v. 通便,净化,使(身,心)清净;  n. 驱赶,泻药,净化; [acc] /pɜːrdʒ/; [or]gmat;
scan: [x] v. 细看;浏览;扫描;  n. 扫描;浏览; [acc] /skæn/; [or]gmat;
urine: [x] n. 尿; [acc] /ˈjʊrən/; [or]gmat;
ravenous: [x] adj. 贪婪的;渴望的,极饿的;狼吞虎咽的; [acc] /ˈrævənəs/; [or]gmat;
elective: [x] adj. 选修的,选举的,选任的;  n. 选修课程; [acc] /ɪˈlektɪv/; [or]gmat;
funnel: [x] n. 漏斗;烟囱;  v. 汇集;通过漏斗等;(使)成漏斗形; [acc] /ˈfʌnl/; [or]gmat;
embody: [x] v. 包含;体现,象征; [acc] /ɪmˈbɑːdi/; [or]gmat;
metropolitan: [x] adj. 大城市的,大都会的;大主教区的; [acc] /ˌmetrəˈpɑːlɪtən/; [or]gmat;
cosmic: [x] adj. 宇宙的;广大无边的; [acc] /ˈkɑːzmɪk/; [or]gmat;
renegade: [x] n. 叛教者,脱党者,叛徒;  v. 背叛,背教,变节;  adj. 叛教的,背叛的,变节的; [acc] /ˈrenɪɡeɪd/; [or]gmat;
incipient: [x] adj. 初期的;刚出现的; [acc] /ɪnˈsɪpiənt/; [or]gmat;
cupidity: [x] n. 贪婪; [acc] /kjuːˈpɪdəti/; [or]gmat;
aquatic: [x] adj. 水生的,水栖的,水中的,水上的;  n. 水生动物,水生植物;水上运动; [acc] /əˈkwætɪk/; [or]gmat;
propagation: [x] n. 繁殖;传播; [acc] /ˌprɑːpəˈɡeɪʃn/; [or]gmat;
dominate: [x] v. 在.中占首要地位;支配,统治,控制;耸立于,俯视;处于支配地位,拥有优势; [acc] /ˈdɑːmɪneɪt/; [or]gmat;
graze: [x] v. (牲畜)吃草;放牧;擦过;  n. 擦,擦伤; [acc] /ɡreɪz/; [or]gmat;
practitioner: [x] n. (医生或律师等)开业者;实践者,从事者; [acc] /prækˈtɪʃənər/; [or]gmat;
stench: [x] n. 臭气,恶臭;  vi. (使)发恶臭;  vt. 发恶臭; [acc] /stentʃ/; [or]gmat;
hamper: [x] v. 阻碍,妨碍,牵制;  n. (有盖的)大篮子; [acc] /ˈhæmpər/; [or]gmat;
reflex: [x] n. 条件反射,反映;  adj. 有反应的;反作用的(效果,音响等);反省的;回想的; [acc] /ˈriːfleks/; [or]gmat;
semicircle: [x] n. 半圆形; [acc] /ˈsemisɜːrkl/; [or]gmat;
burrow: [x] n. 洞穴,地道;藏身处,住处;  v. 挖;钻进;搜寻;  vt. 掩蔽; [acc] /ˈbɜːroʊ/; [or]gmat;
collateral: [x] adj. 间接的,旁系的;  n. 抵押品; [acc] /kəˈlætərəl/; [or]gmat;
strategic: [x] adj. 战略(上)的,对全局有重要意义的,关键的; [acc] /strəˈtiːdʒɪk/; [or]gmat;
psyche: [x] n. 灵魂;心智; [acc] /ˈsaɪki/; [or]gmat;
sensuality: [x] n. 淫荡,好色; [acc] /ˌsenʃuˈæləti/; [or]gmat;
prodigy: [x] n. 天才; [acc] /ˈprɑːdədʒi/; [or]gmat;
influx: [x] n. 流入,涌入;河口; [acc] /ˈɪnflʌks/; [or]gmat;
falter: [x] v. 蹒跚,摇摆;踌躇;畏缩;  n. 踌躇;支吾;颤抖; [acc] /ˈfɔːltər/; [or]gmat;
stimulant: [x] n. [药]兴奋剂;刺激物;酒精饮料;  adj. 激励的;使人兴奋的; [acc] /ˈstɪmjələnt/; [or]gmat;
microscopic: [x] adj. 极小的;用显微镜可见的; [acc] /ˌmaɪkrəˈskɑːpɪk/; [or]gmat;
humid: [x] adj. 潮湿的;湿润的;多湿气的; [acc] /ˈhjuːmɪd/; [or]gmat;
mythological: [x] adj. 神话的,虚构的; [acc] /ˌmɪθəˈlɑːdʒɪkl/; [or]gmat;
eliminate: [x] v. 消灭,铲除;消除,根除;(在比赛中)淘汰; [acc] /ɪˈlɪmɪneɪt/; [or]gmat;
personnel: [x] n. 人事部门,员工,人员; [acc] /ˌpɜːrsəˈnel/; [or]gmat;
circulate: [x] v. (使)流通;(使)循环;(使)传播,流传; [acc] /ˈsɜːrkjəleɪt/; [or]gmat;
perversion: [x] n. 堕落,曲解;性怪癖; [acc] /pərˈvɜːrʒn/; [or]gmat;
notify: [x] v. 通知,告知;报告; [acc] /ˈnoʊtɪfaɪ/; [or]gmat;
irreconcilable: [x] adj. 不能妥协的,不能和解的,不能协调的;  n. 不能和解的人,(政治上的)死硬派; [acc] /ɪˈrekənsaɪləbl/; [or]gmat;
narrator: [x] n. 叙述者;解说员; [acc] /ˈnæreɪtər/; [or]gmat;
illicit: [x] adj. 违法的,违禁的; [acc] /ɪˈlɪsɪt/; [or]gmat;
artisan: [x] n. 工匠,手艺人; [acc] /ˈɑːrtəzn/; [or]gmat;
discard: [x] v. 丢弃;抛弃;遗弃; [acc] /dɪsˈkɑːrd/; [or]gmat;
measles: [x] n. [医]麻疹; [acc] /ˈmiːzlz/; [or]gmat;
explode: [x] v. 爆炸;激增;爆发;使爆炸;驳倒; [acc] /ɪkˈsploʊd/; [or]gmat;
pry: [x] v. 刺探,打听,撬开;  n. 窥探;杠杆;爱打探的人; [acc] /praɪ/; [or]gmat;
ingredient: [x] n. (烹调的)原料;(构成的)要素,因素; [acc] /ɪnˈɡriːdiənt/; [or]gmat;
deficit: [x] n. 亏损;赤字;不足额; [acc] /ˈdefɪsɪt/; [or]gmat;
heretical: [x] adj. 异端的,异教的; [acc] /həˈretɪkl/; [or]gmat;
antithesis: [x] n. 对立面,对照; [acc] /ænˈtɪθəsɪs/; [or]gmat;
evacuation: [x] n. 疏散,撤离,排泄; [acc] /ɪˌvækjuˈeɪʃn/; [or]gmat;
insuperable: [x] adj. 难以克服的,无敌的; [acc] /ɪnˈsuːpərəbl/; [or]gmat;
chronology: [x] n. 年代学;(事件等)按年月次序的排列;年表; [acc] /krəˈnɑːlədʒi/; [or]gmat;
credence: [x] n. 信任,相信; [acc] /ˈkriːdns/; [or]gmat;
fallow: [x] adj. 休耕的;不活跃的;休闲地,休闲的;  n. 休耕地;休耕;  v. 使(翻耕后的土地)休闲; [acc] /ˈfæloʊ/; [or]gmat;
palatable: [x] adj. 美味的,合口味的,合心意的; [acc] /ˈpælətəbl/; [or]gmat;
obligatory: [x] adj. 强制性的;义务的;必须的; [acc] /əˈblɪɡətɔːri/; [or]gmat;
indiscriminate: [x] adj. 任意的;不加区别的,不加选择的; [acc] /ˌɪndɪˈskrɪmɪnət/; [or]gmat;
rib: [x] n. 肋骨,伞骨;  v. 装肋于;用肋状物支撑; [acc] /rɪb/; [or]gmat;
adept: [x] n. 专家,能手;  adj. 熟练的;巧妙的; [acc] /əˈdept/; [or]gmat;
stringent: [x] adj. 严厉的;迫切的;银根紧的; [acc] /ˈstrɪndʒənt/; [or]gmat;
intriguing: [x] adj. 迷人的,有迷惑力的,引起兴趣(或好奇心)的; [acc] /ɪnˈtriːɡɪŋ/; [or]gmat;
nickel: [x] n. 镍;美国五分镍币;五分钱; [acc] /ˈnɪkl/; [or]gmat;
penitentiary: [x] n. 监狱,感化院;  adj. 应处监禁的,监禁的,忏悔的; [acc] /ˌpenɪˈtenʃəri/; [or]gmat;
unwieldy: [x] adj. 使用不便的,不灵巧的,难处理的;笨重的; [acc] /ʌnˈwiːldi/; [or]gmat;
reticent: [x] adj. 沉默不语的;有保留的;含蓄的; [acc] /ˈretɪsnt/; [or]gmat;
exhort: [x] vt. 敦促,劝告;  vi. 规劝,劝告; [acc] /ɪɡˈzɔːrt/; [or]gmat;
canary: [x] n. 金丝雀,女歌星;  adj. 加那利群岛的;鲜黄色的; [acc] /kəˈneri/; [or]gmat;
tile: [x] n. 瓦;瓷砖;  v. 贴砖于;用瓦盖; [acc] /taɪl/; [or]gmat;
homogeneous: [x] adj. 同类的,同质的,有相同特征的; [acc] /ˌhoʊməˈdʒiːniəs/; [or]gmat;
missile: [x] n. 导弹;投射出的物体或武器;  adj. 导弹的;可投掷的;用以发射导弹的; [acc] /ˈmɪsl/; [or]gmat;
spin: [x] v. (使)旋转;纺织;疾驰;眩晕;  n. 旋转;纺织;眩晕; [acc] /spɪn/; [or]gmat;
deterioration: [x] n. 变坏,退化,恶化;堕落; [acc] /dɪˌtɪriəˈreɪʃn/; [or]gmat;
rhinoceros: [x] n. 犀牛; [acc] /raɪˈnɑːsərəs/; [or]gmat;
pliant: [x] adj. 易弯的,柔软的;  n. 顺从; [acc] /ˈplaɪənt/; [or]gmat;
dividend: [x] n. (股份的)红利,回报,效益,被除数; [acc] /ˈdɪvɪdend/; [or]gmat;
computation: [x] n. 估计,计算; [acc] /ˌkɑːmpjuˈteɪʃn/; [or]gmat;
impede: [x] v. 妨碍,阻碍; [acc] /ɪmˈpiːd/; [or]gmat;
depict: [x] v. 描绘,描写; [acc] /dɪˈpɪkt/; [or]gmat;
reinforce: [x] v. 加固;加强;增援;支持; [acc] /ˌriːɪnˈfɔːrs/; [or]gmat;
propeller: [x] n. 螺旋桨;推进器; [acc] /prəˈpelər/; [or]gmat;
chef: [x] n. 主厨;厨师; [acc] /ʃef/; [or]gmat;
pertinent: [x] adj. 有关的;适当的;中肯的;  n. 附属物;参考; [acc] /ˈpɜːrtnənt/; [or]gmat;
rewind: [x] v. 倒回(磁带等),倒带; [acc] /ˌriːˈwaɪnd/; [or]gmat;
parasite: [x] n. 寄生虫;靠他人为生的人; [acc] /ˈpærəsaɪt/; [or]gmat;
coherent: [x] adj. 协调一致的;条理清楚的,有条理的;连贯的;有黏性的,黏合在一起的,粘着的; [acc] /koʊˈhɪrənt/; [or]gmat;
frustrate: [x] v. 使灰心;挫败;阻挠; [acc] /ˈfrʌstreɪt/; [or]gmat;
potassium: [x] n. 钾; [acc] /pəˈtæsiəm/; [or]gmat;
retrieve: [x] v. 取回,重新得到,挽回,检索; [acc] /rɪˈtriːv/; [or]gmat;
intentional: [x] adj. 故意的;有意图的; [acc] /ɪnˈtenʃənl/; [or]gmat;
algebra: [x] n. 代数; [acc] /ˈældʒɪbrə/; [or]gmat;
painstaking: [x] adj. (不辞)劳苦的,辛勤的;  n. 辛劳,煞费苦心; [acc] /ˈpeɪnzteɪkɪŋ/; [or]gmat;
Catholic: [x] adj. (兴趣等)广泛的,(C大写)天主教的;  n. (C大写)天主教徒; [acc] /ˈkæθlɪk/; [or]gmat;
alleviate: [x] v. 减轻;缓解;缓和; [acc] /əˈliːvieɪt/; [or]gmat;
entice: [x] v. 怂恿,引诱; [acc] /ɪnˈtaɪs/; [or]gmat;
optical: [x] adj. 光学的;视觉的; [acc] /ˈɑːptɪkl/; [or]gmat;
enact: [x] v. 颁布;制定法律;扮演; [acc] /ɪˈnækt/; [or]gmat;
tuition: [x] n. 学费,教学,讲授; [acc] /tuˈɪʃn/; [or]gmat;
installation: [x] n. 安装,装置;就职; [acc] /ˌɪnstəˈleɪʃn/; [or]gmat;
amenable: [x] adj. 愿意的,顺从的,服从的;经得起检验的; [acc] /əˈmiːnəbl/; [or]gmat;
discriminate: [x] v. 区别,辨别;歧视; [acc] /dɪˈskrɪmɪneɪt/; [or]gmat;
disarm: [x] vt. 放下武器;使人消除敌意;  vi. 解除武装; [acc] /dɪsˈɑːrm/; [or]gmat;
caterpillar: [x] n. 毛虫,蝴蝶的幼虫; [acc] /ˈkætərpɪlər/; [or]gmat;
crucial: [x] adj. 关键的;决定性的; [acc] /ˈkruːʃl/; [or]gmat;
meteor: [x] n. 流星,大气现象; [acc] /ˈmiːtiər/; [or]gmat;
quota: [x] n. 配额;限额;定额; [acc] /ˈkwoʊtə/; [or]gmat;
slick: [x] adj. 光滑的;圆滑的;顺利的;不费力的;  n. 海面浮油;小块湿润的区域;  v. 使平滑; [acc] /slɪk/; [or]gmat;
larva: [x] n. 幼虫,幼体; [acc] /ˈlɑːrvə/; [or]gmat;
calcium: [x] n. 钙; [acc] /ˈkælsiəm/; [or]gmat;
oatmeal: [x] n. 燕麦片,燕麦粥; [acc] /ˈoʊtmiːl/; [or]gmat;
wreak: [x] v. 实施(报复);造成(破坏或混乱); [acc] /riːk/; [or]gmat;
revere: [x] v. 敬畏;尊敬;崇敬; [acc] /rɪˈvɪr/; [or]gmat;
Titanic: [x] adj. 巨人的,力大无比的;  n. 泰坦尼克号; [acc] /taɪˈtænɪk/; [or]gmat;
nuclear: [x] adj. 原子核的;原子能的;细胞核的; [acc] /ˈnuːkliər/; [or]gmat;
dissipate: [x] v. 消散,消失;浪费; [acc] /ˈdɪsɪpeɪt/; [or]gmat;
spectrum: [x] n. 光谱,范围,系列; [acc] /ˈspektrəm/; [or]gmat;
perfunctory: [x] adj. 草率的,敷衍搪塞的; [acc] /pərˈfʌŋktəri/; [or]gmat;
sodium: [x] n. [化学]钠(11号元素,符号Na); [acc] /ˈsoʊdiəm/; [or]gmat;
urchin: [x] n. 海胆,刺猬,小淘气,顽童; [acc] /ˈɜːrtʃɪn/; [or]gmat;
harmonize: [x] v. 使调和,使一致; [acc] /ˈhɑːrmənaɪz/; [or]gmat;
divest: [x] v. 剥夺;使脱去;迫使放弃; [acc] /daɪˈvest/; [or]gmat;
pup: [x] n. 小狗;幼畜;  v. 生(小狗等小动物); [acc] /pʌp/; [or]gmat;
convalescence: [x] n. 康复,恢复,病后康复期; [acc] /ˌkɑːnvəˈlesns/; [or]gmat;
expound: [x] v. 详细说明,解释,阐述; [acc] /ɪkˈspaʊnd/; [or]gmat;
anomaly: [x] n. 异常,不规则,反常事物; [acc] /əˈnɑːməli/; [or]gmat;
besiege: [x] v. 围攻,困扰; [acc] /bɪˈsiːdʒ/; [or]gmat;
facade: [x] n. 建筑物的正面,外表; [acc] /fəˈsɑːd/; [or]gmat;
conspire: [x] v. 密谋策划;共谋,串通一气; [acc] /kənˈspaɪər/; [or]gmat;
comprise: [x] v. 包含,包括;构成; [acc] /kəmˈpraɪz/; [or]gmat;
ostensible: [x] adj. 表面上的,伪装的; [acc] /ɑːˈstensəbl/; [or]gmat;
deft: [x] adj. 灵巧的,敏捷的,熟练的; [acc] /deft/; [or]gmat;
incongruity: [x] n. 不协调,不一致,不适宜; [acc] /ˌɪnkɑːnˈɡruːəti/; [or]gmat;
acquittal: [x] n. 宣告无罪,开释; [acc] /əˈkwɪtl/; [or]gmat;
prototype: [x] n. 原型,典型,样本; [acc] /ˈproʊtətaɪp/; [or]gmat;
observatory: [x] n. 天文台,气象台,瞭望台; [acc] /əbˈzɜːrvətɔːri/; [or]gmat;
intangible: [x] adj. 不可捉摸的,无形的;  n. 无形的东西; [acc] /ɪnˈtændʒəbl/; [or]gmat;
priority: [x] n. 优先;优先权;优先考虑的事;重要事项; [acc] /praɪˈɔːrəti/; [or]gmat;
replete: [x] adj. 充满的,装满的;  n. [昆]贮蜜蚁; [acc] /rɪˈpliːt/; [or]gmat;
offset: [x] v. 抵消;  adj. 胶印的,透印版印刷的;  n. 分支;抵销; [acc] /ˈɔːfset/; [or]gmat;
unbridled: [x] adj. 无拘束的;激烈的;放纵的;放纵的,无约束的; [acc] /ʌnˈbraɪdld/; [or]gmat;
cascade: [x] n. 层叠;小瀑布;喷流;  v. 像瀑布般冲下或倾泻; [acc] /kæˈskeɪd/; [or]gmat;
nutrition: [x] n. 营养,营养学; [acc] /nuˈtrɪʃn/; [or]gmat;
pedestrian: [x] n. 步行者,行人;  adj. 步行的;平庸无奇的,无聊的; [acc] /pəˈdestriən/; [or]gmat;
deferential: [x] adj. 恭敬的; [acc] /ˌdefəˈrenʃl/; [or]gmat;
monitor: [x] n. 显示器;监视器;班长;  v. 监视;监督;监测; [acc] /ˈmɑːnɪtər/; [or]gmat;
repudiate: [x] v. 拒绝,否定,驳斥; [acc] /rɪˈpjuːdieɪt/; [or]gmat;
allege: [x] v. 断言;硬说; [acc] /əˈledʒ/; [or]gmat;
fresco: [x] n. 壁画;壁画法;  v. 在..上做壁画;用壁画法画出; [acc] /ˈfreskoʊ/; [or]gmat;
null: [x] adj. 无效的;不存在的;  n. 零; [acc] /nʌl/; [or]gmat;
emulate: [x] v. 努力赶上(超过),仿效;  n. 仿真; [acc] /ˈemjuleɪt/; [or]gmat;
upheaval: [x] n. 动乱,大变动; [acc] /ʌpˈhiːvl/; [or]gmat;
sickle: [x] n. 镰刀;  vt. 用镰刀割.;使(红血细胞)成镰状;  vi. 呈现出一种异常的月牙状,用于指红血细胞; [acc] /ˈsɪkl/; [or]gmat;
propagate: [x] v. 繁殖,增殖;  vt. 传播,宣传; [acc] /ˈprɑːpəɡeɪt/; [or]gmat;
probe: [x] v. 探测,探索;  n. 探索,调查;探针,探测器; [acc] /proʊb/; [or]gmat;
untenable: [x] adj. 防守不住的,站不住脚的; [acc] /ʌnˈtenəbl/; [or]gmat;
gender: [x] n. 性,性别;[语法]性,某些语言的(名词,代词和形容词)性的区分; [acc] /ˈdʒendər/; [or]gmat;
tickle: [x] v. 呵.痒,使发痒;使高兴;  n. 痒; [acc] /ˈtɪkl/; [or]gmat;
intestine: [x] n. 肠; [acc] /ɪnˈtestɪn/; [or]gmat;
portray: [x] v. 描绘;描述; [acc] /pɔːrˈtreɪ/; [or]gmat;
incandescent: [x] adj. 白热的,热烈的; [acc] /ˌɪnkænˈdesnt/; [or]gmat;
unobtrusive: [x] adj. 不唐突的,谦虚的,不引人注目的; [acc] /ˌʌnəbˈtruːsɪv/; [or]gmat;
didactic: [x] adj. 说教的;教诲的; [acc] /daɪˈdæktɪk/; [or]gmat;
aggravate: [x] v. 使恶化,加重;使气恼,激怒; [acc] /ˈæɡrəveɪt/; [or]gmat;
coy: [x] adj. 腼腆的,怕羞的;卖弄风情的; [acc] /kɔɪ/; [or]gmat;
reclaim: [x] v. 开拓,开垦;感化;取回;改造;废物回收利用; [acc] /rɪˈkleɪm/; [or]gmat;
synthesis: [x] n. 合成; [acc] /ˈsɪnθəsɪs/; [or]gmat;
darn: [x] v. 缝补;  adj. 可恶的;完全的;  adv. 极其;  int. 可恶;  n. 补丁;织补之处; [acc] /dɑːrn/; [or]gmat;
flippant: [x] adj. 无礼的,轻率的,随意的; [acc] /ˈflɪpənt/; [or]gmat;
universality: [x] n. 普遍性,一般性; [acc] /ˌjuːnɪvɜːrˈsæləti/; [or]gmat;
subsidiary: [x] adj. 辅助的,次要的,附属的;  n. 子公司,附属机构; [acc] /səbˈsɪdieri/; [or]gmat;
bizarre: [x] adj. 稀奇古怪的; [acc] /bɪˈzɑːr/; [or]gmat;
communal: [x] adj. 公社的;公共的; [acc] /kəˈmjuːnl/; [or]gmat;
relay: [x] n. 替班;转播;接力赛跑;  v. 转播;传递; [acc] /ˈriːleɪ/; [or]gmat;
depreciation: [x] n. (货币的)贬值;减价;折旧;蔑视; [acc] /dɪˌpriːʃiˈeɪʃn/; [or]gmat;
malaria: [x] n. 瘴气;疟疾; [acc] /məˈleriə/; [or]gmat;
indelible: [x] adj. (印记等)无法擦除的,无法忘怀的; [acc] /ɪnˈdeləbl/; [or]gmat;
inertia: [x] n. 惯性,惰性; [acc] /ɪˈnɜːrʃə/; [or]gmat;
peddler: [x] n. 小贩; [acc] /ˈpedlər/; [or]gmat;
gruesome: [x] adj. 阴森的;可怕的; [acc] /ˈɡruːsəm/; [or]gmat;
kidney: [x] n. 肾,腰子; [acc] /ˈkɪdni/; [or]gmat;
spectacular: [x] adj. 壮观的,引人入胜的;  n. 壮观的场面,精彩的表演; [acc] /spekˈtækjələr/; [or]gmat;
revise: [x] v. 修订;修改;温习(功课); [acc] /rɪˈvaɪz/; [or]gmat;
clandestine: [x] adj. 秘密的,私下的,暗中的; [acc] /klænˈdestɪn/; [or]gmat;
cellular: [x] adj. 细胞的,无线的;蜂窝式的; [acc] /ˈseljələr/; [or]gmat;
behest: [x] n. 命令,训谕; [acc] /bɪˈhest/; [or]gmat;
perplex: [x] v. 使困惑; [acc] /pərˈpleks/; [or]gmat;
trite: [x] adj. 陈腐的;平庸的;老一套的; [acc] /traɪt/; [or]gmat;
mundane: [x] adj. 普通的,平凡的;单调的;现世的,世俗的; [acc] /mʌnˈdeɪn/; [or]gmat;
obviate: [x] v. 排除,避免,消除; [acc] /ˈɑːbvieɪt/; [or]gmat;
comedian: [x] n. 喜剧演员; [acc] /kəˈmiːdiən/; [or]gmat;
decipher: [x] n. 密电译文;  vt. 解释;破译; [acc] /dɪˈsaɪfər/; [or]gmat;
facial: [x] n. 面部按摩,美容;  adj. 表面的,面部的; [acc] /ˈfeɪʃl/; [or]gmat;
subterfuge: [x] n. 托词,借口,诡计; [acc] /ˈsʌbtərfjuːdʒ/; [or]gmat;
regenerate: [x] v. 新生,再生,使革新;  adj. 改过自新的,新生的;  n. 重生者;再生器官; [acc] /rɪˈdʒenəreɪt/; [or]gmat;
steerage: [x] n. 驾驶,操纵,下等客舱; [acc] /ˈstɪrɪdʒ/; [or]gmat;
exterminate: [x] v. 消灭,灭绝;根除; [acc] /ɪkˈstɜːrmɪneɪt/; [or]gmat;
roost: [x] n. 鸟窝,巢穴,栖木;  vi. 栖息; [acc] /ruːst/; [or]gmat;
parity: [x] n. 相等;同等;平价; [acc] /ˈpærəti/; [or]gmat;
ornamentation: [x] n. 装饰品; [acc] /ˌɔːrnəmenˈteɪʃn/; [or]gmat;
equip: [x] v. 装备;具备; [acc] /ɪˈkwɪp/; [or]gmat;
hybrid: [x] n. 杂种,混血儿,混合物;  adj. 混合的;杂种的; [acc] /ˈhaɪbrɪd/; [or]gmat;
pigment: [x] n. 天然色素,颜料; [acc] /ˈpɪɡmənt/; [or]gmat;
scour: [x] v. 搜查;洗涤,洗刷,擦洗;冲刷成,冲刷出; [acc] /ˈskaʊər/; [or]gmat;
etymology: [x] n. 语源,语源学; [acc] /ˌetɪˈmɑːlədʒi/; [or]gmat;
deduce: [x] v. 演绎;推论,推断; [acc] /dɪˈduːs/; [or]gmat;
proficient: [x] adj. 精通的,熟练的; [acc] /prəˈfɪʃnt/; [or]gmat;
chalice: [x] n. (高脚)酒杯;圣餐杯;［植］杯状花; [acc] /ˈtʃælɪs/; [or]gmat;
depress: [x] vt. 使沮丧;使萧条;压下,压低; [acc] /dɪˈpres/; [or]gmat;
sophisticated: [x] adj. (仪器)精密的,复杂的;老于世故的,老练的,富有经验的;高雅的,精致的; [acc] /səˈfɪstɪkeɪtɪd/; [or]gmat;
infuse: [x] v. 沏(茶),泡(草药);灌输;使充满; [acc] /ɪnˈfjuːz/; [or]gmat;
alligator: [x] n. 短吻鳄(一种鳄鱼); [acc] /ˈælɪɡeɪtər/; [or]gmat;
locomotion: [x] n. 运动;移动;旅行; [acc] /ˌloʊkəˈmoʊʃn/; [or]gmat;
sediment: [x] n. 沉渣,沉淀物,沉淀; [acc] /ˈsedɪmənt/; [or]gmat;
specify: [x] v. 详细说明; [acc] /ˈspesɪfaɪ/; [or]gmat;
dislodge: [x] v. 驱逐;移去;取出; [acc] /dɪsˈlɑːdʒ/; [or]gmat;
espouse: [x] v. 支持,拥护; [acc] /ɪˈspaʊz/; [or]gmat;
disparity: [x] n. 不同,不一致,不等; [acc] /dɪˈspærəti/; [or]gmat;
accrue: [x] v. (利息等)增大,增多; [acc] /əˈkruː/; [or]gmat;
discrepancy: [x] n. 不一致,差异,不符; [acc] /dɪsˈkrepənsi/; [or]gmat;
pneumonia: [x] n. 肺炎; [acc] /nuːˈmoʊniə/; [or]gmat;
usurp: [x] vi. 篡夺,篡位;  vt. 篡夺,强夺; [acc] /juːˈzɜːrp/; [or]gmat;
ironic: [x] adj. 讽刺的; [acc] /aɪˈrɑːnɪk/; [or]gmat;
fauna: [x] n. 动物区系,动物群; [acc] /ˈfɔːnə/; [or]gmat;
intersection: [x] n. 交点,十字路口; [acc] /ˌɪntərˈsekʃn/; [or]gmat;
gorilla: [x] n. 大猩猩,打手,暴徒; [acc] /ɡəˈrɪlə/; [or]gmat;
iniquitous: [x] adj. 邪恶的;不公正的; [acc] /ɪˈnɪkwɪtəs/; [or]gmat;
solidarity: [x] n. 团结一致; [acc] /ˌsɑːlɪˈdærəti/; [or]gmat;
paraphrase: [x] v. 解释,释义;  n. 转述,释义; [acc] /ˈpærəfreɪz/; [or]gmat;
certify: [x] v. (发给证书)证明;证实; [acc] /ˈsɜːrtɪfaɪ/; [or]gmat;
dummy: [x] n. 哑巴,笨蛋,傀儡,人形靶;  adj. 虚拟的,假的; [acc] /ˈdʌmi/; [or]gmat;
crypt: [x] n. 地窟,［解］腺窝,小囊;  pref. 隐藏的;秘密的(=crypto); [acc] /krɪpt/; [or]gmat;
phonograph: [x] n. 留声机; [acc] /ˈfoʊnəɡræf/; [or]gmat;
brew: [x] v. 调制;酿造;冲泡 (茶,咖啡等);酝酿;筹划;  n. 酝酿的饮料;啤酒; [acc] /bruː/; [or]gmat;
homicide: [x] n. 杀人,杀人者; [acc] /ˈhɑːmɪsaɪd/; [or]gmat;
disinclination: [x] n. 不感兴趣,厌恶; [acc] /ˌdɪsˌɪnklɪˈneɪʃn/; [or]gmat;
syndicate: [x] n. 辛迪加;企业联合;财团;  v. 联合成辛迪加;组成企业联合组织;在多家报刊上同时发表; [acc] /ˈsɪndɪkət/; [or]gmat;
divulge: [x] v. 泄露,透露; [acc] /daɪˈvʌldʒ/; [or]gmat;
forestall: [x] v. 领先;占先一步;先发制人,阻止,妨碍;垄断;占先一步; [acc] /fɔːrˈstɔːl/; [or]gmat;
deprivation: [x] n. 剥夺;免职;匮乏;丧失;损失;免职; [acc] /ˌdeprɪˈveɪʃn/; [or]gmat;
alienate: [x] v. 疏远;挑拨; [acc] /ˈeɪliəneɪt/; [or]gmat;
generate: [x] v. 产生(热,电等能量),创造; [acc] /ˈdʒenəreɪt/; [or]gmat;
commensurate: [x] adj. 相称的,相应的;同量的;同样大小的; [acc] /kəˈmenʃərət/; [or]gmat;
snout: [x] n. 猪嘴,猪鼻子;  v. 装管嘴; [acc] /snaʊt/; [or]gmat;
morale: [x] n. 士气,斗志; [acc] /məˈræl/; [or]gmat;
circumspect: [x] adj. 慎重的,仔细的; [acc] /ˈsɜːrkəmspekt/; [or]gmat;
inalienable: [x] adj. 不可分割的; [acc] /ɪnˈeɪliənəbl/; [or]gmat;
classify: [x] v. 把.分类; [acc] /ˈklæsɪfaɪ/; [or]gmat;
inflammatory: [x] adj. 炎症性的;煽动性的;激动的; [acc] /ɪnˈflæmətɔːri/; [or]gmat;
disproportionate: [x] adj. 不成比例的; [acc] /ˌdɪsprəˈpɔːrʃənət/; [or]gmat;
parochial: [x] adj. 教区的;地方范围的; [acc] /pəˈroʊkiəl/; [or]gmat;
curriculum: [x] n. 课程,(学校或专业的)全部课程; [acc] /kəˈrɪkjələm/; [or]gmat;
splinter: [x] n. 碎片;微小的东西;极瘦的人;  v. 分裂;裂成碎片; [acc] /ˈsplɪntər/; [or]gmat;
pant: [x] v. 喘息;气喘吁吁地说;喘气;  n. 喘气; [acc] /pænt/; [or]gmat;
bonus: [x] n. 奖金,额外津贴; [acc] /ˈboʊnəs/; [or]gmat;
asset: [x] n. 财产,资产,有价值的东西或人; [acc] /ˈæset/; [or]gmat;
delta: [x] n. (河流的)三角洲; [acc] /ˈdeltə/; [or]gmat;
illusory: [x] adj. 错觉的,幻影的,虚假的,产生幻觉的; [acc] /ɪˈluːsəri/; [or]gmat;
detrimental: [x] adj. 有害的,不利的; [acc] /ˌdetrɪˈmentl/; [or]gmat;
ambiguity: [x] n. 模棱两可;歧义;误解; [acc] /ˌæmbɪˈɡjuːəti/; [or]gmat;
filament: [x] n. 灯丝,细丝; [acc] /ˈfɪləmənt/; [or]gmat;
weld: [x] v. 焊接;使结合,使成整体;  n. 焊接; [acc] /weld/; [or]gmat;
handicap: [x] n. 障碍,阻碍,不利条件,不利因素;残疾,缺陷,生理缺陷;[高尔夫]给弱者增加的杆数(按击球次数计数,并随参赛者的进步而减少);  v. 使不利,妨碍; [acc] /ˈhændikæp/; [or]gmat;
jolt: [x] n. 猛的一击,摇晃,震惊;  v. (使)颠簸,摇晃;使震惊; [acc] /dʒoʊlt/; [or]gmat;
demur: [x] n. 异议;  v. 异议,反对,拒绝; [acc] /dɪˈmɜːr/; [or]gmat;
diagonal: [x] n. 对角线;  adj. 对角线的;斜的;斜纹的; [acc] /daɪˈæɡənl/; [or]gmat;
adamant: [x] adj. 强硬的,固执的;  n. 坚硬的东西;坚石; [acc] /ˈædəmənt/; [or]gmat;
terse: [x] adj. 简洁的,简明的; [acc] /tɜːrs/; [or]gmat;
indigent: [x] adj. 贫困的,贫穷的; [acc] /ˈɪndɪdʒənt/; [or]gmat;
stave: [x] n. 梯子,杖,梯级;  v. 延缓,破碎,穿孔; [acc] /steɪv/; [or]gmat;
ailment: [x] n. 疾病(尤指微恙),不宁,不安; [acc] /ˈeɪlmənt/; [or]gmat;
taboo: [x] n. 禁忌,(宗教)戒律;  adj. (因不道德或危险而)讳忌的,戒律的; [acc] /təˈbuː/; [or]gmat;
refugee: [x] n. 避难者,难民;  v. 避难;  adj. 避难的; [acc] /ˌrefjuˈdʒiː/; [or]gmat;
shuttle: [x] n. 短程穿梭运行的车辆,接驳车;梭子;穿梭;航天飞机;  v. 穿梭移动;穿梭往返;往返于两地之间; [acc] /ˈʃʌtl/; [or]gmat;
protein: [x] n. 蛋白质;  adj. 蛋白质的; [acc] /ˈproʊtiːn/; [or]gmat;
interlude: [x] n. 插曲;穿插;间歇;幕间节目; [acc] /ˈɪntərluːd/; [or]gmat;
dump: [x] v. 倾倒,丢弃;抛弃(某人);  n. 垃圾场,废物堆;军需品临时堆放的地方; [acc] /dʌmp/; [or]gmat;
tally: [x] n. 计数器;标签;记账;完全相似;  v. 使符合;计算;记录;一致; [acc] /ˈtæli/; [or]gmat;
skeptical: [x] adj. 表示怀疑的; [acc] /ˈskeptɪkl/; [or]gmat;
evolve: [x] v. 使进化;使发展; [acc] /iˈvɑːlv/; [or]gmat;
refine: [x] v. 精炼,改进; [acc] /rɪˈfaɪn/; [or]gmat;
sentient: [x] adj. 有感情的,有感觉力的,意识到的;  n. 有知觉的人; [acc] /ˈsentiənt/; [or]gmat;
demise: [x] n. 死亡,终结; [acc] /dɪˈmaɪz/; [or]gmat;
delinquent: [x] n. 少年罪犯,违犯者;  adj. 不尽责的;怠工的;〈美〉拖欠(税款)的; [acc] /dɪˈlɪŋkwənt/; [or]gmat;
definitive: [x] adj. 可靠的,明确的,权威的;决定性的; [acc] /dɪˈfɪnətɪv/; [or]gmat;
initiate: [x] v. 开始,发动;  n. 新加入组织的人; [acc] /ɪˈnɪʃieɪt/; [or]gmat;
affluent: [x] adj. 富裕的,丰富的; [acc] /ˈæfluənt/; [or]gmat;
affluence: [x] n. 丰富,富裕,流入; [acc] /ˈæfluəns/; [or]gmat;
divergent: [x] adj. 叉开的;分歧的; [acc] /daɪˈvɜːrdʒənt/; [or]gmat;
coyote: [x] n. (美国西部的)郊狼,小狼; [acc] /kaɪˈoʊti/; [or]gmat;
shatter: [x] v. 使粉碎;砸碎;打碎;粉碎; [acc] /ˈʃætər/; [or]gmat;
squash: [x] v. 压扁,压制;  n. 南瓜,易压烂的物品,拥挤的人群,壁球; [acc] /skwɑːʃ/; [or]gmat;
mobility: [x] n. 活动性,灵活性,迁移率,机动性; [acc] /moʊˈbɪləti/; [or]gmat;
monsoon: [x] n. 季雨,季风,大雨; [acc] /ˌmɑːnˈsuːn/; [or]gmat;
sparse: [x] adj. 稀少的;稀疏的; [acc] /spɑːrs/; [or]gmat;
clipping: [x] n. 剪下物,剪辑,剪报;  adj. 快速的; [acc] /ˈklɪpɪŋ/; [or]gmat;
aggregation: [x] n. 集合,集合体,聚合; [acc] /ˌæɡrɪˈɡeɪʃn/; [or]gmat;
substantive: [x] adj. 有实质的;大量的;真实的;独立存在的;  n. 实词,名词,名词性词组; [acc] /səbˈstæntɪv/; [or]gmat;
habitat: [x] n. 自然环境,栖息地; [acc] /ˈhæbɪtæt/; [or]gmat;
sinew: [x] n. 腱,筋,中坚力量;  v. 用腱连结,(好像使用肌筋似的)给..以力量,支持; [acc] /ˈsɪnjuː/; [or]gmat;
exigency: [x] n. 紧急(状态);危急(关头);事变; [acc] /ˈeksɪdʒənsi/; [or]gmat;
dilute: [x] v. 使变淡,稀释;使病弱; [acc] /daɪˈluːt/; [or]gmat;
potter: [x] n. 陶工;  v. 懒散;闲逛;慢条斯理地做事; [acc] /ˈpɑːtər/; [or]gmat;
ensemble: [x] n. 合唱团,表演团体;总效果;全套服装;全套家具; [acc] /ɑːnˈsɑːmbl/; [or]gmat;
agrarian: [x] adj. 耕地的; [acc] /əˈɡreriən/; [or]gmat;
embargo: [x] v. 禁止出入港口;禁止或限制贸易;征用或扣押;  n. 禁令;禁止;封港令; [acc] /ɪmˈbɑːrɡoʊ/; [or]gmat;
saliva: [x] n. 唾液;  vi. 分泌唾液; [acc] /səˈlaɪvə/; [or]gmat;
congestion: [x] n. 拥挤,充血; [acc] /kənˈdʒestʃən/; [or]gmat;
cube: [x] n. 立方体,立方; [acc] /kjuːb/; [or]gmat;
glean: [x] v. 收集(资料); [acc] /ɡliːn/; [or]gmat;
regimen: [x] n. 养生法,生活规则; [acc] /ˈredʒɪmən/; [or]gmat;
slam: [x] v. 砰地关上;猛力拉,扔;砰地放下;猛烈抨击;  n. 砰的一声;大满贯; [acc] /slæm/; [or]gmat;
tactical: [x] adj. 手段的,战术的; [acc] /ˈtæktɪkl/; [or]gmat;
overt: [x] adj. 明显的;公开的;公然的; [acc] /oʊˈvɜːrt/; [or]gmat;
memento: [x] n. 纪念品; [acc] /məˈmentoʊ/; [or]gmat;
versatility: [x] n. 多功能;多用途; [acc] /ˌvɜːrsəˈtɪləti/; [or]gmat;
precursor: [x] n. 先兆,先驱,前体; [acc] /priːˈkɜːrsər/; [or]gmat;
displace: [x] v. 取代,替代,迫使(某人)离开家园,使离开原位; [acc] /dɪsˈpleɪs/; [or]gmat;
conglomerate: [x] n. 砾岩;联合大企业;  vi. 聚集;  adj. 混合的;联合大企业的;  vt. 使聚集;使结成;结合; [acc] /kənˈɡlɑːmərət/; [or]gmat;
autonomy: [x] n. 人身自由;自治;自治权; [acc] /ɔːˈtɑːnəmi/; [or]gmat;
accountant: [x] n. 会计人员,会计师; [acc] /əˈkaʊntənt/; [or]gmat;
nitric: [x] adj. 氮的,含氮的; [acc] /'naɪtrɪk/; [or]gmat;
availability: [x] n. 可得到的人(或物);可用性; [acc] /əˌveɪləˈbɪləti/; [or]gmat;
stipend: [x] n. 奖学金;固定薪金;定期津贴;养老金; [acc] /ˈstaɪpend/; [or]gmat;
skepticism: [x] n. 怀疑态度;怀疑论;多疑癖; [acc] /ˈskeptɪsɪzəm/; [or]gmat;
graph: [x] n. (曲线)图,图表;  vt. 用曲线图表示,把.绘入图表;用胶版印刷; [acc] /ɡræf/; [or]gmat;
phosphate: [x] n. 磷酸盐,磷酸酯; [acc] /ˈfɑːsfeɪt/; [or]gmat;
jasper: [x] n. ［矿］碧玉,墨绿色; [acc] /'dʒæspə/; [or]gmat;
larvae: [x] n. 幼虫;幼体; [acc] /'lɑːrviː/; [or]gmat;
primordial: [x] adj. 原始的;根本的;原生的; [acc] /praɪˈmɔːrdiəl/; [or]gmat;
fungi: [x] n. 菌类;真菌; [acc] /ˈfʌŋɡaɪ/; [or]gmat;
obtrusive: [x] adj. 突出的,爱管闲事的,冒失的,强迫人的; [acc] /əbˈtruːsɪv/; [or]gmat;
diploma: [x] n. 毕业文凭,毕业证书;文凭课程; [acc] /dɪˈploʊmə/; [or]gmat;
smear: [x] n. 油渍,污点,中伤;  v. 涂上,玷污,诽谤,抹去; [acc] /smɪr/; [or]gmat;
strut: [x] n. 高视阔步,抗压装置;  v. 昂首阔步地走,趾高气昂地走; [acc] /strʌt/; [or]gmat;
literacy: [x] n. 读写能力;识字;有文化;教养; [acc] /ˈlɪtərəsi/; [or]gmat;
fume: [x] n. 烟;愤怒;  v. 冒烟;发怒; [acc] /fjuːm/; [or]gmat;
certitude: [x] n. 确实;确信;必然性; [acc] /ˈsɜːrtɪtuːd/; [or]gmat;
espionage: [x] n. 间谍活动,侦查,监视; [acc] /ˈespiənɑːʒ/; [or]gmat;
disrupt: [x] v. 扰乱; [acc] /dɪsˈrʌpt/; [or]gmat;
ferret: [x] n. 雪貂;白鼬;侦探;  v. 搜寻;查获;驱出;用雪貂猎取;  adj. 雪貂似的;搜索者般的;爱窥探的; [acc] /ˈferɪt/; [or]gmat;
envelop: [x] v. 包围,包上;  n. 信封(同"envelope"); [acc] /ɪnˈveləp/; [or]gmat;
clog: [x] v. 阻塞,阻碍;  n. 障碍;木底鞋; [acc] /klɑːɡ/; [or]gmat;
conserve: [x] v. 保藏,保存;节约;  n. 蜜饯,果酱; [acc] /kənˈsɜːrv/; [or]gmat;
fabrication: [x] n. 制作;构成;捏造;伪造物;装配工; [acc] /ˌfæbrɪˈkeɪʃn/; [or]gmat;
eradicate: [x] v. 根除;消灭; [acc] /ɪˈrædɪkeɪt/; [or]gmat;
transmitter: [x] n. 传送者,送话器;发射机;发射台;话筒; [acc] /trænsˈmɪtər/; [or]gmat;
deride: [x] v. 嘲弄,愚弄; [acc] /dɪˈraɪd/; [or]gmat;
derogatory: [x] adj. 不敬的,诽谤的; [acc] /dɪˈrɑːɡətɔːri/; [or]gmat;
subscriber: [x] n. 订购者,捐献者; [acc] /səbˈskraɪbər/; [or]gmat;
fake: [x] adj. 假的,伪造的;  n. 骗子;假货,赝品;  v. 假造,杜撰;伪造;冒充,假装;假装; [acc] /feɪk/; [or]gmat;
spawn: [x] n. 卵;菌丝;产物;  v. 产卵;酿成,造成;大量生产; [acc] /spɔːn/; [or]gmat;
calamitous: [x] adj. 造成灾祸的,灾难的,悲惨的; [acc] /kəˈlæmɪtəs/; [or]gmat;
capsule: [x] n. 胶囊;航天舱,密封舱; [acc] /ˈkæpsl/; [or]gmat;
provocative: [x] adj. 挑衅的,煽动的,刺激的;挑逗的; [acc] /prəˈvɑːkətɪv/; [or]gmat;
mow: [x] n. 干草堆;谷堆;  v. 刈,收割庄稼;扫除,扫倒; [acc] /moʊ/; [or]gmat;
infect: [x] v. 传染,感染;使受影响; [acc] /ɪnˈfekt/; [or]gmat;
incisive: [x] adj. 一针见血的,敏锐的; [acc] /ɪnˈsaɪsɪv/; [or]gmat;
premise: [x] n. 前提;房屋地基;  v. 假定; [acc] /ˈpremɪs/; [or]gmat;
stunt: [x] n. 惊人表演,特技;矮小的人(或物);  v. 阻碍..发育;作惊人表演;使绝招; [acc] /stʌnt/; [or]gmat;
bolster: [x] n. 枕垫;  v. 支持,鼓励,增强; [acc] /ˈboʊlstər/; [or]gmat;
protege: [x] n. 被保护人,门徒,门生; [acc] /ˈproʊtəʒeɪ/; [or]gmat;
secrete: [x] v. 藏匿;私下侵吞;分泌; [acc] /sɪˈkriːt/; [or]gmat;
quiescent: [x] adj. 静止的,沉寂的,不活动的; [acc] /kwaɪˈesnt/; [or]gmat;
donor: [x] n. 捐献者; [acc] /ˈdoʊnər/; [or]gmat;
embellish: [x] vt. 装饰;  v. 吹嘘;润色(文章);  vi. 装饰起来;加以润色;添加细节,对...添枝加叶; [acc] /ɪmˈbelɪʃ/; [or]gmat;
conceal: [x] v. 隐藏,隐瞒,掩盖; [acc] /kənˈsiːl/; [or]gmat;
patronize: [x] v. 惠顾;赞助,资助; [acc] /ˈpeɪtrənaɪz/; [or]gmat;
demolition: [x] n. 拆除(等于demolishment);破坏,毁坏; [acc] /ˌdeməˈlɪʃn/; [or]gmat;
trenchant: [x] adj. 犀利的,锐利的,有力的,清晰的,一针见血的; [acc] /ˈtrentʃənt/; [or]gmat;
debut: [x] n. 初次登台,在社交场合的初次露脸;  v. 初次露面,初次表演;首次推出;  adj. 首张的,首场的,首次的; [acc] /deɪˈbjuː/; [or]gmat;
radiate: [x] v. 辐射,发出(光或热);流露,显示;(使)从中心发散; [acc] /ˈreɪdieɪt/; [or]gmat;
drizzle: [x] v. 下毛毛雨;  n. 细雨,毛毛雨; [acc] /ˈdrɪzl/; [or]gmat;
elite: [x] n. 精英;  adj. 高级的; [acc] /ɪˈliːt/; [or]gmat;
putty: [x] n. ［建］腻子,易于被人摆弄的人;  v. 用油灰填塞; [acc] /ˈpʌti/; [or]gmat;
amplitude: [x] n. 振幅;广阔;幅度; [acc] /ˈæmplɪtuːd/; [or]gmat;
infest: [x] v. 骚扰,寄生于,大批出没; [acc] /ɪnˈfest/; [or]gmat;
dimension: [x] n. 维度;尺寸;尺度;方面; [acc] /dɪˈmenʃn/; [or]gmat;
rugby: [x] n. 英式橄榄球;拉格比(英格兰中部的城市); [acc] /ˈrʌɡbi/; [or]gmat;
concurrent: [x] adj. 一致的;同时发生的;  n. 同时发生的事件; [acc] /kənˈkɜːrənt/; [or]gmat;
encroach: [x] v. 侵犯,侵占;蚕食(on); [acc] /ɪnˈkroʊtʃ/; [or]gmat;
corroborate: [x] v. 支持或证实,强化;  n. 确证者,证物; [acc] /kəˈrɑːbəreɪt/; [or]gmat;
quantum: [x] n. 量子论; [acc] /ˈkwɑːntəm/; [or]gmat;
maneuver: [x] v. 操纵;  n. 操纵;花招;调遣;策略; [acc] /məˈnʊvər/; [or]gmat;
churn: [x] n. (炼制黄油用的)搅乳器;  v. 用搅乳器搅拌; [acc] /tʃɜːrn/; [or]gmat;
accelerate: [x] v. 加速,增长;使增速,促进; [acc] /əkˈseləreɪt/; [or]gmat;
intensify: [x] v. 增强;加剧; [acc] /ɪnˈtensɪfaɪ/; [or]gmat;
dwindle: [x] v. 日渐减少,变小,缩小; [acc] /ˈdwɪndl/; [or]gmat;
bounce: [x] vi. 弹起,蹦跳;  vt. 使弹起;  v. 拒付 (支票);  n. 弹跳,弹力,活力; [acc] /baʊns/; [or]gmat;
salvage: [x] n. 抢救;从灾难中抢救出的物资;  vt. 拯救;打捞; [acc] /ˈsælvɪdʒ/; [or]gmat;
feline: [x] n. 猫科动物;  adj. 猫科的,猫的; [acc] /ˈfiːlaɪn/; [or]gmat;
intermediary: [x] adj. 中间的;媒介的;中途的;  n. 中间人;仲裁者;调解者;媒介物; [acc] /ˌɪntərˈmiːdieri/; [or]gmat;
glut: [x] n. 供过于求,过多;  vt. 使吃饱;使充斥;  vi. 过量地吃; [acc] /ɡlʌt/; [or]gmat;
tuberculosis: [x] n. 肺结核; [acc] /tuːˌbɜːrkjəˈloʊsɪs/; [or]gmat;
deprecate: [x] v. 反对;轻视; [acc] /ˈdeprəkeɪt/; [or]gmat;
prowl: [x] n. (鬼鬼祟祟)徘徊,觅食,游荡;  vi. 徘徊,潜行;  vt. 在.搜寻;潜行于; [acc] /praʊl/; [or]gmat;
evaporate: [x] v. 蒸发,失去水分;消失; [acc] /ɪˈvæpəreɪt/; [or]gmat;
encyclopedia: [x] n. 百科全书; [acc] /ɪnˌsaɪkləˈpiːdiə/; [or]gmat;
cache: [x] n. 隐藏处所,隐藏的粮食或物资,贮藏物;  vt. 贮藏;  vi. 躲藏; [acc] /kæʃ/; [or]gmat;
scorch: [x] v. 烧焦;枯萎;  vi. 高速行驶,疾驰,飞驰; [acc] /skɔːrtʃ/; [or]gmat;
ethnic: [x] adj. 种族的,少数民族的;  n. 少数民族成员;人种学; [acc] /ˈeθnɪk/; [or]gmat;
pare: [x] v. 削去,剥去; [acc] /per/; [or]gmat;
linear: [x] adj. 线的,线性的;直线的;长度的; [acc] /ˈlɪniər/; [or]gmat;
compress: [x] v. 压紧,压缩,压榨; [acc] /kəmˈpres/; [or]gmat;
egregious: [x] adj. 非常恶劣的,过分的;恶名昭彰的;惊人的; [acc] /ɪˈɡriːdʒiəs/; [or]gmat;
marital: [x] adj. 婚姻的; [acc] /ˈmærɪtl/; [or]gmat;
encompass: [x] vt. 环绕,包围;包含;完成; [acc] /ɪnˈkʌmpəs/; [or]gmat;
repository: [x] n. 储藏室;仓库;智囊人物;知识库; [acc] /rɪˈpɑːzətɔːri/; [or]gmat;
cumbersome: [x] adj. 笨重的;麻烦的; [acc] /ˈkʌmbərsəm/; [or]gmat;
condense: [x] v. 压缩;精炼;冷凝; [acc] /kənˈdens/; [or]gmat;
tempo: [x] n. [音]节奏,拍子;行进速度; [acc] /ˈtempoʊ/; [or]gmat;
immune: [x] adj. 免疫的,有免疫力的;不受影响的;免除的; [acc] /ɪˈmjuːn/; [or]gmat;
bilateral: [x] adj. 双边的,有两面的; [acc] /ˌbaɪˈlætərəl/; [or]gmat;
irate: [x] adj. 发怒的,愤怒的; [acc] /aɪˈreɪt/; [or]gmat;
endorsement: [x] n. 认可,支持;背书;签注(文件); [acc] /ɪnˈdɔːrsmənt/; [or]gmat;
clarity: [x] n. 清楚;清澈; [acc] /ˈklærəti/; [or]gmat;
panacea: [x] n. 灵丹妙药,万能药; [acc] /ˌpænəˈsiːə/; [or]gmat;
molecule: [x] n. 分子,微粒; [acc] /ˈmɑːlɪkjuːl/; [or]gmat;
inextricable: [x] adj. 无法摆脱的,纠缠的;  adv. 无法摆脱地,解不开地; [acc] /ˌɪnɪkˈstrɪkəbl/; [or]gmat;
configuration: [x] n. 配置,布局,构造; [acc] /kənˌfɪɡjəˈreɪʃn/; [or]gmat;
overweening: [x] adj. 自负的,过于自信的,傲慢的; [acc] /ˌoʊvərˈwiːnɪŋ/; [or]gmat;
quantitative: [x] adj. 定量的; [acc] /ˈkwɑːntəteɪtɪv/; [or]gmat;
emanate: [x] v. 发出;放射; [acc] /ˈeməneɪt/; [or]gmat;
abdicate: [x] adj. 放弃权力的;退位的;  n. 放弃权力者;退位者;  vi. 退位,辞职;  vt. 辞;放弃; [acc] /ˈæbdɪkeɪt/; [or]gmat;
clam: [x] n. 蛤,蚶;沉默寡言的人; [acc] /klæm/; [or]gmat;
brewery: [x] n. 啤酒厂; [acc] /ˈbruːəri/; [or]gmat;
intake: [x] n. 吸入,收纳;纳入(数量); [acc] /ˈɪnteɪk/; [or]gmat;
virtuoso: [x] n. 艺术品鉴赏家,古董收藏家,艺术大师;  adj. 行家里手的,艺术爱好者的; [acc] /ˌvɜːrtʃuˈoʊsoʊ/; [or]gmat;
endorse: [x] v. 赞同,认可;签注(文件); [acc] /ɪnˈdɔːrs/; [or]gmat;
dope: [x] n. 毒品;粘稠物,胶状物,添加剂;傻瓜,蠢货;内幕消息;  v. 给.服用麻醉剂;  adj. <俚>极好的; [acc] /doʊp/; [or]gmat;
scurrilous: [x] adj. 下流的,恶言毁谤的; [acc] /ˈskɜːrələs/; [or]gmat;
isolate: [x] v. 使隔离;使孤立;  adj. 孤立的;单独的; [acc] /ˈaɪsəleɪt/; [or]gmat;
pulsation: [x] n. 有节奏的鼓动,脉动; [acc] /pʌlˈseɪʃn/; [or]gmat;
captivate: [x] v. 吸引,迷惑; [acc] /ˈkæptɪveɪt/; [or]gmat;
aviator: [x] n. 飞行员; [acc] /ˈeɪvieɪtər/; [or]gmat;
longevity: [x] n. 长寿,长命;寿命; [acc] /lɔːnˈdʒevəti/; [or]gmat;
cinder: [x] n. 余烬,矿渣; [acc] /ˈsɪndər/; [or]gmat;
elliptical: [x] adj. 椭圆的;省略的; [acc] /ɪˈlɪptɪkl/; [or]gmat;
incursion: [x] n. 入侵,侵犯; [acc] /ɪnˈkɜːrʒn/; [or]gmat;
liken: [x] v. 把..比作,比拟; [acc] /ˈlaɪkən/; [or]gmat;
cereal: [x] n. 谷物;谷类食物;谷类食品;  adj. 谷类的;谷类制成的; [acc] /ˈsɪriəl/; [or]gmat;
recur: [x] v. 重新出现;再次发生;重新提起;诉诸;反复; [acc] /rɪˈkɜːr/; [or]gmat;
captious: [x] adj. 挑剔的,吹毛求疵的; [acc] /'kæpʃəs/; [or]gmat;
pact: [x] n. 合同;协约; [acc] /pækt/; [or]gmat;
aura: [x] n. (人或物发出的)气味,气氛,先兆; [acc] /ˈɔːrə/; [or]gmat;
asthma: [x] n. 哮喘症; [acc] /ˈæzmə/; [or]gmat;
terminology: [x] n. 术语,术语学; [acc] /ˌtɜːrməˈnɑːlədʒi/; [or]gmat;
engender: [x] v. 产生; [acc] /ɪnˈdʒendər/; [or]gmat;
gregarious: [x] adj. 群居的,爱社交的; [acc] /ɡrɪˈɡeriəs/; [or]gmat;
hedgehog: [x] n. 刺猬; [acc] /ˈhedʒhɔːɡ/; [or]gmat;
lymph: [x] n. ［医］淋巴,淋巴液,(淋巴液似的)浆,苗; [acc] /lɪmf/; [or]gmat;
circumvent: [x] v. 用计避免,规避; [acc] /ˌsɜːrkəmˈvent/; [or]gmat;
electorate: [x] n. 选民;选区; [acc] /ɪˈlektərət/; [or]gmat;
erase: [x] v. (计算机)擦除;抹去;擦掉; [acc] /ɪˈreɪs/; [or]gmat;
mediate: [x] v. 调解,调停,斡旋; [acc] /ˈmiːdieɪt/; [or]gmat;
propound: [x] v. 提出(问题,计划)供考虑; [acc] /prəˈpaʊnd/; [or]gmat;
intersect: [x] v. 横截,横断;贯穿;相交;交叉; [acc] /ˌɪntərˈsekt/; [or]gmat;
aluminum: [x] n. 铝; [acc] /əˈluːmɪnəm/; [or]gmat;
alfalfa: [x] n. 茴蓿,紫苜蓿; [acc] /ælˈfælfə/; [or]gmat;
balk: [x] v. 畏缩;阻止;停止;  n. 障碍;错误; [acc] /bɔːk/; [or]gmat;
denouement: [x] n. 结局,终场; [acc] /ˌdeɪnuːˈmɑ̃ː/; [or]gmat;
interrogate: [x] v. 审问,审讯; [acc] /ɪnˈterəɡeɪt/; [or]gmat;
static: [x] adj. 静电的,静态的,静止的;  n. 静电,静电干扰; [acc] /ˈstætɪk/; [or]gmat;
fad: [x] n. 风尚,风行一时的东西;  adj. 极好的; [acc] /fæd/; [or]gmat;
seedling: [x] n. 幼苗,籽苗; [acc] /ˈsiːdlɪŋ/; [or]gmat;
casualty: [x] n. 伤亡人员,死伤者,受害人;急诊室(英); [acc] /ˈkæʒuəlti/; [or]gmat;
pragmatic: [x] adj. 国事的,团体事务的;实际的,注重实效的;  n. 爱管闲事的人;专断的人;国事诏书;实际家; [acc] /præɡˈmætɪk/; [or]gmat;
beneficiary: [x] n. [金融]受益人,受惠者;封臣;  adj. 拥有封地的;受圣俸的; [acc] /ˌbenɪˈfɪʃieri/; [or]gmat;
tangent: [x] n. 切线;  adj. 无关的; [acc] /ˈtændʒənt/; [or]gmat;
mural: [x] n. 壁画;壁饰;  adj. 墙壁的;挂在墙壁上的; [acc] /ˈmjʊrəl/; [or]gmat;
fixture: [x] n. 固定装置;体育项目; [acc] /ˈfɪkstʃər/; [or]gmat;
lobe: [x] n. 耳垂,波瓣,(脑,肺等的)叶,裂片; [acc] /loʊb/; [or]gmat;
expedite: [x] v. 加快;促进;发出;  adj. 畅通的;迅速的;方便的; [acc] /ˈekspədaɪt/; [or]gmat;
debase: [x] v. 贬值,降低; [acc] /dɪˈbeɪs/; [or]gmat;
resonance: [x] n. 共振;回声;(情感等的)共鸣; [acc] /ˈrezənəns/; [or]gmat;
install: [x] v. 安装,安置,使就职; [acc] /ɪnˈstɔːl/; [or]gmat;
bulge: [x] n. 凸出部分;  v. 凸出,膨胀; [acc] /bʌldʒ/; [or]gmat;
tenet: [x] n. 信念,原则,教条; [acc] /ˈtenɪt/; [or]gmat;
scrutinize: [x] v. 仔细检查,细看; [acc] /ˈskruːtənaɪz/; [or]gmat;
tamper: [x] v. 篡改;玩弄;贿赂;  n. 填塞者;捣棒; [acc] /ˈtæmpər/; [or]gmat;
protocol: [x] n. 外交礼节;草案;外交议定书;  vi. 拟定议定书;  vt. 把.写入议定书; [acc] /ˈproʊtəkɔːl/; [or]gmat;
curtail: [x] vt. 截短;削减;剥夺.特权; [acc] /kɜːrˈteɪl/; [or]gmat;
milieu: [x] n. 周围环境;背景;周围;出身背景; [acc] /mɪlˈjuː/; [or]gmat;
dioxide: [x] n. 二氧化物; [acc] /daɪˈɑːksaɪd/; [or]gmat;
distort: [x] v. 扭曲,使变形;歪曲,曲解; [acc] /dɪˈstɔːrt/; [or]gmat;
nomad: [x] n. 流浪者,游牧民;  adj. 游牧的;流浪的; [acc] /ˈnoʊmæd/; [or]gmat;
browse: [x] v. 浏览;随意翻阅;(牛,羊等)吃草; [acc] /braʊz/; [or]gmat;
galaxy: [x] n. 星系; [acc] /ˈɡæləksi/; [or]gmat;
migrant: [x] n. 候鸟;移民; [acc] /ˈmaɪɡrənt/; [or]gmat;
adolescent: [x] adj. 青春期的;青少年的;  n. 青少年; [acc] /ˌædəˈlesnt/; [or]gmat;
thyroid: [x] adj. ［解］甲状腺的;  n. 甲状腺; [acc] /ˈθaɪrɔɪd/; [or]gmat;
decimal: [x] n. 小数;  adj. 小数的;十进制的; [acc] /ˈdesɪml/; [or]gmat;
complementary: [x] adj. 补足的,补充的,互补的; [acc] /ˌkɑːmplɪˈmentri/; [or]gmat;
outstrip: [x] v. 比.优越,胜过,比.跑得快; [acc] /ˌaʊtˈstrɪp/; [or]gmat;
dislocation: [x] n. 转位,混乱,[医]脱臼; [acc] /ˌdɪsloʊˈkeɪʃn/; [or]gmat;
lingo: [x] n. 外国话(贬义),行话,方言,隐语; [acc] /ˈlɪŋɡoʊ/; [or]gmat;
deleterious: [x] adj. 有害的;有毒的; [acc] /ˌdeləˈtɪriəs/; [or]gmat;
crate: [x] n. 板条箱,篓;  v. 将某物装入大木箱或板条箱中; [acc] /kreɪt/; [or]gmat;
unification: [x] n. 统一,联合,一致; [acc] /ˌjuːnɪfɪˈkeɪʃn/; [or]gmat;
sewage: [x] n. (下水道)污水;污物; [acc] /ˈsuːɪdʒ/; [or]gmat;
inscribe: [x] v. 刻; [acc] /ɪnˈskraɪb/; [or]gmat;
diphtheria: [x] n. ［医］白喉［症］; [acc] /dɪfˈθɪriə/; [or]gmat;
sponsor: [x] n. 倡导者;提案人;赞助人;担保人;教父,教母;  vt. 发起;倡议;做.的保人;赞助;资助; [acc] /ˈspɑːnsər/; [or]gmat;
vertebrate: [x] adj. 有脊椎的;  n. 脊椎动物; [acc] /ˈvɜːrtɪbrət/; [or]gmat;
pseudonym: [x] n. 笔名,假名; [acc] /ˈsuːdənɪm/; [or]gmat;
quandary: [x] n. 困惑;窘境;为难; [acc] /ˈkwɑːndəri/; [or]gmat;
insomnia: [x] n. 失眠; [acc] /ɪnˈsɑːmniə/; [or]gmat;
discretionary: [x] adj. 分立的,自理自由的;任意的; [acc] /dɪˈskreʃəneri/; [or]gmat;
portrayal: [x] n. 画像,描画,描写; [acc] /pɔːrˈtreɪəl/; [or]gmat;
matrix: [x] n. [数]矩阵,模子; [acc] /ˈmeɪtrɪks/; [or]gmat;
perpetrator: [x] n. 作恶者,犯罪者,行凶者; [acc] /ˈpɜːrpətreɪtər/; [or]gmat;
idiosyncrasy: [x] n. 特殊癖性或行为; [acc] /ˌɪdiəˈsɪŋkrəsi/; [or]gmat;
stun: [x] v. 使昏迷,使发愣; [acc] /stʌn/; [or]gmat;
topple: [x] v. 摇摇欲坠,推翻,颠覆; [acc] /ˈtɑːpl/; [or]gmat;
scapegoat: [x] n. 替罪羊; [acc] /ˈskeɪpɡoʊt/; [or]gmat;
veneer: [x] n. (镶于劣质东西上的)镶面板;掩饰;  v. 虚饰;给.镶以饰片; [acc] /vəˈnɪr/; [or]gmat;
delineate: [x] v. 描画;画出..轮廓; [acc] /dɪˈlɪnieɪt/; [or]gmat;
consensus: [x] n. 一致同意,合意; [acc] /kənˈsensəs/; [or]gmat;
contentious: [x] adj. 好辩的,爱争论的; [acc] /kənˈtenʃəs/; [or]gmat;
linguist: [x] n. 语言学家;会多国语言的人; [acc] /ˈlɪŋɡwɪst/; [or]gmat;
underlie: [x] v. 位于..之下;成为..的基础; [acc] /ˌʌndərˈlaɪ/; [or]gmat;
morphine: [x] n. 吗啡; [acc] /ˈmɔːrfiːn/; [or]gmat;
transplant: [x] n. 移种;移植;  v. 移植(器官),使移居,移种(植物等); [acc] /trænsˈplænt/; [or]gmat;
granular: [x] adj. 粒状的,含颗粒的; [acc] /ˈɡrænjələr/; [or]gmat;
bugbear: [x] n. 使人恐惧的东西,妖怪; [acc] /ˈbʌɡber/; [or]gmat;
lush: [x] adj. 草木茂盛的,多的,丰富豪华的;  n. 酒;醉汉; [acc] /lʌʃ/; [or]gmat;
steppe: [x] n. (尤指东南欧或西伯利地区)无树林的大平原; [acc] /step/; [or]gmat;
portend: [x] v. 预兆,预示; [acc] /pɔːrˈtend/; [or]gmat;
fluctuation: [x] n. 波动;起伏; [acc] /ˌflʌktʃuˈeɪʃn/; [or]gmat;
simulate: [x] v. 假装;模仿;模拟; [acc] /ˈsɪmjuleɪt/; [or]gmat;
abolitionist: [x] n. 废奴主义者; [acc] /ˌæbəˈlɪʃənɪst/; [or]gmat;
sedan: [x] n. 轿子,轿车,单舱汽艇; [acc] /sɪˈdæn/; [or]gmat;
slot: [x] n. 狭缝,狭槽,(机构的)职位;  v. 把.放入狭长开口中,把.纳入; [acc] /slɑːt/; [or]gmat;
altruism: [x] n. 利他主义,不自私; [acc] /ˈæltruɪzəm/; [or]gmat;
samurai: [x] n. (日本)武士阶层,陆军军官,军阀; [acc] /ˈsæmuraɪ/; [or]gmat;
disavow: [x] v. 不承认,抵赖,拒绝对..承担责任; [acc] /ˌdɪsəˈvaʊ/; [or]gmat;
eschew: [x] v. 避开;戒绝; [acc] /ɪsˈtʃuː/; [or]gmat;
engrave: [x] v. 雕刻;铭记; [acc] /ɪnˈɡreɪv/; [or]gmat;
manipulate: [x] v. 操纵,影响;正骨; [acc] /məˈnɪpjuleɪt/; [or]gmat;
vegetarian: [x] n. 吃素的人;  adj. 素食的; [acc] /ˌvedʒəˈteriən/; [or]gmat;
quadrant: [x] n. 象限,四分之一圆; [acc] /ˈkwɑːdrənt/; [or]gmat;
reiterate: [x] vt. 反复讲,重申,反复做; [acc] /riˈɪtəreɪt/; [or]gmat;
cuisine: [x] n. 烹饪;菜肴; [acc] /kwɪˈziːn/; [or]gmat;
amass: [x] vi. 聚集;  vt. 收集;积累,积聚; [acc] /əˈmæs/; [or]gmat;
recast: [x] v. 重建; [acc] /ˌriːˈkæst/; [or]gmat;
arbitrator: [x] n. 公断人; [acc] /ˈɑːrbɪtreɪtər/; [or]gmat;
obituary: [x] n. 讣告;  adj. 关于死者的,讣告的; [acc] /oʊˈbɪtʃueri/; [or]gmat;
mutation: [x] n. 变化,突变;变异; [acc] /mjuːˈteɪʃn/; [or]gmat;
ion: [x] n. ［物］离子; [acc] /ˈaɪən/; [or]gmat;
landlocked: [x] adj. 被陆地包围的,地处内陆的; [acc] /ˈlændlɑːkt/; [or]gmat;
specter: [x] n. 鬼魂,幽灵,恐惧; [acc] /'spektə/; [or]gmat;
modem: [x] n. 调制解调器;  v. [计]通过调制解调器向.发送电子邮件;用调制解调器联通; [acc] /ˈmoʊdem/; [or]gmat;
malleable: [x] adj. (金属)可锻的;有延展性的;(性格)可训练的;易适应的; [acc] /ˈmæliəbl/; [or]gmat;
stipulate: [x] v. 规定;保证;保证;要求以.为条件; [acc] /ˈstɪpjuleɪt/; [or]gmat;
differentiate: [x] v. 使有差异;区别; [acc] /ˌdɪfəˈrenʃieɪt/; [or]gmat;
emission: [x] n. 排放物;放射物; [acc] /iˈmɪʃn/; [or]gmat;
induce: [x] v. 引导,劝诱,诱导; [acc] /ɪnˈduːs/; [or]gmat;
kidnap: [x] v. 诱拐;绑架; [acc] /ˈkɪdnæp/; [or]gmat;
primate: [x] n. 首领,大主教,灵长类的动物; [acc] /'praɪmeɪt/; [or]gmat;
overlap: [x] n. 重叠,重复;  v. (部分地)重叠; [acc] /ˌoʊvərˈlæp/; [or]gmat;
terra-cotta: [x] n. 赤土,赤陶,一种带褐色的柑子; [acc] /ˌterəˈkɑtə/; [or]gmat;
radial: [x] adj. 光线的,放射状的,半径的;  n. 光线,射线; [acc] /ˈreɪdiəl/; [or]gmat;
beatific: [x] adj. 祝福的,有福的; [acc] /ˌbiːəˈtɪfɪk/; [or]gmat;
vendor: [x] n. 小贩,卖主,供应商; [acc] /ˈvendər/; [or]gmat;
oust: [x] v. 罢免,驱逐,剥夺,取代; [acc] /aʊst/; [or]gmat;
audit: [x] v. 审计,查账;旁听;  n. 审计;查帐; [acc] /ˈɔːdɪt/; [or]gmat;
deduct: [x] v. 减去; [acc] /dɪˈdʌkt/; [or]gmat;
olfactory: [x] adj. 嗅觉的; [acc] /ɑːlˈfæktəri/; [or]gmat;
folklore: [x] n. 民俗学,民间传说;民间看法;民俗; [acc] /ˈfoʊklɔːr/; [or]gmat;
hike: [x] n. 远足,徒步旅行;(数量,价格等)增加,上升;  v. 作长途徒步旅行;使高涨,提高(价格); [acc] /haɪk/; [or]gmat;
vascular: [x] adj. 血管的,脉管的; [acc] /ˈvæskjələr/; [or]gmat;
rubble: [x] n. 碎石,瓦砾; [acc] /ˈrʌbl/; [or]gmat;
entree: [x] n. 进入,入场权,［美］主菜,(歌剧等)开始的乐章; [acc] /ˈɑːntreɪ/; [or]gmat;
alto: [x] n. 女低音,男声最高音,中音乐器;  adj. 中音部的; [acc] /ˈæltoʊ/; [or]gmat;
concerto: [x] n. [音乐]协奏曲; [acc] /kənˈtʃɜːrtoʊ/; [or]gmat;
terrorism: [x] n. 恐怖主义; [acc] /ˈterərɪzəm/; [or]gmat;
recession: [x] n. (经济)衰退,不景气;后退,撤回;凹处; [acc] /rɪˈseʃn/; [or]gmat;
autonomous: [x] adj. 自动驾驶的;自治的,独立自主的;自主的; [acc] /ɔːˈtɑːnəməs/; [or]gmat;
mileage: [x] n. 英里数; [acc] /ˈmaɪlɪdʒ/; [or]gmat;
stellar: [x] adj. 星的,星球的,主要的; [acc] /ˈstelər/; [or]gmat;
probate: [x] n. 遗嘱检验;  v. 遗嘱认证;  adj. [法] 遗嘱认证的; [acc] /ˈproʊbeɪt/; [or]gmat;
exemplify: [x] v. 举例说明;例示,是..的典范; [acc] /ɪɡˈzemplɪfaɪ/; [or]gmat;
dietary: [x] adj. 饮食的,与饮食有关的; [acc] /ˈdaɪəteri/; [or]gmat;
cartel: [x] n. 卡特尔;企业联合;垄断联盟;俘虏交换条约; [acc] /kɑːrˈtel/; [or]gmat;
repertory: [x] n. 储备;仓库;全部剧目; [acc] /ˈrepərtɔːri/; [or]gmat;
pelvis: [x] n. 骨盆; [acc] /ˈpelvɪs/; [or]gmat;
seance: [x] n. ［法］集会,会议,降神会; [acc] /ˈseɪɑːns/; [or]gmat;
offshoot: [x] n. 分支,支流,衍生物; [acc] /ˈɔːfʃuːt/; [or]gmat;
ignition: [x] n. 点火,着火;点火开关; [acc] /ɪɡˈnɪʃn/; [or]gmat;
scurry: [x] v. 快速疾走,急跑,急躁不安地来回走动;  n. 快步急跑;疾走;仓皇奔跑声;骤雨; [acc] /ˈskɜːri/; [or]gmat;
hyperbole: [x] n. 夸张的语句;夸张法; [acc] /haɪˈpɜːrbəli/; [or]gmat;
buffer: [x] n. 缓冲,缓冲区;  v. 缓冲; [acc] /ˈbʌfər/; [or]gmat;
beehive: [x] n. 蜂箱; [acc] /ˈbiːhaɪv/; [or]gmat;
coalesce: [x] v. 联合,合并,结合; [acc] /ˌkoʊəˈles/; [or]gmat;
engulf: [x] v. 吞噬,吞没,狼吞虎咽; [acc] /ɪnˈɡʌlf/; [or]gmat;
median: [x] n. 中值,中位数;中线;  adj. 中值的;中央的; [acc] /ˈmiːdiən/; [or]gmat;
aquarium: [x] n. 水族馆,水族箱,鱼缸; [acc] /əˈkweriəm/; [or]gmat;
cryptic: [x] adj. 秘密的,含义模糊的,神秘的,隐藏的; [acc] /ˈkrɪptɪk/; [or]gmat;
grill: [x] n. 烤架;  v. 烤;拷问; [acc] /ɡrɪl/; [or]gmat;
parallelogram: [x] n. 平行四边形; [acc] /ˌpærəˈleləɡræm/; [or]gmat;
plummet: [x] v. 垂直或突然地堕下,骤然下降;  n. 测锤(钓丝的)坠子;线锤;铅锤线;锤规; [acc] /ˈplʌmɪt/; [or]gmat;
teem: [x] vi. 充满;大量存在于;  vt. 生下; [acc] /tiːm/; [or]gmat;
deteriorate: [x] v. 恶化;变质;衰退; [acc] /dɪˈtɪriəreɪt/; [or]gmat;
cocaine: [x] n. 可卡因,古柯碱; [acc] /koʊˈkeɪn/; [or]gmat;
dynamics: [x] n. 动力学;力学; [acc] /daɪ'næmɪks/; [or]gmat;
pervasive: [x] adj. 深入人心的,普遍的; [acc] /pərˈveɪsɪv/; [or]gmat;
increment: [x] n. 增长;增值; [acc] /ˈɪŋkrəmənt/; [or]gmat;
segregation: [x] n. 分离,隔离,种族隔离; [acc] /ˌseɡrɪˈɡeɪʃn/; [or]gmat;
cardiac: [x] adj. 心脏的,心脏病的;  n. 心脏病患者;强心剂;健胃剂; [acc] /ˈkɑːrdiæk/; [or]gmat;
prohibitive: [x] adj. 禁止性的,阻止的;(费用,价格等)过高的;类同禁止的; [acc] /prəˈhɪbətɪv/; [or]gmat;
islamic: [x] adj. 伊斯兰教的,穆斯林的; [acc] /ɪzˈlæmɪk/; [or]gmat;
bucolic: [x] adj. 乡村的;牧羊的; [acc] /bjuːˈkɑːlɪk/; [or]gmat;
metric: [x] adj. 米制的,公制的;  n. 度量标准;[数学]度量;诗体,韵文,诗韵; [acc] /ˈmetrɪk/; [or]gmat;
boycott: [x] vt. 抵制;  n. 抵制; [acc] /ˈbɔɪkɑːt/; [or]gmat;
aftermath: [x] n. 不幸事件之后果,余波; [acc] /ˈæftərmæθ/; [or]gmat;
sophomore: [x] n. 大二年级学生;  adj. 二年级的;二年级学生的; [acc] /ˈsɑːfəmɔːr/; [or]gmat;
quiz: [x] n. 问答比赛,智力竞赛;小测验,小考;  v. 考查,盘问; [acc] /kwɪz/; [or]gmat;
mannerism: [x] n. (说话,举止等的)习气,癖性,矫揉造作; [acc] /ˈmænərɪzəm/; [or]gmat;
rinse: [x] v. (用清水)刷,冲洗掉,漂净,漱口;  n. 嗽洗,漂洗,漂清,冲洗; [acc] /rɪns/; [or]gmat;
hockey: [x] n. 曲棍球; [acc] /ˈhɑːki/; [or]gmat;
whisker: [x] n. 胡须;腮须; [acc] /ˈwɪskər/; [or]gmat;
chameleon: [x] n. 蜥蜴;变色龙;善变的人; [acc] /kəˈmiːliən/; [or]gmat;
hegemony: [x] n. 霸权,领导权; [acc] /hɪˈdʒemoʊni/; [or]gmat;
verisimilitude: [x] n. 逼真,真实性; [acc] /ˌverɪsɪˈmɪlɪtuːd/; [or]gmat;
criteria: [x] n. 标准,条件; [acc] /kraɪ'tɪəriə/; [or]gmat;
hydrocarbon: [x] n. 碳氢化合物,烃; [acc] /ˌhaɪdrəˈkɑːrbən/; [or]gmat;
skeptic: [x] n. 怀疑论者;怀疑者;无神论者; [acc] /ˈskeptɪk/; [or]gmat;
magnesium: [x] n. 镁; [acc] /mæɡˈniːziəm/; [or]gmat;
crass: [x] adj. 粗鲁的,粗俗的,愚钝的; [acc] /kræs/; [or]gmat;
geometric: [x] adj. 几何学的,几何图形的; [acc] /ˌdʒiːəˈmetrɪk/; [or]gmat;
ozone: [x] n. 臭氧;(口语)新鲜空气;能使人兴奋的力量; [acc] /ˈoʊzoʊn/; [or]gmat;
pharmacy: [x] n. 药房,药剂学,配药业,制药业,一批备用药品; [acc] /ˈfɑːrməsi/; [or]gmat;
qualitative: [x] adj. (性)质的,定性的; [acc] /ˈkwɑːləteɪtɪv/; [or]gmat;
promulgate: [x] v. 公布;传播;发表; [acc] /ˈprɑːmlɡeɪt/; [or]gmat;
impoverish: [x] v. 使成赤贫,使枯竭; [acc] /ɪmˈpɑːvərɪʃ/; [or]gmat;
periphery: [x] n. 外围,不重要的部份; [acc] /pəˈrɪfəri/; [or]gmat;
enroll: [x] v. 入学,加入,登记,入伍; [acc] /ɪnˈroʊl/; [or]gmat;
extrinsic: [x] adj. 外在的,外部的; [acc] /eksˈtrɪnzɪk/; [or]gmat;
referendum: [x] n. 公民投票,复决权; [acc] /ˌrefəˈrendəm/; [or]gmat;
laudatory: [x] adj. 表扬的,赞扬的; [acc] /ˈlɔːdətɔːri/; [or]gmat;
genetic: [x] adj. 遗传的,起源的; [acc] /dʒəˈnetɪk/; [or]gmat;
repertoire: [x] n. (剧团,演员等的)全部节目;全部才能; [acc] /ˈrepərtwɑːr/; [or]gmat;
excerpt: [x] n. 摘录,节选;  v. 摘,选;引用; [acc] /ˈeksɜːrpt/; [or]gmat;
rectangle: [x] n. 长方形,矩形; [acc] /ˈrektæŋɡl/; [or]gmat;
kelp: [x] n. 海草,巨藻;海草灰(从中可提取碘); [acc] /kelp/; [or]gmat;
reimburse: [x] v. 偿还;赔偿;退还(钱),付还; [acc] /ˌriːɪmˈbɜːrs/; [or]gmat;
rotate: [x] v. 以..轴转动,使旋转,使..轮流;轮换; [acc] /ˈroʊteɪt/; [or]gmat;
culminate: [x] v. 使达高潮,使结束; [acc] /ˈkʌlmɪneɪt/; [or]gmat;
apportion: [x] v. 分配; [acc] /əˈpɔːrʃn/; [or]gmat;
internecine: [x] adj. 互相残杀的,两败俱伤的,内部冲突的; [acc] /ˌɪntərˈniːsaɪn/; [or]gmat;
disseminate: [x] v. 宣传,传播;散布; [acc] /dɪˈsemɪneɪt/; [or]gmat;
delve: [x] v. 钻研;探究;挖;  n. 穴;洞; [acc] /delv/; [or]gmat;
scenario: [x] n. 剧情梗概;情况,情节;设想; [acc] /səˈnærioʊ/; [or]gmat;
invigorate: [x] v. 鼓舞;提神,使精力充沛;  adj. 生气勃勃的,精力充沛的,健壮的;  n. 滋补;鼓舞; [acc] /ɪnˈvɪɡəreɪt/; [or]gmat;
grandiloquent: [x] adj. (语言等)夸张的,夸大的; [acc] /ɡrænˈdɪləkwənt/; [or]gmat;
ignite: [x] v. 点燃,发光,燃烧; [acc] /ɪɡˈnaɪt/; [or]gmat;
aspersion: [x] n. 诽谤,中伤; [acc] /ə'spɜːʒən/; [or]gmat;
boost: [x] v. 增加;偷盗;  n. 提高;激励;后推;助推发动机; [acc] /buːst/; [or]gmat;
inconsequential: [x] adj. 不重要的,不合理的,不合逻辑的; [acc] /ɪnˌkɑːnsɪˈkwenʃl/; [or]gmat;
uranium: [x] n. 铀; [acc] /juˈreɪniəm/; [or]gmat;
connive: [x] v. 默许,共谋; [acc] /kəˈnaɪv/; [or]gmat;
amenity: [x] n. 适意;舒适;便利设施;舒适,愉快;礼仪; [acc] /əˈmenəti/; [or]gmat;
cognitive: [x] adj. 认识能力的;认知的; [acc] /ˈkɑːɡnətɪv/; [or]gmat;
unwitting: [x] adj. 不知情的;无意的; [acc] /ʌnˈwɪtɪŋ/; [or]gmat;
coordinate: [x] v. 使协调,使一致,调整;  n. 坐标,同等的人物,配套服装;  adj. 并列的;同等的; [acc] /koʊˈɔːrdɪneɪt/; [or]gmat;
outnumber: [x] v. 在数量上超过; [acc] /ˌaʊtˈnʌmbər/; [or]gmat;
nadir: [x] n. 最低点,无底; [acc] /ˈneɪdɪr/; [or]gmat;
maim: [x] v. 使残废; [acc] /meɪm/; [or]gmat;
clarify: [x] v. 阐明,澄清;净化; [acc] /ˈklærəfaɪ/; [or]gmat;
rekindle: [x] v. 重新点燃,使再振作精神; [acc] /ˌriːˈkɪndl/; [or]gmat;
estrange: [x] v. 使疏远,离间; [acc] /ɪ'streɪndʒ/; [or]gmat;
juror: [x] n. 审查委员,陪审员; [acc] /ˈdʒʊrər/; [or]gmat;
toxic: [x] n. 毒物;  adj. 有毒的;中毒的; [acc] /ˈtɑːksɪk/; [or]gmat;
endemic: [x] adj. 地方性的;  n. 地方病; [acc] /enˈdemɪk/; [or]gmat;
integrated: [x] adj. 综合的,完整的,互相协调的; [acc] /ˈɪntɪɡreɪtɪd/; [or]gmat;
gravitate: [x] v. 受引力作用;被吸引; [acc] /ˈɡrævɪteɪt/; [or]gmat;
slump: [x] v. 突然倒下;暴跌;  n. 下降;经济萧条时期; [acc] /slʌmp/; [or]gmat;
cater: [x] v. 供应伙食;为(集会,婚礼等)承办酒席; [acc] /ˈkeɪtər/; [or]gmat;
relativity: [x] n. 相关性;相对性; [acc] /ˌreləˈtɪvəti/; [or]gmat;
unearth: [x] vt. 发掘,掘出,揭露,发现;揭发; [acc] /ʌnˈɜːrθ/; [or]gmat;
permeate: [x] v. 弥漫;普及;渗透; [acc] /ˈpɜːrmieɪt/; [or]gmat;
lethal: [x] adj. 致命的,致死的;杀伤性的;  n. 致死因子; [acc] /ˈliːθl/; [or]gmat;
gel: [x] n. ［物］［化］凝胶(体),冻胶;  v. 胶化; [acc] /dʒel/; [or]gmat;
char: [x] n. 炭,木炭,［常用复］家庭杂物;  v. (把..)烧成炭,烧焦; [acc] /tʃɑːr/; [or]gmat;
seminal: [x] adj. 重要的,精液的,种子的; [acc] /ˈsemɪnl/; [or]gmat;
parallax: [x] n. ［物］［天］视差,［天］周年(日)视差; [acc] /ˈpærəlæks/; [or]gmat;
proctor: [x] n. 代理人,学监;  vt. 监督; [acc] /ˈprɑːktər/; [or]gmat;
asteroid: [x] n. 小行星;  adj. 星状的; [acc] /ˈæstərɔɪd/; [or]gmat;
actuate: [x] v. 开动(机器);激励,驱使; [acc] /ˈæktʃueɪt/; [or]gmat;
obese: [x] adj. 肥胖的;过胖的; [acc] /oʊˈbiːs/; [or]gmat;
subtract: [x] v. 减少;减去;扣除;  vt. 减去; [acc] /səbˈtrækt/; [or]gmat;
archaeologist: [x] n. 考古学家; [acc] /ˌɑːrkiˈɑːlədʒɪst/; [or]gmat;
pinto: [x] n. 杂色马,斑豆;  adj. 杂色的; [acc] /ˈpɪntoʊ/; [or]gmat;
placate: [x] vt. 安抚,抚慰; [acc] /ˈpleɪkeɪt/; [or]gmat;
amplify: [x] v. 放大(声音等);扩大;增强;详述;进一步阐述; [acc] /ˈæmplɪfaɪ/; [or]gmat;
sanitarium: [x] n. 疗养院,休养地; [acc] /ˌsænəˈteriəm/; [or]gmat;
preeminent: [x] adj. 卓越的,超群的;  adv. 卓越地,杰出地; [acc] /priˈemɪnənt/; [or]gmat;
terrain: [x] n. 地面,地形; [acc] /təˈreɪn/; [or]gmat;
overlay: [x] n. 覆盖图;覆盖物;  vt. 在表面上铺一薄层,镀; [acc] /ˌoʊvərˈleɪ/; [or]gmat;
shareholder: [x] n. 股东,股票持有者; [acc] /ˈʃerhoʊldər/; [or]gmat;
jeopardize: [x] v. 危及,损害(也作jeopardise); [acc] /ˈdʒepərdaɪz/; [or]gmat;
obsidian: [x] n. 黑曜石; [acc] /əbˈsɪdiən/; [or]gmat;
microbe: [x] n. 微生物;细菌; [acc] /ˈmaɪkroʊb/; [or]gmat;
contaminate: [x] v. 弄脏,污染; [acc] /kənˈtæmɪneɪt/; [or]gmat;
whirligig: [x] n. 旋转玩具,循环变迁; [acc] /ˈwɜːrliɡɪɡ/; [or]gmat;
irritant: [x] adj. 刺激的,刺激性的;  n. [医]刺激物,刺激剂; [acc] /ˈɪrɪtənt/; [or]gmat;
obesity: [x] n. 肥胖; [acc] /oʊˈbiːsəti/; [or]gmat;
inflate: [x] v. 充气,膨胀,扩大; [acc] /ɪnˈfleɪt/; [or]gmat;
raccoon: [x] n. 浣熊;浣熊毛皮; [acc] /ræˈkuːn/; [or]gmat;
embalm: [x] v. 以香油(或药料)涂,防腐,使不朽; [acc] /ɪmˈbɑːm/; [or]gmat;
sketchy: [x] adj. 概略的,粗略的; [acc] /ˈsketʃi/; [or]gmat;
gradient: [x] n. 斜坡;倾斜度;坡度;渐变;  adj. 倾斜的;渐倾的; [acc] /ˈɡreɪdiənt/; [or]gmat;
mandatory: [x] adj. 命令的,强制性的; [acc] /ˈmændətɔːri/; [or]gmat;
rescind: [x] v. 废除;取消;撤回; [acc] /rɪˈsɪnd/; [or]gmat;
crumple: [x] v. 把.揉作一团,弄皱;压碎; [acc] /ˈkrʌmpl/; [or]gmat;
fjord: [x] n. 峡湾(尤指挪威海岸边的); [acc] /ˈfjɔːrd/; [or]gmat;
brokerage: [x] n. 中间人业务,经济业;付给经纪人的经手费,佣金,回扣; [acc] /ˈbroʊkərɪdʒ/; [or]gmat;
coupon: [x] n. (债券等)息券;赠券;配给券;折扣券; [acc] /ˈkuːpɑːn/; [or]gmat;
turnover: [x] n. 成交量;营业收入;人员更替率;半圆卷饼; [acc] /ˈtɜːrnoʊvər/; [or]gmat;
rodent: [x] n. 啮齿类动物(如鼠等); [acc] /ˈroʊdnt/; [or]gmat;
circumscribe: [x] v. 限制;在.周围画线;[数]使外接,使外切; [acc] /ˈsɜːrkəmskraɪb/; [or]gmat;
rabies: [x] n. (单复同型)狂犬病; [acc] /ˈreɪbiːz/; [or]gmat;
orientation: [x] n. 信仰;倾向;[计]定向;(学生)迎新会;定向,方向;(任职,上学等之前的) 情况介绍;训练; [acc] /ˌɔːriənˈteɪʃn/; [or]gmat;
organism: [x] n. 生物,有机体;有机的组织; [acc] /ˈɔːrɡənɪzəm/; [or]gmat;
deform: [x] v. (使)变形;  adj. 畸形的;丑陋的; [acc] /dɪˈfɔːrm/; [or]gmat;
luminosity: [x] n. 光明,发光体;发光度; [acc] /ˌluːmɪˈnɑːsəti/; [or]gmat;
tactile: [x] adj. 有触觉的;能触知的; [acc] /ˈtæktl/; [or]gmat;
thermal: [x] adj. 保暖的;温泉的;热的;  n. 保暖内衣裤; [acc] /ˈθɜːrml/; [or]gmat;
inept: [x] adj. 无能的;不称职的;笨拙的; [acc] /ɪˈnept/; [or]gmat;
somatic: [x] adj. 肉体的; [acc] /soʊ'mætɪk/; [or]gmat;
stereotype: [x] n. 老套的模式,陈规,成见;  v. 对..产生成见; [acc] /ˈsteriətaɪp/; [or]gmat;
masculinity: [x] n. 男性(气概); [acc] /ˌmæskjuˈlɪnəti/; [or]gmat;
kinetic: [x] adj. 运动的; [acc] /kɪˈnetɪk/; [or]gmat;
implant: [x] v. 嵌入,注入,灌输;  n. [医]植入物,植入管; [acc] /ɪmˈplænt/; [or]gmat;
fleck: [x] n. 斑点,斑纹;雀斑;微粒,小片;  v. 使起斑点;使有斑纹; [acc] /flek/; [or]gmat;
instigate: [x] v. 发起,煽动; [acc] /ˈɪnstɪɡeɪt/; [or]gmat;
agenda: [x] n. 议事日程; [acc] /əˈdʒendə/; [or]gmat;
foreclose: [x] v. 排除,取消抵押品的赎回权; [acc] /fɔːrˈkloʊz/; [or]gmat;
saturate: [x] v. 使充满,使饱和,使湿透; [acc] /ˈsætʃəreɪt/; [or]gmat;
deflect: [x] v. (使)偏斜,(使)偏转; [acc] /dɪˈflekt/; [or]gmat;
elongation: [x] n. 伸长,伸长率,延伸率; [acc] /ˌiːlɔːŋˈɡeɪʃn/; [or]gmat;
hinterland: [x] n. 内地;腹地;穷乡僻壤;远离城镇的地方; [acc] /ˈhɪntərlænd/; [or]gmat;
viola: [x] n. 中提琴; [acc] /viˈoʊlə/; [or]gmat;
devastate: [x] v. 摧毁;使垮掉,使不知所措,使陷于混乱; [acc] /ˈdevəsteɪt/; [or]gmat;
accretion: [x] n. 自然的增加,增加物; [acc] /əˈkriːʃn/; [or]gmat;
rendition: [x] n. 表演,演奏;译文;给予,提供; [acc] /renˈdɪʃn/; [or]gmat;
nostalgia: [x] n. 怀旧之情,思乡病; [acc] /nəˈstældʒə/; [or]gmat;
pituitary: [x] adj. ［解］脑垂体的,粘液的;  n. 垂体,脑垂体; [acc] /pɪˈtuːəteri/; [or]gmat;
tamarind: [x] n. ［植］罗望子树,罗望子果(味酸,常做清凉轻泻剂用); [acc] /ˈtæmərɪnd/; [or]gmat;
indices: [x] n. 目录,指数; [acc] /ˈɪndɪsiːz/; [or]gmat;
cosmetic: [x] n. 化妆品;  adj. 化妆用的,美容的;装门面的 [表不满]; [acc] /kɑːzˈmetɪk/; [or]gmat;
dissenter: [x] n. 持异议者;反对者; [acc] /dɪˈsentər/; [or]gmat;
foreshadow: [x] v. 预示;  n. 预兆; [acc] /fɔːrˈʃædoʊ/; [or]gmat;
Hispanic: [x] adj. 拉丁美洲的;西班牙人的;西班牙的;  n. 讲西班牙语的人;拉美裔美国人; [acc] /hɪˈspænɪk/; [or]gmat;
meander: [x] n. 蜿蜒曲折,迂回曲折的旅程;漫步;  v. 迂回曲折;漫步;漫谈; [acc] /miˈændər/; [or]gmat;
hone: [x] n. 细磨刀石;  v. 磨刀; [acc] /hoʊn/; [or]gmat;
graphite: [x] n. 石墨; [acc] /ˈɡræfaɪt/; [or]gmat;
caveat: [x] n. 警告;防止误解的说明; [acc] /ˈkæviæt/; [or]gmat;
rationale: [x] n. 基本原理;原理的阐述; [acc] /ˌræʃəˈnæl/; [or]gmat;
corrosion: [x] n. 侵蚀,腐蚀状态; [acc] /kəˈroʊʒn/; [or]gmat;
supplicant: [x] n. 乞求者,恳求者; [acc] /ˈsʌplɪkənt/; [or]gmat;
dismember: [x] v. 肢解;瓜分; [acc] /dɪsˈmembər/; [or]gmat;
vintner: [x] n. 葡萄酒商; [acc] /ˈvɪntnər/; [or]gmat;
narcissistic: [x] adj. 自我陶醉的,自恋的; [acc] /ˌnɑːrsɪˈsɪstɪk/; [or]gmat;
therapy: [x] n. 治疗,理疗;疗法; [acc] /ˈθerəpi/; [or]gmat;
cornerstone: [x] n. 奠基石;基础; [acc] /ˈkɔːrnərstoʊn/; [or]gmat;
pentagon: [x] n. 五边形; [acc] /ˈpentəɡɑːn/; [or]gmat;
mainstream: [x] n. 主流,主要倾向;  v. 使.成为主流;将(残障儿童等)纳入正规班级;  adj. 主流的; [acc] /ˈmeɪnstriːm/; [or]gmat;
problematic: [x] adj. 问题的;有疑问的;不确定的; [acc] /ˌprɑːbləˈmætɪk/; [or]gmat;
pelvic: [x] adj. ［解］骨盆的;  n. 骨盆部; [acc] /ˈpelvɪk/; [or]gmat;
collide: [x] vi. 碰撞;互撞;抵触; [acc] /kəˈlaɪd/; [or]gmat;
carbohydrate: [x] n. [化]碳水化合物;淀粉质食物; [acc] /ˌkɑːrboʊˈhaɪdreɪt/; [or]gmat;
fanfare: [x] n. 夸耀,嘹亮的喇叭声;  v. 热闹地介绍[宣布]; [acc] /ˈfænfer/; [or]gmat;
invertebrate: [x] adj. 无脊椎的(动物);没骨气的,懦弱的;  n. 无脊椎动物;没骨气的人; [acc] /ɪnˈvɜːrtɪbrət/; [or]gmat;
conceptual: [x] adj. 概念的; [acc] /kənˈseptʃuəl/; [or]gmat;
algae: [x] n. 藻类; [acc] /ˈældʒiː/; [or]gmat;
brochure: [x] n. 手册,小册子; [acc] /broʊˈʃʊr/; [or]gmat;
prerequisite: [x] n. 先决条件,必要条件;  adj. 必须先具备的,必要的; [acc] /ˌpriːˈrekwəzɪt/; [or]gmat;
lexicographer: [x] n. 词典编纂人; [acc] /ˌleksɪˈkɑːɡrəfər/; [or]gmat;
bipartisan: [x] adj. 由两党成员组成的;被两党支持的; [acc] /ˌbaɪˈpɑːrtɪzn/; [or]gmat;
radioactive: [x] adj. 放射性的; [acc] /ˌreɪdioʊˈæktɪv/; [or]gmat;
spatial: [x] adj. 空间的,关于空间的; [acc] /ˈspeɪʃl/; [or]gmat;
specialize: [x] v. 专门研究,专门从事; [acc] /ˈspeʃəlaɪz/; [or]gmat;
input: [x] n. 投入;[电学,计算机]输入;  vt. 输入; [acc] /ˈɪnpʊt/; [or]gmat;
culpability: [x] n. 有罪,该受谴责; [acc] /ˌkʌlpəˈbɪləti/; [or]gmat;
condor: [x] n. [动物]神鹰;秃鹫; [acc] /ˈkɑːndɔːr/; [or]gmat;
arthritis: [x] n. [外科]关节炎; [acc] /ɑːrˈθraɪtɪs/; [or]gmat;
leeway: [x] n. ［海］［空］风压差;余地; [acc] /ˈliːweɪ/; [or]gmat;
clientele: [x] n. 顾客,常客; [acc] /ˌklaɪənˈtel/; [or]gmat;
jawbone: [x] v. 赊买或借贷;  n. 颚骨,牙床骨;  adv. 〈美俚〉凭信用地; [acc] /ˈdʒɔːboʊn/; [or]gmat;
bloc: [x] n. 集团; [acc] /blɑːk/; [or]gmat;
inhibit: [x] v. 阻碍;阻止,防止;抑制,约束; [acc] /ɪnˈhɪbɪt/; [or]gmat;
distill: [x] v. 抽出..的精华;蒸馏; [acc] /dɪˈstɪl/; [or]gmat;
diabetes: [x] n. 糖尿病,多尿症; [acc] /ˌdaɪəˈbiːtiːz/; [or]gmat;
inoculate: [x] v. [医]给..接种,给..注射预防针,[植]嫁接,灌输; [acc] /ɪˈnɑːkjuleɪt/; [or]gmat;
vaccine: [x] n. 牛痘苗,疫苗;  adj. 牛痘的;预防疫苗的;种痘的; [acc] /vækˈsiːn/; [or]gmat;
dismantle: [x] v. 拆开;拆除; [acc] /dɪsˈmæntl/; [or]gmat;
impasse: [x] n. 僵局;死路; [acc] /ˈɪmpæs/; [or]gmat;
Baroque: [x] adj. 巴洛克式的,结构复杂的,形式怪样的;  n. 巴洛克风格,巴洛克艺术; [acc] /bəˈroʊk/; [or]gmat;
fledgling: [x] n. 刚学飞的幼鸟,无经验的人;  adj. 刚开始的;无经验的; [acc] /ˈfledʒlɪŋ/; [or]gmat;
Pleistocene: [x] n. 更新世,更新世岩; [acc] /'plaistəusi:n/; [or]gmat;
filibuster: [x] n. 冗长演说;  v. 拖延议事; [acc] /ˈfɪlɪbʌstər/; [or]gmat;
irreversible: [x] adj. 不能翻转的;不可撤销的;不可逆的; [acc] /ˌɪrɪˈvɜːrsəbl/; [or]gmat;
stultify: [x] v. 使显得愚蠢,愚弄,使无效,使无价值; [acc] /ˈstʌltɪfaɪ/; [or]gmat;
ragtime: [x] n. 拉格泰姆音乐;  adj. 滑稽的;不严肃的; [acc] /ˈræɡtaɪm/; [or]gmat;
salable: [x] adj. 可出售的,畅销的,有销路的; [acc] /'seɪləbəl/; [or]gmat;
recoup: [x] v. 收回;恢复;偿还;扣除;  n. 获得补偿; [acc] /rɪˈkuːp/; [or]gmat;
solvency: [x] n. 偿付能力;溶解力; [acc] /ˈsɑːlvənsi/; [or]gmat;
inadvertent: [x] adj. 疏忽的,漫不经心的,无意中的; [acc] /ˌɪnədˈvɜːrtənt/; [or]gmat;
oats: [x] n. 燕麦,燕麦片,燕麦粥; [acc] /oʊts/; [or]gmat;
diagnose: [x] v. 诊断(疾病),对(病人)下诊断结论; [acc] /ˌdaɪəɡˈnoʊs/; [or]gmat;
aeronautics: [x] n. 航空学;  adj. 航空(学)的; [acc] /ˌerəˈnɔːtɪks/; [or]gmat;
iguana: [x] n. 美洲大蜥蜴; [acc] /ɪˈɡwɑːnə/; [or]gmat;
ideology: [x] n. 意识形态,思想(体系); [acc] /ˌaɪdiˈɑːlədʒi/; [or]gmat;
reptilian: [x] adj. 爬虫类的;卑下的;  n. 两栖动物;卑劣的人; [acc] /repˈtɪliən/; [or]gmat;
coronary: [x] adj. 冠的,冠状的,花冠的;  n. 冠状动脉;(病理学)冠状动脉血栓形成; [acc] /ˈkɔːrəneri/; [or]gmat;
peddle: [x] v. 叫卖,散播; [acc] /ˈpedl/; [or]gmat;
gullible: [x] adj. 易受骗的;轻信的; [acc] /ˈɡʌləbl/; [or]gmat;
quadrilateral: [x] adj. 四边形的; [acc] /ˌkwɑːdrɪˈlætərəl/; [or]gmat;
chore: [x] n. 日常家庭杂务,日常工作;琐碎烦人的杂务; [acc] /tʃɔːr/; [or]gmat;
pliers: [x] n. 钳子; [acc] /ˈplaɪərz/; [or]gmat;
optimum: [x] adj. 最适宜的;最佳的;  n. 最适条件;最适宜; [acc] /ˈɑːptɪməm/; [or]gmat;
abduct: [x] v. 绑架,拐走; [acc] /æbˈdʌkt/; [or]gmat;
impinge: [x] v. 侵犯,撞击,碰撞; [acc] /ɪmˈpɪndʒ/; [or]gmat;
anthropologist: [x] n. 人类学家,人类学者; [acc] /ˌænθrəˈpɑːlədʒɪst/; [or]gmat;
sulfur: [x] n. 硫磺; [acc] /ˈsʌlfər/; [or]gmat;
cortex: [x] n. [解剖]皮质,树皮,果皮; [acc] /ˈkɔːrteks/; [or]gmat;
disparate: [x] adj. 迥然不同的; [acc] /ˈdɪspərət/; [or]gmat;
trajectory: [x] n. 弹道,航线;轨线; [acc] /trəˈdʒektəri/; [or]gmat;
parenthetical: [x] adj. 作为插入语的,放在括号里的,［喻］插曲的; [acc] /ˌpærənˈθetɪkl/; [or]gmat;
directive: [x] n. 指示,指令;  adj. 指导的,管理的;方向的; [acc] /dəˈrektɪv/; [or]gmat;
nexus: [x] n. 关系;连结; [acc] /ˈneksəs/; [or]gmat;
noncommittal: [x] adj. 态度不明朗的;不承担义务的;无明确意义的; [acc] /ˌnɒnkə'mɪtəl/; [or]gmat;
ferrous: [x] adj. 含铁的; [acc] /ˈferəs/; [or]gmat;
electromagnetic: [x] adj. 电磁的; [acc] /ɪˌlektroʊmæɡˈnetɪk/; [or]gmat;
varicose: [x] adj. ［医］静脉曲张的,治疗静脉曲张用的; [acc] /'værɪˌkoʊs/; [or]gmat;
gravitational: [x] adj. 重力的;万有引力的; [acc] /ˌɡrævɪˈteɪʃənl/; [or]gmat;
nicotine: [x] n. 尼古丁; [acc] /ˈnɪkətiːn/; [or]gmat;
stance: [x] n. 立场,姿态,位置; [acc] /stæns/; [or]gmat;
spate: [x] n. 洪水;一阵;大雨;突然迸发; [acc] /speɪt/; [or]gmat;
metamorphose: [x] v. 使变形,使变质; [acc] /ˌmetəˈmɔːrfoʊz/; [or]gmat;
caviar: [x] n. 鱼子酱; [acc] /ˈkæviɑːr/; [or]gmat;
incompatible: [x] adj. 不兼容的,矛盾的,不调和的; [acc] /ˌɪnkəmˈpætəbl/; [or]gmat;
domesticate: [x] vt. 使习惯于家庭生活;驯养;引进; [acc] /dəˈmestɪkeɪt/; [or]gmat;
rebut: [x] v. (律)辩驳,揭露,戳穿; [acc] /rɪˈbʌt/; [or]gmat;
commute: [x] n. 在两地之间乘车往返;  v. 经常乘车往返于两地之间;  vt. 减免; [acc] /kəˈmjuːt/; [or]gmat;
lactic: [x] adj. 乳汁的,乳的; [acc] /'læktɪk/; [or]gmat;
monochrome: [x] adj. 单色的;  n. 单色画;单色照片,黑白照片; [acc] /ˈmɑːnəkroʊm/; [or]gmat;
payroll: [x] n. 工资单; [acc] /ˈpeɪroʊl/; [or]gmat;
hormone: [x] n. 荷尔蒙,激素; [acc] /ˈhɔːrmoʊn/; [or]gmat;
gourmet: [x] n. 美食家,讲究吃喝的人;  adj. 菜肴精美的; [acc] /ˈɡʊrmeɪ/; [or]gmat;
plaque: [x] n. 饰板,匾,斑块; [acc] /plæk/; [or]gmat;
renal: [x] adj. 肾脏的; [acc] /ˈriːnl/; [or]gmat;
collaborate: [x] v. 合作; [acc] /kəˈlæbəreɪt/; [or]gmat;
osprey: [x] n. ［动］鹗,鱼鹰;白色装饰羽毛; [acc] /ˈɑːspreɪ/; [or]gmat;
polygon: [x] n. 多角形,多边形; [acc] /ˈpɑːliɡɑːn/; [or]gmat;
expertise: [x] n. 专门知识,专门技能; [acc] /ˌekspɜːrˈtiːz/; [or]gmat;
anesthesia: [x] n. 麻醉;麻木(等于anaesthesia); [acc] /ˌænəsˈθiʒə/; [or]gmat;
periwinkle: [x] n. ［植］常春花; [acc] /ˈperiwɪŋkl/; [or]gmat;
bumblebee: [x] n. (动)野蜂,大蜂; [acc] /ˈbʌmblbiː/; [or]gmat;
echelon: [x] n. 等级,阶层,梯形,梯次编队;  vi. 形成梯队;  vt. 排成梯队; [acc] /ˈeʃəlɑːn/; [or]gmat;
rampage: [x] n. 粗暴;胡闹;  v. 暴跳;暴怒;狂暴地乱冲; [acc] /ræmˈpeɪdʒ/; [or]gmat;
electron: [x] n. 电子; [acc] /ɪˈlektrɑːn/; [or]gmat;
cancerous: [x] adj. 癌的,患癌症的; [acc] /ˈkænsərəs/; [or]gmat;
adipose: [x] adj. 脂肪质的,脂肪多的;  n. 动物脂肪; [acc] /ˈædɪpoʊs/; [or]gmat;
sabotage: [x] n. 怠工,蓄意破坏,妨碍;  v. 怠工,从事破坏活动,故意阻挠; [acc] /ˈsæbətɑːʒ/; [or]gmat;
feminist: [x] n. 男女平等主义者,女权扩张论者;  adj. 主张男女平等的,女权主义的; [acc] /ˈfemənɪst/; [or]gmat;
gymnast: [x] n. 体操运动员; [acc] /ˈdʒɪmnæst/; [or]gmat;
bicker: [x] v. 斗嘴,流动,闪动;  n. 口角,流水声; [acc] /ˈbɪkər/; [or]gmat;
cobble: [x] v. 修,拙劣地修补;铺鹅卵石,用圆石铺面;  n. 鹅卵石,圆石; [acc] /ˈkɑːbl/; [or]gmat;
convoluted: [x] adj. 旋绕的,费解的; [acc] /ˈkɑːnvəluːtɪd/; [or]gmat;
irradiation: [x] n. 照射,发光,放射; [acc] /ɪˌreɪdiˈeɪʃn/; [or]gmat;
paleolithic: [x] adj. 旧石器时代的; [acc] /ˌpeɪlɪə'lɪθɪk/; [or]gmat;
diaper: [x] n. 尿布; [acc] /ˈdaɪpər/; [or]gmat;
addict: [x] n. 上瘾的人;入迷的人;  v. 使沉迷,使上瘾; [acc] /ˈædɪkt/; [or]gmat;
laser: [x] n. 激光,激光器; [acc] /ˈleɪzər/; [or]gmat;
meteorite: [x] n. 流星;陨星; [acc] /ˈmiːtiəraɪt/; [or]gmat;
anecdotal: [x] adj. 轶事的,趣闻的;多逸事趣闻的;举例说明的; [acc] /ˌænɪkˈdoʊtl/; [or]gmat;
ceramic: [x] adj. 陶器的,陶瓷的;  n. 陶瓷制品; [acc] /səˈræmɪk/; [or]gmat;
vitriolic: [x] adj. 刻薄的,强烈的,硫酸(盐)的,由硫酸制成的; [acc] /ˌvɪtriˈɑːlɪk/; [or]gmat;
sprinkler: [x] n. 洒水装置,洒水车; [acc] /ˈsprɪŋklər/; [or]gmat;
ovarian: [x] adj. ［解］卵巢的,［植］子房的; [acc] /oʊˈveriən/; [or]gmat;
detractor: [x] n. (批评者)诽谤者,恶意批评者; [acc] /dɪˈtræktər/; [or]gmat;
criminology: [x] n. 犯罪学,刑事学; [acc] /ˌkrɪmɪˈnɑːlədʒi/; [or]gmat;
enervation: [x] n. 虚弱,无力; [acc] /ˌenərˈveɪʃn/; [or]gmat;
boreal: [x] adj. 北的,北方的,北风的,北半球北部山区的; [acc] /'bɔːriːl/; [or]gmat;
nuance: [x] n. 细微差别; [acc] /ˈnuːɑːns/; [or]gmat;
pathogenic: [x] adj. 病原的,致病的,发病的; [acc] /ˌpæθəˈdʒenɪk/; [or]gmat;
antedate: [x] n. 比实际提前的日期;  vt. 在.上写上早于实际的日期;发生于.以前;使提前发生;使回到过去; [acc] /ˌæntiˈdeɪt/; [or]gmat;
timber: [x] n. 木料;树木;性格,素质;  excl. 树要倒啦!;  adj. 木材的,木制的;  v. 用木材作骨架;以林木覆盖; [acc] /ˈtɪmbər/; [or]gmat;
hefty: [x] adj. 重的,肌肉发达的,异常大的;  adv. 强有力地,非常;  n. 体格健壮的人; [acc] /ˈhefti/; [or]gmat;
decimate: [x] v. 大量杀死,十中抽一,大量毁灭; [acc] /ˈdesɪmeɪt/; [or]gmat;
fallout: [x] n. ［原］微粒回降,放射性尘埃;附带的后果;不良后果;  v. 争吵,争议; [acc] /ˈfɔːlaʊt/; [or]gmat;
helium: [x] n. [化学]氦(元素符号He); [acc] /ˈhiːliəm/; [or]gmat;
expatriate: [x] v. (使)移居国外;(使)放弃国籍;流放,放逐;  n. 被流放者;移居国外者;  adj. 移居国外的;被流放的; [acc] /ˌeksˈpeɪtriət/; [or]gmat;
absenteeism: [x] n. 旷工;旷课; [acc] /ˌæbsənˈtiːɪzəm/; [or]gmat;
pornography: [x] n. 色情描写,色情文学,色情画; [acc] /pɔːrˈnɑːɡrəfi/; [or]gmat;
bilingual: [x] adj. 使用两种语言的,用两种文字写成的; [acc] /ˌbaɪˈlɪŋɡwəl/; [or]gmat;
lobbyist: [x] n. 院外活动集团的成员,说客; [acc] /ˈlɑːbiɪst/; [or]gmat;
anesthetic: [x] n. 麻醉剂,麻药;  adj. 麻醉的,感觉缺失的; [acc] /ˌænəs'θetɪk/; [or]gmat;
perimeter: [x] n. 周长;周界; [acc] /pəˈrɪmɪtər/; [or]gmat;
plasma: [x] n. 血浆;等离子体;深绿玉髓; [acc] /ˈplæzmə/; [or]gmat;
chromosome: [x] n. 染色体; [acc] /ˈkroʊməsoʊm/; [or]gmat;
ongoing: [x] n. 进行,前进,发展;  adj. 进行中的,不间断的; [acc] /ˈɑːnɡoʊɪŋ/; [or]gmat;
neural: [x] adj. 神经的;神经系统的;背的;神经中枢的; [acc] /ˈnʊrəl/; [or]gmat;
integer: [x] n. 整数;整体; [acc] /ˈɪntɪdʒər/; [or]gmat;
gyroscope: [x] n. 陀螺仪,回转仪; [acc] /ˈdʒaɪrəskoʊp/; [or]gmat;
carnivore: [x] n. 食肉动物,食虫植物; [acc] /ˈkɑːrnɪvɔːr/; [or]gmat;
heterogeneity: [x] n. 异类,不同,不均匀性,不纯一性,异质性; [acc] /ˌhetərədʒəˈniːəti/; [or]gmat;
haberdashery: [x] n. (总称)男子服饰用品,缝纫用品; [acc] /ˈhæbərdæʃəri/; [or]gmat;
elongate: [x] v. 延长,伸长;  adj. 延长了的;细长的; [acc] /ɪˈlɔːŋɡeɪt/; [or]gmat;
bacterium: [x] n. 细菌; [acc] /bæk'tɪriəm/; [or]gmat;
seismic: [x] adj. 地震的;地震引起的;剧烈的; [acc] /ˈsaɪzmɪk/; [or]gmat;
evict: [x] v. 驱逐,逐出; [acc] /ɪˈvɪkt/; [or]gmat;
entrepreneur: [x] n. 企业家,演出承包人; [acc] /ˌɑːntrəprəˈnɜːr/; [or]gmat;
cheetah: [x] n. 猎豹; [acc] /ˈtʃiːtə/; [or]gmat;
broccoli: [x] n. 硬花球花椰菜;花茎甘蓝; [acc] /ˈbrɑːkəli/; [or]gmat;
segregate: [x] v. 分开,隔离,进行种族隔离; [acc] /ˈseɡrɪɡeɪt/; [or]gmat;
perk: [x] v. 昂首,意气洋洋,振作;  n. 好处;福利;  adj. 〈罕〉同"perky"; [acc] /pɜːrk/; [or]gmat;
gyration: [x] n. 旋转,回旋;［动］螺层; [acc] /dʒaɪˈreɪʃn/; [or]gmat;
perturb: [x] vt. 使不安;烦扰;使紊乱; [acc] /pərˈtɜːrb/; [or]gmat;
medication: [x] n. 药物;药物治疗;药物处理; [acc] /ˌmedɪˈkeɪʃn/; [or]gmat;
trauma: [x] n. 精神创伤,外伤; [acc] /ˈtraʊmə/; [or]gmat;
sequester: [x] v. 使隔离,隔绝,使隐退,没收,扣押; [acc] /sɪˈkwestər/; [or]gmat;
vector: [x] n. [数]向量;矢量;带菌者; [acc] /ˈvektər/; [or]gmat;
tactic: [x] n. (达到目的)手段,战术,策略;  adj. 按顺序的;依次排列的; [acc] /ˈtæktɪk/; [or]gmat;
follicle: [x] n. ［解］小囊,滤泡,卵泡; [acc] /ˈfɑːlɪkl/; [or]gmat;
inhumane: [x] adj. 残忍的,无人情味的; [acc] /ˌɪnhjuːˈmeɪn/; [or]gmat;
anemia: [x] n. 贫血,贫血症; [acc] /ə'niːmiːə/; [or]gmat;
ordinate: [x] n. 纵坐标; [acc] /ˈɔːrdɪnət/; [or]gmat;
alumnus: [x] n. 男毕业生,男校友; [acc] /əˈlʌmnəs/; [or]gmat;
clone: [x] n. 克隆;无性繁殖系个体;复制品;  v. 复制;克隆; [acc] /kloʊn/; [or]gmat;
hypnotist: [x] n. 施行催眠术的人; [acc] /ˈhɪpnətɪst/; [or]gmat;
insulate: [x] v. 隔离,使隔绝(以免受到影响);使隔热; [acc] /ˈɪnsəleɪt/; [or]gmat;
viable: [x] adj. 可行的;能养活的;能生育的; [acc] /ˈvaɪəbl/; [or]gmat;
viscosity: [x] n. 黏性;黏度; [acc] /vɪˈskɑːsəti/; [or]gmat;
dinosaur: [x] n. 恐龙; [acc] /ˈdaɪnəsɔːr/; [or]gmat;
arcane: [x] adj. 神秘的;秘传的;晦涩难解的; [acc] /ɑːrˈkeɪn/; [or]gmat;
obsolescence: [x] n. 即将过时; [acc] /ˌɑːbsəˈlesns/; [or]gmat;
soloist: [x] n. 独奏者,独唱者,［空］单飞者; [acc] /ˈsoʊloʊɪst/; [or]gmat;
clothesline: [x] n. 晒衣绳;  vt. (用胳膊勾住脖子)击倒对手; [acc] /'kloʊzˌlaɪn/; [or]gmat;
subsidize: [x] v. 给予补助金; [acc] /ˈsʌbsɪdaɪz/; [or]gmat;
tonality: [x] n. 音质,音调; [acc] /toʊˈnæləti/; [or]gmat;
multiplier: [x] n. 乘数; [acc] /ˈmʌltɪplaɪər/; [or]gmat;
psychosis: [x] n. 精神病,精神错乱,精神变态; [acc] /saɪˈkoʊsɪs/; [or]gmat;
coda: [x] n. ［音］结尾,符尾; [acc] /ˈkoʊdə/; [or]gmat;
quintessential: [x] adj. 精华的,典型的; [acc] /ˌkwɪntɪˈsenʃl/; [or]gmat;
ballistic: [x] adj. 弹道(学)的,发射的,衡量冲击强度的; [acc] /bəˈlɪstɪk/; [or]gmat;
smokestack: [x] n. 烟囱,烟窗;  adj. 低技术制造业的,大工厂的; [acc] /ˈsmoʊkstæk/; [or]gmat;
hexagon: [x] n. 六角形,六边形;  adj. 六角形的; [acc] /ˈheksəɡɑːn/; [or]gmat;
undercut: [x] v. 廉价出售;较便宜的工资工作;从下边削球;  n. 底切;牛腰部下侧嫩肉;砍口;切球;  adj. 下部被削去[切去,挖掉,凿去]的; [acc] /ˌʌndərˈkʌt/; [or]gmat;
scintillate: [x] v. 闪烁,(淡吐)流露机智; [acc] /'sɪntlˌeɪt/; [or]gmat;
blob: [x] n. 一滴,一抹,难以名状的一团;  v. 弄脏,把.做错,得零分; [acc] /blɑːb/; [or]gmat;
interstellar: [x] adj. 星际的; [acc] /ˌɪntərˈstelər/; [or]gmat;
migraine: [x] n. ［法］［医］周期性偏头痛; [acc] /ˈmaɪɡreɪn/; [or]gmat;
helicopter: [x] n. 直升机;  v. 用直升飞机载送,乘直升机; [acc] /ˈhelɪkɑːptər/; [or]gmat;
questionnaire: [x] n. 调查表,问卷; [acc] /ˌkwestʃəˈner/; [or]gmat;
toxin: [x] n. 毒素,毒质; [acc] /ˈtɑːksɪn/; [or]gmat;
analog: [x] adj. 有长短针的;模拟的;  n. 类似物;模拟; [acc] /ˈænəlɑːɡ/; [or]gmat;
calorie: [x] n. 卡(热量单位); [acc] /ˈkæləri/; [or]gmat;
excrete: [x] v. 排泄,分泌; [acc] /ɪkˈskriːt/; [or]gmat;
myopic: [x] n. 近视;  adj. 近视的;目光短浅的; [acc] /maɪˈɑːpɪk/; [or]gmat;
obstetrical: [x] adj. 产科(学)的,助产的; [acc] /əb'stetrɪkl/; [or]gmat;
psychiatric: [x] adj. 精神病的; [acc] /ˌsaɪkiˈætrɪk/; [or]gmat;
fluorescent: [x] adj. 荧光的;莹光的; [acc] /ˌflɔːˈresnt/; [or]gmat;
syndrome: [x] n. ［医］综合征;一系列表现; [acc] /ˈsɪndroʊm/; [or]gmat;
carpal: [x] n. ［解］腕骨;  adj. 腕骨的; [acc] /ˈkɑːrpl/; [or]gmat;
zing: [x] n. (子弹等的)尖啸声,精力,省略;  v. 对.挑剔,发尖啸声; [acc] /zɪŋ/; [or]gmat;
paradigm: [x] n. 范例,示范; [acc] /ˈpærədaɪm/; [or]gmat;
diva: [x] n. 著名女歌唱家,歌剧女主角; [acc] /ˈdiːvə/; [or]gmat;
amnesia: [x] n. [医学]遗忘症; [acc] /æmˈniːʒə/; [or]gmat;
underscore: [x] v. 强调,加强,划线于.下;  n. 底线; [acc] /ˌʌndərˈskɔːr/; [or]gmat;
toddler: [x] n. 蹒跚而行的人,学步小孩; [acc] /ˈtɑːdlər/; [or]gmat;
provenance: [x] n. 出处,起源; [acc] /ˈprɑːvənəns/; [or]gmat;
posit: [x] v. 假定;  n. 安置;论断; [acc] /ˈpɑːzɪt/; [or]gmat;
potpourri: [x] n. 百花香,杂物,杂曲,杂文集; [acc] /ˌpoʊpʊˈriː/; [or]gmat;
detergent: [x] n. 洗涤剂,清洁剂; [acc] /dɪˈtɜːrdʒənt/; [or]gmat;
leery: [x] adj. 机警的,狡猾的; [acc] /ˈlɪri/; [or]gmat;
debilitate: [x] v. 使衰弱; [acc] /dɪˈbɪlɪteɪt/; [or]gmat;
windshield: [x] n. 挡风玻璃; [acc] /ˈwɪndʃiːld/; [or]gmat;
bureaucrat: [x] n. 官僚,官僚主义者; [acc] /ˈbjʊrəkræt/; [or]gmat;
ecology: [x] n. 生态,生态学; [acc] /iˈkɑːlədʒi/; [or]gmat;
activate: [x] v. 使活动起来;使开始起作用; [acc] /ˈæktɪveɪt/; [or]gmat;
cure-all: [x] n. 万灵药; [acc] /ˈkjʊr ɔːl/; [or]gmat;
marijuana: [x] n. 大麻,大麻中的毒质; [acc] /ˌmærəˈwɑːnə/; [or]gmat;
ideographic: [x] adj. 表意的,表意文字的; [acc] /ˌɪdɪə'græfɪk/; [or]gmat;
hallmark: [x] n. 特点;品质证明;  v. 给.盖上品质证明印记;使具有.标志; [acc] /ˈhɔːlmɑːrk/; [or]gmat;
takeover: [x] n. 接收,接管,接任;收买; [acc] /ˈteɪkoʊvər/; [or]gmat;
statistic: [x] n. 统计;统计数值;统计学; [acc] /stəˈtɪstɪk/; [or]gmat;
methodology: [x] n. 方法论,方法学;(某一学科的)一套方法; [acc] /ˌmeθəˈdɑːlədʒi/; [or]gmat;
outdistance: [x] v. (指赛跑或竞争中)把..远远抛在后面,大大超越; [acc] /ˌaʊtˈdɪstəns/; [or]gmat;
sequential: [x] adj. 连续的;相继的;有顺序的;  n. 〈美俚〉按期服食的避孕丸; [acc] /sɪˈkwenʃl/; [or]gmat;
Inuit: [x] n. 因纽特人;  adj. 因纽特人的; [acc] /ˈɪnjuɪt/; [or]gmat;
doctorate: [x] n. 博士头衔; [acc] /ˈdɑːktərət/; [or]gmat;
linguistics: [x] n. 语言学; [acc] /lɪŋˈɡwɪstɪks/; [or]gmat;
iridium: [x] n. 铱; [acc] /ɪˈrɪdiəm/; [or]gmat;
revitalize: [x] v. 使复活,使重新充满活力,使复兴; [acc] /ˌriːˈvaɪtəlaɪz/; [or]gmat;
sidestep: [x] n. (侧面)台阶;拳击等横跨一步躲避打击;［喻］回避(困难);  v. 回避;横跨一步躲避; [acc] /ˈsaɪdstep/; [or]gmat;
hypotenuse: [x] n. (直角三角形的)斜边; [acc] /haɪˈpɑːtənuːs/; [or]gmat;
blurry: [x] adj. 模糊的,难辩认的; [acc] /ˈblɜːri/; [or]gmat;
jettison: [x] v. 向外抛弃,投弃(船舶遇难时投弃货物以为减轻负载);  n. 抛弃的货物; [acc] /ˈdʒetɪsn/; [or]gmat;
hypertension: [x] n. ［医］高血压,过度紧张; [acc] /ˌhaɪpərˈtenʃn/; [or]gmat;
bisect: [x] n. 对剖邮票;  vi. 分开;  vt. 把.分切为二,把.二等分;二等分; [acc] /baɪˈsekt/; [or]gmat;
desktop: [x] n. 桌面;台式机;  adj. 台式的;桌上用的; [acc] /ˈdesktɑːp/; [or]gmat;
overlie: [x] v. 躺在..上面,压在..上面,盖得使窒息; [acc] /ˌoʊvərˈlaɪ/; [or]gmat;
underwrite: [x] v. 给.保险,承诺支付;同意赔款(海上保险); [acc] /ˌʌndərˈraɪt/; [or]gmat;
congruent: [x] adj. 和谐一致的,全等的; [acc] /ˈkɑːŋɡruənt/; [or]gmat;
trapezium: [x] n. (英)梯形,(美)不规则四边形; [acc] /trəˈpiːziəm/; [or]gmat;
iconography: [x] n. 肖像画法,肖像学,插画,图解; [acc] /ˌaɪkəˈnɑːɡrəfi/; [or]gmat;
dichotomy: [x] n. 二分,本质对立; [acc] /daɪˈkɑːtəmi/; [or]gmat;
allocate: [x] v. 分配,配给; [acc] /ˈæləkeɪt/; [or]gmat;
insecticide: [x] n. 杀虫剂; [acc] /ɪnˈsektɪsaɪd/; [or]gmat;
codify: [x] v. 编纂;将..编成法典; [acc] /ˈkɑːdɪfaɪ/; [or]gmat;
obsess: [x] vt. 迷住,使着迷,使烦扰; [acc] /əbˈses/; [or]gmat;
exacerbate: [x] v. 加重;恶化;激怒; [acc] /ɪɡˈzæsərbeɪt/; [or]gmat;
hedonist: [x] n. 享乐主义者,［心］欢乐主义者;  adj. 享乐主义者的; [acc] /ˈhiːdənɪst/; [or]gmat;
outmoded: [x] adj. 不再流行的,过时的; [acc] /ˌaʊtˈmoʊdɪd/; [or]gmat;
parameter: [x] n. 决定因素;界限;参(变)数;参量; [acc] /pəˈræmɪtər/; [or]gmat;
bottleneck: [x] n. 瓶颈口,(喻)交通易阻塞的狭口;妨碍生产流程的一环;  v. 阻碍;交通堵塞;  adj. (街道等)狭隘的; [acc] /ˈbɑːtlnek/; [or]gmat;
pollination: [x] n. 授粉; [acc] /ˌpɑːləˈneɪʃn/; [or]gmat;
schizophrenia: [x] n. [内科]精神分裂症; [acc] /ˌskɪtsəˈfriːniə/; [or]gmat;
spray: [x] n. 浪花;水雾;喷雾;  vi. 飞溅,喷;  vt. 喷;向..扫射;散布; [acc] /spreɪ/; [or]gmat;
erode: [x] v. 腐蚀;遭侵蚀,腐蚀,侵蚀;削弱;  vt. 损害; [acc] /ɪˈroʊd/; [or]gmat;
divisive: [x] adj. 分裂的;区分的;造成不和的; [acc] /dɪˈvaɪsɪv/; [or]gmat;
hypersensitive: [x] adj. 敏感的;很容易生气的;过敏的;超感光度的; [acc] /ˌhaɪpərˈsensətɪv/; [or]gmat;
seminar: [x] n. 研究班;研讨会; [acc] /ˈsemɪnɑːr/; [or]gmat;
burgeon: [x] v. 发芽,迅速成长;  n. 嫩枝; [acc] /ˈbɜːrdʒən/; [or]gmat;
chauvinism: [x] n. 沙文主义者,盲目爱国主义; [acc] /ˈʃoʊvɪnɪzəm/; [or]gmat;
upturn: [x] n. 情况好转;  v. 朝上,向上;翻转; [acc] /ˈʌptɜːrn/; [or]gmat;
bummer: [x] n. 懒汉,游手好闲的人;  adj. 差劲的;  v. 流浪,乞讨; [acc] /ˈbʌmər/; [or]gmat;
odometer: [x] n. (汽车的)里程表,[车辆]里程; [acc] /oʊˈdɑːmɪtər/; [or]gmat;
demographic: [x] adj. 人口统计学的;人口学的; [acc] /ˌdeməˈɡræfɪk/; [or]gmat;
enzyme: [x] n. [生化]酶; [acc] /ˈenzaɪm/; [or]gmat;
semiconductor: [x] n. 半导体; [acc] /ˌsemikənˈdʌktər/; [or]gmat;
effluent: [x] n. 污水;  adj. 流出的; [acc] /ˈefluənt/; [or]gmat;
pasta: [x] n. 意大利面食; [acc] /ˈpɑːstə/; [or]gmat;
synthesize: [x] v. [化]合成;综合;人工合成; [acc] /ˈsɪnθəsaɪz/; [or]gmat;
totalitarian: [x] n. 极权主义者;  adj. 极权主义的; [acc] /toʊˌtæləˈteriən/; [or]gmat;
additive: [x] n. 添加剂,添加物;  adj. 附加的;[数]加法的; [acc] /ˈædətɪv/; [or]gmat;
integral: [x] adj. (用于构成整体)必需的,不可缺少的,必不可少的;基本的,作为组成部分的,内置的;整体的,完整的; [acc] /ˈɪntɪɡrəl/; [or]gmat;
clockwise: [x] adj. 顺时针方向的;  adv. 顺时针方向地; [acc] /ˈklɑːkwaɪz/; [or]gmat;
deluxe: [x] adj. 豪华的,华丽的; [acc] /dɪˈlʌks/; [or]gmat;
constrict: [x] v. 约束,收缩,妨碍; [acc] /kənˈstrɪkt/; [or]gmat;
breakthrough: [x] n. 突破,突破性进展,重要的新发现;  adj. 突破性的; [acc] /ˈbreɪkθruː/; [or]gmat;
highlight: [x] vt. 使突出,强调,高亮;  n. 最精彩的部分,最重要的事件; [acc] /ˈhaɪlaɪt/; [or]gmat;
eggnog: [x] n. 蛋奶酒; [acc] /ˈeɡnɑːɡ/; [or]gmat;
cartographer: [x] n. 制图师;地图制作者; [acc] /kɑːrˈtɑːɡrəfər/; [or]gmat;
catalyst: [x] n. 催化剂;造成变化的人或事; [acc] /ˈkætəlɪst/; [or]gmat;
reactor: [x] n. ［原］反应堆; [acc] /riˈæktər/; [or]gmat;
artifact: [x] n. 人工制品;手工艺品; [acc] /ˈɑːrtɪfækt/; [or]gmat;
malfunction: [x] v. 发生故障;不起作用;  n. 故障;失灵;疾病; [acc] /ˌmælˈfʌŋkʃn/; [or]gmat;
rehash: [x] v. 重讲,重新处理;  n. 改头换面地作品; [acc] /ˈriːhæʃ/; [or]gmat;
paleontologist: [x] n. 古生物学家; [acc] /ˌpelɪɑn'tɑlədʒɪst/; [or]gmat;
abscissa: [x] n. 横座标,横线; [acc] /æbˈsɪsə/; [or]gmat;
forebear: [x] n. 祖先,祖宗;  v. 忍住; [acc] /ˈfɔːrber/; [or]gmat;
proponent: [x] n. 支持者;提议者;主张者;提出认证遗嘱者;  adj. 建议的;支持的;辩护的; [acc] /prəˈpoʊnənt/; [or]gmat;
racist: [x] n. 种族主义者;  adj. 种族主义的; [acc] /ˈreɪsɪst/; [or]gmat;
plywood: [x] n. 胶合板,层压木板; [acc] /ˈplaɪwʊd/; [or]gmat;
lionize: [x] v. 崇拜,把..奉为名人; [acc] /ˈlaɪənaɪz/; [or]gmat;
hemoglobin: [x] n. ［生化］血红蛋白; [acc] /ˌhiːmə'gloʊbɪn/; [or]gmat;
envision: [x] v. 预测,想象,展望; [acc] /ɪnˈvɪʒn/; [or]gmat;
profitability: [x] n. 赢利能力;收益性;利益率; [acc] /ˌprɑːfɪtəˈbɪləti/; [or]gmat;
archenemy: [x] n. 天敌,主要敌人; [acc] /'ɑːtʃ'enəmɪ/; [or]gmat;
semiotic: [x] n. ［哲］符号学;  adj. 症状的,符号学的,记号语言的; [acc] /ˌsemiˈɑːtɪk/; [or]gmat;
nylon: [x] n. 尼龙,尼龙长袜; [acc] /ˈnaɪlɑːn/; [or]gmat;
benchmark: [x] n. 基准;标准检查程序;  v. 用基准问题测试(计算机系统等); [acc] /ˈbentʃmɑːrk/; [or]gmat;
jumbo: [x] adj. 巨大的,特大的;  n. 体大而笨拙的人或物;大型喷气式客机;庞然大物; [acc] /ˈdʒʌmboʊ/; [or]gmat;
zoom: [x] v. (镜头)拉近(拉远);急速上升,嗡嗡作响;  n. 车辆疾驰的声音,嗡嗡声,(摄影)变焦; [acc] /zuːm/; [or]gmat;
holistic: [x] adj. 整体的;全盘的; [acc] /hoʊˈlɪstɪk/; [or]gmat;
luminescence: [x] n. 发光; [acc] /ˌluːmɪˈnesns/; [or]gmat;
antebellum: [x] adj. (美国南北)战争前的; [acc] /ˌæntiˈbeləm/; [or]gmat;
zoning: [x] n. 分区制,都市的区域划分; [acc] /ˈzoʊnɪŋ/; [or]gmat;
encode: [x] v. 把(电文等)译成电码(或密码),编码; [acc] /ɪnˈkoʊd/; [or]gmat;
infrared: [x] adj. 红外线的;  n. 红外线; [acc] /ˌɪnfrəˈred/; [or]gmat;
stockpile: [x] n. 储备;  v. 储备,贮存; [acc] /ˈstɑːkpaɪl/; [or]gmat;
termite: [x] n. 白蚁; [acc] /ˈtɜːrmaɪt/; [or]gmat;
hepatitis: [x] n. 肝炎; [acc] /ˌhepəˈtaɪtɪs/; [or]gmat;
escalate: [x] v. 逐步升高,逐步增强,加剧恶化; [acc] /ˈeskəleɪt/; [or]gmat;
backdrop: [x] n. 背景幕;(事件的)背景; [acc] /ˈbækdrɑːp/; [or]gmat;
revamp: [x] v. 翻新,整修,升级;  n. 改进,换新鞋面; [acc] /ˈriːvæmp/; [or]gmat;
analgesic: [x] n. 镇痛药;  adj. 止痛的; [acc] /ˌænəlˈdʒiːzɪk/; [or]gmat;
realtor: [x] n. 房地产经纪人; [acc] /ˈriːəltər/; [or]gmat;
gynecologist: [x] n. 妇科医生; [acc] /ˌgaɪnə'kɒlədʒɪst/; [or]gmat;
ersatz: [x] adj. 代用的,人造的,合成的;  n. 代用品,仿制品; [acc] /ˈersɑːts/; [or]gmat;
corny: [x] adj. 谷类的,乡下味的,粗野的,有鸡眼的; [acc] /ˈkɔːrni/; [or]gmat;
proton: [x] n. 质子; [acc] /ˈproʊtɑːn/; [or]gmat;
xenophobia: [x] n. 仇外,对外国人的恐惧或憎恨; [acc] /ˌzenəˈfoʊbiə/; [or]gmat;
airborne: [x] adj. 空运的;在空中的; [acc] /ˈerbɔːrn/; [or]gmat;
proliferate: [x] v. 激增,繁殖,增殖; [acc] /prəˈlɪfəreɪt/; [or]gmat;
ingest: [x] v. 咽下;摄取;吸收;接待; [acc] /ɪnˈdʒest/; [or]gmat;
ecosystem: [x] n. 生态系统; [acc] /ˈiːkoʊsɪstəm/; [or]gmat;
diesel: [x] n. 内燃机,柴油机; [acc] /ˈdiːzl/; [or]gmat;
denigrate: [x] v. 抹黑,贬低; [acc] /ˈdenɪɡreɪt/; [or]gmat;
smog: [x] n. 烟雾; [acc] /smɑːɡ/; [or]gmat;
ambivalent: [x] adj. 矛盾的;摇摆不定的;好恶相克的;  n. 两性人; [acc] /æmˈbɪvələnt/; [or]gmat;
leukemia: [x] n. [医]白血病; [acc] /luː'kiːmɪə/; [or]gmat;
symbiotic: [x] adj. [生态]共栖的;共生的; [acc] /ˌsɪmbaɪˈɑːtɪk/; [or]gmat;
predator: [x] n. 掠夺者,食肉动物; [acc] /ˈpredətər/; [or]gmat;
alumna: [x] n. 女毕业生,女校友; [acc] /əˈlʌmnə/; [or]gmat;
hamster: [x] n. (动)仓鼠; [acc] /ˈhæmstər/; [or]gmat;
vinyl: [x] n. ［化］乙烯基,塑料; [acc] /ˈvaɪnl/; [or]gmat;
aerobic: [x] adj. 需氧的;有氧健身法的; [acc] /eˈroʊbɪk/; [or]gmat;
ethnicity: [x] n. 种族,种族地位,种族特点; [acc] /eθˈnɪsəti/; [or]gmat;
macaque: [x] n. 猕猴,恒河猴,短尾猴; [acc] /məˈkæk/; [or]gmat;
horrendous: [x] adj. 可怕的,令人惊惧的; [acc] /həˈrendəs/; [or]gmat;
pesticide: [x] n. 杀虫剂;农药; [acc] /ˈpestɪsaɪd/; [or]gmat;
provision: [x] n. (法律等)条款;供应;预备,存粮;必需品;  v. 为..提供必需品; [acc] /prəˈvɪʒn/; [or]gmat;
ambivalence: [x] n. 矛盾心理; [acc] /æmˈbɪvələns/; [or]gmat;
burglarize: [x] v. 进行夜盗; [acc] /'bɜːɡləraɪz/; [or]gmat;
cholesterol: [x] n. 胆固醇; [acc] /kəˈlestərɔːl/; [or]gmat;
hypothesize: [x] v. 假设,假定; [acc] /haɪˈpɑːθəsaɪz/; [or]gmat;
bylaw: [x] n. 地方法规; [acc] /'baɪˌlɔː/; [or]gmat;
insulin: [x] n. 胰岛素; [acc] /ˈɪnsəlɪn/; [or]gmat;
neutron: [x] n. 中子; [acc] /ˈnuːtrɑːn/; [or]gmat;
allergy: [x] n. 过敏症,厌恶; [acc] /ˈælərdʒi/; [or]gmat;
customize: [x] v. 定制,定做;按规格改制;定制,定做;依照指定的规格制造; [acc] /ˈkʌstəmaɪz/; [or]gmat;
dehydrate: [x] v. 除去水份,脱水; [acc] /diːˈhaɪdreɪt/; [or]gmat;
transistor: [x] n. 晶体管;半导体收音机; [acc] /trænˈzɪstər/; [or]gmat;
replicate: [x] v. 复制;重复,反复; [acc] /ˈreplɪkeɪt/; [or]gmat;
dopamine: [x] n. ［生化］多巴胺; [acc] /ˈdoʊpəmiːn/; [or]gmat;
juxtapose: [x] v. 使并排;使并置;使并列; [acc] /ˌdʒʌkstəˈpoʊz/; [or]gmat;
upsurge: [x] n. 高潮,高涨; [acc] /ˈʌpsɜːrdʒ/; [or]gmat;
apolitical: [x] adj. 不问政治的; [acc] /ˌeɪpəˈlɪtɪkl/; [or]gmat;
bicentenary: [x] adj. 二百年的;  n. 二百周年纪念; [acc] /ˌbaɪsenˈtenəri/; [or]gmat;
isotope: [x] n. 同位素; [acc] /ˈaɪsətoʊp/; [or]gmat;
sibling: [x] n. 兄弟姊妹;同胞;(生物)同科,同属; [acc] /ˈsɪblɪŋ/; [or]gmat;
polygraph: [x] n. 复写仪,测谎器,多产作家;  vi. 用测谎仪测出结果;  vt. 用测谎仪测试(某人); [acc] /ˈpɑːliɡræf/; [or]gmat;
blackout: [x] n. 断电;  adj. 防空袭的; [acc] /ˈblækaʊt/; [or]gmat;
pollinate: [x] vt. 传花粉给.; [acc] /ˈpɑːləneɪt/; [or]gmat;
sinusitis: [x] n. [医]窦炎; [acc] /ˌsaɪnəˈsaɪtɪs/; [or]gmat;
antibiotic: [x] n. 抗生素;  adj. 抗菌的; [acc] /ˌæntibaɪˈɑːtɪk/; [or]gmat;
extraterrestrial: [x] adj. 地球外的,地球大气圈外的;  n. 外星人,外星生物,宇航员; [acc] /ˌekstrətəˈrestriəl/; [or]gmat;
intracellular: [x] adj. 细胞内部的; [acc] /ˌɪntrə'seljələ/; [or]gmat;
gimmick: [x] n. 吸引人的花招,噱头;  vt. 用暗机关改变或影响; [acc] /ˈɡɪmɪk/; [or]gmat;
radon: [x] n. ［化］氡; [acc] /ˈreɪdɑːn/; [or]gmat;
choreography: [x] n. 编舞艺术;舞蹈编排;舞蹈编排; [acc] /ˌkɔːriˈɑːɡrəfi/; [or]gmat;
portage: [x] n. 搬运,运输线路;  v. 转到陆上运输,运输; [acc] /ˈpɔːrtɪdʒ/; [or]gmat;
odd number: [x] phr. 奇数; [acc] /ɑd ˈnʌmbər/; [or]gmat;
off-the-shelf: [x] adj. (货品)现成常备的,非定制的;  adv. 现成地,无需作重大修改地; [acc] /ˌɔːf ðə ˈʃelf/; [or]gmat;
enthusiastically: [x] adv. 热心地;满腔热情地; [acc] /ɪnˌθuːziˈæstɪkli/; [or]gmat;
organelle: [x] n. ［生］细胞器; [acc] /ˌɔːgə'nel/; [or]gmat;
correlate: [x] v. (使)相关联;  n. 相关物; [acc] /ˈkɔːrələt/; [or]gmat;
hieroglyphic: [x] adj. 象形文字的;  n. 象形文字,象形文字写成的文章; [acc] /ˌhaɪərəˈɡlɪfɪk/; [or]gmat;
amino acid: [x] n. ［生］氨基酸; [acc] /əˌmiːnoʊ ˈæsɪd/; [or]gmat;
neologism: [x] n. 新生词; [acc] /niˈɑːlədʒɪzəm/; [or]gmat;
neonate: [x] n. 初生婴儿; [acc] /ˈniːoʊneɪt/; [or]gmat;
inextricably: [x] adv. 无法摆脱地; [acc] /ˌɪnɪkˈstrɪkəbli/; [or]gmat;
extradite: [x] v. 引渡,获取.的引渡; [acc] /ˈekstrədaɪt/; [or]gmat;
equilateral triangle: [x] phr. 等边三角形; [acc] /ˌiːkwɪˌlætərəl ˈtraɪæŋɡl/; [or]gmat;
anopheles: [x] n. (动)疟蚊属; [acc] /ə'nɒfəˌlɪz/; [or]gmat;
infirmary: [x] n. 医院,医务室(尤指学校等附设的病房或配药处); [acc] /ɪnˈfɜːrməri/; [or]gmat;
transfer: [x] v. 转移;调任;换乘;转变;改编;  n. 转让;转移;调任;汇兑; [acc] /trænsˈfɜːr/; [or]gmat;
defrost: [x] v. 除霜,解冻; [acc] /ˌdiːˈfrɔːst/; [or]gmat;
compensatory: [x] adj. 补偿的,赔偿的; [acc] /kəmˈpensətɔːri/; [or]gmat;
hominid: [x] n. 原始人类;人科动物; [acc] /ˈhɑːmɪnɪd/; [or]gmat;
misrepresent: [x] vi. 作虚假陈述;  vt. 歪曲;误传; [acc] /ˌmɪsˌreprɪˈzent/; [or]gmat;
unison: [x] n. 一致,(音)齐唱;  adj. 同音的; [acc] /ˈjuːnɪsn/; [or]gmat;
real estate: [x] n. 不动产,房地产; [acc] /ˈriːəl əsteɪt/; [or]gmat;
roller coaster: [x] n. 过山车; [acc] /ˈroʊlər koʊstər/; [or]gmat;
overuse: [x] n. 过度的使用;  vt. 使用.过度;使用.过多; [acc] /ˌoʊvərˈjuːs/; [or]gmat;
antifreeze: [x] n. 抗冻剂; [acc] /ˈæntifriːz/; [or]gmat;
antipode: [x] n. 恰恰相反的事物(of,to),相对极,对极; [acc] /'æntɪˌpoʊd/; [or]gmat;
palatability: [x] n. 可口性,风味; [acc] /'pælətəbəlɪtɪ/; [or]gmat;
eventual: [x] adj. 最后的,终于的; [acc] /ɪˈventʃuəl/; [or]gmat;
antipsychotic: [x] adj. 抑制精神的;  n. 安定药; [acc] /ˌæntɪsaɪˈkɒtɪk/; [or]gmat;
antitrust law: [x] phr. 反托拉斯法; [acc] /ˌæntiˈtrʌst lɔ/; [or]gmat;
aperiodic: [x] adj. 非周期的; [acc] /ˌeɪpɪrɪ'ɒdɪk/; [or]gmat;
divergence: [x] n. 分歧;背离; [acc] /daɪˈvɜːrdʒəns/; [or]gmat;
paranormal: [x] adj. 超自然的,异常的;  n. 超常事件(或话题); [acc] /ˌpærəˈnɔːrml/; [or]gmat;
excavate: [x] v. 挖掘,挖出;挖(空),挖(洞); [acc] /ˈekskəveɪt/; [or]gmat;
imposition: [x] n. 征收;强加;欺骗;不公平的负担; [acc] /ˌɪmpəˈzɪʃn/; [or]gmat;
parapsychology: [x] n. 灵学;超心理学; [acc] /ˌpærəsaɪˈkɑːlədʒi/; [or]gmat;
spherule: [x] n. 小球(体); [acc] /'sfeəuːl/; [or]gmat;
slowdown: [x] n. 减速,减退;怠工; [acc] /ˈsloʊdaʊn/; [or]gmat;
decay: [x] v. 腐烂;衰退;腐朽;  n. 腐烂;衰退;腐败; [acc] /dɪˈkeɪ/; [or]gmat;
at stake: [x] phr. 存亡攸关,处于危险中; [acc] /ət steɪk/; [or]gmat;
centrifugal: [x] adj. 离心的;远中的;  n. 离心机; [acc] /ˌsentrɪˈfjuːɡl/; [or]gmat;
per capita: [x] phr. 人均; [acc] /pər ˈkæpɪtə/; [or]gmat;
categorical: [x] adj. 绝对的;直接了当的;无条件的;属于某一范畴的; [acc] /ˌkætəˈɡɔːrɪkl/; [or]gmat;
interdependence: [x] n. 互相依赖; [acc] /ˌɪntərdɪˈpendəns/; [or]gmat;
quarantine: [x] v. 检疫;隔离;使隔离;  n. 检疫;隔离;检疫期;封锁; [acc] /ˈkwɔːrəntiːn/; [or]gmat;
causative: [x] adj. 成为原因的,引起.的;  n. 使役动词; [acc] /ˈkɔːzətɪv/; [or]gmat;
laxity: [x] n. 松弛,放纵; [acc] /ˈlæksəti/; [or]gmat;
better off: [x] adj. 境况(尤指经济境况)较好; [acc] /ˈbetər ɑf/; [or]gmat;
rationality: [x] n. 合理性,合理的行动; [acc] /ˌræʃəˈnæləti/; [or]gmat;
psychopath: [x] n. 精神变态者; [acc] /ˈsaɪkəpæθ/; [or]gmat;
prospectus: [x] n. 章程,内容简介;样张;创办计划书; [acc] /prəˈspektəs/; [or]gmat;
biota: [x] n. 生物区系; [acc] /baɪ'oʊtə/; [or]gmat;
ostentation: [x] n. 卖弄,炫耀; [acc] /ˌɑːstenˈteɪʃn/; [or]gmat;
bipedalism: [x] n. 二足类; [acc] /'baɪpedlɪzəm/; [or]gmat;
reconvene: [x] v. 重新集合,重新召集; [acc] /ˌriːkənˈviːn/; [or]gmat;
inverted: [x] adj. 反向的,倒转的,倒置,颠倒; [acc] /ɪnˈvɜːrtɪd/; [or]gmat;
blind spot: [x] n. ［物］盲点,［无］静区,(驾驶车辆等视力以外的)盲区; [acc] /ˈblaɪnd spɑːt/; [or]gmat;
bona fides: [x] n. ［拉］诚意,善意; [acc] /ˌboʊnə ˈfaɪdiːz/; [or]gmat;
cramped: [x] adj. 狭窄的,挤在一起的; [acc] /kræmpt/; [or]gmat;
unparalleled: [x] adj. 无比的,无双的,空前的; [acc] /ʌnˈpærəleld/; [or]gmat;
meteorologist: [x] n. 气象学者; [acc] /ˌmiːtiəˈrɑːlədʒɪst/; [or]gmat;
prior to: [x] phr. 在..之前; [acc] /ˈpraɪr tu/; [or]gmat;
buttress: [x] n. 扶墙,拱壁;  v. 支持; [acc] /ˈbʌtrəs/; [or]gmat;
prone to: [x] phr. 易于..的; [acc] /proʊn tu/; [or]gmat;
side effect: [x] phr. 副作用; [acc] /ˈsaɪd ɪfekt/; [or]gmat;
novocaine: [x] n. 奴佛卜因(一种麻醉药); [acc] /ˈnoʊvəkeɪn/; [or]gmat;
far-reaching: [x] adj. 深远的;广泛的;伸至远处的; [acc] /ˌfɑːr ˈriːtʃɪŋ/; [or]gmat;
rule of thumb: [x] n. 单凭经验的做法;经验法则; [acc] /rul ɑv θʌm/; [or]gmat;
unsubstantiated: [x] adj. 未经证实的,无事实根据的; [acc] /ˌʌnsəbˈstænʃieɪtɪd/; [or]gmat;
peninsula: [x] n. 半岛; [acc] /pəˈnɪnsələ/; [or]gmat;
embroider: [x] v. 刺绣,绣花;润色,渲染; [acc] /ɪmˈbrɔɪdər/; [or]gmat;
psychoactive: [x] adj. (药剂)对神经起显著(或特殊)作用的; [acc] /ˌsaɪkoʊˈæktɪv/; [or]gmat;
prejudicial: [x] adj. 有害的,引起偏见的; [acc] /ˌpredʒuˈdɪʃl/; [or]gmat;
caries: [x] n. ［拉］［医］龋,骨疡; [acc] /ˈkeriːz/; [or]gmat;
resurgence: [x] n. 复活;再现;再起; [acc] /rɪˈsɜːrdʒəns/; [or]gmat;
dispassionate: [x] adj. 平心静气的,不带感情的; [acc] /dɪsˈpæʃənət/; [or]gmat;
pupation: [x] n. ［动］化蛹; [acc] /pjʊ'peɪʃn/; [or]gmat;
photosynthesis: [x] n. 光合作用; [acc] /ˌfoʊtoʊˈsɪnθəsɪs/; [or]gmat;
herbicide: [x] n. [农药]除草剂; [acc] /ˈɜːrbɪsaɪd/; [or]gmat;
landfill: [x] n. 垃圾堆;  vt. 在垃圾填埋地上处理; [acc] /ˈlændfɪl/; [or]gmat;
hedge: [x] v. 防范,规避;避免直接答复,避免直接回答;围住;用树篱围起;  n. 篱笆,树篱;保障; [acc] /hedʒ/; [or]gmat;
quasar: [x] n. (天)类星体; [acc] /ˈkweɪzɑːr/; [or]gmat;
substantiate: [x] v. 证实;使实体化; [acc] /səbˈstænʃieɪt/; [or]gmat;
chordate: [x] n. 脊索动;  adj. [动]脊索动物的; [acc] /'kɔːˌdeɪt/; [or]gmat;
subsidy: [x] n. 补助金,津贴; [acc] /ˈsʌbsədi/; [or]gmat;
urbanize: [x] v. 使都市化;使文雅; [acc] /'ɜːbənˌaɪz/; [or]gmat;
circadian: [x] adj. ［生］生理节奏的;以24小时为周期的; [acc] /sɜːrˈkeɪdiən/; [or]gmat;
lipid: [x] n. 脂质,油脂; [acc] /ˈlɪpɪd/; [or]gmat;
climatologist: [x] n. 气候学家; [acc] /ˌklaɪməˈtɑːlədʒist/; [or]gmat;
tartan: [x] n. 单桅三角帆船,格子花,格子织物;  adj. 格子花呢的; [acc] /ˈtɑːrtn/; [or]gmat;
closed-circuit television: [x] n. 闭路电视; [acc] /ˌkloʊzd ˌsɜːrkɪt ˈtelɪvɪʒn/; [or]gmat;
counterclockwise: [x] adv. 逆时针方向;  adj. 逆时针方向的,自右向左的; [acc] /ˌkaʊntərˈklɑːkwaɪz/; [or]gmat;
coleslaw: [x] n. 凉拌卷心菜丝; [acc] /ˈkoʊlslɔː/; [or]gmat;
contaminant: [x] n. 污染物,致污物; [acc] /kənˈtæmɪnənt/; [or]gmat;
resuscitation: [x] n. 复活,苏醒; [acc] /rɪˌsʌsɪˈteɪʃn/; [or]gmat;
surcharge: [x] n. 额外费用,过高的要价;  v. 追加罚款;使.装载过多;使.负担过重; [acc] /ˈsɜːrtʃɑːrdʒ/; [or]gmat;
eusocial: [x] adj. (昆虫)完全社会性的,完全群居的; [acc] /juː'soʊʃəl/; [or]gmat;
composite number: [x] phr. 合成数,合数; [acc] /kəmˈpɑːzət ˈnʌmbər/; [or]gmat;
put away: [x] phr. 放好;把.收起来;储存; [acc] /pʊt əˈweɪ/; [or]gmat;
invalidate: [x] v. 使无效;使无价值; [acc] /ɪnˈvælɪdeɪt/; [or]gmat;
compound interest: [x] phr. 复利; [acc] /ˌkɑːmpaʊnd ˈɪntrəst/; [or]gmat;
concentric circle: [x] phr. 同心圆; [acc] /kənˈsentrɪk ˈsɜːrkl/; [or]gmat;
rheumatoid: [x] adj. 风湿病的,类风湿病的; [acc] /'ruːməˌtɔɪd/; [or]gmat;
right angle: [x] phr. 直角; [acc] /ˈraɪt æŋɡl/; [or]gmat;
rhinovirus: [x] n. 鼻病毒; [acc] /ˌraɪnoʊ'vaɪrəs/; [or]gmat;
authentic: [x] adj. 真实的;真正的;可靠的; [acc] /ɔːˈθentɪk/; [or]gmat;
indulge: [x] v. 沉迷于;放纵;满足; [acc] /ɪnˈdʌldʒ/; [or]gmat;
speak out: [x] phr. 大胆地说,清楚和响亮地说; [acc] /spik aʊt/; [or]gmat;
denominator: [x] n. [数]分母; [acc] /dɪˈnɑːmɪneɪtər/; [or]gmat;
rough-hewn: [x] adj. 粗凿成的,粗削的(石头,木材),毛坯的,草拟的; [acc] /ˌrʌf ˈhjuːn/; [or]gmat;
automation: [x] n. 自动化; [acc] /ˌɔːtəˈmeɪʃn/; [or]gmat;
preferential: [x] adj. 优先的;选择的;特惠的; [acc] /ˌprefəˈrenʃl/; [or]gmat;
epicenter: [x] n. 震中,中心,集中点; [acc] /'epɪˌsentə/; [or]gmat;
cornstalk: [x] n. 玉米秆; [acc] /'kɔːnˌstɔːk/; [or]gmat;
sale price: [x] n. 特价,廉价; [acc] /seɪl praɪs/; [or]gmat;
antibiotics: [x] n. 抗生素; [acc] /ˌæntɪbaɪ'ɒtɪks/; [or]gmat;
assembly line: [x] n. 装配线(生产上一环接一环的),流水线; [acc] /əˈsembli laɪn/; [or]gmat;
fretful: [x] adj. 烦躁的,焦躁的,(水面)起波纹的; [acc] /ˈfretfl/; [or]gmat;
critique: [x] n. 批评;评论文章;  v. 批判,评论;评论; [acc] /krɪˈtiːk/; [or]gmat;
overtone: [x] n. [声]泛音,暗示,弦外之音;  v. [摄]使曝光过度; [acc] /ˈoʊvərtoʊn/; [or]gmat;
sermonize: [x] v. 说教,讲道; [acc] /ˈsɜːrmənaɪz/; [or]gmat;
antibody: [x] n. [免疫]抗体; [acc] /ˈæntibɑːdi/; [or]gmat;
daylight saving time: [x] phr. 夏时制; [acc] /ˌdeɪlaɪt ˈseɪvɪŋ taɪm/; [or]gmat;
shoplifting: [x] n. 冒充顾客进商店行窃; [acc] /ˈʃɑːplɪftɪŋ/; [or]gmat;
bombardment: [x] n. 炮轰; [acc] /bɑːmˈbɑːrdmənt/; [or]gmat;
impressionable: [x] adj. 敏感的;易受影响的; [acc] /ɪmˈpreʃənəbl/; [or]gmat;
shortfall: [x] n. 不足,亏空; [acc] /ˈʃɔːrtfɔːl/; [or]gmat;
exhaustive: [x] adj. 详尽的;彻底的;消耗的; [acc] /ɪɡˈzɔːstɪv/; [or]gmat;
shut off: [x] phr. 关掉(煤气等),切断,使隔绝,脱离; [acc] /ʃʌt ɑf/; [or]gmat;
simple interest: [x] phr. 单利; [acc] /ˌsɪmpl ˈɪntrəst/; [or]gmat;
desegregation: [x] n. 取消种族隔离; [acc] /ˌdiːˌseɡrɪˈɡeɪʃn/; [or]gmat;
authenticate: [x] v. 鉴定;证明.是真实的; [acc] /ɔːˈθentɪkeɪt/; [or]gmat;
sporadically: [x] adv. 偶尔; [acc] /spəˈrædɪkli/; [or]gmat;
die out: [x] phr. 灭绝,绝种; [acc] /daɪ aʊt/; [or]gmat;
spillover: [x] n. 溢出(量);外流人口(大城市容纳不下的); [acc] /ˈspɪloʊvər/; [or]gmat;
predominate: [x] v. 居支配地位;主宰;在.中占优势; [acc] /prɪˈdɑːmɪneɪt/; [or]gmat;
statutory: [x] adj. 法定的;法令的;可依法惩处的; [acc] /ˈstætʃətɔːri/; [or]gmat;
bring about: [x] phr. 导致,引起; [acc] /brɪŋ əˈbaʊt/; [or]gmat;
proportion: [x] n. 比例;部分;相称;  v. 使成比例;分配; [acc] /prəˈpɔːrʃn/; [or]gmat;
status quo: [x] n. ［拉］现状; [acc] /ˌsteɪtəs ˈkwoʊ/; [or]gmat;
preponderance: [x] n. 优势;多数;占优势; [acc] /prɪˈpɑːndərəns/; [or]gmat;
streptomycin: [x] n. ［药］链霉素; [acc] /ˌstreptə'maɪsɪn/; [or]gmat;
dogwood: [x] n. 木属植物,山茱萸;  adj. 山茱萸科植物的,淡黄褐色的; [acc] /ˈdɔːɡwʊd/; [or]gmat;
stamina: [x] n. 耐力,持久力; [acc] /ˈstæmɪnə/; [or]gmat;
wedge-shaped: [x] adj. 楔形的;v字形的; [acc] /'wedʒˌʃeɪpt/; [or]gmat;
prudery: [x] n. 过分拘谨,假正经; [acc] /ˈpruːdəri/; [or]gmat;
technocrat: [x] n. 技术人员,技术统治; [acc] /ˈteknəkræt/; [or]gmat;
strep throat: [x] n. ［医］脓毒性咽喉炎; [acc] /ˌstrep ˈθroʊt/; [or]gmat;
stumbling block: [x] n. 障碍物,绊脚石; [acc] /ˈstʌmblɪŋ blɑːk/; [or]gmat;
fanatic: [x] n. 狂热者,盲信者;  adj. 狂热的,入迷的,盲信的; [acc] /fəˈnætɪk/; [or]gmat;
credo: [x] n. 信条,教义; [acc] /ˈkriːdoʊ/; [or]gmat;
subcontract: [x] n. 转包合同,分包合同;  v. 承作,转包; [acc] /ˌsʌbˈkɑːntrækt/; [or]gmat;
cash in on: [x] v. 以.获利,营利; [acc] /kæʃ ɪn ɔn/; [or]gmat;
analytic(al): [x] adj. 分析的;分解的; [acc] /ˌænə'lɪtɪkl/; [or]gmat;
wingspan: [x] n. 翼展(相当wingspread); [acc] /ˈwɪŋspæn/; [or]gmat;
suppressant: [x] n. 抑制药;  adj. 制止的,抑制性的,遏抑的; [acc] /səˈpresnt/; [or]gmat;
stake: [x] n. 木桩;赌注;利害关系;股份,股本;(赛马)奖金;  v. 下注,以桩来支撑; [acc] /steɪk/; [or]gmat;
deploy: [x] v. 部署,设置;展开,散开; [acc] /dɪˈplɔɪ/; [or]gmat;
extracurricular: [x] adj. 课外的,业余的,婚外的; [acc] /ˌekstrəkə'rɪkjələ/; [or]gmat;
progression: [x] n. 前进;连续; [acc] /prəˈɡreʃn/; [or]gmat;
entrant: [x] n. 进入者,新成员,参加竞赛者; [acc] /ˈentrənt/; [or]gmat;
take issue: [x] v. 就某事与某人争论; [acc] /teɪk ˈɪʃu/; [or]gmat;
acreage: [x] n. 面积,英亩数; [acc] /ˈeɪkərɪdʒ/; [or]gmat;
take issue with: [x] quant. 与...争论;对...提出异议; [acc] /teɪk ˈɪʃu wɪθ/; [or]gmat;
take over: [x] phr. 接收,接管,接任,夺取; [acc] /teɪk ˈoʊvər/; [or]gmat;
take precedence over: [x] phr. 优先于..,地位在..之上; [acc] /teɪk ˈpresɪdəns ˈoʊvər/; [or]gmat;
automate: [x] v. 使自动化,自动操作; [acc] /ˈɔːtəmeɪt/; [or]gmat;
inventory: [x] n. 详细目录;存货清单; [acc] /ˈɪnvəntɔːri/; [or]gmat;
intestinal: [x] adj. 肠的; [acc] /ɪnˈtestɪnl/; [or]gmat;
canvas: [x] n. 帆布,(帆布)油画; [acc] /ˈkænvəs/; [or]gmat;
euphoria: [x] n. 幸福愉快感; [acc] /juːˈfɔːriə/; [or]gmat;
passbook: [x] n. 存折; [acc] /ˈpæsbʊk/; [or]gmat;
tortillas: [x] n. (墨西哥人用以代替面包的)未经发酵的玉米饼; [acc] /tɔ'tijəz/; [or]gmat;
trade off: [x] v. 交替换位,通过交换抛掉,权衡; [acc] /treɪd ɑf/; [or]gmat;
ration: [x] n. 定量配给;  v. 配给;定量供应; [acc] /ˈræʃn/; [or]gmat;
fava: [x] n. 蚕豆; [acc] /'fɑːvə/; [or]gmat;
traitorous: [x] adj. 叛徒的,不忠的,卖国贼的,奸诈的; [acc] /ˈtreɪtərəs/; [or]gmat;
ironically: [x] adv. 讽刺地;出乎意料地; [acc] /aɪˈrɑːnɪkli/; [or]gmat;
storefront: [x] n. 店面;  adj. 临街的; [acc] /ˈstɔːrfrʌnt/; [or]gmat;
deterrent: [x] n. 威慑物;  v. 威慑的; [acc] /dɪˈtɜːrənt/; [or]gmat;
give way to: [x] phr. 让位于..;让路; [acc] /ɡɪv weɪ tu/; [or]gmat;
encapsulate: [x] v. 装入胶囊,压缩;概述; [acc] /ɪnˈkæpsjuleɪt/; [or]gmat;
ethnocentric: [x] adj. 种族中心主义的,种族(或民族)优越感的; [acc] /ˌeθnoʊˈsentrɪk/; [or]gmat;
turn down: [x] phr. 拒绝;调低;关小; [acc] /tɜrn daʊn/; [or]gmat;
malady: [x] n. 疾病,弊病; [acc] /ˈmælədi/; [or]gmat;
devoid: [x] adj. 全无的,缺乏的; [acc] /dɪˈvɔɪd/; [or]gmat;
updrafts: [x] n. 向上排气,通风; [acc] /ˈəpˌdræfts/; [or]gmat;
predation: [x] n. 捕食;掠夺,抢夺;捕食动物的方法; [acc] /prɪˈdeɪʃn/; [or]gmat;
free market: [x] n. ［经］自由竞争的市场; [acc] /ˌfriː ˈmɑːrkɪt/; [or]gmat;
valance: [x] n. 窗帘上部的框架,帷幔,挂布; [acc] /ˈvæləns/; [or]gmat;
freestanding: [x] adj. ［建］独立式的; [acc] /'friː'stændɪŋ/; [or]gmat;
disorient: [x] v. 使迷失方位,使迷惑; [acc] /dɪs'ɔːrient/; [or]gmat;
boardinghouse: [x] n. 公寓;供膳食的寄宿处; [acc] /'boʊrdɪŋˌhaʊs/; [or]gmat;
school: [x] n. 学校;学院;流派;(鱼,海豚的)一群;  v. 教育; [acc] /skuːl/; [or]gmat;
gingivitis: [x] n. ［医］(齿)龈炎; [acc] /ˌdʒɪndʒɪˈvaɪtəs/; [or]gmat;
give rise to: [x] phr. 引起,发生; [acc] /ɡɪv raɪz tu/; [or]gmat;
Wall Street: [x] n. 华尔街(美金融业集中之地); [acc] /ˈwɔːl striːt/; [or]gmat;
dilution: [x] n. 稀释;冲淡;稀释法; [acc] /daɪˈluːʃn/; [or]gmat;
rancher: [x] n. 牧场经营者; [acc] /ˈræntʃər/; [or]gmat;
graveside: [x] n. 坟墓边;  adj. 在墓旁的;在墓旁发生的; [acc] /'greɪvˌsaɪd/; [or]gmat;
whole number: [x] phr. 整数; [acc] /ˌhoʊl ˈnʌmbər/; [or]gmat;
hadron: [x] n. ［物］强子(一种基本粒子); [acc] /'hædrən/; [or]gmat;
willy-nilly: [x] adj. 犹豫不决的,不容分辨的,随意的;  adv. 乱七八糟地,不管愿不愿意地; [acc] /ˌwɪli ˈnɪli/; [or]gmat;
aerosol: [x] n. 烟雾,［化］气溶,烟雾剂;  adj. 喷雾的,喷雾器的; [acc] /ˈerəsɔːl/; [or]gmat;
wristband: [x] n. (衬衫等的)袖口,腕套,手表带; [acc] /ˈrɪstbænd/; [or]gmat;
radius: [x] n. 半径;范围; [acc] /ˈreɪdiəs/; [or]gmat;
hatchback: [x] n. ［美］有可向上开启天窗的汽车背部; [acc] /ˈhætʃbæk/; [or]gmat;
unwarranted: [x] adj. 未经保证的,无根据的,不合适的; [acc] /ʌnˈwɔːrəntɪd/; [or]gmat;
get by: [x] v. 侥幸躲过,勉强生活; [acc] /ɡet baɪ/; [or]gmat;
liquidation: [x] n. (公司等的)清理,清算,(债务的)清偿,了结;  v. 破坏,毁灭,杀掉; [acc] /ˌlɪkwɪˈdeɪʃn/; [or]gmat;
assemble: [x] v. 装配(机器等);集合;召集; [acc] /əˈsembl/; [or]gmat;
depletion: [x] n. 消耗,损耗,放血; [acc] /dɪˈpliːʃn/; [or]gmat;
briny: [x] n. 海洋;  adj. 很咸的,海水的; [acc] /ˈbraɪni/; [or]gmat;
predisposition: [x] n. 倾向;素质;易染病体质; [acc] /ˌpriːdɪspəˈzɪʃn/; [or]gmat;
basketry: [x] n. (篮,篓,筐等的)编织术,(总称)(篮子等)编织物; [acc] /'bɑskɪtrɪ/; [or]gmat;
reminiscence: [x] n. 回忆,怀旧,引起联想的相似事物; [acc] /ˌremɪˈnɪsns/; [or]gmat;
dysfunction: [x] n. 功能紊乱,机能障碍,官能不良;  v. 功能失调,出现机能障碍,垮掉; [acc] /dɪsˈfʌŋkʃn/; [or]gmat;
dentition: [x] n. 长牙齿,牙列; [acc] /denˈtɪʃn/; [or]gmat;
ibuprofen: [x] n. 布洛芬(镇痛药); [acc] /ˌaɪbjuːˈproʊfen/; [or]gmat;
idioglossia: [x] n. 自解语症(只有自己懂的语言),自语症; [acc] /ɪdɪə'glɔːsɪə/; [or]gmat;
delusion: [x] n. 错觉; [acc] /dɪˈluːʒn/; [or]gmat;
receptive: [x] adj. 善于接受的;能容纳的; [acc] /rɪˈseptɪv/; [or]gmat;
receptor: [x] n. 感觉器官;感受器;受体;接受器;受体;接受器; [acc] /rɪˈseptər/; [or]gmat;
immunological: [x] adj. ［医］免疫学的; [acc] /ˌɪmjunəˈlɑːdʒɪkl/; [or]gmat;
in full bloom: [x] phr. 全盛时期; [acc] /ɪn fʊl blum/; [or]gmat;
get through: [x] v. 完成;穿过;(成功)渡过(困难时期);打通(电话); [acc] /ɡet θru/; [or]gmat;
turbine: [x] n. 汽轮机,叶轮机; [acc] /ˈtɜːrbaɪn/; [or]gmat;
cardiovascular: [x] adj. ［医］心血管的; [acc] /ˌkɑːrdioʊˈvæskjələr/; [or]gmat;
semiarid: [x] adj. 半干旱的; [acc] /ˌsemɪ'ærɪd/; [or]gmat;
catalog: [x] n. 目录,目录册,商品目录;  v. 为..编目录,登记; [acc] /ˈkætəlɔːɡ/; [or]gmat;
encephalitis: [x] n. [内科]脑炎; [acc] /enˌsefəˈlaɪtəs/; [or]gmat;
inpatient: [x] n. 住院病人; [acc] /ˈɪnpeɪʃnt/; [or]gmat;
susceptibility: [x] n. 易感性的,敏感性,感情; [acc] /səˌseptəˈbɪləti/; [or]gmat;
utensil: [x] n. 工具,(厨房)用具; [acc] /juːˈtensl/; [or]gmat;
seniority: [x] n. 年长,资历深,职位高; [acc] /ˌsiːniˈɔːrəti/; [or]gmat;
interdependency: [x] n. 相互依赖,相关性; [acc] /ɪn'tədɪpendənsɪ/; [or]gmat;
interest rate: [x] phr. 利率; [acc] /ˈɪntrəst reɪt/; [or]gmat;
exterior: [x] n. 外表;外貌,外观;  adj. 外部的;外界的;位于外边的;外交上的; [acc] /ɪkˈstɪriər/; [or]gmat;
rehabilitate: [x] v. 使康复,使恢复名誉,使恢复原状; [acc] /ˌriːəˈbɪlɪteɪt/; [or]gmat;
countervail: [x] v. 抵销,对抗,补偿;  adj. 抗衡的;抵消的; [acc] /'kaʊntəˌveɪl/; [or]gmat;
cytology: [x] n. 细胞学; [acc] /saɪˈtɑːlədʒi/; [or]gmat;
protagonist: [x] n. 主角,领导者,积极参加者; [acc] /prəˈtæɡənɪst/; [or]gmat;
lay sb. off: [x] v. 解雇;关闭;停止活动;  n. (临时)解雇期; [acc] /leɪ ˈsʌmbədi ɑf/; [or]gmat;
congested: [x] adj. 拥挤的,密集的; [acc] /kənˈdʒestɪd/; [or]gmat;
prognosis: [x] n. [医]预后;预知; [acc] /prɑːɡˈnoʊsɪs/; [or]gmat;
pull away: [x] phr. 脱身,离开,脱出; [acc] /pʊl əˈweɪ/; [or]gmat;
resplendent: [x] adj. 华丽的,辉煌的; [acc] /rɪˈsplendənt/; [or]gmat;
letup: [x] n. 放松,停顿; [acc] /'letˌʌp/; [or]gmat;
prosthetic: [x] adj. [医]修复术的,弥补性的; [acc] /prɑːsˈθetɪk/; [or]gmat;
fool around: [x] v. 闲荡,干蠢事(或无用,琐悄的事); [acc] /ful əˈraʊnd/; [or]gmat;
delinquency: [x] n. 失职,玩忽职守,拖欠债务,缺点,过错;[法律]少年犯罪,不法行为(青少年),行为不当; [acc] /dɪˈlɪŋkwənsi/; [or]gmat;
punitive: [x] adj. 给予惩罚,刑罚的; [acc] /ˈpjuːnətɪv/; [or]gmat;
pterosaur: [x] n. 翼龙; [acc] /'terəˌsɔː/; [or]gmat;
competence: [x] n. 能力,胜任,称职; [acc] /ˈkɑːmpɪtəns/; [or]gmat;
respire: [x] v. 呼吸; [acc] /rɪˈspaɪər/; [or]gmat;
liquidator: [x] n. 清算人; [acc] /ˈlɪkwɪdeɪtər/; [or]gmat;
list price: [x] phr. 目录价格,标价; [acc] /ˈlɪst praɪs/; [or]gmat;
renovation: [x] n. 修理;恢复; [acc] /ˌrenəˈveɪʃn/; [or]gmat;
live show: [x] n. 现场表演; [acc] /lɪv ʃoʊ/; [or]gmat;
reclamation: [x] n. 开垦,改造,感化,废料回收; [acc] /ˌrekləˈmeɪʃn/; [or]gmat;
ductile: [x] adj. (某些金属)有延展性的;可塑的;易受影响的; [acc] /ˈdʌktaɪl/; [or]gmat;
logotype: [x] n. ［印］连合活字,广告等用的标识; [acc] /'lɒgəˌtaɪp/; [or]gmat;
hypothalamus: [x] n. 下丘脑; [acc] /ˌhaɪpəˈθæləməs/; [or]gmat;
fluctuate: [x] v. 波动;起伏;涨落; [acc] /ˈflʌktʃueɪt/; [or]gmat;
antigen: [x] n. [免疫]抗原; [acc] /ˈæntɪdʒən/; [or]gmat;
debunk: [x] v. 揭穿真面目,证明为假; [acc] /ˌdiːˈbʌŋk/; [or]gmat;
regressive: [x] adj. 回归的,后退的,退化的; [acc] /rɪˈɡresɪv/; [or]gmat;
carcinogen: [x] n. ［医］致癌物,诱癌物; [acc] /kɑːrˈsɪnədʒən/; [or]gmat;
maladaptive: [x] adj. 不适应的; [acc] /ˌmælə'dæptɪv/; [or]gmat;
nutritious: [x] adj. 有营养的,滋养的; [acc] /nuˈtrɪʃəs/; [or]gmat;
mark up: [x] phr. 标记;加价;提高分数; [acc] /mɑːrk ʌp/; [or]gmat;
mark down: [x] v. 降价;  n. 降价; [acc] /mɑrk daʊn/; [or]gmat;
phony: [x] adj. 假的,伪造的;  n. 假冒者;  suf. 表声音; [acc] /ˈfoʊni/; [or]gmat;
retentive: [x] adj. 保持的;吸(水)的;  adv. 有记性地,记性强地;  n. 保持力;〈物〉顽磁性; [acc] /rɪˈtentɪv/; [or]gmat;
compactness: [x] n. 紧密;小巧;紧凑; [acc] /kəmˈpæktnəs/; [or]gmat;
megalithic: [x] adj. 巨石制的,有巨石物征的; [acc] /ˌmeɡəˈlɪθɪk/; [or]gmat;
choreographer: [x] n. 舞蹈编导; [acc] /ˌkɔːriˈɑːɡrəfər/; [or]gmat;
critic: [x] n. 评论家,批判者;挑剔的人; [acc] /ˈkrɪtɪk/; [or]gmat;
topographical: [x] adj. 地形的,地形学的,地形测量的; [acc] /ˌtɑːpəˈɡræfɪkl/; [or]gmat;
seesaw: [x] n. 跷跷板;拉锯局面,不断起伏的状态;  adj. 来回往复的;拉锯式的;  v. 摇摆不定,时起时伏;  adv. 上下动地[的], 前后动地[的],交互地[的],拉锯性地[的]; [acc] /ˈsiː sɔː/; [or]gmat;
topsoil: [x] n. 表层土;上层土;  v. 去掉表土; [acc] /ˈtɑːpsɔɪl/; [or]gmat;
soprano: [x] n. 女高音,女高音歌手,女高音声部;  adj. 女高音的,童声高音的,女高音声部的; [acc] /səˈprɑːnoʊ/; [or]gmat;
optometrist: [x] n. 配镜师,验光师; [acc] /ɑːpˈtɑːmətrɪst/; [or]gmat;
natural number: [x] phr. 自然数; [acc] /ˌnætʃrəl ˈnʌmbər/; [or]gmat;
pharmacologist: [x] n. 药理学家,药物学家; [acc] /ˌfɑːrməˈkɑːlədʒɪst/; [or]gmat;
rhythmical: [x] adj. 有节奏的,有韵律的; [acc] /ˈrɪðmɪk(ə)l/; [or]gmat;
neuroleptic: [x] adj. 抑制精神的,安定的;  n. 安定药,精神抑制药; [acc] /ˌnjʊəˌnʊrə'leptɪk/; [or]gmat;
neutrino: [x] n. 中微子; [acc] /nuːˈtriːnoʊ/; [or]gmat;
contend: [x] v. 争辩;坚决主张;搏斗; [acc] /kənˈtend/; [or]gmat;
incriminate: [x] v. 控告,暗示..有罪; [acc] /ɪnˈkrɪmɪneɪt/; [or]gmat;
preeminence: [x] n. 杰出; [acc] /priː'emɪnəns/; [or]gmat;
polarity: [x] n. (分)极性;相对的观点; [acc] /pəˈlærəti/; [or]gmat;
outgrowth: [x] n. 结果;副产物;自然的发展;分枝; [acc] /ˈaʊtɡroʊθ/; [or]gmat;
adversarial: [x] adj. 敌人的,对手的,对抗的; [acc] /ˌædvərˈseriəl/; [or]gmat;
account for: [x] phr. 解释,说明;(在数量方面)占;对.负责;导致,引起; [acc] /əˈkaʊnt fɔr/; [or]gmat;
sugarcane: [x] n. 甘蔗; [acc] /'ʃʊgəˌkeɪn/; [or]gmat;
ocher: [x] n. ［矿］赭石,(黄)褐色; [acc] /'oʊkə/; [or]gmat;
raffle: [x] n. 废物;抽彩票;  v. 抽彩票; [acc] /ˈræfl/; [or]gmat;
framework: [x] n. 构架,框架,结构;体制,体系; [acc] /ˈfreɪmwɜːrk/; [or]gmat;
retention: [x] n. 保留,保持; [acc] /rɪˈtenʃn/; [or]gmat;
pall: [x] n. 幕;棺罩;遮盖物;  v. 覆盖;使乏味;走味; [acc] /pɔːl/; [or]gmat;
philanthropic: [x] adj. 博爱的,为他人着想的; [acc] /ˌfɪlənˈθrɑːpɪk/; [or]gmat;
velvet: [x] n. 天鹅绒;鹿茸的嫩皮;  adj. 天鹅绒的; [acc] /ˈvelvɪt/; [or]gmat;
prose: [x] n. 散文;  vt. 用散文写,把.改写成散文;平淡无趣地写;啰啰唆唆地讲; [acc] /proʊz/; [or]gmat;
impulse: [x] n. 冲动,脉冲,驱使; [acc] /ˈɪmpʌls/; [or]gmat;
novelty: [x] n. 新奇;新奇的事物;新颖小巧而廉价的小物品;  adj. 新奇的;风格独特的; [acc] /ˈnɑːvlti/; [or]gmat;
bounty: [x] n. 慷慨;赠物;奖金;  vt. 发给.奖金; [acc] /ˈbaʊnti/; [or]gmat;
prominent: [x] adj. 突起的,显眼的;突出的,杰出的; [acc] /ˈprɑːmɪnənt/; [or]gmat;
readily: [x] adv. 容易地;乐意地;欣然地; [acc] /ˈredɪli/; [or]gmat;
fusion: [x] n. 融合,合并,核聚变; [acc] /ˈfjuːʒn/; [or]gmat;
peel: [x] v. 剥皮,削皮,去壳;  n. 果皮,外皮; [acc] /piːl/; [or]gmat;
proclaim: [x] v. 声明,声称;宣告;表明; [acc] /prəˈkleɪm/; [or]gmat;
headquarters: [x] n. 司令部,指挥部;总部,总局; [acc] /ˈhedkwɔːrtərz/; [or]gmat;
diverge: [x] v. 分歧,分开; [acc] /daɪˈvɜːrdʒ/; [or]gmat;
senate: [x] n. 参议院,上院; [acc] /ˈsenət/; [or]gmat;
promising: [x] adj. 有前途的,有希望的;(前景)光明的; [acc] /ˈprɑːmɪsɪŋ/; [or]gmat;
supplement: [x] n. 增补,补充物,保健品;附录;  v. 补充; [acc] /ˈsʌplɪmənt/; [or]gmat;
gauge: [x] n. 测量仪;尺度,标准;  v. 估计,判断;计量; [acc] /ɡeɪdʒ/; [or]gmat;
fluid: [x] n. 流体,液体;  adj. 流动的;易变的;流畅的; [acc] /ˈfluːɪd/; [or]gmat;
shave: [x] v. 剃,刮;  n. 剃须,修面,剃刀; [acc] /ʃeɪv/; [or]gmat;
insight: [x] n. 深刻的理解,洞察力,见识; [acc] /ˈɪnsaɪt/; [or]gmat;
rug: [x] n. (小)地毯;围毯;男子假发; [acc] /rʌɡ/; [or]gmat;
undermine: [x] v. 暗中破坏;逐渐削弱;侵蚀.的基础;在...下挖坑道,从根基处损害; [acc] /ˌʌndərˈmaɪn/; [or]gmat;
trim: [x] n. 修剪;整齐;装饰;  v. 修剪;整理;装饰;  adj. (人)苗条的;整洁的;  adv. 整齐[整洁]地; [acc] /trɪm/; [or]gmat;
diplomatic: [x] adj. 外交的,从事外交的;老练的,圆滑的; [acc] /ˌdɪpləˈmætɪk/; [or]gmat;
humanitarian: [x] n. 慈善家;人道主义者;博爱主义者;  adj. 人道主义者的;慈善的;博爱的; [acc] /hjuːˌmænɪˈteriən/; [or]gmat;
discourse: [x] n. 交谈,演讲,论述,讲道;  v. 演讲,谈论; [acc] /ˈdɪskɔːrs/; [or]gmat;
progressive: [x] adj. 进步的;逐步的,渐进的;  n. 进步人士; [acc] /prəˈɡresɪv/; [or]gmat;
yeast: [x] n. 酵母,发酵物;兴奋; [acc] /jiːst/; [or]gmat;
upgrade: [x] v. 升级;提高;  n. 改善,提高;升级;升舱; [acc] /ˈʌpɡreɪd/; [or]gmat;
string: [x] n. 弦,线,细绳,一系列;一行;  v. 串起;悬挂;使紧张;  adj. 线的,线织的;由弦乐器组成的; [acc] /strɪŋ/; [or]gmat;
multitude: [x] n. 大量;众多;大批;群众; [acc] /ˈmʌltɪtuːd/; [or]gmat;
medium: [x] adj. 中等的;适中的;  n. 手段;媒介;材料; [acc] /ˈmiːdiəm/; [or]gmat;
signify: [x] vi. 具有重要性;  vt. 表示; [acc] /ˈsɪɡnɪfaɪ/; [or]gmat;
rating: [x] n. 评价;等级;等级评定;额定功率;评分,收视率; [acc] /ˈreɪtɪŋ/; [or]gmat;
implement: [x] n. 工具;器具;  v. 实施,执行;执行; [acc] /ˈɪmplɪment/; [or]gmat;
optimism: [x] n. 乐观,乐观主义; [acc] /ˈɑːptɪmɪzəm/; [or]gmat;
separate: [x] adj. 独立的;分开的;单独的;  v. 使分开,分离,分割,划分; [acc] /ˈsepəreɪt/; [or]gmat;
petroleum: [x] n. 石油; [acc] /pəˈtroʊliəm/; [or]gmat;
regiment: [x] n. (军队)团;  v. 组编成团;严格控制; [acc] /ˈredʒɪmənt/; [or]gmat;
embrace: [x] v. 拥抱;包含;欣然接受,乐意采纳;  n. 拥抱;接受;领会; [acc] /ɪmˈbreɪs/; [or]gmat;
household: [x] n. 同住在一家的人;家务;家常普通的;  adj. 家庭的,家内的,一家的;家喻户晓的; [acc] /ˈhaʊshoʊld/; [or]gmat;
dose: [x] n. (药)剂量,用量,一剂;  vt. 给..服药; [acc] /doʊs/; [or]gmat;
implicit: [x] adj. 隐含的;盲目的;完全的,绝对的;成为一部分的; [acc] /ɪmˈplɪsɪt/; [or]gmat;
prey: [x] n. 被掠食者,猎物;牺牲者;  v. 使..苦恼;  vi. 捕食;受..控制; [acc] /preɪ/; [or]gmat;
discrete: [x] adj. 分开的;不连续的; [acc] /dɪˈskriːt/; [or]gmat;
hide: [x] vt. 躲藏,把.藏起来;隐瞒;  n. 藏身处;隐密场所,隐蔽处;(尤指买卖或用作皮革的)皮;兽皮;人身安全; [acc] /haɪd/; [or]gmat;
swiftly: [x] adv. 迅速地,敏捷地; [acc] /ˈswɪftli/; [or]gmat;
lot: [x] pron. 大量,许多;场地;一批;某一类人;  adv. (与形容词和副词连用)很;非常;(与动词连用)非常;  v. 分组;把.划分(常与out连用);把(土地)划分成块;抽签;拈阄; [acc] /lɑːt/; [or]gmat;
spiced: [x] adj. 五香的,调过味的,含香料的; [acc] /spaɪst/; [or]gmat;
[kk9: GMAT/3000]