default: [n]违约;缺席;缺乏;默认; [vi]不履行义务;拖欠; [vt]不履行;不参加; [acc]/dɪˈfɔːlt/; [or]gre3k;
prudent: [adj]谨慎的,精明的; [acc]/ˈpruːdnt/; [or]gre3k;
appropriate: [adj]合适的;适当的; [v]挪用;拨款;私占; [acc]/əˈproʊpriət/; [or]gre3k;
tackle: [v]对付,处理;(足球等比赛中)阻截; [n]阻截;钓具;滑轮(组); [acc]/ˈtækl/; [or]gre3k;
monarch: [n]君主;帝王;统治者; [acc]/ˈmɑːnərk/; [or]gre3k;
obstruct: [v]阻碍,妨碍,阻塞,堵塞; [acc]/əbˈstrʌkt/; [or]gre3k;
acknowledge: [v]告知收到;对(人)打招呼,招呼(某人)以示相识,致意;就..表示谢忱,鸣谢,感谢,感激,答谢,对..表示感谢;承认(属实),承认(权威,地位); [acc]/əkˈnɑːlɪdʒ/; [or]gre3k;
chagrin: [n]懊恼;委屈;气愤; [v]使.懊恼; [acc]/ʃəˈɡrɪn/; [or]gre3k;
motto: [n]座右铭;格言;箴言;口号; [acc]/ˈmɑːtoʊ/; [or]gre3k;
imprudent: [adj]轻率的,鲁莽的; [acc]/ɪmˈpruːdnt/; [or]gre3k;
emulate: [v]努力赶上(超过),仿效; [n]仿真; [acc]/ˈemjuleɪt/; [or]gre3k;
groggy: [adj]体弱的;摇摇晃晃的,踉踉跄跄的;头昏眼花的; [acc]/ˈɡrɑːɡi/; [or]gre3k;
morbid: [adj]疾病的;(精神等)病态的;恐怖的; [acc]/ˈmɔːrbɪd/; [or]gre3k;
pitfall: [n]陷阱,未料到的危险或困难; [acc]/ˈpɪtfɔːl/; [or]gre3k;
repartee: [n]机敏的应答,妙语,巧辩; [acc]/ˌrepɑːrˈtiː/; [or]gre3k;
trespass: [v]侵入;犯罪; [n]罪过;非法侵入; [acc]/ˈtrespæs/; [or]gre3k;
retard: [v]延迟,使减速; [n]妨碍,阻碍; [acc]/rɪˈtɑːrd/; [or]gre3k;
contemplate: [v]沉思;对..周密考虑;注视; [acc]/ˈkɑːntəmpleɪt/; [or]gre3k;
deplore: [v]谴责;对...深感遗憾;悲悼;痛惜; [acc]/dɪˈplɔːr/; [or]gre3k;
inalienable: [adj]不可分割的; [acc]/ɪnˈeɪliənəbl/; [or]gre3k;
motivate: [vt]激励;使有动机;促进;促动;激发..的积极性; [acc]/ˈmoʊtɪveɪt/; [or]gre3k;
appeal: [vi]呼吁,请求;申诉;有吸引力; [n]呼吁;恳求;(为慈善或好的事业所做的) 筹款努力;(人或物的)吸引力; [acc]/əˈpiːl/; [or]gre3k;
steadfast: [adj]坚定的;不变的; [acc]/ˈstedfæst/; [or]gre3k;
purity: [n]纯洁;纯净;纯正;纯粹; [acc]/ˈpjʊrəti/; [or]gre3k;
flaw: [n]瑕疵;缺点; [v]使有缺陷;使不完美;有瑕疵; [acc]/flɔː/; [or]gre3k;
conform: [vi]一致;遵照,顺从;符合; [vt]使一致;使遵照; [adj]一致的; [acc]/kənˈfɔːrm/; [or]gre3k;
misanthropic: [adj]厌恶人类的,不愿与人来往的; [acc]/ˌmɪsənˈθrɑːpɪk/; [or]gre3k;
detach: [v]使分开,拆卸;派遣; [acc]/dɪˈtætʃ/; [or]gre3k;
fender: [n]火炉围栏;挡泥板,防护板;(汽车的)保险杠; [acc]/ˈfendər/; [or]gre3k;
sophisticated: [adj](仪器)精密的,复杂的;老于世故的,老练的,富有经验的;高雅的,精致的; [acc]/səˈfɪstɪkeɪtɪd/; [or]gre3k;
gargantuan: [adj]巨大的,庞大的; [acc]/ɡɑːrˈɡæntʃuən/; [or]gre3k;
sanctimonious: [adj]伪装虔诚的;道貌岸然的; [acc]/ˌsæŋktɪˈmoʊniəs/; [or]gre3k;
faction: [n]派别,小集团,小派系;派系斗争,内讧; [acc]/ˈfækʃn/; [or]gre3k;
aspersion: [n]诽谤,中伤; [acc]/ə'spɜːʒən/; [or]gre3k;
eminent: [adj]显赫的;杰出的;有名的;(品质)优良的; [acc]/ˈemɪnənt/; [or]gre3k;
flatter: [v]阿谀,使高兴;(肖像等)胜过(真人真物);自鸣得意,自以为是; [acc]/ˈflætər/; [or]gre3k;
mite: [n]极小量,小虫; [acc]/maɪt/; [or]gre3k;
respite: [n]缓解;暂缓;暂时的休息;缓期执行; [v]使缓解;使暂缓;使延期;缓期执行; [acc]/ˈrespɪt/; [or]gre3k;
ingenuity: [n]机灵,心灵手巧,富于创造天赋; [acc]/ˌɪndʒəˈnuːəti/; [or]gre3k;
reel: [n]卷盘; [v]旋转;感到震惊;眩晕; [acc]/riːl/; [or]gre3k;
mime: [n]哑剧演员,小丑,笑剧,丑角; [v]作摹拟表演; [acc]/maɪm/; [or]gre3k;
reluctant: [adj]不情愿的;勉强的; [acc]/rɪˈlʌktənt/; [or]gre3k;
asylum: [n]精神病院,疯人院;避难所; [acc]/əˈsaɪləm/; [or]gre3k;
bonhomie: [n]欢乐友好的氛围; [acc]/ˌbɑːnəˈmiː/; [or]gre3k;
scorch: [v]烧焦;枯萎; [vi]高速行驶,疾驰,飞驰; [acc]/skɔːrtʃ/; [or]gre3k;
finicky: [adj]苛求的,过份讲究的; [acc]/ˈfɪnɪki/; [or]gre3k;
lofty: [adj]极高的,巍峨的;崇高的;高傲的; [acc]/ˈlɔːfti/; [or]gre3k;
strip: [v]剥;夺去;脱衣服; [n]长条;长条形土地; [adj]脱衣舞的;被剥去外皮的; [acc]/strɪp/; [or]gre3k;
vaccinate: [v]进行预防接种; [n]被接种牛痘者; [acc]/ˈvæksɪneɪt/; [or]gre3k;
abuse: [v]虐待;辱骂;(对麻醉毒品,兴奋剂等的)非法服用;滥用; [n]滥用;虐待;辱骂; [acc]/əˈbjuːs/; [or]gre3k;
deluge: [n]洪水;暴雨;泛滥; [v]使泛滥;压倒; [acc]/ˈdeljuːdʒ/; [or]gre3k;
pessimistic: [adj]悲观(主义)的; [acc]/ˌpesɪˈmɪstɪk/; [or]gre3k;
usurp: [vi]篡夺,篡位; [vt]篡夺,强夺; [acc]/juːˈzɜːrp/; [or]gre3k;
elicit: [v]引出;诱出;探出; [acc]/iˈlɪsɪt/; [or]gre3k;
tacit: [adj]心照不宣的,静默的; [acc]/ˈtæsɪt/; [or]gre3k;
orient: [n][the Orient]东方; [v]定..的方位; [adj]东方的;(太阳等)上升的,新生的;闪闪发光的; [acc]/ˈɔːrient/; [or]gre3k;
sedentary: [adj]久坐不动的;静止的;坐惯的,定栖的; [acc]/ˈsednteri/; [or]gre3k;
coarse: [adj]粗糙的;粗俗的;粗鲁的; [acc]/kɔːrs/; [or]gre3k;
hilarious: [adj]有趣的;令人捧腹的;滑稽的;欢闹的; [acc]/hɪˈleriəs/; [or]gre3k;
denouement: [n]结局,终场; [acc]/ˌdeɪnuːˈmɑ̃ː/; [or]gre3k;
adulate: [v]谄媚,奉承; [acc]/'ædʒəˌleɪt/; [or]gre3k;
stentorian: [adj](指声音)极响亮的; [acc]/stenˈtɔːriən/; [or]gre3k;
mongrel: [n]杂种动物,混血儿; [adj]杂种的;杂交的;混血的; [acc]/ˈmʌŋɡrəl/; [or]gre3k;
conservative: [adj]保守的;保守估计的;保守党的; [n]保守主义者;保守党党员; [acc]/kənˈsɜːrvətɪv/; [or]gre3k;
predilection: [n]偏好; [acc]/ˌpredlˈekʃn/; [or]gre3k;
gallant: [adj]勇敢的;(男子对女子)殷勤的; [v]向(女子)献殷勤;护卫;求爱; [n](尤指对女子殷勤的)时髦男子; [acc]/ˈɡælənt/; [or]gre3k;
gangly: [adj]身材痩长的; [acc]/ˈɡæŋɡli/; [or]gre3k;
facilitate: [v]为他人提供方便;使便利; [vt]促进; [acc]/fəˈsɪlɪteɪt/; [or]gre3k;
coerce: [v]强迫,压制; [acc]/koʊˈɜːrs/; [or]gre3k;
convenience: [n]方便;便利设施; [acc]/kənˈviːniəns/; [or]gre3k;
obligatory: [adj]强制性的;义务的;必须的; [acc]/əˈblɪɡətɔːri/; [or]gre3k;
recumbent: [adj]斜倚的;休息的; [n]〈口〉座位斜靠式自行车; [acc]/rɪˈkʌmbənt/; [or]gre3k;
repel: [v]击退,驱逐;排斥,抵制;使厌恶,使反感;使恐惧; [acc]/rɪˈpel/; [or]gre3k;
mitigate: [v]减轻,缓和; [acc]/ˈmɪtɪɡeɪt/; [or]gre3k;
segment: [n]部分;片段;(橘子等的)瓣; [v]分割; [acc]/ˈseɡmənt/; [or]gre3k;
dominant: [adj]主要的,占优势的,支配的,统治的;显性基因的; [acc]/ˈdɑːmɪnənt/; [or]gre3k;
shadow: [n]阴影;影子; [v]把影子投在..;盯梢; [acc]/ˈʃædoʊ/; [or]gre3k;
exceptional: [adj]优越的,杰出的;异常的; [acc]/ɪkˈsepʃənl/; [or]gre3k;
homogenize: [vi]变均匀; [vt]使均匀,使类同; [acc]/həˈmɑdʒəˌnaɪz/; [or]gre3k;
surveillance: [n]监视;检查; [acc]/sɜːrˈveɪləns/; [or]gre3k;
dubious: [adj]可疑的;怀疑的;无把握的; [acc]/ˈduːbiəs/; [or]gre3k;
tact: [n]机智,得体,老练,圆滑; [acc]/tækt/; [or]gre3k;
despicable: [adj]可鄙的,卑劣的; [acc]/dɪˈspɪkəbl/; [or]gre3k;
quaver: [v]颤抖,发颤音; [n]八分音符,颤音; [acc]/ˈkweɪvər/; [or]gre3k;
vicious: [adj]罪恶的;恶意的;凶猛的,残忍的; [acc]/ˈvɪʃəs/; [or]gre3k;
extravagant: [adj]奢侈的,无节制的; [acc]/ɪkˈstrævəɡənt/; [or]gre3k;
peeve: [v]打扰,惹恼; [n]怨恨;麻烦的事物;触怒; [acc]/piːv/; [or]gre3k;
importune: [v]强求,胡搅蛮缠; [adj]同"importunate"; [acc]/ˌɪmpɔːrˈtuːn/; [or]gre3k;
erudite: [adj]博学的,有学问的; [n]饱学之士,有学问的人; [acc]/ˈerudaɪt/; [or]gre3k;
bogus: [adj]假的,假装的; [n]伪币;冒牌货; [acc]/ˈboʊɡəs/; [or]gre3k;
carouse: [v]畅饮,欢宴; [acc]/kəˈraʊz/; [or]gre3k;
reserved: [adj]保留的,留作专用的;矜持的,缄默的,有节制的; [acc]/rɪˈzɜːrvd/; [or]gre3k;
pinpoint: [v]准确地解释或说明; [adj]精确的; [n]针尖,极小之物,极不重要的事物; [acc]/ˈpɪnpɔɪnt/; [or]gre3k;
supersede: [v]代替;紧接着而到来; [acc]/ˌsuːpərˈsiːd/; [or]gre3k;
subject: [n]科目;主题;受试者;国民; [adj]易患的,服从的; [vt]使服从,使隶属,使遭遇; [acc]/ˈsʌbdʒɪkt/; [or]gre3k;
project: [n]项目,工程;专题研究;课题方案; [v]映射,放映;计划,设计,打算,拟订方案;投掷,发射,喷射;表明..的特性,使呈现特性;阐述;突出,伸出;估计,预估; [acc]/ˈprɑːdʒekt/; [or]gre3k;
subordinate: [n]部下;下属; [adj]次要的;从属的;下级的; [v]使从属于;使处于次要地位; [acc]/səˈbɔːrdɪnət/; [or]gre3k;
insubordinate: [adj]不服从的,反抗的; [acc]/ˌɪnsəˈbɔːrdɪnət/; [or]gre3k;
strength: [n]体力,力气,力量;意志力;长处;兵力;实力;人手;浓度,效力;力度,速度; [acc]/streŋθ/; [or]gre3k;
tint: [n]色彩;染发剂;染色; [v]染色,着色于.; [acc]/tɪnt/; [or]gre3k;
motley: [adj]混杂的,杂色的; [n]混杂;杂色衣服;小丑; [acc]/ˈmɑːtli/; [or]gre3k;
tinge: [n]淡淡的(颜色,神色),轻微,少量; [v]给.染色,轻微地影响; [acc]/tɪndʒ/; [or]gre3k;
tinker: [n](流动的)补锅工人; [v]做拙劣修补; [acc]/ˈtɪŋkər/; [or]gre3k;
court: [n]法院,法庭;庭院;球场;宫廷; [v]讨好,取悦;招致危险;追求; [acc]/kɔːrt/; [or]gre3k;
courteous: [adj]有礼貌的,谦恭有礼的; [acc]/ˈkɜːrtiəs/; [or]gre3k;
advocate: [v]提倡;主张;为.辩护; [n]辩护者;提倡者;律师; [acc]/ˈædvəkeɪt/; [or]gre3k;
paunchy: [adj]大腹便便,大肚子的; [acc]/ˈpɔːntʃi/; [or]gre3k;
verify: [v]查证,证明,证实; [acc]/ˈverɪfaɪ/; [or]gre3k;
equivocate: [v]模棱两可地说,支吾其词; [acc]/ɪˈkwɪvəkeɪt/; [or]gre3k;
verisimilar: [adj]逼真的; [acc]/ˌverə'sɪmələ/; [or]gre3k;
bound: [adj]受约束的;有义务的;一定的; [v]束缚;跳跃着前行; [n]跳跃;范围;界限; [acc]/baʊnd/; [or]gre3k;
considerable: [adj]相当大的;重要的;可观的; [acc]/kənˈsɪdərəbl/; [or]gre3k;
obscure: [v]隐藏,使.模糊;使变暗;遮掩; [adj]不清楚的;难以理解的; [n]某种模糊的或不清楚的东西; [acc]/əbˈskjʊr/; [or]gre3k;
cast: [v]投;抛下,投射(光线和阴影);瞥,飞快看(一眼),扫视;掷;放钓;投票;选定演员; [n]投掷物;铸件;演员表,演员阵容; [acc]/kæst/; [or]gre3k;
authority: [n]权威;威信;当局,官方;权力,职权; [acc]/əˈθɔːrəti/; [or]gre3k;
original: [adj]有独创性的,原始的,最初的,新颖的; [n]原件;怪人; [acc]/əˈrɪdʒənl/; [or]gre3k;
religion: [n]宗教;宗教信仰;宗教生活;虔诚的追求; [acc]/rɪˈlɪdʒən/; [or]gre3k;
lissome: [adj]柔软的,敏捷的,轻盈的; [acc]/'lɪsəm/; [or]gre3k;
conviction: [n]定罪;信服;坚强信念; [acc]/kənˈvɪkʃn/; [or]gre3k;
spent: [adj]精疲力竭的; [acc]/spent/; [or]gre3k;
military: [n]军队; [adj]军事的; [acc]/ˈmɪləteri/; [or]gre3k;
legion: [n](古罗马)军团,众多,军队; [adj]众多的,大量的; [acc]/ˈliːdʒən/; [or]gre3k;
movement: [n]动作,移动;运动;(交响乐)乐章; [acc]/ˈmuːvmənt/; [or]gre3k;
sin: [n]罪;罪孽;错误; [v]违犯戒律;犯过失; [acc]/sɪn/; [or]gre3k;
guilt: [n]内疚;罪行;罪恶感; [acc]/ɡɪlt/; [or]gre3k;
claim: [v]声称;要求;断言;主张;认领;索赔; [n]索赔;主张;声称;断言;要求; [acc]/kleɪm/; [or]gre3k;
acclaim: [n]欢呼,赞扬,称赞; [v]欢呼,喝彩,鼓掌欢迎; [vt]鼓掌欢迎,向.欢呼,为.喝彩;推选; [acc]/əˈkleɪm/; [or]gre3k;
shallow: [adj]浅的;肤浅的; [v]变浅;使变浅; [n]浅滩;浅处; [acc]/ˈʃæloʊ/; [or]gre3k;
check: [v]检查;阻止; [n]支票;阻止;检查;阻止物; [acc]/tʃek/; [or]gre3k;
telling: [adj]明显的;生动的; [n]叙述; [acc]/ˈtelɪŋ/; [or]gre3k;
principal: [n]校长,负责人;本金,资本; [adj]主要的,首要的; [acc]/ˈprɪnsəpl/; [or]gre3k;
slight: [adj]轻微的,微小的;纤细的,瘦弱的;少量的; [n]轻视,蔑视; [vt]轻视,忽略; [acc]/slaɪt/; [or]gre3k;
consequence: [n]结果,后果;重要性; [acc]/ˈkɑːnsɪkwens/; [or]gre3k;
tender: [adj]温柔的;嫩的;柔弱的,脆弱的;痛的; [n]煤水车,附属船;投标; [v]提出(希望对方接受的意见等); [acc]/ˈtendər/; [or]gre3k;
vessel: [n]船,容器,血管; [acc]/ˈvesl/; [or]gre3k;
mobile: [n]风铃,悬挂饰物;手机,移动电话; [adj]可移动的;行动方便的; [acc]/ˈmoʊbl/; [or]gre3k;
content: [n]内容,目录;满足; [adj]满足的; [v]使满意; [acc]/ˈkɑːntent/; [or]gre3k;
countenance: [n]面容,表情,气色; [v]支持,赞成; [acc]/ˈkaʊntənəns/; [or]gre3k;
don: [n]指导教师,大学教师;先生,阁下; [vt]穿上; [acc]/dɑːn/; [or]gre3k;
credit: [n]信用;荣誉;学分;信贷;称赞;债权; [v]信赖;归因于;记学分; [acc]/ˈkredɪt/; [or]gre3k;
terror: [n]恐怖,惊骇; [acc]/ˈterər/; [or]gre3k;
harry: [v]折磨,掠夺,骚扰; [n]恶魔,恶鬼;胡闹的青年人;伦敦佬;(人名)哈里; [acc]/ˈhæri/; [or]gre3k;
entrance: [n]入口,通道,大门口;出场,登场;进入权; [v]使出神,使入迷; [acc]/ˈentrəns/; [or]gre3k;
release: [v]释放;解放;发行; [n]解除;免除;发表; [acc]/rɪˈliːs/; [or]gre3k;
committed: [adj]效忠的;忠于.的;坚信的; [acc]/kəˈmɪtɪd/; [or]gre3k;
worship: [v]崇拜,爱戴;做礼拜,拜神; [n]礼拜,礼拜仪式;崇拜,敬仰; [acc]/ˈwɜːrʃɪp/; [or]gre3k;
strike: [v]击打;袭击;罢工; [n]罢工;打击;袭击; [acc]/straɪk/; [or]gre3k;
comply: [vi]依从,服从,遵守; [acc]/kəmˈplaɪ/; [or]gre3k;
devoted: [adj]虔诚的,投入的; [acc]/dɪˈvoʊtɪd/; [or]gre3k;
impious: [adj]不敬神的,不虔诚的,不孝的; [acc]/ɪmˈpaɪəs/; [or]gre3k;
stock: [n]股票;股份;存货;储备;家畜; [v]给..装满;储存; [adj]储备的; [acc]/stɑːk/; [or]gre3k;
wicked: [adj]邪恶的,恶毒的;淘气的,恶作剧的; [n]恶人;邪恶的人; [adv]用作加强语气用; [acc]/ˈwɪkɪd/; [or]gre3k;
earnest: [adj]真诚的,诚挚的,认真的; [n]认真,严肃; [acc]/ˈɜːrnɪst/; [or]gre3k;
license: [n]许可;执照; [v]许可,准许;发许可证; [acc]/ˈlaɪsns/; [or]gre3k;
consent: [n]同意,准许;赞成; [v]同意; [acc]/kənˈsent/; [or]gre3k;
severe: [adj]严重的;严厉的;严酷的;剧烈的; [acc]/sɪˈvɪr/; [or]gre3k;
eternal: [adj]永恒的,永不改变的; [acc]/ɪˈtɜːrnl/; [or]gre3k;
absolute: [adj]完全的;绝对的;纯粹的; [acc]/ˈæbsəluːt/; [or]gre3k;
argument: [n]争吵,争论,辩论;论据,论点; [acc]/ˈɑːrɡjumənt/; [or]gre3k;
rage: [n]极怒;盛怒; [v]迅速蔓延,快速扩散;(战争等)激烈地进行; [acc]/reɪdʒ/; [or]gre3k;
expedition: [n]远征队;探险;短途旅行;迅速; [acc]/ˌekspəˈdɪʃn/; [or]gre3k;
reign: [v]占主导地位,统治,当政; [n](君主)统治时期; [acc]/reɪn/; [or]gre3k;
humble: [adj]卑微的;(级别或地位)低下的,简陋的;谦逊的; [v]使⋯谦逊,使⋯卑下;轻松打败(尤指强大的对手); [acc]/ˈhʌmbl/; [or]gre3k;
fleet: [n]舰队,船队;车队; [adj]迅速的; [acc]/fliːt/; [or]gre3k;
liability: [n]责任;债务;倾向;可能性;不利因素;惹麻烦的人(或事); [acc]/ˌlaɪəˈbɪləti/; [or]gre3k;
wit: [n]富有机智的人;智力,才智;机智;风趣,措辞巧妙的能力; [acc]/wɪt/; [or]gre3k;
agreeable: [adj](欣然)同意的;愉快的;可以接受的; [acc]/əˈɡriːəbl/; [or]gre3k;
utter: [v]说,发出;发射; [adj]完全的;彻底的;无条件的; [acc]/ˈʌtər/; [or]gre3k;
issue: [n]问题;议题;发行物;子女; [v]发行;发布;分配,分发,给; [acc]/ˈɪʃuː/; [or]gre3k;
dispatch: [v]派遣,调遣;发送(信件,电报等);结束,摆脱掉;匆匆办完; [vt]处决; [n]派遣,调遣;发送;快信,急件;迅速,敏捷; [acc]/dɪˈspætʃ/; [or]gre3k;
verse: [n]诗句,诗节,诗; [acc]/vɜːrs/; [or]gre3k;
enthusiasm: [n]热情,热心,热忱;热衷的活动,热爱的事物; [acc]/ɪnˈθuːziæzəm/; [or]gre3k;
magnificent: [adj]华丽的,宏伟的,壮丽的; [acc]/mæɡˈnɪfɪsnt/; [or]gre3k;
wretched: [adj]可怜的;恶劣的;身心疲惫的; [acc]/ˈretʃɪd/; [or]gre3k;
solid: [adj]结实的;坚固的;固体的; [n]固体; [acc]/ˈsɑːlɪd/; [or]gre3k;
equivalent: [adj]相等的;等值的; [n]同义词;等价物; [acc]/ɪˈkwɪvələnt/; [or]gre3k;
frequent: [adj]时常的,频繁的; [v]常去,常到; [acc]/ˈfriːkwənt/; [or]gre3k;
permanent: [adj]永久的,持久的; [n]电烫发; [acc]/ˈpɜːrmənənt/; [or]gre3k;
aspect: [n]外表,面貌;(问题等的)方面; [acc]/ˈæspekt/; [or]gre3k;
dread: [v]惧怕,害怕; [n]畏惧,恐惧; [adj]恐怖的,使人敬畏的; [acc]/dred/; [or]gre3k;
desperate: [adj]绝望的;孤注一掷的;极需要的,渴望的;(情况) 极严重的;极危险的;很危急的; [acc]/ˈdespərət/; [or]gre3k;
contempt: [n]轻视,鄙视; [acc]/kənˈtempt/; [or]gre3k;
idle: [adj]空闲的;懒散的; [v]无所事事;虚度;空转;使空转; [vt]虚度; [acc]/ˈaɪdl/; [or]gre3k;
pen: [n]笔,钢笔;围栏,畜栏; [v]书写;关押,监禁; [acc]/pen/; [or]gre3k;
prospect: [n]前景,展望;视野;景象; [v]勘察;有前途;勘探;对..进行仔细调查; [acc]/ˈprɑːspekt/; [or]gre3k;
vague: [adj]含糊的,模糊的,不明确的,茫然的; [n]模糊不定状态; [acc]/veɪɡ/; [or]gre3k;
infinite: [adj]无限的,无穷的;无数的; [n]无穷,无限大; [acc]/ˈɪnfɪnət/; [or]gre3k;
oath: [n]誓言;誓约;咒骂;咒语; [acc]/oʊθ/; [or]gre3k;
intimate: [adj]亲密的,密切的;详细的; [v]暗示;宣布,通知; [n]密友,知己; [acc]/ˈɪntɪmət/; [or]gre3k;
swear: [v]发誓,郑重地说;咒骂; [acc]/swer/; [or]gre3k;
apt: [adj]恰当的;有(做某事的)倾向; [acc]/æpt/; [or]gre3k;
fury: [n]狂怒,暴怒; [acc]/ˈfjʊri/; [or]gre3k;
royalty: [n]皇家,王族,皇族;版税;专利费; [acc]/ˈrɔɪəlti/; [or]gre3k;
signal: [n]信号;预兆; [v]发信号;标志; [adj]显著的,优越的;暗号的,作信号用的; [acc]/ˈsɪɡnəl/; [or]gre3k;
wanting: [adj]欠缺的,不足的,不够格的; prep. 缺; [acc]/ˈwɑːntɪŋ/; [or]gre3k;
liberal: [n]开明的人,自由主义者; [adj]慷慨的;心胸宽阔的;自由主义的; [acc]/ˈlɪbərəl/; [or]gre3k;
cardinal: [adj]主要的;基本的; [n][天主教]枢机主教,红衣主教;基数; [acc]/ˈkɑːrdɪnl/; [or]gre3k;
gloomy: [adj]愁容满面的,阴暗的,没有希望的; [acc]/ˈɡluːmi/; [or]gre3k;
absurd: [adj]荒唐的;可笑的;不合理的; [n]荒唐; [acc]/əbˈsɜːrd/; [or]gre3k;
wilt: [v]使.凋谢,枯萎; [n]枯萎;憔悴; [acc]/wɪlt/; [or]gre3k;
misfortune: [n]不幸,灾祸; [acc]/ˌmɪsˈfɔːrtʃuːn/; [or]gre3k;
testimony: [n]证据,证词;表明,说明;见证,证明; [acc]/ˈtestɪmoʊni/; [or]gre3k;
absent: [adj]缺席的,不在的;心不在焉的,出神的; [v]缺席;使缺席; prep. 缺乏; [acc]/ˈæbsənt/; [or]gre3k;
feeble: [adj]虚弱的; [acc]/ˈfiːbl/; [or]gre3k;
indifferent: [adj]不感兴趣的,不关心的;平庸的;冷漠的; [acc]/ɪnˈdɪfrənt/; [or]gre3k;
novel: [n]小说,长篇故事; [adj]新奇的,新颖的,不同的; [acc]/ˈnɑːvl/; [or]gre3k;
revenge: [n]报仇;报复; [v]为.报仇,报.之仇; [acc]/rɪˈvendʒ/; [or]gre3k;
zeal: [n]热情,热心; [acc]/ziːl/; [or]gre3k;
steep: [v]沉浸于..; [adj]陡峭的;急剧的;过高的; [n]陡坡; [acc]/stiːp/; [or]gre3k;
saddle: [n]鞍;鞍部; [v]给马装鞍具;装鞍具;使负重担; [acc]/ˈsædl/; [or]gre3k;
scorn: [n]鄙视; [v]轻蔑;对.不屑一顾; [acc]/skɔːrn/; [or]gre3k;
exquisite: [adj]精致的,精选的;细腻的;强烈的; [n]过分讲究穿戴的人; [acc]/ɪkˈskwɪzɪt/; [or]gre3k;
convey: [v]传送,运送;表达,传达; [acc]/kənˈveɪ/; [or]gre3k;
sincere: [adj]真诚的,诚恳的; [acc]/sɪnˈsɪr/; [or]gre3k;
sensation: [n]感觉;知觉;轰动; [acc]/senˈseɪʃn/; [or]gre3k;
specific: [adj]具体的,明确的;特定的;特殊的;针对..的; [n]详情;特性; [acc]/spəˈsɪfɪk/; [or]gre3k;
stiff: [adj]僵直的,酸痛的;硬的;困难的; [acc]/stɪf/; [or]gre3k;
paradise: [n]天国;天堂;极乐世界; [acc]/ˈpærədaɪs/; [or]gre3k;
proprietary: [adj]所有的;专利的;私人拥有的; [n]所有权;所有物;所有人; [acc]/prəˈpraɪəteri/; [or]gre3k;
inevitable: [adj]不可避免的,必然的; [n]必然发生的事; [acc]/ɪnˈevɪtəbl/; [or]gre3k;
jest: [n]笑话,俏皮话;玩笑; [v]开玩笑;嘲笑; [acc]/dʒest/; [or]gre3k;
cunning: [n]狡猾,精巧; [adj]狡猾的,精巧的; [acc]/ˈkʌnɪŋ/; [or]gre3k;
proofread: [v]校正,校对; [acc]/ˈpruːfriːd/; [or]gre3k;
repose: [n]休息,睡眠;静止; [vi]建立于.之上; [vt]使休息,使依靠; [acc]/rɪˈpoʊz/; [or]gre3k;
vigorous: [adj]精力充沛的;强有力的,有活力的;强健的; [acc]/ˈvɪɡərəs/; [or]gre3k;
derivative: [n]派生物;[化学]衍生物; [adj]被引申出的,被诱导的;衍生的;第二手的; [acc]/dɪˈrɪvətɪv/; [or]gre3k;
vulgar: [adj]粗俗的;下流的;平民的;通俗的; [n]平民;方言; [acc]/ˈvʌlɡər/; [or]gre3k;
surrender: [v]投降;屈服;放弃;交出;自首; [n]投降;放弃;屈服;(保险的)解约; [acc]/səˈrendər/; [or]gre3k;
restless: [adj]烦躁不安的,焦虑的;得不到休息的;不安宁的; [acc]/ˈrestləs/; [or]gre3k;
pious: [adj]虔诚的;难以实现的;尽责的; [acc]/ˈpaɪəs/; [or]gre3k;
perpetual: [adj]永远的,永恒的;不断的; [acc]/pərˈpetʃuəl/; [or]gre3k;
esteem: [n]尊敬;尊重; [vt]尊敬;认为;考虑;估计; [acc]/ɪˈstiːm/; [or]gre3k;
nonsense: [n]胡说,废话; [acc]/ˈnɑːnsens/; [or]gre3k;
moderate: [adj]适度的,适中的,温和的,稳健的,中等的; [v]使减轻,使缓和; [n]温和主义者;稳健的人; [acc]/ˈmɑːdərət/; [or]gre3k;
solitude: [n]孤独; [acc]/ˈsɑːlətuːd/; [or]gre3k;
reproach: [v]责备,指责; [n]指责; [acc]/rɪˈproʊtʃ/; [or]gre3k;
dramatic: [adj]戏剧的,戏剧性的;引人注目的;逼真的,刺激的; [acc]/drəˈmætɪk/; [or]gre3k;
summit: [n]山顶,顶点;(政府间的)峰会; [acc]/ˈsʌmɪt/; [or]gre3k;
contract: [n]合同,契约; [v]感染(疾病);招致;订合同;订立(婚约);缩减; [acc]/ˈkɑːntrækt/; [or]gre3k;
arrest: [v]逮捕,拘留;吸引; [n]逮捕,拘留; [acc]/əˈrest/; [or]gre3k;
discharge: [n]发射;释放;解雇;放电; [v]卸掉负担;发射;放电;卸(货);使爆炸;履行;解雇;允许.离开;排出,放出;清偿(债务); [acc]/dɪsˈtʃɑːrdʒ/; [or]gre3k;
chase: [v]追赶;驱逐;追求; [n]追逐;追求; [acc]/tʃeɪs/; [or]gre3k;
formidable: [adj]令人畏惧的;可怕的;难以克服的;难应付的; [acc]/ˈfɔːrmɪdəbl/; [or]gre3k;
subtle: [adj]微妙的;敏锐的;不明显的;精细的;狡猾的; [acc]/ˈsʌtl/; [or]gre3k;
trifle: [n]蛋糕;琐事,小事,无价值的东西; [v]嘲笑,轻视; [acc]/ˈtraɪfl/; [or]gre3k;
sensitive: [adj]敏感的,过敏的;灵敏的;善解人意的,体恤的; [acc]/ˈsensətɪv/; [or]gre3k;
murmur: [v]低声说,低语;低声抱怨; [n]低语;喃喃说话声; [acc]/ˈmɜːrmər/; [or]gre3k;
perish: [vi]死去;毁灭,灭亡; [v]脆裂,老化,腐烂; [acc]/ˈperɪʃ/; [or]gre3k;
sober: [vi]变得冷静; [adj]未饮醉的,清醒的;有节制的;严肃的; [v]使清醒;使冷静; [acc]/ˈsoʊbər/; [or]gre3k;
humor: [n]幽默,诙谐; [acc]/ˈhjuːmər/; [or]gre3k;
amiable: [adj]和蔼的,亲切的;温和的; [acc]/ˈeɪmiəbl/; [or]gre3k;
illustrious: [adj]著名的,杰出的;辉煌的; [acc]/ɪˈlʌstriəs/; [or]gre3k;
abundant: [adj]丰富的;大量的; [acc]/əˈbʌndənt/; [or]gre3k;
array: [n]一系列;陈列;编队; [v]排列;部署; [acc]/əˈreɪ/; [or]gre3k;
harsh: [adj]严厉的;刺耳的;条件艰苦的; [acc]/hɑːrʃ/; [or]gre3k;
pine: [n]松树; [v](因死亡,离别等)难过,悲伤; [acc]/paɪn/; [or]gre3k;
abandon: [v]抛弃;放弃;放纵; [acc]/əˈbændən/; [or]gre3k;
apprehension: [n]忧虑,担心,疑惧;逮捕;理解; [acc]/ˌæprɪˈhenʃn/; [or]gre3k;
hideous: [adj]讨厌的,丑恶的; [acc]/ˈhɪdiəs/; [or]gre3k;
imperial: [adj]帝王的,壮丽的,至尊的; [n]帝国,皇家; [acc]/ɪmˈpɪriəl/; [or]gre3k;
bargain: [n]交易,特价商品;便宜货;契约; [vi]讨价还价,讲价;成交; [vt]经讨价还价成交;用.交换; [adj](价格),低廉的; [acc]/ˈbɑːrɡən/; [or]gre3k;
fatigue: [n]疲乏,劳累; [acc]/fəˈtiːɡ/; [or]gre3k;
virtuous: [adj]善良的,有德行的,贞洁的; [acc]/ˈvɜːrtʃuəs/; [or]gre3k;
conspicuous: [adj]显眼的;显著的;显而易见的; [acc]/kənˈspɪkjuəs/; [or]gre3k;
channel: [n]频道;渠道,方法;海峡; [v]引导;经沟槽输送; [acc]/ˈtʃænl/; [or]gre3k;
accomplish: [v]完成,做到;实现; [acc]/əˈkɑːmplɪʃ/; [or]gre3k;
tribute: [n]致敬;悼念;贡品;称赞; [acc]/ˈtrɪbjuːt/; [or]gre3k;
procure: [vt](努力)取得;获得;导致;完成; [vi]介绍娼妓;拉皮条; [acc]/prəˈkjʊr/; [or]gre3k;
favorable: [adj]赞同的,称赞的;有利的,顺利的; [acc]/ˈfeɪvərəbl/; [or]gre3k;
warrant: [n]逮捕证;正当理由;凭证; [v]使正当; [acc]/ˈwɔːrənt/; [or]gre3k;
convention: [n]会议;习俗;惯例; [acc]/kənˈvenʃn/; [or]gre3k;
cow: [n]母牛,奶牛;母兽; [v]恐吓,吓倒; [acc]/kaʊ/; [or]gre3k;
rejoice: [v]欣喜,高兴; [acc]/rɪˈdʒɔɪs/; [or]gre3k;
confident: [adj]自信的;确信的,深信的; [acc]/ˈkɑːnfɪdənt/; [or]gre3k;
hasty: [adj]匆忙的;仓促完成的;草率的; [acc]/ˈheɪsti/; [or]gre3k;
awe: [n]敬畏;畏怯;(壮观等引起的)惊叹,惊奇; [vt]使敬畏,令人敬畏,使充满畏惧; [acc]/ɔː/; [or]gre3k;
sermon: [n]布道;训诫; [acc]/ˈsɜːrmən/; [or]gre3k;
flock: [n](鸟兽)群;一群人;(对牧师而言的)教徒; [v]聚集,成群而行; [acc]/flɑːk/; [or]gre3k;
smart: [adj]时髦的,衣着讲究的;聪明的;干净的,整洁的; [v]剧痛,刺疼; [acc]/smɑːrt/; [or]gre3k;
manuscript: [n]手稿;底稿;手抄本; [acc]/ˈmænjuskrɪpt/; [or]gre3k;
creek: [n]小溪;小湾; [acc]/kriːk/; [or]gre3k;
awkward: [adj]尴尬的;笨拙的;棘手的;不雅观的;不方便的;困难的,危险的; [acc]/ˈɔːkwərd/; [or]gre3k;
sublime: [adj]雄伟的,崇高的,极端的,超群的;(行为,态度)极端的,漠不关心的; [n]顶峰,崇高; [v]使.纯化,使.升华,变高尚; [acc]/səˈblaɪm/; [or]gre3k;
descend: [vi]走下;降临; [v]下降,下来;突然访问;下移,下降; [acc]/dɪˈsend/; [or]gre3k;
scotch: [n](产自苏格兰的一种)威士忌;刻痕,划痕; [v]阻止;平息;挫败; [acc]/skɑːtʃ/; [or]gre3k;
reflect: [v]倒映;反映,反射;仔细思考;反省; [acc]/rɪˈflekt/; [or]gre3k;
dreary: [adj]沉闷的;乏味的;凄凉的; [acc]/ˈdrɪri/; [or]gre3k;
pan: [n]平底锅; [v]严厉批评;淘金; [acc]/pæn/; [or]gre3k;
convert: [v]可转变为,可变换成;改变,转变,转化;使改变信仰; [n]皈依者;改变宗教信仰者; [acc]/kənˈvɜːrt/; [or]gre3k;
comprehend: [v]由.组成;了解;领会;包含; [acc]/ˌkɑːmprɪˈhend/; [or]gre3k;
compliment: [n]恭维,问候; [v]赞美,祝贺; [acc]/ˈkɑːmplɪmənt/; [or]gre3k;
withdraw: [v]取款;撤退,收回,撤离; [acc]/wɪðˈdrɔː/; [or]gre3k;
polished: [adj]擦亮的;磨光的;优美的;处世圆滑的; [acc]/ˈpɑːlɪʃt/; [or]gre3k;
latitude: [n]纬度;地区;(言论,行动的)自由; [acc]/ˈlætɪtuːd/; [or]gre3k;
delicacy: [n]精致;柔弱;佳肴;优雅;谨慎; [acc]/ˈdelɪkəsi/; [or]gre3k;
contrived: [adj]人为的;做作的;不自然的; [acc]/kənˈtraɪvd/; [or]gre3k;
disguise: [v]伪装;掩饰; [n]伪装物;伪装; [acc]/dɪsˈɡaɪz/; [or]gre3k;
worldly: [adj]世间的,尘世的;世俗的; [adv]世故地; [acc]/ˈwɜːrldli/; [or]gre3k;
trifling: [adj]细微的,不重要的; [acc]/ˈtraɪflɪŋ/; [or]gre3k;
barren: [adj]贫瘠的,不孕的; [n]荒原,不毛之地; [acc]/ˈbærən/; [or]gre3k;
brook: [v](常用于否定句或疑问句)容忍;忍受;容忍; [n]小溪;小河; [acc]/brʊk/; [or]gre3k;
applause: [n]鼓掌,掌声; [acc]/əˈplɔːz/; [or]gre3k;
elaborate: [adj]精心设计的,精巧的;复杂的; [v]详细说明,详尽阐述; [vt]变得复杂; [acc]/ɪˈlæbəreɪt/; [or]gre3k;
accord: [n]协议; [v]授予; [acc]/əˈkɔːrd/; [or]gre3k;
everlasting: [adj]永恒的,持久的;无止境的;耐用的; [acc]/ˌevərˈlæstɪŋ/; [or]gre3k;
imitation: [n]模仿;仿制品;赝品; [adj]伪造的;仿制的; [acc]/ˌɪmɪˈteɪʃn/; [or]gre3k;
vile: [adj]令人讨厌的,恶心的;可恨的;可耻的;简陋的; [acc]/vaɪl/; [or]gre3k;
legend: [n]传说,传奇人物;(奖章纪念牌等的)铭文;地图的图例,插图的说明; [acc]/ˈledʒənd/; [or]gre3k;
bliss: [n]福佑,天赐的福; [vt]使欣喜若狂,使狂喜; [vi]欣喜若狂,狂喜; [acc]/blɪs/; [or]gre3k;
revolt: [v]反抗,叛乱,厌恶;造反;反抗;厌恶; [n]背叛;厌恶;反叛; [acc]/rɪˈvoʊlt/; [or]gre3k;
implicit: [adj]隐含的;盲目的;完全的,绝对的;成为一部分的; [acc]/ɪmˈplɪsɪt/; [or]gre3k;
nerve: [n]神经;胆量,勇气; [v]给.以力量,使振作; [acc]/nɜːrv/; [or]gre3k;
discretion: [n]自由裁量权;谨慎;判断力;判定;考虑周到; [acc]/dɪˈskreʃn/; [or]gre3k;
preach: [v]传教,布道;说教;宣扬; [acc]/priːtʃ/; [or]gre3k;
rational: [adj]理性的;理智的;合理的; [acc]/ˈræʃnəl/; [or]gre3k;
ingenious: [adj]聪明的;有发明天才的;有独创性的,别出心裁的; [acc]/ɪnˈdʒiːniəs/; [or]gre3k;
despise: [vt]轻视,蔑视,看不起; [acc]/dɪˈspaɪz/; [or]gre3k;
hardy: [adj](植物)耐寒的;能吃苦耐劳的;勇敢的; [n]强壮的人; [acc]/ˈhɑːrdi/; [or]gre3k;
grandeur: [n]壮观,宏伟,庄严; [acc]/ˈɡrændʒər/; [or]gre3k;
throng: [v]群集,蜂拥; [n]一大群人; [vt]挤向; [acc]/θrɔːŋ/; [or]gre3k;
prosperous: [adj]富裕的;繁荣的;茂盛的;茁壮生长的; [acc]/ˈprɑːspərəs/; [or]gre3k;
escort: [n]护送者; [v]护送; [acc]/ˈeskɔːrt/; [or]gre3k;
mirth: [n]欢乐,欢笑; [acc]/mɜːrθ/; [or]gre3k;
harbor: [n]海港;港口;避风港; [v]庇护;藏匿;心怀(怨恨等); [acc]/'hɑːbə/; [or]gre3k;
assert: [v]断言;肯定地说;坚持;维护; [acc]/əˈsɜːrt/; [or]gre3k;
dismay: [n]失望;沮丧;惊愕; [v]使惊恐; [acc]/dɪsˈmeɪ/; [or]gre3k;
rail: [n]铁轨;扶手,栏杆; [v]咒骂; [acc]/reɪl/; [or]gre3k;
acquire: [v](尤指靠自己的努力或行动或经过一个过程)获得;学到;取得; [acc]/əˈkwaɪər/; [or]gre3k;
prevail: [v]流行,盛行;战胜,压倒; [acc]/prɪˈveɪl/; [or]gre3k;
dated: [adj]注有(或注明)日期的;过时的,旧式的; [acc]/ˈdeɪtɪd/; [or]gre3k;
tumult: [n]骚动;骚乱;吵闹;激动; [acc]/ˈtuːmʌlt/; [or]gre3k;
propriety: [n]正当(的行为);礼节;适当; [acc]/prəˈpraɪəti/; [or]gre3k;
partial: [adj]偏爱的,特别喜欢的;偏袒的,不公平的,有偏见的;部分的;不完全的; [n][数学]偏微商; [acc]/ˈpɑːrʃl/; [or]gre3k;
reckless: [adj]不顾虑的;鲁莽的,不顾后果的; [acc]/ˈrekləs/; [or]gre3k;
abstract: [adj]抽象的; [n]摘要,抽象; [v]提取; [acc]/ˈæbstrækt/; [or]gre3k;
ragged: [adj]破旧的;参差不齐的;未梳理的;粗糙的;精疲力竭的; [acc]/ˈræɡɪd/; [or]gre3k;
fidelity: [n]忠诚;逼真度,保真度; [acc]/fɪˈdeləti/; [or]gre3k;
petition: [n]请愿;请愿书;祈求; [v]请愿; [acc]/pəˈtɪʃn/; [or]gre3k;
kindred: [n]亲戚,家族,亲属关系,相似; [adj]有血缘关系的,同宗的,同源的,类似的; [acc]/ˈkɪndrəd/; [or]gre3k;
deliberate: [adj]故意的;深思熟虑的;从容不迫的; [v]仔细考虑;研讨; [acc]/dɪˈlɪbərət/; [or]gre3k;
homage: [n]敬意;尊敬;效忠; [acc]/ˈhɑːmɪdʒ/; [or]gre3k;
accessible: [adj]可使用的;可到达的;可进入的;易懂的; [acc]/əkˈsesəbl/; [or]gre3k;
flush: [v]脸红;清除;赶出;冲掉; [n]发红;冲掉;脸红; [adj]挥霍的,浪费的;富有的;完全齐平的; [acc]/flʌʃ/; [or]gre3k;
tyrant: [n]暴君; [acc]/ˈtaɪrənt/; [or]gre3k;
assent: [v]同意,赞成; [n]同意;赞成; [acc]/əˈsent/; [or]gre3k;
wax: [n]蜡;蜡状物; [v]给.上蜡;给.打蜡,给.上蜡;渐渐变大;变为;(月亮)渐圆,渐盈; [adj]蜡制的; [acc]/wæks/; [or]gre3k;
garment: [n]服装; [vt]给 ... 披上衣服;覆上...; [acc]/ˈɡɑːrmənt/; [or]gre3k;
wholesome: [adj]有益于健康的;有益的; [acc]/ˈhoʊlsəm/; [or]gre3k;
remorse: [n]懊悔,自责,同情,怜悯; [acc]/rɪˈmɔːrs/; [or]gre3k;
thrill: [n]兴奋,激动,引起激动的事物; [v](使)非常兴奋,(使)非常激动; [acc]/θrɪl/; [or]gre3k;
acute: [adj](疼痛,妒忌等)剧烈的,严重的;敏锐的;急性的;尖声的; [acc]/əˈkjut/; [or]gre3k;
indispensable: [adj]必不可少的;必需的; [acc]/ˌɪndɪˈspensəbl/; [or]gre3k;
humility: [n]谦逊,谦恭; [acc]/hjuːˈmɪləti/; [or]gre3k;
blast: [n]一阵(疾风等);爆炸;冲击波; [v](用炸药)炸,摧毁; [acc]/blæst/; [or]gre3k;
sullen: [adj]沮丧的,闷闷不乐的;阴沉的; [acc]/ˈsʌlən/; [or]gre3k;
penalty: [n]惩罚,处罚,不利,罚球; [adj]处罚的; [acc]/ˈpenəlti/; [or]gre3k;
screen: [n]屏幕,荧光屏;纱窗; [v]遮蔽;放映;检查; [acc]/skriːn/; [or]gre3k;
shrewd: [adj]精明的;机灵的; [n]精明;精明者; [acc]/ʃruːd/; [or]gre3k;
obedient: [adj]服从的,顺从的;孝顺的; [acc]/oʊˈbiːdiənt/; [or]gre3k;
falsehood: [n]谬误,不真实,谎言,虚假; [acc]/ˈfɔːlshʊd/; [or]gre3k;
crest: [n]鸟冠,盔上的装饰(如羽毛),顶部,顶峰; [v]到达绝顶,加以顶饰; [acc]/krest/; [or]gre3k;
constitute: [v]构成,组成;任命; [acc]/ˈkɑːnstətuːt/; [or]gre3k;
serene: [adj]宁静的,静谧的; [v]宁静;〈诗〉使(海,脸色等)平静;使(天空)明朗; [n]平静(的海);〈诗,古〉晴朗(天空); [acc]/səˈriːn/; [or]gre3k;
commencement: [n]开始,发端;毕业典礼; [acc]/kəˈmensmənt/; [or]gre3k;
restrain: [v]制止(做);抑制(愤怒等),控制;监禁; [acc]/rɪˈstreɪn/; [or]gre3k;
calamity: [n]大灾祸,不幸之事; [acc]/kəˈlæməti/; [or]gre3k;
obstinate: [adj]顽固的;较难治愈的; [acc]/ˈɑːbstɪnət/; [or]gre3k;
hasten: [v]赶快,急忙;加速;催促; [acc]/ˈheɪsn/; [or]gre3k;
barbarous: [adj]野蛮的,残暴的; [acc]/ˈbɑːrbərəs/; [or]gre3k;
mournful: [adj]悲哀的; [acc]/ˈmɔːrnfl/; [or]gre3k;
substitute: [v]代替; [n]代替者,代用品,替补队员; [acc]/ˈsʌbstɪtuːt/; [or]gre3k;
valiant: [n]勇士,勇敢的人; [adj]勇敢的,英勇的; [acc]/ˈvæliənt/; [or]gre3k;
obsolete: [adj]已过时的;已废弃的; [v]使过时;使作废; [n]废词;被废弃的事物; [acc]/ˌɑːbsəˈliːt/; [or]gre3k;
extract: [v]取出;提取;摘录;设法得到;索取; [n]摘录;提出物; [acc]/ɪkˈstrækt/; [or]gre3k;
imposing: [adj]壮观的,壮丽的; [acc]/ɪmˈpoʊzɪŋ/; [or]gre3k;
mute: [n]弱音器; [adj]缄默的;哑的; [vt]减弱.的声音; [acc]/mjuːt/; [or]gre3k;
compromise: [n]妥协;折中; [v]妥协;使遭受危害; [acc]/ˈkɑːmprəmaɪz/; [or]gre3k;
aloft: [adv]在空中,在高处,在上面; prep. 在 ... 上; [acc]/əˈlɔːft/; [or]gre3k;
resolute: [adj]坚决的;果断的; [acc]/ˈrezəluːt/; [or]gre3k;
slumber: [n]睡眠;睡觉; [v]浅睡;打盹儿; [acc]/ˈslʌmbər/; [or]gre3k;
endeavor: [n]尝试,努力,尽力; [v]努力,尽力; [acc]/ɪnˈdevər/; [or]gre3k;
ridicule: [v]嘲笑,愚弄; [n]嘲笑,愚弄; [acc]/ˈrɪdɪkjuːl/; [or]gre3k;
tedious: [adj]沉闷的,冗长乏味的; [acc]/ˈtiːdiəs/; [or]gre3k;
provincial: [adj]省的;地方性的;偏狭的; [n]地方人民;乡下人;外地人; [acc]/prəˈvɪnʃl/; [or]gre3k;
genial: [adj]愉快的,脾气好的,友好的; [acc]/ˈdʒiːniəl/; [or]gre3k;
conjecture: [n]推测;猜想; [v]推测;揣摩; [acc]/kənˈdʒektʃər/; [or]gre3k;
yoke: [n]牛轭;枷锁;纽带; [v]结合;连结; [acc]/joʊk/; [or]gre3k;
perilous: [adj]危险的; [acc]/ˈperələs/; [or]gre3k;
sage: [adj]贤明的,审慎的; [n]圣人,年高望重的人; [acc]/seɪdʒ/; [or]gre3k;
foster: [adj]收养的; [vt]养育;培养,促进; [acc]/ˈfɔːstər/; [or]gre3k;
lance: [n]长矛; [v]以长矛攻击; [acc]/læns/; [or]gre3k;
hammer: [n]锤; [v]锤击; [acc]/ˈhæmər/; [or]gre3k;
plunge: [v]跳进,(使)投入;使陷入;暴跌; [n]卷入,参与;暴跌,骤减; [acc]/plʌndʒ/; [or]gre3k;
patent: [n]专利; [adj]显然的,明显的;专利的;独创的; [v]取得.的专利权; [acc]/ˈpætnt/; [or]gre3k;
rash: [adj]轻率的,鲁莽的; [n]疹,皮疹;(短时期内)爆发的一连串; [acc]/ræʃ/; [or]gre3k;
champion: [n]冠军;拥护者,战士; [v]拥护;保卫;为..而斗争; [adj]夺得第一名的;优胜的; [acc]/ˈtʃæmpiən/; [or]gre3k;
compound: [n]复合物;[化学]化合物; [adj]合成的;复合的;多功能的; [vi]妥协;和解; [vt]混合;调和;调停;使恶化; [acc]/ˈkɑːmpaʊnd/; [or]gre3k;
pilot: [n]领航员;飞行员; [adj]试验性的; [v]给..领航,驾驶;试验; [acc]/ˈpaɪlət/; [or]gre3k;
grin: [v]露齿而笑,咧嘴一笑; [n]龇牙笑; [acc]/ɡrɪn/; [or]gre3k;
prodigious: [adj]异常的,奇妙的;巨大的; [acc]/prəˈdɪdʒəs/; [or]gre3k;
crow: [n]乌鸦;欢呼声; [v]啼;报晓;(儿童)欢笑; [acc]/kroʊ/; [or]gre3k;
sturdy: [adj]结实的;坚固的;强壮的;健壮的; [n](羊的)晕倒病; [acc]/ˈstɜːrdi/; [or]gre3k;
tame: [adj]驯服的,温顺的;顺从的;枯燥的; [v]驯服; [acc]/teɪm/; [or]gre3k;
affliction: [n]苦恼,折磨;痛苦; [acc]/əˈflɪkʃn/; [or]gre3k;
ally: [n]盟友;同盟国;(二战时的) 同盟国; [v]结盟; [acc]/ˈælaɪ/; [or]gre3k;
integrity: [n]正直,真诚;完整; [acc]/ɪnˈteɡrəti/; [or]gre3k;
rider: [n]骑士;附件,附文;扶手; [acc]/ˈraɪdər/; [or]gre3k;
marvel: [n]奇迹,奇景;奇才; [v]惊叹,吃惊,诧异; [acc]/ˈmɑːrvl/; [or]gre3k;
condemn: [v]谴责,责备;判(某人某罪); [acc]/kənˈdem/; [or]gre3k;
sanction: [n]批准;制裁,处罚; [v]批准,支持,对..实施制裁; [acc]/ˈsæŋkʃn/; [or]gre3k;
approbation: [n]称赞,认可;批准; [acc]/ˌæprəˈbeɪʃn/; [or]gre3k;
allegiance: [n]忠诚,拥护; [acc]/əˈliːdʒəns/; [or]gre3k;
dispose: [v]处理,处置,除去;使愿意; [acc]/dɪˈspoʊz/; [or]gre3k;
saturnine: [adj]忧郁的,阴沉的,讥讽的; [acc]/ˈsætərnaɪn/; [or]gre3k;
stature: [n]身高,身材;(精神,道德等的)高度; [acc]/ˈstætʃər/; [or]gre3k;
shift: [n]转移;替换;轮值; [v]移动;售卖(难卖的物品);换挡;改换,替换; [acc]/ʃɪft/; [or]gre3k;
hymn: [n]赞美诗,圣歌;歌颂某事物的电影; [acc]/hɪm/; [or]gre3k;
trumpet: [n]喇叭,小号;小号声;小号手;传声筒; [v]吹喇叭;发出喇叭般的声音;用喇叭吹出;发喇叭似的声音;大声宣布;宣扬; [acc]/ˈtrʌmpɪt/; [or]gre3k;
sanctuary: [n]圣堂,避难所; [acc]/ˈsæŋktʃueri/; [or]gre3k;
shrink: [v]收缩;缩小;退缩; [n](非正式用法)心理医生,精神病医生; [acc]/ʃrɪŋk/; [or]gre3k;
studio: [n]摄影棚;工作室;录音室;单间公寓(studio flat);制片公司; [acc]/ˈstuːdioʊ/; [or]gre3k;
frail: [adj]脆弱的,不坚实的; [n]少妇;灯心草篓;灯心草篓的容量; [acc]/freɪl/; [or]gre3k;
treacherous: [adj]不牢靠的,危险的;奸诈的,叛逆的,背叛的; [adv]背信弃义地; [n]背信弃义,背叛; [acc]/ˈtretʃərəs/; [or]gre3k;
censure: [v]责难,责备; [n]责难,责备; [acc]/ˈsenʃər/; [or]gre3k;
catastrophe: [n]大灾难; [acc]/kəˈtæstrəfi/; [or]gre3k;
insolent: [adj]傲慢的,粗鲁的,无礼的; [acc]/ˈɪnsələnt/; [or]gre3k;
discern: [v]辨别;识别;看出; [acc]/dɪˈsɜːrn/; [or]gre3k;
arbitrary: [adj]随意的,任性的,随心所欲的;霸道的,专制的,专横的;主观的,武断的; [acc]/ˈɑːrbətreri/; [or]gre3k;
ecstasy: [n]狂喜,心醉神怡; [acc]/ˈekstəsi/; [or]gre3k;
luminous: [adj]发光的;鲜艳的;明亮的;夜光的; [acc]/ˈluːmɪnəs/; [or]gre3k;
beseech: [v]恳求,哀求; [adj]恳求的;哀求的;乞求的; [acc]/bɪˈsiːtʃ/; [or]gre3k;
creep: [vi]爬行;潜入;蔓延;变形;毛发直竖; [n]卑鄙小人;爬行;变形;毛骨悚然的感觉; [acc]/kriːp/; [or]gre3k;
disdain: [n]蔑视,鄙视; [vt]鄙视;不屑; [acc]/dɪsˈdeɪn/; [or]gre3k;
pluck: [v]拔去(毛发等);拽开;选; [n]勇气; [acc]/plʌk/; [or]gre3k;
synonymous: [adj]同义的;同义词的;同义突变的; [acc]/sɪˈnɑːnɪməs/; [or]gre3k;
bridle: [n]马笼头,缰绳; [v]上笼头;昂首(表傲慢,愤怒等);抑制,控制; [acc]/ˈbraɪdl/; [or]gre3k;
solemnity: [n]庄严,肃穆,庄严的仪式; [acc]/səˈlemnəti/; [or]gre3k;
resign: [v]辞职; [acc]/rɪˈzaɪn/; [or]gre3k;
iniquity: [n]邪恶,不公正; [acc]/ɪˈnɪkwəti/; [or]gre3k;
devout: [adj]虔诚的,真挚的,诚恳的; [n]虔诚;真挚,诚恳; [acc]/dɪˈvaʊt/; [or]gre3k;
rouse: [vt]唤醒,唤起;激起; [acc]/raʊz/; [or]gre3k;
industrious: [adj]勤劳的,勤奋的; [acc]/ɪnˈdʌstriəs/; [or]gre3k;
adversary: [n]对手,敌手; [acc]/ˈædvərseri/; [or]gre3k;
luxurious: [adj]奢侈的,豪华的; [acc]/lʌɡˈʒʊriəs/; [or]gre3k;
orthodox: [adj]正统的;传统的;(Orthodox)东正教的; [acc]/ˈɔːrθədɑːks/; [or]gre3k;
summon: [v]召唤;召集;聚集; [acc]/ˈsʌmən/; [or]gre3k;
depressed: [adj]沮丧的;萧条的;低迷的; [acc]/dɪˈprest/; [or]gre3k;
grieve: [v]伤心,悲痛; [vi]使悲伤,使伤心; [acc]/ɡriːv/; [or]gre3k;
clumsy: [adj]笨拙的,不灵活的;拙劣的,不得体的; [acc]/ˈklʌmzi/; [or]gre3k;
prairie: [n]大草原,(尤指)北美大草原;草原地带; [acc]/ˈpreri/; [or]gre3k;
incessant: [adj]无间断的,连续的; [acc]/ɪnˈsesnt/; [or]gre3k;
pillar: [n]柱,台柱,栋梁; [acc]/ˈpɪlər/; [or]gre3k;
founder: [n]奠基者;创始人; [v](船)沉没,浸水而沉没;(计划等)失败,受挫折; [acc]/ˈfaʊndər/; [or]gre3k;
vault: [n]保险库,金库,拱顶,墓室; [v]越过,跳过; [acc]/vɔːlt/; [or]gre3k;
deposit: [v]存款,存放;沉淀; [n]存款,定金;沉积物,矿床; [acc]/dɪˈpɑːzɪt/; [or]gre3k;
muddy: [adj]泥泞的;暗淡的;浑浊的; [v]使粘上烂泥;显得扑朔迷离; [acc]/ˈmʌdi/; [or]gre3k;
intelligible: [adj]可理解的,明白易懂的; [acc]/ɪnˈtelɪdʒəbl/; [or]gre3k;
stray: [adj]走失的,迷路的;离了群的; [v]走失;分心,走神;有外遇,在别处拈花惹草; [n]流浪者;走失,迷路; [acc]/streɪ/; [or]gre3k;
superficial: [adj]肤浅的;表面的;微不足道的; [n]表面文章; [acc]/ˌsuːpərˈfɪʃl/; [or]gre3k;
wan: [adj]虚弱的,病态的; [acc]/wɑːn/; [or]gre3k;
grotesque: [adj]奇形怪状的,奇异的; [n]奇形怪状的人(或物,图案等);奇异风格; [acc]/ɡroʊˈtesk/; [or]gre3k;
gratify: [v]使高兴,使满足; [acc]/ˈɡrætɪfaɪ/; [or]gre3k;
extinct: [adj]灭绝的;破灭了的,消亡了的; [acc]/ɪkˈstɪŋkt/; [or]gre3k;
superfluous: [adj]多余的,过剩的;不必要的; [acc]/suːˈpɜːrfluəs/; [or]gre3k;
accidental: [adj]偶然的,意外的;非本质的; [acc]/ˌæksɪˈdentl/; [or]gre3k;
rustic: [n]乡巴佬,庄稼汉,粗人; [adj]乡村的;质朴的;不精致的; [acc]/ˈrʌstɪk/; [or]gre3k;
insensible: [adj]昏迷的,无知觉的,麻木不仁的; [acc]/ɪnˈsensəbl/; [or]gre3k;
cultivate: [v]耕作,养植,栽培;培养,陶冶,发展; [acc]/ˈkʌltɪveɪt/; [or]gre3k;
magnitude: [n]巨大;震级;重要性;[数]量值; [acc]/ˈmæɡnɪtuːd/; [or]gre3k;
harness: [n]挽具,马具,降落伞背带; [v]上挽具;治理(河流等);利用; [acc]/ˈhɑːrnɪs/; [or]gre3k;
edifice: [n]宏伟的建筑物;大厦;(知识的)体系,结构; [acc]/ˈedɪfɪs/; [or]gre3k;
prostrate: [adj]降伏的,沮丧的,衰竭的,俯卧的; [v]弄倒,使屈服; [acc]/ˈprɑːstreɪt/; [or]gre3k;
spur: [v]策马,用踢马刺驱马前进;激励,鞭策;推动; [n]踢马刺,靴刺;刺激,鞭策,鼓励;尖坡; [acc]/spɜːr/; [or]gre3k;
relish: [v]享受;享受.的味道;品味; [n]乐趣;调味品; [acc]/ˈrelɪʃ/; [or]gre3k;
entreat: [v]恳求,请求; [acc]/ɪnˈtriːt/; [or]gre3k;
compose: [v]创作,作曲,形成,构成; [acc]/kəmˈpoʊz/; [or]gre3k;
infamous: [adj]声名狼藉的,无耻的; [acc]/ˈɪnfəməs/; [or]gre3k;
incense: [n]焚香时的烟,香味; [v]激怒; [acc]/ˈɪnsens/; [or]gre3k;
flourish: [vi]繁荣,茂盛,兴旺; [vt]挥舞;夸耀; [n]兴旺;茂盛;炫耀;挥舞; [acc]/ˈflɜːrɪʃ/; [or]gre3k;
dashing: [adj]时髦的,华丽的;雄纠纠的;劲头十足的; [acc]/ˈdæʃɪŋ/; [or]gre3k;
consternation: [n]惊愕,恐怖,惊惶失措; [acc]/ˌkɑːnstərˈneɪʃn/; [or]gre3k;
deference: [n]尊敬,尊重;顺从; [acc]/ˈdefərəns/; [or]gre3k;
anonymous: [adj]匿名的;无名的;不具名的;无特色的;无个性特征; [acc]/əˈnɑːnɪməs/; [or]gre3k;
mischievous: [adj]狡猾的;调皮的;有害的; [acc]/ˈmɪstʃɪvəs/; [or]gre3k;
brisk: [adj]轻快的;活跃的;寒冷而清新的; [acc]/brɪsk/; [or]gre3k;
satire: [n]讽刺(作品); [acc]/ˈsætaɪər/; [or]gre3k;
remnant: [n]遗迹;边角剩料; [acc]/ˈremnənt/; [or]gre3k;
truce: [n]停战;休战;休战协定; [acc]/truːs/; [or]gre3k;
cling: [v]紧紧抓住;黏着,挨近;依恋,依附;坚持,墨守,忠实于; [acc]/klɪŋ/; [or]gre3k;
aversion: [n]厌恶;讨厌的人,(或东西); [acc]/əˈvɜːrʒn/; [or]gre3k;
temporal: [adj]现世的,世俗的;当时的,暂时的;[解]颞的;时间的; [n]世间万物;教会财产; [acc]/ˈtempərəl/; [or]gre3k;
lapse: [n]失误,过失;行为失检;(时间)流逝; [v]退步,倒退,衰退;失效;背弃,放弃(宗教信仰); [acc]/læps/; [or]gre3k;
vitality: [n]活力;生气;生命力; [acc]/vaɪˈtæləti/; [or]gre3k;
patriot: [n]爱国者; [acc]/ˈpeɪtriət/; [or]gre3k;
petty: [adj]价值不大的;小的;器量小的;琐碎的; [acc]/ˈpeti/; [or]gre3k;
malicious: [adj]怀恶意的,恶毒的; [acc]/məˈlɪʃəs/; [or]gre3k;
skeleton: [n]骨骼,梗概;骨瘦如柴的人或动物; [acc]/ˈskelɪtn/; [or]gre3k;
confine: [v]限制;监禁; [n]范围,界限,约束,限制; [acc]/kənˈfaɪn/; [or]gre3k;
reconcile: [v]和解;调解;调和; [acc]/ˈrekənsaɪl/; [or]gre3k;
suppress: [v]镇压;禁止发表;抑制(感情等);阻止.的生长; [acc]/səˈpres/; [or]gre3k;
clasp: [v]握紧;扣紧;扣住;抱紧; [n]扣子;钩子;紧抱;紧握; [acc]/klæsp/; [or]gre3k;
futile: [adj]无益的,无用的; [acc]/ˈfjuːtl/; [or]gre3k;
intrigue: [n]阴谋;诡计; [v]密谋;欺骗;引起极大兴趣; [acc]/ɪnˈtriːɡ/; [or]gre3k;
posture: [n]姿势;看法;态度; [v]装模作样; [acc]/ˈpɑːstʃər/; [or]gre3k;
demanding: [adj]苛求的,难取悦的;费力的; [acc]/dɪˈmændɪŋ/; [or]gre3k;
plump: [adj]颇胖的,丰满的; [v]拍打使鼓起,突然坐下,倒下,; [acc]/plʌmp/; [or]gre3k;
beset: [v]困扰;镶嵌;围绕; [acc]/bɪˈset/; [or]gre3k;
concrete: [n]混凝土; [adj]具体的,实质性的; [v]给 (道路等) 浇混凝土; [acc]/ˈkɑːŋkriːt/; [or]gre3k;
ominous: [adj]不祥的,不吉利的; [acc]/ˈɑːmɪnəs/; [or]gre3k;
menace: [v]威胁,威吓; [n]威胁;具有危险性的人(或物); [acc]/ˈmenəs/; [or]gre3k;
mastery: [n]权力;优势;精通,掌握; [acc]/ˈmæstəri/; [or]gre3k;
frenzy: [n]狂暴;狂怒,暴怒;疯狂,迷乱; [v]使发狂,使狂怒; [acc]/ˈfrenzi/; [or]gre3k;
linger: [v]逗留,留恋; [acc]/ˈlɪŋɡər/; [or]gre3k;
defy: [v]违抗,藐视;使不可能 (理解或解释);违背;赌.也不能; [n]挑战;对抗; [acc]/dɪˈfaɪ/; [or]gre3k;
peer: [n]同龄人,同等地位的人;贵族; [v]仔细看,费力地看; [acc]/pɪr/; [or]gre3k;
strand: [n](线等的)股,缕;一个组成部分;海滨,河岸,海滩,湖滨; [v]使陷入困境;使滞留,使搁浅; [acc]/strænd/; [or]gre3k;
sly: [adj]狡猾的,奸诈的;会心的;淘气的;诡异的; [acc]/slaɪ/; [or]gre3k;
boon: [n]恩惠,福利,利益; [adj]愉快的; [acc]/buːn/; [or]gre3k;
aloof: [adj]远离的;冷漠的,冷淡的; [adv]远离,避开; [acc]/əˈluːf/; [or]gre3k;
placid: [adj]安静的,平和的; [acc]/ˈplæsɪd/; [or]gre3k;
affirm: [v]肯定;断定;坚持声称; [acc]/əˈfɜːrm/; [or]gre3k;
riot: [v]闹事; [n]骚乱;暴乱;骚动;放纵; [acc]/ˈraɪət/; [or]gre3k;
veteran: [n]老兵;退役军人; [adj]经验丰富的;老练的; [acc]/ˈvetərən/; [or]gre3k;
meek: [adj]温顺的,逆来顺受的;谦恭的; [n]温顺的人;谦恭的人; [acc]/miːk/; [or]gre3k;
judicious: [adj]有判断力的;明智的; [acc]/dʒuˈdɪʃəs/; [or]gre3k;
chaos: [n]混沌;混乱,纷乱; [acc]/ˈkeɪɑːs/; [or]gre3k;
prosecution: [n](+the)起诉方,原告;起诉;经营; [acc]/ˌprɑːsɪˈkjuːʃn/; [or]gre3k;
disregard: [v]不理会;漠视; [n]忽视,漠视; [acc]/ˌdɪsrɪˈɡɑːrd/; [or]gre3k;
asunder: [adv]分离;化为碎片; [acc]/əˈsʌndər/; [or]gre3k;
bustle: [n]喧闹,熙攘;腰垫;奔走,奔忙; [v]喧闹;忙乱,奔忙; [acc]/ˈbʌsl/; [or]gre3k;
preface: [n]序言,前言,开端; [acc]/ˈprefəs/; [or]gre3k;
precipice: [n]危险的处境,灾难的边缘,濒危点;悬崖; [acc]/ˈpresəpɪs/; [or]gre3k;
cowardice: [n]胆小,懦弱; [acc]/ˈkaʊərdɪs/; [or]gre3k;
dire: [adj]可怕的;悲惨的;极端的; [acc]/ˈdaɪər/; [or]gre3k;
sneer: [v]冷笑;嘲笑; [n]嘲笑; [acc]/snɪr/; [or]gre3k;
haunt: [v]常去,萦绕于..;(鬼,魂)常出没于;(思想)萦绕; [n]常去的地方; [acc]/hɔːnt/; [or]gre3k;
enmity: [n]敌意,憎恨; [acc]/ˈenməti/; [or]gre3k;
console: [v]安慰,慰问; [n]控制台,仪表板;落地柜; [acc]/kənˈsoʊl/; [or]gre3k;
perceptible: [adj]可察觉的,可注意到的; [acc]/pərˈseptəbl/; [or]gre3k;
outset: [n]开始,开端; [acc]/ˈaʊtset/; [or]gre3k;
lament: [v]哀悼;惋惜;悲叹; [n]悲叹;悼词; [acc]/ləˈment/; [or]gre3k;
epic: [adj]史诗的,叙事诗的;壮丽的,宏大的; [n]史诗;叙事诗;史诗般的作品; [acc]/ˈepɪk/; [or]gre3k;
conscientious: [adj]勤勤恳恳的;认真的; [acc]/ˌkɑːnʃiˈenʃəs/; [or]gre3k;
harmonious: [adj]和谐的,协调的;和睦的;悦耳的; [acc]/hɑːrˈmoʊniəs/; [or]gre3k;
laborious: [adj]费时费力的,辛苦的;艰苦的; [acc]/ləˈbɔːriəs/; [or]gre3k;
din: [n]喧闹声,嘈杂声; [v]喧闹,喋喋不休地说; [acc]/dɪn/; [or]gre3k;
languid: [adj]没精打采的,倦怠的; [acc]/ˈlæŋɡwɪd/; [or]gre3k;
impending: [adj]即将到来的;迫在眉睫的,紧急的; [acc]/ɪmˈpendɪŋ/; [or]gre3k;
theatrical: [adj]戏剧的,矫揉造作的; [n]戏剧表演;戏剧演员;戏剧表演艺术;做戏似的动作; [acc]/θiˈætrɪkl/; [or]gre3k;
spectator: [n]旁观者;观众;目击者; [acc]/ˈspekteɪtər/; [or]gre3k;
imperative: [adj]必要的;祈使的;急需的; [n]命令;必要的事;义务;驱使; [acc]/ɪmˈperətɪv/; [or]gre3k;
random: [adj]随机的;任意的;胡乱的; [acc]/ˈrændəm/; [or]gre3k;
discrete: [adj]分开的;不连续的; [acc]/dɪˈskriːt/; [or]gre3k;
bluff: [adj]直率的; [v]虚张声势,吓唬; [n]虚张声势;吓唬;断崖,绝壁; [acc]/blʌf/; [or]gre3k;
forsake: [v]放弃;抛弃,离开; [acc]/fərˈseɪk/; [or]gre3k;
appealing: [adj]吸引人的,打动人心的; [acc]/əˈpiːlɪŋ/; [or]gre3k;
gorge: [n]峡谷;胃;暴食;咽喉;障碍物; [v]拼命吃;吞下,狼吞虎咽;塞满,填满; [acc]/ɡɔːrdʒ/; [or]gre3k;
damn: excl. 该死,讨厌; [v]诅咒; [n]诅咒; [adj]该死的;完全的; [adv](表示厌烦)该死;非常; [acc]/dæm/; [or]gre3k;
inherent: [adj]内在的,固有的;生来就有的; [acc]/ɪnˈhɪrənt/; [or]gre3k;
spontaneous: [adj]自发的,无意识的;自然的,天真率直的; [acc]/spɑːnˈteɪniəs/; [or]gre3k;
refreshing: [adj]使精神振作的,使人清爽的;清新悦目的; [acc]/rɪˈfreʃɪŋ/; [or]gre3k;
apparition: [n]幽灵,神奇的现象; [acc]/ˌæpəˈrɪʃn/; [or]gre3k;
renounce: [vt]宣布放弃,与...断绝关系;抛弃; [vi]垫牌; [n]垫牌; [acc]/rɪˈnaʊns/; [or]gre3k;
adore: [v]很喜欢,极喜爱;崇拜;爱慕; [acc]/əˈdɔːr/; [or]gre3k;
peculiarity: [n]怪癖;独特性; [acc]/pɪˌkjuːliˈærəti/; [or]gre3k;
profane: [adj]亵渎神圣的,不敬的,粗俗的,污秽的; [v]亵渎,玷污(神圣),滥用; [n]未受秘传的人; [acc]/prəˈfeɪn/; [or]gre3k;
commend: [v]称赞;推荐;委托保管; [acc]/kəˈmend/; [or]gre3k;
revive: [v](使)苏醒;(使)复苏;再兴起;重做; [acc]/rɪˈvaɪv/; [or]gre3k;
ferocious: [adj]凶猛的;强烈的,严重的; [acc]/fəˈroʊʃəs/; [or]gre3k;
disciple: [n]信徒,门徒;耶稣的信徒(或门徒,使徒); [acc]/dɪˈsaɪpl/; [or]gre3k;
soothe: [v]使(某人,情绪)平静,安慰,使(痛苦,疼痛)缓和或减轻; [acc]/suːð/; [or]gre3k;
fable: [n]寓言,童话;无稽之谈; [v]虚构,杜撰;煞有介事地讲; [acc]/ˈfeɪbl/; [or]gre3k;
diminish: [v]减少;失势,削弱.的权势, 减弱.的权势; [acc]/dɪˈmɪnɪʃ/; [or]gre3k;
sordid: [adj]卑鄙的,肮脏的,色彩死气沉沉暗淡的; [acc]/ˈsɔːrdɪd/; [or]gre3k;
temperate: [adj]温和的;适度的,有节制的; [acc]/ˈtempərət/; [or]gre3k;
fervent: [adj]热烈的,满怀热情的;狂热的; [acc]/ˈfɜːrvənt/; [or]gre3k;
scruple: [n]顾虑,不安; [vi]有顾虑,良心上感到不安; [acc]/ˈskruːpl/; [or]gre3k;
prophetic: [adj]预言的,预示的; [acc]/prəˈfetɪk/; [or]gre3k;
grudge: [n]怨恨;妒嫉;恶意;忿忿不平; [v]怨恨;嫉妒;不情愿做; [acc]/ɡrʌdʒ/; [or]gre3k;
malignant: [adj]恶性的,恶毒的,充满恨意的; [n]怀有恶意的人;保王党员; [acc]/məˈlɪɡnənt/; [or]gre3k;
anecdote: [n]轶事,趣闻; [acc]/ˈænɪkdoʊt/; [or]gre3k;
discord: [n]不和,争吵;(声音)不和谐; [acc]/ˈdɪskɔːrd/; [or]gre3k;
knit: [v]编结,针织; [n]编织的衣服;针织衫; [acc]/nɪt/; [or]gre3k;
detain: [v]拘留,使延迟; [acc]/dɪˈteɪn/; [or]gre3k;
vehement: [adj]猛烈的,强烈的; [acc]/ˈviːəmənt/; [or]gre3k;
imperious: [adj]傲慢的,专横的; [acc]/ɪmˈpɪriəs/; [or]gre3k;
impetuous: [adj]冲动的,鲁莽的; [acc]/ɪmˈpetʃuəs/; [or]gre3k;
frivolous: [adj]轻佻的,不重要的,缺乏基础的; [acc]/ˈfrɪvələs/; [or]gre3k;
provoke: [v]激怒;对.挑衅;引起; [acc]/prəˈvoʊk/; [or]gre3k;
affectation: [n]假装,做作;假装;装模作样; [acc]/ˌæfekˈteɪʃn/; [or]gre3k;
plight: [n]困境; [v]宣誓,保证; [acc]/plaɪt/; [or]gre3k;
ludicrous: [adj]荒谬的,可笑的,滑稽的; [acc]/ˈluːdɪkrəs/; [or]gre3k;
colossal: [adj]巨像(似)的;巨大的,庞大的; [acc]/kəˈlɑːsl/; [or]gre3k;
plateau: [n]高原; [vi]到达平稳阶段; [acc]/plæˈtoʊ/; [or]gre3k;
divert: [v]使转向,使改道(或绕道);转移,转移.的注意力;使娱乐,使消遣; [acc]/daɪˈvɜːrt/; [or]gre3k;
ballad: [n]歌谣;小曲; [acc]/ˈbæləd/; [or]gre3k;
summary: [n]摘要,总结; [adj]简略的,概要的,即决的; [acc]/ˈsʌməri/; [or]gre3k;
herald: [n]使者;预兆; [v]预告;为.欢呼; [acc]/ˈherəld/; [or]gre3k;
peep: [n]窥看,隐约看见; [v]窥视,偷看; [acc]/piːp/; [or]gre3k;
invincible: [adj]无敌的;不能征服的; [acc]/ɪnˈvɪnsəbl/; [or]gre3k;
impertinent: [adj]不恰当的,粗鲁的; [acc]/ɪmˈpɜːrtnənt/; [or]gre3k;
mingle: [v]使混合,使相混; [vi]相交往,相往来; [acc]/ˈmɪŋɡl/; [or]gre3k;
psychology: [n]心理学;心理状态;心理; [acc]/saɪˈkɑːlədʒi/; [or]gre3k;
caprice: [n]任性,反复无常,随想曲; [acc]/kəˈpriːs/; [or]gre3k;
obliging: [adj]乐于助人的;有礼貌的;体贴的;亲切的; [acc]/əˈblaɪdʒɪŋ/; [or]gre3k;
strait: [n]海峡;窘迫; [acc]/streɪt/; [or]gre3k;
sanguine: [adj]乐观的,(脸色等)有血色的,多血质的; [n]血红色,乐观; [acc]/ˈsæŋɡwɪn/; [or]gre3k;
scrap: [n]碎片;口角,吵架;小块,小片;废金属;残羹冷炙; [v]报废;舍弃;打架; [acc]/skræp/; [or]gre3k;
pirate: [n]海盗;剽窃者; [v]剽窃; [acc]/ˈpaɪrət/; [or]gre3k;
prevalent: [adj]普遍的,流行的; [acc]/ˈprevələnt/; [or]gre3k;
impenetrable: [adj]难以渗透的,坚不可摧的; [acc]/ɪmˈpenɪtrəbl/; [or]gre3k;
predecessor: [n]前辈;(被取代的)原有事物; [acc]/ˈpredəsesər/; [or]gre3k;
disinterested: [adj]公正的;不感兴趣的;无私的;廉洁的; [acc]/dɪsˈɪntrəstɪd/; [or]gre3k;
reap: [v]收割;获得;收获; [acc]/riːp/; [or]gre3k;
slippery: [adj]滑的;易滑脱的;不老实的;不稳定的; [acc]/ˈslɪpəri/; [or]gre3k;
fringe: [n]刘海;一排;边缘;穗,流苏; [v]形成.的边缘; [acc]/frɪndʒ/; [or]gre3k;
rue: [v]后悔,遗憾; [acc]/ruː/; [or]gre3k;
heresy: [n]异端邪说;异教; [acc]/ˈherəsi/; [or]gre3k;
subdue: [v]征服,压制,减轻; [acc]/səbˈduː/; [or]gre3k;
plausible: [adj]似乎有理的;巧嘴的; [acc]/ˈplɔːzəbl/; [or]gre3k;
dingy: [adj]昏暗的,肮脏的;褴褛的; [n]同"dingey"; [acc]/ˈdɪndʒi/; [or]gre3k;
civility: [n]谦恭;礼貌;端庄; [acc]/səˈvɪləti/; [or]gre3k;
avarice: [n]贪财,贪婪; [acc]/ˈævərɪs/; [or]gre3k;
bait: [n]饵,诱惑物; [v]装饵;辱骂,欺侮; [acc]/beɪt/; [or]gre3k;
congenial: [adj]意气相投的,令人愉快的,意气相投的,协调的; [acc]/kənˈdʒiːniəl/; [or]gre3k;
commotion: [n]骚动,动乱; [acc]/kəˈmoʊʃn/; [or]gre3k;
impudent: [adj]鲁莽的,冒失的,无礼的; [acc]/ˈɪmpjədənt/; [or]gre3k;
ardor: [n]热情,狂热; [acc]/'ɑːdə/; [or]gre3k;
profusion: [n]丰富; [acc]/prəˈfjuːʒn/; [or]gre3k;
fleeting: [adj]短暂的,飞逝的; [acc]/ˈfliːtɪŋ/; [or]gre3k;
latent: [adj]潜在的,隐伏的,不易察觉的; [acc]/ˈleɪtnt/; [or]gre3k;
solace: [n]慰藉,给予安慰的人或事物; [v]安慰,缓和,使开心; [acc]/ˈsɑːləs/; [or]gre3k;
robust: [adj]健壮的,强壮的;精力充沛的;坚固的;粗鲁的; [acc]/roʊˈbʌst/; [or]gre3k;
snare: [n]罗网;陷阱;圈套; [acc]/sner/; [or]gre3k;
allude: [v]间接提到,暗指,暗示; [acc]/əˈluːd/; [or]gre3k;
ordeal: [n]严峻考验,苦难的经历,折磨; [acc]/ɔːrˈdiːl/; [or]gre3k;
clan: [n]家族;氏族;部落;宗派;亲族; [acc]/klæn/; [or]gre3k;
abject: [adj]糟糕透顶的;可怜的,不幸的; [acc]/ˈæbdʒekt/; [or]gre3k;
dart: [n]飞镖;猛冲;标枪; [v]快速投掷;突然移动; [acc]/dɑːrt/; [or]gre3k;
precedent: [n]先例,范例;惯例; [adj]在前的,前面的; [acc]/ˈpresɪdənt/; [or]gre3k;
bully: [n]恃强欺弱者; [v]欺负; [acc]/ˈbʊli/; [or]gre3k;
Canon: [n]标准,教规,正典圣经,教士; [acc]/ˈkænən/; [or]gre3k;
delirium: [n]神志不清,极度兴奋; [acc]/dɪˈlɪriəm/; [or]gre3k;
contradict: [v]与..发生矛盾,与..抵触,与..对立; [acc]/ˌkɑːntrəˈdɪkt/; [or]gre3k;
comely: [adj]动人的,美丽的; [acc]/ˈkʌmli/; [or]gre3k;
redeem: [vt]赎回;挽回;恢复;偿还;弥补;履行;兑换; [acc]/rɪˈdiːm/; [or]gre3k;
elastic: [adj]有弹性的;可伸缩的,(系统或计划)灵活的;弹力材料制成的; [n]松紧带,橡皮圈; [acc]/ɪˈlæstɪk/; [or]gre3k;
wistful: [adj]渴望的,向往的;深思的;留恋的; [acc]/ˈwɪstfl/; [or]gre3k;
gear: [n]档位;齿轮;装备;衣物; [v]使适合; [acc]/ɡɪr/; [or]gre3k;
lumber: [v]缓慢地移动;拖累,迫使担负;伐木;杂乱地堆积;隆隆地行进; [n]木材;废旧家具,不用的大件物品;无用的杂物;隆隆声; [acc]/ˈlʌmbər/; [or]gre3k;
lavish: [adj]奢华的;铺张浪费的; [v]浪费;慷慨给予; [acc]/ˈlævɪʃ/; [or]gre3k;
analogous: [adj]类似的,可比拟的;[昆]同功的; [acc]/əˈnæləɡəs/; [or]gre3k;
partition: [n]划分;隔开物,隔墙,隔板; [v]隔开; [vt]瓜分;分割; [acc]/pɑːrˈtɪʃn/; [or]gre3k;
blunder: [n]愚蠢之举;大错; [vi]犯大错; [v]失策;绊倒; [acc]/ˈblʌndər/; [or]gre3k;
fanciful: [adj]异想天开的;别出心裁的; [acc]/ˈfænsɪfl/; [or]gre3k;
sentinel: [n]哨兵,看守; [v]守卫,放哨; [acc]/ˈsentɪnl/; [or]gre3k;
erroneous: [adj]错误的; [acc]/ɪˈroʊniəs/; [or]gre3k;
deficiency: [n]缺乏,不足;缺陷; [acc]/dɪˈfɪʃnsi/; [or]gre3k;
diligent: [adj]勤奋的;用功的; [acc]/ˈdɪlɪdʒənt/; [or]gre3k;
blunt: [adj]钝的;直率的; [v]使情感,感觉,需求减弱;变钝; [acc]/blʌnt/; [or]gre3k;
descendant: [n]后代,后裔;派生物; [acc]/dɪˈsendənt/; [or]gre3k;
vocation: [n]职业;行业;天职;使命; [acc]/voʊˈkeɪʃn/; [or]gre3k;
pallid: [adj]苍白的,病态的,无生气的; [acc]/ˈpælɪd/; [or]gre3k;
limp: [n]跛行; [vi]一瘸一拐地走,跛行;慢腾腾地进行; [adj]无力的,无生气的;柔软的,软弱的; [acc]/lɪmp/; [or]gre3k;
auspicious: [adj]吉兆的,幸运的; [acc]/ɔːˈspɪʃəs/; [or]gre3k;
scant: [adj]不足的,缺乏的;勉强够的; [v]减少;节省;限制; [acc]/skænt/; [or]gre3k;
turbulent: [adj]湍急的;混乱的,动荡的;骚动的; [acc]/ˈtɜːrbjələnt/; [or]gre3k;
marsh: [n]湿地;沼泽; [acc]/mɑːrʃ/; [or]gre3k;
unanimous: [adj]全体一致的;一致同意的; [acc]/juˈnænɪməs/; [or]gre3k;
sarcasm: [n]讽刺,挖苦,嘲笑; [acc]/ˈsɑːrkæzəm/; [or]gre3k;
tout: [v]招徕顾客,极力赞扬; [acc]/taʊt/; [or]gre3k;
austere: [adj]严峻的;简朴的;苦行的;无装饰的; [acc]/ɔːˈstɪr/; [or]gre3k;
pensive: [adj]沉思的,心事重重的,忧郁的; [acc]/ˈpensɪv/; [or]gre3k;
deplorable: [adj]可叹的;凄惨的; [acc]/dɪˈplɔːrəbl/; [or]gre3k;
extant: [adj]现存的;显著的; [acc]/ekˈstænt/; [or]gre3k;
pernicious: [adj]有害的,恶性的,致命的; [acc]/pərˈnɪʃəs/; [or]gre3k;
brazen: [adj]厚脸皮的,厚颜无耻的;黄铜(制)的; [v]厚着脸皮干,使变得无耻; [acc]/ˈbreɪzn/; [or]gre3k;
stride: [v]大步走;越过;跨越; [vt]大步走过;跨骑在.上; [n]大步;阔步行走的姿势;一大步;跨越;正常的进展; [acc]/straɪd/; [or]gre3k;
meddle: [vi]干预,多管闲事; [acc]/ˈmedl/; [or]gre3k;
secluded: [adj]隐遁的,隔绝的; [acc]/sɪˈkluːdɪd/; [or]gre3k;
giddy: [adj]眼花缭乱的,头晕的,轻率的; [v](使)眼花,(使)眩晕; [acc]/ˈɡɪdi/; [or]gre3k;
collapse: [v](使)倒塌,(使)崩溃,(使)瓦解; [n]倒塌,崩溃,暴跌; [acc]/kəˈlæps/; [or]gre3k;
repute: [n]名声,荣誉; [vt]被认为,被称为; [acc]/rɪˈpjuːt/; [or]gre3k;
confound: [v]使混淆,使混乱;挫败;讨厌; [acc]/kənˈfaʊnd/; [or]gre3k;
scrupulous: [adj]小心谨慎的;严谨的;细心的; [acc]/ˈskruːpjələs/; [or]gre3k;
brake: [v]刹车; [n]刹车,制动器,闸; [acc]/breɪk/; [or]gre3k;
shun: [v](有意或习惯性地)避开,躲开; [acc]/ʃʌn/; [or]gre3k;
aggressive: [adj]好斗的,挑衅性的;有闯劲的,积极进取的; [acc]/əˈɡresɪv/; [or]gre3k;
grate: [n]壁炉;格栅; [v]磨碎,使人烦燥; [acc]/ɡreɪt/; [or]gre3k;
ponderous: [adj]笨重的,笨拙的,沉闷的; [acc]/ˈpɑːndərəs/; [or]gre3k;
friction: [n]摩擦,摩擦力;争执,冲突; [acc]/ˈfrɪkʃn/; [or]gre3k;
arrogance: [n]自大;傲慢态度; [acc]/ˈærəɡəns/; [or]gre3k;
rite: [n]仪式;惯例;习俗; [acc]/raɪt/; [or]gre3k;
abreast: [adv]并肩地,并列; [adj]并排的;并肩的; [acc]/əˈbrest/; [or]gre3k;
distinctive: [adj]有特色的,与众不同的; [acc]/dɪˈstɪŋktɪv/; [or]gre3k;
consummate: [adj]至上的,完美的; [v]完成,使达到极点; [acc]/ˈkɑːnsəmət/; [or]gre3k;
salutation: [n]称呼;招呼;寒喧; [acc]/ˌsæljuˈteɪʃn/; [or]gre3k;
playful: [adj]好玩的,嬉戏的,十分有趣的; [acc]/ˈpleɪfl/; [or]gre3k;
transient: [adj]短暂的,路过的;转瞬即逝的; [n]过客; [acc]/ˈtrænʃnt/; [or]gre3k;
farce: [n]闹剧;胡闹;笑剧; [acc]/fɑːrs/; [or]gre3k;
slate: [n]黑板,石板,候选人名单; [v]提名; [acc]/sleɪt/; [or]gre3k;
chivalrous: [adj]像骑士的,侠义的,大侠的; [acc]/ˈʃɪvəlrəs/; [or]gre3k;
paltry: [adj]不足取的,无价值的,琐碎的,卑鄙的; [acc]/ˈpɔːltri/; [or]gre3k;
periodical: [n]期刊;杂志; [acc]/ˌpɪriˈɑːdɪkl/; [or]gre3k;
banish: [v]放逐;摒弃; [acc]/ˈbænɪʃ/; [or]gre3k;
interminable: [adj]没完没了的,无穷无尽的,冗长的; [acc]/ɪnˈtɜːrmɪnəbl/; [or]gre3k;
copious: [adj]丰富的,多产的; [acc]/ˈkoʊpiəs/; [or]gre3k;
scourge: [n]鞭笞,磨难,带来灾难的事物或人; [v]鞭笞,折磨,使苦恼; [acc]/skɜːrdʒ/; [or]gre3k;
alacrity: [n]反应迅速,乐意; [acc]/əˈlækrəti/; [or]gre3k;
rustle: [v]发出沙沙声,使沙沙作响,偷窃; [n]沙沙声; [acc]/ˈrʌsl/; [or]gre3k;
arduous: [adj]艰巨的;努力的;陡峭的; [acc]/ˈɑːrdʒuəs/; [or]gre3k;
lyric: [n]抒情诗;歌词; [adj](供)吟唱的;抒情的; [acc]/ˈlɪrɪk/; [or]gre3k;
inquisitive: [adj]好奇的,好打听的; [acc]/ɪnˈkwɪzətɪv/; [or]gre3k;
nominal: [adj]名义上的;象征性的,很少的;名词性的; [acc]/ˈnɑːmɪnl/; [or]gre3k;
demonstrate: [vt](用实例,实验)论证;演示,展示;示范; [vi]示威; [acc]/ˈdemənstreɪt/; [or]gre3k;
precarious: [adj]不稳定的;危险的;可疑的;说不定的; [acc]/prɪˈkeriəs/; [or]gre3k;
ethics: [n]行为准则;道德规范; [acc]/'eθɪks/; [or]gre3k;
annoy: [v]使烦恼,使生气; [n]烦恼(等于annoyance); [acc]/əˈnɔɪ/; [or]gre3k;
glide: [v]滑翔;滑动; [n]滑音,延音;滑行; [acc]/ɡlaɪd/; [or]gre3k;
impunity: [n]不受惩罚;无患; [acc]/ɪmˈpjuːnəti/; [or]gre3k;
brim: [n]边;边缘; [v]充满,注满; [vt]注满; [acc]/brɪm/; [or]gre3k;
bribe: [v]向.行贿;买通; [n]贿赂;行贿物; [acc]/braɪb/; [or]gre3k;
audacious: [adj]大胆的,鲁莽的,大胆创新的; [acc]/ɔːˈdeɪʃəs/; [or]gre3k;
pioneer: [n]先驱,先锋,开拓者; [v]开辟,首倡; [acc]/ˌpaɪəˈnɪr/; [or]gre3k;
quarry: n. 采石场;猎物;来源; [v]挖出;努力挖掘; [acc]/ˈkwɔːri/; [or]gre3k;
exacting: [adj]苛求的,要求严格的,强索的; [acc]/ɪɡˈzæktɪŋ/; [or]gre3k;
fathom: n. 英寻(=6英尺); [vi]测量深度; [vt]彻底了解,测深; [acc]/ˈfæðəm/; [or]gre3k;
forbearance: n. 自制,忍耐;宽容; [acc]/fɔːrˈberəns/; [or]gre3k;
repress: [vt]抑制;镇压;约束; [acc]/rɪˈpres/; [or]gre3k;
valid: [adj]有效的,正式认可的;合理的,有根据的; [acc]/ˈvælɪd/; [or]gre3k;
legacy: n. 遗赠(物);遗产; [acc]/ˈleɡəsi/; [or]gre3k;
compelling: [adj]引人注目的;紧迫的;令人信服的; [acc]/kəmˈpelɪŋ/; [or]gre3k;
accommodate: [v]向.提供住处(或膳宿);给.提供方便;容纳;使适应,顺应; [acc]/əˈkɑːmədeɪt/; [or]gre3k;
glossy: [adj]光泽的,光滑的; [acc]/ˈɡlɑːsi/; [or]gre3k;
construct: [v]建造;作(图);构筑; n. 概念;构筑物;结构体;建造物; [acc]/kənˈstrʌkt/; [or]gre3k;
whimsical: [adj]古怪的,异想天开的; [acc]/ˈwɪmzɪkl/; [or]gre3k;
automatic: [adj]无意识的;自动的;自发的; n. 自动手枪;自动工具; [acc]/ˌɔːtəˈmætɪk/; [or]gre3k;
explicit: [adj]充分表达清楚的,明确的;直率的,直截了当的;〔描绘性或暴力的语言或画面〕清晰露骨的; [acc]/ɪkˈsplɪsɪt/; [or]gre3k;
indolent: [adj]懒惰的,懒洋洋的; [acc]/ˈɪndələnt/; [or]gre3k;
pregnant: [adj]怀孕的;充满的,意味深长的; [acc]/ˈpreɡnənt/; [or]gre3k;
buck: n. 雄鹿;年轻男士;美元; [v]反对;马弓背踢后腿挑起; [acc]/bʌk/; [or]gre3k;
sumptuous: [adj]奢侈的;华丽的; [acc]/ˈsʌmptʃuəs/; [or]gre3k;
turmoil: n. 骚动,骚乱; [acc]/ˈtɜːrmɔɪl/; [or]gre3k;
chasm: n. (地壳,冰上的)隐窟,深坑,峡谷;显著差距,巨大分歧; [acc]/ˈkæzəm/; [or]gre3k;
precipitate: [v]促成,使..沉淀,猛摔;[气象]凝结; n. 沉淀物,冷凝物; [adj]突如其来的,仓促的,迅猛的;感情用事的; [acc]/prɪˈsɪpɪteɪt/; [or]gre3k;
cessation: n. 停止,中止,中断; [acc]/seˈseɪʃn/; [or]gre3k;
wary: [adj]谨慎的,小心的,提防的;考虑周到的; [acc]/ˈweri/; [or]gre3k;
diversity: n. 多样性,差异,分集; [acc]/daɪˈvɜːrsəti/; [or]gre3k;
prestige: n. 威望,声望; [acc]/preˈstiːʒ/; [or]gre3k;
abstain: [v]戒掉(烟\酒等);避开;弃权; [acc]/əbˈsteɪn/; [or]gre3k;
sham: n. 假货;虚假;欺诈; [v]假装; [adj]虚假的,假装的; [acc]/ʃæm/; [or]gre3k;
dictate: [v]规定;命令;口授;听写; n. 命令;指令; [acc]/ˈdɪkteɪt/; [or]gre3k;
sate: [v]使心满意足,使厌足; [acc]/seɪt/; [or]gre3k;
rabble: n. 下层社会;乌合之众;暴民; [acc]/ˈræbl/; [or]gre3k;
retort: [v]反驳; n. 反驳,反击,回嘴; [acc]/rɪˈtɔːrt/; [or]gre3k;
adversity: n. 逆境,不幸,灾难; [acc]/ədˈvɜːrsəti/; [or]gre3k;
salutary: [adj]有益的,有益健康的; [acc]/ˈsæljəteri/; [or]gre3k;
hurricane: n. 飓风; [acc]/ˈhɜːrəkeɪn/; [or]gre3k;
atrocious: [adj]糟透的,残暴的,骇人听闻的; [acc]/əˈtroʊʃəs/; [or]gre3k;
impotent: [adj]无力的,无能的,阳痿的; n. 虚弱者;阳痿者; [acc]/ˈɪmpətənt/; [or]gre3k;
palpable: [adj]明显的,易觉察的,可触知的; [acc]/ˈpælpəbl/; [or]gre3k;
withhold: [v]抑制,拒绝给某事物; [acc]/wɪðˈhoʊld/; [or]gre3k;
cement: n. 水泥,混凝土;胶合剂; [vt]巩固,加强;用水泥涂;接合; [vi]粘牢; [acc]/sɪˈment/; [or]gre3k;
aggregate: n. 合计;总数;混凝料;总计; [v]集合;聚集;合计; [adj]总的,总数的;集合的; [acc]/ˈæɡrɪɡət/; [or]gre3k;
inexorable: [adj]不为所动的,坚决不变的; n. 坚定不移的人; [acc]/ɪnˈeksərəbl/; [or]gre3k;
sap: n. 树液,汁液;易上当的人; [v]削弱;逐渐耗竭; [vt]使伤元气; [vi]挖坑道进攻; [acc]/sæp/; [or]gre3k;
dissolve: [v]使溶解;废除,使解散; [acc]/dɪˈzɑːlv/; [or]gre3k;
equilibrium: n. (心态情感等)平静;平衡; [acc]/ˌiːkwɪˈlɪbriəm/; [or]gre3k;
reproof: n. 斥责,责备; [v]重新上防水胶;[印]重新打样; [acc]/rɪˈpruːf/; [or]gre3k;
pitiless: [adj]冷酷的,无情的,无同情心的; [acc]/ˈpɪtiləs/; [or]gre3k;
pompous: [adj]傲慢的,浮华的; [acc]/ˈpɑːmpəs/; [or]gre3k;
exploit: [v]剥削,利用;开发,开拓; n. 辉煌功绩; [acc]/ɪkˈsplɔɪt/; [or]gre3k;
needy: [adj]贫困的;贫穷的;生活艰苦的; [acc]/ˈniːdi/; [or]gre3k;
boisterous: [adj]喧闹的,欢闹的; [acc]/ˈbɔɪstərəs/; [or]gre3k;
affinity: n. 姻亲关系;密切关系;近似,类似关系;亲近; [acc]/əˈfɪnəti/; [or]gre3k;
penitent: [adj]后悔的,忏悔的; n. 改过迁善的人;忏悔的人;悔罪者; [acc]/ˈpenɪtənt/; [or]gre3k;
abiding: [adj]持久的;永久的,不变的; [acc]/əˈbaɪdɪŋ/; [or]gre3k;
lamentable: [adj]可悲的,可怜的,哀伤的; [acc]/ˈlæməntəbl/; [or]gre3k;
speck: n. 斑点,灰尘,污点,小颗粒; [acc]/spek/; [or]gre3k;
uncouth: [adj]笨拙的;粗野的;不舒适的;陌生的; [acc]/ʌnˈkuːθ/; [or]gre3k;
ascetic: [adj]禁欲的;苦行的; n. 禁欲者;苦行者; [acc]/əˈsetɪk/; [or]gre3k;
embark: [v]上船或飞机;开始,着手,从事; [acc]/ɪmˈbɑːrk/; [or]gre3k;
stalwart: n. 坚定的成员;健壮的人; [adj]强壮的,坚定的,忠诚的; [acc]/ˈstɔːlwərt/; [or]gre3k;
variance: n. 变化;[数] 方差;不一致;分歧;变异; [acc]/ˈveriəns/; [or]gre3k;
apprehensive: [adj]忧虑的,不安的,敏悟的,知晓的; [acc]/ˌæprɪˈhensɪv/; [or]gre3k;
timely: [adj]适时的,及时的; [adv]及时地; [acc]/ˈtaɪmli/; [or]gre3k;
prolong: [v]延长;拉长;拖延; [acc]/prəˈlɔːŋ/; [or]gre3k;
sequel: n. 续集;结局;继续;后果; [acc]/ˈsiːkwəl/; [or]gre3k;
kindle: [v]点燃,激起;着火;照亮;煽动; [acc]/ˈkɪndl/; [or]gre3k;
havoc: n. (天灾,战争等造成的)大破坏,大毁灭; [vi]损毁; [vt]严重破坏; [acc]/ˈhævək/; [or]gre3k;
forge: n. 熔炉;锻工车间;铁匠店; [v]锻造;经锻炼而形成;伪造;推进,加强; [acc]/fɔːrdʒ/; [or]gre3k;
covert: [adj]隐蔽的,偷偷摸摸的,[律]在丈夫保护下的; n. 掩蔽处,隐藏处; [acc]/ˈkoʊvɜːrt/; [or]gre3k;
vigilant: [adj]警戒的,警惕的; [acc]/ˈvɪdʒɪlənt/; [or]gre3k;
epithet: n. 外号,绰号; [acc]/ˈepɪθet/; [or]gre3k;
mire: n. 泥沼,困境; [acc]/ˈmaɪər/; [or]gre3k;
levity: n. 轻率,轻浮,多变,不稳定; [acc]/ˈlevəti/; [or]gre3k;
fastidious: [adj]难讨好的,爱挑剔的; [acc]/fæˈstɪdiəs/; [or]gre3k;
traverse: [v]横越;穿过; n. 横越; [acc]/trəˈvɜːrs/; [or]gre3k;
haven: n. 港湾;避难所; [vt]为.提供庇护所; [acc]/ˈheɪvn/; [or]gre3k;
equity: n. 公平,公正;衡平法;普通股;抵押资产的净值; [acc]/ˈekwəti/; [or]gre3k;
eclipse: n. (日,月)食;黯然失色; [v]掩盖..的重要性;使暗淡; [acc]/ɪˈklɪps/; [or]gre3k;
visionary: n. 有远见的人;幻想家; [adj]有远见的;爱幻想的; [acc]/ˈvɪʒəneri/; [or]gre3k;
implacable: [adj]难以满足的,难平息的; [acc]/ɪmˈplækəbl/; [or]gre3k;
tangle: [v](使)缠结;(使)乱作一团; n. 纠缠;纠结;复杂的问题;困惑; [acc]/ˈtæŋɡl/; [or]gre3k;
concentrate: [v]全神贯注于,集中于;浓缩; n. 浓缩物; [acc]/ˈkɑːnsntreɪt/; [or]gre3k;
versed: [adj]熟练的,精通的; [acc]/vɜːrst/; [or]gre3k;
relentless: [adj]顽强的;持续的;坚定地;冷酷的; [acc]/rɪˈlentləs/; [or]gre3k;
fictitious: [adj]虚构的; [acc]/fɪkˈtɪʃəs/; [or]gre3k;
genteel: [adj]有教养的,文雅的;高雅的;假斯文的,装作体面的; [acc]/dʒenˈtiːl/; [or]gre3k;
prerogative: n. 权利;特权; [acc]/prɪˈrɑːɡətɪv/; [or]gre3k;
mar: [v]毁坏,弄糟,玷污; [acc]/mɑːr/; [or]gre3k;
submissive: [adj]顺从的,惟命是从的,谦恭的; [acc]/səbˈmɪsɪv/; [or]gre3k;
rupture: n. 破裂;割裂; [v]使破裂;断绝(关系); [acc]/ˈrʌptʃər/; [or]gre3k;
parable: n. 寓言,比喻; [acc]/ˈpærəbl/; [or]gre3k;
ruthless: [adj]无情的;残忍的; [acc]/ˈruːθləs/; [or]gre3k;
Spartan: [adj]斯巴达式的,简朴的,刻苦的; n. 斯巴达人;勇士; [acc]/ˈspɑːrtn/; [or]gre3k;
vex: [v]使烦恼,使苦恼,使恼怒; [acc]/veks/; [or]gre3k;
adhere: [v]遵守;坚持;粘附;附着,粘在..上; [acc]/ədˈhɪr/; [or]gre3k;
conflagration: n. 建筑物或森林大火; [acc]/ˌkɑːnfləˈɡreɪʃn/; [or]gre3k;
gust: n. 阵风,(感情的)迸发,汹涌; [v]猛吹; [acc]/ɡʌst/; [or]gre3k;
fabulous: [adj]极好的;极妙的;极为巨大的;寓言中的;传说中的; [acc]/ˈfæbjələs/; [or]gre3k;
despotic: [adj]专政的,专横的,暴虐的; [acc]/dɪˈspɑːtɪk/; [or]gre3k;
fragile: [adj]易碎的;易损坏的;虚弱的;脆弱的; [acc]/ˈfrædʒl/; [or]gre3k;
chronic: [adj](疾病)慢性的;长期的;(人)久病的;积习难改的;严重的; [acc]/ˈkrɑːnɪk/; [or]gre3k;
peremptory: [adj]专横的,不容反抗的; [acc]/pəˈremptəri/; [or]gre3k;
slack: [adj]松弛的;懈怠的;萧条的; n. 松弛的部分,松散; [v]变松弛,逃避工作; [acc]/slæk/; [or]gre3k;
gaudy: n. 华丽而俗气的廉价饰物; [adj](服饰,装饰,文风等)华丽而俗气的;浮华的;过分显眼的; [acc]/ˈɡɔːdi/; [or]gre3k;
prodigal: [adj]挥霍的,十分慷慨的; n. 浪子,挥霍者; [acc]/ˈprɑːdɪɡl/; [or]gre3k;
sluggish: [adj]行动迟缓的,迟钝的;偷懒的; [acc]/ˈslʌɡɪʃ/; [or]gre3k;
observant: [adj]机警的;严格遵守的;善于观察的; [acc]/əbˈzɜːrvənt/; [or]gre3k;
droll: [adj]滑稽的;好笑的;逗趣的; n. 逗人发笑的人;滑稽演员;小丑; [v]开玩笑; [adv]古里古怪地,滑稽地; [acc]/droʊl/; [or]gre3k;
provisional: n. 临时邮票; [adj]临时的,暂时的,暂定的; [acc]/prəˈvɪʒənl/; [or]gre3k;
vindictive: [adj]报复性的,怀恨的,惩罚的; [acc]/vɪnˈdɪktɪv/; [or]gre3k;
partisan: [adj]党派的;效忠的;偏袒的;盲目推崇的; n. 党羽;虔诚信徒;游击队; [acc]/ˈpɑːrtəzn/; [or]gre3k;
precipitous: [adj]险峻的;急躁的,鲁莽的; [acc]/prɪˈsɪpɪtəs/; [or]gre3k;
lull: [v]使平静,使安静,哄骗; n. 间歇,暂停,暂时平静; [acc]/lʌl/; [or]gre3k;
stratagem: n. 谋略,策略; [acc]/ˈstrætədʒəm/; [or]gre3k;
gall: n. 粗鲁,无礼; [v]使恼怒; [acc]/ɡɔːl/; [or]gre3k;
clamor: n. 喧闹;强烈的要求; [v]喧嚷;强烈的要求; [acc]/ˈklæmər/; [or]gre3k;
balm: n. 香油,止痛膏,安慰物,香气; [acc]/bɑːm/; [or]gre3k;
fervor: n. 强烈感情,激情,热情; [acc]/ˈfɜrvər/; [or]gre3k;
persistence: n. 坚持不懈,持续; [acc]/pərˈsɪstəns/; [or]gre3k;
relinquish: [v]放弃,让出(权利,财产等),撤回; [acc]/rɪˈlɪŋkwɪʃ/; [or]gre3k;
repeal: n. 撤销; [v]废除;废止; [acc]/rɪˈpiːl/; [or]gre3k;
incumbent: n. 在职者,现任者; [adj]现任的;依靠的;负有职责的; [acc]/ɪnˈkʌmbənt/; [or]gre3k;
inanimate: [adj]无生命的;无生气的; [acc]/ɪnˈænɪmət/; [or]gre3k;
apathy: n. 冷漠,无兴趣;漠不关心,无感情; [acc]/ˈæpəθi/; [or]gre3k;
surpass: [v]胜过;超出; [acc]/sərˈpæs/; [or]gre3k;
parrot: n. 鹦鹉,盲目重复或模仿他人行为的人; [vt]学舌,盲目重复或模仿; [acc]/ˈpærət/; [or]gre3k;
jovial: [adj]天性快活的,主神朱庇特的; n. 左威尔牌手表; [acc]/ˈdʒoʊviəl/; [or]gre3k;
chord: n. 和弦;和音;心弦;(数学)弦; [acc]/kɔːrd/; [or]gre3k;
nocturnal: [adj]夜晚的,夜间发生的; [acc]/nɑːkˈtɜːrnl/; [or]gre3k;
surly: [adj]乖戾的;无礼的;阴沉的; [acc]/ˈsɜːrli/; [or]gre3k;
arid: [adj](土地或气候)干燥的,干旱的,贫瘠的,荒芜的;无创见的,无新意的; [acc]/ˈærɪd/; [or]gre3k;
retinue: n. 侍从,随员; [acc]/ˈretənuː/; [or]gre3k;
stitch: [v]缝,绣; n. 一针,线迹;缝法,编结法;(肋部的)突然剧痛;缝合(伤口); [acc]/stɪtʃ/; [or]gre3k;
discredit: [v]使不相信,使怀疑;败坏.的名声; n. 丧失信誉,丧失名誉;败坏名声的人或事,耻辱; [acc]/dɪsˈkredɪt/; [or]gre3k;
politic: [adj]策略性的,政治上的,国家的; [acc]/ˈpɑːlətɪk/; [or]gre3k;
decorum: n. 礼节,礼貌,端庄,正派; [acc]/dɪˈkɔːrəm/; [or]gre3k;
uncanny: [adj]神秘的,不可思议的; [acc]/ʌnˈkæni/; [or]gre3k;
shroud: n. 寿衣,覆盖物; [v]覆盖,包以尸衣; [acc]/ʃraʊd/; [or]gre3k;
dogged: [adj]顽强的;顽固的; [vt]跟踪;尾随; [acc]/ˈdɔːɡɪd/; [or]gre3k;
fraught: [adj]担心的,忧虑的;充满.的; n. 货物,装载物; [vt]装货于; [acc]/frɔːt/; [or]gre3k;
uphold: [v]维护,支持,举起; [acc]/ʌpˈhoʊld/; [or]gre3k;
atone: [v]赎罪,补偿; [acc]/əˈtoʊn/; [or]gre3k;
languor: n. 身心疲惫;柔情;呆滞; [acc]/ˈlæŋɡər/; [or]gre3k;
twig: n. 细枝,嫩枝;末梢;桠枝; [acc]/twɪɡ/; [or]gre3k;
paramount: n. 元首;最高; [adj]最高的,至上的,首要的; [acc]/ˈpærəmaʊnt/; [or]gre3k;
furtive: [adj]偷偷的,秘密的,鬼鬼祟祟的,; [acc]/ˈfɜːrtɪv/; [or]gre3k;
meditate: [v]考虑,沉思,冥想; [acc]/ˈmedɪteɪt/; [or]gre3k;
flexible: [adj]易曲的,柔软的,灵活的; [acc]/ˈfleksəbl/; [or]gre3k;
coronation: n. 加冕,加冕礼; [acc]/ˌkɔːrəˈneɪʃn/; [or]gre3k;
defile: [v]污损,弄脏;以纵队前进; n. 狭谷;隘路; [acc]/dɪˈfaɪl/; [or]gre3k;
oration: n. 演说;致辞;叙述法; [acc]/ɔːˈreɪʃn/; [or]gre3k;
counterfeit: n. 仿制品,伪造物; [adj]仿造的.假冒的; [v]伪造,仿造; [acc]/ˈkaʊntərfɪt/; [or]gre3k;
hack: n. 砍,劈;出租马车;出租车; [vt]砍,乱劈;胡乱删改;[计算机](熟练地编辑或修改)程序;非法侵入(他人计算机系统); [adj]出租的;用旧了的;(文人等)被雇佣的;雇佣文人做的; [acc]/hæk/; [or]gre3k;
safeguard: [v]保护,维护; n. 防卫措施,防范措施; [acc]/ˈseɪfɡɑːrd/; [or]gre3k;
chaff: n. 谷物的皮壳,米糠;草料,干草;小玩笑; [v]开玩笑; [acc]/tʃæf/; [or]gre3k;
rapt: [adj]全神贯注的,着迷的;狂喜的; [acc]/ræpt/; [or]gre3k;
lurid: [adj](暴力,性爱等)耸人听闻的; [acc]/ˈlʊrɪd/; [or]gre3k;
retribution: n. 报应,惩罚,报答,报偿; [acc]/ˌretrɪˈbjuːʃn/; [or]gre3k;
symmetry: n. 对称;均衡; [acc]/ˈsɪmətri/; [or]gre3k;
mosque: n. 伊斯兰教寺院;清真寺; [acc]/mɑːsk/; [or]gre3k;
inter: [v]埋葬; prep. 在内; [acc]/ɪnˈtɜːr/; [or]gre3k;
exhaust: [v]使筋疲力尽;耗尽;详尽论述; n. 排气装置;废气; [acc]/ɪɡˈzɔːst/; [or]gre3k;
astounding: [adj]使人惊骇的; [acc]/əˈstaʊndɪŋ/; [or]gre3k;
supple: [adj]柔软的;柔顺的; [acc]/ˈsʌpl/; [or]gre3k;
mercenary: n. 外国雇佣兵;唯利是图者; [adj]唯利是图的;雇佣的; [acc]/ˈmɜːrsəneri/; [or]gre3k;
presumptuous: [adj]专横的,自以为是的,冒昧的; [adv]自以为是地,专横地,冒失地; n. 自以为是,专横,冒失; [acc]/prɪˈzʌmptʃuəs/; [or]gre3k;
conjure: [v]变魔术;使...变戏法般地出现(或消失);使想起;使...呈现于脑际;(a name to conjure with)大名鼎鼎的人;影响巨大的事物;恳求; [acc]/ˈkʌndʒər/; [or]gre3k;
dogma: n. 教条;武断的意见; [adj]教义的,教条的,信条的; [acc]/ˈdɔːɡmə/; [or]gre3k;
stupor: n. 恍惚,昏迷,不醒人事; [acc]/ˈstuːpər/; [or]gre3k;
enlighten: [v]启发,开导; [acc]/ɪnˈlaɪtn/; [or]gre3k;
quench: [v]扑灭(火);止渴; [acc]/kwentʃ/; [or]gre3k;
sterile: [adj]不孕的,无细菌的,贫瘠的; [acc]/ˈsterəl/; [or]gre3k;
onset: n. 开始;攻击,袭击; [acc]/ˈɑːnset/; [or]gre3k;
fickle: [adj](在感情等方面)反复无常的,轻浮的,善变的; [acc]/ˈfɪkl/; [or]gre3k;
surmise: [v]猜测,推测,认为; n. 推测,猜度; [acc]/sərˈmaɪz/; [or]gre3k;
wily: [adj]狡猾的; [acc]/ˈwaɪli/; [or]gre3k;
census: n. 人口普查,人口调查;统计; [v]调查(某地区等的)人口数字;统计.的数字; [acc]/ˈsensəs/; [or]gre3k;
denounce: [v]谴责,斥责; [acc]/dɪˈnaʊns/; [or]gre3k;
extinguish: [v]熄灭,扑灭;根除,消灭; [acc]/ɪkˈstɪŋɡwɪʃ/; [or]gre3k;
exalt: [v]提升,提拔,赞扬,使得意; [acc]/ɪɡˈzɔːlt/; [or]gre3k;
loath: [adj]不愿意的; [acc]/loʊθ/; [or]gre3k;
suspend: [v]悬挂,吊;中止;推迟; [acc]/səˈspend/; [or]gre3k;
hoary: [adj]年纪高迈的;(头发等)灰白的;古老的; [acc]/ˈhɔːri/; [or]gre3k;
wayward: [adj]任性的,不规则的,刚愎的; [acc]/ˈweɪwərd/; [or]gre3k;
mania: n. 癫狂,狂热; [acc]/ˈmeɪniə/; [or]gre3k;
agility: n. 敏捷;灵活; [acc]/əˈdʒɪləti/; [or]gre3k;
complacency: n. 自满,自鸣得意;满足; [acc]/kəmˈpleɪsnsi/; [or]gre3k;
rend: [v]撕碎;分裂;强夺; [acc]/rend/; [or]gre3k;
foreground: n. 前景,最显著的位置; [v]强调; [acc]/ˈfɔːrɡraʊnd/; [or]gre3k;
prescription: n. 处方,药方;(医生开)的药;开处方,开药方; [acc]/prɪˈskrɪpʃn/; [or]gre3k;
lithe: [adj]轻盈的(等于lithesome);柔软的;易弯曲的; [acc]/laɪð/; [or]gre3k;
conversant: [adj]熟悉的;精通的;亲近的; [acc]/kənˈvɜːrsnt/; [or]gre3k;
intrinsic: [adj]固有的; [acc]/ɪnˈtrɪnsɪk/; [or]gre3k;
impostor: n. 骗子;冒充者; [acc]/ɪmˈpɑːstər/; [or]gre3k;
credulous: [adj]轻信的,因轻信而产生的; [acc]/ˈkredʒələs/; [or]gre3k;
taint: n. 污点;感染;异味; [vi]腐败,腐烂; [vt]污染;玷污,使受不良影响; [acc]/teɪnt/; [or]gre3k;
ineffable: [adj]不可言喻的,不应说出的,难以形容的; [acc]/ɪnˈefəbl/; [or]gre3k;
sprightly: [adj]活泼的;生气勃勃的;轻快的; [adv]活泼;生气勃勃;轻松地; [acc]/ˈspraɪtli/; [or]gre3k;
ethereal: [adj]太空的,轻巧的,像空气的; [acc]/iˈθɪriəl/; [or]gre3k;
inveterate: [adj]积习已深的,根深蒂固的,长期形成的; [acc]/ɪnˈvetərət/; [or]gre3k;
spat: n. 口角,小争论; [v]轻轻拍打;发生小争吵; [acc]/spæt/; [or]gre3k;
prosaic: [adj]平凡的,乏味的,散文体的; [acc]/prəˈzeɪɪk/; [or]gre3k;
sonnet: n. 十四行诗; [acc]/ˈsɑːnɪt/; [or]gre3k;
adapt: [vi]适应不同情况; [vt]使适合;改编; [acc]/əˈdæpt/; [or]gre3k;
repugnant: [adj]令人厌恶的; [acc]/rɪˈpʌɡnənt/; [or]gre3k;
exodus: n. 大批离去,成群外出; [acc]/ˈeksədəs/; [or]gre3k;
animate: [v]使有生气,使活泼;鼓舞,推动; [adj]有生命的; [acc]/ˈænɪmeɪt/; [or]gre3k;
buoyant: [adj]有浮力的;愉快的;(股市)保持高价的; [acc]/ˈbɔɪənt/; [or]gre3k;
barter: [v]物物交换;以货易货; n. 物物交换;实物交易; [acc]/ˈbɑːrtər/; [or]gre3k;
carnal: [adj]肉体的,肉欲的,性欲的,色欲的,淫荡的; [acc]/ˈkɑːrnl/; [or]gre3k;
zenith: n. 顶点,顶峰;全盛; [acc]/ˈziːnɪθ/; [or]gre3k;
defer: [v]使推迟,使延期;听从,顺从; [vi]延期; [acc]/dɪˈfɜːr/; [or]gre3k;
designate: [adj]已受委派而尚未上任的; [v]标出,说出;委任,任命,提名;指定; [acc]/ˈdezɪɡneɪt/; [or]gre3k;
exemplary: [adj]模范的,可仿效的; [acc]/ɪɡˈzempləri/; [or]gre3k;
oblivious: [adj]不在意的;忘却的,健忘的; [acc]/əˈblɪviəs/; [or]gre3k;
wither: [v]枯萎;凋谢; [vt]使枯萎,使凋谢,萎缩;使人感觉羞惭或迷惑; [acc]/ˈwɪðər/; [or]gre3k;
antipathy: n. 反感,厌恶,憎恶; [acc]/ænˈtɪpəθi/; [or]gre3k;
myriad: n. 无数;极大数量; [adj]无数的; [acc]/ˈmɪriəd/; [or]gre3k;
vestige: n. 遗迹,(生)退化的器官,残余,微量(一般用于否定句); [acc]/ˈvestɪdʒ/; [or]gre3k;
confront: [v]与某人对峙;与..对抗;正视; [acc]/kənˈfrʌnt/; [or]gre3k;
propensity: n. 嗜好,习性;倾向; [acc]/prəˈpensəti/; [or]gre3k;
recoil: [v]畏缩;弹回;报应; n. 畏缩;弹回;反作用; [acc]/rɪˈkɔɪl/; [or]gre3k;
repulse: n. 击退;断然拒绝; [vt]击退;断然拒绝;憎恶; [v]使排斥,使厌恶; [acc]/rɪˈpʌls/; [or]gre3k;
impassive: [adj]无动于衷的,冷漠的; [acc]/ɪmˈpæsɪv/; [or]gre3k;
assail: [v]攻击;质问;着手解决; [acc]/əˈseɪl/; [or]gre3k;
blight: n. 植物枯萎病; [v]使.枯萎; [acc]/blaɪt/; [or]gre3k;
propitious: [adj]适合的;吉利的;顺利的; [acc]/prəˈpɪʃəs/; [or]gre3k;
thwart: n. [船]横坐板; [v]阻挠,阻碍,横过; [adj]横放的; [adv]横过; prep. 〈古〉横跨,横过; [acc]/θwɔːrt/; [or]gre3k;
inert: [adj]不动的,惰性的;行动迟钝的;无生气的; [acc]/ɪˈnɜːrt/; [or]gre3k;
Catholic: [adj](兴趣等)广泛的,(C大写)天主教的; n. (C大写)天主教徒; [acc]/ˈkæθlɪk/; [or]gre3k;
pretense: n. 虚假;伪装;自吹;炫耀;借口;做作; [acc]/ˈpriːtens/; [or]gre3k;
vindicate: [vt]证明.无辜;维护,辩护; [acc]/ˈvɪndɪkeɪt/; [or]gre3k;
burlesque: [adj]滑稽的,可笑的; [v]讥笑; n. 脱衣舞,打油诗,滑稽戏,笑剧,杂耍,漫画; [acc]/bɜːrˈlesk/; [or]gre3k;
novice: n. 生手,新手; [acc]/ˈnɑːvɪs/; [or]gre3k;
frugal: [adj]节俭的,俭朴的;不昂贵的,廉价的,花钱少的,不充足的; [acc]/ˈfruːɡl/; [or]gre3k;
contagious: [adj](病)有传染性的;(人)患传染病的;有感染力的; [acc]/kənˈteɪdʒəs/; [or]gre3k;
counterpart: n. 对应的人(物);副本;对手; [acc]/ˈkaʊntərpɑːrt/; [or]gre3k;
responsive: [adj]反应积极的,反应敏捷的;反应热烈的;响应的; [acc]/rɪˈspɑːnsɪv/; [or]gre3k;
rehearsal: n. 排演;叙述;详述;排练; [acc]/rɪˈhɜːrsl/; [or]gre3k;
solicitous: [adj]热切期望的;热心的;挂念的; [acc]/səˈlɪsɪtəs/; [or]gre3k;
lucid: [adj]明晰的;透明的;易懂的;头脑清楚的; [acc]/ˈluːsɪd/; [or]gre3k;
articulate: [adj]善于表达的;发音清晰的; [v]清晰地发音;清楚地讲话;连接,接合;与.合成整体 ,使相互连贯; [acc]/ɑːrˈtɪkjuleɪt/; [or]gre3k;
cipher: n. 密码,暗号,不重要的人; [acc]/ˈsaɪfər/; [or]gre3k;
unavailing: [adj]无效的,徒劳的; [acc]/ˌʌnəˈveɪlɪŋ/; [or]gre3k;
profligate: [adj]放荡的;不检点的;恣意挥霍的; n. 放荡的人,浪子,肆意挥霍者; [acc]/ˈprɑːflɪɡət/; [or]gre3k;
crook: n. 骗子;弯曲处;钩;河弯;诡计; [v]使弯曲; [adj]不正当的;骗人的; [acc]/krʊk/; [or]gre3k;
intrepid: [adj]无畏的;刚毅的,勇敢的; [acc]/ɪnˈtrepɪd/; [or]gre3k;
overwhelm: [v]压垮;不知所措;淹没;打败,压倒; [acc]/ˌoʊvərˈwelm/; [or]gre3k;
candor: n. 坦白,直率,诚挚; [acc]/'kændə/; [or]gre3k;
infirm: [adj]衰弱的;意志薄弱的;不坚固的; [acc]/ɪnˈfɜːrm/; [or]gre3k;
elevate: [v]上升;提高;举起;提拔; [acc]/ˈelɪveɪt/; [or]gre3k;
voluptuous: [adj]撩人的,沉溺酒色的,骄奢淫逸的; [acc]/vəˈlʌptʃuəs/; [or]gre3k;
paradox: n. 矛盾;似矛盾而正确的说法; [acc]/ˈpærədɑːks/; [or]gre3k;
occult: [adj]秘密的,神秘的,玄妙的; n. 神秘学; [vt]隐蔽;[天](使)掩(星); [vi]定时隐蔽; [acc]/əˈkʌlt/; [or]gre3k;
pore: n. 毛孔,细孔; [v]深思熟虑,仔细阅读,审视; [acc]/pɔːr/; [or]gre3k;
tempestuous: [adj]有暴风雨的,暴乱的,剧烈的; [acc]/temˈpestʃuəs/; [or]gre3k;
corporeal: [adj]物质的,有形的,肉体的; [acc]/kɔːrˈpɔːriəl/; [or]gre3k;
transitory: [adj]短暂的,暂时的,瞬息的; [acc]/ˈtrænsətɔːri/; [or]gre3k;
squalid: [adj]污秽的,肮脏的,卑劣的; [acc]/ˈskwɑːlɪd/; [or]gre3k;
succor: n. 救援,援助者,救援人员; [v]援助,救援; [acc]/ˈsʌkər/; [or]gre3k;
curt: [adj]简略的; [acc]/kɜːrt/; [or]gre3k;
stolid: [adj]无动于衷的,感情麻木的; [acc]/ˈstɑːlɪd/; [or]gre3k;
restitution: n. 归还,赔偿; [acc]/ˌrestɪˈtuːʃn/; [or]gre3k;
concur: [v]同意;一致; [acc]/kənˈkɜːr/; [or]gre3k;
dormant: [adj]睡眠的,休眠的;静止的,隐伏的; [acc]/ˈdɔːrmənt/; [or]gre3k;
jargon: n. 行话,术语;黄锆石; [acc]/ˈdʒɑːrɡən/; [or]gre3k;
negotiate: [v]谈判,交涉,商议;成功越过,渡过; [acc]/nɪˈɡoʊʃieɪt/; [or]gre3k;
desultory: [adj]散漫的,无目的的,断断续续的; [acc]/ˈdesəltɔːri/; [or]gre3k;
inducement: n. 诱因;刺激物;犯罪动因; [acc]/ɪnˈduːsmənt/; [or]gre3k;
voluminous: [adj]大量的;长篇的,多产的;庞大的; [adv]宽松地;容量大地;篇幅长地; n. 宽松;容量大,篇幅长; [acc]/vəˈluːmɪnəs/; [or]gre3k;
dandy: n. 花花公子; [adj]服装华丽的,极好的,上等的; [acc]/ˈdændi/; [or]gre3k;
affable: [adj]易于交谈的,和蔼的; [acc]/ˈæfəbl/; [or]gre3k;
patrician: n. 贵族; [adj]贵族的;显贵的;(相貌等)贵族似的; [acc]/pəˈtrɪʃn/; [or]gre3k;
mishap: n. 不幸的事,灾祸;晦气; [acc]/ˈmɪshæp/; [or]gre3k;
anterior: [adj]前面的,先前的; [acc]/ænˈtɪriər/; [or]gre3k;
guile: n. 狡猾,诡计,欺诈; [acc]/ɡaɪl/; [or]gre3k;
antiquated: [adj]陈旧的,过时的; [v]使古旧,废弃; [acc]/ˈæntɪkweɪtɪd/; [or]gre3k;
mint: n. 薄荷,薄荷糖,造币厂; [v]铸造(硬币); [acc]/mɪnt/; [or]gre3k;
shoal: n. 浅滩,沙洲,一群(鱼); [adj](水)浅的; [v]变成浅滩;驶入浅水的地方;(鱼)成群集聚; [acc]/ʃoʊl/; [or]gre3k;
oblique: [adj]斜的,非直角的,隐射的; [v]倾斜; n. [解]斜肌(尤指腹部的肌肉);倾斜物;[军]倾斜航空照片; [adv][军]以45度角; [acc]/əˈbliːk/; [or]gre3k;
untold: [adj]无数的,数不清的; [acc]/ˌʌnˈtoʊld/; [or]gre3k;
dissolute: [adj]无节制的;放荡的; [acc]/ˈdɪsəluːt/; [or]gre3k;
brevity: n. 简短,短小,精炼; [acc]/ˈbrevəti/; [or]gre3k;
verdant: [adj]青葱的,翠绿的; [acc]/ˈvɜːrdnt/; [or]gre3k;
pungent: [adj]刺激性的;刺鼻的;尖锐的; [acc]/ˈpʌndʒənt/; [or]gre3k;
persevere: [v]坚持,不屈不挠; [acc]/ˌpɜːrsəˈvɪr/; [or]gre3k;
hive: n. 蜂房,忙碌之地; [v]分开,隔开; [acc]/haɪv/; [or]gre3k;
concede: [v]承认;承认失败;让给,让与;让步; [acc]/kənˈsiːd/; [or]gre3k;
depravity: n. n. 恶劣行为;堕落,腐败,邪恶;腐败;邪恶;恶劣行为,腐化堕落的行为; [acc]/dɪˈprævəti/; [or]gre3k;
stifle: [v]抑制,压制,使窒息; [acc]/ˈstaɪfl/; [or]gre3k;
indemnity: n. 赔偿物;补偿,赔偿;保障; [acc]/ɪnˈdemnəti/; [or]gre3k;
tardy: n. 迟到,迟到记录; [adj]缓慢的,迟到的,磨蹭的; [acc]/ˈtɑːrdi/; [or]gre3k;
venom: n. 毒液;恶意;怨恨; [vt]使有毒;放毒; [acc]/ˈvenəm/; [or]gre3k;
ambiguous: [adj]含糊不清的,引起歧义的,模棱两可的; [acc]/æmˈbɪɡjuəs/; [or]gre3k;
avowal: n. 公开承认,声明; [acc]/əˈvaʊəl/; [or]gre3k;
cleave: [v]劈开,分裂; [acc]/kliːv/; [or]gre3k;
credible: [adj]可信任的,可靠的,出色的; [acc]/ˈkredəbl/; [or]gre3k;
portentous: [adj]不祥的;预兆的;令人惊讶的; [acc]/pɔːrˈtentəs/; [or]gre3k;
plebeian: [adj]平民的,普通的,粗俗的; n. 平民,百姓,粗俗的人; [acc]/pləˈbiːən/; [or]gre3k;
grimace: [v]做鬼脸,面部歪扭; n. 愁眉苦脸,怪相,鬼脸; [acc]/ˈɡrɪməs/; [or]gre3k;
caricature: n. 讽刺画,滑稽模仿;扭曲,夸张的描述; [acc]/ˈkærɪkətʃər/; [or]gre3k;
barricade: n. 路障;障碍物;栅栏; [v]设路障;挡住; [acc]/ˌbærɪˈkeɪd/; [or]gre3k;
hypocritical: [adj]虚伪的;伪善的; [acc]/ˌhɪpəˈkrɪtɪkl/; [or]gre3k;
tenacious: [adj]坚忍不拔的,固执的,顽强的; [acc]/təˈneɪʃəs/; [or]gre3k;
florid: [adj]涨红的,华丽的,红润的; [acc]/ˈflɔːrɪd/; [or]gre3k;
hoard: [v]贮藏,秘藏; n. 贮藏物; [acc]/hɔːrd/; [or]gre3k;
insipid: [adj]淡而无味的;枯燥乏味的; [acc]/ɪnˈsɪpɪd/; [or]gre3k;
spleen: n. 脾,脾气,怒气; [acc]/spliːn/; [or]gre3k;
residue: n. 剩余物;残渣;渣;残数; [acc]/ˈrezɪduː/; [or]gre3k;
staunch: [adj]坚定的,可靠的; [vt]止住;止血; [acc]/stɔːntʃ/; [or]gre3k;
taper: [v]逐渐变细; n. 锥形;渐弱;蜡芯,小蜡烛; [vi]变尖;逐渐减弱; [vt]变尖;逐渐减弱; [adj]渐细的;斜的;依次递减的; [acc]/ˈteɪpər/; [or]gre3k;
lustrous: [adj]有光泽的;光辉的; [acc]/ˈlʌstrəs/; [or]gre3k;
forage: [v]搜寻,翻寻,觅食; n. (牛马的)饲料,粮草; [acc]/ˈfɔːrɪdʒ/; [or]gre3k;
sling: n. [机]吊索,投石器,弹弓,抛掷; [v]用投石器投掷,吊起; [acc]/slɪŋ/; [or]gre3k;
bland: [vi]变得平淡无奇,变得枯燥无味; [adj]温和的;(食物等)清淡的;漠不关心的; [vt]使变得淡而无味,使变得枯燥无味;除掉.的特性; [acc]/blænd/; [or]gre3k;
extricate: [v]拯救,救出; n. 解脱;解脱者; [acc]/ˈekstrɪkeɪt/; [or]gre3k;
nourish: [v]养育;培育(希望);增强(希望); [acc]/ˈnɜːrɪʃ/; [or]gre3k;
dissent: [v]不同意;不信奉国教; n. 异议;(大写)不信奉国教; [acc]/dɪˈsent/; [or]gre3k;
unruly: [adj]不守规矩的;任性的;难驾驭的; [acc]/ʌnˈruːli/; [or]gre3k;
speculate: [vi]推测,猜测;投机,做投机买卖; [vt]推测; [acc]/ˈspekjuleɪt/; [or]gre3k;
harangue: n. 长篇大论; [v]高谈阔论;大声训斥; [acc]/həˈræŋ/; [or]gre3k;
dupe: n. 受骗的人,上当者; [v]欺骗,愚弄; [acc]/duːp/; [or]gre3k;
allay: [v]减轻;使缓和;使平静; [acc]/əˈleɪ/; [or]gre3k;
tonic: n. 补药;主调音或基音; [adj]滋补的;声调的;使精神振作的; [acc]/ˈtɑːnɪk/; [or]gre3k;
sacrilege: n. 亵渎圣物,悖理逆天的行为; [acc]/ˈsækrəlɪdʒ/; [or]gre3k;
blemish: [v]损害,玷污; n. 瑕疵,缺点; [acc]/ˈblemɪʃ/; [or]gre3k;
scowl: n. 愁容,怒容,暴风雨前的阴沉晦暗; [v]皱眉头,怒目而视; [acc]/skaʊl/; [or]gre3k;
drudgery: n. 苦工;苦差事;单调乏味的工作; [acc]/ˈdrʌdʒəri/; [or]gre3k;
supplement: n. 增补,补充物,保健品;附录; [v]补充; [acc]/ˈsʌplɪmənt/; [or]gre3k;
fortify: [v]设防于;增强; [acc]/ˈfɔːrtɪfaɪ/; [or]gre3k;
mutter: n. 低语;小声抱怨; [v]低声说;小声抱怨; [vt]低声说;抱怨地说; [acc]/ˈmʌtər/; [or]gre3k;
invoke: [v]调用,祈求,恳求,引起; [acc]/ɪnˈvoʊk/; [or]gre3k;
mimic: [v]模仿,戏弄; n. 模仿者; [adj]模拟的;假的,伪装的; [acc]/ˈmɪmɪk/; [or]gre3k;
conservatory: n. 温室;音乐学校; [adj]有保存力的;保存性的; [acc]/kənˈsɜːrvətɔːri/; [or]gre3k;
simile: n. 直喻,明喻; [acc]/ˈsɪməli/; [or]gre3k;
volatile: [adj]易气化的;爆炸性的;反复无常的;短暂的;不稳定的; [acc]/ˈvɑːlətl/; [or]gre3k;
accumulate: [vi]聚积,堆积; [vt]积攒,积累; [acc]/əˈkjuːmjəleɪt/; [or]gre3k;
fawn: [v]奉承;生(小鹿或小动物); n. 小鹿;浅黄褐色; [acc]/fɔːn/; [or]gre3k;
dodge: n. 托词;躲闪,躲避; [v]回避,规避;躲避,避开; [acc]/dɑːdʒ/; [or]gre3k;
refractory: [adj]难治的,难熔的,不听话的; [acc]/rɪˈfræktəri/; [or]gre3k;
conciliate: [v]调和,安抚; [acc]/kənˈsɪlieɪt/; [or]gre3k;
paroxysm: n. 突发,阵发; [adj]发作性的,爆发性的; [acc]/ˈpærəksɪzəm/; [or]gre3k;
immaterial: [adj]非实体的,无关紧要的; [acc]/ˌɪməˈtɪriəl/; [or]gre3k;
quail: n. 鹌鹑; [v]畏缩;感到恐惧; [acc]/kweɪl/; [or]gre3k;
abhor: [v]痛恨;憎恶; [acc]/əbˈhɔːr/; [or]gre3k;
dexterous: [adj]灵巧的,熟练的; [acc]/ˈdekstrəs/; [or]gre3k;
incentive: n. 刺激,激励;鼓励; [acc]/ɪnˈsentɪv/; [or]gre3k;
deign: [v]屈尊,惠允(做某事); [acc]/deɪn/; [or]gre3k;
variegated: n. 使富有变化,使成为杂色; [adj]斑驳的,多色的,富于变化的; [acc]/ˈverɪɡeɪtɪd/; [or]gre3k;
blithe: [adj]愉快的;快乐无忧的; [acc]/blaɪð/; [or]gre3k;
limpid: [adj]清澈的,透明的,平静的; [acc]/ˈlɪmpɪd/; [or]gre3k;
rhetorical: [adj]语言上的,文字上的,言辞华丽(却往往无内涵的); [acc]/rɪˈtɔːrɪkl/; [or]gre3k;
indigenous: [adj]土生土长的,本土的; [acc]/ɪnˈdɪdʒənəs/; [or]gre3k;
rudimentary: [adj]基本的,初期的;发育不完全的;退化的; [acc]/ˌruːdɪˈmentri/; [or]gre3k;
immaculate: [adj]完美的,无瑕疵的;洁净的; [acc]/ɪˈmækjələt/; [or]gre3k;
specious: [adj]外表美观,华而不实的,徒有其表的; [acc]/ˈspiːʃəs/; [or]gre3k;
amicable: [adj]友善的,温和的,平心静气的; [acc]/ˈæmɪkəbl/; [or]gre3k;
spurious: [adj]假的,伪造的,欺骗的; [acc]/ˈspjʊriəs/; [or]gre3k;
perfidy: n. 不忠,背叛; [acc]/ˈpɜːrfədi/; [or]gre3k;
covetous: [adj]贪婪的,贪心的; [acc]/ˈkʌvətəs/; [or]gre3k;
qualify: [v]胜任,使具有资格;描述,形容; [acc]/ˈkwɑːlɪfaɪ/; [or]gre3k;
inimitable: [adj]独特的,无比的,无法仿效的; [acc]/ɪˈnɪmɪtəbl/; [or]gre3k;
wag: n. 摇摆;爱说笑的人; [v]摇动; [acc]/wæɡ/; [or]gre3k;
grumble: [v]埋怨;发牢骚;咕哝; n. 隆隆响声;抱怨,怨言; [acc]/ˈɡrʌmbl/; [or]gre3k;
puny: [adj]弱小的,微不足道的; [acc]/ˈpjuːni/; [or]gre3k;
callous: [adj]无情的,铁石心肠的,硬结的; [vt](使)变硬,(使)起茧;(使)冷酷无情; [acc]/ˈkæləs/; [or]gre3k;
bewitching: [adj]迷人的,令人着迷的; [acc]/bɪˈwɪtʃɪŋ/; [or]gre3k;
caustic: [adj]腐蚀性的;苛性的;刻薄的;焦散的; n. 腐蚀剂;苛性钠;焦散曲线; [acc]/ˈkɔːstɪk/; [or]gre3k;
compatible: [adj]可和谐共存的;兼容的; [acc]/kəmˈpætəbl/; [or]gre3k;
sanitary: [adj]卫生的;清洁的; [acc]/ˈsænəteri/; [or]gre3k;
bane: n. 祸根; [acc]/beɪn/; [or]gre3k;
benign: [adj]仁慈的;慈祥的;(病)良性的; [acc]/bɪˈnaɪn/; [or]gre3k;
rivulet: n. 小溪,小河; [acc]/ˈrɪvjələt/; [or]gre3k;
ripen: [vi]成熟; [vt]使.成熟;使成熟可以食用; [acc]/ˈraɪpən/; [or]gre3k;
duplicate: n. 复制品; [v]复制;重复; [adj]完全一样的; [acc]/ˈduːplɪkeɪt/; [or]gre3k;
stockade: n. 栅栏,围栏; [acc]/stɑːˈkeɪd/; [or]gre3k;
ramble: [vi]瞎扯;溜达;漫步于; n. 漫步; [acc]/ˈræmbl/; [or]gre3k;
convulsion: n. 惊厥,动乱,震撼,震动; [acc]/kənˈvʌlʃn/; [or]gre3k;
gush: [v]涌出;滔滔不绝地说,洋洋洒洒地写; n. 迸发; [acc]/ɡʌʃ/; [or]gre3k;
incarnate: [adj]化身的,人体化的,肉色的; [v]体现,使.具体化,使实体化; [acc]/ɪnˈkɑːrnət/; [or]gre3k;
cosmopolitan: n. 游历四方的人; [adj]见多识广的;多元的;广泛分布的; [acc]/ˌkɑːzməˈpɑːlɪtən/; [or]gre3k;
opaque: [adj]不透明的;难懂的; [acc]/oʊˈpeɪk/; [or]gre3k;
acquiesce: [v]默许;勉强同意; [adj]默认的; [acc]/ˌækwiˈes/; [or]gre3k;
subservient: [adj]屈从的;奉承的;有用的,有帮助的; [acc]/səbˈsɜːrviənt/; [or]gre3k;
delegate: n. 代表; [v]委派..为代表,授权; [acc]/ˈdelɪɡət/; [or]gre3k;
rectitude: n. 正直,公正,正确; [acc]/ˈrektɪtuːd/; [or]gre3k;
flirt: n. 急扔;调情者; [vi]卖弄风情,调情;戏弄,不认真地对待;摆动; [vt]急速摆动,挥动; [acc]/flɜːrt/; [or]gre3k;
diffuse: [v]传播;扩散,弥漫;漫射; [adj]四散的,散开的;不清楚的; [acc]/dɪˈfjuːz/; [or]gre3k;
belligerent: [adj](国家等)交战的,挑斗的; n. 交战国,交战者;参加斗殴的人或集团; [acc]/bəˈlɪdʒərənt/; [or]gre3k;
startle: [v]吃惊;惊吓; [acc]/ˈstɑːrtl/; [or]gre3k;
vernacular: [adj]本国的,地方的,用本地语写成的; n. 方言;土语;(建筑的)民间风格; [acc]/vərˈnækjələr/; [or]gre3k;
relapse: n. (旧病的)复发,重陷,回复; [vi]重新陷入,回复; [acc]/rɪˈlæps/; [or]gre3k;
contiguous: [adj]相接的;邻近的,附近的; [acc]/kənˈtɪɡjuəs/; [or]gre3k;
arable: [adj]可耕的,适合种植的; n. 耕地; [acc]/ˈærəbl/; [or]gre3k;
plumb: n. 铅锤,测锤; [vi]垂直悬挂; [adj]垂直的; [vt]用铅锤测量; [adv]垂直地; [acc]/plʌm/; [or]gre3k;
varnish: n. 清漆;虚饰;光泽面; [v]涂上清漆;使.有光泽; [acc]/ˈvɑːrnɪʃ/; [or]gre3k;
negligent: [adj]疏忽的,粗心大意的;随意的; [acc]/ˈneɡlɪdʒənt/; [or]gre3k;
compunction: n. 懊悔,良心不安; [acc]/kəmˈpʌŋkʃn/; [or]gre3k;
expire: [v]期满,(期限)终止;断气,死亡; [acc]/ɪkˈspaɪər/; [or]gre3k;
taunt: n. 辱骂,嘲弄; [vt]嘲弄,奚落; [adj][海](桅杆)很高的; [adv]扯满风帆; [acc]/tɔːnt/; [or]gre3k;
debris: n. 废墟,残骸; [acc]/dəˈbriː/; [or]gre3k;
travail: n. 分娩的痛苦,艰苦劳动; [v]辛勤努力,经受分娩的阵痛; [acc]/trəˈveɪl/; [or]gre3k;
institute: n. 学会;学院,专科学院,研究院; [vt]建立,设立,制定; [acc]/ˈɪnstɪtuːt/; [or]gre3k;
complacent: [adj]自满的,得意的; [acc]/kəmˈpleɪsnt/; [or]gre3k;
scurvy: n. 坏血病; [adj]卑鄙的,下流的; [acc]/ˈskɜːrvi/; [or]gre3k;
dissuade: [v]劝阻,阻止; [acc]/dɪˈsweɪd/; [or]gre3k;
snarl: [v]缠结,混乱,吠,咆哮,怒骂; n. 咆哮,吼叫,怒骂,缠结,混乱; [acc]/snɑːrl/; [or]gre3k;
concord: n. 和睦,公约; [acc]/ˈkɑːŋkɔːrd/; [or]gre3k;
morose: [adj]脾气坏的,乖戾的,不高兴的; [acc]/məˈroʊs/; [or]gre3k;
obeisance: n. 鞠躬,敬礼;尊敬; [acc]/oʊˈbiːsns/; [or]gre3k;
methodical: [adj]有系统的,有方法的; [acc]/məˈθɑːdɪkl/; [or]gre3k;
deter: [v]防止,阻止,使踌躇; [acc]/dɪˈtɜːr/; [or]gre3k;
negation: n. 否定,拒绝;反面; 对立面; [acc]/nɪˈɡeɪʃn/; [or]gre3k;
exuberant: [adj](植物)茂盛的,(人)充满活力的; [acc]/ɪɡˈzuːbərənt/; [or]gre3k;
veto: [v]否决;投反对票; n. 否决;否决权;禁止; [acc]/ˈviːtoʊ/; [or]gre3k;
elude: [v]逃避,躲避;使.错过,使.找不到;使.不记得;把.难住; [acc]/iˈluːd/; [or]gre3k;
salient: [adj]显著的;突出的;跳跃的; n. 凸角;突出部分; [acc]/ˈseɪliənt/; [or]gre3k;
immutable: [adj]永远不变的,永恒的; [acc]/ɪˈmjuːtəbl/; [or]gre3k;
extraction: n. 抽出,取出;家世,出身;抽出物; [acc]/ɪkˈstrækʃn/; [or]gre3k;
thorny: [adj]多刺的;痛苦的;令人苦恼的; [acc]/ˈθɔːrni/; [or]gre3k;
pinnacle: n. (哥德式建筑的)小尖塔,顶峰; [v]置于尖顶上,置于高处; [acc]/ˈpɪnəkl/; [or]gre3k;
canvass: [v]仔细检查或详尽地讨论;审查,游说; n. 讨论;细查;劝诱; [acc]/ˈkænvəs/; [or]gre3k;
squall: n. (通常伴随着雨或雪的)风暴,暴风雪; [v]尖叫; [acc]/skwɔːl/; [or]gre3k;
naive: [adj]天真的; n. 天真的人; [acc]/naɪˈiːv/; [or]gre3k;
sip: [v]啜饮; n. 一小口; [acc]/sɪp/; [or]gre3k;
medley: [adj]大杂烩,混合物; n. 混合;混杂;混合物; [acc]/ˈmedli/; [or]gre3k;
persecute: [v](尤指因宗教或政治信仰不同)迫害;烦扰,纠缠; [acc]/ˈpɜːrsɪkjuːt/; [or]gre3k;
nautical: [adj]航海的;海上的;海员的; [acc]/ˈnɔːtɪkl/; [or]gre3k;
vivacious: [adj]活泼的,快活的(多指女性); [acc]/vɪˈveɪʃəs/; [or]gre3k;
somber: [adj]忧郁的;昏暗的,阴天的; [acc]/'sɒmbə/; [or]gre3k;
fluent: [adj]流畅的,(说话)流利的;顺畅的,流畅熟练的; [acc]/ˈfluːənt/; [or]gre3k;
brittle: [adj]易碎的;脆弱的;靠不住的; n. 薄片脆糖; [acc]/ˈbrɪtl/; [or]gre3k;
loathe: [v]憎恨,厌恶; [acc]/loʊð/; [or]gre3k;
assiduous: [adj]勤勉的,刻苦的; [acc]/əˈsɪdʒuəs/; [or]gre3k;
mosaic: n. 镶嵌细工,马赛克; [adj]摩西的;拼花的; [vt]镶嵌;用马赛克装饰; [acc]/moʊˈzeɪɪk/; [or]gre3k;
exorbitant: [adj]要价过高的,过分的; [acc]/ɪɡˈzɔːrbɪtənt/; [or]gre3k;
squat: [adj]蹲着的; [v]蹲坐,蹲伏; n. 蹲坐; [acc]/skwɑːt/; [or]gre3k;
condescending: [adj]贬低的;有优越感的; [acc]/ˌkɑːndɪˈsendɪŋ/; [or]gre3k;
warp: n. 弯曲,歪曲,偏见; [v]使变形,使有偏见,曲解; [acc]/wɔːrp/; [or]gre3k;
tortuous: [adj]弯弯曲曲的,蜿蜒的; [acc]/ˈtɔːrtʃuəs/; [or]gre3k;
foil: n. 箔;锡箔纸;衬托; [v]挫败;使受挫折; [acc]/fɔɪl/; [or]gre3k;
threadbare: [adj]磨破的,衣衫褴褛的,乏味的,俗套的; [acc]/ˈθredber/; [or]gre3k;
jot: n. 最少量,微不足道的量; [vt]草草记下;匆匆记下; [acc]/dʒɑːt/; [or]gre3k;
doze: [vi]瞌睡,假寐; n. 瞌睡; [acc]/doʊz/; [or]gre3k;
leaven: n. 发酵剂,影响力; [v]发酵,影响,渐变; [acc]/ˈlevn/; [or]gre3k;
noxious: [adj]有害的,有毒的; [acc]/ˈnɑːkʃəs/; [or]gre3k;
preoccupation: n. 抢先占据;全神贯注;首先要做的事,急务; [acc]/priˌɑːkjuˈpeɪʃn/; [or]gre3k;
fraudulent: [adj]欺诈的,欺骗性的,骗得的; [acc]/ˈfrɔːdʒələnt/; [or]gre3k;
gratuitous: [adj]无根据的,无理由的,无报酬的,免费的,多余的; [acc]/ɡrəˈtuːɪtəs/; [or]gre3k;
astute: [adj]机敏的,精明的,狡猾的; [acc]/əˈstuːt/; [or]gre3k;
consonant: [adj]辅音的;一致的,和谐的; n. 辅音;辅音字母; [acc]/ˈkɑːnsənənt/; [or]gre3k;
frigid: [adj]寒冷的,冷淡的,死板的,呆板的,性冷淡的; [acc]/ˈfrɪdʒɪd/; [or]gre3k;
stealth: n. 隐秘,秘密; [acc]/stelθ/; [or]gre3k;
irritate: [v]使烦躁;激怒;使难受; [acc]/ˈɪrɪteɪt/; [or]gre3k;
appreciable: [adj]很可观的;可感知的;可察觉的;可评估的; [acc]/əˈpriːʃəbl/; [or]gre3k;
lank: [adj]瘦削的;稀疏的;平直的;细长的; [acc]/læŋk/; [or]gre3k;
concise: [adj]简明的,简要的;简洁的,简要的; [acc]/kənˈsaɪs/; [or]gre3k;
hovel: n. 茅舍,肮脏的小屋; [acc]/ˈhʌvl/; [or]gre3k;
timorous: [adj]胆小的,胆怯的,羞怯的; [acc]/ˈtɪmərəs/; [or]gre3k;
precipitation: n. 猛然摔下;促使;急促;沉淀;降水; [acc]/prɪˌsɪpɪˈteɪʃn/; [or]gre3k;
gloss: n. 光泽;假象;唇膏; [vt]使有光彩;掩盖; [acc]/ɡlɑːs/; [or]gre3k;
sloth: n. 懒惰;树懒; [acc]/slɑːθ/; [or]gre3k;
erratic: [adj]古怪的;反复无常的,不稳定的; [acc]/ɪˈrætɪk/; [or]gre3k;
conducive: [adj]有益的,有助于.的; [acc]/kənˈduːsɪv/; [or]gre3k;
knack: n. 诀窍;本领;熟练技术;巧妙手法; [acc]/næk/; [or]gre3k;
dais: n. 主席台,嘉宾席; [acc]/ˈdeɪɪs/; [or]gre3k;
exotic: [adj]奇异的,珍奇的,来自异国的; [acc]/ɪɡˈzɑːtɪk/; [or]gre3k;
drab: [adj]枯黄色的,无聊的,单调的; n. 单调;淡褐色;[印,纺]淡褐色厚呢;邋遢女人; [acc]/dræb/; [or]gre3k;
ostentatious: [adj]浮华的,虚饰的,外观美丽的; [acc]/ˌɑːstenˈteɪʃəs/; [or]gre3k;
antithetical: [adj]完全对立的,相反的; [acc]/ˌæntɪˈθetɪkl/; [or]gre3k;
jaded: [adj]疲倦的,精疲力竭的;厌倦的; [acc]/ˈdʒeɪdɪd/; [or]gre3k;
ignominy: n. 耻辱,不体面,丑行; [acc]/ˈɪɡnəmɪni/; [or]gre3k;
trepidation: n. 恐惧,惶恐; [acc]/ˌtrepɪˈdeɪʃn/; [or]gre3k;
enigma: n. 谜,哑谜;闷葫芦; [acc]/ɪˈnɪɡmə/; [or]gre3k;
menial: [adj]仆人的,乏味的; n. 家仆; [acc]/ˈmiːniəl/; [or]gre3k;
masquerade: n. 化装舞会;伪装,假扮; [vi]假扮; [acc]/ˌmæskəˈreɪd/; [or]gre3k;
peck: n. 啄;轻吻;喙; [v]啄; [vt]轻吻; [acc]/pek/; [or]gre3k;
hale: [adj]矍铄的(尤指老人);强壮的; [adv]完全地; [v]迫使;猛拉;不断流出; [acc]/heɪl/; [or]gre3k;
feign: [v]假装,装作; [acc]/feɪn/; [or]gre3k;
grit: n. 沙粒;决心,勇气; [v]研磨;在.上铺砂砾;下定决心,咬紧牙关; [acc]/ɡrɪt/; [or]gre3k;
intuitive: [adj]直觉的,凭直觉获知的; [acc]/ɪnˈtuːɪtɪv/; [or]gre3k;
flit: n. 轻快的飞行;迁移; [vi]掠过;轻快地飞过;偷偷溜走;去世; [acc]/flɪt/; [or]gre3k;
taciturn: [adj]沉默寡言的; [acc]/ˈtæsɪtɜːrn/; [or]gre3k;
stigma: n. [植]柱头,耻辱,污名,烙印,特征; [acc]/ˈstɪɡmə/; [or]gre3k;
obsequious: [adj]逢迎的,谄媚的; [acc]/əbˈsiːkwiəs/; [or]gre3k;
duplicity: n. 口是心非;表里不一;不诚实; [acc]/duːˈplɪsəti/; [or]gre3k;
prologue: n. 开场白,序幕; [acc]/ˈproʊlɔːɡ/; [or]gre3k;
imperturbable: [adj]冷静的,沉着的; [acc]/ˌɪmpərˈtɜːrbəbl/; [or]gre3k;
awning: n. 雨篷,遮阳篷; [acc]/ˈɔːnɪŋ/; [or]gre3k;
numb: [adj]麻木的,失去知觉的; [vt]使麻木,使失去知觉; [acc]/nʌm/; [or]gre3k;
rife: [adj]普遍的;流行的; [acc]/raɪf/; [or]gre3k;
attest: [vt]证明;证实;为.作证; [vi]证明;作证; [acc]/əˈtest/; [or]gre3k;
ravenous: [adj]贪婪的;渴望的,极饿的;狼吞虎咽的; [acc]/ˈrævənəs/; [or]gre3k;
efface: [v]擦掉,抹去;消去; [acc]/ɪˈfeɪs/; [or]gre3k;
lurch: n. 突然倾斜,挫折,举步蹒跚,徘徊,困境; [v]惨败,倾斜,徘徊,击败; [acc]/lɜːrtʃ/; [or]gre3k;
simpleton: n. 傻子;笨蛋; [acc]/ˈsɪmpltən/; [or]gre3k;
babble: [v]呀呀学语,喋喋不休,作潺潺声;泄露(秘密); n. 儿语,胡言乱语,潺潺声; [acc]/ˈbæbl/; [or]gre3k;
wrest: n. 扭,拧; [vt]用力拧;强夺;歪曲; [acc]/rest/; [or]gre3k;
untoward: [adj](困难)出乎意料的; [acc]/ʌnˈtɔːrd/; [or]gre3k;
renegade: n. 叛教者,脱党者,叛徒; [v]背叛,背教,变节; [adj]叛教的,背叛的,变节的; [acc]/ˈrenɪɡeɪd/; [or]gre3k;
incipient: [adj]初期的;刚出现的; [acc]/ɪnˈsɪpiənt/; [or]gre3k;
coax: [v]哄,哄诱; [acc]/koʊks/; [or]gre3k;
connoisseur: n. (艺术品等的)鉴赏家,鉴定家,行家; [acc]/ˌkɑːnəˈsɜːr/; [or]gre3k;
practitioner: n. (医生或律师等)开业者;实践者,从事者; [acc]/prækˈtɪʃənər/; [or]gre3k;
interim: n. 中间时期,过渡时期; [adj]暂时的; [acc]/ˈɪntərɪm/; [or]gre3k;
effrontery: n. 厚颜无耻; [acc]/ɪˈfrʌntəri/; [or]gre3k;
obdurate: [adj]固执的,冷酷无情的; [acc]/ˈɑːbdərət/; [or]gre3k;
chide: [v]叱责,指责; [acc]/tʃaɪd/; [or]gre3k;
mettle: n. 勇气,毅力,耐力; [acc]/ˈmetl/; [or]gre3k;
soak: [v]浸泡,渗透,吸入; n. 浸泡; [acc]/soʊk/; [or]gre3k;
stench: n. 臭气,恶臭; [vi](使)发恶臭; [vt]发恶臭; [acc]/stentʃ/; [or]gre3k;
sedate: [adj]沉着的,镇定的,平和的; [v]使服镇静剂而安静下来; [acc]/sɪˈdeɪt/; [or]gre3k;
hamper: [v]阻碍,妨碍,牵制; n. (有盖的)大篮子; [acc]/ˈhæmpər/; [or]gre3k;
overture: n. 主动表示,姿态;前奏曲;序言,事件的开端;提出问题; [vt]作为一种主动姿态提出;向.提出建议; [acc]/ˈoʊvərtʃər/; [or]gre3k;
figurative: [adj]比喻的,修饰丰富的,形容多的; [acc]/ˈfɪɡərətɪv/; [or]gre3k;
pacify: [v]使平静,安慰,抚慰; [acc]/ˈpæsɪfaɪ/; [or]gre3k;
opportune: [adj]适当的,恰好的,合时宜的; [acc]/ˌɑːpərˈtuːn/; [or]gre3k;
facetious: [adj]滑稽的,诙谐的,开玩笑的; [acc]/fəˈsiːʃəs/; [or]gre3k;
embarrass: [vt]使窘迫,使尴尬(尤指在社交场合);困窘,困扰; [acc]/ɪmˈbærəs/; [or]gre3k;
piquant: [adj]辛辣的,开胃的;活泼有趣的; [acc]/ˈpiːkənt/; [or]gre3k;
languish: [v]凋萎,衰弱,变得消瘦; [acc]/ˈlæŋɡwɪʃ/; [or]gre3k;
batch: n. 一批(人或物);一批生产量; [acc]/bætʃ/; [or]gre3k;
dearth: n. 缺乏,供应不足; [acc]/dɜːrθ/; [or]gre3k;
temerity: n. 鲁莽,大胆,蛮勇; [acc]/təˈmerəti/; [or]gre3k;
influx: n. 流入,涌入;河口; [acc]/ˈɪnflʌks/; [or]gre3k;
murky: [adj]黑暗的,朦胧的; [adv]阴暗地,混浊地,可疑地; n. 阴暗;昏暗;混浊;可疑; [acc]/ˈmɜːrki/; [or]gre3k;
jubilant: [adj]喜悦的,欢呼的; [acc]/ˈdʒuːbɪlənt/; [or]gre3k;
falter: [v]蹒跚,摇摆;踌躇;畏缩; n. 踌躇;支吾;颤抖; [acc]/ˈfɔːltər/; [or]gre3k;
archaic: [adj]古代的;陈旧的,过时的,老式的;已不通用的; [acc]/ɑːrˈkeɪɪk/; [or]gre3k;
banter: n. 善意地取笑,逗弄; [v]善意的与人开玩笑; [acc]/ˈbæntər/; [or]gre3k;
recluse: n. 隐士; [adj]隐士的,隐遁的; [acc]/ˈrekluːs/; [or]gre3k;
awry: [adj]扭曲的,走样的; [adv]歪曲地;歪斜地;错误地; [acc]/əˈraɪ/; [or]gre3k;
sepulchral: [adj]坟墓的,阴深的; [acc]/səˈpʌlkrəl/; [or]gre3k;
concave: [adj]凹面的; n. 凹面; [vt]使成凹形; [acc]/kɑːnˈkeɪv/; [or]gre3k;
odium: n. 憎恶,反感; [acc]/ˈoʊdiəm/; [or]gre3k;
gamble: [v]赌博;投机;打赌; n. 赌博;冒险; [vt]赌输; [acc]/ˈɡæmbl/; [or]gre3k;
reprove: [v]责骂,申斥; [acc]/rɪˈpruːv/; [or]gre3k;
alloy: n. 合金; [v]使成合金; [acc]/ˈælɔɪ/; [or]gre3k;
torpor: n. 麻木;无感觉;不活泼; [acc]/ˈtɔːrpər/; [or]gre3k;
evince: [v]表明,表示,引起; [acc]/ɪˈvɪns/; [or]gre3k;
baleful: [adj]邪恶的,恶意的; [adv]凶恶地,有害地; [acc]/ˈbeɪlfl/; [or]gre3k;
talisman: n. 护身符,避邪物; [acc]/ˈtælɪzmən/; [or]gre3k;
officious: [adj]多管闲事的,非官方的; [adv]过分殷勤地; n. 过分殷勤,爱管闲事; [acc]/əˈfɪʃəs/; [or]gre3k;
accessory: n. (妇女的)装饰品;附件;附属物;同谋; [adj]附属的;辅助的;同谋的; [acc]/əkˈsesəri/; [or]gre3k;
schism: n. 分裂,(教派或政党的)分裂; [acc]/ˈsɪzəm/; [or]gre3k;
overbearing: [adj]专横的,独断的,傲慢的; [acc]/ˌoʊvərˈberɪŋ/; [or]gre3k;
baffle: [v]使困惑;难住;阻碍; n. 挡板; [acc]/ˈbæfl/; [or]gre3k;
harass: [v]使困扰,使烦恼,反复袭击; [acc]/həˈræs/; [or]gre3k;
incorrigible: [adj]积习难改的,不可救药的; [acc]/ɪnˈkɔːrɪdʒəbl/; [or]gre3k;
pry: [v]刺探,打听,撬开; n. 窥探;杠杆;爱打探的人; [acc]/praɪ/; [or]gre3k;
culpable: [adj]有罪的;该责备的;不周到的;应受处罚的; [acc]/ˈkʌlpəbl/; [or]gre3k;
subside: [vi]平息,减弱;减弱;(建筑)下陷;(尤指洪水的水位) 回落; [acc]/səbˈsaɪd/; [or]gre3k;
ruse: n. 诡计; [acc]/ruːz/; [or]gre3k;
notch: n. 刻痕,凹口;等级;峡谷; [v]赢得;用刻痕计算;在.上刻凹痕; [acc]/nɑːtʃ/; [or]gre3k;
heretical: [adj]异端的,异教的; [acc]/həˈretɪkl/; [or]gre3k;
rave: n. 热切赞扬,喧闹的宴会;胡言乱语; [v]咆哮;胡言乱语;语无伦次地说; [adj]赞扬的; [acc]/reɪv/; [or]gre3k;
credence: n. 信任,相信; [acc]/ˈkriːdns/; [or]gre3k;
turbid: [adj]混浊的,紊乱的; [acc]/ˈtɜːrbɪd/; [or]gre3k;
shred: n. 碎片,少量,毁灭; [v]切成细条,撕成碎片; [acc]/ʃred/; [or]gre3k;
bravado: n. 故作勇敢,逞能; [acc]/brəˈvɑːdoʊ/; [or]gre3k;
succumb: [v]屈从,屈服,因.死亡(to); [acc]/səˈkʌm/; [or]gre3k;
petulant: [adj]性急的,易怒的,爱闹气的; [acc]/ˈpetʃələnt/; [or]gre3k;
edible: [adj]可食的; [acc]/ˈedəbl/; [or]gre3k;
quell: [v]镇压,消除,减轻(激动,恐惧等); n. 镇压,平息,减轻; [acc]/kwel/; [or]gre3k;
rampant: [adj]猖獗的,蔓生的; [acc]/ˈræmpənt/; [or]gre3k;
fallow: [adj]休耕的;不活跃的;休闲地,休闲的; n. 休耕地;休耕; [v]使(翻耕后的土地)休闲; [acc]/ˈfæloʊ/; [or]gre3k;
probity: n. 正直,诚实; [acc]/ˈproʊbəti/; [or]gre3k;
palatable: [adj]美味的,合口味的,合心意的; [acc]/ˈpælətəbl/; [or]gre3k;
hallucination: n. 幻觉,幻想; [acc]/həˌluːsɪˈneɪʃn/; [or]gre3k;
pique: [v]引起(好奇心,兴趣等),不悦,愤怒; n. 不悦,生气; [acc]/piːk/; [or]gre3k;
lurk: n. 潜伏,潜行; [vi]潜伏;潜藏;鬼鬼祟祟地走; [acc]/lɜːrk/; [or]gre3k;
blur: n. 污点,模糊; [v]使.模糊;弄脏;变模糊; [acc]/blɜːr/; [or]gre3k;
invective: n. 猛烈抨击,恶言漫骂; [adj]谩骂的;恶言的;诽谤的; [acc]/ɪnˈvektɪv/; [or]gre3k;
stringent: [adj]严厉的;迫切的;银根紧的; [acc]/ˈstrɪndʒənt/; [or]gre3k;
glacial: [adj]冰的;冰冷的;冰河时代的; [acc]/ˈɡleɪʃl/; [or]gre3k;
lax: [adj]松懈的;松弛的;[语]松弛元音的; n. 松元音;泻肚; [acc]/læks/; [or]gre3k;
reprobate: n. 混蛋,恶棍; [adj]邪恶的;堕落的; [v]谴责,指责; [acc]/ˈreprəbeɪt/; [or]gre3k;
reticent: [adj]沉默不语的;有保留的;含蓄的; [acc]/ˈretɪsnt/; [or]gre3k;
decrepit: [adj]衰老的,破旧的; [acc]/dɪˈkrepɪt/; [or]gre3k;
voluble: [adj]健谈的,缠绕的,易旋转的; [acc]/ˈvɑːljəbl/; [or]gre3k;
exhort: [vt]敦促,劝告; [vi]规劝,劝告; [acc]/ɪɡˈzɔːrt/; [or]gre3k;
bale: n. 大包裹,灾祸,不幸; [vt]将某物打成包或包装成捆; [acc]/beɪl/; [or]gre3k;
anomalous: [adj]反常的,不规则的,不恰当的; [acc]/əˈnɑːmələs/; [or]gre3k;
querulous: [adj]抱怨的,挑剔的; [acc]/ˈkwerələs/; [or]gre3k;
coquette: n. 调情的女子; [v]不认真对待; [acc]/koʊˈket/; [or]gre3k;
whiff: n. 一吹,一吸,一阵香气,一点点,香烟的一口; [v]轻轻地吹,喷气,[棒]三击出局; [acc]/wɪf/; [or]gre3k;
circuitous: [adj]迂回的,绕圈子的; [acc]/sərˈkjuːɪtəs/; [or]gre3k;
slant: n. 倾斜,倾向性,偏见; [v](使)倾斜,使带有某种色彩,歪曲; [adj]倾斜的;有偏见的; [acc]/slænt/; [or]gre3k;
censor: n. 检查员; [vt]审查,检查;修改; [acc]/ˈsensər/; [or]gre3k;
deterioration: n. 变坏,退化,恶化;堕落; [acc]/dɪˌtɪriəˈreɪʃn/; [or]gre3k;
pliant: [adj]易弯的,柔软的; n. 顺从; [acc]/ˈplaɪənt/; [or]gre3k;
impede: [v]妨碍,阻碍; [acc]/ɪmˈpiːd/; [or]gre3k;
abstruse: [adj]难懂的,深奥的; [acc]/əbˈstruːs/; [or]gre3k;
fantasy: n. 幻想,想象;幻想作品; [vi]奏幻想曲; [vt]想像;幻想; [adj]虚幻的; [acc]/ˈfæntəsi/; [or]gre3k;
convex: [adj]中凸的;凸圆的;凸面的; n. 凸面体;凸状; [acc]/ˈkɑːnveks/; [or]gre3k;
unkempt: [adj](衣服,头发)不整洁的;蓬乱的; [acc]/ˌʌnˈkempt/; [or]gre3k;
pertinent: [adj]有关的;适当的;中肯的; n. 附属物;参考; [acc]/ˈpɜːrtnənt/; [or]gre3k;
stint: n. 节约;从事某工作的时间;固定; [v]节省;限制; [acc]/stɪnt/; [or]gre3k;
acrid: [adj]辛辣的,(言语或语调)刻薄的; [acc]/ˈækrɪd/; [or]gre3k;
retract: [v]缩回;收回;取消; n. 收缩核; [acc]/rɪˈtrækt/; [or]gre3k;
wane: n. 衰退(期);月亏(期);减少; [v](月)缺损;(光,势力,治理等)衰落;减少; [acc]/weɪn/; [or]gre3k;
distraught: [adj]发狂的;心烦意乱的; [acc]/dɪˈstrɔːt/; [or]gre3k;
frustrate: [v]使灰心;挫败;阻挠; [acc]/ˈfrʌstreɪt/; [or]gre3k;
parody: n. 嘲弄文章,拙劣的模仿; [v]拙劣模仿; [acc]/ˈpærədi/; [or]gre3k;
supercilious: [adj]目中无人的,高傲的; [acc]/ˌsuːpərˈsɪliəs/; [or]gre3k;
wry: [adj]歪斜的,扭歪的,歪曲的; [v]歪曲,扭曲;扭转; [acc]/raɪ/; [or]gre3k;
retrieve: [v]取回,重新得到,挽回,检索; [acc]/rɪˈtriːv/; [or]gre3k;
painstaking: [adj](不辞)劳苦的,辛勤的; n. 辛劳,煞费苦心; [acc]/ˈpeɪnzteɪkɪŋ/; [or]gre3k;
alleviate: [v]减轻;缓解;缓和; [acc]/əˈliːvieɪt/; [or]gre3k;
impromptu: [adj]一触即发的;即席的,即兴的; [adv]即席地,即兴地; n. 即兴之作; [acc]/ɪmˈprɑːmptuː/; [or]gre3k;
quack: n. 庸医;鸭叫声; [v]嘎嘎叫;吹嘘;大声闲聊; [adj]骗人的,江湖医生的; [acc]/kwæk/; [or]gre3k;
entice: [v]怂恿,引诱; [acc]/ɪnˈtaɪs/; [or]gre3k;
heinous: [adj]可憎的;极凶恶的; [acc]/ˈheɪnəs/; [or]gre3k;
budge: [v]移动一点;妥协; [acc]/bʌdʒ/; [or]gre3k;
enact: [v]颁布;制定法律;扮演; [acc]/ɪˈnækt/; [or]gre3k;
inkling: n. 轻微暗示,小提示,略知; [acc]/ˈɪŋklɪŋ/; [or]gre3k;
lenient: [adj]宽大的,宽容的,仁慈的; [acc]/ˈliːniənt/; [or]gre3k;
amenable: [adj]愿意的,顺从的,服从的;经得起检验的; [acc]/əˈmiːnəbl/; [or]gre3k;
discriminate: [v]区别,辨别;歧视; [acc]/dɪˈskrɪmɪneɪt/; [or]gre3k;
disarm: [vt]放下武器;使人消除敌意; [vi]解除武装; [acc]/dɪsˈɑːrm/; [or]gre3k;
impervious: [adj]不能渗透的,不为所动的; [acc]/ɪmˈpɜːrviəs/; [or]gre3k;
inflame: [v]使燃烧,激怒(某人); [acc]/ɪnˈfleɪm/; [or]gre3k;
expansive: [adj]广阔的,扩张的,豪爽的; [acc]/ɪkˈspænsɪv/; [or]gre3k;
rapacious: [adj]贪婪的;掠夺的; [acc]/rəˈpeɪʃəs/; [or]gre3k;
gist: n. 主旨,要点;依据; [acc]/dʒɪst/; [or]gre3k;
quota: n. 配额;限额;定额; [acc]/ˈkwoʊtə/; [or]gre3k;
agitate: [v](尤指为法律,社会状况的改变而)激烈争论,鼓动,煽动;搅动(液体);激怒; [acc]/ˈædʒɪteɪt/; [or]gre3k;
ephemeral: [adj]短暂的,短命的; n. 生存极短时间的事物; [acc]/ɪˈfemərəl/; [or]gre3k;
ungainly: [adj]笨拙的,不雅的; [adv]笨拙地;不雅地; [acc]/ʌnˈɡeɪnli/; [or]gre3k;
swagger: n. 傲慢的态度,大摇大摆; [v]大摇大摆地走,吹牛,傲慢; [adj]豪华时髦的; [acc]/ˈswæɡər/; [or]gre3k;
truant: n. 旷课者,懒惰的人; [adj]旷课的,偷懒的; [v]逃学,偷懒,逃避责任; [acc]/ˈtruːənt/; [or]gre3k;
outlandish: [adj]稀奇古怪的,奇特的;异国风情的; [acc]/aʊtˈlændɪʃ/; [or]gre3k;
revere: [v]敬畏;尊敬;崇敬; [acc]/rɪˈvɪr/; [or]gre3k;
sanctify: [vt]使神圣化,使合法化; [acc]/ˈsæŋktɪfaɪ/; [or]gre3k;
dissipate: [v]消散,消失;浪费; [acc]/ˈdɪsɪpeɪt/; [or]gre3k;
spectrum: n. 光谱,范围,系列; [acc]/ˈspektrəm/; [or]gre3k;
taut: [adj]拉紧的;紧张的;整洁的; [acc]/tɔːt/; [or]gre3k;
perfunctory: [adj]草率的,敷衍搪塞的; [acc]/pərˈfʌŋktəri/; [or]gre3k;
accede: [v]同意,就任,加入; [acc]/əkˈsiːd/; [or]gre3k;
haphazard: [adj]偶然的;随意的;凑合的;胡乱的; [acc]/hæpˈhæzərd/; [or]gre3k;
jeopardy: n. 危险;(被告处于被判罪或受处罚的)危险境地; [acc]/ˈdʒepərdi/; [or]gre3k;
craven: [adj]懦弱的,畏缩的; [acc]/ˈkreɪvn/; [or]gre3k;
defray: [v]支出;支付; [acc]/dɪˈfreɪ/; [or]gre3k;
panegyric: n. 颂词,赞词; [acc]/ˌpænəˈdʒɪrɪk/; [or]gre3k;
peruse: [v]详细考察;精读; [acc]/pəˈruːz/; [or]gre3k;
mirage: n. 幻影,海市蜃楼; [acc]/məˈrɑːʒ/; [or]gre3k;
nip: [v]咬;捏;剪断;冻伤;阻止; n. 夹;捏;刺骨;小饮; [acc]/nɪp/; [or]gre3k;
vulnerable: [adj]易受伤的;脆弱的;易受攻击的; [acc]/ˈvʌlnərəbl/; [or]gre3k;
felony: n. 重罪; [acc]/ˈfeləni/; [or]gre3k;
soliloquy: n. 自言自语,独白; [acc]/səˈlɪləkwi/; [or]gre3k;
conspire: [v]密谋策划;共谋,串通一气; [acc]/kənˈspaɪər/; [or]gre3k;
ostensible: [adj]表面上的,伪装的; [acc]/ɑːˈstensəbl/; [or]gre3k;
hypothetical: [adj]假设的,假定的; [acc]/ˌhaɪpəˈθetɪkl/; [or]gre3k;
scoff: [vi]讥笑; [v]嘲笑; n. 愚弄; [acc]/skɔːf/; [or]gre3k;
enamel: n. 搪瓷;珐琅;瓷釉;指甲油; [v]彩饰;涂以瓷釉; [acc]/ɪˈnæml/; [or]gre3k;
deft: [adj]灵巧的,敏捷的,熟练的; [acc]/deft/; [or]gre3k;
prototype: n. 原型,典型,样本; [acc]/ˈproʊtətaɪp/; [or]gre3k;
diffident: [adj]羞怯的,缺乏自信的,谦虚谨慎的; [acc]/ˈdɪfɪdənt/; [or]gre3k;
vouch: [v]担保;证明;保证; n. 被担保者; [acc]/vaʊtʃ/; [or]gre3k;
intangible: [adj]不可捉摸的,无形的; n. 无形的东西; [acc]/ɪnˈtændʒəbl/; [or]gre3k;
seduce: [v]引诱,诱使,诱惑,勾引;着迷; [acc]/sɪˈduːs/; [or]gre3k;
replete: [adj]充满的,装满的; n. [昆]贮蜜蚁; [acc]/rɪˈpliːt/; [or]gre3k;
redoubtable: [adj]可敬畏的,可怕的; [acc]/rɪˈdaʊtəbl/; [or]gre3k;
cascade: n. 层叠;小瀑布;喷流; [v]像瀑布般冲下或倾泻; [acc]/kæˈskeɪd/; [or]gre3k;
hew: [v]砍伐;劈;遵守,坚持; [acc]/hjuː/; [or]gre3k;
swerve: [v]转弯,突然改变方向; n. 转向;滑出;逸出;背离; [acc]/swɜːrv/; [or]gre3k;
pedestrian: n. 步行者,行人; [adj]步行的;平庸无奇的,无聊的; [acc]/pəˈdestriən/; [or]gre3k;
repudiate: [v]拒绝,否定,驳斥; [acc]/rɪˈpjuːdieɪt/; [or]gre3k;
torpid: [adj]懒散的,死气沉沉的,不活泼的; [acc]/ˈtɔːrpɪd/; [or]gre3k;
terminus: n. (火车,汽车)终点站;界标; [acc]/ˈtɜːrmɪnəs/; [or]gre3k;
dissemble: [v]掩饰;假装;隐藏,掩饰; [acc]/dɪˈsembl/; [or]gre3k;
immature: [adj]幼年的;未成熟的; [acc]/ˌɪməˈtʃʊr/; [or]gre3k;
reactionary: [adj]保守的,反动的; n. 反动分子; [acc]/riˈækʃəneri/; [or]gre3k;
conditional: [adj]有条件的,假定的; n. 条件句,条件语; [acc]/kənˈdɪʃənl/; [or]gre3k;
pun: n. 双关语; [v]说双关语,用双关语; [acc]/pʌn/; [or]gre3k;
virulent: [adj]剧毒的;恶性的;有恶意的; [acc]/ˈvɪrələnt/; [or]gre3k;
propagate: [v]繁殖,增殖; [vt]传播,宣传; [acc]/ˈprɑːpəɡeɪt/; [or]gre3k;
probe: [v]探测,探索; n. 探索,调查;探针,探测器; [acc]/proʊb/; [or]gre3k;
malevolent: [adj]有恶意的,恶毒的; [acc]/məˈlevələnt/; [or]gre3k;
untenable: [adj]防守不住的,站不住脚的; [acc]/ʌnˈtenəbl/; [or]gre3k;
inimical: [adj]敌意的,有害的; [acc]/ɪˈnɪmɪkl/; [or]gre3k;
meager: [adj]瘦的;贫乏的;粗劣的;少量的; [acc]/ˈmiːɡər/; [or]gre3k;
foreword: n. 序,前言; [acc]/ˈfɔːrwɜːrd/; [or]gre3k;
shirk: [v]逃避;规避(义务,责任等); n. 偷懒者; [acc]/ʃɜːrk/; [or]gre3k;
leer: [v]斜眼看,睨视;抛媚眼; n. 媚眼;恶意的瞥视; [acc]/lɪr/; [or]gre3k;
insurgent: n. 叛乱分子; [adj]叛乱的,起事的; [acc]/ɪnˈsɜːrdʒənt/; [or]gre3k;
incandescent: [adj]白热的,热烈的; [acc]/ˌɪnkænˈdesnt/; [or]gre3k;
lassitude: n. 困乏,厌倦,无精打采; [acc]/ˈlæsɪtuːd/; [or]gre3k;
didactic: [adj]说教的;教诲的; [acc]/daɪˈdæktɪk/; [or]gre3k;
aggravate: [v]使恶化,加重;使气恼,激怒; [acc]/ˈæɡrəveɪt/; [or]gre3k;
penury: n. 贫穷; [acc]/ˈpenjəri/; [or]gre3k;
coy: [adj]腼腆的,怕羞的;卖弄风情的; [acc]/kɔɪ/; [or]gre3k;
inferno: n. 火海,地狱般的场所; [acc]/ɪnˈfɜːrnoʊ/; [or]gre3k;
restive: [adj]不耐烦的,焦躁不安的,倔强的; [acc]/ˈrestɪv/; [or]gre3k;
synthesis: n. 合成; [acc]/ˈsɪnθəsɪs/; [or]gre3k;
propitiate: [v]讨好,抚慰; [acc]/prəˈpɪʃieɪt/; [or]gre3k;
gainsay: [v]否认,否定,反驳; n. 否认,反驳; [acc]/ˌɡeɪnˈseɪ/; [or]gre3k;
abeyance: n. 中止,搁置; [acc]/əˈbeɪəns/; [or]gre3k;
subsidiary: [adj]辅助的,次要的,附属的; n. 子公司,附属机构; [acc]/səbˈsɪdieri/; [or]gre3k;
disaffected: [adj]不满的,有叛意的,愤愤不平的; [acc]/ˌdɪsəˈfektɪd/; [or]gre3k;
potentate: n. 统治者,君主;有权势的人; [acc]/ˈpoʊtnteɪt/; [or]gre3k;
husk: n. 外壳,皮;无价值之物; [v]削皮;以粗哑的嗓音说; [acc]/hʌsk/; [or]gre3k;
puerile: [adj]幼稚的,孩子气的; [acc]/ˈpjʊrəl/; [or]gre3k;
disjointed: [adj]杂乱的,无逻辑的,脱节的; [acc]/dɪsˈdʒɔɪntɪd/; [or]gre3k;
graft: n. 嫁接;嫁接株;移植; [vi]接枝; [vt]将.嫁接;移植(器官); [acc]/ɡræft/; [or]gre3k;
contrite: [adj]悔罪的;痛悔的; [acc]/kənˈtraɪt/; [or]gre3k;
fallacious: [adj]谬误的,易误解的,虚妄的; [acc]/fəˈleɪʃəs/; [or]gre3k;
obliterate: [v]消灭;涂去;冲刷;忘掉; [acc]/əˈblɪtəreɪt/; [or]gre3k;
rebuff: n. 断然拒绝,回绝,漠不关心; [v]断然拒绝; [acc]/rɪˈbʌf/; [or]gre3k;
allure: [v]吸引;诱使; n. 诱惑力; [acc]/əˈlʊr/; [or]gre3k;
incite: [v]刺激;煽动; [acc]/ɪnˈsaɪt/; [or]gre3k;
indelible: [adj](印记等)无法擦除的,无法忘怀的; [acc]/ɪnˈdeləbl/; [or]gre3k;
jaunty: [adj]愉快的,满足的;斯文的;时髦的; [adv]心满意足地,洋洋得意地; n. 心满意足;洋洋得意; [acc]/ˈdʒɔːnti/; [or]gre3k;
invidious: [adj]惹人反感的,招人嫉妒的,令人厌恶的,诽谤的,不公平的; [acc]/ɪnˈvɪdiəs/; [or]gre3k;
garrulous: [adj]唠叨的,喋喋不休的;聒噪的; [acc]/ˈɡærələs/; [or]gre3k;
scion: n. [农学]接穗;子孙; [acc]/ˈsaɪən/; [or]gre3k;
phenomenal: [adj]非凡的;现象的;显著的; [acc]/fəˈnɑːmɪnl/; [or]gre3k;
rift: n. 裂缝,裂口; [acc]/rɪft/; [or]gre3k;
dynamic: [adj]有活力的,有生气的;不断变化的;动态的; n. 活力,动力; [acc]/daɪˈnæmɪk/; [or]gre3k;
revise: [v]修订;修改;温习(功课); [acc]/rɪˈvaɪz/; [or]gre3k;
clandestine: [adj]秘密的,私下的,暗中的; [acc]/klænˈdestɪn/; [or]gre3k;
annex: n. 附加物;附属的建筑物; [vt]附加;并吞,强行占取;获得; [acc]/əˈneks/; [or]gre3k;
ruffle: [vt]弄皱;使生气,扰乱;连续地轻敲;使起波浪; n. 皱纹;生气;混乱; [vi]起皱;愤怒; [acc]/ˈrʌfl/; [or]gre3k;
discreet: [adj]谨慎的;思虑周全的,小心的; [acc]/dɪˈskriːt/; [or]gre3k;
mediocre: [adj]普通的;平凡的;中等的; [acc]/ˌmiːdiˈoʊkər/; [or]gre3k;
cellular: [adj]细胞的,无线的;蜂窝式的; [acc]/ˈseljələr/; [or]gre3k;
trite: [adj]陈腐的;平庸的;老一套的; [acc]/traɪt/; [or]gre3k;
adjourn: [v]延期,休会,推迟对.采取行动; [vi]休会; [acc]/əˈdʒɜːrn/; [or]gre3k;
mundane: [adj]普通的,平凡的;单调的;现世的,世俗的; [acc]/mʌnˈdeɪn/; [or]gre3k;
obviate: [v]排除,避免,消除; [acc]/ˈɑːbvieɪt/; [or]gre3k;
plush: n. 长毛绒; [adj]豪华的,长毛绒做的,舒服的; [acc]/plʌʃ/; [or]gre3k;
confluence: n. (河流的)汇合,汇流点;(人或物的)聚集; [acc]/ˈkɑːnfluəns/; [or]gre3k;
decipher: n. 密电译文; [vt]解释;破译; [acc]/dɪˈsaɪfər/; [or]gre3k;
pittance: n. 微薄的收入,小额津贴,少量; [acc]/ˈpɪtns/; [or]gre3k;
subterfuge: n. 托词,借口,诡计; [acc]/ˈsʌbtərfjuːdʒ/; [or]gre3k;
buoy: n. 浮标;浮筒;救生圈;航标; [v]使浮起;支撑;鼓励; [acc]/ˈbuːi/; [or]gre3k;
regenerate: [v]新生,再生,使革新; [adj]改过自新的,新生的; n. 重生者;再生器官; [acc]/rɪˈdʒenəreɪt/; [or]gre3k;
porous: [adj]可渗透的,多孔的,可穿越的; [acc]/ˈpɔːrəs/; [or]gre3k;
exterminate: [v]消灭,灭绝;根除; [acc]/ɪkˈstɜːrmɪneɪt/; [or]gre3k;
spurn: [v]轻蔑地拒绝,摒弃,唾弃,一脚踢开; [acc]/spɜːrn/; [or]gre3k;
parity: n. 相等;同等;平价; [acc]/ˈpærəti/; [or]gre3k;
hybrid: n. 杂种,混血儿,混合物; [adj]混合的;杂种的; [acc]/ˈhaɪbrɪd/; [or]gre3k;
pigment: n. 天然色素,颜料; [acc]/ˈpɪɡmənt/; [or]gre3k;
scour: [v]搜查;洗涤,洗刷,擦洗;冲刷成,冲刷出; [acc]/ˈskaʊər/; [or]gre3k;
vanquish: [v]征服,击败; [acc]/ˈvæŋkwɪʃ/; [or]gre3k;
gull: n. 鸥;笨人;易受骗之人; [v]骗;欺诈; [acc]/ɡʌl/; [or]gre3k;
filter: n. 过滤器,滤纸; [v]过滤,渗透; [acc]/ˈfɪltər/; [or]gre3k;
trickle: [v]一滴滴地流;徐徐地流; n. 细流;徐徐地流;稀稀疏疏缓慢来往的东西; [acc]/ˈtrɪkl/; [or]gre3k;
mince: [v]切碎,小步走路; n. 切碎物; [acc]/mɪns/; [or]gre3k;
libertine: n. 性行为放纵者,浪荡子;自由思想家; [adj]放荡的; [acc]/ˈlɪbərtiːn/; [or]gre3k;
decadence: n. 堕落,颓废;衰落; [acc]/ˈdekədəns/; [or]gre3k;
sporadic: [adj]不定时发生的;零星的;分散的; [acc]/spəˈrædɪk/; [or]gre3k;
proficient: [adj]精通的,熟练的; [acc]/prəˈfɪʃnt/; [or]gre3k;
dirge: n. 挽歌;哀悼歌; [acc]/dɜːrdʒ/; [or]gre3k;
surmount: [v]克服,战胜,越过; [acc]/sərˈmaʊnt/; [or]gre3k;
infuse: [v]沏(茶),泡(草药);灌输;使充满; [acc]/ɪnˈfjuːz/; [or]gre3k;
proffer: [v]提出(建议),提供,赠送; n. 提议,建议,赠送; [acc]/ˈprɑːfər/; [or]gre3k;
drone: n. 无人机,无人驾驶飞机;雄蜂;单调的低音; [v]嗡嗡地响; [vi]混日子; [acc]/droʊn/; [or]gre3k;
snub: n. 冷落,怠慢; [vt]冷落;断然拒绝;掐灭; [adj]故意冷落的,断然拒绝的,斥责的; [acc]/snʌb/; [or]gre3k;
tawdry: [adj]非常华丽的,廉价而俗丽的; n. 俗丽的东西,廉价而俗丽之物; [adv]俗丽地,华而不实地; [acc]/ˈtɔːdri/; [or]gre3k;
espouse: [v]支持,拥护; [acc]/ɪˈspaʊz/; [or]gre3k;
translucent: [adj]半透明的;透亮的,有光泽的;易懂的;真实的; [acc]/trænsˈluːsnt/; [or]gre3k;
resonant: [adj]洪亮的,共振的,共鸣的; [acc]/ˈrezənənt/; [or]gre3k;
discrepancy: n. 不一致,差异,不符; [acc]/dɪsˈkrepənsi/; [or]gre3k;
knotty: [adj]有节疤的,有结的;棘手的; [acc]/ˈnɑːti/; [or]gre3k;
upbraid: [v]斥责,责骂; [acc]/ʌpˈbreɪd/; [or]gre3k;
preclude: [v]阻止;排除; [acc]/prɪˈkluːd/; [or]gre3k;
evasive: [adj]逃避的;托辞的,推托的; [acc]/ɪˈveɪsɪv/; [or]gre3k;
retrograde: [vi]倒退,退步; [adj]后退的,退步的,退化的; [vt]使倒退; [acc]/ˈretrəɡreɪd/; [or]gre3k;
ratify: [vt]批准,认可,签署生效; [acc]/ˈrætɪfaɪ/; [or]gre3k;
preternatural: [adj]超自然的;不可思议的; [acc]/ˌpriːtərˈnætʃrəl/; [or]gre3k;
waft: [v]使飘荡;吹送; n. 飘荡;吹拂; [acc]/wɑːft/; [or]gre3k;
paraphrase: [v]解释,释义; n. 转述,释义; [acc]/ˈpærəfreɪz/; [or]gre3k;
cynic: n. 愤世嫉俗者;犬儒学派的人; [adj]犬儒学派的; [acc]/ˈsɪnɪk/; [or]gre3k;
gash: n. 深长的伤口,切痕;裂缝;裂痕; [v]在..上划口;砍; [adj]衣冠楚楚的;聪明伶俐的; [acc]/ɡæʃ/; [or]gre3k;
tractable: [adj]易于管教的,易驾驭的,易处理的,驯良的; [acc]/ˈtræktəbl/; [or]gre3k;
absolve: [v]赦免,宽恕;免除,解除; [acc]/əbˈzɑːlv/; [or]gre3k;
presage: [v]预示; n. 预感,不祥感,前兆,预言; [acc]/ˈpresɪdʒ/; [or]gre3k;
gild: [v]镀金; n. 协会,行会(同guild);同业公会;[植]依赖植物集团; [acc]/ɡɪld/; [or]gre3k;
disinclination: n. 不感兴趣,厌恶; [acc]/ˌdɪsˌɪnklɪˈneɪʃn/; [or]gre3k;
obtuse: [adj]迟钝的;圆头的;不锋利的; [acc]/əbˈtuːs/; [or]gre3k;
windbag: n. 风囊,饶舌之人; [acc]/ˈwɪndbæɡ/; [or]gre3k;
fussy: [adj]爱挑剔的,难取悦的,易烦恼的; [acc]/ˈfʌsi/; [or]gre3k;
divulge: [v]泄露,透露; [acc]/daɪˈvʌldʒ/; [or]gre3k;
sinuous: [adj]弯曲的,蜿蜒的; [acc]/ˈsɪnjuəs/; [or]gre3k;
apocryphal: [adj]伪的;可疑; [acc]/əˈpɑːkrɪfl/; [or]gre3k;
forestall: [v]领先;占先一步;先发制人,阻止,妨碍;垄断;占先一步; [acc]/fɔːrˈstɔːl/; [or]gre3k;
deprivation: n. 剥夺;免职;匮乏;丧失;损失;免职; [acc]/ˌdeprɪˈveɪʃn/; [or]gre3k;
reconnoiter: [v]侦察,勘查; [acc]/ˌrikəˈnɔɪtər/; [or]gre3k;
alienate: [v]疏远;挑拨; [acc]/ˈeɪliəneɪt/; [or]gre3k;
malign: [v]诽谤,中伤; [adj]邪恶的;有害的; [acc]/məˈlaɪn/; [or]gre3k;
salve: n. 药膏,安慰; [v]涂药膏;缓和; [acc]/sælv/; [or]gre3k;
exponent: n. [数]指数;典型;说明者,说明物; [adj]说明的; [acc]/ɪkˈspoʊnənt/; [or]gre3k;
dank: [adj]潮湿的,阴湿的;透水的; [acc]/dæŋk/; [or]gre3k;
commensurate: [adj]相称的,相应的;同量的;同样大小的; [acc]/kəˈmenʃərət/; [or]gre3k;
circumspect: [adj]慎重的,仔细的; [acc]/ˈsɜːrkəmspekt/; [or]gre3k;
venal: [adj]唯利是图的;贪赃枉法; [acc]/ˈviːnl/; [or]gre3k;
savory: [adj]口感好的,味道好的,令人愉悦的; [acc]/ˈseɪvəri/; [or]gre3k;
cursory: [adj]匆忙的,不注意细节的;草率地;粗略地; [acc]/ˈkɜːrsəri/; [or]gre3k;
assuage: [v]缓和,减轻; n. 缓和,减轻;减轻.的人; [acc]/əˈsweɪdʒ/; [or]gre3k;
expiate: [v]赎罪,补偿; [acc]/ˈekspieɪt/; [or]gre3k;
unproductive: [adj]徒然的,无效的; [acc]/ˌʌnprəˈdʌktɪv/; [or]gre3k;
goad: [vt]驱赶;刺激;鼓励; n. (赶牛用的)刺棒; [acc]/ɡoʊd/; [or]gre3k;
noisome: [adj]恶臭的;令人不快的; [acc]/ˈnɔɪsəm/; [or]gre3k;
admonish: [v]训诫,警告; [acc]/ədˈmɑːnɪʃ/; [or]gre3k;
wince: [v]避开,畏缩; n. 畏缩;脸部肌肉的抽搐; [acc]/wɪns/; [or]gre3k;
emigrate: [v]移居国外(或外地); [acc]/ˈemɪɡreɪt/; [or]gre3k;
splinter: n. 碎片;微小的东西;极瘦的人; [v]分裂;裂成碎片; [acc]/ˈsplɪntər/; [or]gre3k;
react: [v]起反应,有影响,对..做出反应;有不良反应;起化学反应; [acc]/riˈækt/; [or]gre3k;
repine: [v]不满,心中抱怨; [acc]/rɪ'paɪn/; [or]gre3k;
miscreant: n. 恶棍,歹徒; [acc]/ˈmɪskriənt/; [or]gre3k;
pervade: [vt]普及;渗透;弥漫; [vi]弥漫;渗透; [acc]/pərˈveɪd/; [or]gre3k;
irascible: [adj]易怒的,性情暴躁的; [acc]/ɪˈræsəbl/; [or]gre3k;
blackmail: n. 敲诈,勒索;保护费; [vt]向.敲诈; [acc]/ˈblækmeɪl/; [or]gre3k;
torrid: [adj]酷热的,热烈; [acc]/ˈtɔːrɪd/; [or]gre3k;
flinch: [v]畏缩,退缩; n. 退缩,畏惧; [acc]/flɪntʃ/; [or]gre3k;
punctilious: [adj]一丝不苟的,精密细心的,拘泥形式的; [acc]/pʌŋkˈtɪliəs/; [or]gre3k;
prate: [v]大谈特谈,唠叨; n. 唠叨,多嘴,无聊话; [acc]/preɪt/; [or]gre3k;
tepid: [adj]微温的,不热烈的; [acc]/ˈtepɪd/; [or]gre3k;
fetter: n. 脚镣;束缚; [vt]给.上脚镣;束缚; [acc]/ˈfetər/; [or]gre3k;
pointer: n. 一种短毛猎犬,暗示,指示,指针,指示器; [acc]/ˈpɔɪntər/; [or]gre3k;
evacuate: [v]撤离,疏散,排清; [acc]/ɪˈvækjueɪt/; [or]gre3k;
supplant: [v]代替;排挤掉; [acc]/səˈplænt/; [or]gre3k;
stingy: [adj]吝啬的,小气的,少量的; [acc]/ˈstɪndʒi/; [or]gre3k;
pedant: n. 学究式人物,书呆子,卖弄学问的人; [acc]/ˈpednt/; [or]gre3k;
illusory: [adj]错觉的,幻影的,虚假的,产生幻觉的; [acc]/ɪˈluːsəri/; [or]gre3k;
disengage: [v]分开; [acc]/ˌdɪsɪnˈɡeɪdʒ/; [or]gre3k;
insular: [adj]岛屿的,与世隔绝的; [acc]/ˈɪnsələr/; [or]gre3k;
phlegmatic: [adj]冷淡的;迟钝的; [acc]/fleɡˈmætɪk/; [or]gre3k;
serpentine: [adj]似蛇般绕曲的,蜿蜒的; [acc]/ˈsɜːrpəntiːn/; [or]gre3k;
laconic: [adj](用词)简洁的;简明的; [adv]简短地,简洁地; [acc]/ləˈkɑːnɪk/; [or]gre3k;
redolent: [adj]气味强烈的,芬芳的,令人想起..的; [acc]/ˈredələnt/; [or]gre3k;
jolt: n. 猛的一击,摇晃,震惊; [v](使)颠簸,摇晃;使震惊; [acc]/dʒoʊlt/; [or]gre3k;
demur: n. 异议; [v]异议,反对,拒绝; [acc]/dɪˈmɜːr/; [or]gre3k;
adamant: [adj]强硬的,固执的; n. 坚硬的东西;坚石; [acc]/ˈædəmənt/; [or]gre3k;
lugubrious: [adj]闷闷不乐的;郁郁寡欢的,悲哀的; [acc]/ləˈɡuːbriəs/; [or]gre3k;
terse: [adj]简洁的,简明的; [acc]/tɜːrs/; [or]gre3k;
nil: n. 零;无; [acc]/nɪl/; [or]gre3k;
indigent: [adj]贫困的,贫穷的; [acc]/ˈɪndɪdʒənt/; [or]gre3k;
melodramatic: [adj]夸张的,情节剧的,戏剧似的; [acc]/ˌmelədrəˈmætɪk/; [or]gre3k;
earshot: n. 听力所及的范围; [acc]/ˈɪrʃɑːt/; [or]gre3k;
nebulous: [adj]朦胧的,星云的,星云状的; [acc]/ˈnebjələs/; [or]gre3k;
winsome: [adj]迷人的;可爱的;漂亮的; [acc]/ˈwɪnsəm/; [or]gre3k;
dilate: [v]使膨胀,扩张,膨胀;详述; [acc]/daɪˈleɪt/; [or]gre3k;
crestfallen: [adj]垂头丧气的,气馁的; [acc]/ˈkrestfɔːlən/; [or]gre3k;
gossamer: n. 蛛丝,小蜘蛛网;薄纱,纤细的东西; [adj]轻而薄的; [acc]/ˈɡɑːsəmər/; [or]gre3k;
intimidate: [v]恫吓,威胁; [acc]/ɪnˈtɪmɪdeɪt/; [or]gre3k;
refine: [v]精炼,改进; [acc]/rɪˈfaɪn/; [or]gre3k;
disprove: [v]反驳,证明.是虚假的; [acc]/ˌdɪsˈpruːv/; [or]gre3k;
combustible: [adj]易燃的;易激动的; n. 可燃物;易燃物; [acc]/kəmˈbʌstəbl/; [or]gre3k;
lullaby: n. 催眠曲,摇篮曲,轻柔的声音; [v]唱催眠曲使入睡; [acc]/ˈlʌləbaɪ/; [or]gre3k;
badger: n. 獾;獾皮毛; [v]纠缠;烦扰(反复提提出问题或要求); [acc]/ˈbædʒər/; [or]gre3k;
hauteur: n. 傲慢; [acc]/hɔːˈtɜːr/; [or]gre3k;
initiate: [v]开始,发动; n. 新加入组织的人; [acc]/ɪˈnɪʃieɪt/; [or]gre3k;
affluent: [adj]富裕的,丰富的; [acc]/ˈæfluənt/; [or]gre3k;
venial: [adj]可原谅的,(罪过)轻微的,可宽恕的; [acc]/ˈviːniəl/; [or]gre3k;
squander: n. 浪费,挥霍; [v]浪费,挥霍; [acc]/ˈskwɑːndər/; [or]gre3k;
wrangle: n. 争论,争吵; [vi]争论,争吵,口角; [vt]辩驳,放牧; [acc]/ˈræŋɡl/; [or]gre3k;
pathological: [adj]病理学的;病态的;由疾病引起的(等于pathologic); [acc]/ˌpæθəˈlɑːdʒɪkl/; [or]gre3k;
aver: [v]极力声明,断言; [acc]/əˈvɜːr/; [or]gre3k;
interdict: n. 禁令;禁止,制止; [v]禁止,制止;闭锁,阻断(敌人通路);[宗教]停止教权; [acc]/ˈɪntərdɪkt/; [or]gre3k;
carp: n. 鲤鱼; [v]吹毛求疵; [acc]/kɑːrp/; [or]gre3k;
jog: [v]慢跑;轻碰; n. 轻推,慢跑,漫步; [acc]/dʒɑːɡ/; [or]gre3k;
voracious: [adj]狼吞虎咽的,贪婪的; [adv]贪婪地; n. 贪婪,贪吃; [acc]/vəˈreɪʃəs/; [or]gre3k;
cordon: n. 哨兵线,警戒线;饰带; [v]布设警戒线;封锁交通; [acc]/ˈkɔːrdn/; [or]gre3k;
sparse: [adj]稀少的;稀疏的; [acc]/spɑːrs/; [or]gre3k;
substantive: [adj]有实质的;大量的;真实的;独立存在的; n. 实词,名词,名词性词组; [acc]/səbˈstæntɪv/; [or]gre3k;
squint: [v]斜视,眯眼睛看; [adj]斜着眼的;斜视的;细眯着眼看的;倾斜的;偏移的; n. 斜视眼;斜视斜眼;趋势; [acc]/skwɪnt/; [or]gre3k;
scrawl: n. 潦草的笔迹; [v]乱涂,乱写,潦草地写; [acc]/skrɔːl/; [or]gre3k;
sinew: n. 腱,筋,中坚力量; [v]用腱连结,(好像使用肌筋似的)给..以力量,支持; [acc]/ˈsɪnjuː/; [or]gre3k;
evoke: [v]唤起;引起;使人想起; [acc]/ɪˈvoʊk/; [or]gre3k;
dilute: [v]使变淡,稀释;使病弱; [acc]/daɪˈluːt/; [or]gre3k;
nurture: [v]养育,培育;培植; n. 养育,培养;教养;营养物; [acc]/ˈnɜːrtʃər/; [or]gre3k;
retrospective: [adj]回顾的;怀旧的;可追溯的; n. 作品回顾展出; [acc]/ˌretrəˈspektɪv/; [or]gre3k;
harrow: n. 耙; [v]耙地,使苦恼,被耙松; [acc]/ˈhæroʊ/; [or]gre3k;
embargo: [v]禁止出入港口;禁止或限制贸易;征用或扣押; n. 禁令;禁止;封港令; [acc]/ɪmˈbɑːrɡoʊ/; [or]gre3k;
truculent: [adj]好斗的;野蛮的;言词刻毒的; [acc]/ˈtrʌkjələnt/; [or]gre3k;
hie: [v]催促,使赶紧; [acc]/haɪ/; [or]gre3k;
downpour: n. 倾盆大雨; [acc]/ˈdaʊnpɔːr/; [or]gre3k;
finesse: n. 技巧,计谋,策略; [v]以技巧取胜; [acc]/fɪˈnes/; [or]gre3k;
incendiary: n. 放火者,纵火者,燃烧弹,煽动者; [adj]放火的,纵火的,能燃烧的,煽动性的; [acc]/ɪnˈsendieri/; [or]gre3k;
annul: [v]取消,废除,宣告无效; [acc]/əˈnʌl/; [or]gre3k;
distortion: n. 扭曲,变形;曲解;失真; [acc]/dɪˈstɔːrʃn/; [or]gre3k;
regimen: n. 养生法,生活规则; [acc]/ˈredʒɪmən/; [or]gre3k;
maudlin: [adj]感情脆弱的;容易流泪的;酒后伤感的; [acc]/ˈmɔːdlɪn/; [or]gre3k;
overt: [adj]明显的;公开的;公然的; [acc]/oʊˈvɜːrt/; [or]gre3k;
relevant: [adj]有关的;恰当的;贴切的; [acc]/ˈreləvənt/; [or]gre3k;
entrap: [v]诱骗; [acc]/ɪnˈtræp/; [or]gre3k;
munificent: [adj]慷慨的,大方的; [acc]/mjuːˈnɪfɪsnt/; [or]gre3k;
humdrum: [adj]单调的;乏味的; n. 平凡;单调; [vi]单调乏味地进行; [acc]/ˈhʌmdrʌm/; [or]gre3k;
adjunct: n. 附属物,配件,添加剂;助手,部下; [adj]附加的,辅助的,下级的; [acc]/ˈædʒʌŋkt/; [or]gre3k;
entangle: [v]使纠缠,卷入; [acc]/ɪnˈtæŋɡl/; [or]gre3k;
errant: [adj]错误的,脱离正途的,迷路的;周游的,漂泊的;无定的; n. 游侠; [acc]/ˈerənt/; [or]gre3k;
demagogue: n. 煽动者; [acc]/ˈdeməɡɑːɡ/; [or]gre3k;
domicile: n. 住宅;永久居住地;期票支付场所; [v]居住;使在指定的场所支付(期票等; [adj]定居;在固定住所生活; [acc]/ˈdɑːmɪsaɪl/; [or]gre3k;
precursor: n. 先兆,先驱,前体; [acc]/priːˈkɜːrsər/; [or]gre3k;
humiliate: [vt]使蒙耻;使丢脸;羞辱; [acc]/hjuːˈmɪlieɪt/; [or]gre3k;
autonomy: n. 人身自由;自治;自治权; [acc]/ɔːˈtɑːnəmi/; [or]gre3k;
fetid: [adj]有恶臭的; [acc]/ˈfetɪd/; [or]gre3k;
forthright: [adj]直接的,直率的,坦白的,豪爽的; [adv]马上,立即; n. 直路; [acc]/ˈfɔːrθraɪt/; [or]gre3k;
hackneyed: [adj]陈腐的,平常的; [acc]/ˈhæknid/; [or]gre3k;
paragon: n. 模范;完美之物;优秀之人; [adj]完美的; [acc]/ˈpærəɡɑːn/; [or]gre3k;
loquacious: [adj]多话的;饶舌的;冗长的;(水)潺潺不息的; [acc]/ləˈkweɪʃəs/; [or]gre3k;
bluster: [v]咆哮;狂吹;夸口;威吓;气势汹汹地说; n. 怒号;吓唬; [acc]/ˈblʌstər/; [or]gre3k;
solvent: [adj]有偿付能力的;有溶解力的; n. 溶剂;解决方法; [acc]/ˈsɑːlvənt/; [or]gre3k;
fascinate: [v]使着迷;使神魂颠倒;吸引注意; [acc]/ˈfæsɪneɪt/; [or]gre3k;
primordial: [adj]原始的;根本的;原生的; [acc]/praɪˈmɔːrdiəl/; [or]gre3k;
mash: [v]捣碎; n. 糊状物; [acc]/mæʃ/; [or]gre3k;
strut: n. 高视阔步,抗压装置; [v]昂首阔步地走,趾高气昂地走; [acc]/strʌt/; [or]gre3k;
parry: [v]挡开,避开(武器,问题等); [acc]/ˈpæri/; [or]gre3k;
certitude: n. 确实;确信;必然性; [acc]/ˈsɜːrtɪtuːd/; [or]gre3k;
clog: [v]阻塞,阻碍; n. 障碍;木底鞋; [acc]/klɑːɡ/; [or]gre3k;
nondescript: [adj]没有特征的,难以形容的,难以归类的; n. 难以名状,不属任何型类的人; [acc]/ˈnɑːndɪskrɪpt/; [or]gre3k;
luminary: n. 杰出人物,发光体; [acc]/ˈluːmɪneri/; [or]gre3k;
conserve: [v]保藏,保存;节约; n. 蜜饯,果酱; [acc]/kənˈsɜːrv/; [or]gre3k;
lag: n. 落后,延迟; [v]落后;缓慢进行,减退; [acc]/læɡ/; [or]gre3k;
acumen: n. 聪明,敏锐; [acc]/ˈækjəmən/; [or]gre3k;
boor: n. 举止粗野的人,乡下人; [acc]/bʊr/; [or]gre3k;
nefarious: [adj]违法的,邪恶的; [acc]/nɪˈferiəs/; [or]gre3k;
deride: [v]嘲弄,愚弄; [acc]/dɪˈraɪd/; [or]gre3k;
fatuous: [adj]愚昧而不自知的; [acc]/ˈfætʃuəs/; [or]gre3k;
gripe: n. 控制,发牢骚,肠绞痛; [v]抱怨,发牢骚; [acc]/ɡraɪp/; [or]gre3k;
onerous: [adj]繁重的,麻烦的;负有义务的;负有法律责任的; [acc]/ˈɑːnərəs/; [or]gre3k;
consolidate: [v]巩固,加强;把.合为一体; [acc]/kənˈsɑːlɪdeɪt/; [or]gre3k;
obloquy: n. 毁谤;耻辱;漫骂; [acc]/ˈɑːbləkwi/; [or]gre3k;
verbatim: [adj]逐字的; [adv]逐字地; [acc]/vɜːrˈbeɪtɪm/; [or]gre3k;
hypnotic: n. 安眠药; [adj]催眠的,令人着迷的; [acc]/hɪpˈnɑːtɪk/; [or]gre3k;
pout: n. 撅嘴,板脸,生气; [v]撅嘴,绷脸; [acc]/paʊt/; [or]gre3k;
glisten: [v]闪烁,闪耀; [acc]/ˈɡlɪsn/; [or]gre3k;
depreciate: [v]贬低,轻视;贬值;折旧; [acc]/dɪˈpriːʃieɪt/; [or]gre3k;
cavil: [v]吹毛求疵,挑剔,无端指摘;挑毛病,无端抱怨; n. 吹毛求疵,苛责,无端的指责; [acc]/ˈkævl/; [or]gre3k;
constrain: [v]约束;限制;强迫; [acc]/kənˈstreɪn/; [or]gre3k;
strident: [adj]尖声的,刺耳的; [acc]/ˈstraɪdnt/; [or]gre3k;
umbrage: n. 不快,愤怒; [acc]/ˈʌmbrɪdʒ/; [or]gre3k;
autocracy: n. 独裁政治;专制政治;独裁政府;独裁统治的国家; [acc]/ɔːˈtɑːkrəsi/; [or]gre3k;
palatial: [adj]宫殿般的;宏伟的; [acc]/pəˈleɪʃl/; [or]gre3k;
belie: [vt]与.不符;矛盾,误解; [acc]/bɪˈlaɪ/; [or]gre3k;
resourceful: [adj]足智多谋的;资源丰富的;机智的; [acc]/rɪˈsɔːrsfl/; [or]gre3k;
swindle: n. 诈骗;欺诈行为;骗局; [vi]欺骗,行骗; [vt]诈骗;骗取; [acc]/ˈswɪndl/; [or]gre3k;
retainer: n. 保持器;家臣;保持者;[机]护圈;预付费用; [acc]/rɪˈteɪnər/; [or]gre3k;
aspirant: n. 有抱负的人,野心家; [adj]上进的,有野心的; [acc]/əˈspaɪərənt/; [or]gre3k;
miserly: [adj]贪财的,吝啬的; [acc]/ˈmaɪzərli/; [or]gre3k;
depose: [v]免职,废黜,作证; [acc]/dɪˈpoʊz/; [or]gre3k;
stunt: n. 惊人表演,特技;矮小的人(或物); [v]阻碍..发育;作惊人表演;使绝招; [acc]/stʌnt/; [or]gre3k;
bolster: n. 枕垫; [v]支持,鼓励,增强; [acc]/ˈboʊlstər/; [or]gre3k;
saunter: n. 漫步,闲逛; [v]闲逛,漫步; [acc]/ˈsɔːntər/; [or]gre3k;
vicarious: [adj]代替别人做的;代理的,代替的;发同感的; [acc]/vaɪˈkeriəs/; [or]gre3k;
consign: [v]托运,托卖,寄存; [acc]/kənˈsaɪn/; [or]gre3k;
secrete: [v]藏匿;私下侵吞;分泌; [acc]/sɪˈkriːt/; [or]gre3k;
rancor: n. 深仇,怨恨; [acc]/ˈræŋkər/; [or]gre3k;
quiescent: [adj]静止的,沉寂的,不活动的; [acc]/kwaɪˈesnt/; [or]gre3k;
incantation: n. 咒语; [acc]/ˌɪnkænˈteɪʃn/; [or]gre3k;
donor: n. 捐献者; [acc]/ˈdoʊnər/; [or]gre3k;
patronize: [v]惠顾;赞助,资助; [acc]/ˈpeɪtrənaɪz/; [or]gre3k;
racy: [adj]令人激动的;猥亵的; [acc]/ˈreɪsi/; [or]gre3k;
demolition: n. 拆除(等于demolishment);破坏,毁坏; [acc]/ˌdeməˈlɪʃn/; [or]gre3k;
tirade: n. 长篇的攻击性演说; [acc]/ˈtaɪreɪd/; [or]gre3k;
cogent: [adj]有说服力的; [acc]/ˈkoʊdʒənt/; [or]gre3k;
apprise: [v]通知,报告; [acc]/əˈpraɪz/; [or]gre3k;
anathema: n. (基督教的)咒诅,被诅咒者,令人厌恶的人; [acc]/əˈnæθəmə/; [or]gre3k;
trenchant: [adj]犀利的,锐利的,有力的,清晰的,一针见血的; [acc]/ˈtrentʃənt/; [or]gre3k;
debut: n. 初次登台,在社交场合的初次露脸; [v]初次露面,初次表演;首次推出; [adj]首张的,首场的,首次的; [acc]/deɪˈbjuː/; [or]gre3k;
rabid: [adj]激烈的;狂暴的;偏激的;患狂犬病的; [acc]/ˈræbɪd/; [or]gre3k;
pliable: [adj]易弯的;柔韧的;圆滑的; [acc]/ˈplaɪəbl/; [or]gre3k;
pristine: [adj]原始的;古时的;纯朴的;崭新的; [acc]/ˈprɪstiːn/; [or]gre3k;
revoke: [v]撤回,取消;废除; n. 有牌不跟; [acc]/rɪˈvoʊk/; [or]gre3k;
slouch: [v]耷拉,低垂,使低垂; n. (帽边等的)下垂,耷拉,萎靡不振的人; [acc]/slaʊtʃ/; [or]gre3k;
drizzle: [v]下毛毛雨; n. 细雨,毛毛雨; [acc]/ˈdrɪzl/; [or]gre3k;
bigot: n. (宗教,种族,政治等的)偏执者,盲信者; [acc]/ˈbɪɡət/; [or]gre3k;
emancipate: [v]解放;释放; [acc]/ɪˈmænsɪpeɪt/; [or]gre3k;
derelict: [adj]渎职的,荒废的,被弃置的; n. 失业贫穷的无家可归者; [acc]/ˈderəlɪkt/; [or]gre3k;
cognizant: [adj]审理的,已认知的; [acc]/ˈkɑːɡnɪzənt/; [or]gre3k;
mesh: n. 网,筛孔; [v]相啮合; [acc]/meʃ/; [or]gre3k;
parenthesis: n. 圆括号;插入语,插入成分;间歇,插曲; [acc]/pəˈrenθəsɪs/; [or]gre3k;
dilatory: [adj]拖拉的,缓慢的,不慌不忙的; [acc]/ˈdɪlətɔːri/; [or]gre3k;
vociferous: [adj](表达意见或感情等)大声的,有力的; [acc]/voʊˈsɪfərəs/; [or]gre3k;
prescience: n. 先见;预知; [acc]/ˈpresiəns/; [or]gre3k;
abjure: [v]发誓放弃,公开放弃,避免; [acc]/əbˈdʒʊr/; [or]gre3k;
corroborate: [v]支持或证实,强化; n. 确证者,证物; [acc]/kəˈrɑːbəreɪt/; [or]gre3k;
nibble: [v]一点点地咬,慢慢啃,吹毛求疵; n. 细咬,轻咬,啃; [acc]/ˈnɪbl/; [or]gre3k;
inception: n. 起初;获得学位; [acc]/ɪnˈsepʃn/; [or]gre3k;
maneuver: [v]操纵; n. 操纵;花招;调遣;策略; [acc]/məˈnʊvər/; [or]gre3k;
accelerate: [v]加速,增长;使增速,促进; [acc]/əkˈseləreɪt/; [or]gre3k;
intensify: [v]增强;加剧; [acc]/ɪnˈtensɪfaɪ/; [or]gre3k;
dwindle: [v]日渐减少,变小,缩小; [acc]/ˈdwɪndl/; [or]gre3k;
commitment: n. 承诺;许诺;委任;承担的义务;献身;赞助;委托;犯罪;罪行;信奉; [acc]/kəˈmɪtmənt/; [or]gre3k;
unimpeachable: [adj]可信的,无可挑剔的; [acc]/ˌʌnɪmˈpiːtʃəbl/; [or]gre3k;
glutton: n. 贪吃者,对..贪婪的人; [acc]/ˈɡlʌtn/; [or]gre3k;
surfeit: n. 饮食过度,过量; [acc]/ˈsɜːrfɪt/; [or]gre3k;
iridescent: [adj]彩虹色的;闪光的,闪色的; [acc]/ˌɪrɪˈdesnt/; [or]gre3k;
salvage: n. 抢救;从灾难中抢救出的物资; [vt]拯救;打捞; [acc]/ˈsælvɪdʒ/; [or]gre3k;
jocund: [adj]快活的;高兴的; [acc]/ˈdʒɑːkənd/; [or]gre3k;
elucidate: [v]阐明,说明; [acc]/iˈluːsɪdeɪt/; [or]gre3k;
animus: n. 憎恨,敌意; [acc]/ˈænɪməs/; [or]gre3k;
glut: n. 供过于求,过多; [vt]使吃饱;使充斥; [vi]过量地吃; [acc]/ɡlʌt/; [or]gre3k;
epilogue: n. 收场白;尾声; [acc]/ˈepɪlɔːɡ/; [or]gre3k;
anarchist: n. 无政府主义者; [acc]/ˈænərkɪst/; [or]gre3k;
elegy: n. 挽歌,哀歌; [acc]/ˈelədʒi/; [or]gre3k;
deprecate: [v]反对;轻视; [acc]/ˈdeprəkeɪt/; [or]gre3k;
prowl: n. (鬼鬼祟祟)徘徊,觅食,游荡; [vi]徘徊,潜行; [vt]在.搜寻;潜行于; [acc]/praʊl/; [or]gre3k;
accost: [v]搭讪;引诱;面对;勾引; [acc]/əˈkɔːst/; [or]gre3k;
palliate: [v]减轻,掩饰,辩解; [acc]/ˈpælieɪt/; [or]gre3k;
diurnal: [adj]白天的;每日的;日间活动的; [acc]/daɪˈɜːrnl/; [or]gre3k;
tether: n. 范围,系链,拴绳; [v]用绳或链拴住; [acc]/ˈteðər/; [or]gre3k;
exasperate: [vt]激怒;加剧; [acc]/ɪɡˈzæspəreɪt/; [or]gre3k;
redundant: [adj]多余的,过剩的;被下岗的; [acc]/rɪˈdʌndənt/; [or]gre3k;
cache: n. 隐藏处所,隐藏的粮食或物资,贮藏物; [vt]贮藏; [vi]躲藏; [acc]/kæʃ/; [or]gre3k;
migratory: [adj]迁移的;流浪的; [acc]/ˈmaɪɡrətɔːri/; [or]gre3k;
slur: n. 含糊的发音,藐视,污点,连线符; [vi]含糊地说; [vt]对.忽略,含糊不清地说出,贬低; [acc]/slɜːr/; [or]gre3k;
retaliate: [v]报复,反击; [acc]/rɪˈtælieɪt/; [or]gre3k;
enamored: [adj]迷恋的;倾心的; [acc]/ɪˈnæmə(r)d/; [or]gre3k;
broach: [v]提出;钻孔;开始讨论;给.开口; [acc]/broʊtʃ/; [or]gre3k;
compress: [v]压紧,压缩,压榨; [acc]/kəmˈpres/; [or]gre3k;
dapper: [adj]干净利落的,衣冠楚楚的; [acc]/ˈdæpər/; [or]gre3k;
profundity: n. 深奥,深厚,深刻; [acc]/prəˈfʌndəti/; [or]gre3k;
pertain: [vi]属于;适合;有关; [acc]/pərˈteɪn/; [or]gre3k;
encompass: [vt]环绕,包围;包含;完成; [acc]/ɪnˈkʌmpəs/; [or]gre3k;
cumbersome: [adj]笨重的;麻烦的; [acc]/ˈkʌmbərsəm/; [or]gre3k;
esoteric: [adj]秘传的,神秘的,限于少数人的; n. 受秘传的人; [acc]/ˌesəˈterɪk/; [or]gre3k;
vaunt: [v]吹嘘,炫耀; [acc]/vɔːnt/; [or]gre3k;
immune: [adj]免疫的,有免疫力的;不受影响的;免除的; [acc]/ɪˈmjuːn/; [or]gre3k;
irate: [adj]发怒的,愤怒的; [acc]/aɪˈreɪt/; [or]gre3k;
coop: [v]把.关进笼子里;限制;拘禁; n. 鸡笼;小屋;捕鱼篓; [acc]/kuːp/; [or]gre3k;
vapid: [adj]索然无味的;无生气的; [adv]乏味地;无滋味地;无趣味地;无生气地; [acc]/ˈvæpɪd/; [or]gre3k;
gladiator: n. 职业格斗者;角斗士,斗剑者; [acc]/ˈɡlædieɪtər/; [or]gre3k;
sunder: [v]切开;分裂,分离; [acc]/ˈsʌndər/; [or]gre3k;
dike: n. 堤防,堤坝;障碍物;(英)壕沟; [v]筑堤防护;开沟排水; [acc]/daɪk/; [or]gre3k;
clarity: n. 清楚;清澈; [acc]/ˈklærəti/; [or]gre3k;
pithy: [adj]精练的,简洁有力的,多髓的; [acc]/ˈpɪθi/; [or]gre3k;
affix: [v]粘上;署名;将罪责加之于; n. 词缀;附加物; [acc]/əˈfɪks/; [or]gre3k;
panacea: n. 灵丹妙药,万能药; [acc]/ˌpænəˈsiːə/; [or]gre3k;
daft: [adj]愚蠢的; [acc]/dæft/; [or]gre3k;
grandiose: [adj]浮夸的,夸大的,宏伟的; [acc]/ˈɡrændioʊs/; [or]gre3k;
chary: [adj]小心的,谨慎的; [acc]/ˈtʃeri/; [or]gre3k;
choleric: [adj]易怒的,暴躁的,胆汁质的; [acc]/ˈkɑːlərɪk/; [or]gre3k;
dappled: [adj]有斑点的,斑驳的; [acc]/ˈdæpld/; [or]gre3k;
recondite: [adj]深奥的,隐藏的,不为人知的; [acc]/ˈrekəndaɪt/; [or]gre3k;
garish: [adj]炫耀的;过分装饰的;过分鲜艳的; [acc]/ˈɡerɪʃ/; [or]gre3k;
abdicate: [adj]放弃权力的;退位的; n. 放弃权力者;退位者; [vi]退位,辞职; [vt]辞;放弃; [acc]/ˈæbdɪkeɪt/; [or]gre3k;
debonair: [adj]温文尔雅的; [acc]/ˌdebəˈner/; [or]gre3k;
pedagogue: n. 教师,卖弄学问者; [acc]/ˈpedəɡɑːɡ/; [or]gre3k;
scathing: [adj]严厉的;损伤的; [v]损伤;伤害; [acc]/ˈskeɪðɪŋ/; [or]gre3k;
squabble: [v]发生口角,大声争吵; n. 争吵,口角; [acc]/ˈskwɑːbl/; [or]gre3k;
glib: [adj]口齿伶俐的;油嘴滑舌的; [acc]/ɡlɪb/; [or]gre3k;
rant: n. 咆哮,痛骂; [v]咆哮,痛骂,大声责骂; [acc]/rænt/; [or]gre3k;
inane: [adj]无意义的,空洞的;愚蠢的; [acc]/ɪˈneɪn/; [or]gre3k;
virtuoso: n. 艺术品鉴赏家,古董收藏家,艺术大师; [adj]行家里手的,艺术爱好者的; [acc]/ˌvɜːrtʃuˈoʊsoʊ/; [or]gre3k;
whet: [v]刺激;磨快;促进; n. 磨;开胃物;刺激物; [acc]/wet/; [or]gre3k;
endorse: [v]赞同,认可;签注(文件); [acc]/ɪnˈdɔːrs/; [or]gre3k;
remiss: [adj]疏忽的,怠慢的; [acc]/rɪˈmɪs/; [or]gre3k;
abridge: [v]删节;削减; [acc]/əˈbrɪdʒ/; [or]gre3k;
flounder: n. 比目鱼;踉跄前进; [v]踉跄前行;(在水或泥浆中)挣扎,陷入困境; [acc]/ˈflaʊndər/; [or]gre3k;
dent: n. 缺口,凹痕; [v]使凹下,凹进,削弱; [acc]/dent/; [or]gre3k;
scurrilous: [adj]下流的,恶言毁谤的; [acc]/ˈskɜːrələs/; [or]gre3k;
engross: [v]独占;正式誊写;使全神贯注于;用大字体书写; [acc]/ɪnˈɡroʊs/; [or]gre3k;
truss: n. 束;构架;捆; [v]捆绑;用构架支撑; [acc]/trʌs/; [or]gre3k;
captivate: [v]吸引,迷惑; [acc]/ˈkæptɪveɪt/; [or]gre3k;
acme: n. 顶点,极点; [acc]/ˈækmi/; [or]gre3k;
palaver: n. 废话;奉承;诱骗;谈判; [v]闲谈;哄骗,笼络; [acc]/pəˈlɑːvər/; [or]gre3k;
flout: n. 表示轻蔑的言行;嘲弄;嘲笑; [vi]藐视;嘲弄;嘲笑; [vt]嘲弄;嘲笑;藐视; [acc]/flaʊt/; [or]gre3k;
scribble: [v]潦草地写,乱写,滥写; n. 潦草的写法,潦草写成的东西,杂文; [acc]/ˈskrɪbl/; [or]gre3k;
adventitious: [adj]外来的,偶然的; [acc]/ˌædvenˈtɪʃəs/; [or]gre3k;
elliptical: [adj]椭圆的;省略的; [acc]/ɪˈlɪptɪkl/; [or]gre3k;
tenable: [adj]站得住脚的;无懈可击的;合理的; [acc]/ˈtenəbl/; [or]gre3k;
incursion: n. 入侵,侵犯; [acc]/ɪnˈkɜːrʒn/; [or]gre3k;
daunt: [v]使气馁,使畏缩,威吓; [acc]/dɔːnt/; [or]gre3k;
nascent: [adj]初生的,萌芽的;发生中的; [acc]/ˈnæsnt/; [or]gre3k;
liken: [v]把..比作,比拟; [acc]/ˈlaɪkən/; [or]gre3k;
captious: [adj]挑剔的,吹毛求疵的; [acc]/'kæpʃəs/; [or]gre3k;
glaze: n. (浇在糕点上的)糖浆,蛋浆,釉;[气]雨淞; [v](眼睛)变呆滞;浇浆汁于 (食物) 表面;给.安装玻璃; [acc]/ɡleɪz/; [or]gre3k;
sinecure: n. 闲职,挂名职务; [acc]/ˈsaɪnɪkjʊr/; [or]gre3k;
shifty: [adj]变化的,诡诈的,机智的; [acc]/ˈʃɪfti/; [or]gre3k;
charlatan: n. 骗子;假内行; [acc]/ˈʃɑːrlətən/; [or]gre3k;
hobble: [v]蹒跚,跛行; n. 跛行;韵律不全的诗;马的脚绊;〈口,方〉困境; [acc]/ˈhɑːbl/; [or]gre3k;
puissance: n. 权力,权势,影响; [acc]/ˈpwɪsəns/; [or]gre3k;
terminology: n. 术语,术语学; [acc]/ˌtɜːrməˈnɑːlədʒi/; [or]gre3k;
badinage: n. 开玩笑,嘲弄,揶揄; [acc]/ˌbædənˈɑːʒ/; [or]gre3k;
effete: [adj]软弱的;娘娘腔的;颓废的; [acc]/ɪˈfiːt/; [or]gre3k;
engender: [v]产生; [acc]/ɪnˈdʒendər/; [or]gre3k;
gregarious: [adj]群居的,爱社交的; [acc]/ɡrɪˈɡeriəs/; [or]gre3k;
cede: [v]放弃;割让(领土); [acc]/siːd/; [or]gre3k;
innocuous: [adj]无伤大雅的;无害的; [acc]/ɪˈnɑːkjuəs/; [or]gre3k;
mercurial: [adj](情绪)善变的; [acc]/mɜːrˈkjʊriəl/; [or]gre3k;
circumvent: [v]用计避免,规避; [acc]/ˌsɜːrkəmˈvent/; [or]gre3k;
pandemonium: n. 地狱,混乱; [acc]/ˌpændəˈmoʊniəm/; [or]gre3k;
mediate: [v]调解,调停,斡旋; [acc]/ˈmiːdieɪt/; [or]gre3k;
augur: n. 预言者; [v]预言,占卜; [acc]/ˈɔːɡər/; [or]gre3k;
travesty: n. 滑稽模仿;拙劣的模仿作品;歪曲; [vt]滑稽地模仿;歪曲; [acc]/ˈtrævəsti/; [or]gre3k;
outwit: [v]以机智胜过; [acc]/ˌaʊtˈwɪt/; [or]gre3k;
prune: n. 梅干; [v]修剪;削减; [acc]/pruːn/; [or]gre3k;
balk: [v]畏缩;阻止;停止; n. 障碍;错误; [acc]/bɔːk/; [or]gre3k;
interrogate: [v]审问,审讯; [acc]/ɪnˈterəɡeɪt/; [or]gre3k;
pertinacious: [adj]顽固的,执拗的; [acc]/ˌpɜːrtnˈeɪʃəs/; [or]gre3k;
hoax: n. 骗局;恶作剧; [vt]愚弄;欺骗; [acc]/hoʊks/; [or]gre3k;
static: [adj]静电的,静态的,静止的; n. 静电,静电干扰; [acc]/ˈstætɪk/; [or]gre3k;
omniscient: [adj]无所不知的,博识的; n. 无所不知者,上帝; [acc]/ɑːmˈnɪsiənt/; [or]gre3k;
converge: [v](向某一点)相交,会合;汇集,聚集,集中; [acc]/kənˈvɜːrdʒ/; [or]gre3k;
fad: n. 风尚,风行一时的东西; [adj]极好的; [acc]/fæd/; [or]gre3k;
trudge: n. 长途跋涉,沉重的步伐; [v]跋涉,吃力地走; [acc]/trʌdʒ/; [or]gre3k;
pragmatic: [adj]国事的,团体事务的;实际的,注重实效的; n. 爱管闲事的人;专断的人;国事诏书;实际家; [acc]/præɡˈmætɪk/; [or]gre3k;
referee: n. 裁判员,仲裁者; [v]裁判,仲裁; [acc]/ˌrefəˈriː/; [or]gre3k;
smug: [adj]自鸣得意的; [acc]/smʌɡ/; [or]gre3k;
capitulate: [vi]有条件投降,认输,屈服,让步,停止抵抗; [acc]/kəˈpɪtʃuleɪt/; [or]gre3k;
opprobrious: [adj]辱骂的;无礼的;可耻的; [acc]/əˈproʊbriəs/; [or]gre3k;
infraction: n. 违法; [acc]/ɪnˈfrækʃn/; [or]gre3k;
breach: n. 破裂;裂痕;冲击;违反; [v]使有裂口;破坏; [acc]/briːtʃ/; [or]gre3k;
transgress: [v]冒犯,违背;侵犯;越界; [acc]/trænzˈɡres/; [or]gre3k;
transparent: [adj]透明的,清澈的,明净的;易识破的,显而易见的; [acc]/trænsˈpærənt/; [or]gre3k;
transcend: [v]超越(经验,理性,信念等)的范围,超过; [acc]/trænˈsend/; [or]gre3k;
digress: [v]离题;走向岔道; [acc]/daɪˈɡres/; [or]gre3k;
regress: [v]后退,退化,恶化; n. 回归;退回; [acc]/rɪˈɡres/; [or]gre3k;
contravene: [v]抵触,违反,反驳,否认; [acc]/ˌkɑːntrəˈviːn/; [or]gre3k;
peroration: n. 结尾,结论,长篇大论; [acc]/ˌperəˈreɪʃn/; [or]gre3k;
monopolize: [vt]垄断;独占,全部占有; [acc]/məˈnɑːpəlaɪz/; [or]gre3k;
monotonous: [adj]单调的,无聊的; [acc]/məˈnɑːtənəs/; [or]gre3k;
monologue: n. 独白,个人长篇演说; [acc]/ˈmɑːnəlɔːɡ/; [or]gre3k;
neutralize: [v]宣布中立,使中立化;使无效;中和; [acc]/ˈnuːtrəlaɪz/; [or]gre3k;
dilettante: n. 半吊子; [acc]/ˌdɪləˈtænti/; [or]gre3k;
watershed: n. (美)流域;分水岭;集水区;转折点;重要关头; [adj]标志转折点的; [acc]/ˈwɔːtərʃed/; [or]gre3k;
halcyon: [adj]平静的,愉快的,幸福的; n. 翡翠鸟;传说中的太平鸟; [acc]/ˈhælsiən/; [or]gre3k;
harbinger: n. 先驱,先兆; [vt]预告;充做.的前驱; [acc]/ˈhɑːrbɪndʒər/; [or]gre3k;
tangent: n. 切线; [adj]无关的; [acc]/ˈtændʒənt/; [or]gre3k;
discursive: [adj](谈话内容)杂乱的,东拉西扯的,无层次的; [acc]/dɪsˈkɜːrsɪv/; [or]gre3k;
nettle: [v]刺激;惹恼;用荨麻刺; n. 荨麻; [acc]/ˈnetl/; [or]gre3k;
urbane: [adj]温文尔雅的,懂礼的;都[城]市气派的; [acc]/ɜːrˈbeɪn/; [or]gre3k;
corrosive: [adj]腐蚀的;腐蚀性的;蚀坏的; n. 腐蚀剂; [acc]/kəˈroʊsɪv/; [or]gre3k;
dally: [v]闲荡,嬉戏;浪费(时间); [acc]/ˈdæli/; [or]gre3k;
expedite: [v]加快;促进;发出; [adj]畅通的;迅速的;方便的; [acc]/ˈekspədaɪt/; [or]gre3k;
debase: [v]贬值,降低; [acc]/dɪˈbeɪs/; [or]gre3k;
meteoric: [adj]流星的,转瞬即逝的,突然的; [acc]/ˌmiːtiˈɔːrɪk/; [or]gre3k;
bulge: n. 凸出部分; [v]凸出,膨胀; [acc]/bʌldʒ/; [or]gre3k;
decadent: [adj]颓废的;衰退的; [acc]/ˈdekədənt/; [or]gre3k;
crux: n. 关键,难题,十字架形,坩埚; [acc]/krʌks/; [or]gre3k;
crutch: n. 拐杖,支柱; [v]支撑; [acc]/krʌtʃ/; [or]gre3k;
crucial: [adj]关键的;决定性的; [acc]/ˈkruːʃl/; [or]gre3k;
crumple: [v]把.揉作一团,弄皱;压碎; [acc]/ˈkrʌmpl/; [or]gre3k;
imbibe: [v]喝,饮;吸收,接受; [acc]/ɪmˈbaɪb/; [or]gre3k;
scrutinize: [v]仔细检查,细看; [acc]/ˈskruːtənaɪz/; [or]gre3k;
slake: [v]解渴,消渴; [acc]/sleɪk/; [or]gre3k;
tamper: [v]篡改;玩弄;贿赂; n. 填塞者;捣棒; [acc]/ˈtæmpər/; [or]gre3k;
quibble: n. 谬论;双关语;遁辞; [v]诡辩;挑剔;说模棱两可的话; [acc]/ˈkwɪbl/; [or]gre3k;
protocol: n. 外交礼节;草案;外交议定书; [vi]拟定议定书; [vt]把.写入议定书; [acc]/ˈproʊtəkɔːl/; [or]gre3k;
curtail: [vt]截短;削减;剥夺.特权; [acc]/kɜːrˈteɪl/; [or]gre3k;
milieu: n. 周围环境;背景;周围;出身背景; [acc]/mɪlˈjuː/; [or]gre3k;
unrequited: [adj]无回报的;无报酬的; [acc]/ˌʌnrɪˈkwaɪtɪd/; [or]gre3k;
distort: [v]扭曲,使变形;歪曲,曲解; [acc]/dɪˈstɔːrt/; [or]gre3k;
nomad: n. 流浪者,游牧民; [adj]游牧的;流浪的; [acc]/ˈnoʊmæd/; [or]gre3k;
gibe: n. 嘲弄,讥笑; [v]嘲笑; [acc]/dʒaɪb/; [or]gre3k;
amorphous: [adj]无定形的;无组织的;[物]非晶形的; [acc]/əˈmɔːrfəs/; [or]gre3k;
postulate: [v]假定.是真的; n. 假定; [acc]/ˈpɑːstʃəleɪt/; [or]gre3k;
histrionic: [adj]戏剧的,装腔作势的,作戏的; n. 演员;戏剧表演;舞台艺术;戏剧似的言行; [acc]/ˌhɪstriˈɑːnɪk/; [or]gre3k;
frothy: [adj]起泡的,多泡的,空洞的; [acc]/ˈfrɔːθi/; [or]gre3k;
squeamish: [adj]害怕的,易受惊的,想呕吐的; n. 易心烦意乱的人;神经脆弱的人; [acc]/ˈskwiːmɪʃ/; [or]gre3k;
tantamount: [adj]与.相等的; [acc]/ˈtæntəmaʊnt/; [or]gre3k;
preservative: n. 防腐剂;预防法;防护层; [adj]有保存力的;防腐的;有保存力的;有保护性的; [acc]/prɪˈzɜːrvətɪv/; [or]gre3k;
succinct: [adj]简明的,简洁的,没有废话的; [acc]/səkˈsɪŋkt/; [or]gre3k;
incontrovertible: [adj]无可争议的; [acc]/ˌɪnkɑːntrəˈvɜːrtəbl/; [or]gre3k;
surreptitious: [adj]鬼鬼祟祟的,暗中的,秘密的; [acc]/ˌsɜːrəpˈtɪʃəs/; [or]gre3k;
knead: [v]揉捏,塑造; [acc]/niːd/; [or]gre3k;
bombast: n. 高调,夸大之辞; [acc]/ˈbɑːmbæst/; [or]gre3k;
welter: n. 混乱;滚浪;翻滚;起伏; [v]翻滚;沉溺;起伏; [adj]负重赛马的; [acc]/ˈweltər/; [or]gre3k;
lethargic: [adj]困倦的,无力的,无兴趣的; [acc]/ləˈθɑːrdʒɪk/; [or]gre3k;
nonchalant: [adj]若无其事的;满不在乎的;冷静的;冷漠的; [acc]/ˌnɑːnʃəˈlɑːnt/; [or]gre3k;
tarnish: n. 弄脏;失去光泽,生锈; [v]变灰暗,失去光泽,破坏(形象等); [acc]/ˈtɑːrnɪʃ/; [or]gre3k;
blatant: [adj]喧哗的;露骨的;公然的;明目张胆的; [acc]/ˈbleɪtnt/; [or]gre3k;
complementary: [adj]补足的,补充的,互补的; [acc]/ˌkɑːmplɪˈmentri/; [or]gre3k;
recalcitrant: [adj]顽抗的,不顺从的; [acc]/rɪˈkælsɪtrənt/; [or]gre3k;
barb: n. 箭头鱼钩等的倒钩;伤人的话; [v]装倒钩于; [adj]具倒刺的;(话)带刺的; [acc]/bɑːrb/; [or]gre3k;
mumble: [v]含糊地说;抿着嘴嚼; n. 含糊的话;咕噜; [acc]/ˈmʌmbl/; [or]gre3k;
pellucid: [adj]透明的,清晰的,明了的; [acc]/pəˈluːsɪd/; [or]gre3k;
abstemious: [adj](吃喝等)有节制的,节俭的; [acc]/əbˈstiːmiəs/; [or]gre3k;
quaff: [v]痛饮; [acc]/kwæf/; [or]gre3k;
lug: n. 耳状物;把手;笨家伙; [v]拖拉; [acc]/lʌɡ/; [or]gre3k;
deleterious: [adj]有害的;有毒的; [acc]/ˌdeləˈtɪriəs/; [or]gre3k;
prolix: [adj]冗长的,说话啰嗦的; [acc]/ˈproʊlɪks/; [or]gre3k;
inaugurate: [v]为..揭幕;为.举行就职典礼;开展; [acc]/ɪˈnɔːɡjəreɪt/; [or]gre3k;
mangy: [adj]污秽的;疥癣的;肮脏的; [acc]/ˈmeɪndʒi/; [or]gre3k;
pseudonym: n. 笔名,假名; [acc]/ˈsuːdənɪm/; [or]gre3k;
quandary: n. 困惑;窘境;为难; [acc]/ˈkwɑːndəri/; [or]gre3k;
subjugate: [v]征服,使服从; [acc]/ˈsʌbdʒuɡeɪt/; [or]gre3k;
dulcet: [adj]美妙的;悦耳的;怡人的; [acc]/ˈdʌlsɪt/; [or]gre3k;
discretionary: [adj]分立的,自理自由的;任意的; [acc]/dɪˈskreʃəneri/; [or]gre3k;
vertigo: n. 晕头转向;眩晕; [acc]/ˈvɜːrtɪɡoʊ/; [or]gre3k;
gloat: [v]幸灾乐祸地看,窃喜; [acc]/ɡloʊt/; [or]gre3k;
encumber: [v]阻塞,妨害,拖累; [acc]/ɪnˈkʌmbər/; [or]gre3k;
aphorism: n. 格言,警句; [acc]/ˈæfərɪzəm/; [or]gre3k;
stoic: n. 斯多葛学派哲学家;禁欲主义者;坚守克己之人; [adj]斯多葛派的;禁欲主义的; [acc]/ˈstoʊɪkl/; [or]gre3k;
advert: n. 广告; [v]注意,留意; [acc]/ˈædvɜːrt/; [or]gre3k;
compendium: n. 纲要,概略; [acc]/kəmˈpendiəm/; [or]gre3k;
idiosyncrasy: n. 特殊癖性或行为; [acc]/ˌɪdiəˈsɪŋkrəsi/; [or]gre3k;
outgoing: [adj]外向的;外出的;乐于助人的;即将离职的,卸任的; n. 流出;开支; [acc]/ˈaʊtɡoʊɪŋ/; [or]gre3k;
veneer: n. (镶于劣质东西上的)镶面板;掩饰; [v]虚饰;给.镶以饰片; [acc]/vəˈnɪr/; [or]gre3k;
parsimonious: [adj]太节省的,小气的; [acc]/ˌpɑːrsəˈmoʊniəs/; [or]gre3k;
delineate: [v]描画;画出..轮廓; [acc]/dɪˈlɪnieɪt/; [or]gre3k;
overshadow: [v]遮蔽,使显得不重要; [acc]/ˌoʊvərˈʃædoʊ/; [or]gre3k;
coeval: [adj]同时代的; n. 同时代的人; [acc]/koʊˈiːvl/; [or]gre3k;
consensus: n. 一致同意,合意; [acc]/kənˈsensəs/; [or]gre3k;
pusillanimous: [adj]懦弱的,胆小的;优柔寡断的; [acc]/ˌpjuːsɪˈlænɪməs/; [or]gre3k;
misdemeanor: n. 轻罪,品行不端; [acc]/ˌmɪsdɪ'miːnə/; [or]gre3k;
venerate: [v]崇敬,敬仰; [acc]/ˈvenəreɪt/; [or]gre3k;
contentious: [adj]好辩的,爱争论的; [acc]/kənˈtenʃəs/; [or]gre3k;
salubrious: [adj]清爽的;气候有益健康的; [acc]/səˈluːbriəs/; [or]gre3k;
bootless: [adj]无用的,无益的,无利可图的,没穿鞋的; [acc]/'buːtlɪs/; [or]gre3k;
circumlocution: n. 婉转曲折的说法,累赘的陈述,遁辞; [acc]/ˌsɜːrkəmləˈkjuːʃn/; [or]gre3k;
antediluvian: [adj]史前的,陈旧的; n. 大洪水以前的人;年迈的人;不合时宜的人; [acc]/ˌæntidɪˈluːviən/; [or]gre3k;
crescendo: n. (音乐)渐强;高潮; [acc]/krəˈʃendoʊ/; [or]gre3k;
effusive: [adj]流出的;感情奔放的; [acc]/ɪˈfjuːsɪv/; [or]gre3k;
cameo: n. 石雕,贝雕;浮雕玉石;文学小品; [acc]/ˈkæmioʊ/; [or]gre3k;
lush: [adj]草木茂盛的,多的,丰富豪华的; n. 酒;醉汉; [acc]/lʌʃ/; [or]gre3k;
tasty: [adj]好吃的;(尤指女子)迷人的,性感的; [acc]/ˈteɪsti/; [or]gre3k;
askew: [adj]歪斜的; [adv]歪斜地,斜地; [acc]/əˈskjuː/; [or]gre3k;
flippancy: n. 轻率;无礼; [acc]/ˈflɪpənsi/; [or]gre3k;
simulate: [v]假装;模仿;模拟; [acc]/ˈsɪmjuleɪt/; [or]gre3k;
deadlock: [vt](使)相持不下; [vi]僵持; n. 僵局;不分胜负; [acc]/ˈdedlɑːk/; [or]gre3k;
complicate: [v](使)变复杂; [acc]/ˈkɑːmplɪkeɪt/; [or]gre3k;
mentor: n. 导师,指导; [vt]做.的良师;指导; [acc]/ˈmentɔːr/; [or]gre3k;
cower: [v]畏缩,退缩,蜷缩; [acc]/ˈkaʊər/; [or]gre3k;
xenophobe: n. 仇视(或畏惧)外国人(或外国事物)者; [acc]/'zenəˌfoʊb/; [or]gre3k;
solder: [v]焊接;使联接在一起; n. 焊接;接合物; [acc]/ˈsɑːdər/; [or]gre3k;
synopsis: n. 摘要,概要; [acc]/sɪˈnɑːpsɪs/; [or]gre3k;
smirk: n. 傻笑;假笑;得意的笑; [vi]傻笑;假笑; [vt]以假笑表示;以傻笑表示; [acc]/smɜːrk/; [or]gre3k;
altruism: n. 利他主义,不自私; [acc]/ˈæltruɪzəm/; [or]gre3k;
largesse: n. 慷慨援助,施舍; [acc]/lɑːrˈdʒes/; [or]gre3k;
disavow: [v]不承认,抵赖,拒绝对..承担责任; [acc]/ˌdɪsəˈvaʊ/; [or]gre3k;
sluggard: n. 懒鬼;游手好闲的人; [acc]/ˈslʌɡərd/; [or]gre3k;
eschew: [v]避开;戒绝; [acc]/ɪsˈtʃuː/; [or]gre3k;
waylay: [v]埋伏,伏击; [acc]/weɪˈleɪ/; [or]gre3k;
convene: [v]集合,召集,召唤; [acc]/kənˈviːn/; [or]gre3k;
vim: n. 精力,活力; [acc]/vɪm/; [or]gre3k;
acrimonious: [adj]严厉的;辛辣的;刻薄的; [acc]/ˌækrɪˈmoʊniəs/; [or]gre3k;
manipulate: [v]操纵,影响;正骨; [acc]/məˈnɪpjuleɪt/; [or]gre3k;
foible: n. 弱点,小缺点,癖好; [acc]/ˈfɔɪbl/; [or]gre3k;
callow: [adj](鸟)未生羽毛的;年轻而无经验的; [acc]/ˈkæloʊ/; [or]gre3k;
agape: [adj]张口结舌,目瞪口呆;张大着; [acc]/əˈɡeɪp/; [or]gre3k;
reiterate: [vt]反复讲,重申,反复做; [acc]/riˈɪtəreɪt/; [or]gre3k;
paucity: n. 小量,缺乏; [acc]/ˈpɔːsəti/; [or]gre3k;
diaphanous: [adj]透明的;精致的;模糊的; [acc]/daɪˈæfənəs/; [or]gre3k;
ill-bred: [adj]没有教养的,没有礼貌的; [acc]/ˌɪl ˈbred/; [or]gre3k;
disconcert: [v]使仓皇失措;使困惑;破坏; [acc]/ˌdɪskənˈsɜːrt/; [or]gre3k;
dour: [adj]严厉的,顽强的,阴沉的,不爱讲话的; [acc]/dʊr/; [or]gre3k;
hallow: [v]把.视为神圣,尊敬; [acc]/'hæloʊ/; [or]gre3k;
ravish: [v]强夺,强奸,使着迷; [acc]/ˈrævɪʃ/; [or]gre3k;
dolt: n. 笨蛋,傻瓜; [acc]/doʊlt/; [or]gre3k;
malleable: [adj](金属)可锻的;有延展性的;(性格)可训练的;易适应的; [acc]/ˈmæliəbl/; [or]gre3k;
stipulate: [v]规定;保证;保证;要求以.为条件; [acc]/ˈstɪpjuleɪt/; [or]gre3k;
madcap: n. 热爱冒险的人; [adj]大胆的,鲁莽的; [acc]/ˈmædkæp/; [or]gre3k;
vicissitude: n. 变迁,沧桑,兴衰; [acc]/vɪˈsɪsɪtuːd/; [or]gre3k;
fumble: [v]摸索,笨拙地做,漏球; n. 摸索,笨拙的处理,漏球; [adj]笨拙的;迟疑的; [acc]/ˈfʌmbl/; [or]gre3k;
cajole: [v]以甜言蜜语哄骗,勾引; [acc]/kəˈdʒoʊl/; [or]gre3k;
flaccid: [adj]软弱的,无活力的,没气力的,松弛的; [acc]/ˈflæsɪd/; [or]gre3k;
encomium: n. 赞美; [acc]/enˈkoʊmiəm/; [or]gre3k;
abysmal: [adj]极低的或极可怜的,(程度)很深的,极端的; [acc]/əˈbɪzməl/; [or]gre3k;
fiasco: n. 大失败,惨败; [acc]/fiˈæskoʊ/; [or]gre3k;
impecunious: [adj]贫困的,一文不名的; [acc]/ˌɪmpɪˈkjuːniəs/; [or]gre3k;
kidnap: [v]诱拐;绑架; [acc]/ˈkɪdnæp/; [or]gre3k;
overlap: n. 重叠,重复; [v](部分地)重叠; [acc]/ˌoʊvərˈlæp/; [or]gre3k;
plod: [v]沉重地走,吃力干,拖沓冗长; n. 辛勤工作,沉重的步伐; [acc]/plɑːd/; [or]gre3k;
coma: n. 昏迷状态; [acc]/ˈkoʊmə/; [or]gre3k;
residual: [adj]残余的,剩余的; [acc]/rɪˈzɪdʒuəl/; [or]gre3k;
crease: n. 折缝,皱痕; [v]起折痕; [acc]/kriːs/; [or]gre3k;
abase: [v]贬抑;使卑下;降低.的地位; n. 贬低;屈辱;贬低别人的人; [acc]/əˈbeɪs/; [or]gre3k;
agog: [adj]兴奋的,有强烈兴趣的; [adv]渴望;极度兴奋; [acc]/əˈɡɑːɡ/; [or]gre3k;
atrophy: [v]萎缩;衰退;虚脱; n. 萎缩;衰退;萎缩症; [acc]/ˈætrəfi/; [or]gre3k;
prudish: [adj]装正经的,故作拘谨的; [acc]/ˈpruːdɪʃ/; [or]gre3k;
vendor: n. 小贩,卖主,供应商; [acc]/ˈvendər/; [or]gre3k;
doff: [v]脱掉(外衣,帽子); [acc]/dɑːf/; [or]gre3k;
oust: [v]罢免,驱逐,剥夺,取代; [acc]/aʊst/; [or]gre3k;
ramshackle: [adj]摇摇欲坠的; [acc]/ˈræmʃækl/; [or]gre3k;
illiteracy: n. 文盲,无知; [acc]/ɪˈlɪtərəsi/; [or]gre3k;
suffocate: [v]使窒息,被闷死,受阻; [acc]/ˈsʌfəkeɪt/; [or]gre3k;
perceptive: [adj]感知的,知觉的;有知觉力的; [acc]/pərˈseptɪv/; [or]gre3k;
diabolic: [adj]恶魔的;恶魔似的;残忍的; [acc]/ˌdaɪə'bɑːlɪk/; [or]gre3k;
viscid: [adj]黏的,黏质的; [acc]/ˈvɪsɪd/; [or]gre3k;
hike: n. 远足,徒步旅行;(数量,价格等)增加,上升; [v]作长途徒步旅行;使高涨,提高(价格); [acc]/haɪk/; [or]gre3k;
barrage: n. 大量;阻塞;齐射式攻击;[水利]拦河坝; [v]以密集火力阻击; [acc]/bəˈrɑːʒ/; [or]gre3k;
improvise: [v]即席创作,临时凑成; [acc]/ˈɪmprəvaɪz/; [or]gre3k;
nudge: [v](用臂肘)轻推(促其注意),鼓动,接近; n. 推动,用肘轻推; [acc]/nʌdʒ/; [or]gre3k;
disgorge: [v]涌出,流出;吐出; [acc]/dɪsˈɡɔːrdʒ/; [or]gre3k;
fallible: [adj]会犯错的,易犯错的; [acc]/ˈfæləbl/; [or]gre3k;
condone: [v]宽恕;赦免; [acc]/kənˈdoʊn/; [or]gre3k;
satiate: [v]使饱足,生腻; [adj]饱足的;厌腻的; [acc]/ˈseɪʃieɪt/; [or]gre3k;
piebald: [adj]花斑的;杂色的; [acc]/ˈpaɪbɔːld/; [or]gre3k;
effulgent: [adj]光辉的,灿烂的; [acc]/ɪˈfʌldʒənt/; [or]gre3k;
recant: [v]宣布放弃,公开认错; [acc]/rɪˈkænt/; [or]gre3k;
minimize: [v]使缩到最小;达到最低值; [acc]/ˈmɪnɪmaɪz/; [or]gre3k;
wheedle: [v]以甜言蜜语诱惑,用甜言蜜语欺骗; [acc]/ˈwiːdl/; [or]gre3k;
reciprocate: [v]互给;酬答;互换;报答; [acc]/rɪˈsɪprəkeɪt/; [or]gre3k;
sloppy: [adj]泥泞的,(工作)草率的,粗心的; [acc]/ˈslɑːpi/; [or]gre3k;
hyperbole: n. 夸张的语句;夸张法; [acc]/haɪˈpɜːrbəli/; [or]gre3k;
chromatic: [adj]彩色的,五彩的; [acc]/krəˈmætɪk/; [or]gre3k;
coalesce: [v]联合,合并,结合; [acc]/ˌkoʊəˈles/; [or]gre3k;
unctuous: [adj]油腔滑调的,虚情假意的; [acc]/ˈʌŋktʃuəs/; [or]gre3k;
cryptic: [adj]秘密的,含义模糊的,神秘的,隐藏的; [acc]/ˈkrɪptɪk/; [or]gre3k;
veer: n. 方向的转变; [v]转向,改变(话题等),放松(绳,缆等); [acc]/vɪr/; [or]gre3k;
bromide: n. [无化]溴化物,庸俗的人,陈词滥调; [acc]/ˈbroʊmaɪd/; [or]gre3k;
plummet: [v]垂直或突然地堕下,骤然下降; n. 测锤(钓丝的)坠子;线锤;铅锤线;锤规; [acc]/ˈplʌmɪt/; [or]gre3k;
grovel: [v]摇尾乞怜;奴颜婢膝;匍匐; [acc]/ˈɡrɑːvl/; [or]gre3k;
testy: [adj]性急的,暴躁的; [acc]/ˈtesti/; [or]gre3k;
polemic: n. 争论,论战,驳斥; [adj]论战的;喜欢争论的; [acc]/pəˈlemɪk/; [or]gre3k;
prude: n. 过分守礼的人,故作正经的人; [acc]/pruːd/; [or]gre3k;
flamboyant: [adj]辉耀的;华丽的,艳丽的;火焰似的; [acc]/flæmˈbɔɪənt/; [or]gre3k;
obstreperous: [adj]吵闹的,喧嚣的;难驾驭的; [acc]/əbˈstrepərəs/; [or]gre3k;
decry: [v]谴责,责难,诽谤; [acc]/dɪˈkraɪ/; [or]gre3k;
chicanery: n. 诡计,诈骗,欺骗; [acc]/ʃɪˈkeɪnəri/; [or]gre3k;
glutinous: [adj]粘的,胶状的; [acc]/ˈɡluːtənəs/; [or]gre3k;
halfhearted: [adj]不感兴趣的,不热情的; [acc]/'hɑːf'hɑːtɪd/; [or]gre3k;
exonerate: [v]使免罪; [acc]/ɪɡˈzɑːnəreɪt/; [or]gre3k;
antic: [adj]古怪的;滑稽可笑的; n. 滑稽动作;丑角; [v]扮小旦;做滑稽动作; [acc]/'æntɪk/; [or]gre3k;
dyspeptic: n. 消化不良者; [adj]消化不良的;患胃病的; [acc]/dɪsˈpeptɪk/; [or]gre3k;
nullification: n. 废弃,取消,(美)州对联邦法令的拒绝执行或承认; [acc]/ˌnʌləfə'keɪʃən/; [or]gre3k;
prohibitive: [adj]禁止性的,阻止的;(费用,价格等)过高的;类同禁止的; [acc]/prəˈhɪbətɪv/; [or]gre3k;
maelstrom: n. 大漩涡;灾祸;不可抗的破坏力; [acc]/ˈmeɪlstrɑːm/; [or]gre3k;
abet: [vt]唆使,怂恿;支持; [acc]/əˈbet/; [or]gre3k;
pall: n. 幕;棺罩;遮盖物; [v]覆盖;使乏味;走味; [acc]/pɔːl/; [or]gre3k;
quixotic: [adj]空想的,堂吉诃德式的; n. 同"quixotism"; [acc]/kwɪkˈsɑːtɪk/; [or]gre3k;
viscous: [adj]黏的;黏稠的;黏滞的;有黏性的; [acc]/ˈvɪskəs/; [or]gre3k;
ameliorate: [v]改善,减轻(痛苦等),改良; [acc]/əˈmiːliəreɪt/; [or]gre3k;
gobble: [v]狼吞虎咽;急急抓住,任意花完;如饥似渴地阅读;发出雄火鸡般的咯咯叫声; n. (火鸡的)咯咯声; [acc]/ˈɡɑːbl/; [or]gre3k;
sedulous: [adj]聚精会神的,勤勉的; [acc]/ˈsedʒələs/; [or]gre3k;
boycott: [vt]抵制; n. 抵制; [acc]/ˈbɔɪkɑːt/; [or]gre3k;
conundrum: n. (答案有双关意义的)谜语;机智问答;难题; [acc]/kəˈnʌndrəm/; [or]gre3k;
fracas: n. 喧嚷,吵闹,争论,论战; [acc]/ˈfreɪkəs/; [or]gre3k;
chameleon: n. 蜥蜴;变色龙;善变的人; [acc]/kəˈmiːliən/; [or]gre3k;
hegemony: n. 霸权,领导权; [acc]/hɪˈdʒemoʊni/; [or]gre3k;
platitude: n. 陈词滥调,老生常谈;单调; [acc]/ˈplætɪtuːd/; [or]gre3k;
disarray: n. 混乱,漫无秩序; [acc]/ˌdɪsəˈreɪ/; [or]gre3k;
deportation: n. 驱逐出境,放逐; [acc]/ˌdiːpɔːrˈteɪʃn/; [or]gre3k;
clot: [v]使凝成块; n. 凝块; [acc]/klɑːt/; [or]gre3k;
banal: [adj]陈腐的;平庸的;老一套的; [acc]/bəˈnɑːl/; [or]gre3k;
neophyte: n. 新信徒;新入教者;初学者; [acc]/ˈniːəfaɪt/; [or]gre3k;
protrude: [v]伸出,突出,凸出; [acc]/proʊˈtruːd/; [or]gre3k;
skeptic: n. 怀疑论者;怀疑者;无神论者; [acc]/ˈskeptɪk/; [or]gre3k;
rapport: n. 密切关系,交往;和谐一致;意见一致; [acc]/ræˈpɔːr/; [or]gre3k;
tyro: n. 新手; [acc]/ˈtaɪroʊ/; [or]gre3k;
rubicund: [adj]红润的;透红的; [acc]/ˈruːbɪkənd/; [or]gre3k;
eclectic: [adj]折衷主义的;选择的; n. 折衷主义者,折衷派的人; [acc]/ɪˈklektɪk/; [or]gre3k;
crass: [adj]粗鲁的,粗俗的,愚钝的; [acc]/kræs/; [or]gre3k;
turpitude: n. 邪恶,卑鄙(行为); [acc]/ˈtɜːrpətuːd/; [or]gre3k;
mollify: [v]安慰,安抚; [acc]/ˈmɑːlɪfaɪ/; [or]gre3k;
pariah: n. 被排斥或鄙视的人; [acc]/pəˈraɪə/; [or]gre3k;
moribund: [adj]濒临失败的,垂死的; n. 垂死的人; [acc]/ˈmɔːrɪbʌnd/; [or]gre3k;
promulgate: [v]公布;传播;发表; [acc]/ˈprɑːmlɡeɪt/; [or]gre3k;
fertilize: [v]施肥,使肥沃,使多产;使受精; [acc]/ˈfɜːrtəlaɪz/; [or]gre3k;
impeccable: [adj]无瑕疵的,没有缺点的; [acc]/ɪmˈpekəbl/; [or]gre3k;
hearten: [v]激励,鼓励,(使)振作; [acc]/ˈhɑːrtn/; [or]gre3k;
ironclad: [adj]坚固的,装铁甲的;无可推诿的; n. 装甲舰; [acc]/ˈaɪərnklæd/; [or]gre3k;
exorcise: [v]驱邪;除怪; [acc]/ˈeksɔːrsaɪz/; [or]gre3k;
favoritism: n. 偏爱,偏袒; [acc]/'feɪvərɪtˌɪzəm/; [or]gre3k;
sulk: n. 生气,愠怒,愠怒的人; [v]生气,愠怒; [acc]/sʌlk/; [or]gre3k;
laudatory: [adj]表扬的,赞扬的; [acc]/ˈlɔːdətɔːri/; [or]gre3k;
paean: n. 欢乐颂,赞美歌; [acc]/ˈpiːən/; [or]gre3k;
protuberant: [adj]突出的,隆起的; [acc]/proʊˈtuːbərənt/; [or]gre3k;
repertoire: n. (剧团,演员等的)全部节目;全部才能; [acc]/ˈrepərtwɑːr/; [or]gre3k;
hanker: [vi]渴望,追求; [acc]/ˈhæŋkər/; [or]gre3k;
abrogate: [v]废止,废除; n. 取消,废除; [acc]/ˈæbrəɡeɪt/; [or]gre3k;
egoistic: [adj]自私自利的,自我中心的; n. 自我主义者; [acc]/ˌeɡoʊˈɪstɪk/; [or]gre3k;
amble: [v]漫步,缓行; n. 缓行,漫步; [acc]/ˈæmbl/; [or]gre3k;
infuriate: [v]使(人)极为愤怒; [acc]/ɪnˈfjʊrieɪt/; [or]gre3k;
dabble: [v]涉足;浅赏,溅湿;浸入水中; [acc]/ˈdæbl/; [or]gre3k;
disseminate: [v]宣传,传播;散布; [acc]/dɪˈsemɪneɪt/; [or]gre3k;
delve: [v]钻研;探究;挖; n. 穴;洞; [acc]/delv/; [or]gre3k;
invigorate: [v]鼓舞;提神,使精力充沛; [adj]生气勃勃的,精力充沛的,健壮的; n. 滋补;鼓舞; [acc]/ɪnˈvɪɡəreɪt/; [or]gre3k;
grandiloquent: [adj](语言等)夸张的,夸大的; [acc]/ɡrænˈdɪləkwənt/; [or]gre3k;
refulgent: [adj]辉煌的,灿烂的; [acc]/rɪˈfʌldʒənt/; [or]gre3k;
ignite: [v]点燃,发光,燃烧; [acc]/ɪɡˈnaɪt/; [or]gre3k;
contumacious: [adj]违抗的,顽固的,反抗法院命令的; [acc]/ˌkɑːntuˈmeɪʃəs/; [or]gre3k;
foment: [v]煽动,助长(坏事); [acc]/foʊˈment/; [or]gre3k;
inconsequential: [adj]不重要的,不合理的,不合逻辑的; [acc]/ɪnˌkɑːnsɪˈkwenʃl/; [or]gre3k;
connive: [v]默许,共谋; [acc]/kəˈnaɪv/; [or]gre3k;
impugn: [v]指责,对.表示怀疑; [acc]/ɪmˈpjuːn/; [or]gre3k;
amenity: n. 适意;舒适;便利设施;舒适,愉快;礼仪; [acc]/əˈmenəti/; [or]gre3k;
assess: [v]评估;估值; [acc]/əˈses/; [or]gre3k;
jabber: [v]急急忙忙地说,急促不清地说; n. 急促不清地话,无意义的话; [acc]/ˈdʒæbər/; [or]gre3k;
prod: n. 刺针;刺棒;签子; [v]刺;戳;刺激; [acc]/prɑːd/; [or]gre3k;
cachet: n. (证明品质的)优良标志,公务印章,私人印戳,威望,纪念邮戳; [acc]/kæˈʃeɪ/; [or]gre3k;
unwitting: [adj]不知情的;无意的; [acc]/ʌnˈwɪtɪŋ/; [or]gre3k;
mellifluous: [adj](曲调)优美的;流畅的;如蜜般的; [acc]/meˈlɪfluəs/; [or]gre3k;
nadir: n. 最低点,无底; [acc]/ˈneɪdɪr/; [or]gre3k;
submerge: [v]沉没,淹没;遮掩; [acc]/səbˈmɜːrdʒ/; [or]gre3k;
nugatory: [adj]无价值的,琐碎的,无效的,无法律效力的; [acc]/ˈnuːɡətɔːri/; [or]gre3k;
detritus: n. 岩屑,碎石; [acc]/dɪˈtraɪtəs/; [or]gre3k;
estrange: [v]使疏远,离间; [acc]/ɪ'streɪndʒ/; [or]gre3k;
desecrate: [v]亵渎,玷污; [acc]/ˈdesɪkreɪt/; [or]gre3k;
ruminate: [v]反刍,再嚼,深思; [acc]/ˈruːmɪneɪt/; [or]gre3k;
endemic: [adj]地方性的; n. 地方病; [acc]/enˈdemɪk/; [or]gre3k;
elephantine: [adj]笨拙的;巨大的; [acc]/ˌelɪˈfæntiːn/; [or]gre3k;
singe: n. (轻微的)烧焦; [v](轻微地)烧焦,烫焦; [acc]/sɪndʒ/; [or]gre3k;
saccharine: [adj]像糖一样的,有甜味的,做作的,矫情的; [acc]/ˈsækəriːn/; [or]gre3k;
penchant: n. 倾向,爱好; [acc]/ˈpentʃənt/; [or]gre3k;
shackle: n. 枷锁,羁绊(物); [v]给..上手铐(脚镣),用钩链连结,束缚; [acc]/ˈʃækl/; [or]gre3k;
gambol: n. 雀跃,嬉戏; [v]欢跃,嬉戏; [acc]/ˈɡæmbl/; [or]gre3k;
peripatetic: [adj]漫游的,逍遥学派的; n. 走来走去的人,逍遥学派的人; [acc]/ˌperipəˈtetɪk/; [or]gre3k;
hoodwink: [v]欺骗,遮眼,蒙蔽; [acc]/ˈhʊdwɪŋk/; [or]gre3k;
temporize: [v]拖延,妥协,顺应时势,迎合潮流; [acc]/ˈtempəraɪz/; [or]gre3k;
sycophant: n. 马屁精; [acc]/ˈsɪkəfænt/; [or]gre3k;
dawdle: [v]闲荡,浪费时间; [acc]/ˈdɔːdl/; [or]gre3k;
furor: n. 狂热;激怒;喧闹;感动; [acc]/ˈfjʊˌrɔr/; [or]gre3k;
loll: [vi]懒洋洋地倚靠;闲荡; [vt]懒洋洋地倚靠着;使悬垂; [acc]/lɑːl/; [or]gre3k;
vacuous: [adj]空的,空虚的,空洞的,无意义的; [acc]/ˈvækjuəs/; [or]gre3k;
lampoon: n. 讽刺文章; [v]讽刺,写文章讽刺; [acc]/læmˈpuːn/; [or]gre3k;
idyll: n. 田园诗,牧歌; [acc]/ˈaɪdl/; [or]gre3k;
compliant: [adj]顺从的,服从的,应允的; [acc]/kəmˈplaɪənt/; [or]gre3k;
manifest: [adj]显然的,明白无误的,明了的; [v]使显现,使显露,表明; n. 货单,旅客名单; [acc]/ˈmænɪfest/; [or]gre3k;
brandish: [v]挥舞;炫耀的挥舞(武器); n. 挥舞; [acc]/ˈbrændɪʃ/; [or]gre3k;
lethal: [adj]致命的,致死的;杀伤性的; n. 致死因子; [acc]/ˈliːθl/; [or]gre3k;
mawkish: [adj]令人厌恶的,伤感的; [acc]/ˈmɔːkɪʃ/; [or]gre3k;
raze: [v]夷为平地,破坏,消除;拆毁; [acc]/reɪz/; [or]gre3k;
seminal: [adj]重要的,精液的,种子的; [acc]/ˈsemɪnl/; [or]gre3k;
peripheral: [adj]外围的; n. 外围设备; [acc]/pəˈrɪfərəl/; [or]gre3k;
assertive: [adj]肯定的;决断的;坚定而自信的;独断的; [acc]/əˈsɜːrtɪv/; [or]gre3k;
martinet: n. 纪律严明之人; [acc]/ˌmɑːrtnˈet/; [or]gre3k;
archetype: n. 原型,典型; [acc]/ˈɑːrkitaɪp/; [or]gre3k;
inchoate: [adj]早期的;刚开始的;未充分发展的; [acc]/ɪnˈkoʊət/; [or]gre3k;
recuperate: [v]恢复(健康),重新得到,复兴; [acc]/rɪˈkuːpəreɪt/; [or]gre3k;
malcontent: n. 不满分子,反抗者; [adj]不满的,不服的; [acc]/ˌmælkənˈtent/; [or]gre3k;
rigmarole: n. 冗长无聊的废话; [acc]/ˈrɪɡməroʊl/; [or]gre3k;
dissonance: n. 不一致;不调和;不和谐音; [acc]/ˈdɪsənəns/; [or]gre3k;
placate: [vt]安抚,抚慰; [acc]/ˈpleɪkeɪt/; [or]gre3k;
preeminent: [adj]卓越的,超群的; [adv]卓越地,杰出地; [acc]/priˈemɪnənt/; [or]gre3k;
disabuse: [v]使省悟,解迷惑,释疑,矫正; [acc]/ˌdɪsəˈbjuːz/; [or]gre3k;
tenuous: [adj]纤细的;稀薄的;贫乏的;脆弱的; [acc]/ˈtenjuəs/; [or]gre3k;
vilify: [v]辱骂,诽谤; [acc]/ˈvɪlɪfaɪ/; [or]gre3k;
muffle: [v]蒙住,裹住,抑制,发低沉的声音; n. 低沉的声音,消声器,包裹物(如头巾,围巾等),唇鼻部; [acc]/ˈmʌfl/; [or]gre3k;
natty: [adj]整洁的,干净的,潇洒的; [acc]/ˈnæti/; [or]gre3k;
stickler: n. 坚持细节的人,顽固的人,费解的事物; [acc]/ˈstɪklər/; [or]gre3k;
rankle: [v]怨恨,使痛苦,化脓; [acc]/ˈræŋkl/; [or]gre3k;
contaminate: [v]弄脏,污染; [acc]/kənˈtæmɪneɪt/; [or]gre3k;
soporific: [adj]催眠的; n. 安眠药; [acc]/ˌsɑːpəˈrɪfɪk/; [or]gre3k;
clement: [adj](天气)温和的;仁慈的; [acc]/ˈklemənt/; [or]gre3k;
sprawl: n. 四肢伸开的躺卧姿势;蔓生; [v]四肢伸开地坐(或卧);爬行;蔓生; [acc]/sprɔːl/; [or]gre3k;
swill: n. 泔水;冲洗;痛饮; [v]冲洗,痛饮; [acc]/swɪl/; [or]gre3k;
countermand: [vt]撤回,取消; [acc]/ˈkaʊntərmænd/; [or]gre3k;
blurt: [v]突然说出,冲动地说; [acc]/blɜːrt/; [or]gre3k;
drivel: n. 胡言乱语; [v]胡言乱语,说傻话; [acc]/ˈdrɪvl/; [or]gre3k;
spiny: [adj]多刺的;长刺的;刺状的;棘手的; n. 多刺的东西; [acc]/ˈspaɪni/; [or]gre3k;
mandatory: [adj]命令的,强制性的; [acc]/ˈmændətɔːri/; [or]gre3k;
abominate: [v]痛恨,痛恶; n. 憎恶者,厌恶者; [acc]/əˈbɑːmɪneɪt/; [or]gre3k;
rescind: [v]废除;取消;撤回; [acc]/rɪˈsɪnd/; [or]gre3k;
vitiate: [vt]污损,污染,使堕落,使(契约等)无效; [acc]/ˈvɪʃieɪt/; [or]gre3k;
indict: [v]控诉,起诉; [acc]/ɪnˈdaɪt/; [or]gre3k;
inveigle: [v]诱骗,诱使,诱惑; [acc]/ɪnˈveɪɡl/; [or]gre3k;
persiflage: n. 挖苦;嘲弄;戏谑; [acc]/ˈpɜːrsɪflɑːʒ/; [or]gre3k;
mendacious: [adj]撒谎的,虚假的; [acc]/menˈdeɪʃəs/; [or]gre3k;
sapient: [adj]聪明的,伶俐的,装聪明样的,有见识的; n. (史前的)智人; [acc]/ˈseɪpiənt/; [or]gre3k;
circumscribe: [v]限制;在.周围画线;[数]使外接,使外切; [acc]/ˈsɜːrkəmskraɪb/; [or]gre3k;
gauche: [adj]笨拙的,不会社交的,偏转的; [acc]/ɡoʊʃ/; [or]gre3k;
tactile: [adj]有触觉的;能触知的; [acc]/ˈtæktl/; [or]gre3k;
forebode: [v]预示,预兆,预言; [acc]/foʊr'boʊd/; [or]gre3k;
septic: [adj]受感染的,败血症的,腐败的; n. 引起腐败的东西;腐败物; [acc]/ˈseptɪk/; [or]gre3k;
fabricate: [v]建造,制造,伪造(文件等),捏造,编造(谎言,借口等); [acc]/ˈfæbrɪkeɪt/; [or]gre3k;
diocesan: [adj]主教管区的; n. 教区主教; [acc]/daɪˈɑːsɪsn/; [or]gre3k;
inept: [adj]无能的;不称职的;笨拙的; [acc]/ɪˈnept/; [or]gre3k;
amalgamate: [v]合并,混合; [acc]/əˈmælɡəmeɪt/; [or]gre3k;
camaraderie: n. 友情; [acc]/ˌkɑːməˈrɑːdəri/; [or]gre3k;
somatic: [adj]肉体的; [acc]/soʊ'mætɪk/; [or]gre3k;
stereotype: n. 老套的模式,陈规,成见; [v]对..产生成见; [acc]/ˈsteriətaɪp/; [or]gre3k;
instigate: [v]发起,煽动; [acc]/ˈɪnstɪɡeɪt/; [or]gre3k;
suture: n. 缝合; [v]缝合; [acc]/ˈsuːtʃər/; [or]gre3k;
plethora: n. 过多,过剩,多血症; [acc]/ˈpleθərə/; [or]gre3k;
vagary: n. 奇想;奇特行为; [acc]/'veɪgərɪ/; [or]gre3k;
saturate: [v]使充满,使饱和,使湿透; [acc]/ˈsætʃəreɪt/; [or]gre3k;
deflect: [v](使)偏斜,(使)偏转; [acc]/dɪˈflekt/; [or]gre3k;
adulterate: [v]掺假; [adj]通奸的;搀杂的; n. 掺假; [acc]/əˈdʌltəreɪt/; [or]gre3k;
ratiocination: n. 推理,推论; [acc]/ˌreɪʃioʊsɪˈneɪʃn/; [or]gre3k;
avid: [adj]渴望的,贪婪的;热心的; [acc]/ˈævɪd/; [or]gre3k;
verve: n. 热情,神韵,活力,气魄; [acc]/vɜːrv/; [or]gre3k;
tiff: n. 淡酒;一口;口角;生气; [acc]/tɪf/; [or]gre3k;
perquisite: n. 固定津贴,福利; [acc]/ˈpɜːrkwɪzɪt/; [or]gre3k;
dishearten: [v]使灰心,使沮丧; [acc]/dɪsˈhɑːrtn/; [or]gre3k;
comity: n. 友好,社会和谐;礼让; [acc]/'kɒmətɪ/; [or]gre3k;
panoramic: [adj]全景的; [acc]/ˌpænəˈræmɪk/; [or]gre3k;
apocalyptic: [adj]预示灾祸的,启示的; [acc]/əˌpɑːkəˈlɪptɪk/; [or]gre3k;
euphemism: n. 婉言,委婉的说法; [acc]/ˈjuːfəmɪzəm/; [or]gre3k;
splice: n. 接合,衔接处; [v]接头,捻接(线头等); [acc]/splaɪs/; [or]gre3k;
doctrinaire: [adj]教条主义的,空谈理论的; n. 空论家,纯理论家; [acc]/ˌdɑːktrəˈner/; [or]gre3k;
gourmand: n. 贪食者; [adj]贪食的; [acc]/ˈɡʊrmɑːnd/; [or]gre3k;
meticulous: [adj]谨小慎微的;一丝不苟的; [acc]/məˈtɪkjələs/; [or]gre3k;
savvy: n. 老练,机智; [v]明确了解; [adj]有见识,精明能干的; [acc]/ˈsævi/; [or]gre3k;
nostalgia: n. 怀旧之情,思乡病; [acc]/nəˈstældʒə/; [or]gre3k;
verbose: [adj]冗长的,啰嗦的; [acc]/vɜːrˈboʊs/; [or]gre3k;
browbeat: [v]恫吓,吓唬;欺侮; [acc]/ˈbraʊbiːt/; [or]gre3k;
proclivity: n. 倾向,怪癖; [acc]/prəˈklɪvəti/; [or]gre3k;
pivotal: [adj]关键的,枢轴的; [acc]/ˈpɪvətl/; [or]gre3k;
inure: [v]使.习惯,使.适应,起作用,有助于; [acc]/ɪˈnjʊr/; [or]gre3k;
meander: n. 蜿蜒曲折,迂回曲折的旅程;漫步; [v]迂回曲折;漫步;漫谈; [acc]/miˈændər/; [or]gre3k;
therapeutic: [adj]治疗的;治疗学的;有益于健康的; n. 治疗剂;治疗学家; [acc]/ˌθerəˈpjuːtɪk/; [or]gre3k;
diatribe: n. 诽谤,恶骂; [acc]/ˈdaɪətraɪb/; [or]gre3k;
hone: n. 细磨刀石; [v]磨刀; [acc]/hoʊn/; [or]gre3k;
stigmatize: [v]诬蔑,玷污; [acc]/ˈstɪɡmətaɪz/; [or]gre3k;
camouflage: n. 伪装;掩饰; [v]使改头换面,伪装,掩饰;欺瞒; [acc]/ˈkæməflɑːʒ/; [or]gre3k;
vignette: n. 装饰图案;小插图; [v]把..印放为虚光照,晕映; [acc]/vɪnˈjet/; [or]gre3k;
croon: [v]低声歌唱或说话; [acc]/kruːn/; [or]gre3k;
shipshape: [adj]井然有序的;整整齐齐的;整洁干净的; [acc]/ˈʃɪpʃeɪp/; [or]gre3k;
euphonious: [adj]悦耳的;好听的;声音和谐的; [acc]/juːˈfoʊniəs/; [or]gre3k;
waddle: [v](鸭,矮胖子等)摇摇摆摆地走,蹒跚而行; n. 摇摆的步子; [acc]/ˈwɑːdl/; [or]gre3k;
torrential: [adj]汹涌的;奔流的; [adv]似急流地; [acc]/təˈrenʃl/; [or]gre3k;
caveat: n. 警告;防止误解的说明; [acc]/ˈkæviæt/; [or]gre3k;
pilfer: [v]偷窃(公司财产),小偷小摸; [acc]/ˈpɪlfər/; [or]gre3k;
malodorous: [adj]有恶臭的;令人极为反感的;不合法的; [acc]/ˌmælˈoʊdərəs/; [or]gre3k;
syllabus: n. 教学大纲,摘要,课程表; [acc]/ˈsɪləbəs/; [or]gre3k;
curmudgeon: n. 脾气暴躁之人; [acc]/kɜːrˈmʌdʒən/; [or]gre3k;
exigent: [adj]迫切的;紧急的;苛求的; [acc]/'eksədʒənt/; [or]gre3k;
fester: [v]溃烂;化脓;使..痛苦;使..恶化; n. 溃烂;脓疮,脓疱; [acc]/ˈfestər/; [or]gre3k;
oscillate: [v]摆动,犹豫; [acc]/ˈɑːsɪleɪt/; [or]gre3k;
feral: [adj]未驯服的,野生的;凶猛的; [acc]/ˈferəl/; [or]gre3k;
lachrymose: [adj]落泪的,好哭的;催泪的;悲哀的; [acc]/ˈlækrɪmoʊs/; [or]gre3k;
charade: n. 看手势猜字谜游戏; [acc]/ʃəˈreɪd/; [or]gre3k;
commiserate: [v]同情,怜悯; [acc]/kəˈmɪzəreɪt/; [or]gre3k;
imbroglio: n. 纠纷,纠葛; [acc]/ɪmˈbroʊlioʊ/; [or]gre3k;
aggrandize: [v]增大;夸大;吹捧; [acc]/ə'grænˌdaɪz/; [or]gre3k;
personable: [adj]英俊的,风度好的; [acc]/ˈpɜːrsənəbl/; [or]gre3k;
teeming: [adj]多产的,丰富的;热闹的; [acc]/ˈtiːmɪŋ/; [or]gre3k;
insensitive: [adj]感觉迟钝的,对.没有感觉的; [acc]/ɪnˈsensətɪv/; [or]gre3k;
proscribe: [v]剥夺..的公权,禁止; [acc]/proʊˈskraɪb/; [or]gre3k;
congeal: [v]凝结;凝固; [acc]/kənˈdʒiːl/; [or]gre3k;
jibe: [v]与.一致,嘲笑,调转方向,改变航道; n. 嘲笑,嘲弄; [acc]/dʒaɪb/; [or]gre3k;
enervate: [v]使虚弱;使无力; [acc]/ˈenərveɪt/; [or]gre3k;
prerequisite: n. 先决条件,必要条件; [adj]必须先具备的,必要的; [acc]/ˌpriːˈrekwəzɪt/; [or]gre3k;
cornucopia: n. 象征丰收的羊角;装满花果及谷穗表丰饶的羊角状物;丰饶的象征; [acc]/ˌkɔːrnjuˈkoʊpiə/; [or]gre3k;
bawdy: [adj]说黄色笑话的;淫猥的,下流的; [acc]/ˈbɔːdi/; [or]gre3k;
fluster: n. 慌乱,狼狈,混乱; [v]使困惑,慌乱; [acc]/ˈflʌstər/; [or]gre3k;
iconoclast: n. 攻击传统观念或风俗的人; [acc]/aɪˈkɑːnəklæst/; [or]gre3k;
oaf: n. 愚蠢的人; [acc]/oʊf/; [or]gre3k;
eleemosynary: [adj]施舍的,慈善的,接受接济的; [acc]/ˌelə'mɒsənˌerɪ/; [or]gre3k;
cohesive: [adj]团结的;紧密结合的;有黏着力的; [acc]/koʊˈhiːsɪv/; [or]gre3k;
hierarchical: [adj]分等级的; [acc]/ˌhaɪəˈrɑːrkɪkl/; [or]gre3k;
fulminate: [v]猛烈抨击,严厉谴责;怒骂; n. 雷酸盐;烈性炸药; [acc]/ˈfʊlmɪneɪt/; [or]gre3k;
toady: n. 谄媚者,拍马屁的人; [v]谄媚,拍马屁; [acc]/ˈtoʊdi/; [or]gre3k;
germane: [adj]有密切关系的;贴切的;恰当的; [acc]/dʒɜːrˈmeɪn/; [or]gre3k;
cloying: [adj]甜得发腻的;厌烦的;倒胃口的; [acc]/ˈklɔɪɪŋ/; [or]gre3k;
inundate: [v]淹没,泛滥; [acc]/ˈɪnʌndeɪt/; [or]gre3k;
distill: [v]抽出..的精华;蒸馏; [acc]/dɪˈstɪl/; [or]gre3k;
pedagogical: [adj]教育的;教学法的; [acc]/ˌpedəˈɡɑdʒɪk(ə)l/; [or]gre3k;
enunciate: [v]发音,阐明,宣布; [acc]/əˈnʌnsieɪt/; [or]gre3k;
embolden: [vt]鼓励,使勇敢,使有胆量; [acc]/ɪmˈboʊldən/; [or]gre3k;
dismantle: [v]拆开;拆除; [acc]/dɪsˈmæntl/; [or]gre3k;
antagonize: [v]使.敌对,使.对抗,引起反抗; [acc]/ænˈtæɡənaɪz/; [or]gre3k;
lacerate: [v]划破,撕裂;伤害;使..痛心; [adj]撕碎的;精神深受创伤的;受折磨的; [acc]/ˈlæsəreɪt/; [or]gre3k;
Baroque: [adj]巴洛克式的,结构复杂的,形式怪样的; n. 巴洛克风格,巴洛克艺术; [acc]/bəˈroʊk/; [or]gre3k;
fledgling: n. 刚学飞的幼鸟,无经验的人; [adj]刚开始的;无经验的; [acc]/ˈfledʒlɪŋ/; [or]gre3k;
filibuster: n. 冗长演说; [v]拖延议事; [acc]/ˈfɪlɪbʌstər/; [or]gre3k;
stultify: [v]使显得愚蠢,愚弄,使无效,使无价值; [acc]/ˈstʌltɪfaɪ/; [or]gre3k;
axiomatic: [adj]公理的,自明的; [acc]/ˌæksiəˈmætɪk/; [or]gre3k;
purloin: [v]偷窃; [acc]/pɜːrˈlɔɪn/; [or]gre3k;
reprehend: [vt]申斥,指责,批评; [acc]/ˌreprɪ'hend/; [or]gre3k;
yokel: n. 乡巴佬;庄稼汉; [acc]/ˈjoʊkl/; [or]gre3k;
inadvertent: [adj]疏忽的,漫不经心的,无意中的; [acc]/ˌɪnədˈvɜːrtənt/; [or]gre3k;
deify: [v]奉为神;崇拜; [acc]/ˈdeɪɪfaɪ/; [or]gre3k;
poach: [v]水煮;小火煮;偷猎;窃取; [acc]/poʊtʃ/; [or]gre3k;
misconstrue: [v]误解,曲解; [acc]/ˌmɪskənˈstruː/; [or]gre3k;
prevaricate: [v]支吾,搪塞,说谎; [acc]/prɪˈværɪkeɪt/; [or]gre3k;
accolade: n. 同意,赞赏; [v]赞扬; [acc]/ˈækəleɪd/; [or]gre3k;
dampen: [v]变潮湿; [vi]沮丧; [vt]使潮湿;抑制,使扫兴; [acc]/ˈdæmpən/; [or]gre3k;
bumptious: [adj]专横傲慢的,自以为是的; [acc]/ˈbʌmpʃəs/; [or]gre3k;
gullible: [adj]易受骗的;轻信的; [acc]/ˈɡʌləbl/; [or]gre3k;
maverick: n. 独行者,想法与众不同的人; [adj]行为不合常规的; [v]用不正当手段获取;迷路; [acc]/ˈmævərɪk/; [or]gre3k;
bash: [v]猛击,痛击;怒殴; n. 猛烈的一击,痛击; [acc]/bæʃ/; [or]gre3k;
goggle: n. 眼睛睁视,风镜,护目镜; [adj]睁眼的,瞪眼的; [v]眼珠转动,瞪眼看,使瞪眼; [acc]/ˈɡɑːɡl/; [or]gre3k;
distal: [adj][解剖]末梢的,末端的; [acc]/ˈdɪstl/; [or]gre3k;
rile: [v]刺激,惹怒; [acc]/raɪl/; [or]gre3k;
disparate: [adj]迥然不同的; [acc]/ˈdɪspərət/; [or]gre3k;
cherubic: [adj]可爱的;天使的;无邪的; [acc]/tʃəˈruːbɪk/; [or]gre3k;
roster: n. 值勤表,花名册; [v]将(姓名)列入值勤名单; [acc]/ˈrɑːstər/; [or]gre3k;
abscond: [v]逃匿,潜逃;避债; [acc]/əbˈskɑːnd/; [or]gre3k;
narcissism: n. 自恋,自爱; [acc]/ˈnɑːrsɪsɪzəm/; [or]gre3k;
tantalize: [v]逗弄,挑逗,使(看到拿不到而)焦急; [acc]/ˈtæntəlaɪz/; [or]gre3k;
parch: [v]焦干,烤干,使干透; [acc]/pɑːrtʃ/; [or]gre3k;
half-baked: [adj]不完整的;未完成的;半熟的; [acc]/ˌhæf ˈbeɪkt/; [or]gre3k;
nexus: n. 关系;连结; [acc]/ˈneksəs/; [or]gre3k;
feckless: [adj]不负责任的,无目标无计划的,无效的; [adv]没有价值地;没有长远目标地;不负责任地; n. 没有价值,没有长远目标,不负责任; [acc]/ˈfekləs/; [or]gre3k;
gadfly: n. 牛虻,令人生厌的人; [acc]/ˈɡædflaɪ/; [or]gre3k;
jejune: [adj]空洞的,枯燥无味的;不成熟的;缺乏营养的; [acc]/dʒɪˈdʒuːn/; [or]gre3k;
grandstand: n. 正面看台;看台席上的观众;哗众取宠的表演; [adj]哗众取宠的;看台上的; [v]哗众取宠;卖弄技巧; [acc]/ˈɡrænstænd/; [or]gre3k;
exude: [v]慢慢流出,四溢,渗出,散发; [acc]/ɪɡˈzuːd/; [or]gre3k;
distend: [v]膨胀;胀大;扩张; [acc]/dɪˈstend/; [or]gre3k;
effluvium: n. 难闻的气味,没用的副产品,废品; [acc]/e'fluːvɪəm/; [or]gre3k;
spate: n. 洪水;一阵;大雨;突然迸发; [acc]/speɪt/; [or]gre3k;
metamorphose: [v]使变形,使变质; [acc]/ˌmetəˈmɔːrfoʊz/; [or]gre3k;
nirvana: n. 涅槃,心灵的平静,极乐; [acc]/nɪrˈvɑːnə/; [or]gre3k;
irk: [v]使苦恼,使厌烦; n. 厌烦,厌倦; [acc]/ɜːrk/; [or]gre3k;
procrastinate: [v](因不愿意做或习惯性地)耽搁,拖延; [acc]/proʊˈkræstɪneɪt/; [or]gre3k;
coagulate: [v]凝结,使凝结; [acc]/koʊˈæɡjuleɪt/; [or]gre3k;
transfigure: [v]美观,改观; [acc]/trænsˈfɪɡjər/; [or]gre3k;
petrify: [v]石化,使僵化,使惊呆; [acc]/ˈpetrɪfaɪ/; [or]gre3k;
malaise: n. 不舒服;心神不安; [acc]/məˈleɪz/; [or]gre3k;
vacillate: [v]犹豫;踌躇;摇摆; [acc]/ˈvæsəleɪt/; [or]gre3k;
gourmet: n. 美食家,讲究吃喝的人; [adj]菜肴精美的; [acc]/ˈɡʊrmeɪ/; [or]gre3k;
aberrant: n. 离开正路的人,反常的人; [adj]偏离正轨的;异常的,畸变的; [acc]/æˈberənt/; [or]gre3k;
collaborate: [v]合作; [acc]/kəˈlæbəreɪt/; [or]gre3k;
perforate: [vt]穿孔于,打孔穿透;在.上打齿孔; [vi]穿过,贯穿;穿孔; [acc]/ˈpɜːrfəreɪt/; [or]gre3k;
wastrel: n. 败家子,挥霍无度的人; [acc]/ˈweɪstrəl/; [or]gre3k;
glower: [v]怒目而视; [acc]/ˈɡlaʊər/; [or]gre3k;
brash: [adj]无礼的,傲慢的;仓促的,性急的; n. 骤雨;碎片;[医]胃灼热; [acc]/bræʃ/; [or]gre3k;
tantrum: n. (孩子气的)脾气发作; [acc]/ˈtæntrəm/; [or]gre3k;
fecund: [adj]肥沃的;多产的;丰饶的;生殖力旺盛的; [acc]/ˈfiːkənd/; [or]gre3k;
purvey: [v](大量)供给,供应; [acc]/pərˈveɪ/; [or]gre3k;
sabotage: n. 怠工,蓄意破坏,妨碍; [v]怠工,从事破坏活动,故意阻挠; [acc]/ˈsæbətɑːʒ/; [or]gre3k;
ream: [v]榨取(果汁等);扩展;挖; n. 令(纸张的计数单位);大量; [acc]/riːm/; [or]gre3k;
daredevil: n. 铤而走险的人,蛮勇的人; [adj]蛮勇的,不怕死的; [acc]/ˈderdevl/; [or]gre3k;
calligraphy: n. 笔迹,墨宝,书法; [acc]/kəˈlɪɡrəfi/; [or]gre3k;
typo: n. 排印错误;排字工;印刷工; [acc]/ˈtaɪpoʊ/; [or]gre3k;
subliminal: [adj]潜意识的,下意识的; [acc]/ˌsʌbˈlɪmɪnl/; [or]gre3k;
pulverize: [v]粉碎;使成粉末;彻底击败;彻底毁坏; [acc]/ˈpʌlvəraɪz/; [or]gre3k;
convoluted: [adj]旋绕的,费解的; [acc]/ˈkɑːnvəluːtɪd/; [or]gre3k;
potable: [adj]适于饮用的; n. 饮料; [acc]/ˈpoʊtəbl/; [or]gre3k;
sacrosanct: [adj](因十分重要,神圣)不可改变,批判的; [acc]/ˈsækroʊsæŋkt/; [or]gre3k;
wobble: [v]摇晃;摇摆;游移不定; n. 摆动;摇晃;不稳定; [acc]/ˈwɑːbl/; [or]gre3k;
pundit: n. 博学者,评论家; [acc]/ˈpʌndɪt/; [or]gre3k;
stodgy: [adj]平凡的;塞满的;庸俗的; [acc]/ˈstɑːdʒi/; [or]gre3k;
addict: n. 上瘾的人;入迷的人; [v]使沉迷,使上瘾; [acc]/ˈædɪkt/; [or]gre3k;
adjudicate: [v]充当裁判,判决; n. 判决,宣判;裁判员; [acc]/əˈdʒuːdɪkeɪt/; [or]gre3k;
quash: [v]镇压,平息,废除,使无效; [acc]/kwɔːʃ/; [or]gre3k;
ebullient: [adj]热情洋溢的,沸腾的; [acc]/ɪˈbʌliənt/; [or]gre3k;
turncoat: n. 叛徒; [acc]/ˈtɜːrnkoʊt/; [or]gre3k;
enfranchise: [v]给予选举权,释放(奴隶); [acc]/ɪnˈfræntʃaɪz/; [or]gre3k;
vitriolic: [adj]刻薄的,强烈的,硫酸(盐)的,由硫酸制成的; [acc]/ˌvɪtriˈɑːlɪk/; [or]gre3k;
burnish: [v]擦亮,磨光; [acc]/ˈbɜːrnɪʃ/; [or]gre3k;
machination: n. 阴谋; [acc]/ˌmækəˈneɪʃn/; [or]gre3k;
debacle: n. 解冻,崩溃;灾害; [acc]/dɪˈbɑːkl/; [or]gre3k;
miff: n. 微怒,小争执; [v]使..恼怒; [adj]有点恼火;有点不高兴; [acc]/mɪf/; [or]gre3k;
disinter: [v]掘出;发掘;显露; [acc]/ˌdɪsɪnˈtɜːr/; [or]gre3k;
nuance: n. 细微差别; [acc]/ˈnuːɑːns/; [or]gre3k;
abut: [v]紧靠; [acc]/əˈbʌt/; [or]gre3k;
antedate: n. 比实际提前的日期; [vt]在.上写上早于实际的日期;发生于.以前;使提前发生;使回到过去; [acc]/ˌæntiˈdeɪt/; [or]gre3k;
discomfit: [v]挫败,扰乱,破坏,使.为难; [acc]/dɪsˈkʌmfɪt/; [or]gre3k;
infelicitous: [adj]不妥当的,不得体的,不吉利的; [acc]/ˌɪnfə'lɪsətəs/; [or]gre3k;
suffuse: [v](色彩等)弥漫,染遍; [acc]/səˈfjuːz/; [or]gre3k;
disenchant: [v]使觉悟,使摆脱幻想; [acc]/ˌdɪsɪn'tʃænt/; [or]gre3k;
waffle: n. 华夫饼干;动听而无意义的话;无聊话; [v]胡扯,含糊其辞; [acc]/ˈwɑːfl/; [or]gre3k;
protean: [adj]变化多端的,能够变化的; [acc]/ˈproʊtiən/; [or]gre3k;
rapprochement: n. 和好,恢复邦交; [acc]/ˌræproʊʃˈmɑːn/; [or]gre3k;
anesthetic: n. 麻醉剂,麻药; [adj]麻醉的,感觉缺失的; [acc]/ˌænəs'θetɪk/; [or]gre3k;
perimeter: n. 周长;周界; [acc]/pəˈrɪmɪtər/; [or]gre3k;
infatuate: [v]使迷恋;使糊涂,使冲昏头脑; [adj]着迷的; [acc]/ɪn'fætʃʊˌeɪt/; [or]gre3k;
lopsided: [adj]不平衡的,倾向一方的; [acc]/ˌlɑːpˈsaɪdɪd/; [or]gre3k;
doldrums: n. (海洋上的)无风带,情绪低沉; [acc]/ˈdoʊldrəmz/; [or]gre3k;
enthrall: [v]迷惑,迷住; [acc]/ɪnˈθrɔl/; [or]gre3k;
immure: [v]监禁; [acc]/ɪˈmjʊr/; [or]gre3k;
boggle: [v]畏缩不前;惊恐;使..困惑; [acc]/ˈbɑːɡl/; [or]gre3k;
wrongheaded: [adj]固执己见的,坚持(错误观点)的; [acc]/'rɒŋhedɪd/; [or]gre3k;
perspicacious: [adj]独具慧眼的,聪颖的; [acc]/ˌpɜːrspɪˈkeɪʃəs/; [or]gre3k;
sartorial: [adj]裁缝匠的,裁缝的;缝纫的; [acc]/sɑːrˈtɔːriəl/; [or]gre3k;
abbreviate: [v]缩写,使省略,使用缩写词; n. 使用缩写词的人;缩短,缩写(词,短语,名字,名称); [acc]/əˈbriːvieɪt/; [or]gre3k;
careen: n. (船的)倾侧; [v](船)倾斜,使倾斜; [acc]/kəˈriːn/; [or]gre3k;
douse: [v]把.浸入水中,用水泼; [acc]/daʊs/; [or]gre3k;
attenuate: [v]变薄,变弱,变纤细; [adj]稀薄的;细小的;减弱的;减少的; [acc]/əˈtenjueɪt/; [or]gre3k;
emollient: n. 润肤剂; [acc]/iˈmɑːliənt/; [or]gre3k;
evict: [v]驱逐,逐出; [acc]/ɪˈvɪkt/; [or]gre3k;
nonplus: [v]使窘困;使迷惑;狼狈不堪; n. 迷惑,困惑; [acc]/ˌnɒn'plʌs/; [or]gre3k;
perturb: [vt]使不安;烦扰;使紊乱; [acc]/pərˈtɜːrb/; [or]gre3k;
minatory: [adj]带来威胁的,有凶兆的; [acc]/ˈmɪnətɔːri/; [or]gre3k;
ancillary: [adj]辅助的,副的; n. 助手;辅助设备; [acc]/ˈænsəleri/; [or]gre3k;
homely: [adj]不好看的,相貌平平的;朴素的;(如在家一般)舒适自在,家庭的;(女士)热情友好的,和蔼的; [acc]/ˈhoʊmli/; [or]gre3k;
sequester: [v]使隔离,隔绝,使隐退,没收,扣押; [acc]/sɪˈkwestər/; [or]gre3k;
resilience: n. 恢复力;弹力;顺应力; [acc]/rɪˈzɪliəns/; [or]gre3k;
recessive: [adj]隐性的,逆行的,后退的; [acc]/rɪˈsesɪv/; [or]gre3k;
commingle: [vi]混合; [vt]使混合;掺和; [acc]/kəˈmɪŋɡl/; [or]gre3k;
insulate: [v]隔离,使隔绝(以免受到影响);使隔热; [acc]/ˈɪnsəleɪt/; [or]gre3k;
hedonism: n. 享乐主义; [acc]/ˈhiːdənɪzəm/; [or]gre3k;
squelch: n. 吧唧声;压制,镇压; [v]吧唧作响;消除,镇压,不让说; [acc]/skweltʃ/; [or]gre3k;
viable: [adj]可行的;能养活的;能生育的; [acc]/ˈvaɪəbl/; [or]gre3k;
arcane: [adj]神秘的;秘传的;晦涩难解的; [acc]/ɑːrˈkeɪn/; [or]gre3k;
deject: [v]使.灰心; [adj]沮丧的,气馁的; [acc]/dɪ'dʒekt/; [or]gre3k;
perambulate: [v]巡行,巡视,漫步; [acc]/pəˈræmbjuleɪt/; [or]gre3k;
sybarite: n. 沉于奢侈逸乐者,酒色之徒; [acc]/'sɪbəˌraɪt/; [or]gre3k;
hidebound: [adj]死板的,顽固的,墨守成规的; [acc]/ˈhaɪdbaʊnd/; [or]gre3k;
coda: n. ［音］结尾,符尾; [acc]/ˈkoʊdə/; [or]gre3k;
guzzle: [v]狂饮暴食,大吃大喝; [acc]/ˈɡʌzl/; [or]gre3k;
lubricate: [v]使.润滑;给.加润滑油; [acc]/ˈluːbrɪkeɪt/; [or]gre3k;
agonize: [v]感到极度痛苦,挣扎,折磨; [acc]/ˈæɡənaɪz/; [or]gre3k;
nauseate: [v]使作呕,产生恶感; [acc]/ˈnɔːzieɪt/; [or]gre3k;
belabor: [v]抨击;反复讨论,啰啰嗦嗦地说明; [acc]/bɪˈleɪbər/; [or]gre3k;
scrimp: [adj]不足的,吝啬的; [vt]过度缩减,克扣; [vi]节省或精打细算; [acc]/skrɪmp/; [or]gre3k;
embezzle: [v]盗用,挪用,贪污; [acc]/ɪmˈbezl/; [or]gre3k;
canard: n. 误传,谬传;谣言; [acc]/kəˈnɑːrd/; [or]gre3k;
hangdog: [adj]伤心的,沮丧的;鬼鬼祟祟的; n. 卑鄙的人;卑微的人; [acc]/ˈhæŋdɔːɡ/; [or]gre3k;
resurrect: [v]复苏,复兴;使复活; [acc]/ˌrezəˈrekt/; [or]gre3k;
garble: [v]使错乱,混淆;歪曲,断章取义; [acc]/'gɑːbəl/; [or]gre3k;
poseur: n. 装模作样的人; [acc]/poʊˈzɜːr/; [or]gre3k;
stabilize: [v]使稳定; [acc]/ˈsteɪbəlaɪz/; [or]gre3k;
surrogate: n. 代替品,代理人,代孕妈妈; [adj]代理的,替代的; [v]代替,代理;指定为自己的代理人,接替; [acc]/ˈsɜːrəɡət/; [or]gre3k;
permeable: [adj]可渗透的;可穿透的; [acc]/ˈpɜːrmiəbl/; [or]gre3k;
besmirch: [v]诽谤,玷污; [acc]/bɪˈsmɜːrtʃ/; [or]gre3k;
cacophony: n. 刺耳的音调;不和谐音; [acc]/kəˈkɑːfəni/; [or]gre3k;
hamstring: n. 腿筋; [v]切断腿筋使成跛腿;使无效; [acc]/ˈhæmstrɪŋ/; [or]gre3k;
hermetic: [adj]密封的;与外界隔绝的;不透气的;炼金术的; [acc]/hɜːrˈmetɪk/; [or]gre3k;
scintillate: [v]闪烁,(淡吐)流露机智; [acc]/'sɪntlˌeɪt/; [or]gre3k;
epitomize: [v]摘要;化身;成为.的缩影; [acc]/ɪˈpɪtəmaɪz/; [or]gre3k;
ethos: n. 民族精神,气质,社会思潮; [acc]/ˈiːθɑːs/; [or]gre3k;
doodle: [v](无目的地)乱画,漫无目的地打发时光; n. 涂鸦; [acc]/ˈduːdl/; [or]gre3k;
preen: [v]打扮;用嘴整理;赞扬; [acc]/priːn/; [or]gre3k;
paranoid: [adj]偏执狂的,过分怀疑的; [acc]/ˈpærənɔɪd/; [or]gre3k;
airtight: [adj]不透气的,密封的; [acc]/ˈertaɪt/; [or]gre3k;
effervesce: [v]冒泡,热情洋溢; [acc]/ˌefə'ves/; [or]gre3k;
bumble: [v]嗡嗡叫,营营响;说话含糊,结结巴巴地讲话;笨拙地行动,踉跄前行;弄糟; n. 〈英〉骄横的小官吏; [acc]/ˈbʌmbl/; [or]gre3k;
berate: [v]猛烈责骂; [acc]/bɪˈreɪt/; [or]gre3k;
macabre: [adj]骇人的,可怖的; [acc]/məˈkɑːbrə/; [or]gre3k;
align: [vi]排队,排成一行; [vt]使成一直线; [acc]/əˈlaɪn/; [or]gre3k;
manumit: [v]解放(奴隶); [acc]/ˌmænjə'mɪt/; [or]gre3k;
excrete: [v]排泄,分泌; [acc]/ɪkˈskriːt/; [or]gre3k;
myopic: n. 近视; [adj]近视的;目光短浅的; [acc]/maɪˈɑːpɪk/; [or]gre3k;
patina: n. 绿锈,光亮的外表,神态,圣餐盘; [acc]/pəˈtiːnə/; [or]gre3k;
anachronistic: [adj]时代错误的; [acc]/əˌnækrəˈnɪstɪk/; [or]gre3k;
beleaguer: [v]围攻; [acc]/bɪ'liːgə/; [or]gre3k;
contort: [v]扭曲,歪曲; [acc]/kənˈtɔːrt/; [or]gre3k;
denude: [v]脱去,剥蚀,剥夺; [acc]/dɪˈnuːd/; [or]gre3k;
paradigm: n. 范例,示范; [acc]/ˈpærədaɪm/; [or]gre3k;
innovative: [adj]创新的,革新的; [acc]/ˈɪnəveɪtɪv/; [or]gre3k;
molt: [v]脱毛,换毛; n. 换羽期,脱毛期; [acc]/moʊlt/; [or]gre3k;
underscore: [v]强调,加强,划线于.下; n. 底线; [acc]/ˌʌndərˈskɔːr/; [or]gre3k;
etch: n. 蚀刻; [vi]蚀刻; [vt]蚀镂,蚀刻,描述,铭记; [acc]/etʃ/; [or]gre3k;
posit: [v]假定; n. 安置;论断; [acc]/ˈpɑːzɪt/; [or]gre3k;
leery: [adj]机警的,狡猾的; [acc]/ˈlɪri/; [or]gre3k;
deplete: [v]使大大减少;耗尽,用尽; [acc]/dɪˈpliːt/; [or]gre3k;
abash: [v]使局促不安;使羞愧; [adj]窘迫的,尴尬的; [adv]窘迫地,尴尬地; n. 窘迫,尴尬; [acc]/ə'bæʃ/; [or]gre3k;
debilitate: [v]使衰弱; [acc]/dɪˈbɪlɪteɪt/; [or]gre3k;
stoke: [v]添加燃料,把(火)拨旺,狼吞虎咽吃; n. 斯托克;[物]沲; [acc]/stoʊk/; [or]gre3k;
castigate: [v]严惩;苛评;矫正;修订; [acc]/ˈkæstɪɡeɪt/; [or]gre3k;
pejorative: n. 轻蔑语; [adj]带有轻蔑意义的,贬低的; [acc]/pɪˈdʒɔːrətɪv/; [or]gre3k;
wanderlust: n. 漫游癖;憧憬流浪; [acc]/ˈwɑːndərlʌst/; [or]gre3k;
galvanize: [v]镀锌,通电,刺激; [acc]/ˈɡælvənaɪz/; [or]gre3k;
kudos: n. 荣誉;名望;称赞; [acc]/ˈkuːdəʊs/; [or]gre3k;
asymmetrical: [adj][数]非对称的; [acc]/ˌeɪsɪˈmetrɪk(ə)l/; [or]gre3k;
macerate: [v]浸软,消瘦; [acc]/ˈmæsəreɪt/; [or]gre3k;
hallmark: n. 特点;品质证明; [v]给.盖上品质证明印记;使具有.标志; [acc]/ˈhɔːlmɑːrk/; [or]gre3k;
pleat: n. 褶,褶状物; [acc]/pliːt/; [or]gre3k;
ineluctable: [adj]不可改变的,无法逃避的; [acc]/ˌɪnɪˈlʌktəbl/; [or]gre3k;
ostracize: [v]放逐,排斥,(古希腊)按贝壳流放法放逐; [acc]/ˈɑːstrəsaɪz/; [or]gre3k;
undergird: [v]加强,巩固..的底部; [acc]/ˌʌndə'gɜːd/; [or]gre3k;
glitch: n. 小故障; [acc]/ɡlɪtʃ/; [or]gre3k;
quotidian: [adj]每天的,司空见惯的; [acc]/kwoʊˈtɪdiən/; [or]gre3k;
heckle: [v]诘问,困扰; n. 麻梳;梳理;[印]针排; [acc]/ˈhekl/; [or]gre3k;
raffish: [adj]轻浮的,艳丽而俗气的; [acc]/ˈræfɪʃ/; [or]gre3k;
eavesdrop: [v]偷听,窃听; n. 屋檐水; [acc]/ˈiːvzdrɑːp/; [or]gre3k;
sidestep: n. (侧面)台阶;拳击等横跨一步躲避打击;［喻］回避(困难); [v]回避;横跨一步躲避; [acc]/ˈsaɪdstep/; [or]gre3k;
roil: [v]搅浑,惹怒,动荡,喧闹; n. 小股汹涌的急流; [acc]/rɔɪl/; [or]gre3k;
belligerence: n. 好战,交战; [acc]/bəˈlɪdʒərəns/; [or]gre3k;
jettison: [v]向外抛弃,投弃(船舶遇难时投弃货物以为减轻负载); n. 抛弃的货物; [acc]/ˈdʒetɪsn/; [or]gre3k;
cosset: [v]宠爱,娇养; n. 宠儿,爱畜;宠物; [acc]/ˈkɑːsɪt/; [or]gre3k;
matriculate: n. 被录取者; [v]准许.入学; [acc]/məˈtrɪkjuleɪt/; [or]gre3k;
plangent: [adj]轰鸣的,凄切的; [acc]/ˈplændʒənt/; [or]gre3k;
congruent: [adj]和谐一致的,全等的; [acc]/ˈkɑːŋɡruənt/; [or]gre3k;
monochromatic: [adj][物]单色的; [acc]/ˌmɑːnəkroʊˈmætɪk/; [or]gre3k;
dichotomy: n. 二分,本质对立; [acc]/daɪˈkɑːtəmi/; [or]gre3k;
blueprint: n. 蓝图,设计图,计划; [vt]制成蓝图,计划; [acc]/ˈbluːprɪnt/; [or]gre3k;
demotic: [adj]通俗的,民众的; [acc]/dɪˈmɑːtɪk/; [or]gre3k;
obsess: [vt]迷住,使着迷,使烦扰; [acc]/əbˈses/; [or]gre3k;
juggernaut: n. 摧毁一切的强大力量,不可抗拒的力量;大型重卡车; [acc]/ˈdʒʌɡərnɔːt/; [or]gre3k;
infiltrate: [v]渗入,潜入 (某地方或组织);(气,液)渗透; n. 渗透物; [acc]/ˈɪnfɪltreɪt/; [or]gre3k;
abrade: [v]磨损,擦伤; [acc]/əˈbreɪd/; [or]gre3k;
exacerbate: [v]加重;恶化;激怒; [acc]/ɪɡˈzæsərbeɪt/; [or]gre3k;
outmoded: [adj]不再流行的,过时的; [acc]/ˌaʊtˈmoʊdɪd/; [or]gre3k;
victimize: [v]使受害,使牺牲,欺骗; [acc]/ˈvɪktɪmaɪz/; [or]gre3k;
decant: [vt]轻轻倒出; [acc]/dɪˈkænt/; [or]gre3k;
indurate: [v]变坚固,使冷酷; [adj]冷酷的,硬化的; [acc]/'ɪndjʊˌreɪt/; [or]gre3k;
erode: [v]腐蚀;遭侵蚀,腐蚀,侵蚀;削弱; [vt]损害; [acc]/ɪˈroʊd/; [or]gre3k;
vaporize: [v](使)蒸发;使.蒸发; [acc]/ˈveɪpəraɪz/; [or]gre3k;
annotate: [v]注释,评注; n. 注释者; [acc]/ˈænəteɪt/; [or]gre3k;
burgeon: [v]发芽,迅速成长; n. 嫩枝; [acc]/ˈbɜːrdʒən/; [or]gre3k;
truncate: [adj]截短的;被删节的; [v]把(某物)截短,去尾; [acc]/ˈtrʌŋkeɪt/; [or]gre3k;
spoof: n. 滑稽模仿(对电影,电视节目等); [v]揶揄,嘲讽;哄骗,欺骗; [acc]/spuːf/; [or]gre3k;
skimp: [vt]少给,克扣,不足量地供给;对.草率从事; [vi]克俭,节省; [adj]少的,不足的; [acc]/skɪmp/; [or]gre3k;
proselytize: [v]使皈依; [acc]/ˈprɑːsələtaɪz/; [or]gre3k;
bifurcate: [v]分为二支,分叉; [adj]分叉的; [acc]/ˈbaɪfərkeɪt/; [or]gre3k;
faze: [v]打扰,折磨,使狼狈,使担忧; [acc]/feɪz/; [or]gre3k;
panache: n. 羽饰,神气十足; [acc]/pəˈnæʃ/; [or]gre3k;
emboss: [v]加浮雕花纹于;使凸出;装饰; [acc]/ɪmˈbɔːs/; [or]gre3k;
aggrieve: [v]使悲痛;冒犯;侵害.的合法权利; [acc]/ə'griːv/; [or]gre3k;
explicate: [v]详细解说; [acc]/ˈeksplɪkeɪt/; [or]gre3k;
obfuscate: [v]使复杂;使迷乱,使模糊;弄暗; [acc]/ˈɑːbfʌskeɪt/; [or]gre3k;
plagiarize: [v]剽窃,抄袭(别人学说,著作); [acc]/ˈpleɪdʒəraɪz/; [or]gre3k;
moratorium: n. 暂停,中止;[金融]延期偿付; [acc]/ˌmɔːrəˈtɔːriəm/; [or]gre3k;
cavort: [v]欢快地蹦跳或行走,雀跃; [acc]/kəˈvɔːrt/; [or]gre3k;
hodgepodge: n. 大杂烩,混煮,一团糟; [acc]/ˈhɑːdʒpɑːdʒ/; [or]gre3k;
tangy: [adj]扑鼻的,有刺激性的,强烈的; [acc]/ˈtæŋi/; [or]gre3k;
rarefy: [v]变稀薄;使(人格,精神等)纯洁;精炼; [acc]/'rerəˌfaɪ/; [or]gre3k;
constrict: [v]约束,收缩,妨碍; [acc]/kənˈstrɪkt/; [or]gre3k;
minutia: n. 次要的细节,小事; [acc]/mɪ'njuːʃɪə/; [or]gre3k;
teeter: [v]使..摇摆;使..上下晃动;蹒跚; n. 跷跷板;摇摆; [acc]/ˈtiːtər/; [or]gre3k;
rookie: n. 新手,新兵,新球员; [acc]/ˈrʊki/; [or]gre3k;
incubate: [v]孵卵; [acc]/ˈɪŋkjubeɪt/; [or]gre3k;
cadge: [v]行乞,乞求,贩卖; [acc]/kædʒ/; [or]gre3k;
jingoist: n. 沙文主义者,侵略主义者; [acc]/dʒɪŋɡə'ʊɪst/; [or]gre3k;
svelte: [adj]体态苗条的;线条清晰的; [acc]/svelt/; [or]gre3k;
pulchritude: n. 漂亮,标致; [acc]/ˈpʌlkrɪtjuːd/; [or]gre3k;
emaciate: [v]使消瘦,使衰弱,使贫瘠; [acc]/ɪ'meɪʃɪˌeɪt/; [or]gre3k;
hubris: n. 傲慢;狂妄自大; [acc]/ˈhjuːbrɪs/; [or]gre3k;
lackluster: n. 无光泽;暗淡; [adj]无光泽的;平凡的; [acc]/ˈlækˌlʌstər/; [or]gre3k;
stasis: n. 平衡,停滞; [acc]/ˈsteɪsɪs/; [or]gre3k;
accrete: [v]逐渐增长,依附,合生,连接; [adj]合生的,增积的; [acc]/ə'kriːt/; [or]gre3k;
excoriate: [v]严厉批评,擦伤(皮肤等); [acc]/ˌeksˈkɔːrieɪt/; [or]gre3k;
forebear: n. 祖先,祖宗; [v]忍住; [acc]/ˈfɔːrber/; [or]gre3k;
beige: n. 米黄色; [adj]浅褐色的,米黄色的; [acc]/beɪʒ/; [or]gre3k;
proponent: n. 支持者;提议者;主张者;提出认证遗嘱者; [adj]建议的;支持的;辩护的; [acc]/prəˈpoʊnənt/; [or]gre3k;
lionize: [v]崇拜,把..奉为名人; [acc]/ˈlaɪənaɪz/; [or]gre3k;
intransigent: [adj]固执的,不妥协的,不让步的; n. 不妥协,不妥协的人; [acc]/ɪnˈtrænzɪdʒənt/; [or]gre3k;
bask: [vi]晒太阳(享受温暖),感到温暖,愉快或舒适; n. 晒太阳,取暖;沉浸于; [acc]/bæsk/; [or]gre3k;
predestine: [v]注定; [acc]/priː'destɪn/; [or]gre3k;
acclimate: [v]服水土,适应新环境; [acc]/ˈækləmeɪt/; [or]gre3k;
embed: [v]把.嵌入;使嵌入; [acc]/ɪmˈbed/; [or]gre3k;
self-abasement: n. 自卑,自谦; [acc]/ˌselfə'beɪsmənt/; [or]gre3k;
expurgate: [v]净化,删去; [acc]/ˈekspərɡeɪt/; [or]gre3k;
lambaste: [v]痛打;痛骂;严责; [acc]/læmˈbæst/; [or]gre3k;
placebo: n. 安慰剂;为死者所诵的晚祷词; [acc]/pləˈsiːboʊ/; [or]gre3k;
decode: [v]译解;解码; [acc]/ˌdiːˈkoʊd/; [or]gre3k;
tycoon: n. 有钱有势的企业家,大亨; [acc]/taɪˈkuːn/; [or]gre3k;
collude: [v]串通,共谋; [acc]/kəˈluːd/; [or]gre3k;
escalate: [v]逐步升高,逐步增强,加剧恶化; [acc]/ˈeskəleɪt/; [or]gre3k;
rambunctious: [adj]喧闹的;难控制的;粗暴的;骚乱的; [acc]/ræmˈbʌŋkʃəs/; [or]gre3k;
symbiosis: n. 共生,共栖; [acc]/ˌsɪmbɪˈoʊsɪs/; [or]gre3k;
analgesic: n. 镇痛药; [adj]止痛的; [acc]/ˌænəlˈdʒiːzɪk/; [or]gre3k;
preempt: [v]制止,以先买权取得,取代; n. 〔经〕优先占有; [acc]/priː'empt/; [or]gre3k;
primp: [v]精心打扮;装饰; [acc]/prɪmp/; [or]gre3k;
repatriate: [v]遣返; n. 被遣返回国者; [acc]/ˌriːˈpeɪtrieɪt/; [or]gre3k;
footloose: [adj]自由自在的,无拘束的,到处走动的; [acc]/ˈfʊtluːs/; [or]gre3k;
draconian: [adj]严峻的,苛刻的; [acc]/drəˈkoʊniən/; [or]gre3k;
scads: n. 大量,巨额; [acc]/skædz/; [or]gre3k;
dilapidate: [v]毁坏,荒废,浪费; [acc]/də'læpəˌdeɪt/; [or]gre3k;
divestiture: n. 剥夺,脱衣,拆分; [acc]/də'vestətʃə/; [or]gre3k;
deadpan: [adj]面无表情的; [adv]面无表情地; [acc]/ˈdedpæn/; [or]gre3k;
proliferate: [v]激增,繁殖,增殖; [acc]/prəˈlɪfəreɪt/; [or]gre3k;
ingest: [v]咽下;摄取;吸收;接待; [acc]/ɪnˈdʒest/; [or]gre3k;
pandemic: [adj]全国流行的;普遍的; [acc]/pænˈdemɪk/; [or]gre3k;
denigrate: [v]抹黑,贬低; [acc]/ˈdenɪɡreɪt/; [or]gre3k;
ambivalent: [adj]矛盾的;摇摆不定的;好恶相克的; n. 两性人; [acc]/æmˈbɪvələnt/; [or]gre3k;
underdog: n. 弱势的一方,受害者,输家; [acc]/ˈʌndərdɔːɡ/; [or]gre3k;
desiccate: [v](使)完全干涸,脱水; [acc]/'desɪˌkeɪt/; [or]gre3k;
incinerate: [v]焚化,毁弃; [acc]/ɪnˈsɪnəreɪt/; [or]gre3k;
defuse: [vi]平息,变弱; [vt]拆除;使消除危险性,平息; [acc]/ˌdiːˈfjuːz/; [or]gre3k;
stonewall: [v]阻碍议事,妨碍; [acc]/ˈstoʊnwɔːl/; [or]gre3k;
sequela: n. [医]后遗症,结果,后继者; [acc]/sɪ'kwiːlə/; [or]gre3k;
imprecise: [adj]不精确的,不严密的; [acc]/ˌɪmprɪˈsaɪs/; [or]gre3k;
calibrate: [vt]测定(或测量).的口径;校准(或校正);调整; [acc]/ˈkælɪbreɪt/; [or]gre3k;
charisma: n. 魅力; [acc]/kəˈrɪzmə/; [or]gre3k;
malinger: [v]装病以逃避工作; [acc]/məˈlɪŋɡər/; [or]gre3k;
backfire: [v]放出逆火,产生出乎意料及事与愿违的结果; n. 逆火;后爆的巨大响声; [acc]/ˌbækˈfaɪər/; [or]gre3k;
dehydrate: [v]除去水份,脱水; [acc]/diːˈhaɪdreɪt/; [or]gre3k;
replicate: [v]复制;重复,反复; [acc]/ˈreplɪkeɪt/; [or]gre3k;
counterproductive: [adj]反效果的,阻碍预期目标的; [acc]/ˌkaʊntərprəˈdʌktɪv/; [or]gre3k;
cronyism: n. 任人唯亲;任用亲信; [acc]/ˈkroʊniɪzəm/; [or]gre3k;
gaffe: n. (社交上令人不快的)失言,失态,失礼; [acc]/ɡæf/; [or]gre3k;
concatenate: [v]连结,连锁; [adj]连结的;连锁的; [acc]/kɑnˈkæt(ə)ˌneɪt/; [or]gre3k;
foolproof: [adj]万无一失的,简单的,肯定成功的; [acc]/ˈfuːlpruːf/; [or]gre3k;
offbeat: [adj]离奇的;标新立异的;[乐]弱拍的;离奇的;标新立异的; [acc]/ˌɔːfˈbiːt/; [or]gre3k;
discombobulate: [vt]使混乱,使困惑,挫败; [acc]/ˌdɪskəmˈbɑːbjuleɪt/; [or]gre3k;
stymie: [v]从中作梗,阻挠;妨碍; n. 妨碍球; [acc]/ˈstaɪmi/; [or]gre3k;
serendipity: n. 机缘巧合; [acc]/ˌserənˈdɪpəti/; [or]gre3k;
labile: [adj]易变化的,不稳定的,不安定; n. 心境不定; [acc]/'leɪbəl/; [or]gre3k;
conflate: [v]合并; [acc]/kənˈfleɪt/; [or]gre3k;
extrapolate: [v]进行推断; [acc]/ɪkˈstræpəleɪt/; [or]gre3k;
smarmy: [adj]迎奉的,讨好的; [acc]/ˈsmɑːrmi/; [or]gre3k;
spindly: [adj]细长的;纺锤形的; [acc]/ˈspɪndli/; [or]gre3k;
correlate: [v](使)相关联; n. 相关物; [acc]/ˈkɔːrələt/; [or]gre3k;
fail-safe: n. 保险措施; [adj]万无一失的; [acc]/ˈfeɪl seɪf/; [or]gre3k;
faultfinder: n. 吹毛求疵的人; [acc]/fɔːlt'faɪndə/; [or]gre3k;
interlock: [v]连锁,连串; n. 〔电信〕结合;联锁装置;相关;联动; [acc]/ˌɪntərˈlɑːk/; [or]gre3k;
fluky: [adj]侥幸的,偶然的; [acc]/ˈfluːki/; [or]gre3k;
misrepresent: [vi]作虚假陈述; [vt]歪曲;误传; [acc]/ˌmɪsˌreprɪˈzent/; [or]gre3k;
reverberate: [v]弹回,起回声,使回荡在; [acc]/rɪˈvɜːrbəreɪt/; [or]gre3k;
nicety: n. 细节,讲究; [acc]/ˈnaɪsəti/; [or]gre3k;
retrench: [v]节省,削减;紧缩; [acc]/rɪˈtrentʃ/; [or]gre3k;
skirmish: n. 小战役,小争吵; [v]卷入战役(争论),搜索; [acc]/ˈskɜːrmɪʃ/; [or]gre3k;
dissect: [v]解剖(动植物等);仔细研究;切开; [acc]/dɪˈsekt/; [or]gre3k;
valediction: n. 告别演说;告别词; [acc]/ˌvælɪˈdɪkʃn/; [or]gre3k;
excavate: [v]挖掘,挖出;挖(空),挖(洞); [acc]/ˈekskəveɪt/; [or]gre3k;
hortative: [adj]激励的; [acc]/'hɔːtətɪv/; [or]gre3k;
revelry: n. 狂欢;欢宴; [acc]/ˈrevlri/; [or]gre3k;
stricture: n. 谴责;严厉;束缚; [acc]/ˈstrɪktʃər/; [or]gre3k;
serried: [adj]密集的;林立的; [acc]/ˈserid/; [or]gre3k;
censorious: [adj]爱挑剔的,吹毛求疵的,严厉批评的; [acc]/senˈsɔːriəs/; [or]gre3k;
exhilarate: [v]使高兴;使兴奋; [adj]使人高兴的,令人兴奋的; [acc]/ɪɡˈzɪləreɪt/; [or]gre3k;
stipple: [v]点画,点描; [acc]/ˈstɪpl/; [or]gre3k;
drench: [v]使淋透;使湿透; n. 淋透;雨淋;浸渍液;(制革时浸泡熟皮的)脱灰水; [acc]/drentʃ/; [or]gre3k;
nitpick: [v]挑剔,吹毛求疵; [acc]/'nɪtpɪk/; [or]gre3k;
grueling: n. 惩罚,劳累; [adj]累垮人的,折磨人的; [acc]/'gruːəlɪŋ/; [or]gre3k;
bruit: [v](未经证实地)散播消息; n. 谣传; [acc]/bruːt/; [or]gre3k;
categorical: [adj]绝对的;直接了当的;无条件的;属于某一范畴的; [acc]/ˌkætəˈɡɔːrɪkl/; [or]gre3k;
offish: [adj]冷淡的,疏远的; [acc]/'ɔːfɪʃ/; [or]gre3k;
disinfect: [v]消毒; [acc]/ˌdɪsɪnˈfekt/; [or]gre3k;
quarantine: [v]检疫;隔离;使隔离; n. 检疫;隔离;检疫期;封锁; [acc]/ˈkwɔːrəntiːn/; [or]gre3k;
rickety: [adj]佝偻病的;摇晃的;蹒跚的;不结实的; [acc]/ˈrɪkəti/; [or]gre3k;
veracious: [adj]诚实的,说真话的; [acc]/və'reɪʃəs/; [or]gre3k;
retouch: n. 润饰;修整部分; [vt]润饰;修整; [vi]润饰;修整; [acc]/ˌriːˈtʌtʃ/; [or]gre3k;
nonentity: n. 不存在,虚无;无能力之人,无足轻重的人; [acc]/nɑːˈnentəti/; [or]gre3k;
extol: [v]赞美,称赞,颂扬; [acc]/ɪkˈstoʊl/; [or]gre3k;
riveting: [adj]非常精彩的; n. 铆接(法; [acc]/ˈrɪvɪtɪŋ/; [or]gre3k;
carefree: [adj]无忧无虑的,轻松愉快的;不负责的; [acc]/ˈkerfriː/; [or]gre3k;
reassure: [v]使放心,使消除疑虑; [acc]/ˌriːəˈʃʊr/; [or]gre3k;
cramped: [adj]狭窄的,挤在一起的; [acc]/kræmpt/; [or]gre3k;
rostrum: n. 讲坛,讲台; [acc]/ˈrɑːstrəm/; [or]gre3k;
stratify: [v]分层,成层,阶层化; [acc]/ˈstrætɪfaɪ/; [or]gre3k;
discommode: [v]使不方便,使为难,使不自由; [acc]/ˌdɪskə'moʊd/; [or]gre3k;
mannered: [adj]装模作样的,矫揉造作的,墨守成规的,中规中矩的; [acc]/ˈmænərd/; [or]gre3k;
discompose: [v]使失态,使烦恼,慌张; [acc]/ˌdɪskəmˈpoʊz/; [or]gre3k;
condole: [v]慰问,哀悼; [acc]/kən'doʊl/; [or]gre3k;
dolorous: [adj]忧伤的,悲痛的; [acc]/ˈdoʊlərəs/; [or]gre3k;
rumple: [v]弄皱;弄得乱七八糟; n. 皱褶;皱纹; [acc]/ˈrʌmpl/; [or]gre3k;
buttress: n. 扶墙,拱壁; [v]支持; [acc]/ˈbʌtrəs/; [or]gre3k;
misbehaving: [adj]调皮的,行为不端的; [acc]/ˌmɪsbɪˈheɪvɪŋ/; [or]gre3k;
fateful: [adj]重大的;决定性的;宿命的; [acc]/ˈfeɪtfl/; [or]gre3k;
licentious: [adj]纵欲的,放肆的; [acc]/laɪˈsenʃəs/; [or]gre3k;
cherished: [adj]受喜爱的,珍爱的; [acc]/ˈtʃerɪʃt/; [or]gre3k;
misapprehension: n. 错误的理解,错误的判断; [acc]/ˌmɪsæprɪˈhenʃn/; [or]gre3k;
synchronous: [adj]同时的,[物]同步的; [acc]/ˈsɪŋkrənəs/; [or]gre3k;
embroider: [v]刺绣,绣花;润色,渲染; [acc]/ɪmˈbrɔɪdər/; [or]gre3k;
churl: n. 吝啬鬼,乡下人,粗暴的人; [acc]/tʃɜːrl/; [or]gre3k;
off-key: [adj]不和谐的;走音的;不恰当的; [acc]/ˌɔːf ˈkiː/; [or]gre3k;
resurgence: n. 复活;再现;再起; [acc]/rɪˈsɜːrdʒəns/; [or]gre3k;
dispassionate: [adj]平心静气的,不带感情的; [acc]/dɪsˈpæʃənət/; [or]gre3k;
arresting: [adj]引人注目的,醒目的,有趣的; [acc]/əˈrestɪŋ/; [or]gre3k;
prowess: n. 勇敢,不凡的能力;超凡技术; [acc]/ˈpraʊəs/; [or]gre3k;
exult: [v]狂喜,欢欣鼓舞; [acc]/ɪɡˈzʌlt/; [or]gre3k;
prepossessing: [adj]给人好感的;有魅力的;引人注意的; [acc]/ˌpriːpəˈzesɪŋ/; [or]gre3k;
vituperate: [v]痛斥,辱骂; [acc]/vaɪ'tjuːpəˌreɪt/; [or]gre3k;
debark: [v]下船,登陆; [acc]/dɪ'bɑːk/; [or]gre3k;
wizen: [v](使)凋谢,(使)枯萎; [adj]凋谢的,枯萎的; [acc]/'wɪzən/; [or]gre3k;
irrigate: [v]灌溉,冲洗; [acc]/ˈɪrɪɡeɪt/; [or]gre3k;
substantiate: [v]证实;使实体化; [acc]/səbˈstænʃieɪt/; [or]gre3k;
subsidy: n. 补助金,津贴; [acc]/ˈsʌbsədi/; [or]gre3k;
voyeur: n. 窥淫狂者,窥隐私者; [acc]/vwaɪˈɜːr/; [or]gre3k;
teetotalism: n. 禁酒; [acc]/ˌtiːˈtoʊtəlɪzəm/; [or]gre3k;
votary: n. 崇拜者,热心支持者; [acc]/ˈvoʊtəri/; [or]gre3k;
privation: n. 缺乏,贫困,丧失,被剥夺了某物的状态; [acc]/praɪˈveɪʃn/; [or]gre3k;
supine: [adj]仰卧的;懒散的;向后靠的; [acc]/ˈsuːpaɪn/; [or]gre3k;
surcharge: n. 额外费用,过高的要价; [v]追加罚款;使.装载过多;使.负担过重; [acc]/ˈsɜːrtʃɑːrdʒ/; [or]gre3k;
ubiquitous: [adj]普遍存在的;无所不在的; [acc]/juːˈbɪkwɪtəs/; [or]gre3k;
polarize: [v](使)极化,(使)偏振,(使)两极分化; [acc]/ˈpoʊləraɪz/; [or]gre3k;
supplicate: [v]恳求,乞求; [acc]/'sʌplɪˌkeɪt/; [or]gre3k;
cloudburst: n. 大暴雨,豪雨; [acc]/ˈklaʊdbɜːrst/; [or]gre3k;
raspy: [adj]声音沙哑的,容易生气的; [acc]/ˈræspi/; [or]gre3k;
slovenly: [adj]不整洁的,马虎的; [acc]/ˈslʌvnli/; [or]gre3k;
authentic: [adj]真实的;真正的;可靠的; [acc]/ɔːˈθentɪk/; [or]gre3k;
illuminate: [vt]照亮;阐释;说明; [acc]/ɪˈluːmɪneɪt/; [or]gre3k;
impenitent: [adj]不悔悟的; [acc]/ɪmˈpenɪtənt/; [or]gre3k;
implode: [vi]内向爆炸,内向崩溃; [vt]使爆裂; [acc]/ɪmˈploʊd/; [or]gre3k;
tentative: [adj]试探性的;不确定的;暂时的;犹豫不决的; [acc]/ˈtentətɪv/; [or]gre3k;
savant: n. 博学之士,大学士; [acc]/sæˈvɑːnt/; [or]gre3k;
sweltering: [adj]酷热的; [acc]/ˈsweltərɪŋ/; [or]gre3k;
fretful: [adj]烦躁的,焦躁的,(水面)起波纹的; [acc]/ˈfretfl/; [or]gre3k;
friable: [adj]易碎的;脆的; [acc]/ˈfraɪəbl/; [or]gre3k;
loutish: [adj]粗野的,笨拙的,无礼的; [acc]/ˈlaʊtɪʃ/; [or]gre3k;
aseptic: [adj]无菌的,洁净的; [acc]/ˌeɪˈseptɪk/; [or]gre3k;
snobbish: [adj]自命不凡的,势利的; [acc]/ˈsnɑːbɪʃ/; [or]gre3k;
asperity: n. (表面的)粗糙;(气候等的)严酷;艰苦的条件;(性格)粗暴; [acc]/æˈsperəti/; [or]gre3k;
coltish: [adj]放浪不拘的,似小马的; [acc]/ˈkoʊltɪʃ/; [or]gre3k;
full-bodied: [adj]浓郁的,意味深长的;魁梧的,躯体大的; [acc]/ˌfʊl ˈbɑːdid/; [or]gre3k;
commodious: [adj]宽敞的; [acc]/kəˈmoʊdiəs/; [or]gre3k;
willful: [adj]有意的,任性的,故意的; [acc]/ˈwɪlfl/; [or]gre3k;
implement: n. 工具;器具; [v]实施,执行;执行; [acc]/ˈɪmplɪment/; [or]gre3k;
protract: [v]绘制;延长;伸展; [acc]/proʊ'trækt/; [or]gre3k;
indulgent: [adj]放纵的;宽容的;任性的; [acc]/ɪnˈdʌldʒənt/; [or]gre3k;
complaisance: n. 迁就,奉承,彬彬有礼; [acc]/kəmˈpleɪzəns/; [or]gre3k;
dissension: n. 意见分歧;纷争;倾轧; [acc]/dɪˈsenʃn/; [or]gre3k;
provident: [adj]节俭的,深谋远虑的,顾及未来的; [acc]/ˈprɑːvɪdənt/; [or]gre3k;
tatty: [adj]不整洁的;不值钱的;简陋的; [acc]/ˈtæti/; [or]gre3k;
stamina: n. 耐力,持久力; [acc]/ˈstæmɪnə/; [or]gre3k;
stammer: [v]口吃,结巴着说出; n. 口吃; [acc]/ˈstæmər/; [or]gre3k;
fitful: [adj]发作的,间歇的,不定的; [acc]/ˈfɪtfl/; [or]gre3k;
unassailable: [adj]无可争辩的,无懈可击的,不可亵渎的; [acc]/ˌʌnəˈseɪləbl/; [or]gre3k;
inclement: [adj]险恶的;气候严酷的;狂风暴雨的; [acc]/ɪnˈklemənt/; [or]gre3k;
figment: n. 空想;虚构的理论,故事等; [acc]/ˈfɪɡmənt/; [or]gre3k;
fanatic: n. 狂热者,盲信者; [adj]狂热的,入迷的,盲信的; [acc]/fəˈnætɪk/; [or]gre3k;
ceremonious: [adj]隆重的;讲究仪式的;正式的; [acc]/ˌserəˈmoʊniəs/; [or]gre3k;
seamy: [adj]丑恶的,露出线缝的; [acc]/ˈsiːmi/; [or]gre3k;
concerted: [adj]一致的,商定的; [acc]/kənˈsɜːrtɪd/; [or]gre3k;
superimpose: [v]添加;重叠;附加;安装; [acc]/ˌsuːpərɪmˈpoʊz/; [or]gre3k;
pucker: [v]折叠;缩拢;皱起; [acc]/ˈpʌkər/; [or]gre3k;
deploy: [v]部署,设置;展开,散开; [acc]/dɪˈplɔɪ/; [or]gre3k;
smother: [v]窒息; [acc]/ˈsmʌðər/; [or]gre3k;
attune: [v]使协调,为.调音; [acc]/ə'tjuːn/; [or]gre3k;
maladroit: [adj]笨拙的; [acc]/ˌmæləˈdrɔɪt/; [or]gre3k;
overwrought: [adj]过分紧张的,过度兴奋的; [acc]/ˌoʊvərˈrɔːt/; [or]gre3k;
timid: [adj]胆怯的;腼腆的; [acc]/ˈtɪmɪd/; [or]gre3k;
eclat: n. 辉煌成就,喝采; [acc]/eɪ'klaː/; [or]gre3k;
zesty: [adj]刺激的,开胃的; [acc]/ˈzesti/; [or]gre3k;
wiretap: n. 窃听装置;窃听; [v]偷听,窃听; [acc]/ˈwaɪərtæp/; [or]gre3k;
feisty: [adj]好斗的,好争论的;活跃的,充满生气的;烦躁不安的,坐立不安的; [acc]/ˈfaɪsti/; [or]gre3k;
immemorial: [adj]太古的,极古的; [acc]/ˌɪməˈmɔːriəl/; [or]gre3k;
provisory: [adj]有附带条件的,临时的; [acc]/prə'vaɪzərɪ/; [or]gre3k;
inventory: n. 详细目录;存货清单; [acc]/ˈɪnvəntɔːri/; [or]gre3k;
sparing: [adj]节省的,节制的,少量使用的,保守的; [acc]/ˈsperɪŋ/; [or]gre3k;
amity: n. 友好,亲善关系,友好关系; [acc]/ˈæməti/; [or]gre3k;
euphoria: n. 幸福愉快感; [acc]/juːˈfɔːriə/; [or]gre3k;
canonize: [v]使加入圣徒之列,推崇,褒扬,将.封为圣徒; [acc]/ˈkænənaɪz/; [or]gre3k;
ration: n. 定量配给; [v]配给;定量供应; [acc]/ˈræʃn/; [or]gre3k;
remodel: [vt]重塑;改造,重建; [acc]/ˌriːˈmɑːdl/; [or]gre3k;
featureless: [adj]缺乏特征的,没有标记的; [acc]/ˈfiːtʃərləs/; [or]gre3k;
baffling: [adj]令人困惑的; [v]使困难,使为难; [acc]/ˈbæflɪŋ/; [or]gre3k;
splutter: n. 劈啪声,急忙说出的话,杂乱的声音; [v]喷溅,气急败坏地说; [acc]/ˈsplʌtər/; [or]gre3k;
convalesce: [v]渐愈,渐渐康复; [acc]/ˌkɑːnvəˈles/; [or]gre3k;
misgiving: n. 疑虑; [vt]担忧;使.疑虑;害怕(misgive的变形); [acc]/ˌmɪsˈɡɪvɪŋ/; [or]gre3k;
convoke: [v]召集会议; [acc]/kənˈvoʊk/; [or]gre3k;
indecorous: [adj]不合乎礼节的,不得体的; [acc]/ɪnˈdekərəs/; [or]gre3k;
sere: [adj]干枯的,凋萎的; [acc]/sɪr/; [or]gre3k;
indoctrinate: [v]灌输思想; [acc]/ɪnˈdɑːktrɪneɪt/; [or]gre3k;
montage: n. 蒙太奇(电影的基本结构手段和叙事方式),混合画,拼集的照片; [acc]/ˌmɑːnˈtɑːʒ/; [or]gre3k;
ascendant: n. 优势,支配地位; [adj]上升的,优越的; [acc]/əˈsendənt/; [or]gre3k;
smuggling: n. 走私; [v]走私; [acc]/ˈsmʌɡlɪŋ/; [or]gre3k;
ingratiating: [adj]讨好的,谄媚的; [acc]/ɪnˈɡreɪʃieɪtɪŋ/; [or]gre3k;
willy-nilly: [adj]犹豫不决的,不容分辨的,随意的; [adv]乱七八糟地,不管愿不愿意地; [acc]/ˌwɪli ˈnɪli/; [or]gre3k;
shiftless: [adj]没有决断力的;无计谋的;偷懒的; [acc]/ˈʃɪftləs/; [or]gre3k;
dependable: [adj]可靠的;可信赖的; [acc]/dɪˈpendəbl/; [or]gre3k;
frosty: [adj]结霜的,严寒的;冷淡的;灰白的; [acc]/ˈfrɔːsti/; [or]gre3k;
diverge: [v]分歧,分开; [acc]/daɪˈvɜːrdʒ/; [or]gre3k;
zealot: n. 狂热份子,犹太教狂热信徒; [acc]/ˈzelət/; [or]gre3k;
unflappable: [adj]镇定自若的;从容不迫的; [acc]/ˌʌnˈflæpəbl/; [or]gre3k;
warmonger: n. 战争贩子,好战者; [acc]/ˈwɔːrmʌŋɡər/; [or]gre3k;
epicure: n. 美食家;享乐主义者; [acc]/ˈepɪkjʊr/; [or]gre3k;
epigram: n. 机智的言语; [acc]/ˈepɪɡræm/; [or]gre3k;
crave: [v]渴望;恳求; [acc]/kreɪv/; [or]gre3k;
delusion: n. 错觉; [acc]/dɪˈluːʒn/; [or]gre3k;
grisly: [adj]恐怖的;令人震惊的;厉害的; [acc]/ˈɡrɪzli/; [or]gre3k;
equable: [adj]温和,平均,稳定的,不变的,(脾气)温和的; [acc]/ˈekwəbl/; [or]gre3k;
intemperate: [adj]放纵的;酗酒的;酷烈的; [acc]/ɪnˈtempərət/; [or]gre3k;
replenish: [v]补充,再装满;把.装满;给.添加燃料; [acc]/rɪˈplenɪʃ/; [or]gre3k;
sodden: [adj]浑身湿透的;浸透的;浸过酒的; [acc]/ˈsɑːdn/; [or]gre3k;
estimable: [adj]可估计的;可尊敬的;有价值的; [acc]/ˈestɪməbl/; [or]gre3k;
figurine: n. 小塑像,小雕像; [acc]/ˌfɪɡjəˈriːn/; [or]gre3k;
susceptibility: n. 易感性的,敏感性,感情; [acc]/səˌseptəˈbɪləti/; [or]gre3k;
servile: [adj]奴颜婢膝的,卑屈的,隶属的; n. 奴隶; [acc]/ˈsɜːrvl/; [or]gre3k;
blase: [adj]玩厌了的,厌烦于享乐的; [acc]/blɑːˈzeɪ/; [or]gre3k;
tranquility: n. 安静,平静; [acc]/træŋ'kwɪlətɪ/; [or]gre3k;
mockery: n. 嘲弄;笑柄;徒劳无功;拙劣可笑的模仿或歪曲; [acc]/ˈmɑːkəri/; [or]gre3k;
limber: [adj]松软的,柔软的;可塑的; n. (炮车的)拖车; [acc]/ˈlɪmbər/; [or]gre3k;
rehabilitate: [v]使康复,使恢复名誉,使恢复原状; [acc]/ˌriːəˈbɪlɪteɪt/; [or]gre3k;
bungle: [v]办糟,失败; n. 粗劣,失败,笨拙; [acc]/ˈbʌŋɡl/; [or]gre3k;
anemic: [adj]贫血的,缺乏力量,活力,精神的; [acc]/ə'niːmɪk/; [or]gre3k;
evanescent: [adj]短暂的,容易消散的,(印象等)逐渐消失的,会凋零的; [acc]/ˌevəˈnesnt/; [or]gre3k;
intoxicant: [adj]醉人的,麻醉的,沉醉的; n. 酒精饮料,麻醉品; [acc]/ɪnˈtɑːksɪkənt/; [or]gre3k;
diehard: n. 顽固分子,保守分子; [adj]顽固的,执拗的; [acc]/ˈdaɪhɑːrd/; [or]gre3k;
reconstitute: [v]重新设立,重新组成; [acc]/ˌriːˈkɑːnstətuːt/; [or]gre3k;
somnolence: n. 困倦;想睡;嗜眠症; [acc]/ˈsɑːmnələns/; [or]gre3k;
plenitude: n. 充分;丰富;大量; [acc]/ˈplenɪtuːd/; [or]gre3k;
mollycoddle: [v]溺爱,娇惯; n. 娇生惯养的人; [acc]/ˈmɑːlikɑːdl/; [or]gre3k;
arrhythmic: [adj]无节奏的;心律不齐的; [acc]/əˈrɪθmɪk/; [or]gre3k;
catalyze: [v]催化;刺激,促进; [acc]/'kætəˌlaɪz/; [or]gre3k;
metaphysical: [adj]形而上学的;超自然的;玄学派诗歌的; [acc]/ˌmetəˈfɪzɪkl/; [or]gre3k;
resplendent: [adj]华丽的,辉煌的; [acc]/rɪˈsplendənt/; [or]gre3k;
preposterous: [adj]荒谬的,可笑的; [acc]/prɪˈpɑːstərəs/; [or]gre3k;
hard-bitten: [adj]顽强的;不屈服的; [acc]/ˌhɑːrd ˈbɪtn/; [or]gre3k;
turgid: [adj]肿胀的;浮夸的;浮肿的; [acc]/ˈtɜːrdʒɪd/; [or]gre3k;
respire: [v]呼吸; [acc]/rɪˈspaɪər/; [or]gre3k;
renovate: [v]更新,修复; [adj]恢复的,革新的,翻新的; [acc]/ˈrenəveɪt/; [or]gre3k;
blandishment: n. 甜言蜜语,奉承;谄媚;哄诱; [acc]/ˈblændɪʃmənt/; [or]gre3k;
bracing: [adj]振奋精神的; [acc]/ˈbreɪsɪŋ/; [or]gre3k;
smattering: n. 浅薄的知识,少量; [adj]肤浅的;些许的;点滴的; [acc]/ˈsmætərɪŋ/; [or]gre3k;
ductile: [adj](某些金属)有延展性的;可塑的;易受影响的; [acc]/ˈdʌktaɪl/; [or]gre3k;
cliche: n. 陈腐思想,陈词滥调; [adj]陈腐的; [acc]/klɪˈʃeɪ/; [or]gre3k;
execrate: [v]谴责,痛恨; [acc]/'eksɪˌkreɪt/; [or]gre3k;
fluctuate: [v]波动;起伏;涨落; [acc]/ˈflʌktʃueɪt/; [or]gre3k;
debunk: [v]揭穿真面目,证明为假; [acc]/ˌdiːˈbʌŋk/; [or]gre3k;
requite: [v]报答,酬谢,回报,补偿;报复; [acc]/rɪˈkwaɪt/; [or]gre3k;
mangle: [v]损毁,使伤残,弄砸; n. 轧布机; [acc]/ˈmæŋɡl/; [or]gre3k;
mutate: [v]变异; [acc]/ˈmjuːteɪt/; [or]gre3k;
detour: n. 弯路,绕行之路; [v]绕道,迂回; [acc]/ˈdiːtʊr/; [or]gre3k;
retentive: [adj]保持的;吸(水)的; [adv]有记性地,记性强地; n. 保持力;〈物〉顽磁性; [acc]/rɪˈtentɪv/; [or]gre3k;
chauvinistic: [adj]盲目爱国的;大男子主义的; [acc]/ˌʃoʊvɪˈnɪstɪk/; [or]gre3k;
beneficent: [adj]慈善的;善行的; [acc]/bɪˈnefɪsnt/; [or]gre3k;
clarion: n. 号角; [adj]清澈响亮的; [acc]/'klærɪən/; [or]gre3k;
padding: n. 衬垫,填料;夸张;废话; [v]给.装衬垫,加垫子; [acc]/ˈpædɪŋ/; [or]gre3k;
remonstrance: n. 抗议,抱怨,谏书; [acc]/rɪˈmɑːnstrəns/; [or]gre3k;
boo: n. 嘘声; [v]嘘(以表示不满或嘲笑); [acc]/buː/; [or]gre3k;
remunerate: [v]酬劳;给与报酬;赔偿; [acc]/rɪˈmjuːnəreɪt/; [or]gre3k;
corrugated: [adj]褶皱的; [acc]/ˈkɔːrəɡeɪtɪd/; [or]gre3k;
extenuate: [v]减轻,低估,为.找借口,使人原谅; [acc]/ɪk'stenjʊˌeɪt/; [or]gre3k;
renege: [v]食言,否认; [acc]/rɪˈniːɡ/; [or]gre3k;
germinate: [v]发芽,发展,生长; [acc]/ˈdʒɜːrmɪneɪt/; [or]gre3k;
contend: [v]争辩;坚决主张;搏斗; [acc]/kənˈtend/; [or]gre3k;
calumniate: [v]诽谤,中伤,诬蔑; [acc]/kə'lʌmnɪˌeɪt/; [or]gre3k;
incriminate: [v]控告,暗示..有罪; [acc]/ɪnˈkrɪmɪneɪt/; [or]gre3k;
pillory: [v]给.上颈手枷;使.惹人嘲笑; n. 示众;颈手枷;使惹人嘲笑; [acc]/ˈpɪləri/; [or]gre3k;
demoralize: [v]使低落,使沮丧;使道德败坏;使士气低落; [acc]/dɪˈmɔːrəlaɪz/; [or]gre3k;
demote: [v]降级,降职; [acc]/ˌdiːˈmoʊt/; [or]gre3k;
outgrowth: n. 结果;副产物;自然的发展;分枝; [acc]/ˈaʊtɡroʊθ/; [or]gre3k;
spendthrift: [adj]挥霍无度的;浪费的; n. 挥霍无度的人;浪费的人; [acc]/ˈspendθrɪft/; [or]gre3k;
acquisitive: [adj]贪得的,物欲重的;可学到的; [acc]/əˈkwɪzətɪv/; [or]gre3k;
earsplitting: [adj]震耳欲聋的; [acc]/'ɪəˌsplɪtɪŋ/; [or]gre3k;
tendentious: [adj]有偏见的,有倾向的;宣传性的; [adv]宣传性地,不公平地,有倾向性地; n. 倾向性小说; [acc]/tenˈdenʃəs/; [or]gre3k;
toy: n. 玩具; [v]不认真考虑,玩弄; [adj]作为玩具的; [acc]/tɔɪ/; [or]gre3k;
scrutable: [adj]可理解的; [acc]/'skruːtəbəl/; [or]gre3k;
exculpate: [v]声明无罪,开脱,使无罪; [acc]/ˈekskʌlpeɪt/; [or]gre3k;
gawky: [adj](举止)笨拙的; n. 笨拙的人; [acc]/ˈɡɔːki/; [or]gre3k;
slew: n. 大量,大批; [v]回转,旋转; [acc]/sluː/; [or]gre3k;
unexceptionable: [adj]无懈可击的,完美无缺的,极好的; [acc]/ˌʌnɪkˈsepʃənəbl/; [or]gre3k;
abnegate: [v]放弃,舍弃,禁忌; [acc]/'æbnɪɡeɪt/; [or]gre3k;
topsy-turvy: [adj]混乱的,不整洁的; n. 颠倒,乱七八糟; [acc]/ˌtɑːpsi ˈtɜːrvi/; [or]gre3k;
timeworn: [adj]陈腐的; [acc]/ˈtaɪmˌwɔrn/; [or]gre3k;
levelheaded: [adj]稳健的,头脑冷静的,明智的; [acc]/'levəl'hedɪd/; [or]gre3k;
disparage: [v]蔑视;贬损; [acc]/dɪˈspærɪdʒ/; [or]gre3k;
balky: [adj]停蹄不前的;倔强的;不愿干的; [acc]/ˈbɔːlki/; [or]gre3k;
opine: [v]以为;想; [acc]/oʊˈpaɪn/; [or]gre3k;
green: [adj]绿色的,青的,草绿色的;缺乏经验的;嫉妒的,眼红的;(赞成)环境保护的;生的,未熟的; n. 绿色;草地,草坪,公共绿地;绿色蔬菜,绿叶蔬菜; [v]使成为绿色,成为绿色,变绿;使..恢复活力; [acc]/ɡriːn/; [or]gre3k;
apoplectic: [adj]中风的,易怒的; n. 中风患者; [acc]/ˌæpəˈplektɪk/; [or]gre3k;
rapscallion: n. 流氓,恶棍; [acc]/ræp'skæljən/; [or]gre3k;
canny: [adj]精明的,谨慎的,节约的; [adv]<苏格兰>仔细地; [acc]/ˈkæni/; [or]gre3k;
behoove: [v]理应,对.有此必要; n. 适宜; [acc]/bɪ'huːv/; [or]gre3k;
imperishable: [adj]不能被摧毁的,不朽的,永恒的; [acc]/ɪmˈperɪʃəbl/; [or]gre3k;
tactless: [adj]不机智的,笨拙的; [adv]粗鲁地,笨拙地,不老练地; n. 粗鲁,笨拙; [acc]/ˈtæktləs/; [or]gre3k;
diplomatic: [adj]外交的,从事外交的;老练的,圆滑的; [acc]/ˌdɪpləˈmætɪk/; [or]gre3k;
asymmetry: n. 不对称,不均匀; [adj]不对称的,不对等的; [acc]/ˌeɪˈsɪmətri/; [or]gre3k;
self-absorbed: [adj]自恋的,自私的; [acc]/ˌself əbˈzɔːrbd/; [or]gre3k;
sop: n. 安慰物,贿赂,回扣; [v]浸湿,湿透; [acc]/sɑːp/; [or]gre3k;
preponderant: [adj]占优势的,压倒性的; [acc]/prɪˈpɑːndərənt/; [or]gre3k;
bedeck: [v]装饰,点缀; [acc]/bɪˈdek/; [or]gre3k;
roisterer: n. 摆架子的人,喝酒喧哗者; [acc]/'rɔɪstərər/; [or]gre3k;
striate: [adj]有条纹的; [v]加条纹,加条; [acc]/'straɪˌeɪt/; [or]gre3k;
scrappy: [adj]好斗的,不连贯的; [acc]/ˈskræpi/; [or]gre3k;
tightfisted: [adj]吝啬的; [acc]/'taɪt'fɪstɪd/; [or]gre3k;
blazon: [v]宣布,装饰; n. 纹章,描绘; [acc]/ˈbleɪzn/; [or]gre3k;
shopworn: [adj]陈旧的; [acc]/ˈʃɑːpwɔːrn/; [or]gre3k;
immanent: [adj]内在的,固有的; n. 天生,固有; [acc]/ˈɪmənənt/; [or]gre3k;
beholden: [adj]蒙恩的,受惠的,感激的,负有义务的,依靠的; [acc]/bɪˈhoʊldən/; [or]gre3k;
goldbrick: n. 懒汉,假金砖,赝品; [v]称病,欺诈,偷懒; [acc]/ˈɡoʊldbrɪk/; [or]gre3k;
deracinate: [v]根除,使孤立; [acc]/ˌdiːˈræsɪneɪt/; [or]gre3k;
bathetic: [adj]平凡的,陈腐的,假装感伤的; [acc]/bə'θetɪk/; [or]gre3k;
apostasy: n. 放弃宗教信仰,变节,背叛; [acc]/əˈpɑːstəsi/; [or]gre3k;
particularize: [v]列举,详细说明; [acc]/pərˈtɪkjələraɪz/; [or]gre3k;
brassy: [adj]似黄铜的,刺耳的,厚脸皮的; n. 铜头高尔夫球棍; [acc]/ˈbræsi/; [or]gre3k;
merited: [adj]应得的,理所当然的; [acc]/ˈmerɪtɪd/; [or]gre3k;
philanthropic: [adj]博爱的,为他人着想的; [acc]/ˌfɪlənˈθrɑːpɪk/; [or]gre3k;
providential: [adj]天佑的;神意的; [acc]/ˌprɑːvɪˈdenʃl/; [or]gre3k;
careworn: [adj]伤心焦虑的;饱经忧患的;疲倦的; [acc]/ˈkerwɔːrn/; [or]gre3k;
runic: [adj]神秘的;古代北欧文字的; n. 古代北欧文字; [acc]/ˈruːnɪk/; [or]gre3k;
dodder: [v]蹒跚,颤巍巍地行进; n. [植]菟丝子; [acc]/ˈdɑdər/; [or]gre3k;
hesitance: n. 犹豫,不情愿; [acc]/'hezətəns/; [or]gre3k;
inveigh: [v]激烈抗议,表示强烈不满;痛骂; [acc]/ɪnˈveɪ/; [or]gre3k;
fusty: [adj]过时的,腐臭的;发霉的; [acc]/ˈfʌsti/; [or]gre3k;
mottle: n. 斑点,杂色,斑驳; [v]使呈杂色,使显得斑驳陆离; [acc]/'mɒtəl/; [or]gre3k;
palter: [v]含糊其词;玩弄;讨价还价,争论不休; [acc]/'pɔːltə/; [or]gre3k;
reprieve: [v]暂缓处罚,免罪,维持运行; n. [法]死缓,缓刑,暂缓; [acc]/rɪˈpriːv/; [or]gre3k;
miniscule: [adj]极小的;草写小字的; n. (中世纪古抄本的)小书写体; [acc]/'mɪnəˌskjuːl/; [or]gre3k;
volition: n. 决定;自主;意志力;下决心;意志力; [acc]/voʊˈlɪʃn/; [or]gre3k;
scuff: [vt]使磨损;践踏;拖着脚走; [vi]磨损;拖着脚走; n. 拖着脚走,磨损,践踏; [acc]/skʌf/; [or]gre3k;
jape: n. 嘲弄;玩笑; [vi]开玩笑; [vt]嘲弄; [acc]/dʒeɪp/; [or]gre3k;
recidivate: [v]回到原先的习惯,尤指重新犯罪; [acc]/rɪ'sɪdəˌveɪt/; [or]gre3k;
ambrosial: [adj](食物或者气味)特别美味的; [acc]/æm'broʊʒɪəl/; [or]gre3k;
taxing: [adj]繁重的,费力的; [acc]/ˈtæksɪŋ/; [or]gre3k;
seemly: [adj]适当的,有礼的,好看的; [adv]适当地; [acc]/ˈsiːmli/; [or]gre3k;
ticklish: [adj]不稳定的;难对付的;易倒的;易痒的;忌讳的; [adv]怕痒地; n. 怕痒,小心处理; [acc]/ˈtɪklɪʃ/; [or]gre3k;
acerbic: [adj]尖刻的;酸涩的心情,心境或者语调,酸涩的; [acc]/əˈsɜːrbɪk/; [or]gre3k;
motile: [adj][生理]能动的,显示活力的; n. 运动型; [acc]/'moʊtɪl/; [or]gre3k;
skittish: [adj]轻佻的;活泼的;胆小的; [acc]/ˈskɪtɪʃ/; [or]gre3k;
raffle: n. 废物;抽彩票; [v]抽彩票; [acc]/ˈræfl/; [or]gre3k;
extemporize: [v]即席演说; [acc]/ɪkˈstempəraɪz/; [or]gre3k;
inculpate: [v]连累;使负罪;控告; [acc]/'ɪnkʌlˌpeɪt/; [or]gre3k;
ossify: [v]硬化,骨化; [acc]/ˈɑːsɪfaɪ/; [or]gre3k;
backslide: [v](情况等)倒退,故态复萌; n. 倒退; [acc]/'bækslaɪd/; [or]gre3k;
jocular: [adj]搞笑的,欢乐的; [acc]/ˈdʒɑːkjələr/; [or]gre3k;
outmaneuver: [v]以计谋胜过;运用策略击败; [acc]/ˌaʊtməˈnuvər/; [or]gre3k;
extort: [vt]敲诈,勒索; [acc]/ɪkˈstɔːrt/; [or]gre3k;
unlettered: [adj]未受教育的,文盲的; [acc]/ˌʌnˈletərd/; [or]gre3k;
fervid: [adj]热的;热心的; [acc]/ˈfɜːrvɪd/; [or]gre3k;
reconvene: [v]重新集合,重新召集; [acc]/ˌriːkənˈviːn/; [or]gre3k;
palpitation: n. [内科]心悸;跳动;颤动; [acc]/ˌpælpə'teɪʃən/; [or]gre3k;
momentum: n. (物理)动量;势头;动力; [acc]/moʊˈmentəm/; [or]gre3k;
resuscitate: [v]使复活,使苏醒,使复兴; [acc]/rɪˈsʌsɪteɪt/; [or]gre3k;
undermine: [v]暗中破坏;逐渐削弱;侵蚀.的基础;在...下挖坑道,从根基处损害; [acc]/ˌʌndərˈmaɪn/; [or]gre3k;
conceal: [v]隐藏,隐瞒,掩盖; [acc]/kənˈsiːl/; [or]gre3k;
gauge: n. 测量仪;尺度,标准; [v]估计,判断;计量; [acc]/ɡeɪdʒ/; [or]gre3k;
marginal: [adj]微小的,不重要的;仅以微弱多数票获胜的; n. (议会或地方委员会的)边缘席位; [acc]/ˈmɑːrdʒɪnl/; [or]gre3k;
requisite: n. 必需品; [adj]需要的,必不可少的,必备的; [acc]/ˈrekwɪzɪt/; [or]gre3k;
groove: n. [建]凹槽;最佳状态;槽;惯例; [v]开槽于;形成沟槽; [acc]/ɡruːv/; [or]gre3k;
lash: [v]鞭打;猛烈抨击;捆绑;摆动;猛击; n. 鞭梢;鞭打; [acc]/læʃ/; [or]gre3k;
intermittent: [adj]断断续续的,间歇的; [acc]/ˌɪntərˈmɪtənt/; [or]gre3k;
proclaim: [v]声明,声称;宣告;表明; [acc]/prəˈkleɪm/; [or]gre3k;
embrace: [v]拥抱;包含;欣然接受,乐意采纳; n. 拥抱;接受;领会; [acc]/ɪmˈbreɪs/; [or]gre3k;
distract: [v]使分心,转移(注意力),分散(思想); [acc]/dɪˈstrækt/; [or]gre3k;
crouch: [v]蹲;弯腰; [acc]/kraʊtʃ/; [or]gre3k;
rein: n. 缰绳; [v]控制; [acc]/reɪn/; [or]gre3k;
versatile: [adj]万能的,综合的,多才多艺的; [acc]/ˈvɜːrsətl/; [or]gre3k;
shrug: n. 耸肩; [v](为表示厌恶,轻漠,冷淡,怀疑等)耸肩;以耸肩表示(厌恶,轻蔑,冷淡,怀疑等); [acc]/ʃrʌɡ/; [or]gre3k;
peel: [v]剥皮,削皮,去壳; n. 果皮,外皮; [acc]/piːl/; [or]gre3k;
insight: n. 深刻的理解,洞察力,见识; [acc]/ˈɪnsaɪt/; [or]gre3k;
integral: [adj](用于构成整体)必需的,不可缺少的,必不可少的;基本的,作为组成部分的,内置的;整体的,完整的; [acc]/ˈɪntɪɡrəl/; [or]gre3k;
carve: [v]雕刻;(把肉等)切成片;开创,开拓; [acc]/kɑːrv/; [or]gre3k;
fracture: n. 骨折;折断;裂口; [v]使折断;使骨折; [acc]/ˈfræktʃər/; [or]gre3k;
stouthearted: [adj]勇敢的; [acc]/ˌstaʊtˈhɑrtəd/; [or]gre3k;
jitters: n. 紧张,激动; [v]紧张不安;使激动;抖动(jitter的三单形式);神经过敏地说; [acc]/ˈdʒɪtərz/; [or]gre3k;
demotion: n. 降级,降职; [acc]/ˌdiːˈmoʊʃn/; [or]gre3k;
piddling: [adj]琐屑的,无用的,不重要的; [acc]/ˈpɪdlɪŋ/; [or]gre3k;
jarring: [adj]剌耳的,震惊的; n. 辗轧声,冲突,震动; [v]受震动而疼痛; [acc]/ˈdʒɑːrɪŋ/; [or]gre3k;
[kk9: 2904个]