bounce: [x] vi. 弹起,蹦跳;  vt. 使弹起;  v. 拒付 (支票);  n. 弹跳,弹力,活力; [acc] /baʊns/;
domestic: [x] adj. 国产的;国内的;家庭的;驯养的;  n. 家仆;家庭纷争; [acc] /dəˈmestɪk/;
guarantee: [x] v. 保证;担保;提供保修;  n. 保证;担保;保修单;保证金; [acc] /ˌɡærənˈtiː/;
mental: [x] adj. 精神的;心理的; [acc] /ˈmentl/;
suicide: [x] n. 自杀;自毁; [acc] /ˈsuːɪsaɪd/;
despise: [x] vt. 轻视,蔑视,看不起; [acc] /dɪˈspaɪz/;
magnet: [x] n. 磁体,磁铁; [acc] /ˈmæɡnət/;
sufficient: [x] adj. 足够的;充分的; [acc] /səˈfɪʃnt/;
vacant: [x] adj. 空的,未被占用的;闲置的;空缺的;茫然的; [acc] /ˈveɪkənt/;
layman: [x] n. 门外汉;俗人;外行; [acc] /ˈleɪmən/;
impatient: [x] adj. 不耐烦的,没有耐心的;急躁的; [acc] /ɪmˈpeɪʃnt/;
urge: [x] v. 力劝,敦促;驱策;力荐;  vi. 驱策;  n. 冲动,欲望; [acc] /ɜːrdʒ/;
brand: [x] n. 商标,品牌;烙印;  v. 给..打上烙印;归为 (不好的事物); [acc] /brænd/;
specialist: [x] n. 专家;专科医生;  adj. 专家的;专业的; [acc] /ˈspeʃəlɪst/;
propaganda: [x] n. 宣传;宣传方法; [acc] /ˌprɑːpəˈɡændə/;
summit: [x] n. 山顶,顶点;(政府间的)峰会; [acc] /ˈsʌmɪt/;
chase: [x] v. 追赶;驱逐;追求;  n. 追逐;追求; [acc] /tʃeɪs/;
endure: [x] v. 忍受;持久;持续;容忍; [acc] /ɪnˈdʊr/;
sheer: [x] adj. 陡峭的;纯粹的;  v. (off)急转向,偏离;  n. 透明薄纱,透明布料的衣服;  adv. 完全地,全然;垂直地,陡峭地; [acc] /ʃɪr/;
extravagant: [x] adj. 奢侈的,无节制的; [acc] /ɪkˈstrævəɡənt/;
probability: [x] n. 可能性;几率,概率; [acc] /ˌprɑːbəˈbɪləti/;
diet: [x] n. 日常饮食;(病人或减肥者的)特种饮食;大量;  v. 节食; [acc] /ˈdaɪət/;
poisonous: [x] adj. 有毒的; [acc] /ˈpɔɪzənəs/;
engine: [x] n. 引擎;发动机;  v. 给..装引擎; [acc] /ˈendʒɪn/;
monarch: [x] n. 君主;帝王;统治者; [acc] /ˈmɑːnərk/;
bulletin: [x] n. 公告;公报;公告牌; [acc] /ˈbʊlətɪn/;
prevailing: [x] adj. 流行的;盛行的;普遍的; [acc] /prɪˈveɪlɪŋ/;
purchase: [x] v. 购买;  n. 购买;所购之物; [acc] /ˈpɜːrtʃəs/;
sturdy: [x] adj. 结实的;坚固的;强壮的;健壮的;  n. (羊的)晕倒病; [acc] /ˈstɜːrdi/;
voluntary: [x] adj. 自愿的;无偿的;志愿的;  n. 即兴曲; [acc] /ˈvɑːlənteri/;
response: [x] n. 回应;作答;响应,回答; [acc] /rɪˈspɑːns/;
fastener: [x] n. 纽扣;使系牢之物; [acc] /ˈfæsnər/;
uproar: [x] n. 骚动;喧嚣; [acc] /ˈʌprɔːr/;
stark: [x] adj. 完全的,明显的,荒凉的;  adv. 完全,明显地; [acc] /stɑːrk/;
suburb: [x] n. 郊区; [acc] /ˈsʌbɜːrb/;
butt: [x] n. 底部,屁股;  v. (人)用头顶撞;(动物)用头(或角)顶;  adv. 猛撞;用头撞; [acc] /bʌt/;
merciful: [x] adj. 慈善的,仁慈的,宽大的; [acc] /ˈmɜːrsɪfl/;
chorus: [x] n. 副歌部分;合唱团;合唱曲,合唱句;  v. 合唱,齐声说;齐声说; [acc] /ˈkɔːrəs/;
glossary: [x] n. 词汇表,术语汇编; [acc] /ˈɡlɑːsəri/;
deduce: [x] v. 演绎;推论,推断; [acc] /dɪˈduːs/;
concession: [x] n. 让步;特许,特许权;承认; [acc] /kənˈseʃn/;
procedure: [x] n. 步骤,过程;程序;手续; [acc] /prəˈsiːdʒər/;
reactor: [x] n. ［原］反应堆; [acc] /riˈæktər/;
specialty: [x] n. 特色菜;专业,专长,特点; [acc] /ˈspeʃəlti/;
brutal: [x] adj. 残忍的,粗鲁的;严酷的,难以忍受的;严峻的; [acc] /ˈbruːtl/;
reproach: [x] v. 责备,指责;  n. 指责; [acc] /rɪˈproʊtʃ/;
spherical: [x] adj. 球形的; [acc] /ˈsferɪkl/;
solemn: [x] adj. 严肃的;庄严的,隆重的;神圣的; [acc] /ˈsɑːləm/;
provoke: [x] v. 激怒;对.挑衅;引起; [acc] /prəˈvoʊk/;
realization: [x] n. 认识,领会,领悟,实现; [acc] /ˌriːələˈzeɪʃn/;
melancholy: [x] n. 忧郁,悲哀;  adj. 忧郁的,令人伤感的; [acc] /ˈmelənkɑːli/;
yolk: [x] n. 蛋黄; [acc] /joʊk/;
offset: [x] v. 抵消;  adj. 胶印的,透印版印刷的;  n. 分支;抵销; [acc] /ˈɔːfset/;
strain: [x] n. 负担;紧张;拉力;(生物体)品种,种类;  v. 拉紧;劳累;过分使用; [acc] /streɪn/;
bourgeois: [x] n. 中产阶级;资产阶级;  adj. 中产阶级的; [acc] /ˌbʊrˈʒwɑː/;
conference: [x] n. 会议;讨论会; [acc] /ˈkɑːnfərəns/;
drain: [x] vi. 排出,排水;  v. 流干,沥干;喝光,耗尽,减少,消逝;  vt. 使流出,排掉水;  n. 下水道,排水管;消耗,排水; [acc] /dreɪn/;
passive: [x] adj. 被动的;消极的;  n. 被动语态; [acc] /ˈpæsɪv/;
achievement: [x] n. 成绩,成就;实现,完成; [acc] /əˈtʃiːvmənt/;
thrill: [x] n. 兴奋,激动,引起激动的事物;  v. (使)非常兴奋,(使)非常激动; [acc] /θrɪl/;
pave: [x] v. 铺(路),铺筑; [acc] /peɪv/;
cyber-: [x] pref. 电脑(网络)的;电脑的;网络的; [acc] /'saɪbə/;
annual: [x] adj. 一年一次的,年度的;  n. 年鉴,一年生植物,一年一度的事件; [acc] /ˈænjuəl/;
scarlet: [x] n. 鲜红色;鲜红色布匹;  adj. 鲜红色的;罪不可赦的; [acc] /ˈskɑːrlət/;
cumulative: [x] adj. 渐增的;累积的; [acc] /ˈkjuːmjəleɪtɪv/;
reconciliation: [x] n. 和解,修好,和好,调停,调解; [acc] /ˌrekənsɪliˈeɪʃn/;
cocaine: [x] n. 可卡因,古柯碱; [acc] /koʊˈkeɪn/;
fraud: [x] n. 欺诈,诈骗;骗子; [acc] /frɔːd/;
complement: [x] v. 补充;与.相配;  n. 补充;互为补充的东西;补语; [acc] /ˈkɑːmplɪment/;
outrage: [x] n. 残暴;暴行,愤怒;  v. 使震怒,使愤慨; [acc] /ˈaʊtreɪdʒ/;
bang: [x] n. 巨响;重击;刘海;  adv. 准确地,完全地;  v. 发出砰的一声;重击;猛敲;砰地关上; [acc] /bæŋ/;
tar: [x] n. 柏油;焦油;  v. 涂柏油; [acc] /tɑːr/;
cane: [x] n. 手杖;茎;藤条;甘蔗; [acc] /keɪn/;
inevitable: [x] adj. 不可避免的,必然的;  n. 必然发生的事; [acc] /ɪnˈevɪtəbl/;
attendance: [x] n. 出席人数;出席;出席者;随员; [acc] /əˈtendəns/;
innovation: [x] n. 创新,革新,新设施,新发明; [acc] /ˌɪnəˈveɪʃn/;
sensor: [x] n. 传感器,灵敏元件; [acc] /ˈsensər/;
entitle: [x] v. 给(书)题名;给予.权利; [acc] /ɪnˈtaɪtl/;
adjoin: [x] v. 与.毗连;贴近; [acc] /əˈdʒɔɪn/;
junk: [x] n. 废旧物品,垃圾,假货;  v. 把.(当废物)丢弃; [acc] /dʒʌŋk/;
cite: [x] v. 引用,引证;传唤,传讯;表彰,嘉奖; [acc] /saɪt/;
clerk: [x] n. 店员;职员;办事员;  vi. 当职员; [acc] /klɜːrk/;
decisive: [x] adj. 决定性的; [acc] /dɪˈsaɪsɪv/;
indignant: [x] adj. 愤慨的,愤愤不平的; [acc] /ɪnˈdɪɡnənt/;
haul: [x] n. 一次获得;拖运路程;  v. 硬拖,硬拉,用力拖;拖,拉,拽;强迫(某人)去某处; [acc] /hɔːl/;
cannon: [x] n. 大炮;机关炮;  v. 相撞;开炮; [acc] /ˈkænən/;
crime: [x] n. 罪行;犯罪;违反道德的行为;  v. 判定犯罪;处罚军事犯; [acc] /kraɪm/;
adjustable: [x] adj. 可调整的; [acc] /əˈdʒʌstəbl/;
mast: [x] n. 桅,桅杆,柱;旗杆;天线竿;  v. 装桅杆于; [acc] /mæst/;
religion: [x] n. 宗教;宗教信仰;宗教生活;虔诚的追求; [acc] /rɪˈlɪdʒən/;
accustomed: [x] adj. 通常的,惯常的;独特的;习惯的,适应了的(to); [acc] /əˈkʌstəmd/;
flare: [x] v. 燃烧(摇曳着);突然发怒;  n. 照明弹;摇曳的火焰;闪光信号; [acc] /fler/;
instrumental: [x] adj. 乐器的;重要的;有帮助的;仪器的;  n. 工具词;器乐曲;工具格; [acc] /ˌɪnstrəˈmentl/;
fluctuate: [x] v. 波动;起伏;涨落; [acc] /ˈflʌktʃueɪt/;
detection: [x] n. 察觉;侦察;检测,检验; [acc] /dɪˈtekʃn/;
commitment: [x] n. 承诺;许诺;委任;承担的义务;献身;赞助;委托;犯罪;罪行;信奉; [acc] /kəˈmɪtmənt/;
purity: [x] n. 纯洁;纯净;纯正;纯粹; [acc] /ˈpjʊrəti/;
tenant: [x] n. 承租人,租客,佃户; [acc] /ˈtenənt/;
initiate: [x] v. 开始,发动;  n. 新加入组织的人; [acc] /ɪˈnɪʃieɪt/;
reward: [x] n. 奖品,报酬,回报;悬赏;  v. 报答,酬谢; [acc] /rɪˈwɔːrd/;
underwear: [x] n. 内衣裤; [acc] /ˈʌndərwer/;
proof: [x] n. 证据,证明,校样;  v. 校对;试验;  adj. 防.的;能抵御;能防范; [acc] /pruːf/;
spectacle: [x] n. 场面;景象,奇观;眼镜; [acc] /ˈspektəkl/;
alternative: [x] adj. 可供选择的;替代的;不寻常的;  n. 可供选择的事物; [acc] /ɔːlˈtɜːrnətɪv/;
linear: [x] adj. 线的,线性的;直线的;长度的; [acc] /ˈlɪniər/;
bias: [x] n. 倾斜;偏心;偏见;  v. 使有偏见; [acc] /ˈbaɪəs/;
abundance: [x] n. 丰富;大量; [acc] /əˈbʌndəns/;
banquet: [x] n. (正式的)宴会;盛宴;  adj. 宴会的; [acc] /ˈbæŋkwɪt/;
devise: [x] v. 设计,想出;密谋;遗赠(不动产);  n. 设计,发明,遗赠; [acc] /dɪˈvaɪz/;
compute: [x] v. 计算,估计; [acc] /kəmˈpjuːt/;
accommodation: [x] n. 住宿,食宿;调解;住处; [acc] /əˌkɑːməˈdeɪʃn/;
gossip: [x] n. 流言蜚语,爱传流言的人;  v. 闲聊,传播流言蜚语; [acc] /ˈɡɑːsɪp/;
advocate: [x] v. 提倡;主张;为.辩护;  n. 辩护者;提倡者;律师; [acc] /ˈædvəkeɪt/;
peculiar: [x] adj. 奇怪的,古怪的;特有的,特别的; [acc] /pɪˈkjuːliər/;
feasible: [x] adj. 可行的,行得通的; [acc] /ˈfiːzəbl/;
republican: [x] n. 共和主义者;共和党员;  adj. 共和国的,共和政体的;共和党的; [acc] /rɪˈpʌblɪkən/;
composite: [x] adj. 合成的,复合的;  n. 合成物,复合材料;  v. 使合成,使混合; [acc] /kəmˈpɑːzət/;
rivalry: [x] n. 竞争,敌对; [acc] /ˈraɪvlri/;
pertinent: [x] adj. 有关的;适当的;中肯的;  n. 附属物;参考; [acc] /ˈpɜːrtnənt/;
iceberg: [x] n. 冰山; [acc] /ˈaɪsbɜːrɡ/;
shady: [x] adj. 成荫的,多荫的;可疑的,靠不住的; [acc] /ˈʃeɪdi/;
cathedral: [x] n. 大教堂;  adj. 有权威的;大教堂的; [acc] /kəˈθiːdrəl/;
hound: [x] n. 猎犬;  v. 追逼;烦扰;纠缠; [acc] /haʊnd/;
awkward: [x] adj. 尴尬的;笨拙的;棘手的;不雅观的;不方便的;困难的,危险的; [acc] /ˈɔːkwərd/;
audit: [x] v. 审计,查账;旁听;  n. 审计;查帐; [acc] /ˈɔːdɪt/;
counter: [x] n. 柜台;回击,反击;  v. 抵消,抗衡;  adv. 相反地; [acc] /ˈkaʊntər/;
specific: [x] adj. 具体的,明确的;特定的;特殊的;针对..的;  n. 详情;特性; [acc] /spəˈsɪfɪk/;
pamphlet: [x] n. 小册子; [acc] /ˈpæmflət/;
brief: [x] adj. 简短的,扼要的,短暂的,短时间的;  n. 摘要,概要,简短声明,诉讼要点;职责;  v. 作.的摘要,向.通报情况; [acc] /briːf/;
seminar: [x] n. 研究班;研讨会; [acc] /ˈsemɪnɑːr/;
ornamental: [x] adj. 装饰性的;  n. 观赏植物;装饰物; [acc] /ˌɔːrnəˈmentl/;
sift: [x] vt. 筛;  v. 筛分;精选;细查; [acc] /sɪft/;
permanence: [x] n. 持久;永久; [acc] /ˈpɜːrmənəns/;
strife: [x] n. 纷争,倾轧; [acc] /straɪf/;
prediction: [x] n. 预言,预测; [acc] /prɪˈdɪkʃn/;
clasp: [x] v. 握紧;扣紧;扣住;抱紧;  n. 扣子;钩子;紧抱;紧握; [acc] /klæsp/;
persecute: [x] v. (尤指因宗教或政治信仰不同)迫害;烦扰,纠缠; [acc] /ˈpɜːrsɪkjuːt/;
underlying: [x] adj. 基本的;潜在的;在下面的; [acc] /ˌʌndərˈlaɪɪŋ/;
standardize: [x] v. 立下标准;制定标准;使合乎标准;使标准化; [acc] /ˈstændərdaɪz/;
angel: [x] n. 天使;可爱的人;善人,好人(感激某人时所说); [acc] /ˈeɪndʒl/;
combination: [x] n. 结合,联合,组合;(保险锁等的)暗码; [acc] /ˌkɑːmbɪˈneɪʃn/;
alleviate: [x] v. 减轻;缓解;缓和; [acc] /əˈliːvieɪt/;
untie: [x] v. 解开,解放; [acc] /ʌnˈtaɪ/;
diverse: [x] adj. 不同的,差异的,多种多样的; [acc] /daɪˈvɜːrs/;
vow: [x] n. 誓约;  v. 宣誓;立誓;发誓; [acc] /vaʊ/;
tract: [x] n. 器官系统;一大片地;短文,小册子; [acc] /trækt/;
bewilder: [x] v. 使不知所措;使迷惑;使变糊涂,弄糊涂; [acc] /bɪˈwɪldər/;
experimentally: [x] adv. 实验上地;用实验方法; [acc] /ɪkˌsperɪˈmentəli/;
perspective: [x] n. 角度,视角,观点,想法;(对事物的)合理判断,正确认识;远景;透视图,透视法,透视效果;  adj. 透视的; [acc] /pərˈspektɪv/;
synthesis: [x] n. 合成; [acc] /ˈsɪnθəsɪs/;
prospect: [x] n. 前景,展望;视野;景象;  v. 勘察;有前途;勘探;对..进行仔细调查; [acc] /ˈprɑːspekt/;
loom: [x] n. 织布机;  v. 阴森地逼近;隐现;即将来临; [acc] /luːm/;
pastime: [x] n. 消遣,娱乐; [acc] /ˈpæstaɪm/;
manure: [x] n. 肥料;  v. 施肥于;耕种; [acc] /məˈnʊr/;
advent: [x] n. 来临;到来;出现; [acc] /ˈædvent/;
probe: [x] v. 探测,探索;  n. 探索,调查;探针,探测器; [acc] /proʊb/;
solidify: [x] v. (使)凝固,(使)团结,巩固; [acc] /səˈlɪdɪfaɪ/;
refuge: [x] n. 避难,庇护;避难所,收容所;隐蔽处;保护区;  vi. 避难,寻求庇护;  vt. 给以庇护,提供庇护; [acc] /ˈrefjuːdʒ/;
hybrid: [x] n. 杂种,混血儿,混合物;  adj. 混合的;杂种的; [acc] /ˈhaɪbrɪd/;
decline: [x] n. 下降;衰退;  v. [语]使发生词尾变化,使变格;下降;拒绝; [acc] /dɪˈklaɪn/;
commute: [x] n. 在两地之间乘车往返;  v. 经常乘车往返于两地之间;  vt. 减免; [acc] /kəˈmjuːt/;
shrink: [x] v. 收缩;缩小;退缩;  n. (非正式用法)心理医生,精神病医生; [acc] /ʃrɪŋk/;
denial: [x] n. 拒绝;否认;拒绝给予; [acc] /dɪˈnaɪəl/;
timely: [x] adj. 适时的,及时的;  adv. 及时地; [acc] /ˈtaɪmli/;
consumption: [x] n. 消耗,消费,耗尽;肺痨; [acc] /kənˈsʌmpʃn/;
prototype: [x] n. 原型,典型,样本; [acc] /ˈproʊtətaɪp/;
approach: [x] v. 接近;靠近;着手处理;  n. 接近;途径;方法; [acc] /əˈproʊtʃ/;
oyster: [x] n. 牡蛎;从中可得到好处的东西;[口语]沉默寡言;  v. 采牡蛎; [acc] /ˈɔɪstər/;
legitimate: [x] adj. 合法的;合理的;  vt. 使合法;授权;宣布..为合法; [acc] /lɪˈdʒɪtɪmət/;
conscious: [x] adj. 神志清醒的;自觉的;意识到的;有意的;  n. 意识; [acc] /ˈkɑːnʃəs/;
fist: [x] n. 拳头;笔迹;  vt. 用拳头打;握成拳;紧握; [acc] /fɪst/;
participant: [x] n. 参加者,参与者;  adj. 参加的;有关系的; [acc] /pɑːrˈtɪsɪpənt/;
scratch: [x] n. 抓痕,擦伤;  v. 划破,擦伤,挠; [acc] /skrætʃ/;
spy: [x] n. 间谍,密探;  v. 当间谍,暗中监视(或侦察); [acc] /spaɪ/;
haughty: [x] adj. 傲慢的; [acc] /ˈhɔːti/;
plea: [x] n. (法律)抗辩;恳求;请求,托词,口实; [acc] /pliː/;
recur: [x] v. 重新出现;再次发生;重新提起;诉诸;反复; [acc] /rɪˈkɜːr/;
coarse: [x] adj. 粗糙的;粗俗的;粗鲁的; [acc] /kɔːrs/;
stun: [x] v. 使昏迷,使发愣; [acc] /stʌn/;
growl: [x] v. (动物)咆哮,吼叫;  n. 咆哮声,怨言,打嗝声; [acc] /ɡraʊl/;
recipient: [x] n. 接受者;容器;间接宾语;  adj. 接受的;善于接受的;接受能力强的; [acc] /rɪˈsɪpiənt/;
appeal: [x] vi. 呼吁,请求;申诉;有吸引力;  n. 呼吁;恳求;(为慈善或好的事业所做的) 筹款努力;(人或物的)吸引力; [acc] /əˈpiːl/;
gradient: [x] n. 斜坡;倾斜度;坡度;渐变;  adj. 倾斜的;渐倾的; [acc] /ˈɡreɪdiənt/;
myth: [x] n. 神话;虚构的信念(或观念,理论);杜撰出来的人(或事物); [acc] /mɪθ/;
charter: [x] n. 宪章;特权,豁免权;契约,证书;租赁;  v. 包,租(飞机,汽车等);  adj. 包租的,租用的; [acc] /ˈtʃɑːrtər/;
ozone: [x] n. 臭氧;(口语)新鲜空气;能使人兴奋的力量; [acc] /ˈoʊzoʊn/;
treaty: [x] n. 条约;协议;协定; [acc] /ˈtriːti/;
pinpoint: [x] v. 准确地解释或说明;  adj. 精确的;  n. 针尖,极小之物,极不重要的事物; [acc] /ˈpɪnpɔɪnt/;
retort: [x] v. 反驳;  n. 反驳,反击,回嘴; [acc] /rɪˈtɔːrt/;
gloomy: [x] adj. 愁容满面的,阴暗的,没有希望的; [acc] /ˈɡluːmi/;
lane: [x] n. 小径,巷,行车道; [acc] /leɪn/;
scale: [x] n. 天平,磅秤;刻度,尺度,标度;等级,级别, 等级体系;鳞片,鳞状物;规模;水垢,牙垢;  v. 攀登;按比例决定;称重;刮鳞,剥落; [acc] /skeɪl/;
charity: [x] n. 慈善团体;慈善;仁慈;施舍; [acc] /ˈtʃærəti/;
prose: [x] n. 散文;  vt. 用散文写,把.改写成散文;平淡无趣地写;啰啰唆唆地讲; [acc] /proʊz/;
appliance: [x] n. 家用器具;家用电器;装置;应用; [acc] /əˈplaɪəns/;
resignation: [x] n. 辞职;辞职书;无奈;顺从; [acc] /ˌrezɪɡˈneɪʃn/;
retain: [x] v. 保持,保留,保存;聘请; [acc] /rɪˈteɪn/;
stability: [x] n. 稳定,稳定性; [acc] /stəˈbɪləti/;
geometrical: [x] adj. 几何学的;几何的; [acc] /ˌdʒiəˈmetrɪk(ə)l/;
notation: [x] n. 记号;标记法;记录; [acc] /noʊˈteɪʃn/;
coherent: [x] adj. 协调一致的;条理清楚的,有条理的;连贯的;有黏性的,黏合在一起的,粘着的; [acc] /koʊˈhɪrənt/;
ban: [x] vt. 禁止;查禁;  n. 禁止,禁令; [acc] /bæn/;
bribe: [x] v. 向.行贿;买通;  n. 贿赂;行贿物; [acc] /braɪb/;
physiological: [x] adj. 生理的,生理学的; [acc] /ˌfɪziəˈlɑːdʒɪkl/;
naive: [x] adj. 天真的;  n. 天真的人; [acc] /naɪˈiːv/;
rank: [x] v. 排名;把.分等级;列队;  n. 等级;军队中的官阶;  adj. 繁茂的,讨厌的,难闻的; [acc] /ræŋk/;
masculine: [x] adj. 男性的;男子气概的; [acc] /ˈmæskjəlɪn/;
immigrant: [x] n. 移民;  adj. 移民的;迁入的; [acc] /ˈɪmɪɡrənt/;
external: [x] adj. 外面的,外部的;外国的; [acc] /ɪkˈstɜːrnl/;
analytic(al): [x] adj. 分析的;分解的; [acc] /ˌænə'lɪtɪkl/;
disposal: [x] n. 销毁,丢掉,处理;  adj. 处理(或置放)废品的; [acc] /dɪˈspoʊzl/;
float: [x] vi. 漂浮,飘浮,浮现;散布;漂泊;  vt. 使漂浮;散布;  n. 浮标,漂浮物,漂浮; [acc] /floʊt/;
grove: [x] n. 小树林;果园; [acc] /ɡroʊv/;
occupation: [x] n. 占领,占据;占用,居住;职业,工作;消遣; [acc] /ˌɑːkjuˈpeɪʃn/;
Thanksgiving: [x] n. 感恩节; [acc] /ˌθæŋksˈɡɪvɪŋ/;
impurity: [x] n. 不洁;杂质;不道德; [acc] /ɪmˈpjʊrəti/;
ruin: [x] v. 毁灭,毁坏;(使)破产;(使)堕落;  n. 毁灭;废墟; [acc] /ˈruːɪn/;
regenerative: [x] adj. 再生的;更新的; [acc] /rɪˈdʒenərətɪv/;
extinguish: [x] v. 熄灭,扑灭;根除,消灭; [acc] /ɪkˈstɪŋɡwɪʃ/;
web: [x] n. 网;蜘蛛网; [acc] /web/;
exert: [x] v. 尽(力),运用,发挥; [acc] /ɪɡˈzɜːrt/;
successive: [x] adj. 连续的;接连的; [acc] /səkˈsesɪv/;
extraordinarily: [x] adv. 格外地;非常好地; [acc] /ɪkˌstrɔːrdəˈnerəli/;
marvel: [x] n. 奇迹,奇景;奇才;  v. 惊叹,吃惊,诧异; [acc] /ˈmɑːrvl/;
extensive: [x] adj. 广阔的;广泛的; [acc] /ɪkˈstensɪv/;
cancel: [x] v. 取消;撤消;删去; [acc] /ˈkænsl/;
rapidity: [x] n. 速度;陡峭; [acc] /rəˈpɪdəti/;
poetry: [x] n. 诗,诗歌,诗作;诗意; [acc] /ˈpoʊətri/;
fracture: [x] n. 骨折;折断;裂口;  v. 使折断;使骨折; [acc] /ˈfræktʃər/;
forum: [x] n. 论坛;讨论会; [acc] /ˈfɔːrəm/;
multiply: [x] v. 乘;繁殖;增加; [acc] /ˈmʌltɪplaɪ/;
batch: [x] n. 一批(人或物);一批生产量; [acc] /bætʃ/;
precedent: [x] n. 先例,范例;惯例;  adj. 在前的,前面的; [acc] /ˈpresɪdənt/;
stylish: [x] adj. 时髦的,漂亮的,流行的; [acc] /ˈstaɪlɪʃ/;
deceptive: [x] adj. 欺骗性的,骗人的; [acc] /dɪˈseptɪv/;
outward: [x] adj. 外面的;向外的;  adv. 外面地,向外地;  n. 外表;外在事务;周围世界;〈罕〉外部; [acc] /ˈaʊtwərd/;
segment: [x] n. 部分;片段;(橘子等的)瓣;  v. 分割; [acc] /ˈseɡmənt/;
condemn: [x] v. 谴责,责备;判(某人某罪); [acc] /kənˈdem/;
reunion: [x] n. 团聚;再联合;再结合;(亲友等的)重聚; [acc] /ˌriːˈjuːniən/;
tradesman: [x] n. 零售商;工匠; [acc] /ˈtreɪdzmən/;
afflict: [x] v. 使痛苦;使苦恼; [acc] /əˈflɪkt/;
overwhelming: [x] adj. 巨大的,势不可挡的,压倒性的;制服的,无法抗拒的; [acc] /ˌoʊvərˈwelmɪŋ/;
knob: [x] n. 圆形把手,旋钮,圆形突出物;  v. 突出;使有球形突出物;在.上生疖(长瘤);给(门等)装球形捏手; [acc] /nɑːb/;
negotiate: [x] v. 谈判,交涉,商议;成功越过,渡过; [acc] /nɪˈɡoʊʃieɪt/;
revolve: [x] v. (使)旋转;(使)绕转; [acc] /rɪˈvɑːlv/;
weird: [x] adj. 古怪的;荒唐的; [acc] /wɪrd/;
aroma: [x] n. 芳香,香气; [acc] /əˈroʊmə/;
proceeding: [x] n. 诉讼;(会议等的)项目;行动;会议记录,会刊;  v. 继续进行; [acc] /prəˈsiːdɪŋ/;
cereal: [x] n. 谷物;谷类食物;谷类食品;  adj. 谷类的;谷类制成的; [acc] /ˈsɪriəl/;
gloom: [x] n. 昏暗,阴暗;忧郁,沮丧;  v. 变忧郁,变忧愁; [acc] /ɡluːm/;
senseless: [x] adj. 不省人事的;无知的;愚蠢的;无意义的;不理解的; [acc] /ˈsensləs/;
discourse: [x] n. 交谈,演讲,论述,讲道;  v. 演讲,谈论; [acc] /ˈdɪskɔːrs/;
retail: [x] adj. 零售的;  n. 零售;  v. 零售,零售价是;  adv. 以零售方式,以零售形式; [acc] /ˈriːteɪl/;
slum: [x] n. 贫民窟,贫民区,陋巷;  v. 去贫民窟,到贫民区去(参观,游玩等); [acc] /slʌm/;
kit: [x] n. 成套工具;工具箱;装备;  vt. 装备; [acc] /kɪt/;
plateau: [x] n. 高原;  vi. 到达平稳阶段; [acc] /plæˈtoʊ/;
considerate: [x] adj. 考虑周到的;体贴的; [acc] /kənˈsɪdərət/;
acquisition: [x] n. 并购;获得;掌握;获得物;取得物; [acc] /ˌækwɪˈzɪʃn/;
vaccinate: [x] v. 进行预防接种;  n. 被接种牛痘者; [acc] /ˈvæksɪneɪt/;
addition: [x] n. 加法;添加;附加物; [acc] /əˈdɪʃn/;
regime: [x] n. 政权;政治制度;养生法,生活规则; [acc] /reɪˈʒiːm/;
erupt: [x] v. 爆发;(火山,喷泉,蒸汽等)喷发;使迸发;喷射出; [acc] /ɪˈrʌpt/;
obsolete: [x] adj. 已过时的;已废弃的;  v. 使过时;使作废;  n. 废词;被废弃的事物; [acc] /ˌɑːbsəˈliːt/;
shrub: [x] n. 灌木; [acc] /ʃrʌb/;
ventilate: [x] v. 使.通风,透风;公开讨论; [acc] /ˈventɪleɪt/;
discard: [x] v. 丢弃;抛弃;遗弃; [acc] /dɪsˈkɑːrd/;
remainder: [x] n. 剩下的人;剩余物,残留部分;  v. 减价出售,削价处理;  adj. 剩余的;留存下的; [acc] /rɪˈmeɪndər/;
analytic: [x] adj. 分析的;分析法的; [acc] /ˌænəˈlɪtɪk/;
underprivileged: [x] adj. 贫困的;被剥夺基本权力的;社会地位低下的;  n. 弱势群体;贫困阶层; [acc] /ˌʌndərˈprɪvəlɪdʒd/;
crank: [x] n. 曲柄;有怪癖的人;脾气坏的人;  v. 装曲柄;转动曲柄;  adj. 脾气暴躁的,易怒的; [acc] /kræŋk/;
aesthetic: [x] n. 美感;审美观;  adj. 美学的;审美的;悦目的;雅致的; [acc] /esˈθetɪk/;
soluble: [x] adj. 可溶解的;可解决的; [acc] /ˈsɑːljəbl/;
electronic: [x] adj. 电子的;电子学的;电子操控的;电子设备的; [acc] /ɪˌlekˈtrɑːnɪk/;
unpaid: [x] adj. 未付款的;不受报酬的; [acc] /ˌʌnˈpeɪd/;
continental: [x] adj. 大陆的,大陆性的;  n. 欧洲人; [acc] /ˌkɑːntɪˈnentl/;
cycle: [x] n. 自行车;周期,循环;  v. (英)骑自行车;循环; [acc] /ˈsaɪkl/;
precipitate: [x] v. 促成,使..沉淀,猛摔;[气象]凝结;  n. 沉淀物,冷凝物;  adj. 突如其来的,仓促的,迅猛的;感情用事的; [acc] /prɪˈsɪpɪteɪt/;
stew: [x] v. 炖,焖,受闷热;使焦虑不安;  n. 炖肉(或菜);鱼塘; [acc] /stuː/;
classic: [x] adj. 经典的;古典的;高雅的;一流的;  n. 经典著作;文豪;优秀典范; [acc] /ˈklæsɪk/;
muddy: [x] adj. 泥泞的;暗淡的;浑浊的;  v. 使粘上烂泥;显得扑朔迷离; [acc] /ˈmʌdi/;
experimentation: [x] n. 实验;试验;实验法; [acc] /ɪkˌsperɪmenˈteɪʃn/;
leisure: [x] n. 闲暇,空暇,休闲时间;  adj. 空闲的; [acc] /ˈliːʒər/;
faction: [x] n. 派别,小集团,小派系;派系斗争,内讧; [acc] /ˈfækʃn/;
pier: [x] n. 码头;桥墩; [acc] /pɪr/;
intellectual: [x] n. 知识分子;  adj. 智力的;理智的;需用智力的;聪明的; [acc] /ˌɪntəˈlektʃuəl/;
curb: [x] v. 勒住;抑制;控制;约束;  n. 路缘;控制;约束; [acc] /kɜːrb/;
suspicious: [x] adj. 可疑的,引起怀疑的;怀疑的,猜疑的; [acc] /səˈspɪʃəs/;
instruct: [x] v. 指导;教;指示;通知; [acc] /ɪnˈstrʌkt/;
cling: [x] v. 紧紧抓住;黏着,挨近;依恋,依附;坚持,墨守,忠实于; [acc] /klɪŋ/;
exotic: [x] adj. 奇异的,珍奇的,来自异国的; [acc] /ɪɡˈzɑːtɪk/;
cabinet: [x] n. 橱;柜;内阁; [acc] /ˈkæbɪnət/;
oath: [x] n. 誓言;誓约;咒骂;咒语; [acc] /oʊθ/;
collapse: [x] v. (使)倒塌,(使)崩溃,(使)瓦解;  n. 倒塌,崩溃,暴跌; [acc] /kəˈlæps/;
overflow: [x] v. 满得外溢,外流,泛滥;充满,洋溢;  n. 溢流口,溢流管;容纳不下的物(或人);溢出,满出;超出额;  adj. 充满的; [acc] /ˌoʊvərˈfloʊ/;
enormous: [x] adj. 极大的,极大量的;巨大的;庞大的; [acc] /ɪˈnɔːrməs/;
commentary: [x] n. 评述;评论,评论文章;(广播员对球赛等的)实况报道,(电影的)解说词; [acc] /ˈkɑːmənteri/;
diplomatic: [x] adj. 外交的,从事外交的;老练的,圆滑的; [acc] /ˌdɪpləˈmætɪk/;
formulation: [x] n. 表述方式;构想,规划;公式化; [acc] /ˌfɔːrmjuˈleɪʃn/;
faith: [x] n. 信任;信心;信仰;  int. 实在,确实; [acc] /feɪθ/;
ultraviolet: [x] adj. 紫外线;紫外线的; [acc] /ˌʌltrəˈvaɪələt/;
knight: [x] n. 骑士;  v. 授以爵位; [acc] /naɪt/;
caption: [x] n. (报刊的)标题;(插图,照片等的)说明文字;  v. 给(图片,照片等)加说明文字; [acc] /ˈkæpʃn/;
prevail: [x] v. 流行,盛行;战胜,压倒; [acc] /prɪˈveɪl/;
walnut: [x] n. 核桃,胡桃;核桃树;胡桃木; [acc] /ˈwɔːlnʌt/;
investigate: [x] v. 调查,研究; [acc] /ɪnˈvestɪɡeɪt/;
frightful: [x] adj. 可怕的;惊人的;使惊恐的;讨厌的;非常的; [acc] /ˈfraɪtfl/;
scrap: [x] n. 碎片;口角,吵架;小块,小片;废金属;残羹冷炙;  v. 报废;舍弃;打架; [acc] /skræp/;
continual: [x] adj. 不断的;连续的;频繁的; [acc] /kənˈtɪnjuəl/;
tick: [x] n. 勾号,(钟表)滴答声,一刹那;  v. 用勾作为记号,发出滴答声; [acc] /tɪk/;
degrade: [x] v. 贬低;降低品格(身价,价值等);分解;降低; [acc] /dɪˈɡreɪd/;
characteristic: [x] n. 特点;特性;特色;  adj. 典型的;特有的;独特的; [acc] /ˌkærəktəˈrɪstɪk/;
momentary: [x] adj. 短暂的,瞬间的; [acc] /ˈmoʊmənteri/;
savage: [x] n. 野蛮人,粗鲁的人;  adj. 凶猛的,猛烈的;野蛮的;未驯化的;  v. (狗等)乱咬;激烈抨击; [acc] /ˈsævɪdʒ/;
intrigue: [x] n. 阴谋;诡计;  v. 密谋;欺骗;引起极大兴趣; [acc] /ɪnˈtriːɡ/;
helmet: [x] n. 钢盔;头盔;盔形物;  vt. 给.戴头盔; [acc] /ˈhelmɪt/;
wring: [x] v. 扭,榨取,强求;绞,拧,扭(尤指脖子);  n. 扭,榨取,强求;折磨; [acc] /rɪŋ/;
snack: [x] n. 零食,小吃,快餐; [acc] /snæk/;
courtesy: [x] n. 礼貌; [acc] /ˈkɜːrtəsi/;
neighbouring: [x] adj. 附近的,毗邻的; [acc] /ˈneɪbərɪŋ/;
ethnic: [x] adj. 种族的,少数民族的;  n. 少数民族成员;人种学; [acc] /ˈeθnɪk/;
verbal: [x] adj. 言语的,口头的,动词的; [acc] /ˈvɜːrbl/;
fabulous: [x] adj. 极好的;极妙的;极为巨大的;寓言中的;传说中的; [acc] /ˈfæbjələs/;
puff: [x] v. 喷出;膨胀,肿胀;吹捧;一口口抽烟;  n. 一口(气味,烟雾);一阵,一股;喷出;粉扑;呼吸;  adj. 吹嘘的; [acc] /pʌf/;
diplomat: [x] n. 外交官,外交家;有交际手腕的人,圆滑的人; [acc] /ˈdɪpləmæt/;
evident: [x] adj. 显然的,明显的,明白的; [acc] /ˈevɪdənt/;
conventional: [x] adj. 普通的,常规的;依照惯例的,依照传统的; [acc] /kənˈvenʃənl/;
pore: [x] n. 毛孔,细孔;  v. 深思熟虑,仔细阅读,审视; [acc] /pɔːr/;
factor: [x] n. 因素;[数]因子,商; [acc] /ˈfæktər/;
consensus: [x] n. 一致同意,合意; [acc] /kənˈsensəs/;
literate: [x] adj. 受过教育的;精通文学的;  n. 学者; [acc] /ˈlɪtərət/;
autonomous: [x] adj. 自动驾驶的;自治的,独立自主的;自主的; [acc] /ɔːˈtɑːnəməs/;
upgrade: [x] v. 升级;提高;  n. 改善,提高;升级;升舱; [acc] /ˈʌpɡreɪd/;
bruise: [x] n. (人体组织或表皮等跌,碰撞后产生的)青肿,挫伤;碰伤;  v. 撞伤,碰伤,(使)挫伤,擦伤(表皮,表面);打击;擦伤; [acc] /bruːz/;
betrayal: [x] n. 背叛;辜负;暴露; [acc] /bɪˈtreɪəl/;
startle: [x] v. 吃惊;惊吓; [acc] /ˈstɑːrtl/;
exquisite: [x] adj. 精致的,精选的;细腻的;强烈的;  n. 过分讲究穿戴的人; [acc] /ɪkˈskwɪzɪt/;
supervise: [x] v. 监督;指导;管理; [acc] /ˈsuːpərvaɪz/;
patriot: [x] n. 爱国者; [acc] /ˈpeɪtriət/;
thoughtless: [x] adj. 欠考虑的,轻率的;不体贴人的; [acc] /ˈθɔːtləs/;
membership: [x] n. 会员资格;成员资格; [acc] /ˈmembərʃɪp/;
criterion: [x] n. 标准,准则; [acc] /kraɪˈtɪriən/;
subtract: [x] v. 减少;减去;扣除;  vt. 减去; [acc] /səbˈtrækt/;
tentative: [x] adj. 试探性的;不确定的;暂时的;犹豫不决的; [acc] /ˈtentətɪv/;
calibration: [x] n. 校准刻度;校正;口径测定; [acc] /ˌkælɪˈbreɪʃn/;
chord: [x] n. 和弦;和音;心弦;(数学)弦; [acc] /kɔːrd/;
cliff: [x] n. 悬崖;峭壁; [acc] /klɪf/;
commonwealth: [x] n. 联邦; [acc] /ˈkɑːmənwelθ/;
equip: [x] v. 装备;具备; [acc] /ɪˈkwɪp/;
transaction: [x] n. 交易;办理;事务;学报; [acc] /trænˈzækʃn/;
straighten: [x] v. (使)弄直,伸直; [acc] /ˈstreɪtn/;
encouragement: [x] n. 鼓励;激励; [acc] /ɪnˈkɜːrɪdʒmənt/;
character: [x] n. 人物,角色;性格;(书写或印刷)符号,(汉)字;特点;人格,品性; [acc] /ˈkærəktər/;
tunnel: [x] n. 隧道;  v. 挖地道; [acc] /ˈtʌnl/;
inherit: [x] v. 经遗传而得(特性等);接受遗产;沿袭;继任; [acc] /ɪnˈherɪt/;
taper: [x] v. 逐渐变细;  n. 锥形;渐弱;蜡芯,小蜡烛;  vi. 变尖;逐渐减弱;  vt. 变尖;逐渐减弱;  adj. 渐细的;斜的;依次递减的; [acc] /ˈteɪpər/;
basis: [x] n. 基础,根据;原因,缘由;基准; [acc] /ˈbeɪsɪs/;
keen: [x] adj. 敏锐的;热衷的,热心的;强烈的,渴望的;  v. 恸哭;  n. 〈英〉号哭,恸哭;  adv. 如饥似渴地; [acc] /kiːn/;
esthetic: [x] adj. 美学的;悦目的;美的;  n. 审美观,美学;审美家; [acc] /esˈθetɪk/;
prophecy: [x] n. 预言书;预言,预言能力; [acc] /ˈprɑːfəsi/;
tendency: [x] n. 趋向,趋势,倾向;癖好,意向;派别; [acc] /ˈtendənsi/;
hug: [x] v. 紧抱;拥抱;  n. 拥抱; [acc] /hʌɡ/;
methodology: [x] n. 方法论,方法学;(某一学科的)一套方法; [acc] /ˌmeθəˈdɑːlədʒi/;
despatch: [x] v. 发送;派遣;打败;  n. (公文)急件;(记者发回的)新闻报道;派遣; [acc] /dɪˈspætʃ/;
collaboration: [x] n. 合作,协作;勾结; [acc] /kəˌlæbəˈreɪʃn/;
disgrace: [x] n. 耻辱;不光彩;失宠;  v. 使丢脸,给.带来耻辱;使失宠; [acc] /dɪsˈɡreɪs/;
narrative: [x] n. 叙述;  adj. 叙述的; [acc] /ˈnærətɪv/;
stumble: [x] v. 绊跌,绊倒;结结巴巴说话;  n. 绊倒;失足;失误;失败; [acc] /ˈstʌmbl/;
criminal: [x] n. 罪犯;  adj. 犯罪的,违法的,刑法的;可耻的; [acc] /ˈkrɪmɪnl/;
grief: [x] n. (因不幸,丧失等而)悲伤,悲痛;悲痛的缘由,伤心事;担心,忧虑; [acc] /ɡriːf/;
roam: [x] v. 闲逛,漫步,徘徊;眼睛或手(缓慢地)扫遍;  n. 漫步,漫游; [acc] /roʊm/;
whitewash: [x] v. 用石灰水把..刷白;  n. 石灰水,白色涂料,白粉胶泥水,涂脂抹粉; [acc] /ˈwaɪtwɑːʃ/;
cafeteria: [x] n. 自助食堂;自助餐馆; [acc] /ˌkæfəˈtɪriə/;
scheme: [x] n. 方案,计划;阴谋,诡计;  v. 图谋,密谋;  adj. 计划的; [acc] /skiːm/;
gramophone: [x] n. 留声机; [acc] /ˈɡræməfoʊn/;
luminous: [x] adj. 发光的;鲜艳的;明亮的;夜光的; [acc] /ˈluːmɪnəs/;
dismiss: [x] v. 开除;解散;摒除,不再考虑; [acc] /dɪsˈmɪs/;
composer: [x] n. 作曲家,设计者,著作者; [acc] /kəmˈpoʊzər/;
inhibit: [x] v. 阻碍;阻止,防止;抑制,约束; [acc] /ɪnˈhɪbɪt/;
revive: [x] v. (使)苏醒;(使)复苏;再兴起;重做; [acc] /rɪˈvaɪv/;
pant: [x] v. 喘息;气喘吁吁地说;喘气;  n. 喘气; [acc] /pænt/;
blossom: [x] v. 开花,兴旺,长成;  n. (果树的)花; [acc] /ˈblɑːsəm/;
shrill: [x] adj. 尖声的,刺耳的;  vi. 尖叫;  vt. 尖叫着说;  n. 尖叫声;  adv. 尖声地,无节制地; [acc] /ʃrɪl/;
veto: [x] v. 否决;投反对票;  n. 否决;否决权;禁止; [acc] /ˈviːtoʊ/;
academy: [x] n. 学院; [acc] /əˈkædəmi/;
administer: [x] v. 管理;执行;实施;给予;用(药); [acc] /ədˈmɪnɪstər/;
dizzy: [x] adj. 眩晕的,头晕目眩的,头昏眼花的;  vt. 使头晕目眩;使困惑; [acc] /ˈdɪzi/;
format: [x] n. 版式;设计;格式;  v. 设计一个版式;使格式化;设计.的版面; [acc] /ˈfɔːrmæt/;
cellar: [x] n. 地窖;地下室;酒窖; [acc] /ˈselər/;
inferior: [x] adj. (等级,地位等)下等的,低等的;低劣的;  n. 部下,地位低的人;次品; [acc] /ɪnˈfɪriər/;
legal: [x] adj. 合法的,法定的;法律的; [acc] /ˈliːɡl/;
spectacular: [x] adj. 壮观的,引人入胜的;  n. 壮观的场面,精彩的表演; [acc] /spekˈtækjələr/;
fore: [x] adj. 在前部的,以前的;  adv. 在前面,在船头;  n. 前部,船头;  prep. 在前; [acc] /fɔːr/;
invalid: [x] adj. 不能识别的;无效的;作废的,不能成立的;  n. 病人,残疾人; [acc] /ɪnˈvælɪd/;
cosmopolitan: [x] n. 游历四方的人;  adj. 见多识广的;多元的;广泛分布的; [acc] /ˌkɑːzməˈpɑːlɪtən/;
intimidate: [x] v. 恫吓,威胁; [acc] /ɪnˈtɪmɪdeɪt/;
scrutiny: [x] n. 监视,细看,详细检查,仔细观察; [acc] /ˈskruːtəni/;
hatch: [x] n. 船舱盖;  v. 孵出,孵;策划; [acc] /hætʃ/;
grim: [x] adj. 严酷的,无情的;令人沮丧的,令人失望的;讨厌的,糟糕的; [acc] /ɡrɪm/;
cleanliness: [x] n. 清洁;洁癖; [acc] /ˈklenlinəs/;
hydraulic: [x] adj. 水力的,水压的; [acc] /haɪˈdrɔːlɪk/;
reproduction: [x] n. 复制;繁殖;复制品;再现; [acc] /ˌriːprəˈdʌkʃn/;
protein: [x] n. 蛋白质;  adj. 蛋白质的; [acc] /ˈproʊtiːn/;
restrict: [x] v. 限制;约束; [acc] /rɪˈstrɪkt/;
pledge: [x] v. 发誓,保证,以.抵押,向.祝酒;  n. 保证,誓言; [acc] /pledʒ/;
dilute: [x] v. 使变淡,稀释;使病弱; [acc] /daɪˈluːt/;
plague: [x] n. 瘟疫;灾难;麻烦;  v. 折磨;烦扰;造成麻烦; [acc] /pleɪɡ/;
competence: [x] n. 能力,胜任,称职; [acc] /ˈkɑːmpɪtəns/;
author: [x] n. 作者;发起人;  v. 成为作家; [acc] /ˈɔːθər/;
tow: [x] v. 拖,牵引;拉; [acc] /toʊ/;
excel: [x] vi. 胜出;  vt. 优于; [acc] /ɪkˈsel/;
leather: [x] n. 皮革;皮制品;  vt. 用皮鞭抽打;用皮革覆盖; [acc] /ˈleðər/;
auditory: [x] adj. 听觉的; [acc] /ˈɔːdətɔːri/;
skip: [x] v. 跳过;略过;遗漏;  n. 跳跃;跳读;省略; [acc] /skɪp/;
Egyptian: [x] n. 埃及人; [acc] /iˈdʒɪpʃn/;
ethics: [x] n. 行为准则;道德规范; [acc] /'eθɪks/;
waxy: [x] adj. 蜡制的;蜡质的;似蜡的; [acc] /ˈwæksi/;
dynamo: [x] n. 发电机;精力充沛的人; [acc] /ˈdaɪnəmoʊ/;
enrich: [x] v. 使丰富;使富裕; [acc] /ɪnˈrɪtʃ/;
elegant: [x] adj. 优美的,文雅的,漂亮雅致的,陈设讲究的; [acc] /ˈelɪɡənt/;
revenue: [x] n. 收入;财政收入;国家的税收; [acc] /ˈrevənuː/;
passion: [x] n. 激情; [acc] /ˈpæʃn/;
jewelry: [x] n. 珠宝; [acc] /ˈdʒuːəlri/;
cancer: [x] n. 癌,癌症;迅速蔓延的恶劣的或危险的事物; [acc] /ˈkænsər/;
terrorist: [x] n. 恐怖主义者; [acc] /ˈterərɪst/;
drainage: [x] n. 排水;排水系统;污水;下水道; [acc] /ˈdreɪnɪdʒ/;
lounge: [x] n. 候机室,休息室,酒吧间;沙发,躺椅;懒散的步子;  v. (懒散地)倚,躺;闲逛; [acc] /laʊndʒ/;
definitely: [x] adv. 一定地,明确地;当然; [acc] /ˈdefɪnətli/;
inclination: [x] n. 点头;做.的倾向;意愿;倾斜; [acc] /ˌɪnklɪˈneɪʃn/;
administration: [x] n. 管理;管理层,管理部门;政府;(药的)配给; [acc] /ədˌmɪnɪˈstreɪʃn/;
mentality: [x] n. 脑力;思想;心理; [acc] /menˈtæləti/;
subscription: [x] n. 订阅;捐款;签署;同意;会费;  adj. 收费的; [acc] /səbˈskrɪpʃn/;
menace: [x] v. 威胁,威吓;  n. 威胁;具有危险性的人(或物); [acc] /ˈmenəs/;
groove: [x] n. [建]凹槽;最佳状态;槽;惯例;  v. 开槽于;形成沟槽; [acc] /ɡruːv/;
studio: [x] n. 摄影棚;工作室;录音室;单间公寓(studio flat);制片公司; [acc] /ˈstuːdioʊ/;
novelty: [x] n. 新奇;新奇的事物;新颖小巧而廉价的小物品;  adj. 新奇的;风格独特的; [acc] /ˈnɑːvlti/;
illiterate: [x] n. 文盲,目不识丁者;  adj. 不识字的;缺乏(某方面)知识的;语法错误的; [acc] /ɪˈlɪtərət/;
theme: [x] n. 主题;主旨;主旋律;  adj. 主题的;  v. 赋予.某种主题; [acc] /θiːm/;
preach: [x] v. 传教,布道;说教;宣扬; [acc] /priːtʃ/;
token: [x] n. 象征;礼券,代金券;筹码,代币;  adj. 象征性的; [acc] /ˈtoʊkən/;
cutter: [x] n. 刀具,切割机;小汽艇;独桅纵帆船; [acc] /ˈkʌtər/;
resolute: [x] adj. 坚决的;果断的; [acc] /ˈrezəluːt/;
expertise: [x] n. 专门知识,专门技能; [acc] /ˌekspɜːrˈtiːz/;
poll: [x] n. 投票,投票数;投票站;民意测验;  v. 获得(票数);  adj. [法]当事人一方作成的; [acc] /poʊl/;
wield: [x] v. 运用,行使;挥;  vt. 使用; [acc] /wiːld/;
device: [x] n. 器械,装置,设备;手段,策略; [acc] /dɪˈvaɪs/;
occupy: [x] v. 占领,占据,侵占;住在,居住,住进;担任(职务),任职;占用(时间,空间等),占有;使用(房屋,建筑); [acc] /ˈɑːkjupaɪ/;
disaster: [x] n. 灾难,天灾; [acc] /dɪˈzæstər/;
hinder: [x] v. 阻碍,妨碍;  adj. 后面的,后方的; [acc] /ˈhɪndər/;
donate: [x] v. 捐献;捐赠;  vi. 捐献;捐赠; [acc] /ˈdoʊneɪt/;
engagement: [x] n. 交战,战斗;约会,约定;婚约,订婚; [acc] /ɪnˈɡeɪdʒmənt/;
conduct: [x] v. 指挥;进行;实施;处理;传导(电,热等);护送;  n. 行为,举止;指挥,带领; [acc] /kənˈdʌkt/;
cosmic: [x] adj. 宇宙的;广大无边的; [acc] /ˈkɑːzmɪk/;
confusion: [x] n. 困惑;混淆;混乱;窘迫; [acc] /kənˈfjuːʒn/;
grill: [x] n. 烤架;  v. 烤;拷问; [acc] /ɡrɪl/;
avert: [x] v. 转移(目光,注意力等);防止;避开; [acc] /əˈvɜːrt/;
exposition: [x] n. 讲解;阐述;展览会,博览会; [acc] /ˌekspəˈzɪʃn/;
obscene: [x] adj. 下流的,淫秽的; [acc] /əbˈsiːn/;
dictate: [x] v. 规定;命令;口授;听写;  n. 命令;指令; [acc] /ˈdɪkteɪt/;
tackle: [x] v. 对付,处理;(足球等比赛中)阻截;  n. 阻截;钓具;滑轮(组); [acc] /ˈtækl/;
drag: [x] v. 拉,拽,拖着(沉重的步伐或疲惫的身躯);拖动,拖沓;  n. 拖,拖累物;  adj. 女穿男服的;男穿女服的;  adv. 带有女伴; [acc] /dræɡ/;
dwarf: [x] n. 侏儒;  v. 变矮;发育不全;  adj. 矮生动物或植物的;矮小的;发育不全的;  vt. 使矮小;阻碍.的发育; [acc] /dwɔːrf/;
pilgrim: [x] n. 朝圣客;香客; [acc] /ˈpɪlɡrɪm/;
conserve: [x] v. 保藏,保存;节约;  n. 蜜饯,果酱; [acc] /kənˈsɜːrv/;
inscribe: [x] v. 刻; [acc] /ɪnˈskraɪb/;
ego: [x] n. 自我;自负;自尊心; [acc] /ˈiːɡoʊ/;
peel: [x] v. 剥皮,削皮,去壳;  n. 果皮,外皮; [acc] /piːl/;
photoelectric: [x] adj. 光电的; [acc] /ˌfoʊtoʊɪˈlektrɪk/;
subdue: [x] v. 征服,压制,减轻; [acc] /səbˈduː/;
conqueror: [x] n. 征服者,胜利者; [acc] /ˈkɑːŋkərər/;
exhibit: [x] n. 展览会,陈列品;  v. 展览,陈列; [acc] /ɪɡˈzɪbɪt/;
heighten: [x] v. 加强,增加,提高; [acc] /ˈhaɪtn/;
assemble: [x] v. 装配(机器等);集合;召集; [acc] /əˈsembl/;
surge: [x] n. 波涛汹涌;波动;激增;  v. 波浪般汹涌奔腾;激增; [acc] /sɜːrdʒ/;
militant: [x] adj. 好战的,好暴力的;  n. 激进分子,斗士; [acc] /ˈmɪlɪtənt/;
conservative: [x] adj. 保守的;保守估计的;保守党的;  n. 保守主义者;保守党党员; [acc] /kənˈsɜːrvətɪv/;
jury: [x] n. 陪审团;全体评审员,评判委员会; [acc] /ˈdʒʊri/;
amateur: [x] n. 业余爱好者;外行;  adj. 外行的;业余爱好的,业余(身份)的; [acc] /ˈæmətʃər/;
clash: [x] vi. 发生冲突;发出撞击声;不合,不一致,不调和;  n. 冲突;抵触;撞击声; [acc] /klæʃ/;
severe: [x] adj. 严重的;严厉的;严酷的;剧烈的; [acc] /sɪˈvɪr/;
fabrication: [x] n. 制作;构成;捏造;伪造物;装配工; [acc] /ˌfæbrɪˈkeɪʃn/;
turnover: [x] n. 成交量;营业收入;人员更替率;半圆卷饼; [acc] /ˈtɜːrnoʊvər/;
bridle: [x] n. 马笼头,缰绳;  v. 上笼头;昂首(表傲慢,愤怒等);抑制,控制; [acc] /ˈbraɪdl/;
xerox: [x] v. 复印; [acc] /ˈzɪrɑːks/;
aggregate: [x] n. 合计;总数;混凝料;总计;  v. 集合;聚集;合计;  adj. 总的,总数的;集合的; [acc] /ˈæɡrɪɡət/;
overt: [x] adj. 明显的;公开的;公然的; [acc] /oʊˈvɜːrt/;
tulip: [x] n. [植]郁金香; [acc] /ˈtuːlɪp/;
attempt: [x] n. 尝试;企图;  vt. 努力去做;试图,尝试; [acc] /əˈtempt/;
prune: [x] n. 梅干;  v. 修剪;削减; [acc] /pruːn/;
premise: [x] n. 前提;房屋地基;  v. 假定; [acc] /ˈpremɪs/;
sensitivity: [x] n. 灵敏性;敏感; [acc] /ˌsensəˈtɪvəti/;
goddess: [x] n. 女神;绝代佳人; [acc] /ˈɡɑːdəs/;
existence: [x] n. 存在;生活方式; [acc] /ɪɡˈzɪstəns/;
majority: [x] n. 多数,大多数,多数票;法定成年年龄; [acc] /məˈdʒɔːrəti/;
score: [x] n. 得分;刻痕;二十;配乐;  vi. 刻痕;  v. 得分;  vt. 在.上刻痕; [acc] /skɔːr/;
axis: [x] n. 轴;中心线;坐标轴;基准线; [acc] /ˈæksɪs/;
hull: [x] n. (果实等的)外壳,船体;  v. 剥壳; [acc] /hʌl/;
progressive: [x] adj. 进步的;逐步的,渐进的;  n. 进步人士; [acc] /prəˈɡresɪv/;
faculty: [x] n. 教职工,全体教员;系;科;能力; [acc] /ˈfæklti/;
enchant: [x] v. 施魔法于;吸引; [acc] /ɪnˈtʃænt/;
thorn: [x] n. 刺;荆棘;带刺小灌木; [acc] /θɔːrn/;
pitch: [x] v. 投掷;用沥青覆盖;[音]为...定音高;扎营;搭帐篷;  n. 投掷;球场;沥青;音高; [acc] /pɪtʃ/;
bless: [x] v. 保佑,祝福,赐福,有幸具有; [acc] /bles/;
jerk: [x] v. 猛拉;使猝然一动;  n. 急推;急拉;蠢货;古怪的人;腌制品;  adj. 颠簸不稳的; [acc] /dʒɜːrk/;
reverse: [x] n. 失败,挫折,倒退;相反,背面;  v. 颠倒,翻转;  adj. 相反的,反面的,颠倒的; [acc] /rɪˈvɜːrs/;
booklet: [x] n. 小册子; [acc] /ˈbʊklət/;
assessment: [x] n. 评估;评价;估价; [acc] /əˈsesmənt/;
territory: [x] n. 地区,领土;版图;领域;范围;属地; [acc] /ˈterətɔːri/;
fling: [x] v. 掷,抛;猛烈地移动;投入;  n. 尽情欢乐的一阵,一时的放纵; [acc] /flɪŋ/;
overload: [x] n. 过载;过重负担;过度刺激;  v. 使超载,使过载;使负担(或负荷)过重; [acc] /ˌoʊvərˈloʊd/;
aggressive: [x] adj. 好斗的,挑衅性的;有闯劲的,积极进取的; [acc] /əˈɡresɪv/;
maintain: [x] v. 维持,保持;断言,宣称;供养,赡养; [acc] /meɪnˈteɪn/;
infant: [x] n. 幼儿,婴儿;  adj. 婴儿的;初期的,初创的; [acc] /ˈɪnfənt/;
ambitious: [x] adj. 有抱负的;雄心勃勃的;(计划,想法等)宏大的,艰巨的; [acc] /æmˈbɪʃəs/;
roundabout: [x] n. 环形路;旋转木马;  adj. 绕远道的;迂回的;转弯抹角的; [acc] /ˈraʊndəbaʊt/;
frock: [x] n. 僧袍;(妇女,小儿的连衣裙式)长衣; [acc] /frɑːk/;
cluster: [x] n. 一串;一簇;  v. 群集;丛生; [acc] /ˈklʌstər/;
juvenile: [x] n. 青少年;雏鸟;  adj. 青少年的;幼稚的; [acc] /ˈdʒuːvənl/;
monster: [x] n. 怪物,怪兽,妖怪;巨兽,巨大的东西,庞然大物;极其残酷的人,恶人,恶魔;小恶棍,捣蛋鬼〔幽默用法〕;  adj. 巨大的;庞大的; [acc] /ˈmɑːnstər/;
majesty: [x] n. 最高权威;雄伟;壮丽;帝王; [acc] /ˈmædʒəsti/;
multitude: [x] n. 大量;众多;大批;群众; [acc] /ˈmʌltɪtuːd/;
monetary: [x] adj. 货币的,金融的;金钱的; [acc] /ˈmɑːnɪteri/;
inhabitant: [x] n. 居民,住户; [acc] /ɪnˈhæbɪtənt/;
velocity: [x] n. 速度;迅速,快速; [acc] /vəˈlɑːsəti/;
comprehend: [x] v. 由.组成;了解;领会;包含; [acc] /ˌkɑːmprɪˈhend/;
devastating: [x] adj. 毁灭性的;惊人的;令人难受的; [acc] /ˈdevəsteɪtɪŋ/;
disappearance: [x] n. 失踪,消失;绝迹; [acc] /ˌdɪsəˈpɪrəns/;
compatible: [x] adj. 可和谐共存的;兼容的; [acc] /kəmˈpætəbl/;
inspection: [x] n. 检查,细看; [acc] /ɪnˈspekʃn/;
profess: [x] v. 表示,承认;宣称; [acc] /prəˈfes/;
panther: [x] n. 豹;黑豹; [acc] /ˈpænθər/;
compile: [x] v. 收集,汇编; [acc] /kəmˈpaɪl/;
recognition: [x] n. 承认,认可;认出;认识; [acc] /ˌrekəɡˈnɪʃn/;
jail: [x] n. 监狱;看守所;  v. 监禁;拘留; [acc] /dʒeɪl/;
planet: [x] n. 行星; [acc] /ˈplænɪt/;
constraint: [x] n. 限制;强迫,拘束;强制; [acc] /kənˈstreɪnt/;
sneeze: [x] n. 喷嚏;  v. 打喷嚏; [acc] /sniːz/;
expanding: [x] adj. 扩展的;详述的;  v. 扩大;扩展; [acc] /ɪkˈspændɪŋ/;
annually: [x] adv. 一年一次;每年; [acc] /ˈænjuəli/;
riot: [x] v. 闹事;  n. 骚乱;暴乱;骚动;放纵; [acc] /ˈraɪət/;
rash: [x] adj. 轻率的,鲁莽的;  n. 疹,皮疹;(短时期内)爆发的一连串; [acc] /ræʃ/;
absurd: [x] adj. 荒唐的;可笑的;不合理的;  n. 荒唐; [acc] /əbˈsɜːrd/;
wrinkle: [x] n. 皱纹,褶皱;窍门;转折,改变;  v. (使)起褶皱; [acc] /ˈrɪŋkl/;
ally: [x] n. 盟友;同盟国;(二战时的) 同盟国;  v. 结盟; [acc] /ˈælaɪ/;
dock: [x] n. 码头;船埠;被告席;  v. (船)进港;扣工资;剪短(动物的尾巴); [acc] /dɑːk/;
explicit: [x] adj. 充分表达清楚的,明确的;直率的,直截了当的;〔描绘性或暴力的语言或画面〕清晰露骨的; [acc] /ɪkˈsplɪsɪt/;
microscopic: [x] adj. 极小的;用显微镜可见的; [acc] /ˌmaɪkrəˈskɑːpɪk/;
variation: [x] n. 变异,变化,变奏曲;[生物] 变异,变种;差异; [acc] /ˌveriˈeɪʃn/;
coincidence: [x] n. 一致;巧合,巧事;同时发生; [acc] /koʊˈɪnsɪdəns/;
migration: [x] n. 迁移;移民;移动; [acc] /maɪˈɡreɪʃn/;
database: [x] n. 数据库; [acc] /ˈdeɪtəbeɪs/;
access: [x] n. 进入;使用权;通道;  v. 进入;访问; [acc] /ˈækses/;
grease: [x] n. 油脂;动物脂;润滑脂;  v. 抹油;使润滑; [acc] /ɡriːs/;
testify: [x] vt. 作证;  vi. 证明;  v. 声明;见证(上帝的存在);证实; [acc] /ˈtestɪfaɪ/;
hostess: [x] n. 女主人,女主持人,女服务员(乘务员); [acc] /ˈhoʊstəs/;
pharmacy: [x] n. 药房,药剂学,配药业,制药业,一批备用药品; [acc] /ˈfɑːrməsi/;
invoice: [x] n. 发票;  v. 开发票;记清单; [acc] /ˈɪnvɔɪs/;
skeleton: [x] n. 骨骼,梗概;骨瘦如柴的人或动物; [acc] /ˈskelɪtn/;
vice: [x] n. 缺点;恶习;邪恶;罪行;生理缺陷;  adj. 副的;代理的;  pref. 代理的;  vt. 用老虎钳夹紧;钳制; [acc] /vaɪs/;
maximum: [x] n. 最大值;最大限度;  adj. 最大的; [acc] /ˈmæksɪməm/;
spice: [x] n. 香料,调味品;额外的趣味;  v. 使增添趣味;加香料于; [acc] /spaɪs/;
economy: [x] n. 经济,经济制度;节约; [acc] /ɪˈkɑːnəmi/;
update: [x] v. 更新;为..提供最新信息;  n. 更新;最新的情况; [acc] /ˌʌpˈdeɪt/;
embryo: [x] n. [动物学]胚胎; [acc] /ˈembrioʊ/;
property: [x] n. 房产;财产;特性;性能; [acc] /ˈprɑːpərti/;
violent: [x] adj. 强烈的,猛烈的;暴力的,粗暴的; [acc] /ˈvaɪələnt/;
defendant: [x] n. 被告; [acc] /dɪˈfendənt/;
innumerable: [x] adj. 数不清的;无数的; [acc] /ɪˈnuːmərəbl/;
sensitive: [x] adj. 敏感的,过敏的;灵敏的;善解人意的,体恤的; [acc] /ˈsensətɪv/;
convince: [x] v. 使确信;使信服; [acc] /kənˈvɪns/;
tolerant: [x] adj. 容忍的,宽容的; [acc] /ˈtɑːlərənt/;
version: [x] n. 版本;译文;(某人对于某件事不同于其他人的)描述,说法; [acc] /ˈvɜːrʒn/;
emotion: [x] n. 感情;情绪;强烈的感情;激动; [acc] /ɪˈmoʊʃn/;
jack: [x] n. 千斤顶;[牌戏]J牌;插座,插口;  adj. 对..感到厌烦的;  v. 偷窃(特别是价值低的物品); [acc] /dʒæk/;
longevity: [x] n. 长寿,长命;寿命; [acc] /lɔːnˈdʒevəti/;
triumph: [x] n. 喜悦,狂喜;凯旋,胜利;  v. 成功,获胜; [acc] /ˈtraɪʌmf/;
napkin: [x] n. 纸巾,餐巾,(小孩用的)尿布; [acc] /ˈnæpkɪn/;
constitution: [x] n. 宪法,章程;组成,结构;体质,体格; [acc] /ˌkɑːnstəˈtuːʃn/;
baron: [x] n. 男爵(英国世袭的最低级的贵族爵位),大财主; [acc] /ˈbærən/;
prejudice: [x] n. 偏见;成见;损害;侵害;  vt. 使抱偏见; [acc] /ˈpredʒudɪs/;
imaginative: [x] adj. 想象的;富于想象力的;虚构的; [acc] /ɪˈmædʒɪnətɪv/;
glare: [x] v. 怒目而视;发出强光;  n. 眩目的光;瞪眼; [acc] /ɡler/;
mob: [x] n. 乌合之众,(尤指)暴民;  v. (指民众)包围(为攻击或赞赏); [acc] /mɑːb/;
declaration: [x] n. 宣言,声明书;宣布,宣告;申报; [acc] /ˌdekləˈreɪʃn/;
wasp: [x] n. 黄蜂; [acc] /wɑːsp/;
diligent: [x] adj. 勤奋的;用功的; [acc] /ˈdɪlɪdʒənt/;
decay: [x] v. 腐烂;衰退;腐朽;  n. 腐烂;衰退;腐败; [acc] /dɪˈkeɪ/;
qualitative: [x] adj. (性)质的,定性的; [acc] /ˈkwɑːləteɪtɪv/;
vast: [x] adj. 辽阔的;巨大的; [acc] /væst/;
crisp: [x] adj. 脆的,易碎的,霜冻的,干脆的;  n. 油炸马铃薯片;  v. (使)发脆; [acc] /krɪsp/;
superintendent: [x] n. 主管人,负责人;警长;监督人; [acc] /ˌsuːpərɪnˈtendənt/;
prism: [x] n. 棱镜;棱柱; [acc] /ˈprɪzəm/;
solo: [x] n. 独唱;  adj. 独奏的;单独的;  adv. 独奏地;单独地;  v. 放单飞; [acc] /ˈsoʊloʊ/;
burden: [x] n. 负担,重担;  v. 使负重,装载;烦扰; [acc] /ˈbɜːrdn/;
depress: [x] vt. 使沮丧;使萧条;压下,压低; [acc] /dɪˈpres/;
herb: [x] n. 草本植物;药草; [acc] /ɜːrb/;
alloy: [x] n. 合金;  v. 使成合金; [acc] /ˈælɔɪ/;
conviction: [x] n. 定罪;信服;坚强信念; [acc] /kənˈvɪkʃn/;
intelligent: [x] adj. 聪明的;智能的; [acc] /ɪnˈtelɪdʒənt/;
allocate: [x] v. 分配,配给; [acc] /ˈæləkeɪt/;
exemplify: [x] v. 举例说明;例示,是..的典范; [acc] /ɪɡˈzemplɪfaɪ/;
blaze: [x] vi. 熊熊燃烧;闪耀;怒视;连续射击;  vt. 大肆宣扬;  n. 火焰; [acc] /bleɪz/;
fulfill: [x] v. 履行,实现,完成;满足(愿望,要求等),使满意; [acc] /fʊl'fɪl/;
distort: [x] v. 扭曲,使变形;歪曲,曲解; [acc] /dɪˈstɔːrt/;
transit: [x] n. 运输;运送;  v. 运送;通过; [acc] /ˈtrænzɪt/;
reservation: [x] n. (住处,席位的)预订;保留态度,保留意见;(美国印第安部落的)居留地; [acc] /ˌrezərˈveɪʃn/;
humanitarian: [x] n. 慈善家;人道主义者;博爱主义者;  adj. 人道主义者的;慈善的;博爱的; [acc] /hjuːˌmænɪˈteriən/;
manifestation: [x] n. 表现,表示;显灵;示威运动; [acc] /ˌmænɪfeˈsteɪʃn/;
stab: [x] v. 刺伤;戳;  n. 刺痛;尝试,努力;一种突然强烈的感觉; [acc] /stæb/;
pressure: [x] n. 压力;压迫,[物] 压强;迫使;  v. 对..施加压力;密封; [acc] /ˈpreʃər/;
appraisal: [x] n. 评估;估价;评价; [acc] /əˈpreɪzl/;
contempt: [x] n. 轻视,鄙视; [acc] /kənˈtempt/;
audible: [x] adj. 听得见的; [acc] /ˈɔːdəbl/;
tug: [x] v. 用力拖(或拉);  n. 猛拉;牵引; [acc] /tʌɡ/;
expenditure: [x] n. (时间,金钱等的)花费,支出,消耗; [acc] /ɪkˈspendɪtʃər/;
correctly: [x] adv. 恰当地,正确地; [acc] /kəˈrektli/;
hearing: [x] n. 听觉;听距;听证会;申辩的机会;  v. 听到; [acc] /ˈhɪrɪŋ/;
tangle: [x] v. (使)缠结;(使)乱作一团;  n. 纠缠;纠结;复杂的问题;困惑; [acc] /ˈtæŋɡl/;
misfortune: [x] n. 不幸,灾祸; [acc] /ˌmɪsˈfɔːrtʃuːn/;
versatile: [x] adj. 万能的,综合的,多才多艺的; [acc] /ˈvɜːrsətl/;
gathering: [x] n. 聚会,集会; [acc] /ˈɡæðərɪŋ/;
infinitely: [x] adv. 无限地,无穷地; [acc] /ˈɪnfɪnətli/;
valid: [x] adj. 有效的,正式认可的;合理的,有根据的; [acc] /ˈvælɪd/;
warning: [x] n. 警告;预告;通知;预兆;  adj. 警告的;告诫的;引以为戒的;  v. warn的现在进行时; [acc] /ˈwɔːrnɪŋ/;
literacy: [x] n. 读写能力;识字;有文化;教养; [acc] /ˈlɪtərəsi/;
isle: [x] n. 岛,小岛; [acc] /aɪl/;
sniff: [x] n. 嗅,吸气(声);  v. 嗅,吸气; [acc] /snɪf/;
numerical: [x] adj. 数字的,用数字表示的; [acc] /nuːˈmerɪkl/;
compression: [x] n. 浓缩;压缩,压紧;[机](内燃机的)压缩冲程; [acc] /kəmˈpreʃn/;
transverse: [x] adj. 横向的;横断的; [acc] /ˈtrænzvɜːrs/;
counterpart: [x] n. 对应的人(物);副本;对手; [acc] /ˈkaʊntərpɑːrt/;
enlighten: [x] v. 启发,开导; [acc] /ɪnˈlaɪtn/;
overwhelm: [x] v. 压垮;不知所措;淹没;打败,压倒; [acc] /ˌoʊvərˈwelm/;
accessory: [x] n. (妇女的)装饰品;附件;附属物;同谋;  adj. 附属的;辅助的;同谋的; [acc] /əkˈsesəri/;
cult: [x] n. 异教;风尚,热潮;信徒;  adj. 流行的;风靡一时的; [acc] /kʌlt/;
boring: [x] adj. 令人厌烦的;单调的;无聊的,乏味的; [acc] /ˈbɔːrɪŋ/;
betray: [x] v. 背叛;失信于;泄露(秘密等);(非故意地)暴露; [acc] /bɪˈtreɪ/;
gorgeous: [x] adj. 绚丽的;极好的;令人愉快的; [acc] /ˈɡɔːrdʒəs/;
sediment: [x] n. 沉渣,沉淀物,沉淀; [acc] /ˈsedɪmənt/;
assimilate: [x] v. 使同化;吸收;消化; [acc] /əˈsɪməleɪt/;
moan: [x] n. 呻吟声;呜咽声;怨声;牢骚;  v. 呻吟;呜咽;抱怨;发牢骚; [acc] /moʊn/;
nightmare: [x] n. 噩梦;可怕的情景;  adj. 可怕的,噩梦似的; [acc] /ˈnaɪtmer/;
target: [x] n. 目标;靶子;  v. 瞄准; [acc] /ˈtɑːrɡɪt/;
afford: [x] v. 买得起;抽得出时间;担负得起;提供;产生;赐予;  vi. 担负得起;买得起; [acc] /əˈfɔːrd/;
complexity: [x] n. 复杂,复杂的事物,复杂性; [acc] /kəmˈpleksəti/;
soar: [x] v. 高飞,翱翔;飞腾;猛增;高飞越过;  n. 高飞;高涨; [acc] /sɔːr/;
stride: [x] v. 大步走;越过;跨越;  vt. 大步走过;跨骑在.上;  n. 大步;阔步行走的姿势;一大步;跨越;正常的进展; [acc] /straɪd/;
criticism: [x] n. 批评;批判;评论; [acc] /ˈkrɪtɪsɪzəm/;
champion: [x] n. 冠军;拥护者,战士;  v. 拥护;保卫;为..而斗争;  adj. 夺得第一名的;优胜的; [acc] /ˈtʃæmpiən/;
vicinity: [x] n. 附近地区;近邻;附近; [acc] /vəˈsɪnəti/;
rap: [x] n. 饶舌歌;  v. 轻敲;表演说唱;严厉批评; [acc] /ræp/;
suspension: [x] n. 悬浮;暂停;停职; [acc] /səˈspenʃn/;
propagate: [x] v. 繁殖,增殖;  vt. 传播,宣传; [acc] /ˈprɑːpəɡeɪt/;
divert: [x] v. 使转向,使改道(或绕道);转移,转移.的注意力;使娱乐,使消遣; [acc] /daɪˈvɜːrt/;
ethical: [x] adj. 伦理的;道德的;凭处方出售的;  n. 处方药; [acc] /ˈeθɪkl/;
notorious: [x] adj. 臭名昭著的,声名狼藉的; [acc] /noʊˈtɔːriəs/;
orbit: [x] v. 环绕..的轨道运行;  n. 轨道;  vi. 环绕..的轨道运行; [acc] /ˈɔːrbɪt/;
derive: [x] v. 获取;得自;起源; [acc] /dɪˈraɪv/;
positive: [x] adj. 积极的;肯定的,明确的;正面的;阳性的;  n. 正面;肯定;优点;正数; [acc] /ˈpɑːzətɪv/;
shrine: [x] n. 神殿,神祠,圣地; [acc] /ʃraɪn/;
wardrobe: [x] n. 衣橱;全部服装;剧服; [acc] /ˈwɔːrdroʊb/;
critic: [x] n. 评论家,批判者;挑剔的人; [acc] /ˈkrɪtɪk/;
significant: [x] adj. 重大的,有意义的;意味深长的;数量相当大的;  n. 象征,标志; [acc] /sɪɡˈnɪfɪkənt/;
molecule: [x] n. 分子,微粒; [acc] /ˈmɑːlɪkjuːl/;
reed: [x] n. 芦苇;苇丛;芦笛;牧笛; [acc] /riːd/;
prominent: [x] adj. 突起的,显眼的;突出的,杰出的; [acc] /ˈprɑːmɪnənt/;
differentiate: [x] v. 使有差异;区别; [acc] /ˌdɪfəˈrenʃieɪt/;
retard: [x] v. 延迟,使减速;  n. 妨碍,阻碍; [acc] /rɪˈtɑːrd/;
porch: [x] n. 门廊;走廊; [acc] /pɔːrtʃ/;
excerpt: [x] n. 摘录,节选;  v. 摘,选;引用; [acc] /ˈeksɜːrpt/;
stroll: [x] n. 漫步;散步;闲荡;溜达;  vi. 散步;  vt. 溜达;游荡;在.散步;在.漫步; [acc] /stroʊl/;
snob: [x] n. 势利小人;假行家; [acc] /snɑːb/;
psychological: [x] adj. 心理的,心理学的; [acc] /ˌsaɪkəˈlɑːdʒɪkl/;
compromise: [x] n. 妥协;折中;  v. 妥协;使遭受危害; [acc] /ˈkɑːmprəmaɪz/;
modification: [x] n. 修改,改进,改造; [acc] /ˌmɑːdɪfɪˈkeɪʃn/;
demonstrate: [x] vt. (用实例,实验)论证;演示,展示;示范;  vi. 示威; [acc] /ˈdemənstreɪt/;
expedition: [x] n. 远征队;探险;短途旅行;迅速; [acc] /ˌekspəˈdɪʃn/;
expose: [x] v. 暴露;揭露;使遭受; [acc] /ɪkˈspoʊz/;
potential: [x] n. 潜力,潜能;  adj. 潜在的,可能的; [acc] /pəˈtenʃl/;
wealth: [x] n. 财富;财产;大量; [acc] /welθ/;
elemental: [x] adj. 基本的;自然力的; [acc] /ˌelɪˈmentl/;
charm: [x] n. 魅力,吸引力,符咒;  v. (使)着迷,施魔法; [acc] /tʃɑːrm/;
undesirable: [x] adj. 令人不悦的;讨厌的;  n. 不受欢迎的人;不良分子; [acc] /ˌʌndɪˈzaɪərəbl/;
pesticide: [x] n. 杀虫剂;农药; [acc] /ˈpestɪsaɪd/;
eagle: [x] n. 鹰,老鹰;鹰状标志;(高尔夫球赛中)少击两棒入穴的成绩;  vt. (高尔夫球赛中)比标准杆数少击两杆入; [acc] /ˈiːɡl/;
thrifty: [x] adj. 节省的,节俭的; [acc] /ˈθrɪfti/;
gamble: [x] v. 赌博;投机;打赌;  n. 赌博;冒险;  vt. 赌输; [acc] /ˈɡæmbl/;
mobile: [x] n. 风铃,悬挂饰物;手机,移动电话;  adj. 可移动的;行动方便的; [acc] /ˈmoʊbl/;
various: [x] adj. 各种各样的;不同的; [acc] /ˈveriəs/;
bleed: [x] vi. 流血;散开;  vt. 榨取,敲诈;使流血;使..排出液体;  n. 出血;  adj. [印]出血版的; [acc] /bliːd/;
terrific: [x] adj. 极好的;可怕的;(尺寸或程度)极其巨大的,大的惊人的; [acc] /təˈrɪfɪk/;
granite: [x] n. 花岗岩; [acc] /ˈɡrænɪt/;
bugle: [x] n. 军号,喇叭;  vi. 吹号;  vt. 吹冲锋号; [acc] /ˈbjuːɡl/;
shaft: [x] n. 柄;轴;杆状物;  v. 苛刻地对待;  vt. 给.装杆; [acc] /ʃæft/;
statistics: [x] n. 统计;统计数字,数据;统计学; [acc] /stəˈtɪstɪks/;
heir: [x] n. 继承人;后继者; [acc] /er/;
fret: [x] v. 使烦恼,使焦急;使腐蚀;使磨损;  n. (斑卓琴,吉他,曼陀林琴等弦乐器指板上定音的)档;侵蚀; [acc] /fret/;
notion: [x] n. 概念,观念;观点,看法;突然的念头;意图; [acc] /ˈnoʊʃn/;
abuse: [x] v. 虐待;辱骂;(对麻醉毒品,兴奋剂等的)非法服用;滥用;  n. 滥用;虐待;辱骂; [acc] /əˈbjuːs/;
radioactive: [x] adj. 放射性的; [acc] /ˌreɪdioʊˈæktɪv/;
inflict: [x] v. 使遭受(损伤,痛苦等);使承担(负担等); [acc] /ɪnˈflɪkt/;
performance: [x] n. 表演,演出;表现;执行;性能; [acc] /pərˈfɔːrməns/;
upright: [x] adj. 垂直的;正直的;  adv. 直立地;  n. 立柱; [acc] /ˈʌpraɪt/;
incur: [x] v. 遭受;招致;引起; [acc] /ɪnˈkɜːr/;
visa: [x] n. 签证; [acc] /ˈviːzə/;
decade: [x] n. 十年,十年间; [acc] /ˈdekeɪd/;
intonation: [x] n. 声调;语调; [acc] /ˌɪntəˈneɪʃn/;
pneumatic: [x] adj. 装满空气的;风力的; [acc] /nuːˈmætɪk/;
anniversary: [x] n. 周年纪念日;  adj. 周年的,(有关)周年纪念的; [acc] /ˌænɪˈvɜːrsəri/;
agent: [x] n. 政府特工;代理商,代理人; [acc] /ˈeɪdʒənt/;
paralysis: [x] n. 瘫痪(症),麻痹(症); [acc] /pəˈræləsɪs/;
marsh: [x] n. 湿地;沼泽; [acc] /mɑːrʃ/;
undermine: [x] v. 暗中破坏;逐渐削弱;侵蚀.的基础;在...下挖坑道,从根基处损害; [acc] /ˌʌndərˈmaɪn/;
communication: [x] n. 沟通方式;交流,通讯;信息; [acc] /kəˌmjuːnɪˈkeɪʃn/;
enclosure: [x] n. 四周有篱笆(或围墙等)的场所,围场;(信中的)附件; [acc] /ɪnˈkloʊʒər/;
fantasy: [x] n. 幻想,想象;幻想作品;  vi. 奏幻想曲;  vt. 想像;幻想;  adj. 虚幻的; [acc] /ˈfæntəsi/;
inaugurate: [x] v. 为..揭幕;为.举行就职典礼;开展; [acc] /ɪˈnɔːɡjəreɪt/;
blunder: [x] n. 愚蠢之举;大错;  vi. 犯大错;  v. 失策;绊倒; [acc] /ˈblʌndər/;
groan: [x] v. 呻吟;抱怨;  n. 呻吟; [acc] /ɡroʊn/;
transistor: [x] n. 晶体管;半导体收音机; [acc] /trænˈzɪstər/;
respond: [x] vi. 作答;对..有效果;做出反应;  v. 回应; [acc] /rɪˈspɑːnd/;
snobbish: [x] adj. 自命不凡的,势利的; [acc] /ˈsnɑːbɪʃ/;
inject: [x] v. 给.注射;注入;引入;射入轨道; [acc] /ɪnˈdʒekt/;
lattice: [x] n. 格子架; [acc] /ˈlætɪs/;
liner: [x] n. 眼线笔;班轮;班机;内衬; [acc] /ˈlaɪnər/;
revision: [x] n. 修订;修改;修订本;复习; [acc] /rɪˈvɪʒn/;
devour: [x] v. 狼吞虎咽;毁灭;贪婪地看,贪婪地阅读; [acc] /dɪˈvaʊər/;
undue: [x] adj. 过分的,不适当的;过度的;尚未到期的; [acc] /ˌʌnˈduː/;
watchful: [x] adj. 注意的,警惕的; [acc] /ˈwɑːtʃfl/;
objective: [x] n. 目标;目的;  adj. 客观的; [acc] /əbˈdʒektɪv/;
nun: [x] n. 修女,尼姑; [acc] /nʌn/;
layer: [x] n. 层;层次;阶层;  v. 把.分层堆放;借助压条法;将(头发)剪成不同层次; [acc] /ler/;
exceed: [x] v. 超过;胜过;超出; [acc] /ɪkˈsiːd/;
trot: [x] v. (使)小跑,(使)快步走,骑马小跑,疾走;  n. 小跑,骑马,疾走;忙碌; [acc] /trɑːt/;
authentic: [x] adj. 真实的;真正的;可靠的; [acc] /ɔːˈθentɪk/;
ridicule: [x] v. 嘲笑,愚弄;  n. 嘲笑,愚弄; [acc] /ˈrɪdɪkjuːl/;
enthusiastic: [x] adj. 狂热的,极感兴趣的,热情的; [acc] /ɪnˌθuːziˈæstɪk/;
construct: [x] v. 建造;作(图);构筑;  n. 概念;构筑物;结构体;建造物; [acc] /kənˈstrʌkt/;
quantitative: [x] adj. 定量的; [acc] /ˈkwɑːntəteɪtɪv/;
court: [x] n. 法院,法庭;庭院;球场;宫廷;  v. 讨好,取悦;招致危险;追求; [acc] /kɔːrt/;
liability: [x] n. 责任;债务;倾向;可能性;不利因素;惹麻烦的人(或事); [acc] /ˌlaɪəˈbɪləti/;
impair: [x] v. 损害;削弱; [acc] /ɪmˈper/;
supplement: [x] n. 增补,补充物,保健品;附录;  v. 补充; [acc] /ˈsʌplɪmənt/;
trial: [x] n. 审判,审理;试验;试用;磨炼,苦难;  adj. 试验的,试验性的;考验的;审判的;  v. 测试; [acc] /ˈtraɪəl/;
acknowledge: [x] v. 告知收到;对(人)打招呼,招呼(某人)以示相识,致意;就..表示谢忱,鸣谢,感谢,感激,答谢,对..表示感谢;承认(属实),承认(权威,地位); [acc] /əkˈnɑːlɪdʒ/;
utensil: [x] n. 工具,(厨房)用具; [acc] /juːˈtensl/;
divorce: [x] n. 离婚,离异;  v. 离婚; [acc] /dɪˈvɔːrs/;
partition: [x] n. 划分;隔开物,隔墙,隔板;  v. 隔开;  vt. 瓜分;分割; [acc] /pɑːrˈtɪʃn/;
avoid: [x] v. 躲开,避开;避免,防止; [acc] /əˈvɔɪd/;
transfer: [x] v. 转移;调任;换乘;转变;改编;  n. 转让;转移;调任;汇兑; [acc] /trænsˈfɜːr/;
destine: [x] v. 注定;预定; [acc] /'destɪn/;
invest: [x] v. 投资,投入;赋予,给予; [acc] /ɪnˈvest/;
lighter: [x] n. 打火机; [acc] /ˈlaɪtər/;
function: [x] n. 功能,作用;函数;应变量;盛大聚会;职务,职责;  v. 起作用;正常运转; [acc] /ˈfʌŋkʃn/;
certainty: [x] n. 必然;确信;必然的事; [acc] /ˈsɜːrtnti/;
machinery: [x] n. 机器,机关;机构,机制; [acc] /məˈʃiːnəri/;
grope: [x] v. 摸索,探索,动手动脚; [acc] /ɡroʊp/;
unfit: [x] adj. 不适宜的,不合适的;不适当的;不健康的;  v. 不适合; [acc] /ʌnˈfɪt/;
adequate: [x] adj. 充足的,充分的,足够的;尚可的,过得去的; [acc] /ˈædɪkwət/;
slim: [x] adj. 细长的;苗条的;  v. (用运动,节食等)减轻体重,变苗条; [acc] /slɪm/;
clarity: [x] n. 清楚;清澈; [acc] /ˈklærəti/;
hesitate: [x] v. 犹豫,踌躇;含糊,支吾,有顾虑; [acc] /ˈhezɪteɪt/;
monologue: [x] n. 独白,个人长篇演说; [acc] /ˈmɑːnəlɔːɡ/;
gown: [x] n. 女礼服;女裙服;长袍; [acc] /ɡaʊn/;
commodity: [x] n. 商品,货物; [acc] /kəˈmɑːdəti/;
opponent: [x] n. 对手,敌手,对抗者;  adj. 对立的;敌对的; [acc] /əˈpoʊnənt/;
immerse: [x] v. 沉浸,沉浸于;使陷入; [acc] /ɪˈmɜːrs/;
capability: [x] n. (实际)能力,性能,容量,接受力; [acc] /ˌkeɪpəˈbɪləti/;
electrician: [x] n. 电工;电气技师; [acc] /ɪˌlekˈtrɪʃn/;
resolve: [x] n. 决心;  v. 解决,决定,表决; [acc] /rɪˈzɑːlv/;
vital: [x] adj. 生命所必需的;必不可少的;至关重要的;有活力的;生命攸关的;  n. 要害;重要部分; [acc] /ˈvaɪtl/;
sculpture: [x] n. 雕刻艺术;雕刻,雕塑; [acc] /ˈskʌlptʃər/;
abnormal: [x] adj. 反常的;畸形的; [acc] /æbˈnɔːrml/;
confinement: [x] n. 限制;监禁;分娩; [acc] /kənˈfaɪnmənt/;
installment: [x] n. 分期付款;部分;安装,安置; [acc] /ɪnˈstɔlmənt/;
issue: [x] n. 问题;议题;发行物;子女;  v. 发行;发布;分配,分发,给; [acc] /ˈɪʃuː/;
describe: [x] v. 描述;形容; [acc] /dɪˈskraɪb/;
elementary: [x] adj. 基本的;初级的;非常简单的; [acc] /ˌelɪˈmentri/;
atlas: [x] n. 地图集; [acc] /ˈætləs/;
finely: [x] adv. 细小地;美好地; [acc] /ˈfaɪnli/;
mutter: [x] n. 低语;小声抱怨;  v. 低声说;小声抱怨;  vt. 低声说;抱怨地说; [acc] /ˈmʌtər/;
eligible: [x] adj. 适合被选的,符合条件的;(尤指婚姻等)合适的,合意的; [acc] /ˈelɪdʒəbl/;
blacksmith: [x] n. 锻工;铁匠; [acc] /ˈblæksmɪθ/;
anode: [x] n. (电)阳极,负极; [acc] /ˈænoʊd/;
interpret: [x] v. 口译;解释;把..理解为; [acc] /ɪnˈtɜːrprɪt/;
disconnect: [x] v. 断开,拆开,使分离; [acc] /ˌdɪskəˈnekt/;
adverse: [x] adj. 不利的;(方向上)逆的;在相反的方向上移动(或运转);相反的; [acc] /ˈædvɜːrs/;
authoritative: [x] adj. 权威性的;可信的;命令式的,专断的; [acc] /əˈθɔːrəteɪtɪv/;
desolate: [x] adj. 荒凉的;孤单寂寞的; [acc] /ˈdesələt/;
offense: [x] n. 犯罪,冒犯,过错,触怒,犯规,进攻; [acc] /əˈfens/;
priority: [x] n. 优先;优先权;优先考虑的事;重要事项; [acc] /praɪˈɔːrəti/;
overhear: [x] v. 无意中听到,偷听到; [acc] /ˌoʊvərˈhɪr/;
evaluate: [x] v. 评价;评估; [acc] /ɪˈvæljueɪt/;
acquaint: [x] v. 使熟悉;使认识;介绍; [acc] /əˈkweɪnt/;
behave: [x] v. 举动;举止端正(或良好,适当); [acc] /bɪˈheɪv/;
datum: [x] n. 数据,资料; [acc] /ˈdeɪtəm/;
buck: [x] n. 雄鹿;年轻男士;美元;  v. 反对;马弓背踢后腿挑起; [acc] /bʌk/;
represent: [x] v. 代表;象征;表示;描述;阐明;说明;演绎; [acc] /ˌreprɪˈzent/;
junction: [x] n. 连接,接合;接合处;路口; [acc] /ˈdʒʌŋkʃn/;
anxiety: [x] n. 焦虑;忧虑;担心; [acc] /æŋˈzaɪəti/;
insist: [x] v. 坚持;坚持要求;坚持认为; [acc] /ɪnˈsɪst/;
discrepancy: [x] n. 不一致,差异,不符; [acc] /dɪsˈkrepənsi/;
reject: [x] v. 拒绝;抵制;  n. 废品;次品;不合格者;被剔除者; [acc] /rɪˈdʒekt/;
imaginary: [x] adj. 想象的,虚构的,假想的; [acc] /ɪˈmædʒɪneri/;
obscure: [x] v. 隐藏,使.模糊;使变暗;遮掩;  adj. 不清楚的;难以理解的;  n. 某种模糊的或不清楚的东西; [acc] /əbˈskjʊr/;
cast: [x] v. 投;抛下,投射(光线和阴影);瞥,飞快看(一眼),扫视;掷;放钓;投票;选定演员;  n. 投掷物;铸件;演员表,演员阵容; [acc] /kæst/;
ordinarily: [x] adv. 普通;通常; [acc] /ˌɔːrdnˈerəli/;
ascertain: [x] v. 探知,弄清,查明(真相等); [acc] /ˌæsərˈteɪn/;
define: [x] v. 给(词,短语等)下定义;使明确;规定;下定义,构成释义; [acc] /dɪˈfaɪn/;
incredible: [x] adj. 不可相信的;惊人的,不可思议的; [acc] /ɪnˈkredəbl/;
sponge: [x] n. 海绵,多孔布丁,松蛋糕;  v. 用湿海绵(或布)擦,揩; [acc] /spʌndʒ/;
destiny: [x] n. 命运,天数,天命; [acc] /ˈdestəni/;
appearance: [x] n. 外貌,外表;到达,抵达;公开露面;出版,发表,刊登; [acc] /əˈpɪrəns/;
shipment: [x] n. 装载的货物;装船;装运;装货量; [acc] /ˈʃɪpmənt/;
compete: [x] v. 参加比赛;竞争,对抗; [acc] /kəmˈpiːt/;
destruction: [x] n. 破坏,毁灭,灭亡; [acc] /dɪˈstrʌkʃn/;
principle: [x] n. 原则,原理;理由,信条; [acc] /ˈprɪnsəpl/;
speculate: [x] vi. 推测,猜测;投机,做投机买卖;  vt. 推测; [acc] /ˈspekjuleɪt/;
settlement: [x] n. 解决;结算;协议;定居; [acc] /ˈsetlmənt/;
postulate: [x] v. 假定.是真的;  n. 假定; [acc] /ˈpɑːstʃəleɪt/;
questionable: [x] adj. 可疑的,不可靠的; [acc] /ˈkwestʃənəbl/;
Saturn: [x] n. [天]土星; [acc] /ˈsætɜːrn/;
streak: [x] n. 条纹,条痕,色线;  v. 裸奔;成条纹; [acc] /striːk/;
exclusively: [x] adv. 专门地;特定地;排外地;仅仅; [acc] /ɪkˈskluːsɪvli/;
petty: [x] adj. 价值不大的;小的;器量小的;琐碎的; [acc] /ˈpeti/;
entrepreneur: [x] n. 企业家,演出承包人; [acc] /ˌɑːntrəprəˈnɜːr/;
rectangle: [x] n. 长方形,矩形; [acc] /ˈrektæŋɡl/;
interface: [x] n. 界面;[地质]分界面,接触面;  v. 相互作用(或影响);交流,交谈; [acc] /ˈɪntərfeɪs/;
purify: [x] v. 净化;提纯; [acc] /ˈpjʊrɪfaɪ/;
possess: [x] v. 拥有,占有;缠住,迷住;支配; [acc] /pəˈzes/;
ripple: [x] n. 涟漪,波纹;  v. (使)泛起层层细浪; [acc] /ˈrɪpl/;
decimal: [x] n. 小数;  adj. 小数的;十进制的; [acc] /ˈdesɪml/;
ingredient: [x] n. (烹调的)原料;(构成的)要素,因素; [acc] /ɪnˈɡriːdiənt/;
amends: [x] n. 赔偿;赔罪; [acc] /əˈmendz/;
fund: [x] n. 资金,基金;存款;  v. 拨款,提供基金; [acc] /fʌnd/;
morality: [x] n. 道德,道德观;道德规范,伦理体系; [acc] /məˈræləti/;
comedy: [x] n. 喜剧,有趣的事情; [acc] /ˈkɑːmədi/;
blank: [x] adj. (纸等)空白的,茫然的;  n. 空白,空白处;  v. 忽视; [acc] /blæŋk/;
consume: [x] v. 消耗,耗尽;  vt. 吃光,喝光;毁灭; [acc] /kənˈsuːm/;
suppress: [x] v. 镇压;禁止发表;抑制(感情等);阻止.的生长; [acc] /səˈpres/;
sympathetic: [x] adj. 有同情心的,同情的;支持的;称心的; [acc] /ˌsɪmpəˈθetɪk/;
tenure: [x] n. 任期;终身职位; [acc] /ˈtenjər/;
damn: [x] excl. 该死,讨厌;  v. 诅咒;  n. 诅咒;  adj. 该死的;完全的;  adv. (表示厌烦)该死;非常; [acc] /dæm/;
symmetry: [x] n. 对称;均衡; [acc] /ˈsɪmətri/;
invert: [x] v. 倒置;倒转;颠倒; [acc] /ɪnˈvɜːrt/;
compact: [x] adj. 小巧的,小型的,袖珍的,体积小的;紧密的,紧凑的,密集的;  v. 把..压紧;变得坚实;  n. 带镜小粉盒;合约,条约; [acc] /ˈkɑːmpækt/;
demand: [x] n. 要求(坚决的),需求;  v. 强烈要求,需要; [acc] /dɪˈmænd/;
feminine: [x] adj. 女性的,娇柔的;  n. 女性;温柔的女性;[语]阴性,阴性词; [acc] /ˈfemənɪn/;
reap: [x] v. 收割;获得;收获; [acc] /riːp/;
solitary: [x] adj. 孤独的,单独的,隐居的;  n. 独居者,隐士;单独禁闭; [acc] /ˈsɑːləteri/;
magnify: [x] v. 放大,扩大;夸大,夸张; [acc] /ˈmæɡnɪfaɪ/;
surplus: [x] adj. 过剩的,多余的;  n. 过剩,盈余;顺差; [acc] /ˈsɜːrplʌs/;
instructive: [x] adj. 有教育意义的; [acc] /ɪnˈstrʌktɪv/;
distract: [x] v. 使分心,转移(注意力),分散(思想); [acc] /dɪˈstrækt/;
compel: [x] v. 强迫;迫使屈服;(使)不得已; [acc] /kəmˈpel/;
cord: [x] n. 细绳,索,(电工学)电绳;索,(电工学)电绳; [acc] /kɔːrd/;
strategic: [x] adj. 战略(上)的,对全局有重要意义的,关键的; [acc] /strəˈtiːdʒɪk/;
flutter: [x] n. 激动不安,紧张;  v. 飘动,飘扬;(鸟等)振翼,拍翅而飞;  vi. (心脏等)快速跳动; [acc] /ˈflʌtər/;
slope: [x] n. 山坡,斜坡,倾斜;  v. 倾斜; [acc] /sloʊp/;
phenomenon: [x] n. 现象;奇迹,奇事,奇才; [acc] /fəˈnɑːmɪnən/;
dominant: [x] adj. 主要的,占优势的,支配的,统治的;显性基因的; [acc] /ˈdɑːmɪnənt/;
glide: [x] v. 滑翔;滑动;  n. 滑音,延音;滑行; [acc] /ɡlaɪd/;
deficient: [x] adj. 有缺陷的;不足的,不充足的;  n. 有缺陷的人[东西]; [acc] /dɪˈfɪʃnt/;
sheriff: [x] n. 警长,郡治安官,州长; [acc] /ˈʃerɪf/;
sovereign: [x] adj. 至高无上的,具有独立主权的,有最高统治权的;  n. 最高统治者,君主,元首; [acc] /ˈsɑːvrən/;
medieval: [x] adj. 中世纪的,中古(时代)的; [acc] /ˌmediˈiːvl/;
conceit: [x] n. 自负;狂妄;想法,观点;构想,幻想; [acc] /kənˈsiːt/;
bull: [x] n. 公牛,雄性的鲸,象等大动物; [acc] /bʊl/;
harassment: [x] n. 骚扰;扰乱;烦恼事; [acc] /həˈræsmənt/;
trifle: [x] n. 蛋糕;琐事,小事,无价值的东西;  v. 嘲笑,轻视; [acc] /ˈtraɪfl/;
lick: [x] v. 舔;卷烧;战胜;使无法理解;轻轻拍打;  vi. 舔;  n. 舔;舌头一次舔的量;狠揍; [acc] /lɪk/;
formula: [x] n. 公式,方程式;配方;方案;方法;配方奶; [acc] /ˈfɔːrmjələ/;
negative: [x] adj. 消极的,负面的;否定的;  n. 否定,否定词;底片; [acc] /ˈneɡətɪv/;
frustrate: [x] v. 使灰心;挫败;阻挠; [acc] /ˈfrʌstreɪt/;
reign: [x] v. 占主导地位,统治,当政;  n. (君主)统治时期; [acc] /reɪn/;
watt: [x] n. 瓦,瓦特; [acc] /wɑːt/;
minibus: [x] n. 小型公共汽车,小型巴士; [acc] /ˈmɪnibʌs/;
electric: [x] adj. 电的,电动的,带电的;刺激的;  n. 供电; [acc] /ɪˈlektrɪk/;
plunder: [x] v. 抢劫,掠夺;  n. 抢劫,战利品; [acc] /ˈplʌndər/;
recite: [x] vi. 背诵;朗诵;  vt. 背诵;朗诵;叙述;列举; [acc] /rɪˈsaɪt/;
infectious: [x] adj. 传染的;感染性的;易传播的; [acc] /ɪnˈfekʃəs/;
interaction: [x] n. 互动;相互作用,相互影响; [acc] /ˌɪntərˈækʃn/;
posture: [x] n. 姿势;看法;态度;  v. 装模作样; [acc] /ˈpɑːstʃər/;
discrete: [x] adj. 分开的;不连续的; [acc] /dɪˈskriːt/;
institution: [x] n. 机构;制度;惯例;习俗;建立,设立,制定; [acc] /ˌɪnstɪˈtuːʃn/;
solidarity: [x] n. 团结一致; [acc] /ˌsɑːlɪˈdærəti/;
gravitation: [x] n. 重力;万有引力;地心吸力; [acc] /ˌɡrævɪˈteɪʃn/;
journalist: [x] n. 记者,新闻工作者; [acc] /ˈdʒɜːrnəlɪst/;
boost: [x] v. 增加;偷盗;  n. 提高;激励;后推;助推发动机; [acc] /buːst/;
clatter: [x] n. 咔嗒;哗啦声;嘈杂的谈笑声;  v. 发出哗啦声;喧闹的谈笑; [acc] /ˈklætər/;
budget: [x] n. 预算;  v. 预算,安排;  adj. 廉价的; [acc] /ˈbʌdʒɪt/;
scared: [x] adj. 害怕的,恐惧的; [acc] /skerd/;
underestimate: [x] v. 低估;对.估计不足; [acc] /ˌʌndərˈestɪmeɪt/;
constant: [x] adj. 不变的,始终如一的;持续不断的;  n. 常数,恒量; [acc] /ˈkɑːnstənt/;
complain: [x] v. 抱怨;诉苦;申诉;控诉;诉说;控告;  vt. 申诉;  n. 抱怨,诉苦; [acc] /kəmˈpleɪn/;
economical: [x] adj. 节约的;经济的;合算的; [acc] /ˌekəˈnɑːmɪkl/;
alarm: [x] n. 警报器,警报;闹钟;惊恐,忧虑;  v. 使惊恐,使忧虑; [acc] /əˈlɑːrm/;
reconcile: [x] v. 和解;调解;调和; [acc] /ˈrekənsaɪl/;
millionaire: [x] n. 百万富翁,大富翁; [acc] /ˌmɪljəˈner/;
bearing: [x] n. 方向;举止;轴承; [acc] /ˈberɪŋ/;
recession: [x] n. (经济)衰退,不景气;后退,撤回;凹处; [acc] /rɪˈseʃn/;
watertight: [x] adj. 不透水的;无懈可击的; [acc] /ˈwɔːtərtaɪt/;
enforce: [x] v. 实施;执行;强制; [acc] /ɪnˈfɔːrs/;
torpedo: [x] n. 鱼雷;油井爆破筒;  v. 用鱼雷进攻,破坏; [acc] /tɔːrˈpiːdoʊ/;
fluctuation: [x] n. 波动;起伏; [acc] /ˌflʌktʃuˈeɪʃn/;
recruit: [x] v. 招募(新兵),招收(新成员);  n. 新兵,新成员; [acc] /rɪˈkruːt/;
depression: [x] n. 抑郁,沮丧;不景气,萧条(期);洼地,凹陷; [acc] /dɪˈpreʃn/;
mediterranean: [x] adj. 地中海的;地中海地区的; [acc] /ˌmedɪtə'reɪniən/;
fraction: [x] n. 部分,片断,碎片;分数; [acc] /ˈfrækʃn/;
descent: [x] n. 下降,下倾;血统,世系;斜坡,坡道; [acc] /dɪˈsent/;
correlation: [x] n. 相互关系,相关(性); [acc] /ˌkɔːrəˈleɪʃn/;
slide: [x] n. 滑行;下落;滑面;幻灯片;  v. 使滑动;使滑入;滑动;滑倒;滑落;下跌; [acc] /slaɪd/;
coalition: [x] n. 结合;联盟;联合; [acc] /ˌkoʊəˈlɪʃn/;
violate: [x] v. 违反,违背;侵犯,妨碍;亵渎; [acc] /ˈvaɪəleɪt/;
humidity: [x] n. 潮湿;湿气;湿度; [acc] /hjuːˈmɪdəti/;
intercourse: [x] n. 交流;性交; [acc] /ˈɪntərkɔːrs/;
spectator: [x] n. 旁观者;观众;目击者; [acc] /ˈspekteɪtər/;
locust: [x] n. 蝗虫; [acc] /ˈloʊkəst/;
spontaneous: [x] adj. 自发的,无意识的;自然的,天真率直的; [acc] /spɑːnˈteɪniəs/;
cartoon: [x] n. 卡通(片),动画片;(尤指报刊上讽刺政客或时事的)漫画,幽默画; [acc] /kɑːrˈtuːn/;
symmetrical: [x] adj. 对称的; [acc] /sɪˈmetrɪkl/;
doctrine: [x] n. 教条,学说,信条,原则; [acc] /ˈdɑːktrɪn/;
terrace: [x] n. 阳台;梯田;走廊;  vi. 成阶地;  adj. 梯形的;  vt. 使成梯田; [acc] /ˈterəs/;
persevere: [x] v. 坚持,不屈不挠; [acc] /ˌpɜːrsəˈvɪr/;
periodical: [x] n. 期刊;杂志; [acc] /ˌpɪriˈɑːdɪkl/;
spokesman: [x] n. 发言人; [acc] /ˈspoʊksmən/;
configuration: [x] n. 配置,布局,构造; [acc] /kənˌfɪɡjəˈreɪʃn/;
transient: [x] adj. 短暂的,路过的;转瞬即逝的;  n. 过客; [acc] /ˈtrænʃnt/;
outfit: [x] n. 装备,全部用品,(协同工作)的一组人;  v. 提供装备; [acc] /ˈaʊtfɪt/;
artillery: [x] n. 大炮,炮兵; [acc] /ɑːrˈtɪləri/;
consul: [x] n. 领事; [acc] /ˈkɑːnsl/;
smuggle: [x] v. 非法偷运;走私; [acc] /ˈsmʌɡl/;
continuity: [x] n. 连续性;(电影或电视节目中)镜头的连接,衔接; [acc] /ˌkɑːntəˈnuːəti/;
eternal: [x] adj. 永恒的,永不改变的; [acc] /ɪˈtɜːrnl/;
linger: [x] v. 逗留,留恋; [acc] /ˈlɪŋɡər/;
paperback: [x] n. 平装书,平装本,简装本;  adj. 纸面装订的,平装本的;  v. 以平装本(或纸面本)出版; [acc] /ˈpeɪpərbæk/;
scrape: [x] n. 擦伤;刮,擦;  v. 刮,擦; [acc] /skreɪp/;
consolidate: [x] v. 巩固,加强;把.合为一体; [acc] /kənˈsɑːlɪdeɪt/;
bandit: [x] n. 强盗,土匪; [acc] /ˈbændɪt/;
sneer: [x] v. 冷笑;嘲笑;  n. 嘲笑; [acc] /snɪr/;
intimate: [x] adj. 亲密的,密切的;详细的;  v. 暗示;宣布,通知;  n. 密友,知己; [acc] /ˈɪntɪmət/;
obstinate: [x] adj. 顽固的;较难治愈的; [acc] /ˈɑːbstɪnət/;
encourage: [x] v. 鼓励,支持;促使;怂恿; [acc] /ɪnˈkɜːrɪdʒ/;
giggle: [x] v. 咯咯地笑,傻笑;  n. 咯咯地笑,傻笑; [acc] /ˈɡɪɡl/;
corresponding: [x] adj. 相应的;符合的,一致的;通信的; [acc] /ˌkɔːrəˈspɑːndɪŋ/;
abbreviation: [x] n. 缩短;缩写词;省略号; [acc] /əˌbriːviˈeɪʃn/;
confidential: [x] adj. 机密的;表示信任的;悄悄的; [acc] /ˌkɑːnfɪˈdenʃl/;
mediate: [x] v. 调解,调停,斡旋; [acc] /ˈmiːdieɪt/;
availability: [x] n. 可得到的人(或物);可用性; [acc] /əˌveɪləˈbɪləti/;
weary: [x] adj. 疲倦的,困乏的,令人厌倦的;  v. 使疲倦;使厌倦; [acc] /ˈwɪri/;
pudding: [x] n. 布丁,一种甜点心; [acc] /ˈpʊdɪŋ/;
reptile: [x] n. 爬行动物,爬虫;  adj. 爬行的,爬虫类的; [acc] /ˈreptaɪl/;
charcoal: [x] n. 木炭; [acc] /ˈtʃɑːrkoʊl/;
embassy: [x] n. 大使馆;大使馆全体人员; [acc] /ˈembəsi/;
bishop: [x] n. 主教; [acc] /ˈbɪʃəp/;
hymn: [x] n. 赞美诗,圣歌;歌颂某事物的电影; [acc] /hɪm/;
grip: [x] v. 握紧,抓牢;  n. 紧握,握力; [acc] /ɡrɪp/;
proton: [x] n. 质子; [acc] /ˈproʊtɑːn/;
colonial: [x] adj. 殖民地的,关于殖民的;  n. 殖民地居民; [acc] /kəˈloʊniəl/;
vain: [x] adj. 爱虚荣的;徒劳的;没有真正意义的,没有真正价值的,无关紧要的;自负的,自高自大的;无益的; [acc] /veɪn/;
alert: [x] adj. 警惕的;充分意识到的;  n. 警觉(状态),戒备(状态);警报;  v. 向.报警,使警惕;使意识到; [acc] /əˈlɜːrt/;
radical: [x] n. 激进分子;基础;原子团;根数,根式;  adj. 重大的,彻底的;激进的; [acc] /ˈrædɪkl/;
paradox: [x] n. 矛盾;似矛盾而正确的说法; [acc] /ˈpærədɑːks/;
practicable: [x] adj. 能实行的,行得通的;适用的,能用的;可通行的; [acc] /ˈpræktɪkəbl/;
hoist: [x] v. 升起,吊起;向上推;  n. 起重机;举起; [acc] /hɔɪst/;
suitcase: [x] n. 小提箱,手提箱; [acc] /ˈsuːtkeɪs/;
expend: [x] v. 消费,用尽; [acc] /ɪkˈspend/;
meteorite: [x] n. 流星;陨星; [acc] /ˈmiːtiəraɪt/;
wink: [x] vi. 闪烁;眨眼示意;  n. 眨眼; [acc] /wɪŋk/;
vowel: [x] n. 元音;元音字母; [acc] /ˈvaʊəl/;
pursuit: [x] n. 追求,寻找;追赶,跟踪;事业,消遣;  v. 追踪,追击; [acc] /pərˈsuːt/;
summon: [x] v. 召唤;召集;聚集; [acc] /ˈsʌmən/;
fatigue: [x] n. 疲乏,劳累; [acc] /fəˈtiːɡ/;
chunk: [x] n. 大块;矮而厚的木块;大量; [acc] /tʃʌŋk/;
disillusion: [x] n. 幻灭;  v. 给.泼冷水; [acc] /ˌdɪsɪˈluːʒn/;
disguise: [x] v. 伪装;掩饰;  n. 伪装物;伪装; [acc] /dɪsˈɡaɪz/;
induce: [x] v. 引导,劝诱,诱导; [acc] /ɪnˈduːs/;
facet: [x] n. (多面体的)面,小平面;琢面,侧面;  vt. 在.上琢面; [acc] /ˈfæsɪt/;
autonomy: [x] n. 人身自由;自治;自治权; [acc] /ɔːˈtɑːnəmi/;
conclude: [x] v. 使结束;推断出;缔结;结束,总结,作决定,作协议; [acc] /kənˈkluːd/;
crush: [x] vt. 压坏;压扁;弄皱;弄碎,压碎;榨出;紧抱;挤入;镇压;欺压;  n. 压扁;极度拥挤;  vi. 被压坏;被揉皱;蜂拥而来; [acc] /krʌʃ/;
rotary: [x] adj. 旋转的;  n. 旋转运行的机器; [acc] /ˈroʊtəri/;
monopoly: [x] n. 垄断;专卖;垄断商品;专卖商品; [acc] /məˈnɑːpəli/;
capacity: [x] n. 产能;容量;本领;才能;负载量;职位; [acc] /kəˈpæsəti/;
output: [x] n. 产量,输出;  vt. 生产,出产,制造;输出;  vi. 生产,出产,制造;输出; [acc] /ˈaʊtpʊt/;
skyscraper: [x] n. 摩天大楼; [acc] /ˈskaɪskreɪpər/;
shrug: [x] n. 耸肩;  v. (为表示厌恶,轻漠,冷淡,怀疑等)耸肩;以耸肩表示(厌恶,轻蔑,冷淡,怀疑等); [acc] /ʃrʌɡ/;
tact: [x] n. 机智,得体,老练,圆滑; [acc] /tækt/;
estate: [x] n. 地产,(上有大片建筑物的)土地,住宅,财产,遗产; [acc] /ɪˈsteɪt/;
rupture: [x] n. 破裂;割裂;  v. 使破裂;断绝(关系); [acc] /ˈrʌptʃər/;
abolish: [x] v. 废除,废止;取消,革除; [acc] /əˈbɑːlɪʃ/;
provision: [x] n. (法律等)条款;供应;预备,存粮;必需品;  v. 为..提供必需品; [acc] /prəˈvɪʒn/;
glance: [x] v. 看一下;  n. 一瞥,扫视; [acc] /ɡlæns/;
warehouse: [x] n. 仓库; [acc] /ˈwerhaʊs/;
adolescent: [x] adj. 青春期的;青少年的;  n. 青少年; [acc] /ˌædəˈlesnt/;
salmon: [x] n. 鲑鱼; [acc] /ˈsæmən/;
mighty: [x] adj. 强大的,强有力的,有势力的;  adv. 很,非常; [acc] /ˈmaɪti/;
guardian: [x] n. 保护人;监护人; [acc] /ˈɡɑːrdiən/;
yacht: [x] n. 游艇;帆船; [acc] /jɑːt/;
equator: [x] n. 赤道; [acc] /ɪˈkweɪtər/;
revenge: [x] n. 报仇;报复;  v. 为.报仇,报.之仇; [acc] /rɪˈvendʒ/;
throne: [x] n. 王座;君主; [acc] /θroʊn/;
restore: [x] v. 恢复;修补;归还; [acc] /rɪˈstɔːr/;
monk: [x] n. 和尚,修道士,僧侣; [acc] /mʌŋk/;
sorrowful: [x] adj. 充满悲伤的,悲哀的,伤心的; [acc] /ˈsɑːroʊfl/;
dilemma: [x] n. 进退两难的窘境; [acc] /dɪˈlemə/;
tuck: [x] v. 把(衬衫,餐巾等的)边塞到里面;把.夹入,把.藏入;  n. (衣服等的)褶,裥; [acc] /tʌk/;
ridiculous: [x] adj. 可笑的,荒谬的; [acc] /rɪˈdɪkjələs/;
slate: [x] n. 黑板,石板,候选人名单;  v. 提名; [acc] /sleɪt/;
soy: [x] n. 大豆;酱油; [acc] /sɔɪ/;
insignificant: [x] adj. 无关紧要的,可忽略的,无意义的; [acc] /ˌɪnsɪɡˈnɪfɪkənt/;
fission: [x] n. [原子能]裂变,裂开,[生物学]分裂生殖; [acc] /ˈfɪʃn/;
virus: [x] n. 病毒;(计算机) 病毒;病毒性疾病; [acc] /ˈvaɪrəs/;
ingenuity: [x] n. 机灵,心灵手巧,富于创造天赋; [acc] /ˌɪndʒəˈnuːəti/;
foster: [x] adj. 收养的;  vt. 养育;培养,促进; [acc] /ˈfɔːstər/;
dioxide: [x] n. 二氧化物; [acc] /daɪˈɑːksaɪd/;
vicious: [x] adj. 罪恶的;恶意的;凶猛的,残忍的; [acc] /ˈvɪʃəs/;
patriotic: [x] adj. 爱国的,有爱国心的,显示爱国精神的; [acc] /ˌpeɪtriˈɑːtɪk/;
rot: [x] v. (使)腐烂;  n. 胡话;腐烂;腐朽,腐败; [acc] /rɑːt/;
tack: [x] n. 平头钉;行动步骤;  v. 钉住;使(船)抢风转变航向; [acc] /tæk/;
poke: [x] v. 刺,戳;拨开,拨(弄);探(出),露出;  n. 戳,捅; [acc] /poʊk/;
supersonic: [x] adj. 超音速的; [acc] /ˌsuːpərˈsɑːnɪk/;
challenge: [x] n. 挑战;质疑;  v. 挑战;质疑; [acc] /ˈtʃælɪndʒ/;
expense: [x] n. 开销,开支;花费,费用;代价; [acc] /ɪkˈspens/;
apt: [x] adj. 恰当的;有(做某事的)倾向; [acc] /æpt/;
deserve: [x] v. 值得,应得;应受; [acc] /dɪˈzɜːrv/;
fright: [x] n. 恐怖,惊吓; [acc] /fraɪt/;
spear: [x] n. 矛;标枪;嫩叶;  v. 刺戳; [acc] /spɪr/;
waitress: [x] n. 女侍者;女服务员; [acc] /ˈweɪtrəs/;
trench: [x] n. 沟;壕沟,战壕;海沟; [acc] /trentʃ/;
hoarse: [x] adj. 沙哑的; [acc] /hɔːrs/;
heritage: [x] n. 遗产;继承物;传统;文化遗产; [acc] /ˈherɪtɪdʒ/;
magician: [x] n. 善于变戏法的人,魔术师,术士; [acc] /məˈdʒɪʃn/;
surpass: [x] v. 胜过;超出; [acc] /sərˈpæs/;
compliment: [x] n. 恭维,问候;  v. 赞美,祝贺; [acc] /ˈkɑːmplɪmənt/;
bleak: [x] adj. 凄凉的;萧瑟的;阴郁的;无希望的; [acc] /bliːk/;
vehicle: [x] n. 交通工具,机动车;传播媒介;工具,手段; [acc] /ˈviːəkl/;
occur: [x] vi. 发生;出现,存在; [acc] /əˈkɜːr/;
prohibit: [x] v. 禁止; [acc] /prəˈhɪbɪt/;
concede: [x] v. 承认;承认失败;让给,让与;让步; [acc] /kənˈsiːd/;
lengthen: [x] v. 变长;延长; [acc] /ˈleŋθən/;
negligence: [x] n. 疏忽; [acc] /ˈneɡlɪdʒəns/;
resent: [x] v. 愤恨; [acc] /rɪˈzent/;
inspiring: [x] adj. 鼓舞人心的,激励人的;启发灵感的; [acc] /ɪnˈspaɪərɪŋ/;
beam: [x] n. 光线;(房屋等)大梁;(横)梁;  v. 发光;照射;发射,播送;微笑;用梁支撑; [acc] /biːm/;
bazaar: [x] n. 集市,商店集中区; [acc] /bəˈzɑːr/;
bamboo: [x] n. 竹,竹子; [acc] /ˌbæmˈbuː/;
sympathy: [x] n. 同情;同感; [acc] /ˈsɪmpəθi/;
spiral: [x] n. 螺旋,螺线;  v. 不断急剧地上升(或下降),螺旋形行进;  adj. 螺旋的; [acc] /ˈspaɪrəl/;
portray: [x] v. 描绘;描述; [acc] /pɔːrˈtreɪ/;
repel: [x] v. 击退,驱逐;排斥,抵制;使厌恶,使反感;使恐惧; [acc] /rɪˈpel/;
blur: [x] n. 污点,模糊;  v. 使.模糊;弄脏;变模糊; [acc] /blɜːr/;
slap: [x] v. 掌掴,拍打,侮辱;  n. 侮辱,掴,拍击声;  adv. 猛然;径直;恰好;正好; [acc] /slæp/;
decent: [x] adj. 体面的;像样的;合宜的;正直的; [acc] /ˈdiːsnt/;
permissible: [x] adj. 容许的;许可的; [acc] /pərˈmɪsəbl/;
diminish: [x] v. 减少;失势,削弱.的权势, 减弱.的权势; [acc] /dɪˈmɪnɪʃ/;
harp: [x] n. 竖琴;  v. 不停地说,喋喋不休; [acc] /hɑːrp/;
prayer: [x] n. 祈祷,祷告;祷文; [acc] /prer/;
inland: [x] adv. 在内陆地;  adj. 内陆的,国内的;  n. 内陆; [acc] /ˈɪnlænd/;
gleam: [x] vi. 闪烁;使发出微光;  n. 闪光;微光;闪现; [acc] /ɡliːm/;
margin: [x] n. 页边的空白,边缘;优势;利润; [acc] /ˈmɑːrdʒən/;
jingle: [x] n. (硬币,铃铛等发出的)叮当声;含有轻松而有节奏的韵律的诗篇;  v. 发出叮当声; [acc] /ˈdʒɪŋɡl/;
buzz: [x] v. 发出嗡嗡声;  n. 嗡嗡声;低沉嘈杂的谈话声; [acc] /bʌz/;
shorten: [x] v. 缩短,(使)变短; [acc] /ˈʃɔːrtn/;
meditate: [x] v. 考虑,沉思,冥想; [acc] /ˈmedɪteɪt/;
priest: [x] n. 教士,神父; [acc] /priːst/;
wax: [x] n. 蜡;蜡状物;  v. 给.上蜡;给.打蜡,给.上蜡;渐渐变大;变为;(月亮)渐圆,渐盈;  adj. 蜡制的; [acc] /wæks/;
notable: [x] n. 著名人士;  adj. 值得注意的,显著的,显要的; [acc] /ˈnoʊtəbl/;
apprehension: [x] n. 忧虑,担心,疑惧;逮捕;理解; [acc] /ˌæprɪˈhenʃn/;
crew: [x] n. (飞机,轮船等的)全体工作人员;一群人; [acc] /kruː/;
elderly: [x] adj. 年老的,年长的;上年纪的人; [acc] /ˈeldərli/;
marginal: [x] adj. 微小的,不重要的;仅以微弱多数票获胜的;  n. (议会或地方委员会的)边缘席位; [acc] /ˈmɑːrdʒɪnl/;
disorder: [x] n. 混乱;紊乱;动乱;  vt. 使混乱;使紊乱; [acc] /dɪsˈɔːrdər/;
cylinder: [x] n. 圆柱体,圆筒;汽缸,泵(或桶)体; [acc] /ˈsɪlɪndər/;
client: [x] n. 委托人,当事人,主顾,客户;客户端; [acc] /ˈklaɪənt/;
abrupt: [x] adj. 突然的;唐突的;鲁莽的; [acc] /əˈbrʌpt/;
successor: [x] n. 继承者;继任者; [acc] /səkˈsesər/;
sample: [x] n. 样品,样本;(用于检验,分析的) 试样;  adj. 样品的,作为例子的;  vi. 抽样检查;  vt. 抽取.的试样;  v. 品尝;体验,尝试; [acc] /ˈsæmpl/;
current: [x] adj. 当前的,现在的;流动的;  n. (电,水,气)流; [acc] /ˈkɜːrənt/;
cemetery: [x] n. 公墓;墓地; [acc] /ˈseməteri/;
belly: [x] n. 圆形或凸起部分;肚子; [acc] /ˈbeli/;
hysterical: [x] adj. 歇斯底里的,情绪激动的; [acc] /hɪˈsterɪkl/;
lofty: [x] adj. 极高的,巍峨的;崇高的;高傲的; [acc] /ˈlɔːfti/;
bid: [x] n. 出价;投标;努力争取;  v. 出价;投标;问候;道别;吩咐; [acc] /bɪd/;
reception: [x] n. 前台,接待处,接收,欢迎,招待会; [acc] /rɪˈsepʃn/;
tremendous: [x] adj. 巨大的;极大的;惊人的; [acc] /trəˈmendəs/;
stall: [x] n. 分隔栏;售货摊;厩;  v. 停止(因故障); [acc] /stɔːl/;
impose: [x] v. 把.强加;强制实行,强迫接受; [acc] /ɪmˈpoʊz/;
coverage: [x] n. 新闻报道;可达范围;覆盖范围; [acc] /ˈkʌvərɪdʒ/;
nasty: [x] adj. 令人讨厌的;严重的;恶劣的;下流的;  n. (复数形式)令人不愉快或对人有害的事物; [acc] /ˈnæsti/;
highlight: [x] vt. 使突出,强调,高亮;  n. 最精彩的部分,最重要的事件; [acc] /ˈhaɪlaɪt/;
minority: [x] n. 少数;少数民族;未成年;  adj. 构成少数的; [acc] /maɪˈnɔːrəti/;
fatal: [x] adj. 致命的;毁灭性的;决定性的; [acc] /ˈfeɪtl/;
temperament: [x] n. 气质,性格,喜怒无常; [acc] /ˈtemprəmənt/;
seemingly: [x] adv. 表面上;看上去;似乎; [acc] /ˈsiːmɪŋli/;
refresh: [x] v. (使)恢复精神,提神;刷新; [acc] /rɪˈfreʃ/;
infinity: [x] n. 无限的时间;大宗,大量;无穷; [acc] /ɪnˈfɪnəti/;
interconnect: [x] v. 互相连接; [acc] /ˌɪntərkəˈnekt/;
cucumber: [x] n. 黄瓜; [acc] /ˈkjuːkʌmbər/;
discharge: [x] n. 发射;释放;解雇;放电;  v. 卸掉负担;发射;放电;卸(货);使爆炸;履行;解雇;允许.离开;排出,放出;清偿(债务); [acc] /dɪsˈtʃɑːrdʒ/;
superiority: [x] n. 优越(性),优等; [acc] /suːˌpɪriˈɔːrəti/;
residual: [x] adj. 残余的,剩余的; [acc] /rɪˈzɪdʒuəl/;
messenger: [x] n. 送信者; [acc] /ˈmesɪndʒər/;
improper: [x] adj. 不成体统的,不合礼仪的;不正确的;不道德的; [acc] /ɪmˈprɑːpər/;
brew: [x] v. 调制;酿造;冲泡 (茶,咖啡等);酝酿;筹划;  n. 酝酿的饮料;啤酒; [acc] /bruː/;
virgin: [x] n. 处女;处男;贞女;  adj. 处女的; [acc] /ˈvɜːrdʒɪn/;
pearl: [x] n. 珍珠;珠状物; [acc] /pɜːrl/;
augment: [x] v. 增加;助长; [acc] /ɔːɡˈment/;
historic: [x] adj. 历史上著名的,有历史意义的;历史性的; [acc] /hɪˈstɔːrɪk/;
simultaneous: [x] adj. 同时发生的; [acc] /ˌsaɪmlˈteɪniəs/;
evenly: [x] adv. 均匀地,平坦地;不偏不倚地; [acc] /ˈiːvnli/;
historian: [x] n. 历史学家,史学工作者; [acc] /hɪˈstɔːriən/;
fragile: [x] adj. 易碎的;易损坏的;虚弱的;脆弱的; [acc] /ˈfrædʒl/;
contend: [x] v. 争辩;坚决主张;搏斗; [acc] /kənˈtend/;
software: [x] n. 软件; [acc] /ˈsɔːftwer/;
disclose: [x] v. 公开,揭露,泄露; [acc] /dɪsˈkloʊz/;
scripture: [x] n. 经文;圣经; [acc] /ˈskrɪptʃər/;
stitch: [x] v. 缝,绣;  n. 一针,线迹;缝法,编结法;(肋部的)突然剧痛;缝合(伤口); [acc] /stɪtʃ/;
scorn: [x] n. 鄙视;  v. 轻蔑;对.不屑一顾; [acc] /skɔːrn/;
elastic: [x] adj. 有弹性的;可伸缩的,(系统或计划)灵活的;弹力材料制成的;  n. 松紧带,橡皮圈; [acc] /ɪˈlæstɪk/;
detector: [x] n. 探测器; [acc] /dɪˈtektər/;
indicative: [x] adj. 指示的;暗示的;陈述的;  n. 陈述语气; [acc] /ɪnˈdɪkətɪv/;
electrical: [x] adj. 有关电的;电气科学的; [acc] /ɪˈlektrɪkl/;
dignity: [x] n. 威严,威风;端庄;尊严,高贵; [acc] /ˈdɪɡnəti/;
casual: [x] adj. 偶然的;临时的;随便的;  n. 临时工;便服; [acc] /ˈkæʒuəl/;
sentiment: [x] n. 感情;情绪; [acc] /ˈsentɪmənt/;
projector: [x] n. 放映机;投影仪; [acc] /prəˈdʒektər/;
transition: [x] n. 转变,过渡时期;  v. (从某一状态或活动)转变,过渡(到另一状态或活动); [acc] /trænˈzɪʃn/;
vector: [x] n. [数]向量;矢量;带菌者; [acc] /ˈvektər/;
uniformly: [x] adv. 一致地; [acc] /ˈjuːnɪfɔːrmli/;
jog: [x] v. 慢跑;轻碰;  n. 轻推,慢跑,漫步; [acc] /dʒɑːɡ/;
winding: [x] adj. 蜿蜒的,弯曲的; [acc] /ˈwaɪndɪŋ/;
flatten: [x] v. 把..弄平; [acc] /ˈflætn/;
generate: [x] v. 产生(热,电等能量),创造; [acc] /ˈdʒenəreɪt/;
ample: [x] adj. 富足的,丰满的,宽敞的; [acc] /ˈæmpl/;
attendant: [x] n. 服务员,侍者,随从;  adj. 伴随的,随之而产生的; [acc] /əˈtendənt/;
contamination: [x] n. 污染;侵蚀,玷污; [acc] /kənˌtæmɪˈneɪʃn/;
nil: [x] n. 零;无; [acc] /nɪl/;
stalk: [x] n. 茎,梗;  v. 隐伏跟踪,(为搜索而)走遍;高视阔步,蔓延; [acc] /stɔːk/;
commend: [x] v. 称赞;推荐;委托保管; [acc] /kəˈmend/;
everlasting: [x] adj. 永恒的,持久的;无止境的;耐用的; [acc] /ˌevərˈlæstɪŋ/;
crumble: [x] v. 弄碎;使破碎;崩溃;破灭;  n. 碎屑;面包屑; [acc] /ˈkrʌmbl/;
bachelor: [x] n. 单身汉;学士学位; [acc] /ˈbætʃələr/;
culminate: [x] v. 使达高潮,使结束; [acc] /ˈkʌlmɪneɪt/;
concept: [x] n. 设想;想法;概念;观念; [acc] /ˈkɑːnsept/;
allege: [x] v. 断言;硬说; [acc] /əˈledʒ/;
affluent: [x] adj. 富裕的,丰富的; [acc] /ˈæfluənt/;
friction: [x] n. 摩擦,摩擦力;争执,冲突; [acc] /ˈfrɪkʃn/;
imply: [x] vt. 暗示;暗指;意味着; [acc] /ɪmˈplaɪ/;
compulsory: [x] adj. 强制的,必修的; [acc] /kəmˈpʌlsəri/;
volunteer: [x] n. 志愿者;志愿兵;志愿者,义务工作者;  v. 自愿做;自愿加入;主动要求;主动提供 (信息); [acc] /ˌvɑːlənˈtɪr/;
haven: [x] n. 港湾;避难所;  vt. 为.提供庇护所; [acc] /ˈheɪvn/;
converse: [x] v. 交谈;  adj. 相反的,颠倒的;  n. 相反的事物; [acc] /kənˈvɜːrs/;
endeavour: [x] n. 尝试;  v. 努力; [acc] /ɪnˈdevər/;
siege: [x] n. 围困;包围; [acc] /siːdʒ/;
fundamental: [x] adj. 基本的,根本的;重要的;基础的;  n. 基本原理;基本原则; [acc] /ˌfʌndəˈmentl/;
scandal: [x] n. 丑闻;丢脸;流言蜚语;反感;愤慨;  v. 诋毁; [acc] /ˈskændl/;
vocational: [x] adj. 职业的;业务的; [acc] /voʊˈkeɪʃənl/;
implement: [x] n. 工具;器具;  v. 实施,执行;执行; [acc] /ˈɪmplɪment/;
charge: [x] v. 充电,充值;索价;控告;向.冲去;  n. 费用;主管;控告; [acc] /tʃɑːrdʒ/;
foremost: [x] adj. (位置或时间),最先的;首要的;  adv. 首先,第一; [acc] /ˈfɔːrmoʊst/;
crooked: [x] adj. 弯曲的;歪的;不正当的;不正直的; [acc] /ˈkrʊkɪd/;
derivation: [x] n. 出处;词源;派生; [acc] /ˌderɪˈveɪʃn/;
linen: [x] n. 亚麻桌布;亚麻布; [acc] /ˈlɪnɪn/;
flush: [x] v. 脸红;清除;赶出;冲掉;  n. 发红;冲掉;脸红;  adj. 挥霍的,浪费的;富有的;完全齐平的; [acc] /flʌʃ/;
validity: [x] n. 正确(性);有效(性),效力; [acc] /vəˈlɪdəti/;
finance: [x] v. 资金供给,筹措资金;  n. 金融,财政,资金; [acc] /ˈfaɪnæns/;
slumber: [x] n. 睡眠;睡觉;  v. 浅睡;打盹儿; [acc] /ˈslʌmbər/;
excessive: [x] adj. 过多的; [acc] /ɪkˈsesɪv/;
recognize: [x] v. 辨别,认出;赏识,表彰;承认;赞成; [acc] /ˈrekəɡnaɪz/;
premier: [x] n. 总理,首相;  adj. 第一的,首位的; [acc] /prɪˈmɪr/;
professional: [x] adj. 职业的;专业的;  n. 专业人员; [acc] /prəˈfeʃənl/;
probation: [x] n. 试用;缓刑;察看; [acc] /proʊˈbeɪʃn/;
intercity: [x] adj. 城市间的,交际的,来往于城市间的; [acc] /ˌɪntərˈsɪti/;
overturn: [x] v. 打翻;  vt. 推翻; [acc] /ˌoʊvərˈtɜːrn/;
rig: [x] n. 钻井架;装备;帆具;成套器械;  v. 操纵;装配;欺骗; [acc] /rɪɡ/;
lace: [x] n. 鞋带;花边;  v. 加以修饰;结带子; [acc] /leɪs/;
overlap: [x] n. 重叠,重复;  v. (部分地)重叠; [acc] /ˌoʊvərˈlæp/;
radius: [x] n. 半径;范围; [acc] /ˈreɪdiəs/;
displacement: [x] n. 替代;移位,位移,排水量; [acc] /dɪsˈpleɪsmənt/;
conspicuous: [x] adj. 显眼的;显著的;显而易见的; [acc] /kənˈspɪkjuəs/;
shorthand: [x] n. 速记;缩写; [acc] /ˈʃɔːrthænd/;
fellowship: [x] n. 友谊;伙伴关系;交情;团体;奖学金; [acc] /ˈfeloʊʃɪp/;
intersection: [x] n. 交点,十字路口; [acc] /ˌɪntərˈsekʃn/;
wade: [x] v. 涉水而行,淌水;跋涉; [acc] /weɪd/;
pattern: [x] n. 模型,模式;典型;图案;版式;样品;  vi. 形成图案;  vt. 用图案装饰; [acc] /ˈpætərn/;
reside: [x] v. 居住; [acc] /rɪˈzaɪd/;
clockwise: [x] adj. 顺时针方向的;  adv. 顺时针方向地; [acc] /ˈklɑːkwaɪz/;
prosecute: [x] v. 起诉;做检察官;从事; [acc] /ˈprɑːsɪkjuːt/;
fiber: [x] n. 纤维(物质);纤维组织;(植物) 纤维; [acc] /ˈfaɪbər/;
apply: [x] v. 涂,敷;应用;申请; [acc] /əˈplaɪ/;
ignorance: [x] n. 不知,不懂;愚昧,无知; [acc] /ˈɪɡnərəns/;
heal: [x] v. 治愈,治疗;痊愈;恢复; [acc] /hiːl/;
shatter: [x] v. 使粉碎;砸碎;打碎;粉碎; [acc] /ˈʃætər/;
bitterness: [x] n. 苦味;辛酸;苦难; [acc] /ˈbɪtərnəs/;
comparable: [x] adj. 类似的,比得上的,可比较的; [acc] /ˈkɑːmpərəbl/;
dual: [x] adj. 双的;双重的; [acc] /ˈduːəl/;
sexual: [x] adj. 性别的;性的;性感的; [acc] /ˈsekʃuəl/;
antenna: [x] n. 天线,触角; [acc] /ænˈtenə/;
fuse: [x] n. 导火线,引信,保险丝;  v. (使)因保险丝熔断而中断工作,熔合,合并; [acc] /fjuːz/;
intake: [x] n. 吸入,收纳;纳入(数量); [acc] /ˈɪnteɪk/;
intensify: [x] v. 增强;加剧; [acc] /ɪnˈtensɪfaɪ/;
cabin: [x] n. (简陋的)小屋;船舱;客舱,机舱;  v. 住在小屋里; [acc] /ˈkæbɪn/;
equivalent: [x] adj. 相等的;等值的;  n. 同义词;等价物; [acc] /ɪˈkwɪvələnt/;
circulation: [x] n. 流传,传播;发行,发行量;(体液的)循环;(水,空气等的)流通;(货币等的)流通; [acc] /ˌsɜːrkjəˈleɪʃn/;
relay: [x] n. 替班;转播;接力赛跑;  v. 转播;传递; [acc] /ˈriːleɪ/;
mortal: [x] adj. 必有一死的;致命的;极端的;  n. 人类; [acc] /ˈmɔːrtl/;
contribute: [x] v. 增进,起促成作用;捐献,捐助;..的原因之一;投稿; [acc] /kənˈtrɪbjuːt/;
ideology: [x] n. 意识形态,思想(体系); [acc] /ˌaɪdiˈɑːlədʒi/;
kilowatt: [x] n. [物]千瓦(功率单位); [acc] /ˈkɪləwɑːt/;
reclaim: [x] v. 开拓,开垦;感化;取回;改造;废物回收利用; [acc] /rɪˈkleɪm/;
redundant: [x] adj. 多余的,过剩的;被下岗的; [acc] /rɪˈdʌndənt/;
statement: [x] n. 声明;结算单,报表;陈述; [acc] /ˈsteɪtmənt/;
precise: [x] adj. 精确的;恰好的; [acc] /prɪˈsaɪs/;
hemisphere: [x] n. (地球的)半球;大脑半球; [acc] /ˈhemɪsfɪr/;
reveal: [x] v. 揭示;透露;显示; [acc] /rɪˈviːl/;
triple: [x] v. 使成三倍,三倍于;  adj. 三倍的; [acc] /ˈtrɪpl/;
inventory: [x] n. 详细目录;存货清单; [acc] /ˈɪnvəntɔːri/;
nought: [x] n. 无;零; [acc] /nɔːt/;
fuel: [x] v. 给.加燃料;  n. 燃料;刺激因素; [acc] /ˈfjuːəl/;
withdraw: [x] v. 取款;撤退,收回,撤离; [acc] /wɪðˈdrɔː/;
cruelty: [x] n. 残忍,残酷(行为); [acc] /ˈkruːəlti/;
dissipate: [x] v. 消散,消失;浪费; [acc] /ˈdɪsɪpeɪt/;
minimize: [x] v. 使缩到最小;达到最低值; [acc] /ˈmɪnɪmaɪz/;
depressed: [x] adj. 沮丧的;萧条的;低迷的; [acc] /dɪˈprest/;
asset: [x] n. 财产,资产,有价值的东西或人; [acc] /ˈæset/;
shield: [x] n. 盾牌;防护物;  v. 保护; [acc] /ʃiːld/;
adjust: [x] v. 调整,调节;校正;改变.以适应; [acc] /əˈdʒʌst/;
draft: [x] n. 气流;通风,通风装置;草稿;汇票;征兵;  v. 起草;征兵; [acc] /dræft/;
insulate: [x] v. 隔离,使隔绝(以免受到影响);使隔热; [acc] /ˈɪnsəleɪt/;
icy: [x] adj. 多冰的; [acc] /ˈaɪsi/;
suspicion: [x] n. 怀疑,猜疑,疑心;少许; [acc] /səˈspɪʃn/;
indignation: [x] n. 愤慨; [acc] /ˌɪndɪɡˈneɪʃn/;
Mars: [x] n. 火星; [acc] /mɑːrz/;
decorative: [x] adj. 装饰的; [acc] /ˈdekəreɪtɪv/;
preview: [x] n. (电影,戏剧等的)预映;(电影等的)预告(片);  v. 预观;预习; [acc] /ˈpriːvjuː/;
woodpecker: [x] n. 啄木鸟; [acc] /ˈwʊdpekər/;
precious: [x] n. <口>宝贝,心爱的人;  adv. 强调极少或太少;  adj. 珍贵的,宝贵的; [acc] /ˈpreʃəs/;
hawk: [x] n. 鹰;鹰派成员(以强硬态度或手段维护国家民族利益的个人,团体或势力);  v. 叫卖,兜售;散播; [acc] /hɔːk/;
sprinkle: [x] v. 撒,洒;下稀疏的雨;  n. 小雨;少量; [acc] /ˈsprɪŋkl/;
brittle: [x] adj. 易碎的;脆弱的;靠不住的;  n. 薄片脆糖; [acc] /ˈbrɪtl/;
subsidy: [x] n. 补助金,津贴; [acc] /ˈsʌbsədi/;
command: [x] n. 命令,指挥;  v. 发布命令,指挥;掌管,控制;指挥,命令;控制,管理; [acc] /kəˈmænd/;
inclusive: [x] adj. 包含..在内的,包罗广泛的; [acc] /ɪnˈkluːsɪv/;
unreasonable: [x] adj. 不合理的;过度的; [acc] /ʌnˈriːznəbl/;
twist: [x] v. 捻,搓;扭;歪曲;  n. 搓,扭拧;意外进展;弯曲处; [acc] /twɪst/;
neutron: [x] n. 中子; [acc] /ˈnuːtrɑːn/;
array: [x] n. 一系列;陈列;编队;  v. 排列;部署; [acc] /əˈreɪ/;
stump: [x] n. 树桩,残肢,残余的部分;  v. 把..难住,到处做演讲,沉重或笨重地移动; [acc] /stʌmp/;
preservation: [x] n. 保存,保护; [acc] /ˌprezərˈveɪʃn/;
urine: [x] n. 尿; [acc] /ˈjʊrən/;
flaw: [x] n. 瑕疵;缺点;  v. 使有缺陷;使不完美;有瑕疵; [acc] /flɔː/;
consultant: [x] n. 会诊医师,顾问医生;顾问; [acc] /kənˈsʌltənt/;
popularity: [x] n. 受大众欢迎; [acc] /ˌpɑːpjuˈlærəti/;
pedestrian: [x] n. 步行者,行人;  adj. 步行的;平庸无奇的,无聊的; [acc] /pəˈdestriən/;
smash: [x] v. 粉碎,猛冲,击溃;  n. 破碎(声),猛撞,巨大的成功;  adj. 极为成功的; [acc] /smæʃ/;
metropolitan: [x] adj. 大城市的,大都会的;大主教区的; [acc] /ˌmetrəˈpɑːlɪtən/;
perplex: [x] v. 使困惑; [acc] /pərˈpleks/;
Pope: [x] n. 教皇; [acc] /poʊp/;
suite: [x] n. (旅馆的)套间;一套家具;一组程序;组曲; [acc] /swiːt/;
wholesome: [x] adj. 有益于健康的;有益的; [acc] /ˈhoʊlsəm/;
chapel: [x] n. 小教堂;私人祈祷室; [acc] /ˈtʃæpl/;
whirl: [x] v. 回旋;使旋转;  n. 回旋;一个接一个的活动; [acc] /wɜːrl/;
spotlight: [x] n. 聚光灯;  v. 聚光照明,使显著; [acc] /ˈspɑːtlaɪt/;
advertise: [x] v. 为..做广告;公告;公布; [acc] /ˈædvərtaɪz/;
armor: [x] n. 盔甲;装甲; [acc] /ˈɑrmər/;
expire: [x] v. 期满,(期限)终止;断气,死亡; [acc] /ɪkˈspaɪər/;
fertilizer: [x] n. 肥料,化肥; [acc] /ˈfɜːrtəlaɪzər/;
impulse: [x] n. 冲动,脉冲,驱使; [acc] /ˈɪmpʌls/;
erect: [x] v. 搭建,竖起;建造,建立;  adj. 直立的,垂直的; [acc] /ɪˈrekt/;
expert: [x] n. 专家;  adj. 熟练的,专业的; [acc] /ˈekspɜːrt/;
radiate: [x] v. 辐射,发出(光或热);流露,显示;(使)从中心发散; [acc] /ˈreɪdieɪt/;
detach: [x] v. 使分开,拆卸;派遣; [acc] /dɪˈtætʃ/;
essence: [x] n. 本质,实质;精髓,精华; [acc] /ˈesns/;
exchange: [x] v. 交换,互换;交流;进行易货贸易;  n. 交换;交易所;(货币的)兑换; [acc] /ɪksˈtʃeɪndʒ/;
chuck: [x] v. 轻轻地扔;抛;丢弃; [acc] /tʃʌk/;
excessively: [x] adv. 过分地,非常地; [acc] /ɪkˈsesɪvli/;
appreciation: [x] n. 感激;欣赏,鉴识,评价;增值;理解,了解; [acc] /əˌpriːʃiˈeɪʃn/;
embarrass: [x] vt. 使窘迫,使尴尬(尤指在社交场合);困窘,困扰; [acc] /ɪmˈbærəs/;
tribe: [x] n. 部落; [acc] /traɪb/;
notify: [x] v. 通知,告知;报告; [acc] /ˈnoʊtɪfaɪ/;
reassure: [x] v. 使放心,使消除疑虑; [acc] /ˌriːəˈʃʊr/;
transformation: [x] n. 变化,改造,转变; [acc] /ˌtrænsfərˈmeɪʃn/;
fabric: [x] n. 布料,织物;质地,结构; [acc] /ˈfæbrɪk/;
galaxy: [x] n. 星系; [acc] /ˈɡæləksi/;
species: [x] n. (单复同)物种;种类;人类;  adj. 物种上的; [acc] /ˈspiːʃiːz/;
rage: [x] n. 极怒;盛怒;  v. 迅速蔓延,快速扩散;(战争等)激烈地进行; [acc] /reɪdʒ/;
disproportionate: [x] adj. 不成比例的; [acc] /ˌdɪsprəˈpɔːrʃənət/;
immune: [x] adj. 免疫的,有免疫力的;不受影响的;免除的; [acc] /ɪˈmjuːn/;
wretched: [x] adj. 可怜的;恶劣的;身心疲惫的; [acc] /ˈretʃɪd/;
oval: [x] adj. 椭圆形的;  n. 椭圆形; [acc] /ˈoʊvl/;
senator: [x] n. 参议员; [acc] /ˈsenətər/;
illustrate: [x] v. 举例说明,阐明;图解,加插图; [acc] /ˈɪləstreɪt/;
rejoice: [x] v. 欣喜,高兴; [acc] /rɪˈdʒɔɪs/;
doubtless: [x] adv. 无疑地;肯定地;  adj. 无疑的;肯定的; [acc] /ˈdaʊtləs/;
Easter: [x] n. 复活节; [acc] /ˈiːstər/;
shadowy: [x] adj. 朦胧的;模糊的;多荫的,阴凉的; [acc] /ˈʃædoʊi/;
confer: [x] v. 授予(奖项,学位,荣誉或权利);商讨,协商; [acc] /kənˈfɜːr/;
process: [x] v. 加工;处理;  n. 过程,进程;工序,程序;传票; [acc] /ˈprɑːses/;
attractive: [x] adj. 有魅力的;吸引人的;引起兴趣的; [acc] /əˈtræktɪv/;
legend: [x] n. 传说,传奇人物;(奖章纪念牌等的)铭文;地图的图例,插图的说明; [acc] /ˈledʒənd/;
reserve: [x] n. 储备;保留;保护区;  v. 保留;预定;储备; [acc] /rɪˈzɜːrv/;
robust: [x] adj. 健壮的,强壮的;精力充沛的;坚固的;粗鲁的; [acc] /roʊˈbʌst/;
compound: [x] n. 复合物;[化学]化合物;  adj. 合成的;复合的;多功能的;  vi. 妥协;和解;  vt. 混合;调和;调停;使恶化; [acc] /ˈkɑːmpaʊnd/;
stream: [x] n. 小河,溪流;流,一股,一串;  v. 流(出),涌(出);按能力分班(或分组); [acc] /striːm/;
stimulus: [x] n. 刺激物;鼓励;促进因素; [acc] /ˈstɪmjələs/;
descend: [x] vi. 走下;降临;  v. 下降,下来;突然访问;下移,下降; [acc] /dɪˈsend/;
fitness: [x] n. 适当,恰当,健康; [acc] /ˈfɪtnəs/;
sulfur: [x] n. 硫磺; [acc] /ˈsʌlfər/;
psychiatrist: [x] n. 精神病医生;精神病学家; [acc] /saɪˈkaɪətrɪst/;
flank: [x] v. 位于.的侧面;  n. 肋,肋腹,侧翼; [acc] /flæŋk/;
correspondent: [x] n. 通讯员,记者;通信者; [acc] /ˌkɔːrəˈspɑːndənt/;
gauge: [x] n. 测量仪;尺度,标准;  v. 估计,判断;计量; [acc] /ɡeɪdʒ/;
quart: [x] n. 夸脱; [acc] /kwɔːrt/;
detail: [x] n. 细节;详情;特遣队;  vt. 详述;派遣; [acc] /ˈdiːteɪl/;
indispensable: [x] adj. 必不可少的;必需的; [acc] /ˌɪndɪˈspensəbl/;
utmost: [x] adj. 最大的;极度的;最远的;  n. 极限; [acc] /ˈʌtmoʊst/;
integrity: [x] n. 正直,真诚;完整; [acc] /ɪnˈteɡrəti/;
antique: [x] n. 古董;古玩;古物;  adj. 古代的;古董的; [acc] /ænˈtiːk/;
mammal: [x] n. 哺乳动物; [acc] /ˈmæml/;
grasshopper: [x] n. 蚱蜢; [acc] /ˈɡræshɑːpər/;
cripple: [x] n. 跛子,伤残人(或动物);  v. 使跛;使受伤致残;严重削弱; [acc] /ˈkrɪpl/;
quest: [x] n. 探索,寻求;  v. 寻找,搜索; [acc] /kwest/;
authorize: [x] v. 批准;授权; [acc] /ˈɔːθəraɪz/;
elliptical: [x] adj. 椭圆的;省略的; [acc] /ɪˈlɪptɪkl/;
burglar: [x] n. 窃贼; [acc] /ˈbɜːrɡlər/;
imperative: [x] adj. 必要的;祈使的;急需的;  n. 命令;必要的事;义务;驱使; [acc] /ɪmˈperətɪv/;
emission: [x] n. 排放物;放射物; [acc] /iˈmɪʃn/;
intervention: [x] n. 介入;调停;干涉,干预; [acc] /ˌɪntərˈvenʃn/;
dependant: [x] n. (子女等)受抚养者; [acc] /dɪˈpendənt/;
cholesterol: [x] n. 胆固醇; [acc] /kəˈlestərɔːl/;
artificial: [x] adj. 人造的,人工的,假的;假装的,虚伪的;  n. 人造肥料;<美>假花; [acc] /ˌɑːrtɪˈfɪʃl/;
disease: [x] n. 疾病; [acc] /dɪˈziːz/;
rebuke: [x] v. 指责;  n. 谴责; [acc] /rɪˈbjuːk/;
breed: [x] n. 血统;种类;  v. 产仔;繁殖;使繁殖; [acc] /briːd/;
threshold: [x] n. 门槛;开端; [acc] /ˈθreʃhoʊld/;
interrupt: [x] v. 打扰;打断,中断;插嘴;妨碍; [acc] /ˌɪntəˈrʌpt/;
assess: [x] v. 评估;估值; [acc] /əˈses/;
category: [x] n. 类别;范畴; [acc] /ˈkætəɡɔːri/;
superstition: [x] n. 迷信,盲目恐惧; [acc] /ˌsuːpərˈstɪʃn/;
element: [x] n. 元素;成分;要素;电炉,热水器等的电热元件,电热丝; [acc] /ˈelɪmənt/;
overcome: [x] v. 战胜;克服;压倒;得胜,征服; [acc] /ˌoʊvərˈkʌm/;
outermost: [x] adj. 最外面的;最远的; [acc] /ˈaʊtərmoʊst/;
quantify: [x] v. 确定数量; [acc] /ˈkwɑːntɪfaɪ/;
perfume: [x] n. 香水;香气;  v. 使充满芳香;洒香水于; [acc] /pərˈfjuːm/;
Jesus: [x] n. 耶稣;  excl. 天哪;岂有此理; [acc] /ˈdʒiːzəs/;
invariably: [x] adv. 总是;不变地,永恒地; [acc] /ɪnˈveriəbli/;
stroke: [x] n. 击打;一击,一次,一举;中风;抚摸;笔画;  v. 拭去;轻抚; [acc] /stroʊk/;
vulnerable: [x] adj. 易受伤的;脆弱的;易受攻击的; [acc] /ˈvʌlnərəbl/;
retention: [x] n. 保留,保持; [acc] /rɪˈtenʃn/;
commercial: [x] adj. 商业性的,贸易的;  n. 商业广告; [acc] /kəˈmɜːrʃl/;
solution: [x] n. 解决办法;解答;溶液;溶解; [acc] /səˈluːʃn/;
formulate: [x] v. 构想出(计划,方法等);系统地阐述; [acc] /ˈfɔːrmjuleɪt/;
rational: [x] adj. 理性的;理智的;合理的; [acc] /ˈræʃnəl/;
flexible: [x] adj. 易曲的,柔软的,灵活的; [acc] /ˈfleksəbl/;
completion: [x] n. 完成,完满; [acc] /kəmˈpliːʃn/;
mar: [x] v. 毁坏,弄糟,玷污; [acc] /mɑːr/;
lieutenant: [x] n. 陆军中尉,海军上尉,空军中尉;副队长;助理官员;警督; [acc] /luːˈtenənt/;
dominate: [x] v. 在.中占首要地位;支配,统治,控制;耸立于,俯视;处于支配地位,拥有优势; [acc] /ˈdɑːmɪneɪt/;
muscular: [x] adj. 肌肉的;肌肉发达的;强有力的; [acc] /ˈmʌskjələr/;
optimist: [x] n. 乐天派,乐观者; [acc] /ˈɑːptɪmɪst/;
literal: [x] adj. 字面上的;照字面的;缺乏想像力的; [acc] /ˈlɪtərəl/;
shepherd: [x] n. 牧羊人;  v. 带领; [acc] /ˈʃepərd/;
preside: [x] v. 主持; [acc] /prɪˈzaɪd/;
rely: [x] v. 依赖,依靠;信赖; [acc] /rɪˈlaɪ/;
bald: [x] adj. 秃头的; [acc] /bɔːld/;
hush: [x] vi. 安静下来;嘘!别做声!别吵!;  vt. 使安静;  n. 安静; [acc] /hʌʃ/;
hierarchy: [x] n. 阶层,等级制度; [acc] /ˈhaɪərɑːrki/;
recover: [x] v. 恢复;痊愈,恢复健康;收回;换回;重新获得;重新找到; [acc] /rɪˈkʌvər/;
gene: [x] n. 基因; [acc] /dʒiːn/;
relative: [x] n. 亲戚,家人,亲属;相关物,关系词,同类事物;  adj. 相对的;有关系的,(语)关系的; [acc] /ˈrelətɪv/;
strive: [x] v. 斗争;努力,奋斗; [acc] /straɪv/;
mustard: [x] n. 芥菜;芥末;芥末色;  adj. 芥末色的; [acc] /ˈmʌstərd/;
defective: [x] adj. 有缺陷的; [acc] /dɪˈfektɪv/;
magistrate: [x] n. 法官; [acc] /ˈmædʒɪstreɪt/;
supreme: [x] adj. 至高的;最重要的;极度的; [acc] /suːˈpriːm/;
rein: [x] n. 缰绳;  v. 控制; [acc] /reɪn/;
inference: [x] n. 推断,推断的结果; [acc] /ˈɪnfərəns/;
immigrate: [x] v. 移居入境; [acc] /ˈɪmɪɡreɪt/;
cozy: [x] adj. 温暖舒适的,安逸的;  v. 取悦; [acc] /ˈkoʊzi/;
bleach: [x] v. 漂白;  n. 漂白剂; [acc] /bliːtʃ/;
greed: [x] n. 贪欲,贪婪;贪吃; [acc] /ɡriːd/;
orchestra: [x] n. 管弦乐队;  adj. 管弦乐队的; [acc] /ˈɔːrkɪstrə/;
motivate: [x] vt. 激励;使有动机;促进;促动;激发..的积极性; [acc] /ˈmoʊtɪveɪt/;
interfere: [x] v. 干涉,妨碍;妨碍;干涉;  vi. 妨碍; [acc] /ˌɪntərˈfɪr/;
attach: [x] v. 系;贴;附上;附加;缚; [acc] /əˈtætʃ/;
rectify: [x] v. 纠正;修复; [acc] /ˈrektɪfaɪ/;
harmony: [x] n. 和谐;和声;和睦;协调; [acc] /ˈhɑːrməni/;
modest: [x] adj. 谦虚的,谦逊的;端庄的,羞怯的;不太大(或太贵,太重要)的,适度的; [acc] /ˈmɑːdɪst/;
flatter: [x] v. 阿谀,使高兴;(肖像等)胜过(真人真物);自鸣得意,自以为是; [acc] /ˈflætər/;
argue: [x] v. 争吵;主张,认为;提供.证据,提出证明;表明(原因等); [acc] /ˈɑːrɡjuː/;
complaint: [x] n. 抱怨,怨言;不满的缘由,痛苦根源;控诉;投诉; [acc] /kəmˈpleɪnt/;
migrate: [x] vi. 迁徙;迁移,移往;迁移; [acc] /ˈmaɪɡreɪt/;
annoy: [x] v. 使烦恼,使生气;  n. 烦恼(等于annoyance); [acc] /əˈnɔɪ/;
customary: [x] adj. 合乎习俗的;惯常的; [acc] /ˈkʌstəmeri/;
calculus: [x] n. (数)微积分学; [acc] /ˈkælkjələs/;
pineapple: [x] n. 凤梨,菠萝; [acc] /ˈpaɪnæpl/;
disposition: [x] n. 性情,性格;意向,倾向;排列,部署; [acc] /ˌdɪspəˈzɪʃn/;
indifferent: [x] adj. 不感兴趣的,不关心的;平庸的;冷漠的; [acc] /ɪnˈdɪfrənt/;
individual: [x] adj. 个别的,独特的;单独的;  n. 独立的个体; [acc] /ˌɪndɪˈvɪdʒuəl/;
disagreement: [x] n. 分歧,不和;不一致; [acc] /ˌdɪsəˈɡriːmənt/;
span: [x] n. 跨度;时间段;范围;持续时间;  v. 持续;横跨;包括; [acc] /spæn/;
sacrifice: [x] vt. 牺牲;祭献;  vi. 奉献;做出牺牲;  n. 祭品;牺牲; [acc] /ˈsækrɪfaɪs/;
kidney: [x] n. 肾,腰子; [acc] /ˈkɪdni/;
racial: [x] adj. 种族的;人种的; [acc] /ˈreɪʃl/;
juggle: [x] v. 玩杂耍;同时做;对.巧妙应付; [acc] /ˈdʒʌɡl/;
minimum: [x] adj. 最少的,最低程度的;  n. 最低限度,最小量; [acc] /ˈmɪnɪməm/;
install: [x] v. 安装,安置,使就职; [acc] /ɪnˈstɔːl/;
paradise: [x] n. 天国;天堂;极乐世界; [acc] /ˈpærədaɪs/;
cork: [x] n. 软木;  v. 塞住,抑制; [acc] /kɔːrk/;
scar: [x] n. 伤疤,伤痕;内心创伤;  v. (给.)留下伤痕; [acc] /skɑːr/;
pathetic: [x] adj. 可怜的;不足的; [acc] /pəˈθetɪk/;
wag: [x] n. 摇摆;爱说笑的人;  v. 摇动; [acc] /wæɡ/;
multiplication: [x] n. 乘法; [acc] /ˌmʌltɪplɪˈkeɪʃn/;
committee: [x] n. 委员会;全体委员; [acc] /kəˈmɪti/;
tensile: [x] adj. 可拉长的,可伸长的,[物]张力的,拉力的; [acc] /ˈtensl/;
previous: [x] adj. 以前的;早先的;过早的; [acc] /ˈpriːviəs/;
latent: [x] adj. 潜在的,隐伏的,不易察觉的; [acc] /ˈleɪtnt/;
molecular: [x] adj. 分子的; [acc] /məˈlekjələr/;
eject: [x] v. (使)弹出;喷射;放逐; [acc] /iˈdʒekt/;
fax: [x] n. 传真(机);传真件;  v. 用传真传输; [acc] /fæks/;
fighter: [x] n. 战士;战斗机,歼击机; [acc] /ˈfaɪtər/;
principally: [x] adv. 主要地; [acc] /ˈprɪnsəpli/;
perimeter: [x] n. 周长;周界; [acc] /pəˈrɪmɪtər/;
elicit: [x] v. 引出;诱出;探出; [acc] /iˈlɪsɪt/;
beware: [x] v. 当心,谨防; [acc] /bɪˈwer/;
scope: [x] n. 瞄准镜;范围;余地; [acc] /skoʊp/;
destructive: [x] adj. 破坏(性)的,毁灭(性)的; [acc] /dɪˈstrʌktɪv/;
timber: [x] n. 木料;树木;性格,素质;  excl. 树要倒啦!;  adj. 木材的,木制的;  v. 用木材作骨架;以林木覆盖; [acc] /ˈtɪmbər/;
stereotype: [x] n. 老套的模式,陈规,成见;  v. 对..产生成见; [acc] /ˈsteriətaɪp/;
bonus: [x] n. 奖金,额外津贴; [acc] /ˈboʊnəs/;
limp: [x] n. 跛行;  vi. 一瘸一拐地走,跛行;慢腾腾地进行;  adj. 无力的,无生气的;柔软的,软弱的; [acc] /lɪmp/;
agitation: [x] n. 摇动;焦虑,忧虑;煽动; [acc] /ˌædʒɪˈteɪʃn/;
prudent: [x] adj. 谨慎的,精明的; [acc] /ˈpruːdnt/;
symposium: [x] n. 专题报告会; [acc] /sɪmˈpoʊziəm/;
clinical: [x] adj. 临床的;冷静的; [acc] /ˈklɪnɪkl/;
episode: [x] n. 插曲,片断;连续剧的一集;一段经历; [acc] /ˈepɪsoʊd/;
tempt: [x] v. 诱惑;吸引;冒..的风险,不顾; [acc] /tempt/;
kin: [x] n. 亲属; [acc] /kɪn/;
compassion: [x] n. 同情;怜悯; [acc] /kəmˈpæʃn/;
corps: [x] n. (由两个或以上师组成的)军,兵团;一群人;特别小组; [acc] /kɔːr/;
exploit: [x] v. 剥削,利用;开发,开拓;  n. 辉煌功绩; [acc] /ɪkˈsplɔɪt/;
realistic: [x] adj. 现实(主义)的;现实可行的;逼真的,栩栩如生的; [acc] /ˌriːəˈlɪstɪk/;
Antarctic: [x] adj. 南极的;  n. 南极区; [acc] /ænˈtɑːrktɪk/;
memorize: [x] v. 熟记; [acc] /ˈmeməraɪz/;
rating: [x] n. 评价;等级;等级评定;额定功率;评分,收视率; [acc] /ˈreɪtɪŋ/;
curly: [x] adj. 卷曲的,卷毛的,弯曲的; [acc] /ˈkɜːrli/;
saturate: [x] v. 使充满,使饱和,使湿透; [acc] /ˈsætʃəreɪt/;
accord: [x] n. 协议;  v. 授予; [acc] /əˈkɔːrd/;
behavior: [x] n. 行为;举止;态度; [acc] /bɪ'heɪvjə/;
evolution: [x] n. 进化,演变;发展; [acc] /ˌevəˈluːʃn/;
deed: [x] n. 行为;契约; [acc] /diːd/;
handicap: [x] n. 障碍,阻碍,不利条件,不利因素;残疾,缺陷,生理缺陷;[高尔夫]给弱者增加的杆数(按击球次数计数,并随参赛者的进步而减少);  v. 使不利,妨碍; [acc] /ˈhændikæp/;
pose: [x] n. 姿势;装腔作势,伪装;  vi. 摆造型;  vt. 主张,提出;引起,导致; [acc] /poʊz/;
coincide: [x] v. 巧合,一致,相符; [acc] /ˌkoʊɪnˈsaɪd/;
infusion: [x] n. 灌输;注入物;输入; [acc] /ɪnˈfjuːʒn/;
chronic: [x] adj. (疾病)慢性的;长期的;(人)久病的;积习难改的;严重的; [acc] /ˈkrɑːnɪk/;
nominal: [x] adj. 名义上的;象征性的,很少的;名词性的; [acc] /ˈnɑːmɪnl/;
slang: [x] n. 俚语,行话; [acc] /slæŋ/;
microprocessor: [x] n. 微处理器; [acc] /ˌmaɪkroʊˈproʊsesər/;
hum: [x] v. 发出嗡嗡声,哼(歌曲);  n. 轰鸣声,嗡嗡营营声; [acc] /hʌm/;
ingenious: [x] adj. 聪明的;有发明天才的;有独创性的,别出心裁的; [acc] /ɪnˈdʒiːniəs/;
cute: [x] adj. 可爱的;讨人喜爱的;聪明的; [acc] /kjuːt/;
tactics: [x] n. 战术,策略; [acc] /'tæktɪks/;
compactness: [x] n. 紧密;小巧;紧凑; [acc] /kəmˈpæktnəs/;
bibliography: [x] n. 参考书目;文献学; [acc] /ˌbɪbliˈɑːɡrəfi/;
sergeant: [x] n. 士官,中士,警官; [acc] /ˈsɑːrdʒənt/;
spoil: [x] v. 溺爱;娇惯;(食物)变质;毁坏;  n. 溺爱;战利品;犒劳;成功所带来的好处; [acc] /spɔɪl/;
batter: [x] n. (用鸡蛋,牛奶等调制的)面糊;  v. 连续猛击; [acc] /ˈbætər/;
proficiency: [x] n. 熟练;精通; [acc] /prəˈfɪʃnsi/;
extent: [x] n. 范围;程度;宽度;长度; [acc] /ɪkˈstent/;
deliberately: [x] adv. 故意地;慢条斯理地; [acc] /dɪˈlɪbərətli/;
climax: [x] n. 高潮,最令人兴奋(或感兴趣)的部分;  v. (使)达到顶点,(使)达到高潮; [acc] /ˈklaɪmæks/;
skeptical: [x] adj. 表示怀疑的; [acc] /ˈskeptɪkl/;
stern: [x] adj. 严厉的;严峻的;苛刻的;坚决的;  n. 船尾; [acc] /stɜːrn/;
context: [x] n. 上下文,语境;背景; [acc] /ˈkɑːntekst/;
monitor: [x] n. 显示器;监视器;班长;  v. 监视;监督;监测; [acc] /ˈmɑːnɪtər/;
incident: [x] n. 事件;事变,军事冲突,冲突;事故;  adj. [法]附带的;[光]入射的;易发生的,伴随而来的; [acc] /ˈɪnsɪdənt/;
handout: [x] n. 宣传单;施舍物;印刷品;讲义;小册子; [acc] /ˈhændaʊt/;
capacitor: [x] n. 电容器; [acc] /kəˈpæsɪtər/;
conversion: [x] n. 转变,转换;宗教,信仰上的转变;[经济学]兑换; [acc] /kənˈvɜːrʒn/;
segregate: [x] v. 分开,隔离,进行种族隔离; [acc] /ˈseɡrɪɡeɪt/;
maple: [x] n. 枫树;枫木; [acc] /ˈmeɪpl/;
lathe: [x] n. 车床; [acc] /leɪð/;
ultimate: [x] adj. 根本的;最后的,最终的; [acc] /ˈʌltɪmət/;
hindrance: [x] n. 妨碍;障碍物; [acc] /ˈhɪndrəns/;
trader: [x] n. 商人; [acc] /ˈtreɪdər/;
producer: [x] n. 电影制片人;电视制作人,制作公司;出产地; [acc] /prəˈduːsər/;
thrive: [x] v. 茁壮成长;繁荣,兴旺; [acc] /θraɪv/;
romance: [x] n. 浪漫;  v. 向..求爱; [acc] /ˈroʊmæns/;
earthenware: [x] n. [总称]陶器;  adj. 陶制的; [acc] /ˈɜːrθnwer/;
commence: [x] v. 开始; [acc] /kəˈmens/;
oar: [x] n. 桨,橹; [acc] /ɔːr/;
bead: [x] n. 珠子;水珠; [acc] /biːd/;
fake: [x] adj. 假的,伪造的;  n. 骗子;假货,赝品;  v. 假造,杜撰;伪造;冒充,假装;假装; [acc] /feɪk/;
rapture: [x] n. 狂喜; [acc] /ˈræptʃər/;
permeate: [x] v. 弥漫;普及;渗透; [acc] /ˈpɜːrmieɪt/;
mint: [x] n. 薄荷,薄荷糖,造币厂;  v. 铸造(硬币); [acc] /mɪnt/;
vegetation: [x] n. 植被; [acc] /ˌvedʒəˈteɪʃn/;
dub: [x] v. 授予(称号);为(电影)配音;混录录制(音乐);  n. (西印度群岛的)强节奏音乐; [acc] /dʌb/;
heater: [x] n. 加热器;发热器; [acc] /ˈhiːtər/;
fiction: [x] n. 虚构;想象;小说; [acc] /ˈfɪkʃn/;
virtual: [x] adj. (计算机)虚拟的;十分接近的;实质上的; [acc] /ˈvɜːrtʃuəl/;
diagnose: [x] v. 诊断(疾病),对(病人)下诊断结论; [acc] /ˌdaɪəɡˈnoʊs/;
dodge: [x] n. 托词;躲闪,躲避;  v. 回避,规避;躲避,避开; [acc] /dɑːdʒ/;
deformation: [x] n. 变形;畸形; [acc] /ˌdiːfɔːrˈmeɪʃn/;
toss: [x] v. 扔,抛,掷;  n. 掷,掷钱币来决定,猛抬头; [acc] /tɔːs/;
recall: [x] v. 回想起,记起,回忆;召回;  n. 召回(有问题的产品); [acc] /rɪˈkɔːl/;
identical: [x] adj. 相同的,同样的,一模一样的;相似的;  n. 完全相同的事物; [acc] /aɪˈdentɪkl/;
kidnap: [x] v. 诱拐;绑架; [acc] /ˈkɪdnæp/;
nourish: [x] v. 养育;培育(希望);增强(希望); [acc] /ˈnɜːrɪʃ/;
arrest: [x] v. 逮捕,拘留;吸引;  n. 逮捕,拘留; [acc] /əˈrest/;
deny: [x] v. 否认,拒绝承认,拒绝给予,自制; [acc] /dɪˈnaɪ/;
submarine: [x] n. 潜水艇;  adj. 水底的,海底的; [acc] /ˈsʌbməriːn/;
prevalent: [x] adj. 普遍的,流行的; [acc] /ˈprevələnt/;
slack: [x] adj. 松弛的;懈怠的;萧条的;  n. 松弛的部分,松散;  v. 变松弛,逃避工作; [acc] /slæk/;
contest: [x] n. 比赛,竞争;  v. 争夺,争论; [acc] /ˈkɑːntest/;
release: [x] v. 释放;解放;发行;  n. 解除;免除;发表; [acc] /rɪˈliːs/;
odor: [x] n. 气味; [acc] /ˈoʊdər/;
incapable: [x] adj. 无能力的,不能的; [acc] /ɪnˈkeɪpəbl/;
accident: [x] n. 事故;意外;偶然; [acc] /ˈæksɪdənt/;
stereo: [x] n. 立体声(装置);  adj. 立体声的; [acc] /ˈsterioʊ/;
rigorous: [x] adj. 严厉的,严格的; [acc] /ˈrɪɡərəs/;
mock: [x] v. 嘲笑;轻蔑,蔑视;  adj. 不真诚的;伪造的;  n. 模拟考; [acc] /mɑːk/;
complexion: [x] n. 肤色;特性; [acc] /kəmˈplekʃn/;
worthy: [x] adj. (of)值得..的,配得上..的,可尊敬的,有价值的;  n. 知名人士;杰出人物; [acc] /ˈwɜːrði/;
slot: [x] n. 狭缝,狭槽,(机构的)职位;  v. 把.放入狭长开口中,把.纳入; [acc] /slɑːt/;
constituent: [x] adj. 组成的;有选举权的;  n. 选民;成分; [acc] /kənˈstɪtʃuənt/;
alternate: [x] adj. 交替的,轮流的,间隔的;  v. (使)交替,(使)轮流;  n. 代替者; [acc] /ˈɔːltərnət/;
intensive: [x] adj. 加强的,强调的;精耕细作的;密集的;  n. 加强器;[语]强义词,强调成份; [acc] /ɪnˈtensɪv/;
symphony: [x] n. 交响乐; [acc] /ˈsɪmfəni/;
seam: [x] n. 缝;接缝;地层; [acc] /siːm/;
approve: [x] v. 称许,赞成,批准; [acc] /əˈpruːv/;
similar: [x] adj. 相似的;类似的;  n. 类似物;相像的人;相似物; [acc] /ˈsɪmələr/;
hail: [x] n. 冰雹;一阵;  v. 下冰雹;歌颂; [acc] /heɪl/;
leopard: [x] n. 豹;美洲豹;美洲虎; [acc] /ˈlepərd/;
contribution: [x] n. 贡献,投稿稿件,捐献物; [acc] /ˌkɑːntrɪˈbjuːʃn/;
obtain: [x] v. 获得,赢得,取得;存在,流行,适用; [acc] /əbˈteɪn/;
threaten: [x] vt. 威胁;危及;恐吓;预示..的恶兆;  v. 恐吓; [acc] /ˈθretn/;
apparatus: [x] n. 装置,仪器;设备;组织,机构; [acc] /ˌæpəˈrætəs/;
strait: [x] n. 海峡;窘迫; [acc] /streɪt/;
decrease: [x] v. 减少;减;  n. 减;减少; [acc] /dɪˈkriːs/;
pristine: [x] adj. 原始的;古时的;纯朴的;崭新的; [acc] /ˈprɪstiːn/;
primary: [x] adj. 初等教育的;初级的;基本的;首要的;主要的;  n. 首选;(美)初选; [acc] /ˈpraɪmeri/;
curt: [x] adj. 简略的; [acc] /kɜːrt/;
account: [x] n. 账户;原因,理由;叙述;  v. 报账,做出说明(或解释),为.负责,受罚;认为,考虑; [acc] /əˈkaʊnt/;
relevant: [x] adj. 有关的;恰当的;贴切的; [acc] /ˈreləvənt/;
advantageous: [x] adj. 有利的; [acc] /ˌædvənˈteɪdʒəs/;
assert: [x] v. 断言;肯定地说;坚持;维护; [acc] /əˈsɜːrt/;
absorb: [x] vt. 吸收;汲取;吸引..的注意;理解,掌握;承受; [acc] /əbˈzɔːrb/;
thermal: [x] adj. 保暖的;温泉的;热的;  n. 保暖内衣裤; [acc] /ˈθɜːrml/;
ward: [x] n. 病房;行政区;受监护人;  v. 守护,躲开; [acc] /wɔːrd/;
tile: [x] n. 瓦;瓷砖;  v. 贴砖于;用瓦盖; [acc] /taɪl/;
preclude: [x] v. 阻止;排除; [acc] /prɪˈkluːd/;
authority: [x] n. 权威;威信;当局,官方;权力,职权; [acc] /əˈθɔːrəti/;
hasty: [x] adj. 匆忙的;仓促完成的;草率的; [acc] /ˈheɪsti/;
facilitate: [x] v. 为他人提供方便;使便利;  vt. 促进; [acc] /fəˈsɪlɪteɪt/;
shrimp: [x] n. (小)虾; [acc] /ʃrɪmp/;
remain: [x] v. 剩余;逗留;保持不变;依然,继续;  n. 剩余物;遗迹;残骸; [acc] /rɪˈmeɪn/;
publicity: [x] n. 公开(性),公众的关注;宣传;名声; [acc] /pʌbˈlɪsəti/;
strand: [x] n. (线等的)股,缕;一个组成部分;海滨,河岸,海滩,湖滨;  v. 使陷入困境;使滞留,使搁浅; [acc] /strænd/;
valve: [x] n. 阀门,活门; [acc] /vælv/;
assume: [x] v. 猜想;以为,假设;呈现;就职;(想当然地)认为;承担(责任); [acc] /əˈsuːm/;
insight: [x] n. 深刻的理解,洞察力,见识; [acc] /ˈɪnsaɪt/;
witness: [x] n. 目击者,证人;  v. 目击,亲眼看见;为..作证; [acc] /ˈwɪtnəs/;
proposition: [x] n. 提议,计划,命题;  v. 向.求欢; [acc] /ˌprɑːpəˈzɪʃn/;
bowel: [x] n. 肠;内部; [acc] /ˈbaʊəl/;
motto: [x] n. 座右铭;格言;箴言;口号; [acc] /ˈmɑːtoʊ/;
distinguish: [x] v. 区别,识别,辨别,使显著; [acc] /dɪˈstɪŋɡwɪʃ/;
objection: [x] n. 反对,异议; [acc] /əbˈdʒekʃn/;
emergency: [x] n. 紧急情况;突发事件; [acc] /iˈmɜːrdʒənsi/;
barge: [x] n. 平底货船,驳船;  v. 猛撞; [acc] /bɑːrdʒ/;
cautious: [x] adj. 小心的,谨慎的; [acc] /ˈkɔːʃəs/;
drastic: [x] adj. 极端的;猛烈的;激烈的; [acc] /ˈdræstɪk/;
absorption: [x] n. 吸收;全神贯注;合并; [acc] /əbˈsɔːrpʃn/;
privacy: [x] n. 隐私;秘密;私生活; [acc] /ˈpraɪvəsi/;
primitive: [x] adj. 原始的;简陋的;  n. 原始人; [acc] /ˈprɪmətɪv/;
inspector: [x] n. 检查员,督察员;视察者,检阅者;(英)查票员; [acc] /ɪnˈspektər/;
exceptional: [x] adj. 优越的,杰出的;异常的; [acc] /ɪkˈsepʃənl/;
merchandise: [x] n. 商品,货品;  v. 推销,经营; [acc] /ˈmɜːrtʃəndaɪs/;
polymer: [x] n. 聚合体; [acc] /ˈpɑːlɪmər/;
sophisticated: [x] adj. (仪器)精密的,复杂的;老于世故的,老练的,富有经验的;高雅的,精致的; [acc] /səˈfɪstɪkeɪtɪd/;
astronomer: [x] n. 天文学家; [acc] /əˈstrɑːnəmər/;
moor: [x] v. 停泊;系住;  n. 旷野地;荒野; [acc] /mʊr/;
furnish: [x] v. (用家具等)布置(房间,公寓等);供应,提供; [acc] /ˈfɜːrnɪʃ/;
disastrous: [x] adj. 灾难性的; [acc] /dɪˈzæstrəs/;
squat: [x] adj. 蹲着的;  v. 蹲坐,蹲伏;  n. 蹲坐; [acc] /skwɑːt/;
blink: [x] v. 眨眼睛;闪亮;闪烁;  n. 眨眼睛; [acc] /blɪŋk/;
ascend: [x] v. 沿着.上升,攀登; [acc] /əˈsend/;
force: [x] v. 强迫;推动;凭借武力前进;  n. 力量;武力;势力; [acc] /fɔːrs/;
commit: [x] v. 犯(罪);进行 (自杀);调拨 (钱,资源);监禁;送交 (到精神病院,监狱等);承诺,保证; [acc] /kəˈmɪt/;
athlete: [x] n. 运动员,体育家,强壮的人; [acc] /ˈæθliːt/;
perish: [x] vi. 死去;毁灭,灭亡;  v. 脆裂,老化,腐烂; [acc] /ˈperɪʃ/;
discriminate: [x] v. 区别,辨别;歧视; [acc] /dɪˈskrɪmɪneɪt/;
filth: [x] n. 污秽图片;污物;对警察的冒犯言辞; [acc] /fɪlθ/;
creation: [x] n. 创造,创作;创造物,作品; [acc] /kriˈeɪʃn/;
cavity: [x] n. 洞;龋洞; [acc] /ˈkævəti/;
bug: [x] n. [计算机](制作软件程序所产生的意料不到的)错误,故障;窃听器;热衷于(某事)者;臭虫,小虫子;  v. 使厌烦,打扰;窃听;  vt. 使烦恼,纠缠; [acc] /bʌɡ/;
cynical: [x] adj. 愤世嫉俗的;恶意的;悲观的; [acc] /ˈsɪnɪkl/;
currency: [x] n. 货币;流通;流行; [acc] /ˈkɜːrənsi/;
bound: [x] adj. 受约束的;有义务的;一定的;  v. 束缚;跳跃着前行;  n. 跳跃;范围;界限; [acc] /baʊnd/;
complicated: [x] adj. 复杂的;难解的;  v. 使复杂; [acc] /ˈkɑːmplɪkeɪtɪd/;
salute: [x] n. 致意;致敬,欢迎;  v. 向..行举手礼;敬礼; [acc] /səˈluːt/;
pasture: [x] n. 牧场,草地;生活状况;  v. 放牧; [acc] /ˈpæstʃər/;
maiden: [x] n. (文学)少女,未嫁女子;  adj. 未婚的,处女的,初次的; [acc] /ˈmeɪdn/;
swap: [x] v. 交换;替换;对调;  n. 交换;交换物; [acc] /swɑːp/;
band: [x] n. 乐队;帮伙;带;  v. 用带捆扎;联合; [acc] /bænd/;
graduate: [x] v. 毕业;渐变;渐渐变为;取得资格;授予.学位;  n. 大学毕业生;学位获得者;  adj. 毕业的;研究生的; [acc] /ˈɡrædʒuət/;
endurance: [x] n. 忍耐力,耐性,耐用度; [acc] /ɪnˈdʊrəns/;
visualize: [x] v. 使形象化;想象; [acc] /ˈvɪʒuəlaɪz/;
oxidize: [x] v. 生锈;氧化; [acc] /ˈɑːksɪdaɪz/;
salvation: [x] n. 拯救,救赎;救助;救世; [acc] /sælˈveɪʃn/;
flask: [x] n. 烧瓶;长颈瓶;扁瓶; [acc] /flæsk/;
promote: [x] v. 提升;促进;发扬;促销; [acc] /prəˈmoʊt/;
background: [x] n. 图片背景,底色;出身;背景;时代背景; [acc] /ˈbækɡraʊnd/;
extract: [x] v. 取出;提取;摘录;设法得到;索取;  n. 摘录;提出物; [acc] /ɪkˈstrækt/;
fortress: [x] n. 堡垒;要塞; [acc] /ˈfɔːrtrəs/;
terrify: [x] v. 使害怕;使惊恐; [acc] /ˈterɪfaɪ/;
vary: [x] v. 相异;改变,变化;使多样化; [acc] /ˈveri/;
diversion: [x] n. 绕行路;转移,改变方向;分心,消遣;分水渠; [acc] /daɪˈvɜːrʒn/;
deliberate: [x] adj. 故意的;深思熟虑的;从容不迫的;  v. 仔细考虑;研讨; [acc] /dɪˈlɪbərət/;
dazzle: [x] n. 光辉;令人赞叹的东西;  v. 使眼花;使赞叹不已; [acc] /ˈdæzl/;
evoke: [x] v. 唤起;引起;使人想起; [acc] /ɪˈvoʊk/;
twinkle: [x] vi. 闪烁;闪闪发光; [acc] /ˈtwɪŋkl/;
overlook: [x] v. 忽视,未注意到;眺望,俯视;  n. 忽视,远眺; [acc] /ˌoʊvərˈlʊk/;
pantry: [x] n. 食品室;餐具室; [acc] /ˈpæntri/;
shrewd: [x] adj. 精明的;机灵的;  n. 精明;精明者; [acc] /ʃruːd/;
deflect: [x] v. (使)偏斜,(使)偏转; [acc] /dɪˈflekt/;
cradle: [x] n. 摇篮;策源地,发源地;  v. 轻轻地抱,捧; [acc] /ˈkreɪdl/;
originality: [x] n. 创造性;独创性; [acc] /əˌrɪdʒəˈnæləti/;
ivory: [x] n. 象牙,象牙制品;乳白色; [acc] /ˈaɪvəri/;
malice: [x] n. 恶意,怨恨; [acc] /ˈmælɪs/;
blond: [x] adj. 金色的,亚麻色的(头发);白皙的,金发碧眼的(人); [acc] /blɑnd/;
diesel: [x] n. 内燃机,柴油机; [acc] /ˈdiːzl/;
destination: [x] n. 目的地,终点;  adj. 目的地的; [acc] /ˌdestɪˈneɪʃn/;
hoe: [x] n. 锄头;  v. 用锄耕地; [acc] /hoʊ/;
blush: [x] v. 脸红;害臊;  n. 脸红; [acc] /blʌʃ/;
hazard: [x] n. 公害;危险;危险的事物;机会;  v. 使冒危险;冒险做; [acc] /ˈhæzərd/;
litter: [x] n. 垃圾;杂乱;  v. 乱丢; [acc] /ˈlɪtər/;
heave: [x] v. 用力举起;掷扔;发出叹息;恶心;  n. 举起,升降; [acc] /hiːv/;
bridegroom: [x] n. 新郎; [acc] /ˈbraɪdɡruːm/;
environmental: [x] adj. 周围的;环境的; [acc] /ɪnˌvaɪrənˈmentl/;
compensate: [x] v. 补偿,赔偿,给..报酬; [acc] /ˈkɑːmpenseɪt/;
coup: [x] n. 政变;出乎意料的行动或胜利; [acc] /kuː/;
input: [x] n. 投入;[电学,计算机]输入;  vt. 输入; [acc] /ˈɪnpʊt/;
reinforce: [x] v. 加固;加强;增援;支持; [acc] /ˌriːɪnˈfɔːrs/;
postal: [x] adj. 邮政的,邮局的;邮件的; [acc] /ˈpoʊstl/;
announcement: [x] n. 宣告,发表,一项公告; [acc] /əˈnaʊnsmənt/;
patron: [x] n. 老主顾;赞助人;支持者; [acc] /ˈpeɪtrən/;
spacious: [x] adj. 宽敞的,广阔的; [acc] /ˈspeɪʃəs/;
mortgage: [x] n. 按揭贷款,抵押贷款;  v. 抵押; [acc] /ˈmɔːrɡɪdʒ/;
murmur: [x] v. 低声说,低语;低声抱怨;  n. 低语;喃喃说话声; [acc] /ˈmɜːrmər/;
manuscript: [x] n. 手稿;底稿;手抄本; [acc] /ˈmænjuskrɪpt/;
poster: [x] n. 海报,张贴的大幅广告;贴标语的人; [acc] /ˈpoʊstər/;
bushel: [x] n. (pl.)大量;蒲式耳(容量等于八加仑); [acc] /ˈbʊʃl/;
alien: [x] n. 外国人;外星人;  adj. 陌生的;外国的,外星(人)的;异己的,不相容的; [acc] /ˈeɪliən/;
guilt: [x] n. 内疚;罪行;罪恶感; [acc] /ɡɪlt/;
hurricane: [x] n. 飓风; [acc] /ˈhɜːrəkeɪn/;
deadly: [x] adj. 致命的,致死的,十足的;  adv. 死一般地;非常; [acc] /ˈdedli/;
convict: [x] n. 犯人;  v. (经审讯)证明..有罪,使..知罪; [acc] /ˈkɑːnvɪkt/;
catastrophe: [x] n. 大灾难; [acc] /kəˈtæstrəfi/;
elevate: [x] v. 上升;提高;举起;提拔; [acc] /ˈelɪveɪt/;
idleness: [x] n. 闲散;赋闲无事; [acc] /ˈaɪdlnəs/;
cooperative: [x] adj. 合作的;协作的;  n. 合作社; [acc] /koʊˈɑːpərətɪv/;
testimony: [x] n. 证据,证词;表明,说明;见证,证明; [acc] /ˈtestɪmoʊni/;
incomplete: [x] adj. 不完全的;未完成的,未结束的;  n. 未完成,未修毕; [acc] /ˌɪnkəmˈpliːt/;
impetus: [x] n. 推动力;促进; [acc] /ˈɪmpɪtəs/;
extraordinary: [x] adj. 非同寻常的;特别的; [acc] /ɪkˈstrɔːrdəneri/;
random: [x] adj. 随机的;任意的;胡乱的; [acc] /ˈrændəm/;
fearless: [x] adj. 大胆的,勇敢的,无畏的; [acc] /ˈfɪrləs/;
confidence: [x] n. 自信,信心;信任;有把握; [acc] /ˈkɑːnfɪdəns/;
integral: [x] adj. (用于构成整体)必需的,不可缺少的,必不可少的;基本的,作为组成部分的,内置的;整体的,完整的; [acc] /ˈɪntɪɡrəl/;
impart: [x] v. 传授,给予,将(某性质)给予或赋予某事物; [acc] /ɪmˈpɑːrt/;
levy: [x] v. 征收(税等);  n. 征税;税款; [acc] /ˈlevi/;
relish: [x] v. 享受;享受.的味道;品味;  n. 乐趣;调味品; [acc] /ˈrelɪʃ/;
revel: [x] n. 狂欢;  v. 狂欢; [acc] /ˈrevl/;
rival: [x] n. 竞争者,对手;  v. 与.竞争,与.匹敌;  adj. 竞争的,敌对的; [acc] /ˈraɪvl/;
elite: [x] n. 精英;  adj. 高级的; [acc] /ɪˈliːt/;
alliance: [x] n. 联盟,同盟;盟约;盟国,同盟者;类同; [acc] /əˈlaɪəns/;
region: [x] n. 地区,区域;范围;行政区;身体部位; [acc] /ˈriːdʒən/;
equilibrium: [x] n. (心态情感等)平静;平衡; [acc] /ˌiːkwɪˈlɪbriəm/;
pregnant: [x] adj. 怀孕的;充满的,意味深长的; [acc] /ˈpreɡnənt/;
propulsion: [x] n. 推进力; [acc] /prəˈpʌlʃn/;
prime: [x] adj. 首要的,主要的;最好的,第一流的;  n. 青春,全盛期,青壮年时期;  v. 使准备好; [acc] /praɪm/;
ascribe: [x] v. 把.归因于;把.归属于; [acc] /əˈskraɪb/;
beyond: [x] adv. 更远处,更多,以后;  prep. 超过;在能力,理解力之外;除..之外; [acc] /bɪˈjɑːnd/;
abide: [x] v. 遵守;忍受;居住; [acc] /əˈbaɪd/;
bud: [x] n. 蓓蕾,芽;  v. 使发芽; [acc] /bʌd/;
pirate: [x] n. 海盗;剽窃者;  v. 剽窃; [acc] /ˈpaɪrət/;
diffuse: [x] v. 传播;扩散,弥漫;漫射;  adj. 四散的,散开的;不清楚的; [acc] /dɪˈfjuːz/;
proximity: [x] n. 接近;邻近; [acc] /prɑːkˈsɪməti/;
manual: [x] n. 手册;指南;  adj. 手的;手制的;手工的;体力的; [acc] /ˈmænjuəl/;
gutter: [x] n. 水槽,檐槽,排水沟;贫民区;  v. (蜡烛)忽明忽暗; [acc] /ˈɡʌtər/;
factual: [x] adj. 事实的;真实的; [acc] /ˈfæktʃuəl/;
identity: [x] n. 身份;特性;一致; [acc] /aɪˈdentəti/;
bacterium: [x] n. 细菌; [acc] /bæk'tɪriəm/;
alienate: [x] v. 疏远;挑拨; [acc] /ˈeɪliəneɪt/;
academic: [x] adj. 学术的;学院的,大学的;理论的;  n. 学者; [acc] /ˌækəˈdemɪk/;
orthodox: [x] adj. 正统的;传统的;(Orthodox)东正教的; [acc] /ˈɔːrθədɑːks/;
resign: [x] v. 辞职; [acc] /rɪˈzaɪn/;
retirement: [x] n. 退休,退休生活;退役; [acc] /rɪˈtaɪərmənt/;
diploma: [x] n. 毕业文凭,毕业证书;文凭课程; [acc] /dɪˈploʊmə/;
implication: [x] n. 暗示;含意;牵连;卷入;可能的后果; [acc] /ˌɪmplɪˈkeɪʃn/;
fascinate: [x] v. 使着迷;使神魂颠倒;吸引注意; [acc] /ˈfæsɪneɪt/;
shovel: [x] n. 铁锨,铲;  v. 铲起; [acc] /ˈʃʌvl/;
psychology: [x] n. 心理学;心理状态;心理; [acc] /saɪˈkɑːlədʒi/;
household: [x] n. 同住在一家的人;家务;家常普通的;  adj. 家庭的,家内的,一家的;家喻户晓的; [acc] /ˈhaʊshoʊld/;
appease: [x] v. 抚慰;平息; [acc] /əˈpiːz/;
obedient: [x] adj. 服从的,顺从的;孝顺的; [acc] /oʊˈbiːdiənt/;
slash: [x] n. 砍痕;砍;  v. 砍,大幅度削减; [acc] /slæʃ/;
cocktail: [x] n. 鸡尾酒;餐前开胃小吃;混合物; [acc] /ˈkɑːkteɪl/;
intuition: [x] n. 直觉;感觉; [acc] /ˌɪntuˈɪʃn/;
consist: [x] v. 由..组成;在于; [acc] /kənˈsɪst/;
terminology: [x] n. 术语,术语学; [acc] /ˌtɜːrməˈnɑːlədʒi/;
regulation: [x] n. 法规,条例,规章;管理; [acc] /ˌreɡjuˈleɪʃn/;
pluck: [x] v. 拔去(毛发等);拽开;选;  n. 勇气; [acc] /plʌk/;
gross: [x] adj. 总的,毛重的;恶心的;粗鲁的;  n. 总量,总额;  adv. 总共地;  vt. 总共赚得; [acc] /ɡroʊs/;
contract: [x] n. 合同,契约;  v. 感染(疾病);招致;订合同;订立(婚约);缩减; [acc] /ˈkɑːntrækt/;
absence: [x] n. 缺席;缺勤;缺乏;缺席,心不在焉; [acc] /ˈæbsəns/;
embed: [x] v. 把.嵌入;使嵌入; [acc] /ɪmˈbed/;
degradation: [x] n. 降级,降格;退化;恶化; [acc] /ˌdeɡrəˈdeɪʃn/;
rattle: [x] n. 格格声,发出嘎嘎声的儿童玩具,(响尾蛇)音响器官;  v. (使)发出格格声,(人或车)疾驰,使烦扰; [acc] /ˈrætl/;
tablet: [x] n. 药片;便笺簿;碑,匾; [acc] /ˈtæblət/;
conception: [x] n. 怀孕,构想,设想,思想,观念; [acc] /kənˈsepʃn/;
dwell: [x] v. (尤指作为常住居民)居住; [acc] /dwel/;
famine: [x] n. 饥荒;严重的缺乏; [acc] /ˈfæmɪn/;
trend: [x] n. 趋势;倾向;时尚;  v. 倾向;走向;转向;使趋向; [acc] /trend/;
sector: [x] n. (经济等)部门,部分;战区,防区;扇形,扇区; [acc] /ˈsektər/;
stuffy: [x] adj. 闷热的;古板的;鼻子不通气的; [acc] /ˈstʌfi/;
brightness: [x] n. 明亮;聪明,智慧;[光]亮度; [acc] /ˈbraɪtnəs/;
gallery: [x] n. 美术馆,画廊;(大厅的)旁听席,边座; [acc] /ˈɡæləri/;
eruption: [x] n. 喷发;(情绪)爆发;出疹; [acc] /ɪˈrʌpʃn/;
convene: [x] v. 集合,召集,召唤; [acc] /kənˈviːn/;
item: [x] n. 物品;条,条款,项目; [acc] /ˈaɪtəm/;
constrain: [x] v. 约束;限制;强迫; [acc] /kənˈstreɪn/;
ranch: [x] n. 大农场; [acc] /ræntʃ/;
contact: [x] v. 接触;联系;  n. 接触;联系;  adj. 保持接触的;由接触引起的;[航]可看见地面景物的;  adv. [航]以目力观察(飞行);  int. 开动; [acc] /ˈkɑːntækt/;
repay: [x] v. 偿还(钱款或债务);报答;回报; [acc] /rɪˈpeɪ/;
negligible: [x] adj. 微不足道的,可忽略不计的; [acc] /ˈneɡlɪdʒəbl/;
executive: [x] n. 执行者;经理;行政人员;  adj. 执行的; [acc] /ɪɡˈzekjətɪv/;
hostile: [x] adj. 敌对的,敌方的;怀敌意的; [acc] /ˈhɑːstl/;
lash: [x] v. 鞭打;猛烈抨击;捆绑;摆动;猛击;  n. 鞭梢;鞭打; [acc] /læʃ/;
navigation: [x] n. 导航,航行,航海; [acc] /ˌnævɪˈɡeɪʃn/;
idiot: [x] n. 愚蠢的人,白痴; [acc] /ˈɪdiət/;
humble: [x] adj. 卑微的;(级别或地位)低下的,简陋的;谦逊的;  v. 使⋯谦逊,使⋯卑下;轻松打败(尤指强大的对手); [acc] /ˈhʌmbl/;
beetle: [x] n. 甲虫;  v. 快速移动; [acc] /ˈbiːtl/;
residential: [x] adj. 居住的,住宅的;寄宿的; [acc] /ˌrezɪˈdenʃl/;
admiration: [x] n. 钦佩;仰慕; [acc] /ˌædməˈreɪʃn/;
climate: [x] n. 气候;(社会思想等)趋势; [acc] /ˈklaɪmət/;
turtle: [x] n. 海龟; [acc] /ˈtɜːrtl/;
thrash: [x] v. 打(谷),(用棍,鞭等)痛打,打败,使逆行,胜过;  n. 敲击摇滚乐; [acc] /θræʃ/;
offensive: [x] adj. 冒犯的,进攻的,无礼的,令人不快的,得罪人的;  n. 进攻; [acc] /əˈfensɪv/;
panic: [x] n. 恐慌;惊慌;慌乱;  v. (使)恐慌;使..惊慌失措;  adj. 恐慌的,惊慌的; [acc] /ˈpænɪk/;
coffin: [x] n. 棺材; [acc] /ˈkɔːfɪn/;
wealthy: [x] n. 富人;  adj. 富有的;充分的; [acc] /ˈwelθi/;
recreation: [x] n. 娱乐活动,消遣; [acc] /ˌrekriˈeɪʃn/;
captive: [x] adj. 被捕获的;被俘虏的;  n. 俘虏; [acc] /ˈkæptɪv/;
narration: [x] n. 叙述;解说;配音; [acc] /nəˈreɪʃn/;
parallel: [x] adj. 平行的;相似的;  n. 相似物;平行线;  v. 与..相似;与..匹配;  adv. 并行地,平行地; [acc] /ˈpærəlel/;
windmill: [x] n. 风车;风车房; [acc] /ˈwɪndmɪl/;
transcend: [x] v. 超越(经验,理性,信念等)的范围,超过; [acc] /trænˈsend/;
syndrome: [x] n. ［医］综合征;一系列表现; [acc] /ˈsɪndroʊm/;
canvas: [x] n. 帆布,(帆布)油画; [acc] /ˈkænvəs/;
gaze: [x] v. 凝视,注视;  n. 凝视,注视; [acc] /ɡeɪz/;
transmission: [x] n. 发射,转播,传播,变速器; [acc] /trænsˈmɪʃn/;
stationery: [x] n. 文具;(有配套信封的)信纸; [acc] /ˈsteɪʃəneri/;
sociable: [x] adj. 好交际的; [acc] /ˈsoʊʃəbl/;
verdict: [x] n. (陪审团)裁决;定论;意见; [acc] /ˈvɜːrdɪkt/;
penalty: [x] n. 惩罚,处罚,不利,罚球;  adj. 处罚的; [acc] /ˈpenəlti/;
intelligible: [x] adj. 可理解的,明白易懂的; [acc] /ɪnˈtelɪdʒəbl/;
shipwreck: [x] n. 遇难船;船只失事;  v. 使遭遇海难; [acc] /ˈʃɪprek/;
federation: [x] n. 同盟,联盟,联邦; [acc] /ˌfedəˈreɪʃn/;
perception: [x] n. 洞察力,理解力;洞察力,理解力,认识,观念,看法; [acc] /pərˈsepʃn/;
literary: [x] adj. 文学的,文学上的;精通文学的;以写作为职业的;书本上的;书面的;书面语的; [acc] /ˈlɪtəreri/;
aware: [x] adj. 意识到的,知道的; [acc] /əˈwer/;
anonymous: [x] adj. 匿名的;无名的;不具名的;无特色的;无个性特征; [acc] /əˈnɑːnɪməs/;
straightforward: [x] adj. 坦率的,笔直的,正直的,直接的; [acc] /ˌstreɪtˈfɔːrwərd/;
gnaw: [x] v. 啃,咬,消耗,侵蚀; [acc] /nɔː/;
embark: [x] v. 上船或飞机;开始,着手,从事; [acc] /ɪmˈbɑːrk/;
prophet: [x] n. 先知,预言者; [acc] /ˈprɑːfɪt/;
defeat: [x] n. 挫败;击败,战胜;  v. 打败;战胜; [acc] /dɪˈfiːt/;
gigantic: [x] adj. 巨大的; [acc] /dʒaɪˈɡæntɪk/;
efficient: [x] adj. 效率高的;有能力的;能胜任的; [acc] /ɪˈfɪʃnt/;
owl: [x] n. 猫头鹰; [acc] /aʊl/;
utilization: [x] n. 利用; [acc] /ˌjuːtələˈzeɪʃn/;
earnings: [x] n. 工资;收入;收益; [acc] /ˈɜːrnɪŋz/;
concentration: [x] n. 集中;专注;浓缩; [acc] /ˌkɑːnsnˈtreɪʃn/;
rascal: [x] n. 不诚实的人;坏蛋,淘气鬼; [acc] /ˈræskl/;
toward: [x] prep. 向;朝;对于; [acc] /tɔːrd/;
hostility: [x] n. 虐待,敌意;不友善;敌对; [acc] /hɑːˈstɪləti/;
lure: [x] v. 引诱;以诱饵吸引;  n. 诱惑力;诱惑物;鱼饵; [acc] /lʊr/;
glamour: [x] n. 魅力;诱惑力; [acc] /ˈɡlæmər/;
skull: [x] n. 颅骨;脑壳; [acc] /skʌl/;
symbol: [x] n. 象征;符号,图标;记号;标志; [acc] /ˈsɪmbl/;
calcium: [x] n. 钙; [acc] /ˈkælsiəm/;
reputation: [x] n. 名声;声誉; [acc] /ˌrepjuˈteɪʃn/;
pajamas: [x] n. (=pyjamas)睡衣,宽长裤; [acc] /pəˈdʒæməz/;
sensation: [x] n. 感觉;知觉;轰动; [acc] /senˈseɪʃn/;
urban: [x] adj. 城市的,城镇的,都市的; [acc] /ˈɜːrbən/;
peripheral: [x] adj. 外围的;  n. 外围设备; [acc] /pəˈrɪfərəl/;
offspring: [x] n. 后代; [acc] /ˈɔːfsprɪŋ/;
mobilize: [x] v. 动员起来;动员;鼓动起; [acc] /ˈmoʊbəlaɪz/;
signify: [x] vi. 具有重要性;  vt. 表示; [acc] /ˈsɪɡnɪfaɪ/;
capsule: [x] n. 胶囊;航天舱,密封舱; [acc] /ˈkæpsl/;
auditorium: [x] n. 〈美〉讲堂;听众席; [acc] /ˌɔːdɪˈtɔːriəm/;
productive: [x] adj. 多产的;产生..的;富有成效的; [acc] /prəˈdʌktɪv/;
console: [x] v. 安慰,慰问;  n. 控制台,仪表板;落地柜; [acc] /kənˈsoʊl/;
audience: [x] n. (演讲,音乐会等的)听众,观众;正式会见;拥护者; [acc] /ˈɔːdiəns/;
disapprove: [x] v. 不同意; [acc] /ˌdɪsəˈpruːv/;
obligation: [x] n. 义务,责任; [acc] /ˌɑːblɪˈɡeɪʃn/;
reef: [x] n. 礁;  v. 收帆,缩帆; [acc] /riːf/;
vent: [x] n. 发泄;通风口,排气口;(上衣背部或两侧的)开衩;(小型动物的)排泄口;  v. 发泄(情绪),开孔,泄露; [acc] /vent/;
attitude: [x] n. 态度;看法;姿势; [acc] /ˈætɪtuːd/;
linguistic: [x] adj. 语言的,语言上的; [acc] /lɪŋˈɡwɪstɪk/;
status: [x] n. 地位;状态;身份; [acc] /ˈsteɪtəs/;
cruise: [x] n. 巡航;漫游;旅行;  v. 航游;巡航;(出租车,船等)缓慢巡行; [acc] /kruːz/;
tame: [x] adj. 驯服的,温顺的;顺从的;枯燥的;  v. 驯服; [acc] /teɪm/;
barrier: [x] n. 障碍;屏障;隔阂;壁垒;  v. 用栅栏围住; [acc] /ˈbæriər/;
tuberculosis: [x] n. 肺结核; [acc] /tuːˌbɜːrkjəˈloʊsɪs/;
missionary: [x] n. 传教士; [acc] /ˈmɪʃəneri/;
gracious: [x] adj. 和善的;亲切的;优美的;奢华的; [acc] /ˈɡreɪʃəs/;
appendix: [x] n. 附录;阑尾;附属物; [acc] /əˈpendɪks/;
drawback: [x] n. 缺点;障碍,不利条件; [acc] /ˈdrɔːbæk/;
apartment: [x] n. (美)公寓,一套房间; [acc] /əˈpɑːrtmənt/;
ancient: [x] adj. 远古的,古代的,古老的;  n. 古代人;古文明国的国民; [acc] /ˈeɪnʃənt/;
proficient: [x] adj. 精通的,熟练的; [acc] /prəˈfɪʃnt/;
slippery: [x] adj. 滑的;易滑脱的;不老实的;不稳定的; [acc] /ˈslɪpəri/;
adapt: [x] vi. 适应不同情况;  vt. 使适合;改编; [acc] /əˈdæpt/;
intestine: [x] n. 肠; [acc] /ɪnˈtestɪn/;
radiant: [x] adj. 光芒四射的,绚丽的;喜悦的; [acc] /ˈreɪdiənt/;
wharf: [x] n. 码头; [acc] /wɔːrf/;
stairway: [x] n. 楼梯; [acc] /ˈsterweɪ/;
ore: [x] n. 矿石;矿砂;矿,矿石; [acc] /ɔːr/;
epilogue: [x] n. 收场白;尾声; [acc] /ˈepɪlɔːɡ/;
coke: [x] n. 可乐;焦炭; [acc] /koʊk/;
bureaucracy: [x] n. 官僚主义;政府机构; [acc] /bjʊˈrɑːkrəsi/;
component: [x] n. 零件;  adj. 组成的; [acc] /kəmˈpoʊnənt/;
quota: [x] n. 配额;限额;定额; [acc] /ˈkwoʊtə/;
rip: [x] n. 裂缝,裂口;  v. 撕开,扯破,裂开,敲诈; [acc] /rɪp/;
aviation: [x] n. 航空,航空学;飞机制造业; [acc] /ˌeɪviˈeɪʃn/;
module: [x] n. 组件,模件,(航天器的)舱;(组成一门课程的)独立单元; [acc] /ˈmɑːdʒuːl/;
nourishment: [x] n. 食物,营养品; [acc] /ˈnɜːrɪʃmənt/;
vigorous: [x] adj. 精力充沛的;强有力的,有活力的;强健的; [acc] /ˈvɪɡərəs/;
original: [x] adj. 有独创性的,原始的,最初的,新颖的;  n. 原件;怪人; [acc] /əˈrɪdʒənl/;
noted: [x] adj. 著名的; [acc] /ˈnoʊtɪd/;
brilliant: [x] adj. 聪颖的;卓越的,有才气的;明亮的; [acc] /ˈbrɪliənt/;
pumpkin: [x] n. 南瓜,倭瓜; [acc] /ˈpʌmpkɪn/;
respective: [x] adj. 各自的; [acc] /rɪˈspektɪv/;
sieve: [x] n. 筛子,粗篮;  v. 筛,滤; [acc] /sɪv/;
erase: [x] v. (计算机)擦除;抹去;擦掉; [acc] /ɪˈreɪs/;
formidable: [x] adj. 令人畏惧的;可怕的;难以克服的;难应付的; [acc] /ˈfɔːrmɪdəbl/;
glitter: [x] v. 闪闪发光,闪耀;  n. 灿烂的光辉,闪光; [acc] /ˈɡlɪtər/;
dedicate: [x] v. 献给,致力于; [acc] /ˈdedɪkeɪt/;
adore: [x] v. 很喜欢,极喜爱;崇拜;爱慕; [acc] /əˈdɔːr/;
repeal: [x] n. 撤销;  v. 废除;废止; [acc] /rɪˈpiːl/;
couch: [x] n. 长沙发;长椅;长榻;  v. 表达; [acc] /kaʊtʃ/;
provided: [x] conj. 假如,如果,以..为条件;  adj. 预备好的,提供的; [acc] /prəˈvaɪdɪd/;
activate: [x] v. 使活动起来;使开始起作用; [acc] /ˈæktɪveɪt/;
repression: [x] n. 压抑,压制,镇压; [acc] /rɪˈpreʃn/;
depict: [x] v. 描绘,描写; [acc] /dɪˈpɪkt/;
ruthless: [x] adj. 无情的;残忍的; [acc] /ˈruːθləs/;
peg: [x] n. 小钉,栓,挂物钉;晾衣夹;  v. 用钉子钉,用钉(或桩等)固定;限定(价格,工资等);将.看成,将.归入; [acc] /peɡ/;
affection: [x] n. 关爱,爱慕;感情;作用,影响;疾病; [acc] /əˈfekʃn/;
tiresome: [x] adj. 使人疲倦的;烦人的,讨厌的;无聊的; [acc] /ˈtaɪərsəm/;
forge: [x] n. 熔炉;锻工车间;铁匠店;  v. 锻造;经锻炼而形成;伪造;推进,加强; [acc] /fɔːrdʒ/;
economic: [x] adj. 经济上的,经济学的;合算的;有利可图的; [acc] /ˌekəˈnɑːmɪk/;
assassination: [x] n. 暗杀; [acc] /əˌsæsəˈneɪʃn/;
refinery: [x] n. 精炼厂; [acc] /rɪˈfaɪnəri/;
prosperous: [x] adj. 富裕的;繁荣的;茂盛的;茁壮生长的; [acc] /ˈprɑːspərəs/;
fixture: [x] n. 固定装置;体育项目; [acc] /ˈfɪkstʃər/;
acquire: [x] v. (尤指靠自己的努力或行动或经过一个过程)获得;学到;取得; [acc] /əˈkwaɪər/;
sneak: [x] vi. 鬼鬼祟祟地走;打小报告;  vt. 潜行;偷窃;  adj. 偷偷的;  n. 行为鬼祟的人; [acc] /sniːk/;
fury: [x] n. 狂怒,暴怒; [acc] /ˈfjʊri/;
plaster: [x] n. 灰泥,石膏;  v. 抹泥; [acc] /ˈplæstər/;
dismay: [x] n. 失望;沮丧;惊愕;  v. 使惊恐; [acc] /dɪsˈmeɪ/;
inorganic: [x] adj. 无机的; [acc] /ˌɪnɔːrˈɡænɪk/;
complication: [x] n. (新出现的)困难,难题;并发症; [acc] /ˌkɑːmplɪˈkeɪʃn/;
grin: [x] v. 露齿而笑,咧嘴一笑;  n. 龇牙笑; [acc] /ɡrɪn/;
dim: [x] adj. 暗淡的;模糊的;朦胧的;  v. 变暗淡; [acc] /dɪm/;
leakage: [x] n. 泄漏; [acc] /ˈliːkɪdʒ/;
dread: [x] v. 惧怕,害怕;  n. 畏惧,恐惧;  adj. 恐怖的,使人敬畏的; [acc] /dred/;
vigour: [x] n. 活力; [acc] /ˈvɪɡər/;
confirmation: [x] n. 证实,确认,批准; [acc] /ˌkɑːnfərˈmeɪʃn/;
knit: [x] v. 编结,针织;  n. 编织的衣服;针织衫; [acc] /nɪt/;
confirm: [x] v. 确认;证实;批准; [acc] /kənˈfɜːrm/;
guideline: [x] n. 指导路线,准则; [acc] /ˈɡaɪdlaɪn/;
sham: [x] n. 假货;虚假;欺诈;  v. 假装;  adj. 虚假的,假装的; [acc] /ʃæm/;
readily: [x] adv. 容易地;乐意地;欣然地; [acc] /ˈredɪli/;
subsequent: [x] adj. 随后的; [acc] /ˈsʌbsɪkwənt/;
chestnut: [x] n. 栗子,栗树;  adj. 栗色的; [acc] /ˈtʃesnʌt/;
shark: [x] n. 鲨鱼;骗子; [acc] /ʃɑːrk/;
scrub: [x] v. 用力擦洗;宣布中止;  n. 灌木丛;擦洗; [acc] /skrʌb/;
escort: [x] n. 护送者;  v. 护送; [acc] /ˈeskɔːrt/;
adhere: [x] v. 遵守;坚持;粘附;附着,粘在..上; [acc] /ədˈhɪr/;
molten: [x] adj. 熔化的; [acc] /ˈmoʊltən/;
temper: [x] n. 脾气,性情;调和剂;  v. 锻炼,缓和; [acc] /ˈtempər/;
instinct: [x] n. 天性;本能;直觉;  adj. 充满的; [acc] /ˈɪnstɪŋkt/;
ignite: [x] v. 点燃,发光,燃烧; [acc] /ɪɡˈnaɪt/;
federal: [x] adj. 联邦制的;联邦政府的; [acc] /ˈfedərəl/;
shutter: [x] n. 百叶窗;照相机快门; [acc] /ˈʃʌtər/;
resemblance: [x] n. 相似,形似; [acc] /rɪˈzembləns/;
unanimous: [x] adj. 全体一致的;一致同意的; [acc] /juˈnænɪməs/;
confession: [x] n. 忏悔;坦白,供认;教派; [acc] /kənˈfeʃn/;
toad: [x] n. [动]蟾蜍,癞蛤蟆,讨厌的家伙; [acc] /toʊd/;
recipe: [x] n. 方法;食谱; [acc] /ˈresəpi/;
tickle: [x] v. 呵.痒,使发痒;使高兴;  n. 痒; [acc] /ˈtɪkl/;
pastry: [x] n. 糕点,点心; [acc] /ˈpeɪstri/;
eclipse: [x] n. (日,月)食;黯然失色;  v. 掩盖..的重要性;使暗淡; [acc] /ɪˈklɪps/;
luxurious: [x] adj. 奢侈的,豪华的; [acc] /lʌɡˈʒʊriəs/;
screw: [x] n. 螺旋;螺丝;  v. 拧紧;  vi. 敲诈勒索;  vt. 用螺钉固定;把.拧紧; [acc] /skruː/;
deprive: [x] v. 使丧失;剥夺;免去.的职务; [acc] /dɪˈpraɪv/;
recede: [x] vi. 退去;渐渐远去;(尤指问题,感情或品质)逐渐减弱;(头发)从前向后减少;向后倾斜; [acc] /rɪˈsiːd/;
hypothesis: [x] n. 假说;假设; [acc] /haɪˈpɑːθəsɪs/;
legacy: [x] n. 遗赠(物);遗产; [acc] /ˈleɡəsi/;
aspiration: [x] n. 抱负,志向;发 h 音; [acc] /ˌæspəˈreɪʃn/;
gear: [x] n. 档位;齿轮;装备;衣物;  v. 使适合; [acc] /ɡɪr/;
sardine: [x] n. [鱼]沙丁鱼; [acc] /ˌsɑːrˈdiːn/;
blunt: [x] adj. 钝的;直率的;  v. 使情感,感觉,需求减弱;变钝; [acc] /blʌnt/;
peak: [x] n. 顶峰;山顶;尖端;  v. 达到最高点;  adj. 最高度的;高峰时期的;巅峰状态的; [acc] /piːk/;
religious: [x] adj. 宗教的;虔诚的; [acc] /rɪˈlɪdʒəs/;
considerable: [x] adj. 相当大的;重要的;可观的; [acc] /kənˈsɪdərəbl/;
sparkle: [x] vi. 闪耀;焕发,活跃,才华横溢;  n. 光亮;活力; [acc] /ˈspɑːrkl/;
curse: [x] n. 诅咒;咒骂;祸因;  v. 诅咒;咒骂;使受罪; [acc] /kɜːrs/;
option: [x] n. 选择;选择权;选修课;  v. 得到或获准进行选择;调动球员; [acc] /ˈɑːpʃn/;
occasional: [x] adj. 偶尔的;临时的;偶然的; [acc] /əˈkeɪʒənl/;
scorch: [x] v. 烧焦;枯萎;  vi. 高速行驶,疾驰,飞驰; [acc] /skɔːrtʃ/;
replacement: [x] n. 代替物;接替者;更换; [acc] /rɪˈpleɪsmənt/;
cuckoo: [x] n. 杜鹃鸟;布谷鸟;  adj. 疯狂的; [acc] /ˈkʊkuː/;
identify: [x] v. 认出,联系;识别;确定,鉴定,发现;认为.等同,认为.关系紧密;表明.的身份;认同,有共鸣,有同感; [acc] /aɪˈdentɪfaɪ/;
combine: [x] v. 使混合(结合,组合,联合);结合;联合;组合;  n. 联合体,联合企业;联合收割机; [acc] /kəmˈbaɪn/;
environment: [x] n. 环境;外界;工作平台; [acc] /ɪnˈvaɪrənmənt/;
discern: [x] v. 辨别;识别;看出; [acc] /dɪˈsɜːrn/;
traverse: [x] v. 横越;穿过;  n. 横越; [acc] /trəˈvɜːrs/;
deem: [x] v. 认为,视为;知道,相信; [acc] /diːm/;
handbook: [x] n. 手册;指南; [acc] /ˈhændbʊk/;
corrupt: [x] v. 变腐败,堕落;贿赂,使腐败;  adj. 腐败的;堕落的; [acc] /kəˈrʌpt/;
lily: [x] n. 百合; [acc] /ˈlɪli/;
tutor: [x] n. 家庭教师,指导教师;  v. 个别指导;当.家庭教师; [acc] /ˈtuːtər/;
fabricate: [x] v. 建造,制造,伪造(文件等),捏造,编造(谎言,借口等); [acc] /ˈfæbrɪkeɪt/;
makeup: [x] n. 化妆品; [acc] /'meɪkˌʌp/;
clue: [x] n. 线索;提示;暗示;  vt. 为..提供线索; [acc] /kluː/;
polar: [x] adj. 极地的;南北两极的;截然对立的,正好相反的; [acc] /ˈpoʊlər/;
elbow: [x] n. 手肘;衣服肘部;  v. 用肘推,挤; [acc] /ˈelboʊ/;
confident: [x] adj. 自信的;确信的,深信的; [acc] /ˈkɑːnfɪdənt/;
survival: [x] n. 存活;生存; [acc] /sərˈvaɪvl/;
groom: [x] n. 新郎;马夫;  v. 修整;装扮;照料; [acc] /ɡruːm/;
mosque: [x] n. 伊斯兰教寺院;清真寺; [acc] /mɑːsk/;
neutral: [x] adj. 中立的;中性的;  n. 中立国;中性色; [acc] /ˈnuːtrəl/;
attorney: [x] n. (辩护)律师; [acc] /əˈtɜːrni/;
metallic: [x] adj. 金属的;金属般的; [acc] /məˈtælɪk/;
manufacture: [x] v. 生产;制造;  n. 制造,生产;制造业;(复)产品; [acc] /ˌmænjuˈfæktʃər/;
civilian: [x] n. 平民,百姓;  adj. 平民的,百姓的,民用的; [acc] /səˈvɪliən/;
tub: [x] n. 洗澡盆,浴缸,桶,盆,杯,一桶的(分量); [acc] /tʌb/;
royalty: [x] n. 皇家,王族,皇族;版税;专利费; [acc] /ˈrɔɪəlti/;
barely: [x] adv. 几乎不;仅仅;只不过; [acc] /ˈberli/;
stillness: [x] n. 沉静;宁静,静止; [acc] /ˈstɪlnəs/;
follower: [x] n. 追随者;信徒; [acc] /ˈfɑːloʊər/;
beneficial: [x] adj. 有益的,有利的; [acc] /ˌbenɪˈfɪʃl/;
electricity: [x] n. 电,电力;电流;电学; [acc] /ɪˌlekˈtrɪsəti/;
melody: [x] n. 旋律,曲调,悦耳的音乐; [acc] /ˈmelədi/;
comparison: [x] n. 比较;对照;比较等级;比喻; [acc] /kəmˈpærɪsn/;
applaud: [x] v. 鼓掌;  vi. 喝彩;  vt. 向.鼓掌表示赞赏;给.捧场; [acc] /əˈplɔːd/;
confront: [x] v. 与某人对峙;与..对抗;正视; [acc] /kənˈfrʌnt/;
worthwhile: [x] adj. 值得(花时间,精力)的,有意义的; [acc] /ˌwɜːrθˈwaɪl/;
label: [x] n. 标签;称号;唱片公司;  v. 把..称为,贴标签于..; [acc] /ˈleɪbl/;
torque: [x] n. 转矩; [acc] /tɔːrk/;
expel: [x] v. 罚出,开除;排出;开除;驱逐; [acc] /ɪkˈspel/;
responsible: [x] adj. 有责任,负责的; [acc] /rɪˈspɑːnsəbl/;
definition: [x] n. (轮廓等)清晰;定义,释义; [acc] /ˌdefɪˈnɪʃn/;
peninsula: [x] n. 半岛; [acc] /pəˈnɪnsələ/;
scarcity: [x] n. 缺乏,不足; [acc] /ˈskersəti/;
irrespective: [x] adj. 不考虑的,不顾的; [acc] /ˌɪrɪˈspektɪv/;
concentrate: [x] v. 全神贯注于,集中于;浓缩;  n. 浓缩物; [acc] /ˈkɑːnsntreɪt/;
contradict: [x] v. 与..发生矛盾,与..抵触,与..对立; [acc] /ˌkɑːntrəˈdɪkt/;
disperse: [x] v. 使散开;分散,散开; [acc] /dɪˈspɜːrs/;
excess: [x] adj. 额外的,过量的,过度的,附加的;  n. 超越,超过,过度; [acc] /ɪkˈses/;
crab: [x] n. 螃蟹;蟹肉; [acc] /kræb/;
electron: [x] n. 电子; [acc] /ɪˈlektrɑːn/;
propel: [x] v. 推进,推动,激励; [acc] /prəˈpel/;
mash: [x] v. 捣碎;  n. 糊状物; [acc] /mæʃ/;
convention: [x] n. 会议;习俗;惯例; [acc] /kənˈvenʃn/;
community: [x] n. 社区;团体;(生)群落;人群,很多个体的集合体; [acc] /kəˈmjuːnəti/;
arbitrary: [x] adj. 随意的,任性的,随心所欲的;霸道的,专制的,专横的;主观的,武断的; [acc] /ˈɑːrbətreri/;
weapon: [x] n. 武器;手段;  v. 武装,提供武器; [acc] /ˈwepən/;
exception: [x] n. 例外(的人或事),除外; [acc] /ɪkˈsepʃn/;
commission: [x] n. 委员会;任务;权限;委任;销售佣金;  v. 委任; [acc] /kəˈmɪʃn/;
energize: [x] v. 使活跃;给予精力;使兴奋; [acc] /ˈenərdʒaɪz/;
surgeon: [x] n. 外科医生; [acc] /ˈsɜːrdʒən/;
setback: [x] n. 挫折;失败; [acc] /ˈsetbæk/;
diagnosis: [x] n. 诊断; [acc] /ˌdaɪəɡˈnoʊsɪs/;
stiffness: [x] n. 僵硬;不友好,死板;硬度; [acc] /ˈstɪfnəs/;
industrial: [x] adj. 工业的;产业的;  n. 产业工人;工业公司;[商]工业股票; [acc] /ɪnˈdʌstriəl/;
ironically: [x] adv. 讽刺地;出乎意料地; [acc] /aɪˈrɑːnɪkli/;
metallurgy: [x] n. 冶金学,冶金术; [acc] /ˈmetlɜːrdʒi/;
queer: [x] adj. 怪异的;〈贬〉同性恋的;  n. 〈贬〉同性恋者;  v. 破坏.的计划; [acc] /kwɪr/;
scramble: [x] v. 争夺,攀登; [acc] /ˈskræmbl/;
register: [x] v. 登记,注册;(仪表等)显示;留意;  n. 登记,注册;现金收纳机; [acc] /ˈredʒɪstər/;
survive: [x] vi. 活下来,幸存;  vt. 比..活得长;幸存,存活;幸免于难; [acc] /sərˈvaɪv/;
paragraph: [x] n. (文章的)段,节; [acc] /ˈpærəɡræf/;
mop: [x] n. 拖把(俗称地拖);多而蓬乱的头发;  v. 用拖把拖洗,擦,抹; [acc] /mɑːp/;
appropriate: [x] adj. 合适的;适当的;  v. 挪用;拨款;私占; [acc] /əˈproʊpriət/;
cape: [x] n. 斗篷;披肩;岬,海岬,海角; [acc] /keɪp/;
intricate: [x] adj. 错综复杂的; [acc] /ˈɪntrɪkət/;
judicial: [x] adj. 司法的,法庭的,法律的,审判(上)的; [acc] /dʒuˈdɪʃl/;
simulate: [x] v. 假装;模仿;模拟; [acc] /ˈsɪmjuleɪt/;
primarily: [x] adv. 首先;主要地; [acc] /praɪˈmerəli/;
solicit: [x] v. 乞求,恳求给予(帮助,金钱); [acc] /səˈlɪsɪt/;
solitude: [x] n. 孤独; [acc] /ˈsɑːlətuːd/;
slip: [x] v. 滑倒,跌落,溜走,疏忽;偷偷地给;被遗忘;  n. 溜走;疏忽,错误;纸条;  adj. 打有活结的;可拆卸的;滑动的; [acc] /slɪp/;
feeble: [x] adj. 虚弱的; [acc] /ˈfiːbl/;
subdivide: [x] v. 再分; [acc] /ˈsʌbdɪvaɪd/;
disgust: [x] v. 使作呕,使厌恶;  n. 恶心; [acc] /dɪsˈɡʌst/;
substitute: [x] v. 代替;  n. 代替者,代用品,替补队员; [acc] /ˈsʌbstɪtuːt/;
agreeable: [x] adj. (欣然)同意的;愉快的;可以接受的; [acc] /əˈɡriːəbl/;
multiple: [x] adj. 多重的,复合的,倍数的;  n. 倍数; [acc] /ˈmʌltɪpl/;
mechanism: [x] n. 机械装置;机制,机理,原理; [acc] /ˈmekənɪzəm/;
pension: [x] n. 养老金,抚恤金;廉租屋;  v. 发给..养老金; [acc] /ˈpenʃn/;
effective: [x] adj. 有效的,有影响的;实际的;生效的; [acc] /ɪˈfektɪv/;
vine: [x] n. 藤,蔓; [acc] /vaɪn/;
bandage: [x] n. 绷带;  v. 用绷带绑扎; [acc] /ˈbændɪdʒ/;
routine: [x] n. 常规,例行公事,一套固定舞步(或动作);  adj. 例行的,普通的,惯例的; [acc] /ruːˈtiːn/;
raisin: [x] n. 葡萄干; [acc] /ˈreɪzn/;
flux: [x] n. 流动,不断的变动; [acc] /flʌks/;
magnificent: [x] adj. 华丽的,宏伟的,壮丽的; [acc] /mæɡˈnɪfɪsnt/;
spine: [x] n. 脊椎; [acc] /spaɪn/;
deviation: [x] n. 偏离,背离; [acc] /ˌdiːviˈeɪʃn/;
impartial: [x] adj. 公平的,不偏不倚的; [acc] /ɪmˈpɑːrʃl/;
Jupiter: [x] n. 木星; [acc] /ˈdʒuːpɪtər/;
midst: [x] n. 中部,中间; [acc] /mɪdst/;
retrieve: [x] v. 取回,重新得到,挽回,检索; [acc] /rɪˈtriːv/;
flat: [x] adj. 平坦的;浅的;平面的;单调的;  n. 平面;公寓;  adv. 平直地; [acc] /flæt/;
outset: [x] n. 开始,开端; [acc] /ˈaʊtset/;
polish: [x] v. 磨光,擦亮;润饰,使优美;  n. 擦光剂;优美,完善;  adj. 波兰的;波兰人的;波兰语的; [acc] /ˈpɑːlɪʃ/;
withhold: [x] v. 抑制,拒绝给某事物; [acc] /wɪðˈhoʊld/;
establish: [x] v. 建立;确立;使安全;使成为; [acc] /ɪˈstæblɪʃ/;
bargain: [x] n. 交易,特价商品;便宜货;契约;  vi. 讨价还价,讲价;成交;  vt. 经讨价还价成交;用.交换;  adj. (价格),低廉的; [acc] /ˈbɑːrɡən/;
analogy: [x] n. 比拟,比喻;类比;相似;类似; [acc] /əˈnælədʒi/;
aggravate: [x] v. 使恶化,加重;使气恼,激怒; [acc] /ˈæɡrəveɪt/;
aspect: [x] n. 外表,面貌;(问题等的)方面; [acc] /ˈæspekt/;
lever: [x] n. 杠杆;控制杆;施加影响的手段;  v. 用杠杆移动;撬开; [acc] /ˈlevər/;
adopt: [x] v. 收养;采纳,采用; [acc] /əˈdɑːpt/;
epoch: [x] n. 时期;新时代; [acc] /ˈepək/;
veil: [x] v. 用面纱掩盖,掩饰;  n. 面纱,遮蔽物; [acc] /veɪl/;
degenerate: [x] v. 堕落,衰减;  adj. 腐化的,颓废的,退化的;变质的;  n. 堕落者; [acc] /dɪˈdʒenəreɪt/;
inevitably: [x] adv. 必然地;不可避免地; [acc] /ɪnˈevɪtəbli/;
protest: [x] v. 抗议;反对;  n. 声明,反对; [acc] /ˈproʊtest/;
clown: [x] n. 小丑,粗鲁愚蠢的人; [acc] /klaʊn/;
ammunition: [x] n. 弹药;炮弹; [acc] /ˌæmjuˈnɪʃn/;
quiver: [x] n. 颤抖;箭袋;  vi. 颤抖; [acc] /ˈkwɪvər/;
mingle: [x] v. 使混合,使相混;  vi. 相交往,相往来; [acc] /ˈmɪŋɡl/;
motorway: [x] n. 高速公路; [acc] /ˈmoʊtərweɪ/;
nutrition: [x] n. 营养,营养学; [acc] /nuˈtrɪʃn/;
heap: [x] n. (一)堆;大量;  v. 堆;堆积; [acc] /hiːp/;
gasp: [x] v. 喘气;渴望;气喘吁吁地说出;  n. 喘气; [acc] /ɡæsp/;
hamper: [x] v. 阻碍,妨碍,牵制;  n. (有盖的)大篮子; [acc] /ˈhæmpər/;
sociology: [x] n. 社会学; [acc] /ˌsoʊsiˈɑːlədʒi/;
chief: [x] n. 老板,头子;主管;(部落) 首领;酋长;长官;  adj. 主要的;首席的; [acc] /tʃiːf/;
ornament: [x] n. 装饰;  v. 装饰; [acc] /ˈɔːrnəmənt/;
ritual: [x] n. (宗教等的)仪式,例行公事,老规矩;  adj. 作为仪式一部分的,例行的; [acc] /ˈrɪtʃuəl/;
symptom: [x] n. 症状;征兆; [acc] /ˈsɪmptəm/;
warrant: [x] n. 逮捕证;正当理由;凭证;  v. 使正当; [acc] /ˈwɔːrənt/;
carve: [x] v. 雕刻;(把肉等)切成片;开创,开拓; [acc] /kɑːrv/;
abundant: [x] adj. 丰富的;大量的; [acc] /əˈbʌndənt/;
sincerity: [x] n. 诚挚; [acc] /sɪnˈserəti/;
undergo: [x] v. 经历;遭受; [acc] /ˌʌndərˈɡoʊ/;
desirable: [x] adj. 有吸引力的;性感的;令人向往的;令人满意的; [acc] /dɪˈzaɪərəbl/;
claim: [x] v. 声称;要求;断言;主张;认领;索赔;  n. 索赔;主张;声称;断言;要求; [acc] /kleɪm/;
strategy: [x] n. 谋略,策略,计谋; [acc] /ˈstrætədʒi/;
grain: [x] n. 谷物种子,谷物,少量;格令;颗粒;纹理;  v. 使成粒状; [acc] /ɡreɪn/;
exertion: [x] n. 用力;运用; [acc] /ɪɡˈzɜːrʃn/;
intense: [x] adj. 强烈的,激烈的;紧张的;认真的;热情的; [acc] /ɪnˈtens/;
poultry: [x] n. 家禽(肉); [acc] /ˈpoʊltri/;
finite: [x] adj. 有限的;限定的; [acc] /ˈfaɪnaɪt/;
council: [x] n. 议会;理事会;委员会; [acc] /ˈkaʊnsl/;
overpass: [x] n. 天桥; [acc] /ˈoʊvərpæs/;
grieve: [x] v. 伤心,悲痛;  vi. 使悲伤,使伤心; [acc] /ɡriːv/;
controversy: [x] n. 争论,辩论; [acc] /ˈkɑːntrəvɜːrsi/;
adoption: [x] n. 收养,采用,采纳; [acc] /əˈdɑːpʃn/;
catalyst: [x] n. 催化剂;造成变化的人或事; [acc] /ˈkætəlɪst/;
slick: [x] adj. 光滑的;圆滑的;顺利的;不费力的;  n. 海面浮油;小块湿润的区域;  v. 使平滑; [acc] /slɪk/;
stagger: [x] v. 蹒跚;(使)错开(时间),交错安排;使吃惊;  n. 蹒跚; [acc] /ˈstæɡər/;
yield: [x] v. 出产;屈服;弯曲;让行;  n. 收益; [acc] /jiːld/;
analytical: [x] adj. 分析的;分析法的; [acc] /ˌænəˈlɪtɪkl/;
figure: [x] n. 体型;人物,人影;形状;数字;  v. 想出,估计,计算出; [acc] /ˈfɪɡjər/;
ion: [x] n. ［物］离子; [acc] /ˈaɪən/;
inspiration: [x] n. 灵感;鼓舞人心的人(或事物);妙计,好办法; [acc] /ˌɪnspəˈreɪʃn/;
terrain: [x] n. 地面,地形; [acc] /təˈreɪn/;
controversial: [x] adj. 引起争论的,有争议的; [acc] /ˌkɑːntrəˈvɜːrʃl/;
optimism: [x] n. 乐观,乐观主义; [acc] /ˈɑːptɪmɪzəm/;
footpath: [x] n. 小路,人行道; [acc] /ˈfʊtpæθ/;
mechanize: [x] v. 使机械化; [acc] /ˈmekənaɪz/;
solicitor: [x] n. (英)初级律师; [acc] /səˈlɪsɪtər/;
drastically: [x] adv. 大大地;彻底地; [acc] /ˈdræstɪkli/;
patrol: [x] n. 巡逻兵;巡逻;  v. 巡逻;巡查,巡游; [acc] /pəˈtroʊl/;
graphic: [x] adj. 形象的;图表的;  n. 图,图表; [acc] /ˈɡræfɪk/;
erosion: [x] n. 侵蚀;腐蚀;磨损;削弱;减少; [acc] /ɪˈroʊʒn/;
discrimination: [x] n. 歧视,偏见; [acc] /dɪˌskrɪmɪˈneɪʃn/;
costume: [x] n. 服装,剧装;  vt. 提供服装;为 ... 设计服装;  adj. 服装打扮的; [acc] /ˈkɑːstuːm/;
fin: [x] n. 鳍; [acc] /fɪn/;
brisk: [x] adj. 轻快的;活跃的;寒冷而清新的; [acc] /brɪsk/;
origin: [x] n. 起源;由来,来源;出身; [acc] /ˈɔːrɪdʒɪn/;
sensible: [x] adj. 明智的,理智的;可觉察的;实用耐穿的; [acc] /ˈsensəbl/;
inadequate: [x] adj. 不足够的,不充分的,不适当的; [acc] /ɪnˈædɪkwət/;
contaminate: [x] v. 弄脏,污染; [acc] /kənˈtæmɪneɪt/;
invisible: [x] adj. 看不见的,无形的; [acc] /ɪnˈvɪzəbl/;
van: [x] n. 厢式货车;面包车;(火车的)货车车厢;先锋; [acc] /væn/;
obstacle: [x] n. 障碍;障碍物;妨碍; [acc] /ˈɑːbstəkl/;
feat: [x] n. 绝技,功绩,武艺; [acc] /fiːt/;
tighten: [x] v. 拉紧;使..更严格; [acc] /ˈtaɪtn/;
irritate: [x] v. 使烦躁;激怒;使难受; [acc] /ˈɪrɪteɪt/;
ponder: [x] v. 仔细考虑,沉思; [acc] /ˈpɑːndər/;
rinse: [x] v. (用清水)刷,冲洗掉,漂净,漱口;  n. 嗽洗,漂洗,漂清,冲洗; [acc] /rɪns/;
predict: [x] v. 预言,预告,预测; [acc] /prɪˈdɪkt/;
modify: [x] v. 改装,修改,更改;修饰,限定; [acc] /ˈmɑːdɪfaɪ/;
locality: [x] n. 地区;地点;位置;方位; [acc] /loʊˈkæləti/;
mute: [x] n. 弱音器;  adj. 缄默的;哑的;  vt. 减弱.的声音; [acc] /mjuːt/;
resort: [x] vi. 采取;求助;  n. 求助;凭借;诉诸,采取;度假胜地; [acc] /rɪˈzɔːrt/;
articulate: [x] adj. 善于表达的;发音清晰的;  v. 清晰地发音;清楚地讲话;连接,接合;与.合成整体 ,使相互连贯; [acc] /ɑːrˈtɪkjuleɪt/;
youngster: [x] n. 年轻人,少年; [acc] /ˈjʌŋstər/;
verse: [x] n. 诗句,诗节,诗; [acc] /vɜːrs/;
jean: [x] n. 牛仔裤; [acc] /dʒɪn/;
adjacent: [x] adj. 邻接的,毗连的;邻近的; [acc] /əˈdʒeɪsnt/;
standpoint: [x] n. 立场,观点; [acc] /ˈstændpɔɪnt/;
predominant: [x] adj. 占主导地位的;显著的; [acc] /prɪˈdɑːmɪnənt/;
innovative: [x] adj. 创新的,革新的; [acc] /ˈɪnəveɪtɪv/;
tan: [x] n. 棕褐色,棕黄色;晒成棕褐色,晒黑;  v. 使晒成棕褐色;硝制(皮革); [acc] /tæn/;
universe: [x] n. 宇宙,万物,世界,领域,范围; [acc] /ˈjuːnɪvɜːrs/;
halve: [x] v. 二等分;平分; [acc] /hæv/;
lunar: [x] adj. 月亮的; [acc] /ˈluːnər/;
identification: [x] n. 识别;鉴定;验明;身份证明; [acc] /aɪˌdentɪfɪˈkeɪʃn/;
conform: [x] vi. 一致;遵照,顺从;符合;  vt. 使一致;使遵照;  adj. 一致的; [acc] /kənˈfɔːrm/;
assault: [x] n. 攻击,袭击;  v. 攻击,袭击,殴打; [acc] /əˈsɔːlt/;
petition: [x] n. 请愿;请愿书;祈求;  v. 请愿; [acc] /pəˈtɪʃn/;
caution: [x] n. 小心;警告;告诫;  v. 劝.谨慎小心;警告; [acc] /ˈkɔːʃn/;
predecessor: [x] n. 前辈;(被取代的)原有事物; [acc] /ˈpredəsesər/;
cartridge: [x] n. 墨盒;弹药筒,弹药;墨水,笔芯; [acc] /ˈkɑːrtrɪdʒ/;
assurance: [x] n. 信心,自信;保证;保险; [acc] /əˈʃʊrəns/;
glider: [x] n. 滑翔机;滑翔伞; [acc] /ˈɡlaɪdər/;
abut: [x] v. 紧靠; [acc] /əˈbʌt/;
unlock: [x] v. 开启;解开; [acc] /ˌʌnˈlɑːk/;
dolphin: [x] n. 海豚; [acc] /ˈdɑːlfɪn/;
glorify: [x] v. 赞美,赞扬,崇拜(神);美化; [acc] /ˈɡlɔːrɪfaɪ/;
remote: [x] n. 遥控器;  adj. 遥远的;偏僻的;关系远的; [acc] /rɪˈmoʊt/;
presentation: [x] n. 演讲;报告;介绍;颁奖仪式; [acc] /ˌpriːzenˈteɪʃn/;
hospitality: [x] n. 好客;款待; [acc] /ˌhɑːspɪˈtæləti/;
turbulent: [x] adj. 湍急的;混乱的,动荡的;骚动的; [acc] /ˈtɜːrbjələnt/;
fringe: [x] n. 刘海;一排;边缘;穗,流苏;  v. 形成.的边缘; [acc] /frɪndʒ/;
modernize: [x] v. (使)现代化; [acc] /ˈmɑːdərnaɪz/;
ohm: [x] n. 欧姆; [acc] /oʊm/;
conscientious: [x] adj. 勤勤恳恳的;认真的; [acc] /ˌkɑːnʃiˈenʃəs/;
privilege: [x] n. 特权,优待;荣幸;  v. 给..特权; [acc] /ˈprɪvəlɪdʒ/;
transport: [x] v. 运输;使狂喜;流放;  n. 运输;运输工具;流放犯; [acc] /ˈtrænspɔːrt/;
architect: [x] n. 设计师;建筑师; [acc] /ˈɑːrkɪtekt/;
engage: [x] vt. 吸引住(注意力,兴趣);雇,聘;  vi. 使加入,使融入;订婚;  v. (军队)交战;啮合; [acc] /ɪnˈɡeɪdʒ/;
auction: [x] n. 拍卖;  v. 拍卖; [acc] /ˈɔːkʃn/;
locomotive: [x] n. 机车,火车头;  adj. 运动的; [acc] /ˌloʊkəˈmoʊtɪv/;
snore: [x] vi. 打鼾;  n. 鼾声; [acc] /snɔːr/;
grave: [x] adj. 严重的;严肃的,庄重的;  n. 墓;  adv. 沉重地,庄重地;极慢地;  vt. 雕刻;铭记; [acc] /ɡreɪv/;
attack: [x] n. (病)发作,攻击;  v. 攻击,进攻,抨击;毁坏; [acc] /əˈtæk/;
wedge: [x] v. 楔入;  n. 楔子; [acc] /wedʒ/;
fowl: [x] n. 家禽;鸟类; [acc] /faʊl/;
bully: [x] n. 恃强欺弱者;  v. 欺负; [acc] /ˈbʊli/;
dividend: [x] n. (股份的)红利,回报,效益,被除数; [acc] /ˈdɪvɪdend/;
critical: [x] adj. 批评的;文艺评论的;爱挑剔的;危急的;关键的,重要的; [acc] /ˈkrɪtɪkl/;
saint: [x] n. 圣人; [acc] /seɪnt/;
rectangular: [x] adj. 长方形的; [acc] /rekˈtæŋɡjələr/;
renaissance: [x] n. 新生,复兴;文艺复兴; [acc] /ˈrenəsɑːns/;
application: [x] n. 运用;申请(书);应用程序; [acc] /ˌæplɪˈkeɪʃn/;
conceive: [x] v. 怀孕;设想,想出; [acc] /kənˈsiːv/;
hydrocarbon: [x] n. 碳氢化合物,烃; [acc] /ˌhaɪdrəˈkɑːrbən/;
corporate: [x] adj. 公司的;全体的;共同的;(法人)团体的; [acc] /ˈkɔːrpərət/;
stationary: [x] adj. 静止的;固定的;  n. 定居者,驻军; [acc] /ˈsteɪʃəneri/;
endanger: [x] v. 危及,危害; [acc] /ɪnˈdeɪndʒər/;
tissue: [x] n. 面巾纸,(动植物的)组织,纱布; [acc] /ˈtɪʃuː/;
manipulate: [x] v. 操纵,影响;正骨; [acc] /məˈnɪpjuleɪt/;
subordinate: [x] n. 部下;下属;  adj. 次要的;从属的;下级的;  v. 使从属于;使处于次要地位; [acc] /səˈbɔːrdɪnət/;
ginger: [x] n. 生姜;姜黄色;  v. 使有活力,使兴奋;  adj. 姜黄色的; [acc] /ˈdʒɪndʒər/;
chaos: [x] n. 混沌;混乱,纷乱; [acc] /ˈkeɪɑːs/;
jug: [x] n. (有把手,小口的)大壶;一壶,一罐(的量); [acc] /dʒʌɡ/;
rarely: [x] adv. 很少,难得; [acc] /ˈrerli/;
sullen: [x] adj. 沮丧的,闷闷不乐的;阴沉的; [acc] /ˈsʌlən/;
enthusiasm: [x] n. 热情,热心,热忱;热衷的活动,热爱的事物; [acc] /ɪnˈθuːziæzəm/;
owe: [x] v. 感谢;欠;把.归于;占有;欠钱; [acc] /oʊ/;
complex: [x] adj. 复杂的,难解的;复合的;  n. 情结;建筑群;综合体,集合体; [acc] /ˈkɑːmpleks/;
alter: [x] v. 改变;改动,使变样;改做; [acc] /ˈɔːltər/;
Venus: [x] n. 金星; [acc] /ˈviːnəs/;
reflect: [x] v. 倒映;反映,反射;仔细思考;反省; [acc] /rɪˈflekt/;
kerosene: [x] n. 煤油; [acc] /ˈkerəsiːn/;
pest: [x] n. 讨厌的人(或东西);害虫; [acc] /pest/;
logical: [x] adj. 有逻辑的;合情合理的;推理正确的; [acc] /ˈlɑːdʒɪkl/;
mixer: [x] n. 搅拌机;调酒用的饮料;混频器; [acc] /ˈmɪksər/;
delicate: [x] adj. 易碎的,易坏的,脆弱的;(人)娇弱的,体弱多病的;精美的,精致的,精巧的;微妙的,需要谨慎处理的;优美的,优雅的;柔和的,清淡的,淡雅的; [acc] /ˈdelɪkət/;
opium: [x] n. 鸦片; [acc] /ˈoʊpiəm/;
normalization: [x] n. 正常化; [acc] /ˌnɔːrmələˈzeɪʃn/;
scrutinize: [x] v. 仔细检查,细看; [acc] /ˈskruːtənaɪz/;
assign: [x] v. 布置;分配;指定;指派;归因;确定; [acc] /əˈsaɪn/;
grant: [x] v. 给予,许可,授予;承认;  n. 许可;拨款,补助金; [acc] /ɡrænt/;
shove: [x] v. 推;猛推;  n. 推搡; [acc] /ʃʌv/;
relief: [x] n. 安慰;解脱;减轻;浮雕;凸显,起伏;救济金;救济物资;换班人;接替人; [acc] /rɪˈliːf/;
reliable: [x] adj. 可靠的;可信赖的;确实的; [acc] /rɪˈlaɪəbl/;
dealer: [x] n. 经销商,商人,(俚)毒贩; [acc] /ˈdiːlər/;
toll: [x] n. 伤亡人数;(道路等的)通行费;钟声;  v. 敲钟; [acc] /toʊl/;
calorie: [x] n. 卡(热量单位); [acc] /ˈkæləri/;
crucial: [x] adj. 关键的;决定性的; [acc] /ˈkruːʃl/;
simultaneously: [x] adv. 同时地; [acc] /ˌsaɪmlˈteɪniəsli/;
military: [x] n. 军队;  adj. 军事的; [acc] /ˈmɪləteri/;
deficiency: [x] n. 缺乏,不足;缺陷; [acc] /dɪˈfɪʃnsi/;
pickle: [x] n. 盐汁;泡菜;  v. 腌; [acc] /ˈpɪkl/;
script: [x] n. 剧本,脚本,手稿;文字系统;  v. 为电影(或戏剧等)写剧本; [acc] /skrɪpt/;
expansion: [x] n. 扩大,扩充,扩张,膨胀; [acc] /ɪkˈspænʃn/;
gust: [x] n. 阵风,(感情的)迸发,汹涌;  v. 猛吹; [acc] /ɡʌst/;
inlet: [x] n. 水湾,小湾;进口,入口; [acc] /ˈɪnlet/;
emphasis: [x] n. 强调;重点;重要性; [acc] /ˈemfəsɪs/;
consent: [x] n. 同意,准许;赞成;  v. 同意; [acc] /kənˈsent/;
candidate: [x] n. (官职,获奖资格等的)候选人;投考人;申请求职者; [acc] /ˈkændɪdət/;
accordance: [x] n. 符合;一致;授予; [acc] /əˈkɔːrdns/;
medium: [x] adj. 中等的;适中的;  n. 手段;媒介;材料; [acc] /ˈmiːdiəm/;
mechanical: [x] adj. 机械的,机械学的,机械性的; [acc] /məˈkænɪkl/;
moreover: [x] adv. 此外,而且; [acc] /mɔːrˈoʊvər/;
permanent: [x] adj. 永久的,持久的;  n. 电烫发; [acc] /ˈpɜːrmənənt/;
formal: [x] adj. 正式的;正规的;规范的,合乎规矩的;形式上的;礼节上的;  n. <美>须穿礼服的社交集会;<口>夜礼服; [acc] /ˈfɔːrml/;
similarity: [x] n. 相似,类似; [acc] /ˌsɪməˈlærəti/;
touched: [x] adj. 受感动的;精神轻微失常的; [acc] /tʌtʃt/;
rhythm: [x] n. 节奏;韵律;格律; [acc] /ˈrɪðəm/;
marble: [x] n. 大理石;(游戏用的)玻璃弹子; [acc] /ˈmɑːrbl/;
prick: [x] n. 扎,一刺,刺痛,锥,阴茎;  v. 刺,戳,刺痛,竖起; [acc] /prɪk/;
counsel: [x] n. 忠告;律师,法律顾问;  v. 劝告,提议; [acc] /ˈkaʊnsl/;
dean: [x] n. (大学的)学院院长;系主任;资格最老者,泰斗;牧师; [acc] /diːn/;
ford: [x] v. 涉水,渡河;  n. 浅滩; [acc] /fɔːrd/;
willingness: [x] n. 自愿; [acc] /ˈwɪlɪŋnəs/;
poverty: [x] n. 贫困;贫穷; [acc] /ˈpɑːvərti/;
inaccurate: [x] adj. 不准确的; [acc] /ɪnˈækjərət/;
demonstration: [x] n. 示范表演,演示;实物说明;游行;表现; [acc] /ˌdemənˈstreɪʃn/;
deduct: [x] v. 减去; [acc] /dɪˈdʌkt/;
swamp: [x] n. 沼泽;  v. 淹没,浸没;使困惑,压倒; [acc] /swɑːmp/;
plight: [x] n. 困境;  v. 宣誓,保证; [acc] /plaɪt/;
parasite: [x] n. 寄生虫;靠他人为生的人; [acc] /ˈpærəsaɪt/;
arrogant: [x] adj. 傲慢的,妄自尊大的; [acc] /ˈærəɡənt/;
martyr: [x] n. 烈士;受难者;乞怜者;  v. 迫害,折磨; [acc] /ˈmɑːrtər/;
remnant: [x] n. 遗迹;边角剩料; [acc] /ˈremnənt/;
boom: [x] n. 隆隆声;繁荣;景气;激增;  v. 发出低沉有回响的声音;迅速发展,蓬勃发展;以低沉有回响的声音发出; [acc] /buːm/;
amusement: [x] n. 娱乐,消遣;乐趣; [acc] /əˈmjuːzmənt/;
analog: [x] adj. 有长短针的;模拟的;  n. 类似物;模拟; [acc] /ˈænəlɑːɡ/;
mere: [x] adj. 仅仅的;纯粹的;  n. 小湖,池塘;〈英〉边境(线); [acc] /mɪr/;
chant: [x] v. 吟唱;诵扬;  n. 圣歌;赞美诗;旋律; [acc] /tʃænt/;
pessimistic: [x] adj. 悲观(主义)的; [acc] /ˌpesɪˈmɪstɪk/;
requisite: [x] n. 必需品;  adj. 需要的,必不可少的,必备的; [acc] /ˈrekwɪzɪt/;
criticize: [x] v. 批评,评论,挑剔,责难; [acc] /ˈkrɪtɪsaɪz/;
limitation: [x] n. 限制,局限性; [acc] /ˌlɪmɪˈteɪʃn/;
hose: [x] n. 输水软管;  v. 用水管冲洗(汽车等); [acc] /hoʊz/;
twilight: [x] n. 黄昏,薄暮,黎明;晚期,没落时期;  adj. 微明的;界限不清的; [acc] /ˈtwaɪlaɪt/;
herald: [x] n. 使者;预兆;  v. 预告;为.欢呼; [acc] /ˈherəld/;
promotion: [x] n. 晋升;提升;促销;促进; [acc] /prəˈmoʊʃn/;
volume: [x] n. 音量;数量;容量;册,卷; [acc] /ˈvɑːljuːm/;
breach: [x] n. 破裂;裂痕;冲击;违反;  v. 使有裂口;破坏; [acc] /briːtʃ/;
exploration: [x] n. 探索;研究; [acc] /ˌekspləˈreɪʃn/;
manufacturer: [x] n. 制造商;制造厂; [acc] /ˌmænjuˈfæktʃərər/;
innate: [x] adj. 与生俱来的,天生的; [acc] /ɪˈneɪt/;
seaport: [x] n. 海港; [acc] /ˈsiːpɔːrt/;
unemployment: [x] n. 失业;失业人数; [acc] /ˌʌnɪmˈplɔɪmənt/;
venture: [x] n. 企业;(商业)冒险;投机,风险投资;  vi. 冒险前进;  vt. 冒.的危险;以.做赌注; [acc] /ˈventʃər/;
ware: [x] n. 货物;制品;陶器; [acc] /wer/;
dome: [x] n. 圆屋顶,穹顶; [acc] /doʊm/;
anticipate: [x] v. 预测;期待;提早(做); [acc] /ænˈtɪsɪpeɪt/;
sweetness: [x] n. 甜蜜,可爱;甜味; [acc] /ˈswiːtnəs/;
bestow: [x] v. 给予; [acc] /bɪˈstoʊ/;
ecology: [x] n. 生态,生态学; [acc] /iˈkɑːlədʒi/;
victim: [x] n. 牺牲品,受害者,替罪羊; [acc] /ˈvɪktɪm/;
invaluable: [x] adj. 非常宝贵的,极为贵重的,无价的; [acc] /ɪnˈvæljuəbl/;
extinction: [x] n. 熄灭,灭绝,消失; [acc] /ɪkˈstɪŋkʃn/;
resultant: [x] adj. 作为结果的; [acc] /rɪˈzʌltənt/;
Catholic: [x] adj. (兴趣等)广泛的,(C大写)天主教的;  n. (C大写)天主教徒; [acc] /ˈkæθlɪk/;
tuna: [x] n. 金枪鱼; [acc] /ˈtuːnə/;
circumstance: [x] n. 条件;情况;命运;客观环境; [acc] /ˈsɜːrkəmstæns/;
breakdown: [x] n. 损坏;故障;分类,明细;倒塌,崩溃;衰退; [acc] /ˈbreɪkdaʊn/;
intrinsic: [x] adj. 固有的; [acc] /ɪnˈtrɪnsɪk/;
insurance: [x] n. 保险;保险费;保险业;安全保证; [acc] /ɪnˈʃʊrəns/;
premature: [x] adj. 早产的,过早的,早熟的;  n. 早产儿; [acc] /ˌpriːməˈtʃʊr/;
institute: [x] n. 学会;学院,专科学院,研究院;  vt. 建立,设立,制定; [acc] /ˈɪnstɪtuːt/;
wrath: [x] n. 愤怒; [acc] /ræθ/;
lease: [x] v. 出租,租得;  n. 租约,租契; [acc] /liːs/;
transplant: [x] n. 移种;移植;  v. 移植(器官),使移居,移种(植物等); [acc] /trænsˈplænt/;
hostage: [x] n. 人质; [acc] /ˈhɑːstɪdʒ/;
likeness: [x] n. 相像,相似;画像,写真; [acc] /ˈlaɪknəs/;
ramble: [x] vi. 瞎扯;溜达;漫步于;  n. 漫步; [acc] /ˈræmbl/;
vocation: [x] n. 职业;行业;天职;使命; [acc] /voʊˈkeɪʃn/;
prosper: [x] v. (生意等)成功;(城市,文化,植物生长等)繁荣; [acc] /ˈprɑːspər/;
evil: [x] adj. 邪恶的,罪恶的;  n. 邪恶,罪恶; [acc] /ˈiːvl/;
casualty: [x] n. 伤亡人员,死伤者,受害人;急诊室(英); [acc] /ˈkæʒuəlti/;
assure: [x] v. 向..保证,使确信;保证,确保; [acc] /əˈʃʊr/;
immortal: [x] adj. 不朽的; [acc] /ɪˈmɔːrtl/;
perch: [x] v. (使)栖息,就位;  n. 栖木,有利的地位,杆,河鲈; [acc] /pɜːrtʃ/;
companion: [x] n. 同伴,志同道合的人;参考书; [acc] /kəmˈpæniən/;
lining: [x] n. (衣服等的)衬里;衬料;里子; [acc] /ˈlaɪnɪŋ/;
schedule: [x] n. 时间表,日程,计划表;清单,节目表;  v. 预定,安排; [acc] /ˈskedʒuːl/;
norm: [x] n. 准则;模范;规范,标准; [acc] /nɔːrm/;
directory: [x] n. 人名地址录,(电话)号码簿;目录; [acc] /dəˈrektəri/;
spectrum: [x] n. 光谱,范围,系列; [acc] /ˈspektrəm/;
forsake: [x] v. 放弃;抛弃,离开; [acc] /fərˈseɪk/;
media: [x] n. 媒体;传播媒介; [acc] /ˈmiːdiə/;
nickel: [x] n. 镍;美国五分镍币;五分钱; [acc] /ˈnɪkl/;
instability: [x] n. 不稳定(性); [acc] /ˌɪnstəˈbɪləti/;
detective: [x] n. 侦探,私人侦探;  adj. 侦探的; [acc] /dɪˈtektɪv/;
independence: [x] n. (国家的)独立;(人的)自立,独立; [acc] /ˌɪndɪˈpendəns/;
courteous: [x] adj. 有礼貌的,谦恭有礼的; [acc] /ˈkɜːrtiəs/;
rehearsal: [x] n. 排演;叙述;详述;排练; [acc] /rɪˈhɜːrsl/;
chatter: [x] n. 喋喋不休;吱吱声;啁啾声;  vi. 吱吱叫;唠叨;(使)打颤,打战,发颤;喋喋不休地说; [acc] /ˈtʃætər/;
ballet: [x] n. 芭蕾舞,芭蕾舞剧;芭蕾舞团; [acc] /bæˈleɪ/;
acquaintance: [x] n. 认识;对..有了解,熟知;熟人,相识的人; [acc] /əˈkweɪntəns/;
malnutrition: [x] n. 营养不良; [acc] /ˌmælnuːˈtrɪʃn/;
vocal: [x] n. 声乐作品;  adj. 畅言无忌的;声音的; [acc] /ˈvoʊkl/;
ramp: [x] n. 斜坡,坡道;倾斜装置;  v. 蔓延; [acc] /ræmp/;
buffer: [x] n. 缓冲,缓冲区;  v. 缓冲; [acc] /ˈbʌfər/;
situated: [x] adj. 坐落在.的;处于某种境地的; [acc] /ˈsɪtʃueɪtɪd/;
firmness: [x] n. 坚定;稳固;稳定;坚(硬)度; [acc] /ˈfɜːrmnəs/;
versus: [x] prep. 以..为对手;与..相对,与..相比; [acc] /ˈvɜːrsəs/;
tilt: [x] v. (使)倾斜;  n. 倾斜,斜坡; [acc] /tɪlt/;
financial: [x] adj. 金融的;财政的;财务的; [acc] /faɪˈnænʃl/;
vacancy: [x] n. 空,空白,空房;(职位)空缺;空虚; [acc] /ˈveɪkənsi/;
prevention: [x] n. 预防,防止; [acc] /prɪˈvenʃn/;
subjective: [x] adj. 主观(上)的,个人的; [acc] /səbˈdʒektɪv/;
elaborate: [x] adj. 精心设计的,精巧的;复杂的;  v. 详细说明,详尽阐述;  vt. 变得复杂; [acc] /ɪˈlæbəreɪt/;
unique: [x] adj. 独特的,独一无二的;(唯一的)特有的;不同寻常的; [acc] /juˈniːk/;
closet: [x] n. 橱,壁橱,小储藏室;  v. 把.引进密室会谈;  adj. 私下的,秘密的; [acc] /ˈklɑːzət/;
massacre: [x] n. 大屠杀,残杀;惨败;  v. 屠杀;彻底击败; [acc] /ˈmæsəkər/;
implore: [x] v. 恳求; [acc] /ɪmˈplɔːr/;
hatred: [x] n. 憎恨;怨恨; [acc] /ˈheɪtrɪd/;
outlaw: [x] n. 歹徒,逃犯,丧失公权者;  v. 将..放逐,宣布..为不合法; [acc] /ˈaʊtlɔː/;
refugee: [x] n. 避难者,难民;  v. 避难;  adj. 避难的; [acc] /ˌrefjuˈdʒiː/;
characterize: [x] v. 表示..的特性;描述..特性; [acc] /ˈkærəktəraɪz/;
optimum: [x] adj. 最适宜的;最佳的;  n. 最适条件;最适宜; [acc] /ˈɑːptɪməm/;
duplicate: [x] n. 复制品;  v. 复制;重复;  adj. 完全一样的; [acc] /ˈduːplɪkeɪt/;
corrosion: [x] n. 侵蚀,腐蚀状态; [acc] /kəˈroʊʒn/;
dispatch: [x] v. 派遣,调遣;发送(信件,电报等);结束,摆脱掉;匆匆办完;  vt. 处决;  n. 派遣,调遣;发送;快信,急件;迅速,敏捷; [acc] /dɪˈspætʃ/;
plausible: [x] adj. 似乎有理的;巧嘴的; [acc] /ˈplɔːzəbl/;
boiler: [x] n. 热水器,锅炉; [acc] /ˈbɔɪlər/;
dubious: [x] adj. 可疑的;怀疑的;无把握的; [acc] /ˈduːbiəs/;
respectful: [x] adj. 有礼貌的;恭敬的; [acc] /rɪˈspektfl/;
slice: [x] v. 把..切成片;大幅度削减;切开;  n. 薄片;份额,部分; [acc] /slaɪs/;
extraction: [x] n. 抽出,取出;家世,出身;抽出物; [acc] /ɪkˈstrækʃn/;
illusion: [x] n. 假象,幻象;幻想;错误观念; [acc] /ɪˈluːʒn/;
envisage: [x] v. 想象,设想; [acc] /ɪnˈvɪzɪdʒ/;
exclusive: [x] adj. 独有的;奢华的;排外的;  n. 独家新闻; [acc] /ɪkˈskluːsɪv/;
incorporate: [x] v. 包含;使并入; [acc] /ɪnˈkɔːrpəreɪt/;
cardinal: [x] adj. 主要的;基本的;  n. [天主教]枢机主教,红衣主教;基数; [acc] /ˈkɑːrdɪnl/;
benefit: [x] v. 受益,有助于,使受益;  n. 好处,益处;救济金; [acc] /ˈbenɪfɪt/;
settle: [x] v. 安顿;定居;解决;调停;(目光)停留;结算,算清;  n. 背长椅,座位;定居,安顿; [acc] /ˈsetl/;
virtue: [x] n. 正直,善良;美德,德行;好处,优点; [acc] /ˈvɜːrtʃuː/;
consecutive: [x] adj. 连续的,连贯的; [acc] /kənˈsekjətɪv/;
editorial: [x] adj. 编辑的,编者的;  n. (报刊的)社论; [acc] /ˌedɪˈtɔːriəl/;
condemnation: [x] n. 谴责,定罪; [acc] /ˌkɑːndemˈneɪʃn/;
insert: [x] vt. 插入,嵌入;  n. 插入物;插页; [acc] /ɪnˈsɜːrt/;
overhang: [x] n. 突出;悬垂;伸出量;  v. 悬于..之上; [acc] /ˌoʊvərˈhæŋ/;
incline: [x] n. 倾斜,斜坡,斜面;  v. (使)倾斜,(使)倾向于; [acc] /ɪnˈklaɪn/;
inaccessible: [x] adj. 达不到的;难达到的; [acc] /ˌɪnækˈsesəbl/;
documentary: [x] n. 纪录片;  adj. 纪实的;文献的; [acc] /ˌdɑːkjuˈmentri/;
foil: [x] n. 箔;锡箔纸;衬托;  v. 挫败;使受挫折; [acc] /fɔɪl/;
Arctic: [x] n. 北极;  adj. 北极的,极寒的; [acc] /ˈɑːrktɪk/;
stubborn: [x] adj. 顽固的;倔强的;难对付的; [acc] /ˈstʌbərn/;
opaque: [x] adj. 不透明的;难懂的; [acc] /oʊˈpeɪk/;
clone: [x] n. 克隆;无性繁殖系个体;复制品;  v. 复制;克隆; [acc] /kloʊn/;
unfold: [x] v. 展开,伸展;表露,显露; [acc] /ʌnˈfoʊld/;
pact: [x] n. 合同;协约; [acc] /pækt/;
rape: [x] v. 强奸;  n. 强奸;掠夺,强夺;油菜; [acc] /reɪp/;
statesman: [x] n. 政治家; [acc] /ˈsteɪtsmən/;
cherish: [x] v. 珍爱,珍视;抱有(希望); [acc] /ˈtʃerɪʃ/;
weaver: [x] n. 织布者,织工; [acc] /ˈwiːvər/;
dentist: [x] n. 牙医; [acc] /ˈdentɪst/;
raid: [x] n. 突袭;袭击;  v. 袭击;劫掠;攫取;突然搜捕; [acc] /reɪd/;
quench: [x] v. 扑灭(火);止渴; [acc] /kwentʃ/;
waver: [x] vi. 犹豫;摇摆;颤抖; [acc] /ˈweɪvər/;
supple: [x] adj. 柔软的;柔顺的; [acc] /ˈsʌpl/;
vulgar: [x] adj. 粗俗的;下流的;平民的;通俗的;  n. 平民;方言; [acc] /ˈvʌlɡər/;
acid: [x] n. [化学]酸;酸性物质;尖酸;  adj. 尖刻的;敏锐的;含酸过多的;酸的;酸味的; [acc] /ˈæsɪd/;
susceptible: [x] adj. 易受感染的;易受影响的;多情的; [acc] /səˈseptəbl/;
designate: [x] adj. 已受委派而尚未上任的;  v. 标出,说出;委任,任命,提名;指定; [acc] /ˈdezɪɡneɪt/;
denote: [x] v. 是.的标志;指出;  vt. 指示;代表(或表示); [acc] /dɪˈnoʊt/;
Turkey: [x] n. 土耳其; [acc] /ˈtɜːrki/;
preferable: [x] adj. 更可取的,更好的,更合适的(to); [acc] /ˈprefrəbl/;
spouse: [x] n. 配偶,夫妇;夫,妻;  v. 和.结婚; [acc] /spaʊs/;
proclaim: [x] v. 声明,声称;宣告;表明; [acc] /prəˈkleɪm/;
emerge: [x] v. 冲出,冒出;浮现;出现; [acc] /iˈmɜːrdʒ/;
project: [x] n. 项目,工程;专题研究;课题方案;  v. 映射,放映;计划,设计,打算,拟订方案;投掷,发射,喷射;表明..的特性,使呈现特性;阐述;突出,伸出;估计,预估; [acc] /ˈprɑːdʒekt/;
remedy: [x] v. 治疗;恢复;补救;  n. 治疗;补救;矫正; [acc] /ˈremədi/;
commemorate: [x] v. 纪念,庆祝; [acc] /kəˈmeməreɪt/;
limb: [x] n. 肢体;臂;枝干;树枝;  v. 肢解; [acc] /lɪm/;
guy: [x] n. 男人;家伙; [acc] /ɡaɪ/;
clutch: [x] v. 抓住;紧握;  n. 抓住;离合器; [acc] /klʌtʃ/;
heel: [x] n. 脚后跟;(鞋)后跟;  v. 给(鞋)钉后掌,倾侧,紧跟; [acc] /hiːl/;
conflict: [x] n. 冲突,(意见)分歧,战斗,斗争;  v. 冲突,抵触,争执; [acc] /ˈkɑːnflɪkt/;
microwave: [x] n. 微波炉,微波;  v. 用微波炉加热; [acc] /ˈmaɪkrəweɪv/;
stabilize: [x] v. 使稳定; [acc] /ˈsteɪbəlaɪz/;
crash: [x] n. 碰撞,坠落,轰隆声;  v. 碰撞,坠落,崩溃;  adj. 紧急的; [acc] /kræʃ/;
kinetic: [x] adj. 运动的; [acc] /kɪˈnetɪk/;
economics: [x] n. 经济学;经济情况;经济; [acc] /ˌekəˈnɑːmɪks/;
browse: [x] v. 浏览;随意翻阅;(牛,羊等)吃草; [acc] /braʊz/;
electrode: [x] n. 电极; [acc] /ɪˈlektroʊd/;
clause: [x] n. 条款;从句; [acc] /klɔːz/;
agenda: [x] n. 议事日程; [acc] /əˈdʒendə/;
hearty: [x] adj. 衷心的;亲切的;精神饱满的;丰盛的;强烈的; [acc] /ˈhɑːrti/;
advantage: [x] v. 使处于有利地位;有利于;有助于;  n. 优势,利益,有利条件; [acc] /ədˈvæntɪdʒ/;
compose: [x] v. 创作,作曲,形成,构成; [acc] /kəmˈpoʊz/;
consumer: [x] n. 消费者;用户;消耗者; [acc] /kənˈsuːmər/;
credit: [x] n. 信用;荣誉;学分;信贷;称赞;债权;  v. 信赖;归因于;记学分; [acc] /ˈkredɪt/;
enhance: [x] v. 提高(强度,力量,数量等);增加,加强; [acc] /ɪnˈhæns/;
oxygen: [x] n. 氧气; [acc] /ˈɑːksɪdʒən/;
incense: [x] n. 焚香时的烟,香味;  v. 激怒; [acc] /ˈɪnsens/;
capable: [x] adj. 有本领的,有能力的;有才能的,能干的; [acc] /ˈkeɪpəbl/;
foam: [x] n. 泡沫;泡沫体;泡沫塑料;  vi. 吐白沫,起泡沫; [acc] /foʊm/;
clip: [x] n. 回形针,夹子;(电影,广播,电视节目的)片段;  v. 夹住;删剪;剪辑; [acc] /klɪp/;
object: [x] n. 物体;宾语;目标;  v. 提出..作为反对的理由;反对; [acc] /ˈɑːbdʒekt/;
disregard: [x] v. 不理会;漠视;  n. 忽视,漠视; [acc] /ˌdɪsrɪˈɡɑːrd/;
mansion: [x] n. 官邸;巨宅;大厦; [acc] /ˈmænʃn/;
garbage: [x] n. 垃圾桶;垃圾; [acc] /ˈɡɑːrbɪdʒ/;
jealousy: [x] n. 妒忌,猜忌; [acc] /ˈdʒeləsi/;
circus: [x] n. 马戏团;杂技团;环形广场;闹剧(表示不满); [acc] /ˈsɜːrkəs/;
striking: [x] adj. 容貌出众的,吸引人的;显著的,突出的;  n. 罢工; [acc] /ˈstraɪkɪŋ/;
imposing: [x] adj. 壮观的,壮丽的; [acc] /ɪmˈpoʊzɪŋ/;
comet: [x] n. 彗星; [acc] /ˈkɑːmət/;
accuse: [x] v. 指责;控告;把..归咎于; [acc] /əˈkjuːz/;
masterpiece: [x] n. 杰作; [acc] /ˈmæstərpiːs/;
mild: [x] adj. 味淡的;温暖的;轻微的;温和的;  n. 淡味啤酒; [acc] /maɪld/;
melt: [x] v. 融化;熔化;溶化; [acc] /melt/;
merge: [x] v. 合并;融合; [acc] /mɜːrdʒ/;
resistant: [x] adj. 有抵抗力的,抗..的;反抗的; [acc] /rɪˈzɪstənt/;
theorem: [x] n. [数]定理,法则; [acc] /ˈθiːərəm/;
yearn: [x] v. 渴望,向往; [acc] /jɜːrn/;
bypass: [x] v. 绕过;回避;  n. 旁路;心脏分流手术; [acc] /ˈbaɪpæs/;
consequent: [x] adj. 作为结果(或后果)的,随之发生的;  n. 结果,随后的事; [acc] /ˈkɑːnsəkwənt/;
hinge: [x] n. 铰链;  v. 靠铰链转动; [acc] /hɪndʒ/;
perfection: [x] n. 完美,完满;完善; [acc] /pərˈfekʃn/;
homely: [x] adj. 不好看的,相貌平平的;朴素的;(如在家一般)舒适自在,家庭的;(女士)热情友好的,和蔼的; [acc] /ˈhoʊmli/;
defect: [x] n. 缺陷,缺点,不足之处;  v. 背叛,逃跑,开小差; [acc] /ˈdiːfekt/;
transform: [x] v. 将..变形,改变,转换; [acc] /trænsˈfɔːrm/;
mitten: [x] n. 连指手套; [acc] /ˈmɪtn/;
informed: [x] adj. 了解情况的,消息灵通的; [acc] /ɪnˈfɔːrmd/;
slogan: [x] n. 标语;口号;广告语; [acc] /ˈsloʊɡən/;
flap: [x] n. 慌乱(状态);拍打,挥动;(一端固定,可自由掀动的布或皮的) 垂悬平片;  v. 拍打,挥动; [acc] /flæp/;
consequently: [x] adv. 结果;因此;所以; [acc] /ˈkɑːnsəkwentli/;
explore: [x] v. 探险,探索,尝试; [acc] /ɪkˈsplɔːr/;
delegate: [x] n. 代表;  v. 委派..为代表,授权; [acc] /ˈdelɪɡət/;
shuttle: [x] n. 短程穿梭运行的车辆,接驳车;梭子;穿梭;航天飞机;  v. 穿梭移动;穿梭往返;往返于两地之间; [acc] /ˈʃʌtl/;
originate: [x] vi. 起源;开始;  vt. 开创; [acc] /əˈrɪdʒɪneɪt/;
flake: [x] n. 薄片;  v. 使成薄片;剥落;雪片般落下; [acc] /fleɪk/;
propagation: [x] n. 繁殖;传播; [acc] /ˌprɑːpəˈɡeɪʃn/;
ancestor: [x] n. 祖宗;祖先;原型; [acc] /ˈænsestər/;
theft: [x] n. 偷盗,失窃; [acc] /θeft/;
endeavor: [x] n. 尝试,努力,尽力;  v. 努力,尽力; [acc] /ɪnˈdevər/;
revelation: [x] n. 揭露;揭示;(出乎意料的)被揭示的真相; [acc] /ˌrevəˈleɪʃn/;
northward(s): [x] adv. 向北地; [acc] /ˈnɔːrθwərdz/;
curriculum: [x] n. 课程,(学校或专业的)全部课程; [acc] /kəˈrɪkjələm/;
global: [x] adj. 全球的;全面的; [acc] /ˈɡloʊbl/;
feature: [x] n. 面貌,相貌;特征,特点;特辑;  vt. 使突出,以.为特色;  vi. 起重要作用,作为主要角色; [acc] /ˈfiːtʃər/;
outline: [x] n. 外形,轮廓;大纲,概要;  v. 描绘,画出..的轮廓; [acc] /ˈaʊtlaɪn/;
dove: [x] n. 鸽子; [acc] /dʌv/;
brace: [x] n. [医学]牙齿定位器;  v. 支柱;支撑;加固;使绷紧; [acc] /breɪs/;
seaside: [x] n. 海滨,海边;  adj. 海边的,海滨的; [acc] /ˈsiːsaɪd/;
commonsense: [x] adj. 常识的;  n. 常识; [acc] /ˌkɑːmən ˈsens/;
mall: [x] n. 购物商场; [acc] /mɔːl/;
abstract: [x] adj. 抽象的;  n. 摘要,抽象;  v. 提取; [acc] /ˈæbstrækt/;
kernel: [x] n. 子粒,谷粒;核心; [acc] /ˈkɜːrnl/;
itinerary: [x] n. 旅程,路线;旅行计划; [acc] /aɪˈtɪnəreri/;
champagne: [x] n. 香槟酒; [acc] /ʃæmˈpeɪn/;
optimistic: [x] adj. 乐观的,乐观主义的; [acc] /ˌɑːptɪˈmɪstɪk/;
arson: [x] n. [法律]纵火,纵火罪; [acc] /ˈɑːrsn/;
assignment: [x] n. 任务,(课外)作业;分配,委派; [acc] /əˈsaɪnmənt/;
entertainment: [x] n. 娱乐;招待,款待; [acc] /ˌentərˈteɪnmənt/;
dart: [x] n. 飞镖;猛冲;标枪;  v. 快速投掷;突然移动; [acc] /dɑːrt/;
estimate: [x] v. 估价,估计,评价;  n. 估计,评价; [acc] /ˈestɪmət/;
dramatically: [x] adv. 显著地,剧烈地,引人注目地;戏剧性地; [acc] /drəˈmætɪkli/;
patent: [x] n. 专利;  adj. 显然的,明显的;专利的;独创的;  v. 取得.的专利权; [acc] /ˈpætnt/;
benign: [x] adj. 仁慈的;慈祥的;(病)良性的; [acc] /bɪˈnaɪn/;
definitive: [x] adj. 可靠的,明确的,权威的;决定性的; [acc] /dɪˈfɪnətɪv/;
qualification: [x] n. 资格证明;条件;合格证书;资格;限制性条件; [acc] /ˌkwɑːlɪfɪˈkeɪʃn/;
systematically: [x] adv. 有系统地; [acc] /ˌsɪstəˈmætɪkli/;
descendant: [x] n. 后代,后裔;派生物; [acc] /dɪˈsendənt/;
satisfactorily: [x] adv. 满意地; [acc] /ˌsætɪsˈfæktərəli/;
inhabit: [x] v. 居住于; [acc] /ɪnˈhæbɪt/;
reel: [x] n. 卷盘;  v. 旋转;感到震惊;眩晕; [acc] /riːl/;
consult: [x] v. 请教,咨询;查阅;商量; [acc] /kənˈsʌlt/;
infinite: [x] adj. 无限的,无穷的;无数的;  n. 无穷,无限大; [acc] /ˈɪnfɪnət/;
courageous: [x] adj. 勇敢的,英勇的,有胆量的; [acc] /kəˈreɪdʒəs/;
cater: [x] v. 供应伙食;为(集会,婚礼等)承办酒席; [acc] /ˈkeɪtər/;
mess: [x] n. 凌乱状态,混乱状态;肮脏,污秽;困境;食堂;大量某物;  v. 弄脏,弄乱;浪费时间,瞎闹; [acc] /mes/;
border: [x] n. 边界;花坛;滚边,边沿,包边;  v. 近似;毗邻;与..接壤;为..镶边; [acc] /ˈbɔːrdər/;
alas: [x] excl. 唉;  adv. 不幸地; [acc] /əˈlæs/;
minimal: [x] adj. 最低限度的; [acc] /ˈmɪnɪməl/;
genetic: [x] adj. 遗传的,起源的; [acc] /dʒəˈnetɪk/;
haunt: [x] v. 常去,萦绕于..;(鬼,魂)常出没于;(思想)萦绕;  n. 常去的地方; [acc] /hɔːnt/;
ideal: [x] adj. 理想的;完美的;空想的;观念的;  n. 理想;典范;目标; [acc] /aɪˈdiːəl/;
edible: [x] adj. 可食的; [acc] /ˈedəbl/;
aid: [x] n. 帮助;救护,援助;帮助者,助手;  v. 帮助;援助,帮助,有助于; [acc] /eɪd/;
jeopardize: [x] v. 危及,损害(也作jeopardise); [acc] /ˈdʒepərdaɪz/;
ambassador: [x] n. (特命全权)大使;代表; [acc] /æmˈbæsədər/;
modulate: [x] v. 调整(音调);变调;调节(使平衡); [acc] /ˈmɑːdʒəleɪt/;
expression: [x] n. 表情,神情;表达,表述;措辞; [acc] /ɪkˈspreʃn/;
feast: [x] n. 盛宴;筵席;节日;  v. 尽情地吃; [acc] /fiːst/;
basement: [x] n. [建筑学]地下室;根基; [acc] /ˈbeɪsmənt/;
penguin: [x] n. 企鹅; [acc] /ˈpeŋɡwɪn/;
erroneous: [x] adj. 错误的; [acc] /ɪˈroʊniəs/;
superb: [x] adj. 极好的;壮丽的; [acc] /suːˈpɜːrb/;
horrible: [x] adj. 可怕的,恐怖的;讨厌的,糟糕的;粗鲁的,不友好的; [acc] /ˈhɔːrəbl/;
arrangement: [x] n. 布置;排列;组合体;整齐;调解;办法;协议;计划; [acc] /əˈreɪndʒmənt/;
geology: [x] n. 地质学,(某一地区的)地质; [acc] /dʒiˈɑːlədʒi/;
orientation: [x] n. 信仰;倾向;[计]定向;(学生)迎新会;定向,方向;(任职,上学等之前的) 情况介绍;训练; [acc] /ˌɔːriənˈteɪʃn/;
render: [x] v. 使成为,致使,使处于(某种状态);提供,给予,以.回报;(以某种方式)表达,表现;翻译;粉刷,往(墙上)抹灰;将(脂肪)熬成油,使熔化;  n. 粉刷,打底,交纳; [acc] /ˈrendər/;
comic: [x] adj. 滑稽的,喜剧的,漫画的;  n. 连环漫画杂志;喜剧演员; [acc] /ˈkɑːmɪk/;
implicit: [x] adj. 隐含的;盲目的;完全的,绝对的;成为一部分的; [acc] /ɪmˈplɪsɪt/;
stable: [x] n. 马厩;  adj. 稳定的;安定的;  v. 使(马)入厩; [acc] /ˈsteɪbl/;
revolutionary: [x] n. 革命者;  adj. 革命的;革命性的; [acc] /ˌrevəˈluːʃəneri/;
domain: [x] n. 域名;领土;管区,势力圈; [acc] /doʊˈmeɪn/;
aerial: [x] adj. 飞机的,航空的,由飞机进行的;空中的,架空的;  n. 天线; [acc] /ˈeriəl/;
illegal: [x] adj. 不合法的,非法的;  n. 非法移民,非法劳工;间谍; [acc] /ɪˈliːɡl/;
infection: [x] n. 感染;传染病; [acc] /ɪnˈfekʃn/;
notwithstanding: [x] prep. 尽管,虽然;  adv. 尽管,虽然;  conj. 尽管,虽然; [acc] /ˌnɑːtwɪθˈstændɪŋ/;
oriental: [x] adj. 东方的;  n. 东方人; [acc] /ˌɔːriˈentl/;
prospective: [x] adj. 未来的;预期的;  n. 预期; [acc] /prəˈspektɪv/;
pursue: [x] v. 进行,从事;追求,追赶; [acc] /pərˈsuː/;
exclaim: [x] v. 呼叫,惊叫; [acc] /ɪkˈskleɪm/;
stray: [x] adj. 走失的,迷路的;离了群的;  v. 走失;分心,走神;有外遇,在别处拈花惹草;  n. 流浪者;走失,迷路; [acc] /streɪ/;
arena: [x] n. 竞技场,角斗场;(活动,斗争或竞争的)场所,战场,(竞争)舞台; [acc] /əˈriːnə/;
discipline: [x] n. 纪律;学科;训练;  v. 训练;惩罚;管制; [acc] /ˈdɪsəplɪn/;
unity: [x] n. 联合,统一;统一体;团结,一致; [acc] /ˈjuːnəti/;
forthcoming: [x] adj. 即将出现的,即将到来的;唾手可得的,可用的;乐于提供信息的; [acc] /ˌfɔːrθˈkʌmɪŋ/;
subscribe: [x] vi. 捐款;订阅;认购(股份);  vt. 申请; [acc] /səbˈskraɪb/;
ignore: [x] v. 忽视;不理; [acc] /ɪɡˈnɔːr/;
triangular: [x] adj. 三角形的;三人间的; [acc] /traɪˈæŋɡjələr/;
employment: [x] n. 职业;雇佣;就业;运用; [acc] /ɪmˈplɔɪmənt/;
chip: [x] n. 木屑,碎片;缺口;圆形筹码;芯片;炸薯条,炸薯片;  v. 碎裂;削,凿;将.削成,凿成; [acc] /tʃɪp/;
generosity: [x] n. 慷慨,大方; [acc] /ˌdʒenəˈrɑːsəti/;
tumble: [x] v. 翻滚;不由自主地卷入;(价格等)暴跌;跌倒,摔下,滚下;  n. 跌倒,摔倒; [acc] /ˈtʌmbl/;
disrupt: [x] v. 扰乱; [acc] /dɪsˈrʌpt/;
decree: [x] v. 命令,判决,颁布;  n. 法令,政令; [acc] /dɪˈkriː/;
extreme: [x] adj. 极端的;极远的;极限的;极度的;偏激的;  n. 极端;极度(状态),最大程度; [acc] /ɪkˈstriːm/;
magnetism: [x] n. 吸引力;磁性; [acc] /ˈmæɡnətɪzəm/;
rebel: [x] v. 造反,反抗,反叛;  n. 造反者;反叛者;叛逆者;  adj. 反抗的;造反的; [acc] /ˈrebl/;
embody: [x] v. 包含;体现,象征; [acc] /ɪmˈbɑːdi/;
assistance: [x] n. 援助;帮助;补助; [acc] /əˈsɪstəns/;
artery: [x] n. 动脉;干线; [acc] /ˈɑːrtəri/;
silicon: [x] n. 硅; [acc] /ˈsɪlɪkən/;
linguist: [x] n. 语言学家;会多国语言的人; [acc] /ˈlɪŋɡwɪst/;
interact: [x] v. 交流,沟通,互动;互相作用,互相影响; [acc] /ˌɪntərˈækt/;
reaction: [x] n. 反应能力;反应;生理反应; [acc] /riˈækʃn/;
pulley: [x] n. 滑轮; [acc] /ˈpʊli/;
ferrous: [x] adj. 含铁的; [acc] /ˈferəs/;
polarity: [x] n. (分)极性;相对的观点; [acc] /pəˈlærəti/;
universally: [x] adv. 普遍地;到处; [acc] /ˌjuːnɪˈvɜːrsəli/;
initial: [x] adj. 第一的;最初的;开始的;  n. 首字母; [acc] /ɪˈnɪʃl/;
admit: [x] v. 承认;准许.进入,允许.加入;容许,可容纳; [acc] /ədˈmɪt/;
bizarre: [x] adj. 稀奇古怪的; [acc] /bɪˈzɑːr/;
persistent: [x] adj. 坚持的;持续的; [acc] /pərˈsɪstənt/;
tease: [x] v. 取笑;挑逗;逗弄;使..渴望;逆梳;  n. 爱戏弄别人者; [acc] /tiːz/;
dramatic: [x] adj. 戏剧的,戏剧性的;引人注目的;逼真的,刺激的; [acc] /drəˈmætɪk/;
compare: [x] v. 比较,比作;  n. 比较;对照; [acc] /kəmˈper/;
associate: [x] v. 联想;联合;联系,交往;  n. 伙伴;同事;  adj. 副的; [acc] /əˈsoʊʃieɪt/;
sermon: [x] n. 布道;训诫; [acc] /ˈsɜːrmən/;
scatter: [x] v. (使)分散,撒开,散播; [acc] /ˈskætər/;
accurate: [x] adj. 精确的;正确的;符合标准的; [acc] /ˈækjərət/;
involve: [x] v. 牵涉,涉及;卷入,使参与;吸引;包含,需要,影响; [acc] /ɪnˈvɑːlv/;
wrench: [x] n. 扳手;痛苦,难受;猛扭,猛拉;  v. 猛拧;挣脱;使扭伤; [acc] /rentʃ/;
warfare: [x] n. 战争;斗争,冲突; [acc] /ˈwɔːrfer/;
whisker: [x] n. 胡须;腮须; [acc] /ˈwɪskər/;
pretext: [x] n. 借口,托词; [acc] /ˈpriːtekst/;
cue: [x] n. 提示;暗号;球杆;  v. 给.提示; [acc] /kjuː/;
execution: [x] n. 死刑;实行,执行,履行;演奏,表演; [acc] /ˌeksɪˈkjuːʃn/;
lubricate: [x] v. 使.润滑;给.加润滑油; [acc] /ˈluːbrɪkeɪt/;
package: [x] n. 包裹;一揽子,一整套; [acc] /ˈpækɪdʒ/;
scent: [x] n. 气味;香味;迹象;  v. 嗅到;察觉; [acc] /sent/;
arch: [x] n. 拱洞;拱门;拱起;  v. 做成拱形;  adj. 调皮的,淘气的; [acc] /ɑːrtʃ/;
foresee: [x] v. 预知,预料,预测; [acc] /fɔːrˈsiː/;
imitation: [x] n. 模仿;仿制品;赝品;  adj. 伪造的;仿制的; [acc] /ˌɪmɪˈteɪʃn/;
flip: [x] v. 把.往上抛;掷;抽打;用指轻弹;空翻;  adj. 轻率的,无礼的; [acc] /flɪp/;
stack: [x] n. 堆,一大堆;烟囱;  v. 堆积,堆放; [acc] /stæk/;
classification: [x] n. 分类,归类;(动植物等的)分类学; [acc] /ˌklæsɪfɪˈkeɪʃn/;
sharply: [x] adv. 锐利地,敏锐地,急剧地,剧烈地; [acc] /ˈʃɑːrpli/;
frequent: [x] adj. 时常的,频繁的;  v. 常去,常到; [acc] /ˈfriːkwənt/;
pendulum: [x] n. 摆,钟摆;摇摆不定的事态(或局面); [acc] /ˈpendʒələm/;
distribution: [x] n. 分布;分配;分发;散布; [acc] /ˌdɪstrɪˈbjuːʃn/;
brood: [x] n. 一窝,同窝幼崽;  vi. 冥思苦想;  vt. 孵;默想;  adj. 传种用的;(母鸡等)抱窝的;(昆虫等)产卵的; [acc] /bruːd/;
accelerate: [x] v. 加速,增长;使增速,促进; [acc] /əkˈseləreɪt/;
supplementary: [x] adj. 补充的;附加的;  n. 补充者; [acc] /ˌsʌplɪˈmentri/;
moral: [x] adj. 道德(上)的,道义的;  n. 道德,品行;寓意; [acc] /ˈmɔːrəl/;
diverge: [x] v. 分歧,分开; [acc] /daɪˈvɜːrdʒ/;
association: [x] n. 结合;伙伴,关系;协会,联盟,社团;联想; [acc] /əˌsəʊsiˈeɪʃn/;
stainless: [x] adj. 不生锈的,不锈钢的; [acc] /ˌsteɪnləs/;
communicate: [x] v. 沟通,交流;传达,传递;传染;相连,相通;显露; [acc] /kəˈmjuːnɪkeɪt/;
benevolent: [x] adj. 慈爱的,仁慈的;乐善好施的;慈善的; [acc] /bəˈnevələnt/;
grunt: [x] v. (猪等)作呼噜声,(表示烦恼,反对,疲劳,轻蔑等)发哼声;  n. 呼噜声,咕哝; [acc] /ɡrʌnt/;
gravel: [x] n. 沙砾,小石,砾石;  adj. 粗重而沙哑的,刺耳的;  vt. 用砾石铺;使困惑; [acc] /ˈɡrævl/;
chat: [x] v. 闲谈,聊天;  n. 闲谈,聊天; [acc] /tʃæt/;
accumulate: [x] vi. 聚积,堆积;  vt. 积攒,积累; [acc] /əˈkjuːmjəleɪt/;
wallet: [x] n. 皮夹,钱包; [acc] /ˈwɑːlɪt/;
clan: [x] n. 家族;氏族;部落;宗派;亲族; [acc] /klæn/;
sour: [x] adj. 酸的;(人)尖酸刻薄的,不友好的;  v. (友谊,局势,态度等)变坏;使恶化; [acc] /ˈsaʊər/;
inherent: [x] adj. 内在的,固有的;生来就有的; [acc] /ɪnˈhɪrənt/;
bankrupt: [x] adj. 破产的;彻底失败的;彻底缺乏的;  n. 破产者;  v. 使破产;使枯竭; [acc] /ˈbæŋkrʌpt/;
stout: [x] adj. 矮胖的,结实的;勇敢的;激烈的;  n. 矮胖子;烈性啤酒; [acc] /staʊt/;
intent: [x] adj. 全神贯注的;专心致志的;  n. 意图;意向;目的; [acc] /ɪnˈtent/;
migrant: [x] n. 候鸟;移民; [acc] /ˈmaɪɡrənt/;
lens: [x] n. 镜头;透镜;镜片;晶状体; [acc] /lenz/;
motive: [x] n. 动机,目的;  adj. 发动的,运动的,动机的;  v. 引发,促进,激发; [acc] /ˈmoʊtɪv/;
vein: [x] n. 静脉;血管;叶脉;纹理;迹象;风格,性情; [acc] /veɪn/;
security: [x] n. 安全;防护措施;债券;抵押物; [acc] /sɪˈkjʊrəti/;
refrain: [x] v. 抑制,避免;  n. 歌曲的反复句,叠句; [acc] /rɪˈfreɪn/;
luggage: [x] n. 行李箱,行李;衣箱;皮箱; [acc] /ˈlʌɡɪdʒ/;
hurl: [x] v. 用力投掷;  n. 猛投; [acc] /hɜːrl/;
eliminate: [x] v. 消灭,铲除;消除,根除;(在比赛中)淘汰; [acc] /ɪˈlɪmɪneɪt/;
premium: [x] adj. 高级的;高价的;(汽油)辛烷值高的;  n. 额外费用,溢价;保险金; [acc] /ˈpriːmiəm/;
misery: [x] n. 痛苦,悲惨,不幸; [acc] /ˈmɪzəri/;
manifest: [x] adj. 显然的,明白无误的,明了的;  v. 使显现,使显露,表明;  n. 货单,旅客名单; [acc] /ˈmænɪfest/;
irreversible: [x] adj. 不能翻转的;不可撤销的;不可逆的; [acc] /ˌɪrɪˈvɜːrsəbl/;
illegible: [x] adj. 难读的;难以辨认的; [acc] /ɪˈledʒəbl/;
assumption: [x] n. 假定,设想;采取;承担; [acc] /əˈsʌmpʃn/;
rally: [x] n. 集会;公路汽车赛;  v. 集合;恢复(健康等),重新振作; [acc] /ˈræli/;
scan: [x] v. 细看;浏览;扫描;  n. 扫描;浏览; [acc] /skæn/;
fragrance: [x] n. 香水;香味;芳香; [acc] /ˈfreɪɡrəns/;
inflation: [x] n. 通货膨胀;(充气后)膨胀;自负; [acc] /ɪnˈfleɪʃn/;
algebra: [x] n. 代数; [acc] /ˈældʒɪbrə/;
irony: [x] n. 反语;冷嘲;具有讽刺意味的事; [acc] /ˈaɪrəni/;
telecommunications: [x] n. 无线电通讯;电信学; [acc] /ˌtelikəˌmjuːnɪˈkeɪʃnz/;
fireplace: [x] n. 壁炉; [acc] /ˈfaɪərpleɪs/;
furious: [x] adj. 狂怒的;愤怒的;猛烈的; [acc] /ˈfjʊriəs/;
barren: [x] adj. 贫瘠的,不孕的;  n. 荒原,不毛之地; [acc] /ˈbærən/;
dine: [x] v. 吃饭,用餐;招待..吃饭;用正餐(晚餐); [acc] /daɪn/;
trait: [x] n. 特征; [acc] /treɪt/;
digest: [x] v. 消化;领会,理解;  n. 摘要; [acc] /daɪˈdʒest/;
trolley: [x] n. 电车;有轨电车;无轨电车;触轮;手推车;  vt. 搭乘;  vi. 搭乘; [acc] /ˈtrɑːli/;
mesh: [x] n. 网,筛孔;  v. 相啮合; [acc] /meʃ/;
atmosphere: [x] n. 大气层;大气;空气;气氛; [acc] /ˈætməsfɪr/;
vision: [x] n. 视力;视野;视觉;景象;想象;洞察;  v. 幻想,设想; [acc] /ˈvɪʒn/;
drought: [x] n. 干旱,旱灾; [acc] /draʊt/;
sin: [x] n. 罪;罪孽;错误;  v. 违犯戒律;犯过失; [acc] /sɪn/;
jelly: [x] n. 果冻,肉冻;胶状物;  vi. 成胶状;做胶冻;  adj. 有胶冻的;  vt. 使成胶冻; [acc] /ˈdʒeli/;
competitive: [x] adj. 竞争的;好胜的;有竞争力的; [acc] /kəmˈpetətɪv/;
debate: [x] n. 辩论;讨论;  v. 辩论;争论;议论; [acc] /dɪˈbeɪt/;
contemplate: [x] v. 沉思;对..周密考虑;注视; [acc] /ˈkɑːntəmpleɪt/;
puppy: [x] n. 小狗,幼犬; [acc] /ˈpʌpi/;
decorate: [x] v. 装饰,布置;把(勋章)授给(某人); [acc] /ˈdekəreɪt/;
moss: [x] n. 苔,藓,地衣; [acc] /mɔːs/;
initiative: [x] n. 主动权,主动性;首创精神;(重要的)法案,倡议; [acc] /ɪˈnɪʃətɪv/;
resident: [x] n. 居民;住客;住院实习医师;  adj. 居住的;住校的;固有的; [acc] /ˈrezɪdənt/;
enroll: [x] v. 入学,加入,登记,入伍; [acc] /ɪnˈroʊl/;
tramp: [x] n. 流浪汉;无业游民;沉重的脚步声;长途跋涉;  v. 重步行走;踏;践踏; [acc] /træmp/;
dissatisfaction: [x] n. 不满,不平;令人不满的事物; [acc] /ˌdɪsˌsætɪsˈfækʃn/;
magnitude: [x] n. 巨大;震级;重要性;[数]量值; [acc] /ˈmæɡnɪtuːd/;
bulk: [x] n. 大批;容量;体积;大块;  adj. 大量的;散装的;  v. 膨胀;显得重要; [acc] /bʌlk/;
ferry: [x] n. 渡船,渡轮;渡口;  v. 运送;渡运(人,车或物等); [acc] /ˈferi/;
squash: [x] v. 压扁,压制;  n. 南瓜,易压烂的物品,拥挤的人群,壁球; [acc] /skwɑːʃ/;
surgery: [x] n. 外科手术;外科; [acc] /ˈsɜːrdʒəri/;
marshal: [x] v. 整理,排列,集结;  n. 元帅;司仪,主持人; [acc] /ˈmɑːrʃl/;
contention: [x] n. 争夺;争论,辩论;论点; [acc] /kənˈtenʃn/;
tanker: [x] n. 油轮;运油飞机;油槽车;坦克手; [acc] /ˈtæŋkər/;
overestimate: [x] v. 过高估计;过高评价;  n. 过高的估计;过高的评价; [acc] /ˌoʊvərˈestɪmət/;
quartz: [x] n. 石英; [acc] /kwɔːrts/;
regiment: [x] n. (军队)团;  v. 组编成团;严格控制; [acc] /ˈredʒɪmənt/;
plump: [x] adj. 颇胖的,丰满的;  v. 拍打使鼓起,突然坐下,倒下,; [acc] /plʌmp/;
management: [x] n. 经营,管理,处理;管理者; [acc] /ˈmænɪdʒmənt/;
isolate: [x] v. 使隔离;使孤立;  adj. 孤立的;单独的; [acc] /ˈaɪsəleɪt/;
divine: [x] adj. 神的,神圣的;极好的;  v. (凭直觉)发现,猜到;  n. 神学家;圣职人员;教士;上帝; [acc] /dɪˈvaɪn/;
apology: [x] n. 道歉,(表达)歉意; [acc] /əˈpɑːlədʒi/;
verge: [x] n. 边缘;边界;  v. 接近;濒临; [acc] /vɜːrdʒ/;
aerospace: [x] n. 宇宙空间;航空航天(业);  adj. 航空与航天的,宇宙空间的; [acc] /ˈeroʊspeɪs/;
convey: [x] v. 传送,运送;表达,传达; [acc] /kənˈveɪ/;
fort: [x] n. 堡垒,要塞; [acc] /fɔːrt/;
infrastructure: [x] n. 基础设施; [acc] /ˈɪnfrəstrʌktʃər/;
efficiency: [x] n. 效率;功效;功率;性能; [acc] /ɪˈfɪʃnsi/;
available: [x] adj. 可得到的,可利用的,有空的,有效的; [acc] /əˈveɪləbl/;
tightly: [x] adv. 紧紧地; [acc] /ˈtaɪtli/;
deflection: [x] n. 转向;偏斜;偏折,折射; [acc] /dɪˈflekʃn/;
unify: [x] v. 使联合,统一;使相同,使一致; [acc] /ˈjuːnɪfaɪ/;
likelihood: [x] n. 可能;可能性; [acc] /ˈlaɪklihʊd/;
quaint: [x] adj. 精巧的;古雅的; [acc] /kweɪnt/;
principal: [x] n. 校长,负责人;本金,资本;  adj. 主要的,首要的; [acc] /ˈprɪnsəpl/;
amplitude: [x] n. 振幅;广阔;幅度; [acc] /ˈæmplɪtuːd/;
corrode: [x] v. 受腐蚀;腐蚀,侵蚀; [acc] /kəˈroʊd/;
mask: [x] n. 面具;遮蔽物;伪装;  v. 隐藏(感情);掩盖,掩饰,掩护;伪装; [acc] /mæsk/;
merit: [x] n. 优点;价值;功绩;  v. 值得;应得; [acc] /ˈmerɪt/;
analyze: [x] v. 分析;细察; [acc] /ˈænəlaɪz/;
provocative: [x] adj. 挑衅的,煽动的,刺激的;挑逗的; [acc] /prəˈvɑːkətɪv/;
shed: [x] v. 流出(眼泪);蜕皮;脱落;使清晰;流下;去除,摆脱;  n. 棚屋; [acc] /ʃed/;
restrain: [x] v. 制止(做);抑制(愤怒等),控制;监禁; [acc] /rɪˈstreɪn/;
detect: [x] v. 发现,发觉;侦察,探测; [acc] /dɪˈtekt/;
consistent: [x] adj. 始终如一的,持续的,一致的; [acc] /kənˈsɪstənt/;
envious: [x] adj. 羡慕的,嫉妒的; [acc] /ˈenviəs/;
hike: [x] n. 远足,徒步旅行;(数量,价格等)增加,上升;  v. 作长途徒步旅行;使高涨,提高(价格); [acc] /haɪk/;
velvet: [x] n. 天鹅绒;鹿茸的嫩皮;  adj. 天鹅绒的; [acc] /ˈvelvɪt/;
detain: [x] v. 拘留,使延迟; [acc] /dɪˈteɪn/;
astonishment: [x] n. 惊讶; [acc] /əˈstɑːnɪʃmənt/;
violation: [x] n. 违反,违背,妨碍;侵害;[体]违例,强奸; [acc] /ˌvaɪəˈleɪʃn/;
vault: [x] n. 保险库,金库,拱顶,墓室;  v. 越过,跳过; [acc] /vɔːlt/;
collide: [x] vi. 碰撞;互撞;抵触; [acc] /kəˈlaɪd/;
lame: [x] adj. 跛的;瘸的;差劲的,乏味的;〔解释或借口〕无说服力的,站不住脚的,蹩脚的;  v. (使)变跛; [acc] /leɪm/;
oppose: [x] v. 反对;反抗; [acc] /əˈpoʊz/;
contrast: [x] n. 差异,对照,对比;对照;对比;  v. (with)使与..对比; [acc] /ˈkɑːntræst/;
persuasion: [x] n. 说服;说服力; [acc] /pərˈsweɪʒn/;
radiator: [x] n. 散热器;暖气片; [acc] /ˈreɪdieɪtər/;
excursion: [x] n. 远足;短途旅行; [acc] /ɪkˈskɜːrʒn/;
affirm: [x] v. 肯定;断定;坚持声称; [acc] /əˈfɜːrm/;
aspire: [x] vi. 渴望,有志于(与to,for,after连用或后接不定式); [acc] /əˈspaɪər/;
deadline: [x] n. 截止期限,最后期限;  vt. 通过设定一时间期限来统治; [acc] /ˈdedlaɪn/;
yell: [x] v. 叫喊;  n. 叫喊;呐喊,欢呼; [acc] /jel/;
relieve: [x] v. 消除,减轻;换班; [acc] /rɪˈliːv/;
defiance: [x] n. 蔑视;反抗;挑战; [acc] /dɪˈfaɪəns/;
humanity: [x] n. 人性;人类;人道;慈爱;(复)人文学科; [acc] /hjuːˈmænəti/;
coward: [x] n. 懦夫,胆小鬼;  adj. 懦弱的,胆怯的; [acc] /ˈkaʊərd/;
substance: [x] n. 物质;实质,本质;药物; [acc] /ˈsʌbstəns/;
industrious: [x] adj. 勤劳的,勤奋的; [acc] /ɪnˈdʌstriəs/;
prescription: [x] n. 处方,药方;(医生开)的药;开处方,开药方; [acc] /prɪˈskrɪpʃn/;
superior: [x] n. 上级,高手;  adj. 较高级的,上层的,出众的; [acc] /suːˈpɪriər/;
furniture: [x] n. 家具;装置;设备; [acc] /ˈfɜːrnɪtʃər/;
geographical: [x] adj. 地理的,地理学的; [acc] /ˌdʒiːəˈɡræfɪkl/;
mature: [x] adj. 成熟的;到期的;  vt. 使成熟;  vi. 成熟; [acc] /məˈtʃʊr/;
distinct: [x] adj. 截然不同的;独特的;明显的;清晰的; [acc] /dɪˈstɪŋkt/;
spatial: [x] adj. 空间的,关于空间的; [acc] /ˈspeɪʃl/;
barometer: [x] n. 晴雨表;气压表; [acc] /bəˈrɑːmɪtər/;
acute: [x] adj. (疼痛,妒忌等)剧烈的,严重的;敏锐的;急性的;尖声的; [acc] /əˈkjut/;
plead: [x] v. 恳求,辩护,(不)认罪;提出.为理由; [acc] /pliːd/;
willow: [x] n. 柳树;  v. 用打棉机打开和清理;  adj. 柳木制的; [acc] /ˈwɪloʊ/;
cognitive: [x] adj. 认识能力的;认知的; [acc] /ˈkɑːɡnətɪv/;
alongside: [x] adv. 在旁边,并排地,并肩地;  prep. 在.旁边,和.并排;和.一起; [acc] /əˌlɔːŋˈsaɪd/;
barley: [x] n. 大麦; [acc] /ˈbɑːrli/;
receipt: [x] n. 收据,收条;收入;收到; [acc] /rɪˈsiːt/;
overhead: [x] adj. 在头顶上的,上面的,架空的;  adv. 在上面;在头顶,在上面;  n. 吊顶,天花板,屋顶;企业运营的一般费用(如房租,电费等); [acc] /ˌoʊvərˈhed/;
engross: [x] v. 独占;正式誊写;使全神贯注于;用大字体书写; [acc] /ɪnˈɡroʊs/;
donation: [x] n. 捐款;捐赠物; [acc] /doʊˈneɪʃn/;
neglect: [x] v. 忽视;忽略;疏忽;  n. 疏忽;忽视; [acc] /nɪˈɡlekt/;
uncertain: [x] adj. 不确定的;不确知的;不可靠的;易变的; [acc] /ʌnˈsɜːrtn/;
irrigation: [x] n. 灌溉; [acc] /ˌɪrɪˈɡeɪʃn/;
congress: [x] n. 国会(美);代表大会;议会;立法机关; [acc] /ˈkɑːŋɡrəs/;
discreet: [x] adj. 谨慎的;思虑周全的,小心的; [acc] /dɪˈskriːt/;
prone: [x] adj. 易于.的;有.倾向的;俯卧的; [acc] /proʊn/;
garment: [x] n. 服装;  vt. 给 ... 披上衣服;覆上...; [acc] /ˈɡɑːrmənt/;
accessible: [x] adj. 可使用的;可到达的;可进入的;易懂的; [acc] /əkˈsesəbl/;
essential: [x] adj. 必不可少的,必要的;本质的;重要的;基本的;  n. 要素;必需品; [acc] /ɪˈsenʃl/;
accommodate: [x] v. 向.提供住处(或膳宿);给.提供方便;容纳;使适应,顺应; [acc] /əˈkɑːmədeɪt/;
snatch: [x] v. 强夺;攫取;  n. 片断; [acc] /snætʃ/;
snap: [x] v. 使喀嚓一声折断,使发出吧嗒一声(关上或打开);  n. 吧嗒声;快照;  adj. 仓促的,突然的; [acc] /snæp/;
equality: [x] n. 同等,平等;[数]等式; [acc] /iˈkwɑːləti/;
mountainous: [x] adj. 多山的;巨大的; [acc] /ˈmaʊntənəs/;
reciprocal: [x] adj. 相互的,互惠的;  n. 倒数;互相关联的事物; [acc] /rɪˈsɪprəkl/;
devote: [x] vt. 奉献;献身于,专心致力于; [acc] /dɪˈvoʊt/;
convenience: [x] n. 方便;便利设施; [acc] /kənˈviːniəns/;
competitor: [x] n. 竞争对手,参赛者; [acc] /kəmˈpetɪtər/;
printer: [x] n. 印刷机,印刷工;打印机; [acc] /ˈprɪntər/;
booth: [x] n. 小舍;隔开的小间;公用电话亭;有篷的售货摊;窝棚; [acc] /buːθ/;
classical: [x] adj. 古典的;传统的;正统的;权威的;  n. 古典音乐; [acc] /ˈklæsɪkl/;
collision: [x] n. 碰撞;冲突; [acc] /kəˈlɪʒn/;
imitate: [x] v. 模仿; [acc] /ˈɪmɪteɪt/;
refusal: [x] n. 拒绝,回绝; [acc] /rɪˈfjuːzl/;
genuine: [x] adj. 真正的;真的;真诚的; [acc] /ˈdʒenjuɪn/;
exaggerate: [x] vi. 夸张;  vt. 夸大,夸张;使扩大; [acc] /ɪɡˈzædʒəreɪt/;
fantastic: [x] adj. 极好的;极大的;不真实的;荒诞离奇的;不可思议的;  n. 〈古〉古怪的人; [acc] /fænˈtæstɪk/;
watery: [x] adj. 水的;水分多的;水淋淋的,平淡的,稀薄的,松软的,有雨意的;微弱的,淡薄的; [acc] /ˈwɔːtəri/;
instrument: [x] n. 仪器;工具;乐器;手段; [acc] /ˈɪnstrəmənt/;
wither: [x] v. 枯萎;凋谢;  vt. 使枯萎,使凋谢,萎缩;使人感觉羞惭或迷惑; [acc] /ˈwɪðər/;
ambition: [x] n. 雄心,强烈欲望,抱负;(具体的)追求目标;  vt. 追求;有.野心; [acc] /æmˈbɪʃn/;
design: [x] vt. 设计;  n. 设计;图样;  vi. 设计略图;(为工艺品,装潢项目等)设计;当设计师;构思; [acc] /dɪˈzaɪn/;
tribute: [x] n. 致敬;悼念;贡品;称赞; [acc] /ˈtrɪbjuːt/;
aisle: [x] n. (席位间的)通道,过道; [acc] /aɪl/;
ensue: [x] v. 跟着发生,接踵而来;因而产生; [acc] /ɪnˈsuː/;
exhausted: [x] adj. 精疲力竭的;耗尽的;用完的; [acc] /ɪɡˈzɔːstɪd/;
sacred: [x] adj. 神圣的,宗教(性)的;神圣不可侵犯的; [acc] /ˈseɪkrɪd/;
ultrasonic: [x] adj. 超声的; [acc] /ˌʌltrəˈsɑːnɪk/;
mission: [x] n. 任务,使命;代表团,使团;  vi. 派遣..执行任务; [acc] /ˈmɪʃn/;
perpendicular: [x] adj. 成直角的,垂直的;直立的;  n. 垂直线; [acc] /ˌpɜːrpənˈdɪkjələr/;
inspire: [x] v. 使生灵感;启示;激发,激励; [acc] /ɪnˈspaɪər/;
proverb: [x] n. 谚语; [acc] /ˈprɑːvɜːrb/;
sober: [x] vi. 变得冷静;  adj. 未饮醉的,清醒的;有节制的;严肃的;  v. 使清醒;使冷静; [acc] /ˈsoʊbər/;
crowd: [x] n. 人群,一群;民众;朋友;  v. 聚集;涌入(脑海);挤满; [acc] /kraʊd/;
persistence: [x] n. 坚持不懈,持续; [acc] /pərˈsɪstəns/;
pious: [x] adj. 虔诚的;难以实现的;尽责的; [acc] /ˈpaɪəs/;
mourn: [x] v. 哀悼,哀伤; [acc] /mɔːrn/;
parachute: [x] n. 降落伞;  v. 跳伞; [acc] /ˈpærəʃuːt/;
destined: [x] adj. 命中注定的,预定的;(for)以.为目的地的; [acc] /ˈdestɪnd/;
allowance: [x] v. 定量供应(食物,饮料等物品);配给;  n. 零用钱;津贴,补贴;限额;免税额;允许,容忍,让步;考虑; [acc] /əˈlaʊəns/;
focus: [x] n. 焦点,聚焦;焦距;关注;  v. 使聚焦,集中注意力; [acc] /ˈfoʊkəs/;
baffle: [x] v. 使困惑;难住;阻碍;  n. 挡板; [acc] /ˈbæfl/;
album: [x] n. 相册;唱片集,专辑;集邮册; [acc] /ˈælbəm/;
consequence: [x] n. 结果,后果;重要性; [acc] /ˈkɑːnsɪkwens/;
landscape: [x] n. 风景;风景画;景观;横向打印格式;  v. 美化环境; [acc] /ˈlændskeɪp/;
partial: [x] adj. 偏爱的,特别喜欢的;偏袒的,不公平的,有偏见的;部分的;不完全的;  n. [数学]偏微商; [acc] /ˈpɑːrʃl/;
deplore: [x] v. 谴责;对...深感遗憾;悲悼;痛惜; [acc] /dɪˈplɔːr/;
splash: [x] v. 泼洒,溅,使成斑驳状;将.置于显眼位置;  n. 污点;飞溅的水;卖弄;拍打水的声音; 落入水的声音; [acc] /splæʃ/;
vivid: [x] adj. (颜色)鲜艳的,强烈的(颜色,光);生动的,清晰的(记忆,描述); [acc] /ˈvɪvɪd/;
miser: [x] n. 守财奴,吝啬鬼,(石油)凿井机; [acc] /ˈmaɪzər/;
suffice: [x] v. 足够; [acc] /səˈfaɪs/;
tropic: [x] n. 热带,回归线;  adj. 热带的; [acc] /ˈtrɑːpɪk/;
olive: [x] n. 橄榄;橄榄树;橄榄色;  adj. 橄榄色的; [acc] /ˈɑːlɪv/;
condense: [x] v. 压缩;精炼;冷凝; [acc] /kənˈdens/;
intellect: [x] n. 智力,理解力;非凡的才智;才华出众的人; [acc] /ˈɪntəlekt/;
additional: [x] adj. 增加的;附加的; [acc] /əˈdɪʃənl/;
comprehensive: [x] adj. 综合的;有充分理解力的,悟性好的;全面的,完整的;详尽的;广泛的,无所不包的;广义的;  n. 综合测验;综合学校; [acc] /ˌkɑːmprɪˈhensɪv/;
coupon: [x] n. (债券等)息券;赠券;配给券;折扣券; [acc] /ˈkuːpɑːn/;
wreck: [x] n. 沉船,失事船;失事;(事故中)遭严重损坏的汽车(飞机等);  v. 破坏,使毁灭; [acc] /rek/;
brink: [x] n. (尤指崖边)边缘; [acc] /brɪŋk/;
souvenir: [x] n. 纪念物,纪念品;  vt. 把.留作纪念; [acc] /ˈsuːvənɪr/;
confine: [x] v. 限制;监禁;  n. 范围,界限,约束,限制; [acc] /kənˈfaɪn/;
corpse: [x] n. 尸体,被废弃的东西; [acc] /kɔːrps/;
ashore: [x] adv. 在岸上,上岸; [acc] /əˈʃɔːr/;
fossil: [x] n. 化石;  adj. 从地下发掘出来的;化石的;属于旧时代的;陈腐的; [acc] /ˈfɑːsl/;
devotion: [x] n. 奉献,献身于...;热爱;投入;忠诚; [acc] /dɪˈvoʊʃn/;
deviate: [x] v. 偏离;背离;  adj. 脱离常轨的;  n. 脱离常轨的人; [acc] /ˈdiːvieɪt/;
bust: [x] n. 半身塑像;胸部;  v. 打碎;搜捕;降级;终止;  adj. 破产的;打碎的; [acc] /bʌst/;
desire: [x] n. 渴望;欲望;愿望;要求;  vi. 有希望,期望,愿望;  vt. 希望,渴望;请求,要求; [acc] /dɪˈzaɪər/;
saturation: [x] n. 饱和(状态),浸润,浸透; [acc] /ˌsætʃəˈreɪʃn/;
depute: [x] vt. 委派.为代表,指派,.为代理人;把(工作,责任等)交托给; [acc] /dɪˈpjuːt/;
burial: [x] n. 埋葬,葬礼;掩埋; [acc] /ˈberiəl/;
briefcase: [x] n. 公文包; [acc] /ˈbriːfkeɪs/;
reluctant: [x] adj. 不情愿的;勉强的; [acc] /rɪˈlʌktənt/;
automated: [x] adj. 机械化的;自动化的; [acc] /ˈɔtəˌmeɪtəd/;
correspondence: [x] n. 通信,通信联系;信件,函件;符合,一致;相似; [acc] /ˌkɔːrəˈspɑːndəns/;
bracket: [x] n. 括号;(年龄,收入等的)等级段,档次;壁架,支架;  v. 把.置于括号内;把.归入同一类; [acc] /ˈbrækɪt/;
safeguard: [x] v. 保护,维护;  n. 防卫措施,防范措施; [acc] /ˈseɪfɡɑːrd/;
incidence: [x] n. 发生率,入射角度; [acc] /ˈɪnsɪdəns/;
thicken: [x] v. (使)变厚,(使)变粗,使)变浓;变复杂,变密集; [acc] /ˈθɪkən/;
timid: [x] adj. 胆怯的;腼腆的; [acc] /ˈtɪmɪd/;
momentum: [x] n. (物理)动量;势头;动力; [acc] /moʊˈmentəm/;
evacuate: [x] v. 撤离,疏散,排清; [acc] /ɪˈvækjueɪt/;
peculiarity: [x] n. 怪癖;独特性; [acc] /pɪˌkjuːliˈærəti/;
doom: [x] v. 注定;命定;  n. 毁灭;厄运;劫数; [acc] /duːm/;
undertaking: [x] n. 事业,企业;承诺,保证;殡仪业;工程; [acc] /ˌʌndərˈteɪkɪŋ/;
holder: [x] n. 持有者,占有者,(台,架等)支持物; [acc] /ˈhoʊldər/;
generous: [x] adj. 慷慨的;充裕的,宽厚的;肥沃的; [acc] /ˈdʒenərəs/;
sue: [x] v. 控告,提起诉讼;控告;起诉;  n. 女子名(Sue); [acc] /suː/;
tyrant: [x] n. 暴君; [acc] /ˈtaɪrənt/;
trigger: [x] n. (枪等的)扳机,诱因;  v. 触发,引起,激发,扣扳机; [acc] /ˈtrɪɡər/;
flannel: [x] n. 法兰绒;绒布;法兰绒衣服;花言巧语;托辞;  adj. 法兰绒制的; [acc] /ˈflænl/;
enterprise: [x] n. 企业(或事业)单位,公司;事业;事业心; [acc] /ˈentərpraɪz/;
foul: [x] adj. 难闻的,发臭的;糟透了的;污秽的;犯规的;  n. 犯规;  vi. 犯规;  vt. 弄脏,使污秽;使纠缠; [acc] /faʊl/;
hitherto: [x] adv. 到目前为止,迄今为止; [acc] /ˌhɪðərˈtuː/;
indefinite: [x] adj. 模糊的;不确定的;无限的; [acc] /ɪnˈdefɪnət/;
peer: [x] n. 同龄人,同等地位的人;贵族;  v. 仔细看,费力地看; [acc] /pɪr/;
mass: [x] n. 众多;大多数;[物]质量;群众;  adj. 大量的,大规模的;  v. 聚集; [acc] /mæs/;
toxic: [x] n. 毒物;  adj. 有毒的;中毒的; [acc] /ˈtɑːksɪk/;
verify: [x] v. 查证,证明,证实; [acc] /ˈverɪfaɪ/;
bump: [x] n. 隆起物;撞击;(碰撞造成的)肿块;  v. 撞击;颠簸地行驶;凹凸不平;除名,撵走; [acc] /bʌmp/;
discount: [x] n. (价格,债款等)折扣;  v. 打折扣,不全信,怀疑地看待; [acc] /ˈdɪskaʊnt/;
emphasize: [x] v. 强调;着重;使突出; [acc] /ˈemfəsaɪz/;
reliance: [x] n. 信任,信心;信赖,依靠;信赖的人,(或物); [acc] /rɪˈlaɪəns/;
kindle: [x] v. 点燃,激起;着火;照亮;煽动; [acc] /ˈkɪndl/;
fuss: [x] n. 大惊小怪,小题大做;  v. (为小事)烦恼,过于忧虑; [acc] /fʌs/;
converge: [x] v. (向某一点)相交,会合;汇集,聚集,集中; [acc] /kənˈvɜːrdʒ/;
preliminary: [x] adj. 初步的,预备的;  n. 预赛;预考,初试;初步措施; [acc] /prɪˈlɪmɪneri/;
shabby: [x] adj. 破烂的,卑鄙的,衣衫褴褛的; [acc] /ˈʃæbi/;
Buddhism: [x] n. 佛教; [acc] /ˈbʊdɪzəm/;
comprehension: [x] n. 测试;理解力; [acc] /ˌkɑːmprɪˈhenʃn/;
limestone: [x] n. [地质学]石灰岩;石灰石; [acc] /ˈlaɪmstoʊn/;
pistol: [x] n. 手枪,信号,发令枪;  v. 用手枪杀死,用手枪伤害; [acc] /ˈpɪstl/;
hurrah: [x] excl. 好哇;  v. 欢呼;  n. 欢呼声;骚动;欢乐; [acc] /həˈrɑː/;
attachment: [x] n. 依恋;(机器的,通过邮件发送的)附件;连接物; [acc] /əˈtætʃmənt/;
sustain: [x] v. 维持;支撑,承受;供养;忍受;遭受,蒙受; [acc] /səˈsteɪn/;
cloak: [x] n. 斗篷,披风;覆盖物;  vt. 给.披斗篷;掩饰; [acc] /kloʊk/;
outbreak: [x] n. (战争,叛乱,感情等的)爆发;突然发生;  vi. 爆发; [acc] /ˈaʊtbreɪk/;
pedal: [x] n. 踏脚板;  v. 踏踩板;  adj. 脚踏的;  vt. 踏.的踏板; [acc] /ˈpedl/;
profession: [x] n. 职业;行业;声明;立誓信教; [acc] /prəˈfeʃn/;
accomplish: [x] v. 完成,做到;实现; [acc] /əˈkɑːmplɪʃ/;
forerunner: [x] n. 先驱;祖先;前兆;预兆; [acc] /ˈfɔːrʌnər/;
decompose: [x] v. (使)腐烂;分解; [acc] /ˌdiːkəmˈpoʊz/;
numerous: [x] adj. 为数众多的,许多的; [acc] /ˈnuːmərəs/;
evidence: [x] v. 证明;  n. 证据,证明;证物,证词; [acc] /ˈevɪdəns/;
frequency: [x] n. 频繁;屡次,经常发生;次数;频率; [acc] /ˈfriːkwənsi/;
recovery: [x] n. 痊愈;恢复,复苏;重获; [acc] /rɪˈkʌvəri/;
viscous: [x] adj. 黏的;黏稠的;黏滞的;有黏性的; [acc] /ˈvɪskəs/;
collaborate: [x] v. 合作; [acc] /kəˈlæbəreɪt/;
superficial: [x] adj. 肤浅的;表面的;微不足道的;  n. 表面文章; [acc] /ˌsuːpərˈfɪʃl/;
arrange: [x] v. 整理;改编(乐曲);筹备,安排;达成;达成协议;做安排; [acc] /əˈreɪndʒ/;
yoke: [x] n. 牛轭;枷锁;纽带;  v. 结合;连结; [acc] /joʊk/;
budge: [x] v. 移动一点;妥协; [acc] /bʌdʒ/;
therefore: [x] adv. 因此,所以; [acc] /ˈðerfɔːr/;
racket: [x] n. 吵闹声;球拍;  v. 嚷闹,吵闹,纵情欢闹;用球拍打; [acc] /ˈrækɪt/;
canteen: [x] n. 食堂,小卖部;水壶; [acc] /kænˈtiːn/;
profile: [x] n. 侧面像;外形,轮廓;  v. 描绘..的轮廓,扼要描述; [acc] /ˈproʊfaɪl/;
fold: [x] v. 折叠;彻底失败;合拢;  n. 折叠;褶; [acc] /foʊld/;
thirst: [x] n. 渴;干渴,缺水;渴求,渴望;  v. 渴求; [acc] /θɜːrst/;
magnetic: [x] adj. 有磁性的;有吸引力的; [acc] /mæɡˈnetɪk/;
serpent: [x] n. 大毒蛇,阴险的人; [acc] /ˈsɜːrpənt/;
perpetual: [x] adj. 永远的,永恒的;不断的; [acc] /pərˈpetʃuəl/;
slander: [x] n. 诽谤,诋毁;  v. 讲坏话,污蔑,诽谤; [acc] /ˈslændər/;
dispose: [x] v. 处理,处置,除去;使愿意; [acc] /dɪˈspoʊz/;
thigh: [x] n. 大腿; [acc] /θaɪ/;
emigrate: [x] v. 移居国外(或外地); [acc] /ˈemɪɡreɪt/;
alcohol: [x] n. 酒;酒精,乙醇; [acc] /ˈælkəhɔːl/;
energetic: [x] adj. 精力充沛的,充满活力的;有力的,积极的; [acc] /ˌenərˈdʒetɪk/;
utilize: [x] v. 利用;使用; [acc] /ˈjuːtəlaɪz/;
slaughter: [x] v. 屠杀,屠宰;  n. 屠宰,屠杀; [acc] /ˈslɔːtər/;
insanity: [x] n. 疯狂;精神错乱,精神病;荒谬,愚蠢; [acc] /ɪnˈsænəti/;
feudal: [x] adj. 领地的;封建制度的;封建时代的;世仇的; [acc] /ˈfjuːdl/;
streamline: [x] n. 流线型;  adj. 流线型的;  vt. 使成流线型;使.简化; [acc] /ˈstriːmlaɪn/;
impact: [x] n. 碰撞,冲击;冲击力;影响;  v. 冲击;压紧;产生影响;塞满; [acc] /ˈɪmpækt/;
analyst: [x] n. 分析员; [acc] /ˈænəlɪst/;
promising: [x] adj. 有前途的,有希望的;(前景)光明的; [acc] /ˈprɑːmɪsɪŋ/;
badge: [x] n. 徽章;象征;标记;  vt. 给予.标记;授予.徽章; [acc] /bædʒ/;
distortion: [x] n. 扭曲,变形;曲解;失真; [acc] /dɪˈstɔːrʃn/;
luncheon: [x] n. 午宴; [acc] /ˈlʌntʃən/;
sequence: [x] n. 顺序,次序;连续,继续; [acc] /ˈsiːkwəns/;
reckless: [x] adj. 不顾虑的;鲁莽的,不顾后果的; [acc] /ˈrekləs/;
sauce: [x] n. 酱,调味汁;莽撞,冒失; [acc] /sɔːs/;
exclamation: [x] n. 感叹,惊叹,惊呼;惊叹词; [acc] /ˌekskləˈmeɪʃn/;
illuminate: [x] vt. 照亮;阐释;说明; [acc] /ɪˈluːmɪneɪt/;
squad: [x] n. (军队的)班,小队,小组;  v. 编成班; [acc] /skwɑːd/;
automation: [x] n. 自动化; [acc] /ˌɔːtəˈmeɪʃn/;
miniature: [x] adj. 小型的,微小的;  n. 微小的模型,缩影,微型人物像;  vt. 使成小型;把.画成纤细画;缩写; [acc] /ˈmɪnətʃər/;
exclude: [x] vt. 不包括;排挤;排除;驱逐,赶出; [acc] /ɪkˈskluːd/;
boycott: [x] vt. 抵制;  n. 抵制; [acc] /ˈbɔɪkɑːt/;
deafen: [x] v. 变聋; [acc] /ˈdefn/;
defy: [x] v. 违抗,藐视;使不可能 (理解或解释);违背;赌.也不能;  n. 挑战;对抗; [acc] /dɪˈfaɪ/;
preserve: [x] v. 贮鲜,保鲜;保存;保护;  n. 独揽之事,独占的活动; [acc] /prɪˈzɜːrv/;
eloquent: [x] adj. 有口才的;雄辩的;演说动人的; [acc] /ˈeləkwənt/;
dreadful: [x] adj. 糟透了的,极不合意的;可怕的; [acc] /ˈdredfl/;
recycle: [x] v. 回收利用;改建;  n. 再循环; [acc] /ˌriːˈsaɪkl/;
string: [x] n. 弦,线,细绳,一系列;一行;  v. 串起;悬挂;使紧张;  adj. 线的,线织的;由弦乐器组成的; [acc] /strɪŋ/;
series: [x] n. 系列,系列节目;连续比赛;连续,接连; [acc] /ˈsɪriːz/;
nurture: [x] v. 养育,培育;培植;  n. 养育,培养;教养;营养物; [acc] /ˈnɜːrtʃər/;
literature: [x] n. 文学;宣传册;文献; [acc] /ˈlɪtrətʃər/;
massive: [x] adj. 巨大的;大规模的;大量的; [acc] /ˈmæsɪv/;
concise: [x] adj. 简明的,简要的;简洁的,简要的; [acc] /kənˈsaɪs/;
combustion: [x] n. 燃烧; [acc] /kəmˈbʌstʃən/;
clearing: [x] n. 清除,清洁;空旷地; [acc] /ˈklɪrɪŋ/;
encounter: [x] v. 邂逅,遭遇,偶遇;  n. 偶然碰见,遭遇; [acc] /ɪnˈkaʊntər/;
staircase: [x] n. 楼梯; [acc] /ˈsterkeɪs/;
glow: [x] n. 光辉,红光,热情;  v. 发光,发红光,发热; [acc] /ɡloʊ/;
comply: [x] vi. 依从,服从,遵守; [acc] /kəmˈplaɪ/;
insulator: [x] n. 绝缘体,绝热器; [acc] /ˈɪnsəleɪtər/;
colleague: [x] n. 同事;同行; [acc] /ˈkɑːliːɡ/;
graze: [x] v. (牲畜)吃草;放牧;擦过;  n. 擦,擦伤; [acc] /ɡreɪz/;
extinct: [x] adj. 灭绝的;破灭了的,消亡了的; [acc] /ɪkˈstɪŋkt/;
agony: [x] n. 极大痛苦; [acc] /ˈæɡəni/;
census: [x] n. 人口普查,人口调查;统计;  v. 调查(某地区等的)人口数字;统计.的数字; [acc] /ˈsensəs/;
nominate: [x] v. 提名;任命;  adj. 有特定名字的;被提名的;被指定的; [acc] /ˈnɑːmɪneɪt/;
hiss: [x] n. 嘶嘶声;发嘘声;  vi. 发出嘶嘶声;  vt. 嘶嘶地发出;发嘘声让(某人)别做声; [acc] /hɪs/;
drill: [x] n. 训练;反复操练;钻头;  v. 在..上钻孔;钻孔; [acc] /drɪl/;
thesis: [x] n. (学位)论文,论题,论点; [acc] /ˈθiːsɪs/;
distill: [x] v. 抽出..的精华;蒸馏; [acc] /dɪˈstɪl/;
insane: [x] adj. 精神失常的,疯狂的;精神病患者的;荒唐的;  n. 精神失常的人;精神错乱的人; [acc] /ɪnˈseɪn/;
sanction: [x] n. 批准;制裁,处罚;  v. 批准,支持,对..实施制裁; [acc] /ˈsæŋkʃn/;
edit: [x] v. 剪辑;编辑;校订;  n. 编辑[校订]工作; [acc] /ˈedɪt/;
default: [x] n. 违约;缺席;缺乏;默认;  vi. 不履行义务;拖欠;  vt. 不履行;不参加; [acc] /dɪˈfɔːlt/;
attain: [x] v. 获得;达到(某个年纪,水平,条件);实现;  n. 成就; [acc] /əˈteɪn/;
mason: [x] n. 泥瓦匠,共济会会员(等于freemason); [acc] /ˈmeɪsn/;
propeller: [x] n. 螺旋桨;推进器; [acc] /prəˈpelər/;
therapy: [x] n. 治疗,理疗;疗法; [acc] /ˈθerəpi/;
loyal: [x] adj. 忠心的;忠诚的;  n. 效忠(君主)的臣民; [acc] /ˈlɔɪəl/;
resume: [x] n. 简历;  v. 重新开始;继续;  vt. 回到;恢复;重新开始; [acc] /ˈrezəmeɪ/;
frantic: [x] adj. 疯狂的;狂乱的;慌乱的; [acc] /ˈfræntɪk/;
vertical: [x] adj. 垂直的;顶点的;  n. 垂直线,垂直面; [acc] /ˈvɜːrtɪkl/;
pedlar: [x] n. 小贩;传播者; [acc] /ˈpedlər/;
fragrant: [x] adj. 芬芳的;香的; [acc] /ˈfreɪɡrənt/;
persist: [x] v. 坚持,固执;继续存留; [acc] /pərˈsɪst/;
clinic: [x] n. 诊所;门诊(部,室); [acc] /ˈklɪnɪk/;
astronomy: [x] n. 天文学; [acc] /əˈstrɑːnəmi/;
nickname: [x] n. 绰号;诨号;昵称;  vt. 起绰号;叫错.的名字; [acc] /ˈnɪkneɪm/;
resonance: [x] n. 共振;回声;(情感等的)共鸣; [acc] /ˈrezənəns/;
award: [x] n. 奖品;奖学金;判决;  vt. 授予;给予; [acc] /əˈwɔːrd/;
tuition: [x] n. 学费,教学,讲授; [acc] /tuˈɪʃn/;
photography: [x] n. 摄影;摄影术; [acc] /fəˈtɑːɡrəfi/;
convert: [x] v. 可转变为,可变换成;改变,转变,转化;使改变信仰;  n. 皈依者;改变宗教信仰者; [acc] /kənˈvɜːrt/;
harmonious: [x] adj. 和谐的,协调的;和睦的;悦耳的; [acc] /hɑːrˈmoʊniəs/;
howl: [x] v. (狼,狗等)嗥叫;(风等)呼啸;(因愤怒,痛苦等)吼叫,哀号;  n. 嚎叫,哀号; [acc] /haʊl/;
subtle: [x] adj. 微妙的;敏锐的;不明显的;精细的;狡猾的; [acc] /ˈsʌtl/;
medal: [x] n. 奖牌;勋章;  v. 授予奖章; [acc] /ˈmedl/;
deceive: [x] v. 欺骗,行骗; [acc] /dɪˈsiːv/;
triumphant: [x] adj. 得胜的,得意洋洋的; [acc] /traɪˈʌmfənt/;
exhaust: [x] v. 使筋疲力尽;耗尽;详尽论述;  n. 排气装置;废气; [acc] /ɪɡˈzɔːst/;
terminate: [x] adj. 终止的;可结尾的;  vi. 结束;结尾;  v. 使结束,终止; [acc] /ˈtɜːrmɪneɪt/;
combat: [x] n. 战斗,格斗;  v. 与.战斗,与.斗争;  adj. 战斗的; [acc] /ˈkɑːmbæt/;
embroidery: [x] n. 刺绣(品),润色; [acc] /ɪmˈbrɔɪdəri/;
reckon: [x] vt. 计算;想,指望;把.看做;  v. 认为;  vi. 计算;估计; [acc] /ˈrekən/;
grab: [x] v. 攫取,抓取,掠夺;赶紧做;吸引;  n. 抓取,非法所得; [acc] /ɡræb/;
refreshment: [x] n. 茶点;食物,饮料;(会议或旅行期间提供的)饮料,点心,茶点; [acc] /rɪˈfreʃmənt/;
crisis: [x] n. 危机;存亡之际; [acc] /ˈkraɪsɪs/;
accusation: [x] n. 谴责;[律]指控; [acc] /ˌækjuˈzeɪʃn/;
tabulate: [x] v. 将.制成表;制成表格;  vt. 把.列表显示;  adj. 平面的;板状的; [acc] /ˈtæbjuleɪt/;
questionnaire: [x] n. 调查表,问卷; [acc] /ˌkwestʃəˈner/;
smog: [x] n. 烟雾; [acc] /smɑːɡ/;
sip: [x] v. 啜饮;  n. 一小口; [acc] /sɪp/;
phase: [x] n. (月等的)变相;盈亏;方面;阶段; [acc] /feɪz/;
shortcut: [x] n. 捷径;快捷之法;  adj. 提供捷径的;有简便方法的;  v. 抄近路,走捷径; [acc] /ˈʃɔːrtkʌt/;
shear: [x] vt. 剪羊毛;剪头发;  n. (复数)大剪刀; [acc] /ʃɪr/;
amplify: [x] v. 放大(声音等);扩大;增强;详述;进一步阐述; [acc] /ˈæmplɪfaɪ/;
idiom: [x] n. 习语;成语;惯用语法; [acc] /ˈɪdiəm/;
mutual: [x] adj. 互相的;彼此的;共同的; [acc] /ˈmjuːtʃuəl/;
allegiance: [x] n. 忠诚,拥护; [acc] /əˈliːdʒəns/;
wrestle: [x] v. 摔跤,角斗;斗争,努力;  n. 摔跤,角力,扭斗; [acc] /ˈresl/;
deficit: [x] n. 亏损;赤字;不足额; [acc] /ˈdefɪsɪt/;
conservation: [x] n. 保护;保存;维持; [acc] /ˌkɑːnsərˈveɪʃn/;
preference: [x] n. 偏爱;喜爱物; [acc] /ˈprefrəns/;
meadow: [x] n. 草地; [acc] /ˈmedoʊ/;
loosely: [x] adv. 宽松地,松散地; [acc] /ˈluːsli/;
referee: [x] n. 裁判员,仲裁者;  v. 裁判,仲裁; [acc] /ˌrefəˈriː/;
hover: [x] v. (鸟,直升机)盘旋,翱翔;(人)逗留在附近,徘徊; [acc] /ˈhʌvər/;
bunch: [x] n. 束;串;群,伙;  v. 集中,挤在一起;使成一束(或一群等); [acc] /bʌntʃ/;
clearance: [x] n. 清除;清理;清空;许可; [acc] /ˈklɪrəns/;
contrive: [x] v. 发明;设计出;设法做到;谋划;策划; [acc] /kənˈtraɪv/;
constitute: [x] v. 构成,组成;任命; [acc] /ˈkɑːnstətuːt/;
prestige: [x] n. 威望,声望; [acc] /preˈstiːʒ/;
attract: [x] v. 吸引,引诱; [acc] /əˈtrækt/;
arc: [x] n. 弧形物,弧;弧光;电弧; [acc] /ɑːrk/;
tranquil: [x] adj. 宁静的,安静的; [acc] /ˈtræŋkwɪl/;
emergence: [x] n. 冒出;出现;浮现;发生; [acc] /iˈmɜːrdʒəns/;
semester: [x] n. 一学期;半年; [acc] /sɪˈmestər/;
lodging: [x] n. 住所;寄宿;(大学生的)校外宿舍; [acc] /ˈlɑːdʒɪŋ/;
intact: [x] adj. 原封未动的,未受损的,完整无缺的; [acc] /ɪnˈtækt/;
expand: [x] v. 膨胀;扩大;  vt. 详细展开; [acc] /ɪkˈspænd/;
reference: [x] n. 参考书;提及;推荐人;参考;证明;推荐信;  v. 附.以供参考;引用; [acc] /ˈrefrəns/;
piston: [x] n. 活塞,瓣; [acc] /ˈpɪstən/;
cable: [x] n. 电缆,缆,索;  v. 拍电报; [acc] /ˈkeɪbl/;
appreciable: [x] adj. 很可观的;可感知的;可察觉的;可评估的; [acc] /əˈpriːʃəbl/;
errand: [x] n. 差使;差事;使命; [acc] /ˈerənd/;
graphite: [x] n. 石墨; [acc] /ˈɡræfaɪt/;
bacteria: [x] n. 细菌(复数); [acc] /bækˈtɪriə/;
concern: [x] n. 关心,担忧;  v. 感兴趣,涉及,关心,(使)担忧; [acc] /kənˈsɜːrn/;
indulge: [x] v. 沉迷于;放纵;满足; [acc] /ɪnˈdʌldʒ/;
plunge: [x] v. 跳进,(使)投入;使陷入;暴跌;  n. 卷入,参与;暴跌,骤减; [acc] /plʌndʒ/;
specification: [x] n. 规格,载明,详述; [acc] /ˌspesɪfɪˈkeɪʃn/;
stock: [x] n. 股票;股份;存货;储备;家畜;  v. 给..装满;储存;  adj. 储备的; [acc] /stɑːk/;
epidemic: [x] adj. 流行性的,传染的;  n. 流行病,传染病,(犯罪等的)盛行; [acc] /ˌepɪˈdemɪk/;
instantaneous: [x] adj. 瞬间的;即刻的;猝发的; [acc] /ˌɪnstənˈteɪniəs/;
barricade: [x] n. 路障;障碍物;栅栏;  v. 设路障;挡住; [acc] /ˌbærɪˈkeɪd/;
insect: [x] n. 昆虫; [acc] /ˈɪnsekt/;
irregularity: [x] n. 不规律;无常;不良行为; [acc] /ɪˌreɡjəˈlærəti/;
staple: [x] v. 用订书钉订;  n. 订书钉;主食;主要产品;  adj. 主要的;基本的;标准的; [acc] /ˈsteɪpl/;
electronics: [x] n. 电子学,电子工业;电子设备,电子产品; [acc] /ɪˌlekˈtrɑːnɪks/;
transmit: [x] v. 传送;传播,传导;发射; [acc] /trænsˈmɪt/;
display: [x] v. 展示;显示;陈列;  n. 表现,流露,展示;显示,显示器;陈列品; [acc] /dɪˈspleɪ/;
pole: [x] n. 杆,竿极(点);磁极;电极; [acc] /poʊl/;
smoothly: [x] adv. 流畅地;顺畅地,流利地;平滑地;平稳地; [acc] /ˈsmuːðli/;
perspiration: [x] n. 汗水;出汗; [acc] /ˌpɜːrspəˈreɪʃn/;
flee: [x] v. 逃走,(时间)飞逝;逃离;避开; [acc] /fliː/;
muse: [x] v. 沉思;冥想;  n. [希神]缪斯女神,灵感; [acc] /mjuːz/;
loyalty: [x] n. 忠诚;忠心耿耿; [acc] /ˈlɔɪəlti/;
liable: [x] adj. (for)有责任的;有义务的;(to)有.倾向的;易于.的,有可能.; [acc] /ˈlaɪəbl/;
tedious: [x] adj. 沉闷的,冗长乏味的; [acc] /ˈtiːdiəs/;
incentive: [x] n. 刺激,激励;鼓励; [acc] /ɪnˈsentɪv/;
execute: [x] v. 处决;完成(动作);实行;执行(计划); [acc] /ˈeksɪkjuːt/;
paralyze: [x] vt. 使瘫痪;使麻痹;使不能活动; [acc] /ˈperəˌlaɪz/;
snail: [x] n. 蜗牛;迟钝的人;  v. 捉蜗牛;缓慢移动; [acc] /sneɪl/;
telecommunication: [x] n. 远程通讯;  adj. 与电信有关的; [acc] /ˌtelikəˌmjuːnɪˈkeɪʃn/;
deteriorate: [x] v. 恶化;变质;衰退; [acc] /dɪˈtɪriəreɪt/;
grumble: [x] v. 埋怨;发牢骚;咕哝;  n. 隆隆响声;抱怨,怨言; [acc] /ˈɡrʌmbl/;
merely: [x] adv. 仅仅;仅仅,只不过; [acc] /ˈmɪrli/;
productivity: [x] n. 生产力;生产率;多产; [acc] /ˌprɑːdʌkˈtɪvəti/;
luxury: [x] adj. 奢侈的,豪华的;  n. 奢侈,奢华; [acc] /ˈlʌkʃəri/;
cordial: [x] adj. 热情友好的,衷心的; [acc] /ˈkɔːrdʒəl/;
disturbance: [x] n. 骚乱,混乱;扰乱,打扰;心神不安,烦恼; [acc] /dɪˈstɜːrbəns/;
certify: [x] v. (发给证书)证明;证实; [acc] /ˈsɜːrtɪfaɪ/;
rebellion: [x] n. 反叛,叛乱;反抗; [acc] /rɪˈbeljən/;
breakthrough: [x] n. 突破,突破性进展,重要的新发现;  adj. 突破性的; [acc] /ˈbreɪkθruː/;
culture: [x] n. 文化;文明;修养;栽培;  v. 使有教养;培养; [acc] /ˈkʌltʃər/;
signal: [x] n. 信号;预兆;  v. 发信号;标志;  adj. 显著的,优越的;暗号的,作信号用的; [acc] /ˈsɪɡnəl/;
soften: [x] v. (使)变柔软,(使)变柔和;使(态度)温和,变温和;使 (光,颜色或声音) 变柔和; [acc] /ˈsɔːfn/;
dimension: [x] n. 维度;尺寸;尺度;方面; [acc] /dɪˈmenʃn/;
wholesaler: [x] n. 批发商; [acc] /ˈhoʊlseɪlər/;
denounce: [x] v. 谴责,斥责; [acc] /dɪˈnaʊns/;
biography: [x] n. 传记文学,传记; [acc] /baɪˈɑːɡrəfi/;
addict: [x] n. 上瘾的人;入迷的人;  v. 使沉迷,使上瘾; [acc] /ˈædɪkt/;
latitude: [x] n. 纬度;地区;(言论,行动的)自由; [acc] /ˈlætɪtuːd/;
submit: [x] v. 提交;屈服,使...服从;建议,主张; [acc] /səbˈmɪt/;
treasurer: [x] n. 财务主管; [acc] /ˈtreʒərər/;
mercury: [x] n. 水银,汞;水星(Mercury); [acc] /ˈmɜːrkjəri/;
peril: [x] n. 危险;  vt. 置.于危险中;危及; [acc] /ˈperəl/;
spite: [x] n. 恶意,怨恨;  v. 刁难,欺侮; [acc] /spaɪt/;
softness: [x] n. 柔和,温柔; [acc] /ˈsɔːftnəs/;
burner: [x] n. 火炉;燃烧嘴;烧火的人; [acc] /ˈbɜːrnər/;
freshen: [x] v. 使清新,使新鲜,使精神焕发;添(饮料);增强; [acc] /ˈfreʃn/;
amend: [x] v. 改进;修订;修正; [acc] /əˈmend/;
orient: [x] n. [the Orient]东方;  v. 定..的方位;  adj. 东方的;(太阳等)上升的,新生的;闪闪发光的; [acc] /ˈɔːrient/;
scoff: [x] vi. 讥笑;  v. 嘲笑;  n. 愚弄; [acc] /skɔːf/;
sticky: [x] adj. 粘的,黏糊糊的;闷热的;困难的;令人不满意的;  n. 便利贴; [acc] /ˈstɪki/;
participation: [x] n. 参与;参加; [acc] /pɑːrˌtɪsɪˈpeɪʃn/;
woe: [x] n. 悲哀;痛苦;  int. 唉(表示痛苦,悲伤或悔恨);咳; [acc] /woʊ/;
abandon: [x] v. 抛弃;放弃;放纵; [acc] /əˈbændən/;
maneuver: [x] v. 操纵;  n. 操纵;花招;调遣;策略; [acc] /məˈnʊvər/;
[kk9: 3071个]