crawl: [v]爬,爬行;缓慢行进; [n]缓慢行进;自由式游泳; [a]/krɔːl/; [or]yshx;
absorb: [vt]吸收;汲取;吸引..的注意;理解,掌握;承受; [a]/əbˈzɔːrb/; [or]yshx;
layman: [n]门外汉;俗人;外行; [a]/ˈleɪmən/; [or]yshx;
maximum: [n]最大值;最大限度; [adj]最大的; [a]/ˈmæksɪməm/; [or]yshx;
shrug: [n]耸肩; [v](为表示厌恶,轻漠,冷淡,怀疑等)耸肩;以耸肩表示(厌恶,轻蔑,冷淡,怀疑等); [a]/ʃrʌɡ/; [or]yshx;
summit: [n]山顶,顶点;(政府间的)峰会; [a]/ˈsʌmɪt/; [or]yshx;
challenge: [n]挑战;质疑; [v]挑战;质疑; [a]/ˈtʃælɪndʒ/; [or]yshx;
bounce: [vi]弹起,蹦跳; [vt]使弹起; [v]拒付 (支票); [n]弹跳,弹力,活力; [a]/baʊns/; [or]yshx;
sufficient: [adj]足够的;充分的; [a]/səˈfɪʃnt/; [or]yshx;
abuse: [v]虐待;辱骂;(对麻醉毒品,兴奋剂等的)非法服用;滥用; [n]滥用;虐待;辱骂; [a]/əˈbjuːs/; [or]yshx;
slice: [v]把..切成片;大幅度削减;切开; [n]薄片;份额,部分; [a]/slaɪs/; [or]yshx;
ban: [vt]禁止;查禁; [n]禁止,禁令; [a]/bæn/; [or]yshx;
horrible: [adj]可怕的,恐怖的;讨厌的,糟糕的;粗鲁的,不友好的; [a]/ˈhɔːrəbl/; [or]yshx;
prescribe: [v]给..开药;命令,指示; [a]/prɪˈskraɪb/; [or]yshx;
obstruct: [v]阻碍,妨碍,阻塞,堵塞; [a]/əbˈstrʌkt/; [or]yshx;
sow: [v]播种;散布;煽动; [n]母猪; [a]/soʊ/; [or]yshx;
focus: [n]焦点,聚焦;焦距;关注; [v]使聚焦,集中注意力; [a]/ˈfoʊkəs/; [or]yshx;
shock: [v](使)震惊,(使)震动; [n]震动,震惊,冲击,休克; [a]/ʃɑːk/; [or]yshx;
slap: [v]掌掴,拍打,侮辱; [n]侮辱,掴,拍击声; [adv]猛然;径直;恰好;正好; [a]/slæp/; [or]yshx;
lace: [n]鞋带;花边; [v]加以修饰;结带子; [a]/leɪs/; [or]yshx;
scrutiny: [n]监视,细看,详细检查,仔细观察; [a]/ˈskruːtəni/; [or]yshx;
vacant: [adj]空的,未被占用的;闲置的;空缺的;茫然的; [a]/ˈveɪkənt/; [or]yshx;
accumulate: [vi]聚积,堆积; [vt]积攒,积累; [a]/əˈkjuːmjəleɪt/; [or]yshx;
dub: [v]授予(称号);为(电影)配音;混录录制(音乐); [n](西印度群岛的)强节奏音乐; [a]/dʌb/; [or]yshx;
cork: [n]软木; [v]塞住,抑制; [a]/kɔːrk/; [or]yshx;
sovereign: [adj]至高无上的,具有独立主权的,有最高统治权的; [n]最高统治者,君主,元首; [a]/ˈsɑːvrən/; [or]yshx;
pant: [v]喘息;气喘吁吁地说;喘气; [n]喘气; [a]/pænt/; [or]yshx;
privilege: [n]特权,优待;荣幸; [v]给..特权; [a]/ˈprɪvəlɪdʒ/; [or]yshx;
psychiatry: [n]精神病学;精神病治疗法; [a]/saɪˈkaɪətri/; [or]yshx;
freak: [n]怪人,怪物,奇事; [adj]反常的,怪诞的; [vt]使强烈反应(震惊;畏惧); [vi]在药物影响下变得异乎寻常; [a]/friːk/; [or]yshx;
fascinate: [v]使着迷;使神魂颠倒;吸引注意; [a]/ˈfæsɪneɪt/; [or]yshx;
ceremony: [n]典礼,仪式;礼节; [a]/ˈserəmoʊni/; [or]yshx;
guideline: [n]指导路线,准则; [a]/ˈɡaɪdlaɪn/; [or]yshx;
ambition: [n]雄心,强烈欲望,抱负;(具体的)追求目标; [vt]追求;有.野心; [a]/æmˈbɪʃn/; [or]yshx;
sprawl: [n]四肢伸开的躺卧姿势;蔓生; [v]四肢伸开地坐(或卧);爬行;蔓生; [a]/sprɔːl/; [or]yshx;
plot: [n]情节,阴谋,小块土地; [v]密谋,计划,为小说写情节; [a]/plɑːt/; [or]yshx;
retail: [adj]零售的; [n]零售; [v]零售,零售价是; [adv]以零售方式,以零售形式; [a]/ˈriːteɪl/; [or]yshx;
inert: [adj]不动的,惰性的;行动迟钝的;无生气的; [a]/ɪˈnɜːrt/; [or]yshx;
structural: [adj]结构的,构造的,建筑的; [a]/ˈstrʌktʃərəl/; [or]yshx;
bound: [adj]受约束的;有义务的;一定的; [v]束缚;跳跃着前行; [n]跳跃;范围;界限; [a]/baʊnd/; [or]yshx;
persevere: [v]坚持,不屈不挠; [a]/ˌpɜːrsəˈvɪr/; [or]yshx;
factor: [n]因素;[数]因子,商; [a]/ˈfæktər/; [or]yshx;
flake: [n]薄片; [v]使成薄片;剥落;雪片般落下; [a]/fleɪk/; [or]yshx;
stoop: [v]弯腰,俯身;屈从;堕落,沦为; [n]弯腰; [a]/stuːp/; [or]yshx;
inspire: [v]使生灵感;启示;激发,激励; [a]/ɪnˈspaɪər/; [or]yshx;
critical: [adj]批评的;文艺评论的;爱挑剔的;危急的;关键的,重要的; [a]/ˈkrɪtɪkl/; [or]yshx;
making: [n]制作,形成,发展; [a]/ˈmeɪkɪŋ/; [or]yshx;
mansion: [n]官邸;巨宅;大厦; [a]/ˈmænʃn/; [or]yshx;
stubborn: [adj]顽固的;倔强的;难对付的; [a]/ˈstʌbərn/; [or]yshx;
loyal: [adj]忠心的;忠诚的; [n]效忠(君主)的臣民; [a]/ˈlɔɪəl/; [or]yshx;
revelation: [n]揭露;揭示;(出乎意料的)被揭示的真相; [a]/ˌrevəˈleɪʃn/; [or]yshx;
come up: [v]升起;出现;发生;发芽; [a]/kʌm ʌp/; [or]yshx;
mission: [n]任务,使命;代表团,使团; [vi]派遣..执行任务; [a]/ˈmɪʃn/; [or]yshx;
erect: [v]搭建,竖起;建造,建立; [adj]直立的,垂直的; [a]/ɪˈrekt/; [or]yshx;
isle: [n]岛,小岛; [a]/aɪl/; [or]yshx;
classify: [v]把.分类; [a]/ˈklæsɪfaɪ/; [or]yshx;
cannon: [n]大炮;机关炮; [v]相撞;开炮; [a]/ˈkænən/; [or]yshx;
lucid: [adj]明晰的;透明的;易懂的;头脑清楚的; [a]/ˈluːsɪd/; [or]yshx;
crevice: [n]缺口,裂缝; [a]/ˈkrevɪs/; [or]yshx;
maltreat: [v]虐待;滥用; [a]/ˌmælˈtriːt/; [or]yshx;
navigable: [adj](江河,海洋)可航行的,可通航的;(船)适航的; [a]/ˈnævɪɡəbl/; [or]yshx;
civic: [adj]城市的;公民的,市民的; [a]/ˈsɪvɪk/; [or]yshx;
frugal: [adj]节俭的,俭朴的;不昂贵的,廉价的,花钱少的,不充足的; [a]/ˈfruːɡl/; [or]yshx;
throng: [v]群集,蜂拥; [n]一大群人; [vt]挤向; [a]/θrɔːŋ/; [or]yshx;
specimen: [n]标本,样本,样品; [a]/ˈspesɪmən/; [or]yshx;
stereotype: [n]老套的模式,陈规,成见; [v]对..产生成见; [a]/ˈsteriətaɪp/; [or]yshx;
cosmopolitan: [n]游历四方的人; [adj]见多识广的;多元的;广泛分布的; [a]/ˌkɑːzməˈpɑːlɪtən/; [or]yshx;
devote: [vt]奉献;献身于,专心致力于; [a]/dɪˈvoʊt/; [or]yshx;
benefit: [v]受益,有助于,使受益; [n]好处,益处;救济金; [a]/ˈbenɪfɪt/; [or]yshx;
coordinate: [v]使协调,使一致,调整; [n]坐标,同等的人物,配套服装; [adj]并列的;同等的; [a]/koʊˈɔːrdɪneɪt/; [or]yshx;
unconscious: [adj]不省人事的;无意识的;未察觉的; [a]/ʌnˈkɑːnʃəs/; [or]yshx;
melancholy: [n]忧郁,悲哀; [adj]忧郁的,令人伤感的; [a]/ˈmelənkɑːli/; [or]yshx;
do away with: [phr]废除;消灭;去掉; [a]/doʊ əˈweɪ wɪθ/; [or]yshx;
lay bare: [phr]揭发;暴露;公开; [a]/leɪ ber/; [or]yshx;
incipient: [adj]初期的;刚出现的; [a]/ɪnˈsɪpiənt/; [or]yshx;
plateau: [n]高原; [vi]到达平稳阶段; [a]/plæˈtoʊ/; [or]yshx;
evaporate: [v]蒸发,失去水分;消失; [a]/ɪˈvæpəreɪt/; [or]yshx;
cast sb. (sth.) aside: [v]抛弃,废除; [a]/kæst ˈsʌmbədi ˈsʌmθɪŋ əˈsaɪd/; [or]yshx;
pants: [n]裤子,短裤; [a]/pænts/; [or]yshx;
monarchy: [n]君主,最高统治者;君主政体;君主国; [a]/ˈmɑːnərki/; [or]yshx;
redeem: [vt]赎回;挽回;恢复;偿还;弥补;履行;兑换; [a]/rɪˈdiːm/; [or]yshx;
look one's best: [v]表现出最好的状态; [a]/lʊk wʌnz bɛst/; [or]yshx;
default: [n]违约;缺席;缺乏;默认; [vi]不履行义务;拖欠; [vt]不履行;不参加; [a]/dɪˈfɔːlt/; [or]yshx;
nourishment: [n]食物,营养品; [a]/ˈnɜːrɪʃmənt/; [or]yshx;
exchange: [v]交换,互换;交流;进行易货贸易; [n]交换;交易所;(货币的)兑换; [a]/ɪksˈtʃeɪndʒ/; [or]yshx;
trim: [n]修剪;整齐;装饰; [v]修剪;整理;装饰; [adj](人)苗条的;整洁的; [adv]整齐[整洁]地; [a]/trɪm/; [or]yshx;
sour: [adj]酸的;(人)尖酸刻薄的,不友好的; [v](友谊,局势,态度等)变坏;使恶化; [a]/ˈsaʊər/; [or]yshx;
heave: [v]用力举起;掷扔;发出叹息;恶心; [n]举起,升降; [a]/hiːv/; [or]yshx;
board: [n]木板;董事会;甲板;膳食; [v]乘船,登机;用板铺;供膳食;寄宿; [a]/bɔːrd/; [or]yshx;
antecedent: [adj]先行的,先驱的; [n]祖先,前情; [a]/ˌæntɪˈsiːdnt/; [or]yshx;
phobia: [n]恐惧症; [a]/ˈfoʊbiə/; [or]yshx;
spectator: [n]旁观者;观众;目击者; [a]/ˈspekteɪtər/; [or]yshx;
spur: [v]策马,用踢马刺驱马前进;激励,鞭策;推动; [n]踢马刺,靴刺;刺激,鞭策,鼓励;尖坡; [a]/spɜːr/; [or]yshx;
proficiency: [n]熟练;精通; [a]/prəˈfɪʃnsi/; [or]yshx;
soak: [v]浸泡,渗透,吸入; [n]浸泡; [a]/soʊk/; [or]yshx;
initiate: [v]开始,发动; [n]新加入组织的人; [a]/ɪˈnɪʃieɪt/; [or]yshx;
armour: [n]盔甲; [a]/ˈɑːrmər/; [or]yshx;
dynamic: [adj]有活力的,有生气的;不断变化的;动态的; [n]活力,动力; [a]/daɪˈnæmɪk/; [or]yshx;
quota: [n]配额;限额;定额; [a]/ˈkwoʊtə/; [or]yshx;
constant: [adj]不变的,始终如一的;持续不断的; [n]常数,恒量; [a]/ˈkɑːnstənt/; [or]yshx;
carve: [v]雕刻;(把肉等)切成片;开创,开拓; [a]/kɑːrv/; [or]yshx;
stretch: [v]伸展,延伸,张开,夸大,超越; [n]伸展,张开;一段时间;一段路程; [adj]可伸缩的;弹性的; [a]/stretʃ/; [or]yshx;
roam: [v]闲逛,漫步,徘徊;眼睛或手(缓慢地)扫遍; [n]漫步,漫游; [a]/roʊm/; [or]yshx;
embassy: [n]大使馆;大使馆全体人员; [a]/ˈembəsi/; [or]yshx;
embark: [v]上船或飞机;开始,着手,从事; [a]/ɪmˈbɑːrk/; [or]yshx;
ruffle: [vt]弄皱;使生气,扰乱;连续地轻敲;使起波浪; [n]皱纹;生气;混乱; [vi]起皱;愤怒; [a]/ˈrʌfl/; [or]yshx;
lottery: [n]彩票;碰运气的事,难算计的事;抽彩给奖法; [a]/ˈlɑːtəri/; [or]yshx;
logic: [n]逻辑,推理;逻辑性;逻辑学; [a]/ˈlɑːdʒɪk/; [or]yshx;
assert: [v]断言;肯定地说;坚持;维护; [a]/əˈsɜːrt/; [or]yshx;
grease: [n]油脂;动物脂;润滑脂; [v]抹油;使润滑; [a]/ɡriːs/; [or]yshx;
pathos: [n]悲怆,哀婉;痛苦; [a]/ˈpeɪθɑːs/; [or]yshx;
inundate: [v]淹没,泛滥; [a]/ˈɪnʌndeɪt/; [or]yshx;
keep away (from): [phr]远离,回避; [a]/kiːp əˈweɪ frʌm/; [or]yshx;
fraction: [n]部分,片断,碎片;分数; [a]/ˈfrækʃn/; [or]yshx;
go on about sth.: [v]喋喋不休; [a]/ɡoʊ ɔːn əˈbaʊt ˈsʌmθɪŋ/; [or]yshx;
circumstance: [n]条件;情况;命运;客观环境; [a]/ˈsɜːrkəmstæns/; [or]yshx;
confine: [v]限制;监禁; [n]范围,界限,约束,限制; [a]/kənˈfaɪn/; [or]yshx;
fade: [vi]褪色,褪去;失去;逐渐消失; [vt]使褪色; [n]淡入,淡出; [adj]乏味的; [a]/feɪd/; [or]yshx;
consent: [n]同意,准许;赞成; [v]同意; [a]/kənˈsent/; [or]yshx;
column: [n]柱,支柱,圆柱;专栏;长队; [a]/ˈkɑːləm/; [or]yshx;
systematic: [adj]有系统的,系统化的,有条理的;有计划有步骤的,有条不紊的; [a]/ˌsɪstəˈmætɪk/; [or]yshx;
isolate: [v]使隔离;使孤立; [adj]孤立的;单独的; [a]/ˈaɪsəleɪt/; [or]yshx;
sack: [n]一袋;麻袋;开除; [v]开除;劫掠;掠夺; [a]/sæk/; [or]yshx;
translucent: [adj]半透明的;透亮的,有光泽的;易懂的;真实的; [a]/trænsˈluːsnt/; [or]yshx;
policy: [n]保险单;政策,方针;原则,策略; [a]/ˈpɑːləsi/; [or]yshx;
go round: [v]足够分配;绕道走,到处走动; [a]/ɡoʊ raʊnd/; [or]yshx;
vulnerable: [adj]易受伤的;脆弱的;易受攻击的; [a]/ˈvʌlnərəbl/; [or]yshx;
timely: [adj]适时的,及时的; [adv]及时地; [a]/ˈtaɪmli/; [or]yshx;
convention: [n]会议;习俗;惯例; [a]/kənˈvenʃn/; [or]yshx;
preach: [v]传教,布道;说教;宣扬; [a]/priːtʃ/; [or]yshx;
get down to business: [phr]着手干正事; [a]/ɡet daʊn tu ˈbɪznəs/; [or]yshx;
jumble: [n]混杂;混乱;待义卖的一堆旧什物; [v]使混乱;搞乱; [a]/ˈdʒʌmbl/; [or]yshx;
renowned: [adj]著名的;有名的; [a]/rɪˈnaʊnd/; [or]yshx;
hygiene: [n]卫生;卫生学;保健学; [a]/ˈhaɪdʒiːn/; [or]yshx;
goad: [vt]驱赶;刺激;鼓励; [n](赶牛用的)刺棒; [a]/ɡoʊd/; [or]yshx;
vanish: [vi]消失;突然不见;消灭; [v]使消失;使不见; [n][语音学]消失音,弱化音; [a]/ˈvænɪʃ/; [or]yshx;
hold on: [phr]坚持;不挂断;稍等;紧紧抓住; [a]/həʊld ɒn/; [or]yshx;
sensitive: [adj]敏感的,过敏的;灵敏的;善解人意的,体恤的; [a]/ˈsensətɪv/; [or]yshx;
substantiate: [v]证实;使实体化; [a]/səbˈstænʃieɪt/; [or]yshx;
pigment: [n]天然色素,颜料; [a]/ˈpɪɡmənt/; [or]yshx;
exceed: [v]超过;胜过;超出; [a]/ɪkˈsiːd/; [or]yshx;
calendar: [n]日历;时间表;历法; [vt]把.记入日程表中;把.列入表中;为(文件等)作分类索引;将.排入日程表; [a]/ˈkælɪndər/; [or]yshx;
fist: [n]拳头;笔迹; [vt]用拳头打;握成拳;紧握; [a]/fɪst/; [or]yshx;
committee: [n]委员会;全体委员; [a]/kəˈmɪti/; [or]yshx;
itinerary: [n]旅程,路线;旅行计划; [a]/aɪˈtɪnəreri/; [or]yshx;
likelihood: [n]可能;可能性; [a]/ˈlaɪklihʊd/; [or]yshx;
story: [n]故事,小说;叙述,描述;新闻报道;谎言,假话;楼层; [a]/ˈstɔːri/; [or]yshx;
launch: [v]发射;出海;创办,开始从事; [n]发射,投放市场;(游艇,汽艇)下水;发行; [a]/lɔːntʃ/; [or]yshx;
dispose: [v]处理,处置,除去;使愿意; [a]/dɪˈspoʊz/; [or]yshx;
come over sb.: [v](被感觉等)支配,攥住,拜访; [a]/kʌm ˈoʊvər ˈsʌmbədi/; [or]yshx;
pour: [v]注,倒,灌;下(雨);不断地大量投入,倾注; [n]倾泻;倾盆大雨; [a]/pɔːr/; [or]yshx;
suppress: [v]镇压;禁止发表;抑制(感情等);阻止.的生长; [a]/səˈpres/; [or]yshx;
predecessor: [n]前辈;(被取代的)原有事物; [a]/ˈpredəsesər/; [or]yshx;
flask: [n]烧瓶;长颈瓶;扁瓶; [a]/flæsk/; [or]yshx;
prevalent: [adj]普遍的,流行的; [a]/ˈprevələnt/; [or]yshx;
bind: [v]捆绑;装订;约束;结合; [n]窘境,困境;讨厌的事情;捆绑;植物的藤蔓; [a]/baɪnd/; [or]yshx;
mall: [n]购物商场; [a]/mɔːl/; [or]yshx;
addict: [n]上瘾的人;入迷的人; [v]使沉迷,使上瘾; [a]/ˈædɪkt/; [or]yshx;
platform: [n]站台;平台;讲台;舞台;论坛; [a]/ˈplætfɔːrm/; [or]yshx;
spokesman: [n]发言人; [a]/ˈspoʊksmən/; [or]yshx;
strait: [n]海峡;窘迫; [a]/streɪt/; [or]yshx;
cement: [n]水泥,混凝土;胶合剂; [vt]巩固,加强;用水泥涂;接合; [vi]粘牢; [a]/sɪˈment/; [or]yshx;
lens: [n]镜头;透镜;镜片;晶状体; [a]/lenz/; [or]yshx;
shrink: [v]收缩;缩小;退缩; [n](非正式用法)心理医生,精神病医生; [a]/ʃrɪŋk/; [or]yshx;
disrupt: [v]扰乱; [a]/dɪsˈrʌpt/; [or]yshx;
balcony: [n]阳台,剧院楼厅; [a]/ˈbælkəni/; [or]yshx;
dome: [n]圆屋顶,穹顶; [a]/doʊm/; [or]yshx;
on time: [adv]准时; [a]/ɑːn taɪm/; [or]yshx;
painstaking: [adj](不辞)劳苦的,辛勤的; [n]辛劳,煞费苦心; [a]/ˈpeɪnzteɪkɪŋ/; [or]yshx;
recipient: [n]接受者;容器;间接宾语; [adj]接受的;善于接受的;接受能力强的; [a]/rɪˈsɪpiənt/; [or]yshx;
Fahrenheit: [n]华氏度; [adj]华氏度的,华氏温度计的; [a]/ˈfærənhaɪt/; [or]yshx;
reign: [v]占主导地位,统治,当政; [n](君主)统治时期; [a]/reɪn/; [or]yshx;
mitigate: [v]减轻,缓和; [a]/ˈmɪtɪɡeɪt/; [or]yshx;
triumph: [n]喜悦,狂喜;凯旋,胜利; [v]成功,获胜; [a]/ˈtraɪʌmf/; [or]yshx;
dramatic: [adj]戏剧的,戏剧性的;引人注目的;逼真的,刺激的; [a]/drəˈmætɪk/; [or]yshx;
throat: [n]咽喉,嗓子;口子; [a]/θroʊt/; [or]yshx;
bookcase: [n]书橱,书架; [a]/ˈbʊkkeɪs/; [or]yshx;
bitumen: [n]沥青; [a]/bəˈtuːmən/; [or]yshx;
aviation: [n]航空,航空学;飞机制造业; [a]/ˌeɪviˈeɪʃn/; [or]yshx;
cunning: [n]狡猾,精巧; [adj]狡猾的,精巧的; [a]/ˈkʌnɪŋ/; [or]yshx;
hand sth. down to sb.: [v](作为传统)传下,传给; [a]/hænd ˈsʌmθɪŋ daʊn tu ˈsʌmbədi/; [or]yshx;
contemplate: [v]沉思;对..周密考虑;注视; [a]/ˈkɑːntəmpleɪt/; [or]yshx;
upbringing: [n]抚育,抚养,教养; [a]/ˈʌpbrɪŋɪŋ/; [or]yshx;
ferry: [n]渡船,渡轮;渡口; [v]运送;渡运(人,车或物等); [a]/ˈferi/; [or]yshx;
harmony: [n]和谐;和声;和睦;协调; [a]/ˈhɑːrməni/; [or]yshx;
arise: [v]起床;出现;升起;由.引起,发生; [a]/əˈraɪz/; [or]yshx;
check in: [phr]报到,记录;登记入住; [a]/tʃek ɪn/; [or]yshx;
title: [n]标题;头衔;权利; [vt]加标题于;授予.称号; [adj]标题的,题目的;称呼的; [a]/ˈtaɪtl/; [or]yshx;
gross: [adj]总的,毛重的;恶心的;粗鲁的; [n]总量,总额; [adv]总共地; [vt]总共赚得; [a]/ɡroʊs/; [or]yshx;
convict: [n]犯人; [v](经审讯)证明..有罪,使..知罪; [a]/ˈkɑːnvɪkt/; [or]yshx;
petty: [adj]价值不大的;小的;器量小的;琐碎的; [a]/ˈpeti/; [or]yshx;
temptation: [n]引诱,诱惑; [a]/tempˈteɪʃn/; [or]yshx;
evoke: [v]唤起;引起;使人想起; [a]/ɪˈvoʊk/; [or]yshx;
stand by sth.: [phr]信守;支持; [a]/stænd baɪ ˈsʌmθɪŋ/; [or]yshx;
annuity: [n]年金,养老金;年金保险;年金享受权; [a]/əˈnuːəti/; [or]yshx;
protein: [n]蛋白质; [adj]蛋白质的; [a]/ˈproʊtiːn/; [or]yshx;
prospectus: [n]章程,内容简介;样张;创办计划书; [a]/prəˈspektəs/; [or]yshx;
to one's face: [phr]坦白地;当面; [a]/tu wʌnz feɪs/; [or]yshx;
sociology: [n]社会学; [a]/ˌsoʊsiˈɑːlədʒi/; [or]yshx;
betray: [v]背叛;失信于;泄露(秘密等);(非故意地)暴露; [a]/bɪˈtreɪ/; [or]yshx;
tide: [n]潮,潮汐;潮流; [vi]随潮漂浮; [a]/taɪd/; [or]yshx;
blast: [n]一阵(疾风等);爆炸;冲击波; [v](用炸药)炸,摧毁; [a]/blæst/; [or]yshx;
culminate: [v]使达高潮,使结束; [a]/ˈkʌlmɪneɪt/; [or]yshx;
port: [n]舷窗;舱门;港口城市;葡萄酒;港,港口; [a]/pɔːrt/; [or]yshx;
pin: [v]别住,钉住,固定住; [n]别针,饰针; [a]/pɪn/; [or]yshx;
faith: [n]信任;信心;信仰; int. 实在,确实; [a]/feɪθ/; [or]yshx;
in one: [phr]成为一体;只试一次; [a]/ɪn wʌn/; [or]yshx;
pilot: [n]领航员;飞行员; [adj]试验性的; [v]给..领航,驾驶;试验; [a]/ˈpaɪlət/; [or]yshx;
omit: [v]删去,省去,忽略;遗漏; [a]/əˈmɪt/; [or]yshx;
opinion: [n]意见,看法,主张; [a]/əˈpɪnjən/; [or]yshx;
pessimism: [n]悲观,悲观主义; [a]/ˈpesɪmɪzəm/; [or]yshx;
overdue: [adj]过期的;迟到的;未兑的; [a]/ˌoʊvərˈduː/; [or]yshx;
inhabit: [v]居住于; [a]/ɪnˈhæbɪt/; [or]yshx;
parasite: [n]寄生虫;靠他人为生的人; [a]/ˈpærəsaɪt/; [or]yshx;
horizon: [n]地平线;眼界,见识; [a]/həˈraɪzn/; [or]yshx;
parachute: [n]降落伞; [v]跳伞; [a]/ˈpærəʃuːt/; [or]yshx;
competition: [n]比赛;竞争;竞争者; [a]/ˌkɑːmpəˈtɪʃn/; [or]yshx;
metaphor: [n]暗喻,隐喻; [a]/ˈmetəfər/; [or]yshx;
contend: [v]争辩;坚决主张;搏斗; [a]/kənˈtend/; [or]yshx;
bacterium: [n]细菌; [a]/bæk'tɪriəm/; [or]yshx;
possession: [n]财产,所有物,拥有;控球; [a]/pəˈzeʃn/; [or]yshx;
erratic: [adj]古怪的;反复无常的,不稳定的; [a]/ɪˈrætɪk/; [or]yshx;
resort: [vi]采取;求助; [n]求助;凭借;诉诸,采取;度假胜地; [a]/rɪˈzɔːrt/; [or]yshx;
prompt: [v]提示;激起;促进,推动;敦促; [adj]迅速的,及时的; [n]提示; [a]/prɑːmpt/; [or]yshx;
undertake: [v]保证;承担,承包; [a]/ˌʌndərˈteɪk/; [or]yshx;
squeeze: [v](常指用手)挤压;挤进,塞进;用力挤压榨取;减少,压缩; [n]榨;压榨;挤,塞; [a]/skwiːz/; [or]yshx;
hound: [n]猎犬; [v]追逼;烦扰;纠缠; [a]/haʊnd/; [or]yshx;
frantic: [adj]疯狂的;狂乱的;慌乱的; [a]/ˈfræntɪk/; [or]yshx;
delinquency: [n]失职,玩忽职守,拖欠债务,缺点,过错;[法律]少年犯罪,不法行为(青少年),行为不当; [a]/dɪˈlɪŋkwənsi/; [or]yshx;
bulb: [n]电灯泡;球状物;球茎; [a]/bʌlb/; [or]yshx;
ongoing: [n]进行,前进,发展; [adj]进行中的,不间断的; [a]/ˈɑːnɡoʊɪŋ/; [or]yshx;
persecute: [v](尤指因宗教或政治信仰不同)迫害;烦扰,纠缠; [a]/ˈpɜːrsɪkjuːt/; [or]yshx;
cape: [n]斗篷;披肩;岬,海岬,海角; [a]/keɪp/; [or]yshx;
frustrate: [v]使灰心;挫败;阻挠; [a]/ˈfrʌstreɪt/; [or]yshx;
maritime: [adj]海事的,海上的,沿海的,近海的;海员的,水手的; [a]/ˈmærɪtaɪm/; [or]yshx;
doom: [v]注定;命定; [n]毁灭;厄运;劫数; [a]/duːm/; [or]yshx;
dial: [v]拨(电话号码);打电话; [n]钟面;仪表盘;拨号盘; [a]/ˈdaɪəl/; [or]yshx;
artery: [n]动脉;干线; [a]/ˈɑːrtəri/; [or]yshx;
flutter: [n]激动不安,紧张; [v]飘动,飘扬;(鸟等)振翼,拍翅而飞; [vi](心脏等)快速跳动; [a]/ˈflʌtər/; [or]yshx;
hum: [v]发出嗡嗡声,哼(歌曲); [n]轰鸣声,嗡嗡营营声; [a]/hʌm/; [or]yshx;
hang on: [phr]坚持下去;不挂断;稍等;握住不放; [a]/hæŋ ɔn/; [or]yshx;
single out: [v]挑选,选出; [a]/ˈsɪŋɡ(ə)l aʊt/; [or]yshx;
bother: [v]麻烦,打扰;花时间; [n]烦扰,麻烦,打扰; [a]/ˈbɑːðər/; [or]yshx;
raid: [n]突袭;袭击; [v]袭击;劫掠;攫取;突然搜捕; [a]/reɪd/; [or]yshx;
obstinate: [adj]顽固的;较难治愈的; [a]/ˈɑːbstɪnət/; [or]yshx;
orderly: [adj]有秩序的,整齐的,有条不紊的; [a]/ˈɔːrdərli/; [or]yshx;
crisp: [adj]脆的,易碎的,霜冻的,干脆的; [n]油炸马铃薯片; [v](使)发脆; [a]/krɪsp/; [or]yshx;
quarry: [n]采石场;猎物;来源; [v]挖出;努力挖掘; [a]/ˈkwɔːri/; [or]yshx;
coverage: [n]新闻报道;可达范围;覆盖范围; [a]/ˈkʌvərɪdʒ/; [or]yshx;
conceive: [v]怀孕;设想,想出; [a]/kənˈsiːv/; [or]yshx;
leak: [v]漏;泄露; [n]漏洞;泄漏,裂缝; [a]/liːk/; [or]yshx;
grim: [adj]严酷的,无情的;令人沮丧的,令人失望的;讨厌的,糟糕的; [a]/ɡrɪm/; [or]yshx;
magnanimous: [adj]宽宏大量的,大度的;慷慨的; [a]/mæɡˈnænɪməs/; [or]yshx;
immigrant: [n]移民; [adj]移民的;迁入的; [a]/ˈɪmɪɡrənt/; [or]yshx;
prospect: [n]前景,展望;视野;景象; [v]勘察;有前途;勘探;对..进行仔细调查; [a]/ˈprɑːspekt/; [or]yshx;
affirm: [v]肯定;断定;坚持声称; [a]/əˈfɜːrm/; [or]yshx;
undue: [adj]过分的,不适当的;过度的;尚未到期的; [a]/ˌʌnˈduː/; [or]yshx;
casualty: [n]伤亡人员,死伤者,受害人;急诊室(英); [a]/ˈkæʒuəlti/; [or]yshx;
mar: [v]毁坏,弄糟,玷污; [a]/mɑːr/; [or]yshx;
canvas: [n]帆布,(帆布)油画; [a]/ˈkænvəs/; [or]yshx;
crooked: [adj]弯曲的;歪的;不正当的;不正直的; [a]/ˈkrʊkɪd/; [or]yshx;
take sth. over: [v]接管; [a]/teɪk ˈsʌmθɪŋ ˈoʊvər/; [or]yshx;
detest: [vt]厌恶,憎恨,痛恨; [a]/dɪˈtest/; [or]yshx;
alarm: [n]警报器,警报;闹钟;惊恐,忧虑; [v]使惊恐,使忧虑; [a]/əˈlɑːrm/; [or]yshx;
bungalow: [n]平房,小屋; [a]/ˈbʌŋɡəloʊ/; [or]yshx;
motto: [n]座右铭;格言;箴言;口号; [a]/ˈmɑːtoʊ/; [or]yshx;
resource: [n]资源,财力,办法; [v]向.提供资金(或设备); [a]/ˈriːsɔːrs/; [or]yshx;
take sb. out: [phr]带.出去;淘汰出局; [a]/teɪk ˈsʌmbədi aʊt/; [or]yshx;
gesture: [n]手势,表情;姿态; [v]做手势,用动作示意; [vt]用手势表达; [a]/ˈdʒestʃər/; [or]yshx;
bend: [v](使)弯曲,(使)改变(主意),使屈服; [n]弯曲,弯曲处,倾向,屈服;(复数形式)减压症; [a]/bend/; [or]yshx;
on the air: [phr]直播中; [a]/ɔn ðə er/; [or]yshx;
transmission: [n]发射,转播,传播,变速器; [a]/trænsˈmɪʃn/; [or]yshx;
bring back: [phr]拿回来;使.回忆起来; [a]/briŋbæk/; [or]yshx;
sacred: [adj]神圣的,宗教(性)的;神圣不可侵犯的; [a]/ˈseɪkrɪd/; [or]yshx;
trifle: [n]蛋糕;琐事,小事,无价值的东西; [v]嘲笑,轻视; [a]/ˈtraɪfl/; [or]yshx;
molecule: [n]分子,微粒; [a]/ˈmɑːlɪkjuːl/; [or]yshx;
threshold: [n]门槛;开端; [a]/ˈθreʃhoʊld/; [or]yshx;
climax: [n]高潮,最令人兴奋(或感兴趣)的部分; [v](使)达到顶点,(使)达到高潮; [a]/ˈklaɪmæks/; [or]yshx;
complex: [adj]复杂的,难解的;复合的; [n]情结;建筑群;综合体,集合体; [a]/ˈkɑːmpleks/; [or]yshx;
unify: [v]使联合,统一;使相同,使一致; [a]/ˈjuːnɪfaɪ/; [or]yshx;
radiate: [v]辐射,发出(光或热);流露,显示;(使)从中心发散; [a]/ˈreɪdieɪt/; [or]yshx;
fellowship: [n]友谊;伙伴关系;交情;团体;奖学金; [a]/ˈfeloʊʃɪp/; [or]yshx;
hard and fast: [phr](规则等)严格的,不容改变的; [a]/hɑrd ənd fæst/; [or]yshx;
harsh: [adj]严厉的;刺耳的;条件艰苦的; [a]/hɑːrʃ/; [or]yshx;
humble: [adj]卑微的;(级别或地位)低下的,简陋的;谦逊的; [v]使⋯谦逊,使⋯卑下;轻松打败(尤指强大的对手); [a]/ˈhʌmbl/; [or]yshx;
evacuate: [v]撤离,疏散,排清; [a]/ɪˈvækjueɪt/; [or]yshx;
versed: [adj]熟练的,精通的; [a]/vɜːrst/; [or]yshx;
uncalled-for: [adj]没有必要的,不合适的; [a]/ʌn'kɔːldˌfɔː/; [or]yshx;
orientate oneself: [v]确认方位,地址; [a]/ˈɔriənˌteɪt wʌnˈself/; [or]yshx;
paddle: [n]桨; [v]用脚(手)划水,荡桨; [a]/ˈpædl/; [or]yshx;
kin: [n]亲属; [a]/kɪn/; [or]yshx;
antibiotic: [n]抗生素; [adj]抗菌的; [a]/ˌæntibaɪˈɑːtɪk/; [or]yshx;
alter: [v]改变;改动,使变样;改做; [a]/ˈɔːltər/; [or]yshx;
barometer: [n]晴雨表;气压表; [a]/bəˈrɑːmɪtər/; [or]yshx;
contradict: [v]与..发生矛盾,与..抵触,与..对立; [a]/ˌkɑːntrəˈdɪkt/; [or]yshx;
sheet: [n]被单;纸张;薄板; [a]/ʃiːt/; [or]yshx;
thesis: [n](学位)论文,论题,论点; [a]/ˈθiːsɪs/; [or]yshx;
bang: [n]巨响;重击;刘海; [adv]准确地,完全地; [v]发出砰的一声;重击;猛敲;砰地关上; [a]/bæŋ/; [or]yshx;
odor: [n]气味; [a]/ˈoʊdər/; [or]yshx;
outweigh: [v]比..重要;比..有价值;比.重; [a]/ˌaʊtˈweɪ/; [or]yshx;
hawk: [n]鹰;鹰派成员(以强硬态度或手段维护国家民族利益的个人,团体或势力); [v]叫卖,兜售;散播; [a]/hɔːk/; [or]yshx;
abound: [v]充满,很多,富于; [a]/əˈbaʊnd/; [or]yshx;
dawn: [n]黎明;开始; [v]破晓; [a]/dɔːn/; [or]yshx;
entrepreneur: [n]企业家,演出承包人; [a]/ˌɑːntrəprəˈnɜːr/; [or]yshx;
architect: [n]设计师;建筑师; [a]/ˈɑːrkɪtekt/; [or]yshx;
unconditional: [adj]绝对的,无条件的; [a]/ˌʌnkənˈdɪʃənl/; [or]yshx;
towel: [n]毛巾,手巾; [v]用毛巾擦; [a]/ˈtaʊəl/; [or]yshx;
trend: [n]趋势;倾向;时尚; [v]倾向;走向;转向;使趋向; [a]/trend/; [or]yshx;
splendid: [adj]壮观的,辉煌的,华丽的;极好的,出色的; [a]/ˈsplendɪd/; [or]yshx;
get over: [phr]克服;恢复;熬过;原谅; [a]/ɡet ˈoʊvər/; [or]yshx;
indignant: [adj]愤慨的,愤愤不平的; [a]/ɪnˈdɪɡnənt/; [or]yshx;
swarm: [n]蜂群;一群,一批人; [v]蜂拥;密集; [vt]蜂拥;挤满; [a]/swɔːrm/; [or]yshx;
find fault with: [phr]埋怨,挑剔; [a]/faɪnd fɔlt wɪθ/; [or]yshx;
tacit: [adj]心照不宣的,静默的; [a]/ˈtæsɪt/; [or]yshx;
concentrate: [v]全神贯注于,集中于;浓缩; [n]浓缩物; [a]/ˈkɑːnsntreɪt/; [or]yshx;
fall back on: [phr]求助于; [a]/fɔl bæk ɔn/; [or]yshx;
porous: [adj]可渗透的,多孔的,可穿越的; [a]/ˈpɔːrəs/; [or]yshx;
neutralize: [v]宣布中立,使中立化;使无效;中和; [a]/ˈnuːtrəlaɪz/; [or]yshx;
initial: [adj]第一的;最初的;开始的; [n]首字母; [a]/ɪˈnɪʃl/; [or]yshx;
shovel: [n]铁锨,铲; [v]铲起; [a]/ˈʃʌvl/; [or]yshx;
conspicuous: [adj]显眼的;显著的;显而易见的; [a]/kənˈspɪkjuəs/; [or]yshx;
expedient: [n]权宜之计,手段; [adj]有利的,方便的;权宜之计的; [a]/ɪkˈspiːdiənt/; [or]yshx;
come on: [phr]来吧;发展;开始; [a]/kʌm ɔn/; [or]yshx;
inventory: [n]详细目录;存货清单; [a]/ˈɪnvəntɔːri/; [or]yshx;
archaic: [adj]古代的;陈旧的,过时的,老式的;已不通用的; [a]/ɑːrˈkeɪɪk/; [or]yshx;
devastate: [v]摧毁;使垮掉,使不知所措,使陷于混乱; [a]/ˈdevəsteɪt/; [or]yshx;
applicant: [n]申请人;请求者; [a]/ˈæplɪkənt/; [or]yshx;
thigh: [n]大腿; [a]/θaɪ/; [or]yshx;
norm: [n]准则;模范;规范,标准; [a]/nɔːrm/; [or]yshx;
make the most of: [v]充分利用; [a]/meɪk ðə moʊst ɑv/; [or]yshx;
hold one's ground: [phr]坚持立场; [a]/hold wʌnz ɡraʊnd/; [or]yshx;
proclaim: [v]声明,声称;宣告;表明; [a]/prəˈkleɪm/; [or]yshx;
physiological: [adj]生理的,生理学的; [a]/ˌfɪziəˈlɑːdʒɪkl/; [or]yshx;
wreck: [n]沉船,失事船;失事;(事故中)遭严重损坏的汽车(飞机等); [v]破坏,使毁灭; [a]/rek/; [or]yshx;
fluid: [n]流体,液体; [adj]流动的;易变的;流畅的; [a]/ˈfluːɪd/; [or]yshx;
rescue: [v]营救,援救; [n]营救,救援; [a]/ˈreskjuː/; [or]yshx;
cocaine: [n]可卡因,古柯碱; [a]/koʊˈkeɪn/; [or]yshx;
cut across: [v]抄近路通过; quant. 与...相抵触;与...相反; [a]/kʌt əˈkrɔs/; [or]yshx;
vain: [adj]爱虚荣的;徒劳的;没有真正意义的,没有真正价值的,无关紧要的;自负的,自高自大的;无益的; [a]/veɪn/; [or]yshx;
at its best: [phr]处在最好状态; [a]/ət ɪts best/; [or]yshx;
odyssey: [n]长途冒险旅行;一连串的冒险;奥德赛; [a]/ˈɑːdəsi/; [or]yshx;
beneficial: [adj]有益的,有利的; [a]/ˌbenɪˈfɪʃl/; [or]yshx;
impair: [v]损害;削弱; [a]/ɪmˈper/; [or]yshx;
attack: [n](病)发作,攻击; [v]攻击,进攻,抨击;毁坏; [a]/əˈtæk/; [or]yshx;
nowhere: [adv]任何地方都不;没有任何地方,无处;找不到;在不重要的地方;突然(发生); [n]无名之地;任何地方; [a]/ˈnoʊwer/; [or]yshx;
saturate: [v]使充满,使饱和,使湿透; [a]/ˈsætʃəreɪt/; [or]yshx;
get nowhere: [phr](使)无进展;行不通; [a]/ɡet ˈnoʊˌhwer/; [or]yshx;
amateur: [n]业余爱好者;外行; [adj]外行的;业余爱好的,业余(身份)的; [a]/ˈæmətʃər/; [or]yshx;
thermometer: [n]温度计; [a]/θərˈmɑːmɪtər/; [or]yshx;
trail: [n]小径,路径;记号,痕迹,线索; [v]拽;跟;落后于;追赶;(烟等)袅袅升起; [a]/treɪl/; [or]yshx;
prestige: [n]威望,声望; [a]/preˈstiːʒ/; [or]yshx;
parliament: [n]议会;国会; [a]/ˈpɑːrləmənt/; [or]yshx;
indigenous: [adj]土生土长的,本土的; [a]/ɪnˈdɪdʒənəs/; [or]yshx;
democracy: [n]民主制度;民主国家;民主主义;民众; [a]/dɪˈmɑːkrəsi/; [or]yshx;
delectable: [adj]令人愉快的;美味的; [a]/dɪˈlektəbl/; [or]yshx;
readily: [adv]容易地;乐意地;欣然地; [a]/ˈredɪli/; [or]yshx;
rural: [adj]乡村的,农村的,田园的; [a]/ˈrʊrəl/; [or]yshx;
extreme: [adj]极端的;极远的;极限的;极度的;偏激的; [n]极端;极度(状态),最大程度; [a]/ɪkˈstriːm/; [or]yshx;
herd: [n]兽群,牧群; [v]放牧,群集; [a]/hɜːrd/; [or]yshx;
extract: [v]取出;提取;摘录;设法得到;索取; [n]摘录;提出物; [a]/ɪkˈstrækt/; [or]yshx;
trauma: [n]精神创伤,外伤; [a]/ˈtraʊmə/; [or]yshx;
latent: [adj]潜在的,隐伏的,不易察觉的; [a]/ˈleɪtnt/; [or]yshx;
set in: [phr]开始;到来;生效;流行;设置(戏剧,小说等的)背景;上涨;插入; [a]/set ɪn/; [or]yshx;
phonetic: [adj]语音的; [a]/fəˈnetɪk/; [or]yshx;
proceed: [v]前进(尤指停止后继续进行);继续进行,继续做; [n]收入,获利; [a]/proʊˈsiːd/; [or]yshx;
extinguish: [v]熄灭,扑灭;根除,消灭; [a]/ɪkˈstɪŋɡwɪʃ/; [or]yshx;
limp: [n]跛行; [vi]一瘸一拐地走,跛行;慢腾腾地进行; [adj]无力的,无生气的;柔软的,软弱的; [a]/lɪmp/; [or]yshx;
gratitude: [n]感激,感谢; [a]/ˈɡrætɪtuːd/; [or]yshx;
petal: [n]花瓣; [a]/ˈpetl/; [or]yshx;
relief: [n]安慰;解脱;减轻;浮雕;凸显,起伏;救济金;救济物资;换班人;接替人; [a]/rɪˈliːf/; [or]yshx;
purity: [n]纯洁;纯净;纯正;纯粹; [a]/ˈpjʊrəti/; [or]yshx;
sanitary: [adj]卫生的;清洁的; [a]/ˈsænəteri/; [or]yshx;
organ: [n]器官;风琴; [a]/ˈɔːrɡən/; [or]yshx;
tamper: [v]篡改;玩弄;贿赂; [n]填塞者;捣棒; [a]/ˈtæmpər/; [or]yshx;
swerve: [v]转弯,突然改变方向; [n]转向;滑出;逸出;背离; [a]/swɜːrv/; [or]yshx;
plantation: [n]农场;种植园;栽植; [a]/plænˈteɪʃn/; [or]yshx;
convenience: [n]方便;便利设施; [a]/kənˈviːniəns/; [or]yshx;
discriminate: [v]区别,辨别;歧视; [a]/dɪˈskrɪmɪneɪt/; [or]yshx;
technician: [n]技术员,技师;技术专家; [a]/tekˈnɪʃn/; [or]yshx;
entangle: [v]使纠缠,卷入; [a]/ɪnˈtæŋɡl/; [or]yshx;
on no account: [adv]决不; [a]/ɔn noʊ əˈkaʊnt/; [or]yshx;
jagged: [adj]锯齿状的,参差不齐的;锯齿状的; [a]/ˈdʒæɡɪd/; [or]yshx;
farewell: [adj]告别的; [n]再见;告别,离别; [a]/ˌferˈwel/; [or]yshx;
semblance: [n]相似;外表,外貌; [a]/ˈsembləns/; [or]yshx;
notify: [v]通知,告知;报告; [a]/ˈnoʊtɪfaɪ/; [or]yshx;
magistrate: [n]法官; [a]/ˈmædʒɪstreɪt/; [or]yshx;
transform: [v]将..变形,改变,转换; [a]/trænsˈfɔːrm/; [or]yshx;
mesh: [n]网,筛孔; [v]相啮合; [a]/meʃ/; [or]yshx;
hatch: [n]船舱盖; [v]孵出,孵;策划; [a]/hætʃ/; [or]yshx;
determination: [n]决定;确定;决心; [a]/dɪˌtɜːrmɪˈneɪʃn/; [or]yshx;
swamp: [n]沼泽; [v]淹没,浸没;使困惑,压倒; [a]/swɑːmp/; [or]yshx;
bribe: [v]向.行贿;买通; [n]贿赂;行贿物; [a]/braɪb/; [or]yshx;
blunt: [adj]钝的;直率的; [v]使情感,感觉,需求减弱;变钝; [a]/blʌnt/; [or]yshx;
as for: [phr]至于,就.方面说; [a]/əz fɔr/; [or]yshx;
beverage: [n](水,酒等之外的)饮料; [a]/ˈbevərɪdʒ/; [or]yshx;
exasperate: [vt]激怒;加剧; [a]/ɪɡˈzæspəreɪt/; [or]yshx;
wary: [adj]谨慎的,小心的,提防的;考虑周到的; [a]/ˈweri/; [or]yshx;
peculiar: [adj]奇怪的,古怪的;特有的,特别的; [a]/pɪˈkjuːliər/; [or]yshx;
denial: [n]拒绝;否认;拒绝给予; [a]/dɪˈnaɪəl/; [or]yshx;
smooth: [adj]光滑的;平稳的; [v]使光滑;使平稳; [a]/smuːð/; [or]yshx;
make (sth. )out: [v]写;辨认出;理解;歪曲; [a]/meɪk ˈsʌmθɪŋ aʊt/; [or]yshx;
feedback: [n]反馈,反馈意见; [a]/ˈfiːdbæk/; [or]yshx;
rip: [n]裂缝,裂口; [v]撕开,扯破,裂开,敲诈; [a]/rɪp/; [or]yshx;
wretched: [adj]可怜的;恶劣的;身心疲惫的; [a]/ˈretʃɪd/; [or]yshx;
take sth. off: [phr]除去;取消;脱掉; [a]/teɪk ˈsʌmθɪŋ ɑːf/; [or]yshx;
shanty: [n]简陋的小木屋;(水手唱的)劳动号子; [a]/ˈʃænti/; [or]yshx;
contempt: [n]轻视,鄙视; [a]/kənˈtempt/; [or]yshx;
curve: [v]使弯曲; [n]曲线,弯曲; [adj]弯曲的;曲线形的; [a]/kɜːrv/; [or]yshx;
pace: [n]速度;步,步伐; [v]踱步; [a]/peɪs/; [or]yshx;
routine: [n]常规,例行公事,一套固定舞步(或动作); [adj]例行的,普通的,惯例的; [a]/ruːˈtiːn/; [or]yshx;
take stock of: [v]估量;观察; [a]/teɪk stɒk ɑv/; [or]yshx;
cafe: [n]咖啡馆,餐馆; [a]/kæˈfeɪ/; [or]yshx;
elated: [adj]得意洋洋的;振奋的; [a]/iˈleɪtɪd/; [or]yshx;
segregate: [v]分开,隔离,进行种族隔离; [a]/ˈseɡrɪɡeɪt/; [or]yshx;
dingy: [adj]昏暗的,肮脏的;褴褛的; [n]同"dingey"; [a]/ˈdɪndʒi/; [or]yshx;
distill: [v]抽出..的精华;蒸馏; [a]/dɪˈstɪl/; [or]yshx;
quaint: [adj]精巧的;古雅的; [a]/kweɪnt/; [or]yshx;
bless: [v]保佑,祝福,赐福,有幸具有; [a]/bles/; [or]yshx;
conscious: [adj]神志清醒的;自觉的;意识到的;有意的; [n]意识; [a]/ˈkɑːnʃəs/; [or]yshx;
offend: [v]冒犯,得罪,伤害.的感情; [a]/əˈfend/; [or]yshx;
lax: [adj]松懈的;松弛的;[语]松弛元音的; [n]松元音;泻肚; [a]/læks/; [or]yshx;
haven: [n]港湾;避难所; [vt]为.提供庇护所; [a]/ˈheɪvn/; [or]yshx;
give (sth.) off: [v]发出(烟,气); [a]/ɡɪv ˈsʌmθɪŋ ɑːf/; [or]yshx;
make up with sb.: [v]与.和解; [a]/meɪk ʌp wɪθ ˈsʌmbədi/; [or]yshx;
make up for: [v]补偿,弥补; [a]/meɪk ʌp fɔr/; [or]yshx;
perspire: [v]出汗,流汗; [a]/pərˈspaɪər/; [or]yshx;
antagonism: [n]对抗,敌对;敌意; [a]/ænˈtæɡənɪzəm/; [or]yshx;
associate: [v]联想;联合;联系,交往; [n]伙伴;同事; [adj]副的; [a]/əˈsoʊʃieɪt/; [or]yshx;
bandage: [n]绷带; [v]用绷带绑扎; [a]/ˈbændɪdʒ/; [or]yshx;
grid: [n]格子,地图坐标; [a]/ɡrɪd/; [or]yshx;
skip: [v]跳过;略过;遗漏; [n]跳跃;跳读;省略; [a]/skɪp/; [or]yshx;
rise to the occasion: [v]应付自如; [a]/raɪz tu ði əˈkeʒən/; [or]yshx;
console: [v]安慰,慰问; [n]控制台,仪表板;落地柜; [a]/kənˈsoʊl/; [or]yshx;
stand by sb.: [v]支持某人; [a]/stænd baɪ ˈsʌmbədi/; [or]yshx;
doubtful: [adj]怀疑的,疑惑的; [a]/ˈdaʊtfl/; [or]yshx;
imminent: [adj]迫近的,紧迫的,即将来临的; [a]/ˈɪmɪnənt/; [or]yshx;
provided: [conj]假如,如果,以..为条件; [adj]预备好的,提供的; [a]/prəˈvaɪdɪd/; [or]yshx;
jungle: [n]丛林,密林;危险地带;丛林音乐; [a]/ˈdʒʌŋɡl/; [or]yshx;
junction: [n]连接,接合;接合处;路口; [a]/ˈdʒʌŋkʃn/; [or]yshx;
potent: [adj]强有力的;有权势的;有说服力的; [a]/ˈpoʊtnt/; [or]yshx;
elderly: [adj]年老的,年长的;上年纪的人; [a]/ˈeldərli/; [or]yshx;
spin: [v](使)旋转;纺织;疾驰;眩晕; [n]旋转;纺织;眩晕; [a]/spɪn/; [or]yshx;
puncture: [v]刺破(车胎等),扎,穿孔; [n]刺孔,刺; [a]/ˈpʌŋktʃər/; [or]yshx;
peril: [n]危险; [vt]置.于危险中;危及; [a]/ˈperəl/; [or]yshx;
illuminate: [vt]照亮;阐释;说明; [a]/ɪˈluːmɪneɪt/; [or]yshx;
realm: [n]王国;领域;国土; [a]/relm/; [or]yshx;
constituent: [adj]组成的;有选举权的; [n]选民;成分; [a]/kənˈstɪtʃuənt/; [or]yshx;
assign: [v]布置;分配;指定;指派;归因;确定; [a]/əˈsaɪn/; [or]yshx;
request: [n]请求;要求; [v]请求;要求; [a]/rɪˈkwest/; [or]yshx;
variable: [adj]易变的,可变的; [n]变量,可变物; [a]/ˈveriəbl/; [or]yshx;
divert: [v]使转向,使改道(或绕道);转移,转移.的注意力;使娱乐,使消遣; [a]/daɪˈvɜːrt/; [or]yshx;
slim: [adj]细长的;苗条的; [v](用运动,节食等)减轻体重,变苗条; [a]/slɪm/; [or]yshx;
council: [n]议会;理事会;委员会; [a]/ˈkaʊnsl/; [or]yshx;
bookkeeper: [n]簿记员;会计员; [a]/ˈbʊkkiːpər/; [or]yshx;
ponderous: [adj]笨重的,笨拙的,沉闷的; [a]/ˈpɑːndərəs/; [or]yshx;
look round: [phr]四处看;寻找; [a]/lʊk raʊnd/; [or]yshx;
crash: [n]碰撞,坠落,轰隆声; [v]碰撞,坠落,崩溃; [adj]紧急的; [a]/kræʃ/; [or]yshx;
ecology: [n]生态,生态学; [a]/iˈkɑːlədʒi/; [or]yshx;
conjunction: [n]连接;联合,结合;连接词; [a]/kənˈdʒʌŋkʃn/; [or]yshx;
explode: [v]爆炸;激增;爆发;使爆炸;驳倒; [a]/ɪkˈsploʊd/; [or]yshx;
toddle: [v](如小孩)蹒跚学步; [n]东倒西歪的走路;刚学走步的小孩; [a]/ˈtɑːdl/; [or]yshx;
agency: [n]代理(处);政府机构;代理;介入;作用; [a]/ˈeɪdʒənsi/; [or]yshx;
junior: [adj]年少的;下级的;低年级的; [n]年少者,晚辈;(美国四年制大学)三年级学生;职位较低者; [a]/ˈdʒuːniər/; [or]yshx;
cane: [n]手杖;茎;藤条;甘蔗; [a]/keɪn/; [or]yshx;
shift: [n]转移;替换;轮值; [v]移动;售卖(难卖的物品);换挡;改换,替换; [a]/ʃɪft/; [or]yshx;
famine: [n]饥荒;严重的缺乏; [a]/ˈfæmɪn/; [or]yshx;
persist: [v]坚持,固执;继续存留; [a]/pərˈsɪst/; [or]yshx;
tract: [n]器官系统;一大片地;短文,小册子; [a]/trækt/; [or]yshx;
corrupt: [v]变腐败,堕落;贿赂,使腐败; [adj]腐败的;堕落的; [a]/kəˈrʌpt/; [or]yshx;
say to oneself: [phr]心中暗想;自言自语; [a]/seɪ tu wʌnˈself/; [or]yshx;
come to nothing: [phr]失败,落空; [a]/kʌm tu ˈnʌθɪŋ/; [or]yshx;
consumption: [n]消耗,消费,耗尽;肺痨; [a]/kənˈsʌmpʃn/; [or]yshx;
hysterical: [adj]歇斯底里的,情绪激动的; [a]/hɪˈsterɪkl/; [or]yshx;
turmoil: [n]骚动,骚乱; [a]/ˈtɜːrmɔɪl/; [or]yshx;
swallow: [n]吞咽;燕子;一次吞咽的量; [vi]做吞咽动作,咽口水; [v]咽下,吞下; [vt]相信; [a]/ˈswɑːloʊ/; [or]yshx;
naive: [adj]天真的; [n]天真的人; [a]/naɪˈiːv/; [or]yshx;
collide: [vi]碰撞;互撞;抵触; [a]/kəˈlaɪd/; [or]yshx;
stroke: [n]击打;一击,一次,一举;中风;抚摸;笔画; [v]拭去;轻抚; [a]/stroʊk/; [or]yshx;
differentiate: [v]使有差异;区别; [a]/ˌdɪfəˈrenʃieɪt/; [or]yshx;
mackintosh: [n]雨衣,防水胶布; [a]/ˈmækɪntɑːʃ/; [or]yshx;
degenerate: [v]堕落,衰减; [adj]腐化的,颓废的,退化的;变质的; [n]堕落者; [a]/dɪˈdʒenəreɪt/; [or]yshx;
bolt: [n]门栓,螺栓;闪电;弩箭; [v]闩门;(马受惊)脱缰; [adv]突然地;像箭似地;直立地; [a]/boʊlt/; [or]yshx;
fling: [v]掷,抛;猛烈地移动;投入; [n]尽情欢乐的一阵,一时的放纵; [a]/flɪŋ/; [or]yshx;
tinge: [n]淡淡的(颜色,神色),轻微,少量; [v]给.染色,轻微地影响; [a]/tɪndʒ/; [or]yshx;
bet: [n]赌注;打赌; [v]打赌;敢断定; [a]/bet/; [or]yshx;
excursion: [n]远足;短途旅行; [a]/ɪkˈskɜːrʒn/; [or]yshx;
precious: [n]<口>宝贝,心爱的人; [adv]强调极少或太少; [adj]珍贵的,宝贵的; [a]/ˈpreʃəs/; [or]yshx;
zeal: [n]热情,热心; [a]/ziːl/; [or]yshx;
specialize: [v]专门研究,专门从事; [a]/ˈspeʃəlaɪz/; [or]yshx;
corps: [n](由两个或以上师组成的)军,兵团;一群人;特别小组; [a]/kɔːr/; [or]yshx;
set sth. back: [v]把(钟,表)向回拨; [a]/set ˈsʌmθɪŋ bæk/; [or]yshx;
ridge: [n]脊,岭,山脉,垄; [a]/rɪdʒ/; [or]yshx;
assault: [n]攻击,袭击; [v]攻击,袭击,殴打; [a]/əˈsɔːlt/; [or]yshx;
shell: [n]炮弹;骨架;壳,外壳;贝壳; [v]剥壳;炮击; [a]/ʃel/; [or]yshx;
deliver: [v]递送,交付;履行;发表(演讲);分娩;投掷; [a]/dɪˈlɪvər/; [or]yshx;
get somewhere: [v]有所成就; [a]/ɡet ˈsʌmwer/; [or]yshx;
shelter: [n]隐蔽处,躲避处(常用来指住处);庇护; [v]遮蔽,掩护,庇护; [a]/ˈʃeltər/; [or]yshx;
faculty: [n]教职工,全体教员;系;科;能力; [a]/ˈfæklti/; [or]yshx;
corpse: [n]尸体,被废弃的东西; [a]/kɔːrps/; [or]yshx;
brood: [n]一窝,同窝幼崽; [vi]冥思苦想; [vt]孵;默想; [adj]传种用的;(母鸡等)抱窝的;(昆虫等)产卵的; [a]/bruːd/; [or]yshx;
dreary: [adj]沉闷的;乏味的;凄凉的; [a]/ˈdrɪri/; [or]yshx;
pesticide: [n]杀虫剂;农药; [a]/ˈpestɪsaɪd/; [or]yshx;
mandatory: [adj]命令的,强制性的; [a]/ˈmændətɔːri/; [or]yshx;
astronomy: [n]天文学; [a]/əˈstrɑːnəmi/; [or]yshx;
opportunity: [n]机会,良机; [a]/ˌɑːpərˈtuːnəti/; [or]yshx;
synchronize: [v]校准时间;使协调;与......同步; [a]/ˈsɪŋkrənaɪz/; [or]yshx;
set on sb.: [v]攻击; [a]/set ɔːn ˈsʌmbədi/; [or]yshx;
misdeed: [n]不端行为,罪行; [a]/ˌmɪsˈdiːd/; [or]yshx;
disdain: [n]蔑视,鄙视; [vt]鄙视;不屑; [a]/dɪsˈdeɪn/; [or]yshx;
opaque: [adj]不透明的;难懂的; [a]/oʊˈpeɪk/; [or]yshx;
appliance: [n]家用器具;家用电器;装置;应用; [a]/əˈplaɪəns/; [or]yshx;
proxy: [n]代理权,代表权,代理人; [adj]代理的; [a]/ˈprɑːksi/; [or]yshx;
forecast: [n]预测;预报; [v]预报,预测; [a]/ˈfɔːrkæst/; [or]yshx;
revive: [v](使)苏醒;(使)复苏;再兴起;重做; [a]/rɪˈvaɪv/; [or]yshx;
series: [n]系列,系列节目;连续比赛;连续,接连; [a]/ˈsɪriːz/; [or]yshx;
discord: [n]不和,争吵;(声音)不和谐; [a]/ˈdɪskɔːrd/; [or]yshx;
Christian: [n]基督教徒; [adj]基督教的,基督教徒的; [a]/ˈkrɪstʃən/; [or]yshx;
pervade: [vt]普及;渗透;弥漫; [vi]弥漫;渗透; [a]/pərˈveɪd/; [or]yshx;
devour: [v]狼吞虎咽;毁灭;贪婪地看,贪婪地阅读; [a]/dɪˈvaʊər/; [or]yshx;
complement: [v]补充;与.相配; [n]补充;互为补充的东西;补语; [a]/ˈkɑːmplɪment/; [or]yshx;
fragment: [n]片段;碎片; [v]使成碎片; [a]/ˈfræɡmənt/; [or]yshx;
chaste: [adj]贞洁的;纯洁的;朴素的; [a]/tʃeɪst/; [or]yshx;
microbe: [n]微生物;细菌; [a]/ˈmaɪkroʊb/; [or]yshx;
web: [n]网;蜘蛛网; [a]/web/; [or]yshx;
staff: [n]全体职员,员工;参谋;拐杖;五线谱; [adj]行政工作的;参谋的;职员的;作为正式工作人员的; [v]雇用工作人员;给.配备员工; [a]/stæf/; [or]yshx;
outright: [adj]完全的,彻底的,全部地;直率的; [adv]完全地;直率地,痛快地;直截了当地; [a]/ˈaʊtraɪt/; [or]yshx;
refugee: [n]避难者,难民; [v]避难; [adj]避难的; [a]/ˌrefjuˈdʒiː/; [or]yshx;
perfume: [n]香水;香气; [v]使充满芳香;洒香水于; [a]/pərˈfjuːm/; [or]yshx;
doctrine: [n]教条,学说,信条,原则; [a]/ˈdɑːktrɪn/; [or]yshx;
economic: [adj]经济上的,经济学的;合算的;有利可图的; [a]/ˌekəˈnɑːmɪk/; [or]yshx;
warehouse: [n]仓库; [a]/ˈwerhaʊs/; [or]yshx;
quiver: [n]颤抖;箭袋; [vi]颤抖; [a]/ˈkwɪvər/; [or]yshx;
withdraw: [v]取款;撤退,收回,撤离; [a]/wɪðˈdrɔː/; [or]yshx;
substitute: [v]代替; [n]代替者,代用品,替补队员; [a]/ˈsʌbstɪtuːt/; [or]yshx;
come upon: [phr]遇到;对⋯⋯有感觉;突然⋯⋯想做; [a]/kʌm əˈpɑn/; [or]yshx;
bulk: [n]大批;容量;体积;大块; [adj]大量的;散装的; [v]膨胀;显得重要; [a]/bʌlk/; [or]yshx;
bargain: [n]交易,特价商品;便宜货;契约; [vi]讨价还价,讲价;成交; [vt]经讨价还价成交;用.交换; [adj](价格),低廉的; [a]/ˈbɑːrɡən/; [or]yshx;
be on good terms (with sb.): [phr]关系好; [a]/biː ɔːn ɡʊd tɜːrmz wɪθ ˈsʌmbədi/; [or]yshx;
cardinal: [adj]主要的;基本的; [n][天主教]枢机主教,红衣主教;基数; [a]/ˈkɑːrdɪnl/; [or]yshx;
bring about: [phr]导致,引起; [a]/brɪŋ əˈbaʊt/; [or]yshx;
ideal: [adj]理想的;完美的;空想的;观念的; [n]理想;典范;目标; [a]/aɪˈdiːəl/; [or]yshx;
aspire: [vi]渴望,有志于(与to,for,after连用或后接不定式); [a]/əˈspaɪər/; [or]yshx;
recruit: [v]招募(新兵),招收(新成员); [n]新兵,新成员; [a]/rɪˈkruːt/; [or]yshx;
denomination: [n]名称,名目;(货币的) 面额;单位;教派; [a]/dɪˌnɑːmɪˈneɪʃn/; [or]yshx;
authority: [n]权威;威信;当局,官方;权力,职权; [a]/əˈθɔːrəti/; [or]yshx;
set out: [v]出发; [a]/set aʊt/; [or]yshx;
chaos: [n]混沌;混乱,纷乱; [a]/ˈkeɪɑːs/; [or]yshx;
in time: [adv]及时;总有一天; [a]/ɪn taɪm/; [or]yshx;
liable: [adj](for)有责任的;有义务的;(to)有.倾向的;易于.的,有可能.; [a]/ˈlaɪəbl/; [or]yshx;
wrap: [v]裹,包,捆;覆盖; [n]包裹物,覆盖物;外衣; [a]/ræp/; [or]yshx;
elevate: [v]上升;提高;举起;提拔; [a]/ˈelɪveɪt/; [or]yshx;
audit: [v]审计,查账;旁听; [n]审计;查帐; [a]/ˈɔːdɪt/; [or]yshx;
monetary: [adj]货币的,金融的;金钱的; [a]/ˈmɑːnɪteri/; [or]yshx;
ransom: [n]赎金,赎身; [v]赎回,解救; [a]/ˈrænsəm/; [or]yshx;
hitchhike: [v]免费搭乘他人便车; [n]搭便车(旅行); [a]/ˈhɪtʃhaɪk/; [or]yshx;
bewilder: [v]使不知所措;使迷惑;使变糊涂,弄糊涂; [a]/bɪˈwɪldər/; [or]yshx;
pathetic: [adj]可怜的;不足的; [a]/pəˈθetɪk/; [or]yshx;
depress: [vt]使沮丧;使萧条;压下,压低; [a]/dɪˈpres/; [or]yshx;
inject: [v]给.注射;注入;引入;射入轨道; [a]/ɪnˈdʒekt/; [or]yshx;
barren: [adj]贫瘠的,不孕的; [n]荒原,不毛之地; [a]/ˈbærən/; [or]yshx;
modest: [adj]谦虚的,谦逊的;端庄的,羞怯的;不太大(或太贵,太重要)的,适度的; [a]/ˈmɑːdɪst/; [or]yshx;
glide: [v]滑翔;滑动; [n]滑音,延音;滑行; [a]/ɡlaɪd/; [or]yshx;
miserable: [adj]悲惨的,痛苦的;使人难受的;不快乐的,不友善的,暴躁的(人);极少的; [a]/ˈmɪzrəbl/; [or]yshx;
malice: [n]恶意,怨恨; [a]/ˈmælɪs/; [or]yshx;
rival: [n]竞争者,对手; [v]与.竞争,与.匹敌; [adj]竞争的,敌对的; [a]/ˈraɪvl/; [or]yshx;
frost: [n]霜冻,严寒; [v]结霜,冻死; [a]/frɔːst/; [or]yshx;
insulate: [v]隔离,使隔绝(以免受到影响);使隔热; [a]/ˈɪnsəleɪt/; [or]yshx;
ravage: [n]毁坏,荒废,破坏的残迹; [v]摧残,破坏; [a]/ˈrævɪdʒ/; [or]yshx;
transit: [n]运输;运送; [v]运送;通过; [a]/ˈtrænzɪt/; [or]yshx;
cucumber: [n]黄瓜; [a]/ˈkjuːkʌmbər/; [or]yshx;
blot: [n]墨水渍;污点;缺点; [v]涂污;(用吸水纸)吸干墨水;遮暗; [a]/blɑːt/; [or]yshx;
innumerable: [adj]数不清的;无数的; [a]/ɪˈnuːmərəbl/; [or]yshx;
naval: [adj]海军的,军舰的; [a]/ˈneɪvl/; [or]yshx;
historic: [adj]历史上著名的,有历史意义的;历史性的; [a]/hɪˈstɔːrɪk/; [or]yshx;
innovation: [n]创新,革新,新设施,新发明; [a]/ˌɪnəˈveɪʃn/; [or]yshx;
misrepresent: [vi]作虚假陈述; [vt]歪曲;误传; [a]/ˌmɪsˌreprɪˈzent/; [or]yshx;
embarrass: [vt]使窘迫,使尴尬(尤指在社交场合);困窘,困扰; [a]/ɪmˈbærəs/; [or]yshx;
technique: [n]技巧,技能;方法;技术; [a]/tekˈniːk/; [or]yshx;
kit: [n]成套工具;工具箱;装备; [vt]装备; [a]/kɪt/; [or]yshx;
herb: [n]草本植物;药草; [a]/ɜːrb/; [or]yshx;
articulate: [adj]善于表达的;发音清晰的; [v]清晰地发音;清楚地讲话;连接,接合;与.合成整体 ,使相互连贯; [a]/ɑːrˈtɪkjuleɪt/; [or]yshx;
null: [adj]无效的;不存在的; [n]零; [a]/nʌl/; [or]yshx;
swift: [adj]敏捷的,矫健的;快速的,迅速的; [n]雨燕; [a]/swɪft/; [or]yshx;
triangle: [n]三角形; [a]/ˈtraɪæŋɡl/; [or]yshx;
tremble: [v]发抖;哆嗦;摇动; [n]发抖;震颤; [a]/ˈtrembl/; [or]yshx;
despair: [n]绝望,失望; [v]失望; [a]/dɪˈsper/; [or]yshx;
pilgrim: [n]朝圣客;香客; [a]/ˈpɪlɡrɪm/; [or]yshx;
dominate: [v]在.中占首要地位;支配,统治,控制;耸立于,俯视;处于支配地位,拥有优势; [a]/ˈdɑːmɪneɪt/; [or]yshx;
concise: [adj]简明的,简要的;简洁的,简要的; [a]/kənˈsaɪs/; [or]yshx;
in sb.'s favour: [phr]对某人有利;偏爱; [a]/ɪn ˈsʌmbədiz ˈfeɪvər/; [or]yshx;
chorus: [n]副歌部分;合唱团;合唱曲,合唱句; [v]合唱,齐声说;齐声说; [a]/ˈkɔːrəs/; [or]yshx;
natal: [adj]出生的;分娩的;与生俱来的; [a]/ˈneɪtl/; [or]yshx;
sprout: [v]发芽,开始生长;发展; [n]苗芽; [a]/spraʊt/; [or]yshx;
skeleton: [n]骨骼,梗概;骨瘦如柴的人或动物; [a]/ˈskelɪtn/; [or]yshx;
come out: [vi]出现,显露,出版,被算出,结果是,公开表态; [a]/kʌm aʊt/; [or]yshx;
meddle: [vi]干预,多管闲事; [a]/ˈmedl/; [or]yshx;
compliment: [n]恭维,问候; [v]赞美,祝贺; [a]/ˈkɑːmplɪmənt/; [or]yshx;
trickle: [v]一滴滴地流;徐徐地流; [n]细流;徐徐地流;稀稀疏疏缓慢来往的东西; [a]/ˈtrɪkl/; [or]yshx;
artificial: [adj]人造的,人工的,假的;假装的,虚伪的; [n]人造肥料;<美>假花; [a]/ˌɑːrtɪˈfɪʃl/; [or]yshx;
go back: [phr]回去;追溯; [a]/ɡoʊ bæk/; [or]yshx;
measure: [v]测量;估量; [n]措施;方法;尺寸;量度标准; [a]/ˈmeʒər/; [or]yshx;
brake: [v]刹车; [n]刹车,制动器,闸; [a]/breɪk/; [or]yshx;
client: [n]委托人,当事人,主顾,客户;客户端; [a]/ˈklaɪənt/; [or]yshx;
abstract: [adj]抽象的; [n]摘要,抽象; [v]提取; [a]/ˈæbstrækt/; [or]yshx;
style: [n]风格;样式; [v]称呼;设计; [a]/staɪl/; [or]yshx;
sediment: [n]沉渣,沉淀物,沉淀; [a]/ˈsedɪmənt/; [or]yshx;
intelligible: [adj]可理解的,明白易懂的; [a]/ɪnˈtelɪdʒəbl/; [or]yshx;
lease: [v]出租,租得; [n]租约,租契; [a]/liːs/; [or]yshx;
superintend: [v]监督;主管;指挥; [a]/ˌsuːpərɪnˈtend/; [or]yshx;
margin: [n]页边的空白,边缘;优势;利润; [a]/ˈmɑːrdʒən/; [or]yshx;
hand sth. out: [phr]分发; [a]/hænd ˈsʌmθɪŋ aʊt/; [or]yshx;
cognitive: [adj]认识能力的;认知的; [a]/ˈkɑːɡnətɪv/; [or]yshx;
undercharge: [n]索价低于常价;充电不足; [vi]向.少收钱; [vt]向.少收钱; [a]/ˌʌndərˈtʃɑːrdʒ/; [or]yshx;
pageant: [n]盛会,历史剧,选美; [a]/ˈpædʒənt/; [or]yshx;
flatter: [v]阿谀,使高兴;(肖像等)胜过(真人真物);自鸣得意,自以为是; [a]/ˈflætər/; [or]yshx;
first and foremost: [adv]首先; [a]/fɜrst ənd ˈfɔrˌmoʊst/; [or]yshx;
shoal: [n]浅滩,沙洲,一群(鱼); [adj](水)浅的; [v]变成浅滩;驶入浅水的地方;(鱼)成群集聚; [a]/ʃoʊl/; [or]yshx;
meagre: [adj]瘦的;贫弱的;贫乏的; [a]/ˈmiːɡər/; [or]yshx;
marble: [n]大理石;(游戏用的)玻璃弹子; [a]/ˈmɑːrbl/; [or]yshx;
corporate: [adj]公司的;全体的;共同的;(法人)团体的; [a]/ˈkɔːrpərət/; [or]yshx;
border on (upon): [v]接近,近似; [a]/ˈbɔːrdər ɔːn əˈpɔːn/; [or]yshx;
stagger: [v]蹒跚;(使)错开(时间),交错安排;使吃惊; [n]蹒跚; [a]/ˈstæɡər/; [or]yshx;
muddle: [n]混乱,杂乱,(头脑的)糊涂; [v](使)混乱,(使)迷惑,混淆; [adj]引起困惑的;使人糊涂的;难以理解的; [a]/ˈmʌdl/; [or]yshx;
patent: [n]专利; [adj]显然的,明显的;专利的;独创的; [v]取得.的专利权; [a]/ˈpætnt/; [or]yshx;
clash: [vi]发生冲突;发出撞击声;不合,不一致,不调和; [n]冲突;抵触;撞击声; [a]/klæʃ/; [or]yshx;
tighten: [v]拉紧;使..更严格; [a]/ˈtaɪtn/; [or]yshx;
queer: [adj]怪异的;〈贬〉同性恋的; [n]〈贬〉同性恋者; [v]破坏.的计划; [a]/kwɪr/; [or]yshx;
upright: [adj]垂直的;正直的; [adv]直立地; [n]立柱; [a]/ˈʌpraɪt/; [or]yshx;
decree: [v]命令,判决,颁布; [n]法令,政令; [a]/dɪˈkriː/; [or]yshx;
impede: [v]妨碍,阻碍; [a]/ɪmˈpiːd/; [or]yshx;
revolve: [v](使)旋转;(使)绕转; [a]/rɪˈvɑːlv/; [or]yshx;
scent: [n]气味;香味;迹象; [v]嗅到;察觉; [a]/sent/; [or]yshx;
discern: [v]辨别;识别;看出; [a]/dɪˈsɜːrn/; [or]yshx;
clan: [n]家族;氏族;部落;宗派;亲族; [a]/klæn/; [or]yshx;
keep sb. (sth.) out (of): [v]不让.入内; [a]/kiːp ˈsʌmbədi ˈsʌmθɪŋ aʊt ʌv/; [or]yshx;
continuity: [n]连续性;(电影或电视节目中)镜头的连接,衔接; [a]/ˌkɑːntəˈnuːəti/; [or]yshx;
affection: [n]关爱,爱慕;感情;作用,影响;疾病; [a]/əˈfekʃn/; [or]yshx;
barber: [n]理发师,理发店; [a]/ˈbɑːrbər/; [or]yshx;
simultaneous: [adj]同时发生的; [a]/ˌsaɪmlˈteɪniəs/; [or]yshx;
adhere: [v]遵守;坚持;粘附;附着,粘在..上; [a]/ədˈhɪr/; [or]yshx;
caustic: [adj]腐蚀性的;苛性的;刻薄的;焦散的; [n]腐蚀剂;苛性钠;焦散曲线; [a]/ˈkɔːstɪk/; [or]yshx;
shimmer: [v]闪烁,微微发亮; [n]微光,闪光; [a]/ˈʃɪmər/; [or]yshx;
throbbing: [adj]跳动的,悸动的; [a]/ˈθrɑːbɪŋ/; [or]yshx;
contrive: [v]发明;设计出;设法做到;谋划;策划; [a]/kənˈtraɪv/; [or]yshx;
genetic: [adj]遗传的,起源的; [a]/dʒəˈnetɪk/; [or]yshx;
beset: [v]困扰;镶嵌;围绕; [a]/bɪˈset/; [or]yshx;
fuss: [n]大惊小怪,小题大做; [v](为小事)烦恼,过于忧虑; [a]/fʌs/; [or]yshx;
pounce: [n]猛扑,飞扑; [vi]猛扑,突然袭击; [vt]扑过去抓住; [a]/paʊns/; [or]yshx;
cripple: [n]跛子,伤残人(或动物); [v]使跛;使受伤致残;严重削弱; [a]/ˈkrɪpl/; [or]yshx;
obsolete: [adj]已过时的;已废弃的; [v]使过时;使作废; [n]废词;被废弃的事物; [a]/ˌɑːbsəˈliːt/; [or]yshx;
edit: [v]剪辑;编辑;校订; [n]编辑[校订]工作; [a]/ˈedɪt/; [or]yshx;
consist: [v]由..组成;在于; [a]/kənˈsɪst/; [or]yshx;
ephemeral: [adj]短暂的,短命的; [n]生存极短时间的事物; [a]/ɪˈfemərəl/; [or]yshx;
annual: [adj]一年一次的,年度的; [n]年鉴,一年生植物,一年一度的事件; [a]/ˈænjuəl/; [or]yshx;
layer: [n]层;层次;阶层; [v]把.分层堆放;借助压条法;将(头发)剪成不同层次; [a]/ler/; [or]yshx;
eddy: [n]漩涡; [v]旋转;起漩涡; [a]/ˈedi/; [or]yshx;
summary: [n]摘要,总结; [adj]简略的,概要的,即决的; [a]/ˈsʌməri/; [or]yshx;
notorious: [adj]臭名昭著的,声名狼藉的; [a]/noʊˈtɔːriəs/; [or]yshx;
frown: [n]皱眉;不悦; [v]皱眉;不赞成;使哑口无言; [a]/fraʊn/; [or]yshx;
sponge: [n]海绵,多孔布丁,松蛋糕; [v]用湿海绵(或布)擦,揩; [a]/spʌndʒ/; [or]yshx;
ethnic: [adj]种族的,少数民族的; [n]少数民族成员;人种学; [a]/ˈeθnɪk/; [or]yshx;
pamphlet: [n]小册子; [a]/ˈpæmflət/; [or]yshx;
brisk: [adj]轻快的;活跃的;寒冷而清新的; [a]/brɪsk/; [or]yshx;
rub: [v]抚摸;摩擦;擦破; [n]蹭;障碍;磨损处; [a]/rʌb/; [or]yshx;
volatile: [adj]易气化的;爆炸性的;反复无常的;短暂的;不稳定的; [a]/ˈvɑːlətl/; [or]yshx;
curriculum vitae: [phr]简短的履历书; [a]/kəˌrɪkjələm ˈviːtaɪ/; [or]yshx;
keep off: [phr]让开;不接近; [a]/kip ɑf/; [or]yshx;
infirmary: [n]医院,医务室(尤指学校等附设的病房或配药处); [a]/ɪnˈfɜːrməri/; [or]yshx;
permeate through (among): [phr]渗透,透入; [a]/ˈpɜːrmieɪt θruː əˈmʌŋ/; [or]yshx;
annoy: [v]使烦恼,使生气; [n]烦恼(等于annoyance); [a]/əˈnɔɪ/; [or]yshx;
accompany: [v]陪伴;为..伴奏(或伴唱); [a]/əˈkʌmpəni/; [or]yshx;
cumbersome: [adj]笨重的;麻烦的; [a]/ˈkʌmbərsəm/; [or]yshx;
click: [v]点击(鼠标);(使)发出咔哒声;情投意合;博得喝彩; [n]咔哒声,点击; [a]/klɪk/; [or]yshx;
bull: [n]公牛,雄性的鲸,象等大动物; [a]/bʊl/; [or]yshx;
be bent on: [v]专心致志于;决心要; [a]/bi bent ɔn/; [or]yshx;
unrest: [n]不安,骚动;动荡的局面;不安的状态; [a]/ʌnˈrest/; [or]yshx;
sketch: [n]梗概,素描; [v]速写,打草稿; [a]/sketʃ/; [or]yshx;
trick: [v]哄骗;捉弄,戏弄; [n]恶作剧,诡计;技艺,戏法; [adj]虚弱的; [a]/trɪk/; [or]yshx;
forerunner: [n]先驱;祖先;前兆;预兆; [a]/ˈfɔːrʌnər/; [or]yshx;
hydrogen: [n]氢,氢气; [a]/ˈhaɪdrədʒən/; [or]yshx;
fountain: [n]泉水,喷泉;源泉;人造喷泉装置; [a]/ˈfaʊntn/; [or]yshx;
efficient: [adj]效率高的;有能力的;能胜任的; [a]/ɪˈfɪʃnt/; [or]yshx;
enormous: [adj]极大的,极大量的;巨大的;庞大的; [a]/ɪˈnɔːrməs/; [or]yshx;
flavor: [n]味,风味;调味品; [v]给..调味; [a]/ˈfleɪvər/; [or]yshx;
sponsor: [n]倡导者;提案人;赞助人;担保人;教父,教母; [vt]发起;倡议;做.的保人;赞助;资助; [a]/ˈspɑːnsər/; [or]yshx;
wholesome: [adj]有益于健康的;有益的; [a]/ˈhoʊlsəm/; [or]yshx;
congress: [n]国会(美);代表大会;议会;立法机关; [a]/ˈkɑːŋɡrəs/; [or]yshx;
respiration: [n]呼吸; [a]/ˌrespəˈreɪʃn/; [or]yshx;
theft: [n]偷盗,失窃; [a]/θeft/; [or]yshx;
indicative: [adj]指示的;暗示的;陈述的; [n]陈述语气; [a]/ɪnˈdɪkətɪv/; [or]yshx;
stem: [n]茎,(树)干; [v]阻止;起源于;遏制,抑制; [a]/stem/; [or]yshx;
compel: [v]强迫;迫使屈服;(使)不得已; [a]/kəmˈpel/; [or]yshx;
pass over: [v]忽略;不注意; [a]/pæs ˈoʊvər/; [or]yshx;
thrust: [v]猛冲,猛推;刺,戳; [n]猛冲,推进;推力;主要观点; [a]/θrʌst/; [or]yshx;
deft: [adj]灵巧的,敏捷的,熟练的; [a]/deft/; [or]yshx;
misuse: [v]误用;滥用; [n]误用;滥用; [a]/ˌmɪsˈjuːs/; [or]yshx;
buzz: [v]发出嗡嗡声; [n]嗡嗡声;低沉嘈杂的谈话声; [a]/bʌz/; [or]yshx;
valve: [n]阀门,活门; [a]/vælv/; [or]yshx;
buck: [n]雄鹿;年轻男士;美元; [v]反对;马弓背踢后腿挑起; [a]/bʌk/; [or]yshx;
call on: [phr]拜访,呼吁,请求; [a]/kɔːl ɑːn/; [or]yshx;
portion: [n]一部分,份额,分担的责任; [v]把.分成份额,分配; [a]/ˈpɔːrʃn/; [or]yshx;
numb: [adj]麻木的,失去知觉的; [vt]使麻木,使失去知觉; [a]/nʌm/; [or]yshx;
withstand: [v]忍受;抵挡; [a]/wɪðˈstænd/; [or]yshx;
lodging: [n]住所;寄宿;(大学生的)校外宿舍; [a]/ˈlɑːdʒɪŋ/; [or]yshx;
convey: [v]传送,运送;表达,传达; [a]/kənˈveɪ/; [or]yshx;
profane: [adj]亵渎神圣的,不敬的,粗俗的,污秽的; [v]亵渎,玷污(神圣),滥用; [n]未受秘传的人; [a]/prəˈfeɪn/; [or]yshx;
concoct: [v]调合;编造(故事等); [a]/kənˈkɑːkt/; [or]yshx;
slope: [n]山坡,斜坡,倾斜; [v]倾斜; [a]/sloʊp/; [or]yshx;
manufacture: [v]生产;制造; [n]制造,生产;制造业;(复)产品; [a]/ˌmænjuˈfæktʃər/; [or]yshx;
scale: [n]天平,磅秤;刻度,尺度,标度;等级,级别, 等级体系;鳞片,鳞状物;规模;水垢,牙垢; [v]攀登;按比例决定;称重;刮鳞,剥落; [a]/skeɪl/; [or]yshx;
assimilate: [v]使同化;吸收;消化; [a]/əˈsɪməleɪt/; [or]yshx;
prohibit: [v]禁止; [a]/prəˈhɪbɪt/; [or]yshx;
inhibit: [v]阻碍;阻止,防止;抑制,约束; [a]/ɪnˈhɪbɪt/; [or]yshx;
pose: [n]姿势;装腔作势,伪装; [vi]摆造型; [vt]主张,提出;引起,导致; [a]/poʊz/; [or]yshx;
monopoly: [n]垄断;专卖;垄断商品;专卖商品; [a]/məˈnɑːpəli/; [or]yshx;
universal: [adj]普遍存在的;全体的;通用的;宇宙的; [n]普遍原则; [a]/ˌjuːnɪˈvɜːrsl/; [or]yshx;
statute: [n]法令,法规,条例; [a]/ˈstætʃuːt/; [or]yshx;
notch: [n]刻痕,凹口;等级;峡谷; [v]赢得;用刻痕计算;在.上刻凹痕; [a]/nɑːtʃ/; [or]yshx;
toll: [n]伤亡人数;(道路等的)通行费;钟声; [v]敲钟; [a]/toʊl/; [or]yshx;
dwell: [v](尤指作为常住居民)居住; [a]/dwel/; [or]yshx;
mechanism: [n]机械装置;机制,机理,原理; [a]/ˈmekənɪzəm/; [or]yshx;
mist: [n]薄雾,朦胧; [v]使模糊,下雾; [a]/mɪst/; [or]yshx;
confuse: [v]混淆;使混乱,使迷糊; [a]/kənˈfjuːz/; [or]yshx;
chew: [v]嚼,咀嚼; [n]嚼碎,咀嚼; [a]/tʃuː/; [or]yshx;
previous: [adj]以前的;早先的;过早的; [a]/ˈpriːviəs/; [or]yshx;
motivate: [vt]激励;使有动机;促进;促动;激发..的积极性; [a]/ˈmoʊtɪveɪt/; [or]yshx;
alleviate: [v]减轻;缓解;缓和; [a]/əˈliːvieɪt/; [or]yshx;
individual: [adj]个别的,独特的;单独的; [n]独立的个体; [a]/ˌɪndɪˈvɪdʒuəl/; [or]yshx;
carry out: [phr]执行,实行;实现;完成; [a]/ˈkærɪ aʊt/; [or]yshx;
bulge: [n]凸出部分; [v]凸出,膨胀; [a]/bʌldʒ/; [or]yshx;
manuscript: [n]手稿;底稿;手抄本; [a]/ˈmænjuskrɪpt/; [or]yshx;
telling: [adj]明显的;生动的; [n]叙述; [a]/ˈtelɪŋ/; [or]yshx;
gush: [v]涌出;滔滔不绝地说,洋洋洒洒地写; [n]迸发; [a]/ɡʌʃ/; [or]yshx;
worthwhile: [adj]值得(花时间,精力)的,有意义的; [a]/ˌwɜːrθˈwaɪl/; [or]yshx;
academic: [adj]学术的;学院的,大学的;理论的; [n]学者; [a]/ˌækəˈdemɪk/; [or]yshx;
spacious: [adj]宽敞的,广阔的; [a]/ˈspeɪʃəs/; [or]yshx;
shabby: [adj]破烂的,卑鄙的,衣衫褴褛的; [a]/ˈʃæbi/; [or]yshx;
resemble: [v]像,相像,相似; [a]/rɪˈzembl/; [or]yshx;
accomplish: [v]完成,做到;实现; [a]/əˈkɑːmplɪʃ/; [or]yshx;
hell: [n]地狱,阴间;苦境,极大的痛苦; [a]/hel/; [or]yshx;
refine: [v]精炼,改进; [a]/rɪˈfaɪn/; [or]yshx;
invoice: [n]发票; [v]开发票;记清单; [a]/ˈɪnvɔɪs/; [or]yshx;
admission: [n]准许进入;进入权;入场费; [a]/ədˈmɪʃn/; [or]yshx;
strengthen: [v]加强,变坚固,变强大; [a]/ˈstreŋθn/; [or]yshx;
qualification: [n]资格证明;条件;合格证书;资格;限制性条件; [a]/ˌkwɑːlɪfɪˈkeɪʃn/; [or]yshx;
spouse: [n]配偶,夫妇;夫,妻; [v]和.结婚; [a]/spaʊs/; [or]yshx;
badge: [n]徽章;象征;标记; [vt]给予.标记;授予.徽章; [a]/bædʒ/; [or]yshx;
incline: [n]倾斜,斜坡,斜面; [v](使)倾斜,(使)倾向于; [a]/ɪnˈklaɪn/; [or]yshx;
limb: [n]肢体;臂;枝干;树枝; [v]肢解; [a]/lɪm/; [or]yshx;
sparkle: [vi]闪耀;焕发,活跃,才华横溢; [n]光亮;活力; [a]/ˈspɑːrkl/; [or]yshx;
at the same time: [adv]同时;然而; [a]/ət ðə seɪm taɪm/; [or]yshx;
check out: [phr]结账后离开,检验,通过考核,合格; [a]/tʃek aʊt/; [or]yshx;
engage: [vt]吸引住(注意力,兴趣);雇,聘; [vi]使加入,使融入;订婚; [v](军队)交战;啮合; [a]/ɪnˈɡeɪdʒ/; [or]yshx;
dividend: [n](股份的)红利,回报,效益,被除数; [a]/ˈdɪvɪdend/; [or]yshx;
seclude: [v]与世隔绝,使隔绝; [a]/sɪˈkluːd/; [or]yshx;
achieve: [v]完成,达到,获得,实现; [a]/əˈtʃiːv/; [or]yshx;
freight: [n]货运;货物;运费; [v]运送; [a]/freɪt/; [or]yshx;
establish: [v]建立;确立;使安全;使成为; [a]/ɪˈstæblɪʃ/; [or]yshx;
venerate: [v]崇敬,敬仰; [a]/ˈvenəreɪt/; [or]yshx;
procure: [vt](努力)取得;获得;导致;完成; [vi]介绍娼妓;拉皮条; [a]/prəˈkjʊr/; [or]yshx;
mode: [n]模式;方式; [a]/moʊd/; [or]yshx;
deficit: [n]亏损;赤字;不足额; [a]/ˈdefɪsɪt/; [or]yshx;
signify: [vi]具有重要性; [vt]表示; [a]/ˈsɪɡnɪfaɪ/; [or]yshx;
employment: [n]职业;雇佣;就业;运用; [a]/ɪmˈplɔɪmənt/; [or]yshx;
loll: [vi]懒洋洋地倚靠;闲荡; [vt]懒洋洋地倚靠着;使悬垂; [a]/lɑːl/; [or]yshx;
tension: [n](精神上的)紧张,不安;紧张局面;拉紧;张力;电压; [v]绷紧; [a]/ˈtenʃn/; [or]yshx;
cylinder: [n]圆柱体,圆筒;汽缸,泵(或桶)体; [a]/ˈsɪlɪndər/; [or]yshx;
offset: [v]抵消; [adj]胶印的,透印版印刷的; [n]分支;抵销; [a]/ˈɔːfset/; [or]yshx;
debris: [n]废墟,残骸; [a]/dəˈbriː/; [or]yshx;
certainty: [n]必然;确信;必然的事; [a]/ˈsɜːrtnti/; [or]yshx;
malignant: [adj]恶性的,恶毒的,充满恨意的; [n]怀有恶意的人;保王党员; [a]/məˈlɪɡnənt/; [or]yshx;
harbor: [n]海港;港口;避风港; [v]庇护;藏匿;心怀(怨恨等); [a]/'hɑːbə/; [or]yshx;
transplant: [n]移种;移植; [v]移植(器官),使移居,移种(植物等); [a]/trænsˈplænt/; [or]yshx;
decorate: [v]装饰,布置;把(勋章)授给(某人); [a]/ˈdekəreɪt/; [or]yshx;
vomit: [n]呕吐物,呕吐; [v]呕吐;吐出;涌出;喷出; [a]/ˈvɑːmɪt/; [or]yshx;
scale up (down): [phr]按比例增加(或降低); [a]/skeɪl ʌp daʊn/; [or]yshx;
hardware: [n]五金器具,(总称)金属器材;硬件; [a]/ˈhɑːrdwer/; [or]yshx;
surgeon: [n]外科医生; [a]/ˈsɜːrdʒən/; [or]yshx;
roast: [v]烤,炙,烘;挖苦;逗乐; [n]烤肉; [adj]烤的,烘的; [a]/roʊst/; [or]yshx;
the gist: [n]要旨; [a]/ðə dʒɪst/; [or]yshx;
platitude: [n]陈词滥调,老生常谈;单调; [a]/ˈplætɪtuːd/; [or]yshx;
feature: [n]面貌,相貌;特征,特点;特辑; [vt]使突出,以.为特色; [vi]起重要作用,作为主要角色; [a]/ˈfiːtʃər/; [or]yshx;
cabinet: [n]橱;柜;内阁; [a]/ˈkæbɪnət/; [or]yshx;
spectrum: [n]光谱,范围,系列; [a]/ˈspektrəm/; [or]yshx;
ruinous: [adj]毁坏的;毁灭性的,破坏性的; [a]/ˈruːɪnəs/; [or]yshx;
thorough: [adj]彻底的,完全的;详尽的,细致深入的; [a]/ˈθɜːroʊ/; [or]yshx;
ascribe: [v]把.归因于;把.归属于; [a]/əˈskraɪb/; [or]yshx;
anxiety: [n]焦虑;忧虑;担心; [a]/æŋˈzaɪəti/; [or]yshx;
pinch: [v]捏,掐,夹痛; [n]捏;少量,一撮;困苦; [a]/pɪntʃ/; [or]yshx;
coach: [n]四轮大马车;教练;长途汽车; [v]训练,指导; [a]/koʊtʃ/; [or]yshx;
compress: [v]压紧,压缩,压榨; [a]/kəmˈpres/; [or]yshx;
rot: [v](使)腐烂; [n]胡话;腐烂;腐朽,腐败; [a]/rɑːt/; [or]yshx;
hereditary: [adj]世袭的,遗传的; [a]/həˈredɪteri/; [or]yshx;
discard: [v]丢弃;抛弃;遗弃; [a]/dɪsˈkɑːrd/; [or]yshx;
intersection: [n]交点,十字路口; [a]/ˌɪntərˈsekʃn/; [or]yshx;
conversely: [adv]相反地,反过来; [a]/kənˈvɜːrsli/; [or]yshx;
pillar: [n]柱,台柱,栋梁; [a]/ˈpɪlər/; [or]yshx;
righteous: [adj]正直的,正当的,公正的; [a]/ˈraɪtʃəs/; [or]yshx;
signature: [n]签名,署名;识别标志,鲜明特色;个人特色; [a]/ˈsɪɡnətʃər/; [or]yshx;
dash: [vi]猛冲,突进; [v]猛掷; [n]破折号;猛冲; [a]/dæʃ/; [or]yshx;
evolution: [n]进化,演变;发展; [a]/ˌevəˈluːʃn/; [or]yshx;
recession: [n](经济)衰退,不景气;后退,撤回;凹处; [a]/rɪˈseʃn/; [or]yshx;
pay sb. back: [v]还债;受到惩罚; [a]/peɪ ˈsʌmbədi bæk/; [or]yshx;
laudable: [adj]值得称赞的; [a]/ˈlɔːdəbl/; [or]yshx;
secretion: [n]分泌,分泌物;隐藏; [a]/sɪˈkriːʃn/; [or]yshx;
dodge: [n]托词;躲闪,躲避; [v]回避,规避;躲避,避开; [a]/dɑːdʒ/; [or]yshx;
petition: [n]请愿;请愿书;祈求; [v]请愿; [a]/pəˈtɪʃn/; [or]yshx;
anecdote: [n]轶事,趣闻; [a]/ˈænɪkdoʊt/; [or]yshx;
bring (call) sth. to mind: [v]想起某事; [a]/brɪŋ kɔːl ˈsʌmθɪŋ tu maɪnd/; [or]yshx;
go up: [phr]上升;被建立;被炸毁; [a]/ɡoʊ ʌp/; [or]yshx;
expose: [v]暴露;揭露;使遭受; [a]/ɪkˈspoʊz/; [or]yshx;
reassure: [v]使放心,使消除疑虑; [a]/ˌriːəˈʃʊr/; [or]yshx;
tonic: [n]补药;主调音或基音; [adj]滋补的;声调的;使精神振作的; [a]/ˈtɑːnɪk/; [or]yshx;
look in (on sb.): [v](顺便)看望; [a]/lʊk ɪn ɔːn ˈsʌmbədi/; [or]yshx;
scum: [n]浮沫,浮渣; [a]/skʌm/; [or]yshx;
feel like: [v]想要; quant. 像要.似的;觉得;摸起来像.似的; [a]/fil laɪk/; [or]yshx;
plug: [vi]堵塞;插入(插头); [vt]塞; [n]塞子;插头; [a]/plʌɡ/; [or]yshx;
reference: [n]参考书;提及;推荐人;参考;证明;推荐信; [v]附.以供参考;引用; [a]/ˈrefrəns/; [or]yshx;
enhance: [v]提高(强度,力量,数量等);增加,加强; [a]/ɪnˈhæns/; [or]yshx;
mannerism: [n](说话,举止等的)习气,癖性,矫揉造作; [a]/ˈmænərɪzəm/; [or]yshx;
sequence: [n]顺序,次序;连续,继续; [a]/ˈsiːkwəns/; [or]yshx;
rage: [n]极怒;盛怒; [v]迅速蔓延,快速扩散;(战争等)激烈地进行; [a]/reɪdʒ/; [or]yshx;
digital: [adj]数字显示的;数字的,数码的; [n]键;数字仪表,时钟; [a]/ˈdɪdʒɪtl/; [or]yshx;
mercantile: [adj]商人的,商业的; [a]/ˈmɜːrkəntaɪl/; [or]yshx;
pass sth. on to: [v]把.交给.; [a]/pæs ˈsʌmθɪŋ ɔːn tu/; [or]yshx;
vice: [n]缺点;恶习;邪恶;罪行;生理缺陷; [adj]副的;代理的; pref. 代理的; [vt]用老虎钳夹紧;钳制; [a]/vaɪs/; [or]yshx;
retort: [v]反驳; [n]反驳,反击,回嘴; [a]/rɪˈtɔːrt/; [or]yshx;
bruise: [n](人体组织或表皮等跌,碰撞后产生的)青肿,挫伤;碰伤; [v]撞伤,碰伤,(使)挫伤,擦伤(表皮,表面);打击;擦伤; [a]/bruːz/; [or]yshx;
tire: [v](使)疲倦,(使)厌倦; [n]轮胎,车胎; [a]/ˈtaɪər/; [or]yshx;
pinpoint: [v]准确地解释或说明; [adj]精确的; [n]针尖,极小之物,极不重要的事物; [a]/ˈpɪnpɔɪnt/; [or]yshx;
simulate: [v]假装;模仿;模拟; [a]/ˈsɪmjuleɪt/; [or]yshx;
assemble: [v]装配(机器等);集合;召集; [a]/əˈsembl/; [or]yshx;
convene: [v]集合,召集,召唤; [a]/kənˈviːn/; [or]yshx;
dock: [n]码头;船埠;被告席; [v](船)进港;扣工资;剪短(动物的尾巴); [a]/dɑːk/; [or]yshx;
discharge: [n]发射;释放;解雇;放电; [v]卸掉负担;发射;放电;卸(货);使爆炸;履行;解雇;允许.离开;排出,放出;清偿(债务); [a]/dɪsˈtʃɑːrdʒ/; [or]yshx;
bear sth. in mind: [v]记住某事; [a]/ber ˈsʌmθɪŋ ɪn maɪnd/; [or]yshx;
spoil: [v]溺爱;娇惯;(食物)变质;毁坏; [n]溺爱;战利品;犒劳;成功所带来的好处; [a]/spɔɪl/; [or]yshx;
haul: [n]一次获得;拖运路程; [v]硬拖,硬拉,用力拖;拖,拉,拽;强迫(某人)去某处; [a]/hɔːl/; [or]yshx;
exert: [v]尽(力),运用,发挥; [a]/ɪɡˈzɜːrt/; [or]yshx;
frontier: [n]边境,边疆;新领域;<美>边远地区,边界地区; [adj]开拓的; [a]/frʌnˈtɪr/; [or]yshx;
infant: [n]幼儿,婴儿; [adj]婴儿的;初期的,初创的; [a]/ˈɪnfənt/; [or]yshx;
yearn: [v]渴望,向往; [a]/jɜːrn/; [or]yshx;
excavate: [v]挖掘,挖出;挖(空),挖(洞); [a]/ˈekskəveɪt/; [or]yshx;
take sth. in: [v]承接;领会;改小尺寸; [a]/teɪk ˈsʌmθɪŋ ɪn/; [or]yshx;
scrupulous: [adj]小心谨慎的;严谨的;细心的; [a]/ˈskruːpjələs/; [or]yshx;
equivalent: [adj]相等的;等值的; [n]同义词;等价物; [a]/ɪˈkwɪvələnt/; [or]yshx;
acquaint: [v]使熟悉;使认识;介绍; [a]/əˈkweɪnt/; [or]yshx;
fatuous: [adj]愚昧而不自知的; [a]/ˈfætʃuəs/; [or]yshx;
paranoia: [n](心理)偏执狂,多疑症; [a]/ˌpærəˈnɔɪə/; [or]yshx;
fabulous: [adj]极好的;极妙的;极为巨大的;寓言中的;传说中的; [a]/ˈfæbjələs/; [or]yshx;
aboriginal: [adj]土著的,原来的; [n]土著居民; [a]/ˌæbəˈrɪdʒənl/; [or]yshx;
overhaul: [n]大修;全面检查;彻底革新; [vt]解体检修,大修;彻底革新; [a]/ˌoʊvərˈhɔːl/; [or]yshx;
facet: [n](多面体的)面,小平面;琢面,侧面; [vt]在.上琢面; [a]/ˈfæsɪt/; [or]yshx;
pass away: [v]死,逝世; [a]/pæs əˈweɪ/; [or]yshx;
elegant: [adj]优美的,文雅的,漂亮雅致的,陈设讲究的; [a]/ˈelɪɡənt/; [or]yshx;
keep on (doing sth.): [v]继续做某事; [a]/kiːp ɔːn ˈduːɪŋ ˈsʌmθɪŋ/; [or]yshx;
curl: [n]卷毛,卷发; [v]使卷曲; [a]/kɜːrl/; [or]yshx;
linen: [n]亚麻桌布;亚麻布; [a]/ˈlɪnɪn/; [or]yshx;
militant: [adj]好战的,好暴力的; [n]激进分子,斗士; [a]/ˈmɪlɪtənt/; [or]yshx;
make for sb.(sth.): [phr]有助于;促进;走向; [a]/meɪk fɔːr ˈsʌmbədi ˈsʌmθɪŋ/; [or]yshx;
crucial: [adj]关键的;决定性的; [a]/ˈkruːʃl/; [or]yshx;
appraisal: [n]评估;估价;评价; [a]/əˈpreɪzl/; [or]yshx;
voluntary: [adj]自愿的;无偿的;志愿的; [n]即兴曲; [a]/ˈvɑːlənteri/; [or]yshx;
crisis: [n]危机;存亡之际; [a]/ˈkraɪsɪs/; [or]yshx;
uprising: [n]起义;升起; [adj]升起的; [v]起义;升起; [a]/ˈʌpraɪzɪŋ/; [or]yshx;
call sb. (sth.) up: [v]打电话;征召; [a]/kɔːl ˈsʌmbədi ˈsʌmθɪŋ ʌp/; [or]yshx;
visualize: [v]使形象化;想象; [a]/ˈvɪʒuəlaɪz/; [or]yshx;
paralyze: [vt]使瘫痪;使麻痹;使不能活动; [a]/ˈperəˌlaɪz/; [or]yshx;
shiver: [v]颤抖,打战;颤动; [n]颤抖,打战; [a]/ˈʃɪvər/; [or]yshx;
explicit: [adj]充分表达清楚的,明确的;直率的,直截了当的;〔描绘性或暴力的语言或画面〕清晰露骨的; [a]/ɪkˈsplɪsɪt/; [or]yshx;
swear: [v]发誓,郑重地说;咒骂; [a]/swer/; [or]yshx;
nuance: [n]细微差别; [a]/ˈnuːɑːns/; [or]yshx;
opening: [n]开口;孔;开始;开幕;职位空缺; [adj]开始的,开场的; [a]/ˈoʊpnɪŋ/; [or]yshx;
reward: [n]奖品,报酬,回报;悬赏; [v]报答,酬谢; [a]/rɪˈwɔːrd/; [or]yshx;
wardrobe: [n]衣橱;全部服装;剧服; [a]/ˈwɔːrdroʊb/; [or]yshx;
heap: [n](一)堆;大量; [v]堆;堆积; [a]/hiːp/; [or]yshx;
personnel: [n]人事部门,员工,人员; [a]/ˌpɜːrsəˈnel/; [or]yshx;
know better (than): [v]很明白(而不至于); [a]/noʊ ˈbetər ðən/; [or]yshx;
inspection: [n]检查,细看; [a]/ɪnˈspekʃn/; [or]yshx;
revenge: [n]报仇;报复; [v]为.报仇,报.之仇; [a]/rɪˈvendʒ/; [or]yshx;
activate: [v]使活动起来;使开始起作用; [a]/ˈæktɪveɪt/; [or]yshx;
come down: [phr]倒塌;下降,下来; [a]/kʌm daʊn/; [or]yshx;
dim: [adj]暗淡的;模糊的;朦胧的; [v]变暗淡; [a]/dɪm/; [or]yshx;
madden: [v]使发疯,使发狂; [a]/ˈmædn/; [or]yshx;
defect: [n]缺陷,缺点,不足之处; [v]背叛,逃跑,开小差; [a]/ˈdiːfekt/; [or]yshx;
stand out: [phr]突出;继续抵抗; [a]/stænd aut/; [or]yshx;
regardless: [adj]不顾的,不注意的; [adv]不顾一切地; [a]/rɪˈɡɑːrdləs/; [or]yshx;
counterbalance: [n]平衡力;抵销; [v]使平衡;抵消; [a]/ˌkaʊntərˈbæləns/; [or]yshx;
stand off: [phr]远离;疏远; [a]/stænd ɑf/; [or]yshx;
crude: [adj]天然的;粗糙的;粗鲁的;简陋的; [n]原油; [a]/kruːd/; [or]yshx;
zoology: [n]动物学;动物区系; [a]/zuˈɑːlədʒi/; [or]yshx;
terrace: [n]阳台;梯田;走廊; [vi]成阶地; [adj]梯形的; [vt]使成梯田; [a]/ˈterəs/; [or]yshx;
come round(around): [phr]绕道而来;过访;重又来到;改变主意;苏醒; [a]/kʌm raʊnd əˈraʊnd/; [or]yshx;
drudgery: [n]苦工;苦差事;单调乏味的工作; [a]/ˈdrʌdʒəri/; [or]yshx;
dull: [adj]愚笨的,迟钝的;枯燥的,沉闷的;不清晰的,吵闹的; [v]缓和;减轻;使阴暗; [a]/dʌl/; [or]yshx;
coupon: [n](债券等)息券;赠券;配给券;折扣券; [a]/ˈkuːpɑːn/; [or]yshx;
file: [n]文件夹,档案,文件; [vi]把文件归档,提交(申请等); [vt]把(文件等)归档; [a]/faɪl/; [or]yshx;
barter: [v]物物交换;以货易货; [n]物物交换;实物交易; [a]/ˈbɑːrtər/; [or]yshx;
demolish: [v]拆毁(建筑物等);毁坏,破坏(组织等);〈俚〉吃光; [a]/dɪˈmɑːlɪʃ/; [or]yshx;
rational: [adj]理性的;理智的;合理的; [a]/ˈræʃnəl/; [or]yshx;
diameter: [n]直径; [a]/daɪˈæmɪtər/; [or]yshx;
have one's say: [phr]利用机会发表意见; [a]/hæv wʌnz seɪ/; [or]yshx;
predominant: [adj]占主导地位的;显著的; [a]/prɪˈdɑːmɪnənt/; [or]yshx;
in hand: [adv]可以动用的;在处理中;在控制中; [a]/ɪn hænd/; [or]yshx;
poke: [v]刺,戳;拨开,拨(弄);探(出),露出; [n]戳,捅; [a]/poʊk/; [or]yshx;
favor: [n]偏爱,帮助,特权,赞成; [vt]偏爱,支持,利于,长得像; [a]/ˈfeɪvər/; [or]yshx;
bounty: [n]慷慨;赠物;奖金; [vt]发给.奖金; [a]/ˈbaʊnti/; [or]yshx;
nylon: [n]尼龙,尼龙长袜; [a]/ˈnaɪlɑːn/; [or]yshx;
fossil: [n]化石; [adj]从地下发掘出来的;化石的;属于旧时代的;陈腐的; [a]/ˈfɑːsl/; [or]yshx;
promote: [v]提升;促进;发扬;促销; [a]/prəˈmoʊt/; [or]yshx;
beautician: [n]美容师; [a]/bjuːˈtɪʃn/; [or]yshx;
ambassador: [n](特命全权)大使;代表; [a]/æmˈbæsədər/; [or]yshx;
laundry: [n]洗衣;送洗的衣物;洗衣店;洗衣房; [a]/ˈlɔːndri/; [or]yshx;
barn: [n]谷仓,牲口棚;简陋的大房子; [a]/bɑːrn/; [or]yshx;
lane: [n]小径,巷,行车道; [a]/leɪn/; [or]yshx;
hubbub: [n]嘈杂,喧哗; [a]/ˈhʌbʌb/; [or]yshx;
propriety: [n]正当(的行为);礼节;适当; [a]/prəˈpraɪəti/; [or]yshx;
linear: [adj]线的,线性的;直线的;长度的; [a]/ˈlɪniər/; [or]yshx;
probe: [v]探测,探索; [n]探索,调查;探针,探测器; [a]/proʊb/; [or]yshx;
recommendation: [n]推荐,建议,介绍,推荐信; [a]/ˌrekəmenˈdeɪʃn/; [or]yshx;
cherish: [v]珍爱,珍视;抱有(希望); [a]/ˈtʃerɪʃ/; [or]yshx;
assume: [v]猜想;以为,假设;呈现;就职;(想当然地)认为;承担(责任); [a]/əˈsuːm/; [or]yshx;
sicken: [vi]患病;恶心;厌倦; [vt]使生病;令.恶心;使厌恶; [a]/ˈsɪkən/; [or]yshx;
souvenir: [n]纪念物,纪念品; [vt]把.留作纪念; [a]/ˈsuːvənɪr/; [or]yshx;
compulsory: [adj]强制的,必修的; [a]/kəmˈpʌlsəri/; [or]yshx;
consign: [v]托运,托卖,寄存; [a]/kənˈsaɪn/; [or]yshx;
bizarre: [adj]稀奇古怪的; [a]/bɪˈzɑːr/; [or]yshx;
overrun: [v]溢出,泛滥;(侵略军)横行; [n]泛滥成灾;超出限度; [a]/ˈoʊvərʌn/; [or]yshx;
let alone: [phr]听任;不打扰;更别说; [a]/let əˈloʊn/; [or]yshx;
propulsion: [n]推进力; [a]/prəˈpʌlʃn/; [or]yshx;
majority: [n]多数,大多数,多数票;法定成年年龄; [a]/məˈdʒɔːrəti/; [or]yshx;
tunnel: [n]隧道; [v]挖地道; [a]/ˈtʌnl/; [or]yshx;
sympathetic: [adj]有同情心的,同情的;支持的;称心的; [a]/ˌsɪmpəˈθetɪk/; [or]yshx;
crack: [v]敲出裂痕,敲破;垮掉;断裂,折断;说(笑话); [n]裂缝;破裂声;挖苦话;强效纯可卡因; [adj]最好的,一流的; [adv]尖锐地; [vi]断裂,折断; [a]/kræk/; [or]yshx;
neat: [adj]整洁的;灵巧的;纯的;不掺水的;干净利索的 (行动); [a]/niːt/; [or]yshx;
issue: [n]问题;议题;发行物;子女; [v]发行;发布;分配,分发,给; [a]/ˈɪʃuː/; [or]yshx;
lament: [v]哀悼;惋惜;悲叹; [n]悲叹;悼词; [a]/ləˈment/; [or]yshx;
let oneself go: [v]尽情,情不自禁; [a]/let wʌnˈself ɡoʊ/; [or]yshx;
courier: [n]快递员,通讯员,导游; [a]/ˈkʊriər/; [or]yshx;
poise: [v]使相等,使平衡; [n]泰然自若,信心; [a]/pɔɪz/; [or]yshx;
solvent: [adj]有偿付能力的;有溶解力的; [n]溶剂;解决方法; [a]/ˈsɑːlvənt/; [or]yshx;
linger: [v]逗留,留恋; [a]/ˈlɪŋɡər/; [or]yshx;
ratio: [n]比率,比例; [a]/ˈreɪʃioʊ/; [or]yshx;
brand: [n]商标,品牌;烙印; [v]给..打上烙印;归为 (不好的事物); [a]/brænd/; [or]yshx;
counsel: [n]忠告;律师,法律顾问; [v]劝告,提议; [a]/ˈkaʊnsl/; [or]yshx;
roll: [v]滚动,转动;卷;使摇摆;使平坦,压平; [n]卷;卷状物;隆隆声; [a]/roʊl/; [or]yshx;
stick sth. out: [v]伸出; [a]/stɪk ˈsʌmθɪŋ aʊt/; [or]yshx;
slander: [n]诽谤,诋毁; [v]讲坏话,污蔑,诽谤; [a]/ˈslændər/; [or]yshx;
transfer: [v]转移;调任;换乘;转变;改编; [n]转让;转移;调任;汇兑; [a]/trænsˈfɜːr/; [or]yshx;
alongside: [adv]在旁边,并排地,并肩地; prep. 在.旁边,和.并排;和.一起; [a]/əˌlɔːŋˈsaɪd/; [or]yshx;
revolt: [v]反抗,叛乱,厌恶;造反;反抗;厌恶; [n]背叛;厌恶;反叛; [a]/rɪˈvoʊlt/; [or]yshx;
adjust: [v]调整,调节;校正;改变.以适应; [a]/əˈdʒʌst/; [or]yshx;
naked: [adj]裸体的,无遮蔽的; [a]/ˈneɪkɪd/; [or]yshx;
carton: [n](尤指装食品和液体的)硬纸盒,纸板箱,塑料箱; [a]/ˈkɑːrtn/; [or]yshx;
exterior: [n]外表;外貌,外观; [adj]外部的;外界的;位于外边的;外交上的; [a]/ɪkˈstɪriər/; [or]yshx;
bold: [adj]大胆的,勇敢的;无耻的,放肆的;醒目的; [n]粗体字; [a]/boʊld/; [or]yshx;
range: [n]排;变动范围;山脉;放牧场;射程;范围; [vi]排成一排; [vt]排列; [adj]牧场的; [a]/reɪndʒ/; [or]yshx;
mess: [n]凌乱状态,混乱状态;肮脏,污秽;困境;食堂;大量某物; [v]弄脏,弄乱;浪费时间,瞎闹; [a]/mes/; [or]yshx;
cease: [v]停止,结束; [n]停止,停息; [a]/siːs/; [or]yshx;
flabby: [adj](肌肉)松软的,意志薄弱的; [adv]肌肉松垂地,肥胖地; [n](肌肉等)不结实,松弛; [a]/ˈflæbi/; [or]yshx;
scrape: [n]擦伤;刮,擦; [v]刮,擦; [a]/skreɪp/; [or]yshx;
vehicle: [n]交通工具,机动车;传播媒介;工具,手段; [a]/ˈviːəkl/; [or]yshx;
stick up: [phr]竖起; [a]/stɪk ʌp/; [or]yshx;
ownership: [n]所有权; [a]/ˈoʊnərʃɪp/; [or]yshx;
remnant: [n]遗迹;边角剩料; [a]/ˈremnənt/; [or]yshx;
extravagant: [adj]奢侈的,无节制的; [a]/ɪkˈstrævəɡənt/; [or]yshx;
see eye to eye (with): [v]看法完全一致; [a]/siː aɪ tu aɪ wɪθ/; [or]yshx;
sparse: [adj]稀少的;稀疏的; [a]/spɑːrs/; [or]yshx;
distribute: [v]分发,分配,配送;散布; [a]/dɪˈstrɪbjuːt/; [or]yshx;
plank: [n]厚木板;木板制成物;政纲条款;要点; [v]在..上铺板;砰一声放下;用菜板端出; [a]/plæŋk/; [or]yshx;
porch: [n]门廊;走廊; [a]/pɔːrtʃ/; [or]yshx;
expand: [v]膨胀;扩大; [vt]详细展开; [a]/ɪkˈspænd/; [or]yshx;
bust: [n]半身塑像;胸部; [v]打碎;搜捕;降级;终止; [adj]破产的;打碎的; [a]/bʌst/; [or]yshx;
open one's eyes to: [phr]使某人看清; [a]/ˈoʊpən wʌnz aɪz tu/; [or]yshx;
intrigue: [n]阴谋;诡计; [v]密谋;欺骗;引起极大兴趣; [a]/ɪnˈtriːɡ/; [or]yshx;
reclaim: [v]开拓,开垦;感化;取回;改造;废物回收利用; [a]/rɪˈkleɪm/; [or]yshx;
raft: [n]木筏;救生艇; [a]/ræft/; [or]yshx;
essential: [adj]必不可少的,必要的;本质的;重要的;基本的; [n]要素;必需品; [a]/ɪˈsenʃl/; [or]yshx;
mold: [vt]塑造;使形成; [v]把..塑造成; [n]霉菌;模子;气质; [a]/moʊld/; [or]yshx;
mutual: [adj]互相的;彼此的;共同的; [a]/ˈmjuːtʃuəl/; [or]yshx;
layout: [n]布局;(版面)设计; [a]/ˈleɪaʊt/; [or]yshx;
toss: [v]扔,抛,掷; [n]掷,掷钱币来决定,猛抬头; [a]/tɔːs/; [or]yshx;
on account of: [phr]因为; [a]/ɑːn ə'kaʊnt əv/; [or]yshx;
mind one's own business: [v]少管闲事;各人自扫门前雪; [a]/maɪnd wʌnz oʊn ˈbɪznəs/; [or]yshx;
vicinity: [n]附近地区;近邻;附近; [a]/vəˈsɪnəti/; [or]yshx;
pragmatic: [adj]国事的,团体事务的;实际的,注重实效的; [n]爱管闲事的人;专断的人;国事诏书;实际家; [a]/præɡˈmætɪk/; [or]yshx;
lethal: [adj]致命的,致死的;杀伤性的; [n]致死因子; [a]/ˈliːθl/; [or]yshx;
accuse: [v]指责;控告;把..归咎于; [a]/əˈkjuːz/; [or]yshx;
tackle: [v]对付,处理;(足球等比赛中)阻截; [n]阻截;钓具;滑轮(组); [a]/ˈtækl/; [or]yshx;
imitate: [v]模仿; [a]/ˈɪmɪteɪt/; [or]yshx;
bibliography: [n]参考书目;文献学; [a]/ˌbɪbliˈɑːɡrəfi/; [or]yshx;
compile: [v]收集,汇编; [a]/kəmˈpaɪl/; [or]yshx;
maiden: [n](文学)少女,未嫁女子; [adj]未婚的,处女的,初次的; [a]/ˈmeɪdn/; [or]yshx;
array: [n]一系列;陈列;编队; [v]排列;部署; [a]/əˈreɪ/; [or]yshx;
grumble: [v]埋怨;发牢骚;咕哝; [n]隆隆响声;抱怨,怨言; [a]/ˈɡrʌmbl/; [or]yshx;
janitor: [n]看门人;清洁工; [a]/ˈdʒænɪtər/; [or]yshx;
judicial: [adj]司法的,法庭的,法律的,审判(上)的; [a]/dʒuˈdɪʃl/; [or]yshx;
succumb: [v]屈从,屈服,因.死亡(to); [a]/səˈkʌm/; [or]yshx;
pay off: [v]付清;取得成功,使得益;贿赂;报复; [a]/peɪ ɔːf/; [or]yshx;
transgress: [v]冒犯,违背;侵犯;越界; [a]/trænzˈɡres/; [or]yshx;
rail: [n]铁轨;扶手,栏杆; [v]咒骂; [a]/reɪl/; [or]yshx;
manual: [n]手册;指南; [adj]手的;手制的;手工的;体力的; [a]/ˈmænjuəl/; [or]yshx;
anchor: [n]担任(广播电视新闻节目)的主持人;支柱;锚; [v]抛锚; [vt]使固定; [a]/ˈæŋkər/; [or]yshx;
sort sth. out: [phr]分类,拣选,整理;解决;消除误会; [a]/sɔːrt ˈsʌmθɪŋ aʊt/; [or]yshx;
gaunt: [adj]憔悴的,瘦削的; [n]憔悴,荒凉; [a]/ɡɔːnt/; [or]yshx;
phenomenal: [adj]非凡的;现象的;显著的; [a]/fəˈnɑːmɪnl/; [or]yshx;
whip: [vt]鞭打,抽打;突然拿取,猛然抓住;痛责;驱使;怂恿; [v]一下子猛地移动,急走,急冲; [n]鞭子;抽打;组织秘书;蛋奶水果甜点心; [a]/wɪp/; [or]yshx;
horticulture: [n]园艺;园艺学; [a]/ˈhɔːrtɪkʌltʃər/; [or]yshx;
minimal: [adj]最低限度的; [a]/ˈmɪnɪməl/; [or]yshx;
mourn: [v]哀悼,哀伤; [a]/mɔːrn/; [or]yshx;
disperse: [v]使散开;分散,散开; [a]/dɪˈspɜːrs/; [or]yshx;
flaw: [n]瑕疵;缺点; [v]使有缺陷;使不完美;有瑕疵; [a]/flɔː/; [or]yshx;
heighten: [v]加强,增加,提高; [a]/ˈhaɪtn/; [or]yshx;
humiliate: [vt]使蒙耻;使丢脸;羞辱; [a]/hjuːˈmɪlieɪt/; [or]yshx;
generate: [v]产生(热,电等能量),创造; [a]/ˈdʒenəreɪt/; [or]yshx;
output: [n]产量,输出; [vt]生产,出产,制造;输出; [vi]生产,出产,制造;输出; [a]/ˈaʊtpʊt/; [or]yshx;
beat: [v]敲打;打败;打;(心脏)跳动;搅拌; [n]敲打;拍子; [adj]精疲力竭的,疲惫不堪的;垮掉的,属于"垮掉的一代"的; [a]/biːt/; [or]yshx;
in favour of: prep. 赞成;以.为收款人; [a]/ɪn ˈfeɪvər ɑv/; [or]yshx;
sterilize: [vt]消毒;使不孕;使(土地)不毛; [a]/ˈsterəlaɪz/; [or]yshx;
misfortune: [n]不幸,灾祸; [a]/ˌmɪsˈfɔːrtʃuːn/; [or]yshx;
geometry: [n]几何学;几何形状; [a]/dʒiˈɑːmətri/; [or]yshx;
subtract: [v]减少;减去;扣除; [vt]减去; [a]/səbˈtrækt/; [or]yshx;
assure: [v]向..保证,使确信;保证,确保; [a]/əˈʃʊr/; [or]yshx;
ritual: [n](宗教等的)仪式,例行公事,老规矩; [adj]作为仪式一部分的,例行的; [a]/ˈrɪtʃuəl/; [or]yshx;
vicious: [adj]罪恶的;恶意的;凶猛的,残忍的; [a]/ˈvɪʃəs/; [or]yshx;
epoch: [n]时期;新时代; [a]/ˈepək/; [or]yshx;
tease: [v]取笑;挑逗;逗弄;使..渴望;逆梳; [n]爱戏弄别人者; [a]/tiːz/; [or]yshx;
repent: [v](对某事或行为感到)悔恨;后悔;悔改; [adj][植]匍匐生根的;[动]爬行的; [a]/rɪˈpent/; [or]yshx;
on end: [adv]直立; [a]/ɔn end/; [or]yshx;
puzzle: [n]拼图;谜;迷惑;难题; [v]使迷惑; [a]/ˈpʌzl/; [or]yshx;
grieve: [v]伤心,悲痛; [vi]使悲伤,使伤心; [a]/ɡriːv/; [or]yshx;
deadlock: [vt](使)相持不下; [vi]僵持; [n]僵局;不分胜负; [a]/ˈdedlɑːk/; [or]yshx;
tournament: [n]锦标赛,联赛;比赛; [a]/ˈtʊrnəmənt/; [or]yshx;
nurture: [v]养育,培育;培植; [n]养育,培养;教养;营养物; [a]/ˈnɜːrtʃər/; [or]yshx;
abridge: [v]删节;削减; [a]/əˈbrɪdʒ/; [or]yshx;
pick sth. up: [v]买;得到;知道;捡起; [a]/pɪk ˈsʌmθɪŋ ʌp/; [or]yshx;
clip: [n]回形针,夹子;(电影,广播,电视节目的)片段; [v]夹住;删剪;剪辑; [a]/klɪp/; [or]yshx;
nautical: [adj]航海的;海上的;海员的; [a]/ˈnɔːtɪkl/; [or]yshx;
reticent: [adj]沉默不语的;有保留的;含蓄的; [a]/ˈretɪsnt/; [or]yshx;
pottery: [n]陶器;陶艺;陶艺厂; [a]/ˈpɑːtəri/; [or]yshx;
sting: [v]叮;刺疼;使苦闷;蜇; [n](因被刺而引起的)疼痛;(警方为抓捕罪犯精心设计的)圈套; [a]/stɪŋ/; [or]yshx;
productive: [adj]多产的;产生..的;富有成效的; [a]/prəˈdʌktɪv/; [or]yshx;
flare: [v]燃烧(摇曳着);突然发怒; [n]照明弹;摇曳的火焰;闪光信号; [a]/fler/; [or]yshx;
appointment: [n]约会,会面;委派;任命的职位;接受委派者;制定; [a]/əˈpɔɪntmənt/; [or]yshx;
stereo: [n]立体声(装置); [adj]立体声的; [a]/ˈsterioʊ/; [or]yshx;
promise: [n]诺言;有成功希望的预示;允诺的事; [vt]保证,允诺; [vi]有指望;允诺,保证; [a]/ˈprɑːmɪs/; [or]yshx;
finance: [v]资金供给,筹措资金; [n]金融,财政,资金; [a]/ˈfaɪnæns/; [or]yshx;
have (get) the upper hand: [v]取得优势,占上风; [a]/hæv ɡet ði ˈʌpər hænd/; [or]yshx;
panorama: [n]全景,概观; [a]/ˌpænəˈræmə/; [or]yshx;
description: [n]描写,形容,叙述;种类,类型; [a]/dɪˈskrɪpʃn/; [or]yshx;
go for sb.: [v]去请(人);袭击; [a]/ɡoʊ fɔːr ˈsʌmbədi/; [or]yshx;
redundant: [adj]多余的,过剩的;被下岗的; [a]/rɪˈdʌndənt/; [or]yshx;
auction: [n]拍卖; [v]拍卖; [a]/ˈɔːkʃn/; [or]yshx;
from the outset: [adv]从一开始; [a]/frɒm ðə ˈaʊtˌset/; [or]yshx;
bunch: [n]束;串;群,伙; [v]集中,挤在一起;使成一束(或一群等); [a]/bʌntʃ/; [or]yshx;
subscribe: [vi]捐款;订阅;认购(股份); [vt]申请; [a]/səbˈskraɪb/; [or]yshx;
inherit: [v]经遗传而得(特性等);接受遗产;沿袭;继任; [a]/ɪnˈherɪt/; [or]yshx;
equator: [n]赤道; [a]/ɪˈkweɪtər/; [or]yshx;
audible: [adj]听得见的; [a]/ˈɔːdəbl/; [or]yshx;
grill: [n]烤架; [v]烤;拷问; [a]/ɡrɪl/; [or]yshx;
flexible: [adj]易曲的,柔软的,灵活的; [a]/ˈfleksəbl/; [or]yshx;
amaze: [v]使惊奇,使惊诧; [a]/əˈmeɪz/; [or]yshx;
torch: [n]手电筒;火把,火炬; [v]放火烧,纵火烧(建筑物或汽车); [a]/tɔːrtʃ/; [or]yshx;
deficiency: [n]缺乏,不足;缺陷; [a]/dɪˈfɪʃnsi/; [or]yshx;
versus: prep. 以..为对手;与..相对,与..相比; [a]/ˈvɜːrsəs/; [or]yshx;
apply: [v]涂,敷;应用;申请; [a]/əˈplaɪ/; [or]yshx;
gymnasium: [n]体育馆,健身房; [a]/dʒɪmˈneɪziəm/; [or]yshx;
loan: [n]贷款;暂借; [v]借贷; [a]/loʊn/; [or]yshx;
garment: [n]服装; [vt]给 ... 披上衣服;覆上...; [a]/ˈɡɑːrmənt/; [or]yshx;
reserve: [n]储备;保留;保护区; [v]保留;预定;储备; [a]/rɪˈzɜːrv/; [or]yshx;
anyhow: [adv]不论用何种方法,无论如何;随意地;尽管如此; [a]/ˈenihaʊ/; [or]yshx;
tender: [adj]温柔的;嫩的;柔弱的,脆弱的;痛的; [n]煤水车,附属船;投标; [v]提出(希望对方接受的意见等); [a]/ˈtendər/; [or]yshx;
eke: [v](极小幅度地)增加;放长;(艰难地)取得; [a]/iːk/; [or]yshx;
myriad: [n]无数;极大数量; [adj]无数的; [a]/ˈmɪriəd/; [or]yshx;
toxic: [n]毒物; [adj]有毒的;中毒的; [a]/ˈtɑːksɪk/; [or]yshx;
scout: [v]侦察;监视;嘲笑; [n]童子军,侦察员,守卫; [a]/skaʊt/; [or]yshx;
gust: [n]阵风,(感情的)迸发,汹涌; [v]猛吹; [a]/ɡʌst/; [or]yshx;
meadow: [n]草地; [a]/ˈmedoʊ/; [or]yshx;
champion: [n]冠军;拥护者,战士; [v]拥护;保卫;为..而斗争; [adj]夺得第一名的;优胜的; [a]/ˈtʃæmpiən/; [or]yshx;
alloy: [n]合金; [v]使成合金; [a]/ˈælɔɪ/; [or]yshx;
assess: [v]评估;估值; [a]/əˈses/; [or]yshx;
at a stroke: [adv]一下子; [a]/ət ə stroʊk/; [or]yshx;
fatigue: [n]疲乏,劳累; [a]/fəˈtiːɡ/; [or]yshx;
slit: [n]投币口,裂缝; [v]切开; [a]/slɪt/; [or]yshx;
precise: [adj]精确的;恰好的; [a]/prɪˈsaɪs/; [or]yshx;
presentation: [n]演讲;报告;介绍;颁奖仪式; [a]/ˌpriːzenˈteɪʃn/; [or]yshx;
poultry: [n]家禽(肉); [a]/ˈpoʊltri/; [or]yshx;
misappropriate: [v]滥用,误用; [adj]=inappropriate; [a]/ˌmɪsəˈproʊprieɪt/; [or]yshx;
fixture: [n]固定装置;体育项目; [a]/ˈfɪkstʃər/; [or]yshx;
blaze: [vi]熊熊燃烧;闪耀;怒视;连续射击; [vt]大肆宣扬; [n]火焰; [a]/bleɪz/; [or]yshx;
make the best of a bad job: [v]尽力把损失减少到最小; [a]/meɪk ðə best ɑv ə bæd dʒɑb/; [or]yshx;
loath: [adj]不愿意的; [a]/loʊθ/; [or]yshx;
in the air: [phr]在空中;悬而未决;在流传中; [a]/ɪn ðə er/; [or]yshx;
stationary: [adj]静止的;固定的; [n]定居者,驻军; [a]/ˈsteɪʃəneri/; [or]yshx;
publicity: [n]公开(性),公众的关注;宣传;名声; [a]/pʌbˈlɪsəti/; [or]yshx;
headstrong: [adj]任性的;顽固的; [a]/ˈhedstrɔːŋ/; [or]yshx;
generous: [adj]慷慨的;充裕的,宽厚的;肥沃的; [a]/ˈdʒenərəs/; [or]yshx;
endurance: [n]忍耐力,耐性,耐用度; [a]/ɪnˈdʊrəns/; [or]yshx;
bay: [n]海湾,港湾;困境; [vi](尤指猎犬等)吠,叫,咆哮;筑堤遏(水); [v]穷追,使陷入绝境;阻止(敌人)不使前进;向.吠叫; [adj]赤褐色的,栗色的; [a]/beɪ/; [or]yshx;
in line for: [adv]即可得到;排队; [a]/ɪn laɪn fɔr/; [or]yshx;
stationery: [n]文具;(有配套信封的)信纸; [a]/ˈsteɪʃəneri/; [or]yshx;
numerate: [v]列举;读(数); [adj]有计算能力的,数学基础好的; [a]/ˈnuːmərət/; [or]yshx;
communication: [n]沟通方式;交流,通讯;信息; [a]/kəˌmjuːnɪˈkeɪʃn/; [or]yshx;
bully: [n]恃强欺弱者; [v]欺负; [a]/ˈbʊli/; [or]yshx;
reckon with sb.: [v]清算;将.加以考虑,认真对待; [a]/ˈrekən wɪθ ˈsʌmbədi/; [or]yshx;
fatal: [adj]致命的;毁灭性的;决定性的; [a]/ˈfeɪtl/; [or]yshx;
hostage: [n]人质; [a]/ˈhɑːstɪdʒ/; [or]yshx;
tough: [adj]坚韧的;健壮的;嚼不动的;棘手的;困难的; [adv]强硬地,顽强地; [n]暴徒,恶棍; [v]坚持,忍受; [a]/tʌf/; [or]yshx;
blend: [v]混合;把.混成一体; [n]混合物; [a]/blend/; [or]yshx;
tablet: [n]药片;便笺簿;碑,匾; [a]/ˈtæblət/; [or]yshx;
scissors: [n]剪刀; [a]/ˈsɪzərz/; [or]yshx;
soar: [v]高飞,翱翔;飞腾;猛增;高飞越过; [n]高飞;高涨; [a]/sɔːr/; [or]yshx;
latitude: [n]纬度;地区;(言论,行动的)自由; [a]/ˈlætɪtuːd/; [or]yshx;
unique: [adj]独特的,独一无二的;(唯一的)特有的;不同寻常的; [a]/juˈniːk/; [or]yshx;
roar: [n]吼叫声,怒号声,轰鸣声; [vi]吼叫;咆哮; [vt]大声呼喊; [a]/rɔːr/; [or]yshx;
bearing: [n]方向;举止;轴承; [a]/ˈberɪŋ/; [or]yshx;
apprentice: [v]使当学徒; [n]学徒; [a]/əˈprentɪs/; [or]yshx;
blink: [v]眨眼睛;闪亮;闪烁; [n]眨眼睛; [a]/blɪŋk/; [or]yshx;
exhaust: [v]使筋疲力尽;耗尽;详尽论述; [n]排气装置;废气; [a]/ɪɡˈzɔːst/; [or]yshx;
compute: [v]计算,估计; [a]/kəmˈpjuːt/; [or]yshx;
converge: [v](向某一点)相交,会合;汇集,聚集,集中; [a]/kənˈvɜːrdʒ/; [or]yshx;
formidable: [adj]令人畏惧的;可怕的;难以克服的;难应付的; [a]/ˈfɔːrmɪdəbl/; [or]yshx;
emphasize: [v]强调;着重;使突出; [a]/ˈemfəsaɪz/; [or]yshx;
recite: [vi]背诵;朗诵; [vt]背诵;朗诵;叙述;列举; [a]/rɪˈsaɪt/; [or]yshx;
combustible: [adj]易燃的;易激动的; [n]可燃物;易燃物; [a]/kəmˈbʌstəbl/; [or]yshx;
avalanche: [n]雪崩;大量拥至; [vi]崩塌; [a]/ˈævəlæntʃ/; [or]yshx;
discrepancy: [n]不一致,差异,不符; [a]/dɪsˈkrepənsi/; [or]yshx;
susceptible: [adj]易受感染的;易受影响的;多情的; [a]/səˈseptəbl/; [or]yshx;
vanquish: [v]征服,击败; [a]/ˈvæŋkwɪʃ/; [or]yshx;
tangle: [v](使)缠结;(使)乱作一团; [n]纠缠;纠结;复杂的问题;困惑; [a]/ˈtæŋɡl/; [or]yshx;
gape: [n]裂口,张嘴,打哈欠; [v]目瞪口呆地凝视,打哈欠,张开,裂开; [a]/ɡeɪp/; [or]yshx;
graphic: [adj]形象的;图表的; [n]图,图表; [a]/ˈɡræfɪk/; [or]yshx;
dwarf: [n]侏儒; [v]变矮;发育不全; [adj]矮生动物或植物的;矮小的;发育不全的; [vt]使矮小;阻碍.的发育; [a]/dwɔːrf/; [or]yshx;
envy: [n]妒忌;妒忌的对象; [v]嫉妒,羡慕; [a]/ˈenvi/; [or]yshx;
reckless: [adj]不顾虑的;鲁莽的,不顾后果的; [a]/ˈrekləs/; [or]yshx;
juvenile: [n]青少年;雏鸟; [adj]青少年的;幼稚的; [a]/ˈdʒuːvənl/; [or]yshx;
bunk: [n](火车等)床铺,铺位,卧铺;骗人的话,废话; [v]睡(在床铺上),去睡; [a]/bʌŋk/; [or]yshx;
once more: [adv]再一次; [a]/wʌns mɔr/; [or]yshx;
curb: [v]勒住;抑制;控制;约束; [n]路缘;控制;约束; [a]/kɜːrb/; [or]yshx;
come across sb.(sth.): [v]偶然碰见; [a]/kʌm əˈkrɑːs ˈsʌmbədi ˈsʌmθɪŋ/; [or]yshx;
howl: [v](狼,狗等)嗥叫;(风等)呼啸;(因愤怒,痛苦等)吼叫,哀号; [n]嚎叫,哀号; [a]/haʊl/; [or]yshx;
formulate: [v]构想出(计划,方法等);系统地阐述; [a]/ˈfɔːrmjuleɪt/; [or]yshx;
erase: [v](计算机)擦除;抹去;擦掉; [a]/ɪˈreɪs/; [or]yshx;
token: [n]象征;礼券,代金券;筹码,代币; [adj]象征性的; [a]/ˈtoʊkən/; [or]yshx;
at all times: [adv]经常,一直;无论何时; [a]/ət ɔl taɪmz/; [or]yshx;
tropic: [n]热带,回归线; [adj]热带的; [a]/ˈtrɑːpɪk/; [or]yshx;
species: [n](单复同)物种;种类;人类; [adj]物种上的; [a]/ˈspiːʃiːz/; [or]yshx;
levy: [v]征收(税等); [n]征税;税款; [a]/ˈlevi/; [or]yshx;
retreat: [v]撤退,撤离,(被迫)退却,后退; [n]撤退,退却,隐退;休养所,收容所;躲藏处; [a]/rɪˈtriːt/; [or]yshx;
display: [v]展示;显示;陈列; [n]表现,流露,展示;显示,显示器;陈列品; [a]/dɪˈspleɪ/; [or]yshx;
make sb. out to be: [v]把.说成; [a]/meɪk ˈsʌmbədi aʊt tu bi/; [or]yshx;
cosmic: [adj]宇宙的;广大无边的; [a]/ˈkɑːzmɪk/; [or]yshx;
pole: [n]杆,竿极(点);磁极;电极; [a]/poʊl/; [or]yshx;
bar: [n]酒吧;(金属)棒;闩;障碍;柜台; [vt]阻挡;禁止;闩住; prep. 除.之外; [a]/bɑːr/; [or]yshx;
despatch: [v]发送;派遣;打败; [n](公文)急件;(记者发回的)新闻报道;派遣; [a]/dɪˈspætʃ/; [or]yshx;
gown: [n]女礼服;女裙服;长袍; [a]/ɡaʊn/; [or]yshx;
blame: [v]责备,把..归咎于; [n]责备,过失; [a]/bleɪm/; [or]yshx;
cue: [n]提示;暗号;球杆; [v]给.提示; [a]/kjuː/; [or]yshx;
literacy: [n]读写能力;识字;有文化;教养; [a]/ˈlɪtərəsi/; [or]yshx;
federation: [n]同盟,联盟,联邦; [a]/ˌfedəˈreɪʃn/; [or]yshx;
afford: [v]买得起;抽得出时间;担负得起;提供;产生;赐予; [vi]担负得起;买得起; [a]/əˈfɔːrd/; [or]yshx;
swell: [v](使)膨胀,(使)鼓起; [n]增大,膨胀,肿胀,汹涌; [adj]时髦的;一流的;很好的; [a]/swel/; [or]yshx;
impulse: [n]冲动,脉冲,驱使; [a]/ˈɪmpʌls/; [or]yshx;
clue: [n]线索;提示;暗示; [vt]为..提供线索; [a]/kluː/; [or]yshx;
take after sb.: [v]像某人; [a]/teɪk ˈæftər ˈsʌmbədi/; [or]yshx;
gossip: [n]流言蜚语,爱传流言的人; [v]闲聊,传播流言蜚语; [a]/ˈɡɑːsɪp/; [or]yshx;
pull through: [phr]渡过难关;恢复健康; [a]/pʊl θru/; [or]yshx;
decrease: [v]减少;减; [n]减;减少; [a]/dɪˈkriːs/; [or]yshx;
masculine: [adj]男性的;男子气概的; [a]/ˈmæskjəlɪn/; [or]yshx;
pension: [n]养老金,抚恤金;廉租屋; [v]发给..养老金; [a]/ˈpenʃn/; [or]yshx;
verge: [n]边缘;边界; [v]接近;濒临; [a]/vɜːrdʒ/; [or]yshx;
suspense: [n]悬疑;焦虑;悬念;悬而未决; [adj]令人挂心的,令人心焦的,产生悬念的; [a]/səˈspens/; [or]yshx;
bouquet: [n]花束,(酒的)芳香; [a]/buˈkeɪ/; [or]yshx;
clarify: [v]阐明,澄清;净化; [a]/ˈklærəfaɪ/; [or]yshx;
mentality: [n]脑力;思想;心理; [a]/menˈtæləti/; [or]yshx;
referendum: [n]公民投票,复决权; [a]/ˌrefəˈrendəm/; [or]yshx;
falter: [v]蹒跚,摇摆;踌躇;畏缩; [n]踌躇;支吾;颤抖; [a]/ˈfɔːltər/; [or]yshx;
cast: [v]投;抛下,投射(光线和阴影);瞥,飞快看(一眼),扫视;掷;放钓;投票;选定演员; [n]投掷物;铸件;演员表,演员阵容; [a]/kæst/; [or]yshx;
reel: [n]卷盘; [v]旋转;感到震惊;眩晕; [a]/riːl/; [or]yshx;
jury: [n]陪审团;全体评审员,评判委员会; [a]/ˈdʒʊri/; [or]yshx;
fluent: [adj]流畅的,(说话)流利的;顺畅的,流畅熟练的; [a]/ˈfluːənt/; [or]yshx;
propagate: [v]繁殖,增殖; [vt]传播,宣传; [a]/ˈprɑːpəɡeɪt/; [or]yshx;
funnel: [n]漏斗;烟囱; [v]汇集;通过漏斗等;(使)成漏斗形; [a]/ˈfʌnl/; [or]yshx;
protocol: [n]外交礼节;草案;外交议定书; [vi]拟定议定书; [vt]把.写入议定书; [a]/ˈproʊtəkɔːl/; [or]yshx;
mustache: [n]髭,小胡子;触须; [a]/ˈmʌstæʃ/; [or]yshx;
genius: [n]天才;天资,天赋;才华; [a]/ˈdʒiːniəs/; [or]yshx;
irritate: [v]使烦躁;激怒;使难受; [a]/ˈɪrɪteɪt/; [or]yshx;
residence: [n]住宅,居住,居留权; [a]/ˈrezɪdəns/; [or]yshx;
missile: [n]导弹;投射出的物体或武器; [adj]导弹的;可投掷的;用以发射导弹的; [a]/ˈmɪsl/; [or]yshx;
brilliant: [adj]聪颖的;卓越的,有才气的;明亮的; [a]/ˈbrɪliənt/; [or]yshx;
viable: [adj]可行的;能养活的;能生育的; [a]/ˈvaɪəbl/; [or]yshx;
facilitate: [v]为他人提供方便;使便利; [vt]促进; [a]/fəˈsɪlɪteɪt/; [or]yshx;
yawn: [v]打呵欠;裂开;打着呵欠说; [n]呵欠;乏味或枯燥的事物; [a]/jɔːn/; [or]yshx;
torture: [v]对.施以酷刑,拷问,折磨; [n]酷刑,折磨; [adj]遭受重创的;饱受煎熬的; [a]/ˈtɔːrtʃər/; [or]yshx;
microfilm: [n]微缩胶片; [v]缩微拍摄; [a]/ˈmaɪkroʊfɪlm/; [or]yshx;
couch: [n]长沙发;长椅;长榻; [v]表达; [a]/kaʊtʃ/; [or]yshx;
heir: [n]继承人;后继者; [a]/er/; [or]yshx;
hike: [n]远足,徒步旅行;(数量,价格等)增加,上升; [v]作长途徒步旅行;使高涨,提高(价格); [a]/haɪk/; [or]yshx;
microcosm: [n]微观世界,缩影; [a]/ˈmaɪkroʊkɑːzəm/; [or]yshx;
plunder: [v]抢劫,掠夺; [n]抢劫,战利品; [a]/ˈplʌndər/; [or]yshx;
commend: [v]称赞;推荐;委托保管; [a]/kəˈmend/; [or]yshx;
parallel: [adj]平行的;相似的; [n]相似物;平行线; [v]与..相似;与..匹配; [adv]并行地,平行地; [a]/ˈpærəlel/; [or]yshx;
theme: [n]主题;主旨;主旋律; [adj]主题的; [v]赋予.某种主题; [a]/θiːm/; [or]yshx;
merit: [n]优点;价值;功绩; [v]值得;应得; [a]/ˈmerɪt/; [or]yshx;
radical: [n]激进分子;基础;原子团;根数,根式; [adj]重大的,彻底的;激进的; [a]/ˈrædɪkl/; [or]yshx;
make sb. up: [v]化妆; [a]/meɪk ˈsʌmbədi ʌp/; [or]yshx;
fleeting: [adj]短暂的,飞逝的; [a]/ˈfliːtɪŋ/; [or]yshx;
pedal: [n]踏脚板; [v]踏踩板; [adj]脚踏的; [vt]踏.的踏板; [a]/ˈpedl/; [or]yshx;
miracle: [n]奇迹; [a]/ˈmɪrəkl/; [or]yshx;
criminal: [n]罪犯; [adj]犯罪的,违法的,刑法的;可耻的; [a]/ˈkrɪmɪnl/; [or]yshx;
diligent: [adj]勤奋的;用功的; [a]/ˈdɪlɪdʒənt/; [or]yshx;
give sth. up: [v]放弃;戒烟; [a]/ɡɪv ˈsʌmθɪŋ ʌp/; [or]yshx;
at a loose end: [adv]不知做什么好; [a]/ət ə lus end/; [or]yshx;
commonwealth: [n]联邦; [a]/ˈkɑːmənwelθ/; [or]yshx;
elsewhere: [adv]在别处,向别处; [a]/ˌelsˈwer/; [or]yshx;
practitioner: [n](医生或律师等)开业者;实践者,从事者; [a]/prækˈtɪʃənər/; [or]yshx;
trustworthy: [adj]可信赖的,可靠的; [a]/ˈtrʌstwɜːrði/; [or]yshx;
turbulent: [adj]湍急的;混乱的,动荡的;骚动的; [a]/ˈtɜːrbjələnt/; [or]yshx;
vacation: [n]休假,假期; [v]休假,度假; [a]/veɪˈkeɪʃn/; [or]yshx;
kindle: [v]点燃,激起;着火;照亮;煽动; [a]/ˈkɪndl/; [or]yshx;
aisle: [n](席位间的)通道,过道; [a]/aɪl/; [or]yshx;
hinge: [n]铰链; [v]靠铰链转动; [a]/hɪndʒ/; [or]yshx;
ultimatum: [n]最后通牒; [a]/ˌʌltɪˈmeɪtəm/; [or]yshx;
breeze: [n]微风,清风;轻而易举的事; [v]飘然而行;轻松通过; [a]/briːz/; [or]yshx;
delicate: [adj]易碎的,易坏的,脆弱的;(人)娇弱的,体弱多病的;精美的,精致的,精巧的;微妙的,需要谨慎处理的;优美的,优雅的;柔和的,清淡的,淡雅的; [a]/ˈdelɪkət/; [or]yshx;
pretentious: [adj]做作的,自命不凡的,炫耀的; [a]/prɪˈtenʃəs/; [or]yshx;
album: [n]相册;唱片集,专辑;集邮册; [a]/ˈælbəm/; [or]yshx;
configuration: [n]配置,布局,构造; [a]/kənˌfɪɡjəˈreɪʃn/; [or]yshx;
compare: [v]比较,比作; [n]比较;对照; [a]/kəmˈper/; [or]yshx;
livestock: [n]家畜,牲畜; [a]/ˈlaɪvstɑːk/; [or]yshx;
compensate: [v]补偿,赔偿,给..报酬; [a]/ˈkɑːmpenseɪt/; [or]yshx;
pay up: [v]付清,结账; [a]/peɪ ʌp/; [or]yshx;
marvelous: [adj]非凡的;叹为观止的,令人惊奇的; [n]怪事; [a]/ˈmɑːrvələs/; [or]yshx;
yoke: [n]牛轭;枷锁;纽带; [v]结合;连结; [a]/joʊk/; [or]yshx;
fundamental: [adj]基本的,根本的;重要的;基础的; [n]基本原理;基本原则; [a]/ˌfʌndəˈmentl/; [or]yshx;
tap: [n]塞子;水龙头;轻敲; [v]轻叩,轻敲;监听,窃听 (电话);开发,发掘;利用; [a]/tæp/; [or]yshx;
choir: [n](教会的)歌唱队,唱诗班; [a]/ˈkwaɪər/; [or]yshx;
saddle: [n]鞍;鞍部; [v]给马装鞍具;装鞍具;使负重担; [a]/ˈsædl/; [or]yshx;
cavity: [n]洞;龋洞; [a]/ˈkævəti/; [or]yshx;
battery: [n]电池(组);排炮;一组,许多,众多; [a]/ˈbætəri/; [or]yshx;
postmortem: [n]验尸,尸体解剖; [adj]事后的,死后的,事后检查或详论的; [a]/ˌpoʊs(t)ˈmɔrtəm/; [or]yshx;
set about sth.: [v]着手; [a]/siː əˈbaʊt ˈsʌmθɪŋ/; [or]yshx;
solo: [n]独唱; [adj]独奏的;单独的; [adv]独奏地;单独地; [v]放单飞; [a]/ˈsoʊloʊ/; [or]yshx;
quantitative: [adj]定量的; [a]/ˈkwɑːntəteɪtɪv/; [or]yshx;
somewhat: [adv]有点儿,稍微,有些; [pron]某物;一些; [a]/ˈsʌmwʌt/; [or]yshx;
commotion: [n]骚动,动乱; [a]/kəˈmoʊʃn/; [or]yshx;
highlight: [vt]使突出,强调,高亮; [n]最精彩的部分,最重要的事件; [a]/ˈhaɪlaɪt/; [or]yshx;
aggregate: [n]合计;总数;混凝料;总计; [v]集合;聚集;合计; [adj]总的,总数的;集合的; [a]/ˈæɡrɪɡət/; [or]yshx;
inquire: [v]打听,询问;调查; [a]/ɪn'kwaɪər/; [or]yshx;
paradox: [n]矛盾;似矛盾而正确的说法; [a]/ˈpærədɑːks/; [or]yshx;
fruition: [n]享有;最后完成,实现,取得成果; [a]/fruˈɪʃn/; [or]yshx;
depart: [v]离开;起程;出发;起程;出发;离职; [a]/dɪˈpɑːrt/; [or]yshx;
gauge: [n]测量仪;尺度,标准; [v]估计,判断;计量; [a]/ɡeɪdʒ/; [or]yshx;
keep to: [v]履行诺言;限制自己;坚持; [a]/kip tu/; [or]yshx;
innocent: [adj]天真的,单纯的;无辜的,清白的;无恶意的; [n]天真无邪的人; [a]/ˈɪnəsnt/; [or]yshx;
live on: [phr]以.为主食;靠.生活; [a]/liːv ɑːn/; [or]yshx;
ultraviolet: [adj]紫外线;紫外线的; [a]/ˌʌltrəˈvaɪələt/; [or]yshx;
athlete: [n]运动员,体育家,强壮的人; [a]/ˈæθliːt/; [or]yshx;
raw: [adj]生的,未煮过的;未加工的;(因皮肤开裂)疼痛的; [a]/rɔː/; [or]yshx;
repetition: [n]重复,反复; [a]/ˌrepəˈtɪʃn/; [or]yshx;
expend: [v]消费,用尽; [a]/ɪkˈspend/; [or]yshx;
paramount: [n]元首;最高; [adj]最高的,至上的,首要的; [a]/ˈpærəmaʊnt/; [or]yshx;
on hand: [adv]手头现有; [a]/ɔn hænd/; [or]yshx;
drastic: [adj]极端的;猛烈的;激烈的; [a]/ˈdræstɪk/; [or]yshx;
glossary: [n]词汇表,术语汇编; [a]/ˈɡlɑːsəri/; [or]yshx;
lawn: [n]草地;草坪;(衣服用)细麻; [a]/lɔːn/; [or]yshx;
swirl: [n]漩涡;打旋;涡状形; [v]盘绕;打旋;眩晕;大口喝酒; [a]/swɜːrl/; [or]yshx;
agitation: [n]摇动;焦虑,忧虑;煽动; [a]/ˌædʒɪˈteɪʃn/; [or]yshx;
eliminate: [v]消灭,铲除;消除,根除;(在比赛中)淘汰; [a]/ɪˈlɪmɪneɪt/; [or]yshx;
oust: [v]罢免,驱逐,剥夺,取代; [a]/aʊst/; [or]yshx;
hang up: [phr]挂断电话; [a]/hæŋ ʌp/; [or]yshx;
original: [adj]有独创性的,原始的,最初的,新颖的; [n]原件;怪人; [a]/əˈrɪdʒənl/; [or]yshx;
erosion: [n]侵蚀;腐蚀;磨损;削弱;减少; [a]/ɪˈroʊʒn/; [or]yshx;
comment: [n]评论,议论;批评,意见;注解; [vt]评论; [vi]进行评论;为.作评语; [a]/ˈkɑːment/; [or]yshx;
haphazard: [adj]偶然的;随意的;凑合的;胡乱的; [a]/hæpˈhæzərd/; [or]yshx;
invariably: [adv]总是;不变地,永恒地; [a]/ɪnˈveriəbli/; [or]yshx;
relevant: [adj]有关的;恰当的;贴切的; [a]/ˈreləvənt/; [or]yshx;
gorgeous: [adj]绚丽的;极好的;令人愉快的; [a]/ˈɡɔːrdʒəs/; [or]yshx;
assassination: [n]暗杀; [a]/əˌsæsəˈneɪʃn/; [or]yshx;
scan: [v]细看;浏览;扫描; [n]扫描;浏览; [a]/skæn/; [or]yshx;
weird: [adj]古怪的;荒唐的; [a]/wɪrd/; [or]yshx;
brittle: [adj]易碎的;脆弱的;靠不住的; [n]薄片脆糖; [a]/ˈbrɪtl/; [or]yshx;
grope: [v]摸索,探索,动手动脚; [a]/ɡroʊp/; [or]yshx;
split: [n]劈裂;裂缝;碎片;分裂;不和; [adj]分裂的;不一致的; [v]分开;裂开;被撕破;劈开;割开;撕裂;分配;分担;使分裂; [a]/splɪt/; [or]yshx;
welfare: [n]福利;幸福,健康; [a]/ˈwelfer/; [or]yshx;
site: [n]场所;地点;网站;现场; [vt]给.造址,坐落于; [a]/saɪt/; [or]yshx;
trunk: [n]树干;象鼻;(人)躯干;大衣箱;主体;(车的)后备箱;汽车车尾的行李箱; [a]/trʌŋk/; [or]yshx;
inept: [adj]无能的;不称职的;笨拙的; [a]/ɪˈnept/; [or]yshx;
notation: [n]记号;标记法;记录; [a]/noʊˈteɪʃn/; [or]yshx;
dilute: [v]使变淡,稀释;使病弱; [a]/daɪˈluːt/; [or]yshx;
flirt: [n]急扔;调情者; [vi]卖弄风情,调情;戏弄,不认真地对待;摆动; [vt]急速摆动,挥动; [a]/flɜːrt/; [or]yshx;
propaganda: [n]宣传;宣传方法; [a]/ˌprɑːpəˈɡændə/; [or]yshx;
contemporary: [adj]同时代的;当代的,现代的; [n]同龄人,同时代的人; [a]/kənˈtempəreri/; [or]yshx;
knit: [v]编结,针织; [n]编织的衣服;针织衫; [a]/nɪt/; [or]yshx;
insane: [adj]精神失常的,疯狂的;精神病患者的;荒唐的; [n]精神失常的人;精神错乱的人; [a]/ɪnˈseɪn/; [or]yshx;
call it a day: [v]收工; [a]/kɔl ɪt ə deɪ/; [or]yshx;
null and void: [phr]无效的; [a]/nʌl ənd vɔɪd/; [or]yshx;
mildew: [vt]使发霉; [vi]发霉,长霉; [n]霉,霉菌; [adj]发霉的; [a]/ˈmɪlduː/; [or]yshx;
reckon on: [phr]依赖;估计;计划;指望; [a]/ˈrekən ɔn/; [or]yshx;
Arctic: [n]北极; [adj]北极的,极寒的; [a]/ˈɑːrktɪk/; [or]yshx;
make one's day: [phr]使某人快活; [a]/meɪk wʌnz deɪ/; [or]yshx;
maternal: [adj]母亲的,母性的;母方的,母系的; [a]/məˈtɜːrnl/; [or]yshx;
underestimate: [v]低估;对.估计不足; [a]/ˌʌndərˈestɪmeɪt/; [or]yshx;
vocational: [adj]职业的;业务的; [a]/voʊˈkeɪʃənl/; [or]yshx;
clutch: [v]抓住;紧握; [n]抓住;离合器; [a]/klʌtʃ/; [or]yshx;
available: [adj]可得到的,可利用的,有空的,有效的; [a]/əˈveɪləbl/; [or]yshx;
sustain: [v]维持;支撑,承受;供养;忍受;遭受,蒙受; [a]/səˈsteɪn/; [or]yshx;
postpone: [v]延迟,推迟,延缓; [a]/poʊˈspoʊn/; [or]yshx;
baggage: [n]行李; [a]/ˈbæɡɪdʒ/; [or]yshx;
balance: [n]平衡;称;平静;和谐;余额; [v]保持平衡;使平衡;补偿; [a]/ˈbæləns/; [or]yshx;
anniversary: [n]周年纪念日; [adj]周年的,(有关)周年纪念的; [a]/ˌænɪˈvɜːrsəri/; [or]yshx;
ore: [n]矿石;矿砂;矿,矿石; [a]/ɔːr/; [or]yshx;
capacity: [n]产能;容量;本领;才能;负载量;职位; [a]/kəˈpæsəti/; [or]yshx;
prodigious: [adj]异常的,奇妙的;巨大的; [a]/prəˈdɪdʒəs/; [or]yshx;
butcher: [n]屠夫,肉贩子;刽子手; [v]屠宰;屠戮,残杀; [a]/ˈbʊtʃər/; [or]yshx;
diploma: [n]毕业文凭,毕业证书;文凭课程; [a]/dɪˈploʊmə/; [or]yshx;
aware: [adj]意识到的,知道的; [a]/əˈwer/; [or]yshx;
have the makings of: [v]具有成为.所需要的素质; [a]/həv ðə ˈmeɪkɪŋz ɑv/; [or]yshx;
come (bring) sth. to light: [v]显露,揭露; [a]/kʌm brɪŋ ˈsʌmθɪŋ tu laɪt/; [or]yshx;
drawback: [n]缺点;障碍,不利条件; [a]/ˈdrɔːbæk/; [or]yshx;
chapel: [n]小教堂;私人祈祷室; [a]/ˈtʃæpl/; [or]yshx;
condemn: [v]谴责,责备;判(某人某罪); [a]/kənˈdem/; [or]yshx;
crown: [n]王冠,冕;王权;花冠; [v]加冕; [a]/kraʊn/; [or]yshx;
conspiracy: [n]密谋,阴谋; [a]/kənˈspɪrəsi/; [or]yshx;
drain: [vi]排出,排水; [v]流干,沥干;喝光,耗尽,减少,消逝; [vt]使流出,排掉水; [n]下水道,排水管;消耗,排水; [a]/dreɪn/; [or]yshx;
be in two minds about sth.: [adj]犹豫不决; [a]/biː ɪn tuː maɪndz əˈbaʊt ˈsʌmθɪŋ/; [or]yshx;
delete: [v]删除; [a]/dɪˈliːt/; [or]yshx;
obnoxious: [adj]非常讨厌的;可憎的; [a]/əbˈnɑːkʃəs/; [or]yshx;
chord: [n]和弦;和音;心弦;(数学)弦; [a]/kɔːrd/; [or]yshx;
superfluous: [adj]多余的,过剩的;不必要的; [a]/suːˈpɜːrfluəs/; [or]yshx;
steamer: [n]蒸汽船;蒸锅; [a]/ˈstiːmər/; [or]yshx;
nominate: [v]提名;任命; [adj]有特定名字的;被提名的;被指定的; [a]/ˈnɑːmɪneɪt/; [or]yshx;
enrich: [v]使丰富;使富裕; [a]/ɪnˈrɪtʃ/; [or]yshx;
diffuse: [v]传播;扩散,弥漫;漫射; [adj]四散的,散开的;不清楚的; [a]/dɪˈfjuːz/; [or]yshx;
decent: [adj]体面的;像样的;合宜的;正直的; [a]/ˈdiːsnt/; [or]yshx;
acid: [n][化学]酸;酸性物质;尖酸; [adj]尖刻的;敏锐的;含酸过多的;酸的;酸味的; [a]/ˈæsɪd/; [or]yshx;
discreet: [adj]谨慎的;思虑周全的,小心的; [a]/dɪˈskriːt/; [or]yshx;
slot: [n]狭缝,狭槽,(机构的)职位; [v]把.放入狭长开口中,把.纳入; [a]/slɑːt/; [or]yshx;
ambulance: [n]救护车; [a]/ˈæmbjələns/; [or]yshx;
come about: [phr]发生; [a]/kʌm ə'baʊt/; [or]yshx;
jog: [v]慢跑;轻碰; [n]轻推,慢跑,漫步; [a]/dʒɑːɡ/; [or]yshx;
abrupt: [adj]突然的;唐突的;鲁莽的; [a]/əˈbrʌpt/; [or]yshx;
discount: [n](价格,债款等)折扣; [v]打折扣,不全信,怀疑地看待; [a]/ˈdɪskaʊnt/; [or]yshx;
coward: [n]懦夫,胆小鬼; [adj]懦弱的,胆怯的; [a]/ˈkaʊərd/; [or]yshx;
nutrition: [n]营养,营养学; [a]/nuˈtrɪʃn/; [or]yshx;
chief: [n]老板,头子;主管;(部落) 首领;酋长;长官; [adj]主要的;首席的; [a]/tʃiːf/; [or]yshx;
decade: [n]十年,十年间; [a]/ˈdekeɪd/; [or]yshx;
hold out (against): [phr]坚持(反抗),顶住; [a]/hoʊld aʊt əˈɡeɪnst/; [or]yshx;
estate: [n]地产,(上有大片建筑物的)土地,住宅,财产,遗产; [a]/ɪˈsteɪt/; [or]yshx;
yacht: [n]游艇;帆船; [a]/jɑːt/; [or]yshx;
exaggerate: [vi]夸张; [vt]夸大,夸张;使扩大; [a]/ɪɡˈzædʒəreɪt/; [or]yshx;
weld: [v]焊接;使结合,使成整体; [n]焊接; [a]/weld/; [or]yshx;
inflict: [v]使遭受(损伤,痛苦等);使承担(负担等); [a]/ɪnˈflɪkt/; [or]yshx;
go (very) far: [phr]成功;扬名;大有前途; [a]/ɡoʊ ˈveri fɑːr/; [or]yshx;
ardent: [adj]热心的,热烈的; [a]/ˈɑːrdnt/; [or]yshx;
claim: [v]声称;要求;断言;主张;认领;索赔; [n]索赔;主张;声称;断言;要求; [a]/kleɪm/; [or]yshx;
pump: [v]抽水,抽取;用泵输送;向.灌注;盘问; [n]打气筒;泵,抽水(机);胶底帆布鞋; [a]/pʌmp/; [or]yshx;
exacerbate: [v]加重;恶化;激怒; [a]/ɪɡˈzæsərbeɪt/; [or]yshx;
comprise: [v]包含,包括;构成; [a]/kəmˈpraɪz/; [or]yshx;
clumsy: [adj]笨拙的,不灵活的;拙劣的,不得体的; [a]/ˈklʌmzi/; [or]yshx;
abandon: [v]抛弃;放弃;放纵; [a]/əˈbændən/; [or]yshx;
steadfast: [adj]坚定的;不变的; [a]/ˈstedfæst/; [or]yshx;
solidarity: [n]团结一致; [a]/ˌsɑːlɪˈdærəti/; [or]yshx;
synthetic: [adj]合成的,人造的;[语]综合型的,综合性的,借助词尾变化表示句法关系的; [n]合成物; [a]/sɪnˈθetɪk/; [or]yshx;
compound: [n]复合物;[化学]化合物; [adj]合成的;复合的;多功能的; [vi]妥协;和解; [vt]混合;调和;调停;使恶化; [a]/ˈkɑːmpaʊnd/; [or]yshx;
sacrifice: [vt]牺牲;祭献; [vi]奉献;做出牺牲; [n]祭品;牺牲; [a]/ˈsækrɪfaɪs/; [or]yshx;
valuation: [n]估价,评价,鉴定;估定的价值,定价; [a]/ˌvæljuˈeɪʃn/; [or]yshx;
merge into: [phr]合并;结合; [a]/mɜrdʒ ˈɪntu/; [or]yshx;
gaudy: [n]华丽而俗气的廉价饰物; [adj](服饰,装饰,文风等)华丽而俗气的;浮华的;过分显眼的; [a]/ˈɡɔːdi/; [or]yshx;
fake: [adj]假的,伪造的; [n]骗子;假货,赝品; [v]假造,杜撰;伪造;冒充,假装;假装; [a]/feɪk/; [or]yshx;
dairy: [n]牛奶场;乳制品; [adj]牛奶的,奶制的; [a]/ˈderi/; [or]yshx;
glitter: [v]闪闪发光,闪耀; [n]灿烂的光辉,闪光; [a]/ˈɡlɪtər/; [or]yshx;
picturesque: [adj]似画的,生动的; [a]/ˌpɪktʃəˈresk/; [or]yshx;
artillery: [n]大炮,炮兵; [a]/ɑːrˈtɪləri/; [or]yshx;
pointed: [adj]尖锐的;率直的; [a]/ˈpɔɪntɪd/; [or]yshx;
geology: [n]地质学,(某一地区的)地质; [a]/dʒiˈɑːlədʒi/; [or]yshx;
pull over: [v]开到路边; [a]/pʊl ˈoʊvər/; [or]yshx;
booth: [n]小舍;隔开的小间;公用电话亭;有篷的售货摊;窝棚; [a]/buːθ/; [or]yshx;
remedy: [v]治疗;恢复;补救; [n]治疗;补救;矫正; [a]/ˈremədi/; [or]yshx;
pertinent: [adj]有关的;适当的;中肯的; [n]附属物;参考; [a]/ˈpɜːrtnənt/; [or]yshx;
decrepit: [adj]衰老的,破旧的; [a]/dɪˈkrepɪt/; [or]yshx;
illusion: [n]假象,幻象;幻想;错误观念; [a]/ɪˈluːʒn/; [or]yshx;
veto: [v]否决;投反对票; [n]否决;否决权;禁止; [a]/ˈviːtoʊ/; [or]yshx;
allege: [v]断言;硬说; [a]/əˈledʒ/; [or]yshx;
track: [v]跟踪追赶;用纤拉船; [n]跑道;小路;行动路线;足迹;轨道; [a]/træk/; [or]yshx;
bug: [n][计算机](制作软件程序所产生的意料不到的)错误,故障;窃听器;热衷于(某事)者;臭虫,小虫子; [v]使厌烦,打扰;窃听; [vt]使烦恼,纠缠; [a]/bʌɡ/; [or]yshx;
applaud: [v]鼓掌; [vi]喝彩; [vt]向.鼓掌表示赞赏;给.捧场; [a]/əˈplɔːd/; [or]yshx;
live through: [phr]度过; [a]/lɪv θru/; [or]yshx;
discipline: [n]纪律;学科;训练; [v]训练;惩罚;管制; [a]/ˈdɪsəplɪn/; [or]yshx;
look back (on sth.): [phr]回顾; [a]/lʊk bæk ɒn ˈsʌmθɪŋ/; [or]yshx;
incorporate: [v]包含;使并入; [a]/ɪnˈkɔːrpəreɪt/; [or]yshx;
unfold: [v]展开,伸展;表露,显露; [a]/ʌnˈfoʊld/; [or]yshx;
pull oneself together: [v]振作起来;恢复镇定; [a]/pʊl wʌnˈself təˈɡeðər/; [or]yshx;
fantastic: [adj]极好的;极大的;不真实的;荒诞离奇的;不可思议的; [n]〈古〉古怪的人; [a]/fænˈtæstɪk/; [or]yshx;
leave sb. (sth.) behind: [phr]忘带,留下; [a]/liːv ˈsʌmbədi ˈsʌmθɪŋ bɪˈhaɪnd/; [or]yshx;
cradle: [n]摇篮;策源地,发源地; [v]轻轻地抱,捧; [a]/ˈkreɪdl/; [or]yshx;
particle: [n]粒子,微粒;[语]小品词; [a]/ˈpɑːrtɪkl/; [or]yshx;
reciprocal: [adj]相互的,互惠的; [n]倒数;互相关联的事物; [a]/rɪˈsɪprəkl/; [or]yshx;
disgust: [v]使作呕,使厌恶; [n]恶心; [a]/dɪsˈɡʌst/; [or]yshx;
suspicious: [adj]可疑的,引起怀疑的;怀疑的,猜疑的; [a]/səˈspɪʃəs/; [or]yshx;
deflect: [v](使)偏斜,(使)偏转; [a]/dɪˈflekt/; [or]yshx;
hasty: [adj]匆忙的;仓促完成的;草率的; [a]/ˈheɪsti/; [or]yshx;
have to do with: [v]与.有关; [a]/hæv tə dʊ wɪð/; [or]yshx;
mount: [v]登上;爬上;骑上;增长;组织,安排; [n]山;峰; [a]/maʊnt/; [or]yshx;
distinguish: [v]区别,识别,辨别,使显著; [a]/dɪˈstɪŋɡwɪʃ/; [or]yshx;
clear away: [v]把.除掉; [a]/klɪr əˈweɪ/; [or]yshx;
memento: [n]纪念品; [a]/məˈmentoʊ/; [or]yshx;
cluster: [n]一串;一簇; [v]群集;丛生; [a]/ˈklʌstər/; [or]yshx;
phase out: [v]逐渐淘汰; [a]/feɪz aʊt/; [or]yshx;
concrete: [n]混凝土; [adj]具体的,实质性的; [v]给 (道路等) 浇混凝土; [a]/ˈkɑːŋkriːt/; [or]yshx;
get round sth.: [v]规避(法律),避开; [a]/ɡet raʊnd ˈsʌmθɪŋ/; [or]yshx;
cellar: [n]地窖;地下室;酒窖; [a]/ˈselər/; [or]yshx;
fickle: [adj](在感情等方面)反复无常的,轻浮的,善变的; [a]/ˈfɪkl/; [or]yshx;
courtesy: [n]礼貌; [a]/ˈkɜːrtəsi/; [or]yshx;
likewise: [adv]同样地,此外; [a]/ˈlaɪkwaɪz/; [or]yshx;
authentic: [adj]真实的;真正的;可靠的; [a]/ɔːˈθentɪk/; [or]yshx;
grip: [v]握紧,抓牢; [n]紧握,握力; [a]/ɡrɪp/; [or]yshx;
pave: [v]铺(路),铺筑; [a]/peɪv/; [or]yshx;
lucrative: [adj]合算的;获利的;有利可图的; [a]/ˈluːkrətɪv/; [or]yshx;
foresee: [v]预知,预料,预测; [a]/fɔːrˈsiː/; [or]yshx;
irony: [n]反语;冷嘲;具有讽刺意味的事; [a]/ˈaɪrəni/; [or]yshx;
deduct: [v]减去; [a]/dɪˈdʌkt/; [or]yshx;
sore: [adj]疼痛的,酸痛的;恼火的; [n]疮; [adv]〈古,诗〉同"sorely. a sore throat"; [a]/sɔːr/; [or]yshx;
endorse: [v]赞同,认可;签注(文件); [a]/ɪnˈdɔːrs/; [or]yshx;
aerial: [adj]飞机的,航空的,由飞机进行的;空中的,架空的; [n]天线; [a]/ˈeriəl/; [or]yshx;
eject: [v](使)弹出;喷射;放逐; [a]/iˈdʒekt/; [or]yshx;
berth: [n]停泊处;卧铺;[口语]职业; [v]使停泊; [a]/bɜːrθ/; [or]yshx;
cushion: [n]坐垫; [v]减轻,缓和; [a]/ˈkʊʃn/; [or]yshx;
massacre: [n]大屠杀,残杀;惨败; [v]屠杀;彻底击败; [a]/ˈmæsəkər/; [or]yshx;
precarious: [adj]不稳定的;危险的;可疑的;说不定的; [a]/prɪˈkeriəs/; [or]yshx;
infect: [v]传染,感染;使受影响; [a]/ɪnˈfekt/; [or]yshx;
cynical: [adj]愤世嫉俗的;恶意的;悲观的; [a]/ˈsɪnɪkl/; [or]yshx;
boom: [n]隆隆声;繁荣;景气;激增; [v]发出低沉有回响的声音;迅速发展,蓬勃发展;以低沉有回响的声音发出; [a]/buːm/; [or]yshx;
plow: [v]犁,耕; [n]犁; [a]/plau/; [or]yshx;
pompous: [adj]傲慢的,浮华的; [a]/ˈpɑːmpəs/; [or]yshx;
adore: [v]很喜欢,极喜爱;崇拜;爱慕; [a]/əˈdɔːr/; [or]yshx;
suitcase: [n]小提箱,手提箱; [a]/ˈsuːtkeɪs/; [or]yshx;
exemplify: [v]举例说明;例示,是..的典范; [a]/ɪɡˈzemplɪfaɪ/; [or]yshx;
alien: [n]外国人;外星人; [adj]陌生的;外国的,外星(人)的;异己的,不相容的; [a]/ˈeɪliən/; [or]yshx;
get through: [v]完成;穿过;(成功)渡过(困难时期);打通(电话); [a]/ɡet θru/; [or]yshx;
involve: [v]牵涉,涉及;卷入,使参与;吸引;包含,需要,影响; [a]/ɪnˈvɑːlv/; [or]yshx;
peel: [v]剥皮,削皮,去壳; [n]果皮,外皮; [a]/piːl/; [or]yshx;
creep: [vi]爬行;潜入;蔓延;变形;毛发直竖; [n]卑鄙小人;爬行;变形;毛骨悚然的感觉; [a]/kriːp/; [or]yshx;
all out: [phr]全力以赴; [a]/ˌɔːl ˈaʊt/; [or]yshx;
unanimous: [adj]全体一致的;一致同意的; [a]/juˈnænɪməs/; [or]yshx;
chamber: [n]会议室;(作特殊用途的)房间;议院; [a]/ˈtʃeɪmbər/; [or]yshx;
inferior: [adj](等级,地位等)下等的,低等的;低劣的; [n]部下,地位低的人;次品; [a]/ɪnˈfɪriər/; [or]yshx;
call for: [v]需要;邀请;呼吁; [a]/kɔːl fɔr/; [or]yshx;
frail: [adj]脆弱的,不坚实的; [n]少妇;灯心草篓;灯心草篓的容量; [a]/freɪl/; [or]yshx;
keep sb. on: [v]继续雇用某人; [a]/kiːp ˈsʌmbədi ɔːn/; [or]yshx;
expire: [v]期满,(期限)终止;断气,死亡; [a]/ɪkˈspaɪər/; [or]yshx;
jail: [n]监狱;看守所; [v]监禁;拘留; [a]/dʒeɪl/; [or]yshx;
utmost: [adj]最大的;极度的;最远的; [n]极限; [a]/ˈʌtmoʊst/; [or]yshx;
errand: [n]差使;差事;使命; [a]/ˈerənd/; [or]yshx;
lick: [v]舔;卷烧;战胜;使无法理解;轻轻拍打; [vi]舔; [n]舔;舌头一次舔的量;狠揍; [a]/lɪk/; [or]yshx;
neurotic: [adj]神经质的;神经官能病的; [n]神经病患者; [a]/nʊˈrɑːtɪk/; [or]yshx;
combat: [n]战斗,格斗; [v]与.战斗,与.斗争; [adj]战斗的; [a]/ˈkɑːmbæt/; [or]yshx;
hint: [v]作暗示;透露; [n]暗示,示意;建议; [a]/hɪnt/; [or]yshx;
racket: [n]吵闹声;球拍; [v]嚷闹,吵闹,纵情欢闹;用球拍打; [a]/ˈrækɪt/; [or]yshx;
straightforward: [adj]坦率的,笔直的,正直的,直接的; [a]/ˌstreɪtˈfɔːrwərd/; [or]yshx;
savage: [n]野蛮人,粗鲁的人; [adj]凶猛的,猛烈的;野蛮的;未驯化的; [v](狗等)乱咬;激烈抨击; [a]/ˈsævɪdʒ/; [or]yshx;
catch on: [phr]变得流行;理解; [a]/kætʃ ɔn/; [or]yshx;
circumference: [n]圆周长度,圆周;周围; [a]/sərˈkʌmfərəns/; [or]yshx;
mosaic: [n]镶嵌细工,马赛克; [adj]摩西的;拼花的; [vt]镶嵌;用马赛克装饰; [a]/moʊˈzeɪɪk/; [or]yshx;
elite: [n]精英; [adj]高级的; [a]/ɪˈliːt/; [or]yshx;
overflow: [v]满得外溢,外流,泛滥;充满,洋溢; [n]溢流口,溢流管;容纳不下的物(或人);溢出,满出;超出额; [adj]充满的; [a]/ˌoʊvərˈfloʊ/; [or]yshx;
decompose: [v](使)腐烂;分解; [a]/ˌdiːkəmˈpoʊz/; [or]yshx;
boundary: [n]边界,分界线;使球越过边界线的击球(得加分); [a]/ˈbaʊndri/; [or]yshx;
deceive: [v]欺骗,行骗; [a]/dɪˈsiːv/; [or]yshx;
planetarium: [n]天文馆,行星仪; [a]/ˌplænɪˈteriəm/; [or]yshx;
invaluable: [adj]非常宝贵的,极为贵重的,无价的; [a]/ɪnˈvæljuəbl/; [or]yshx;
dignity: [n]威严,威风;端庄;尊严,高贵; [a]/ˈdɪɡnəti/; [or]yshx;
crush: [vt]压坏;压扁;弄皱;弄碎,压碎;榨出;紧抱;挤入;镇压;欺压; [n]压扁;极度拥挤; [vi]被压坏;被揉皱;蜂拥而来; [a]/krʌʃ/; [or]yshx;
procedure: [n]步骤,过程;程序;手续; [a]/prəˈsiːdʒər/; [or]yshx;
insult: [v]侮辱,凌辱; [n]侮辱的言词或行为; [a]/ɪnˈsʌlt/; [or]yshx;
champagne: [n]香槟酒; [a]/ʃæmˈpeɪn/; [or]yshx;
cliche: [n]陈腐思想,陈词滥调; [adj]陈腐的; [a]/klɪˈʃeɪ/; [or]yshx;
exhort: [vt]敦促,劝告; [vi]规劝,劝告; [a]/ɪɡˈzɔːrt/; [or]yshx;
ovation: [n]热烈欢迎,欢呼; [a]/oʊˈveɪʃn/; [or]yshx;
enforce: [v]实施;执行;强制; [a]/ɪnˈfɔːrs/; [or]yshx;
ghastly: [adj]苍白的,可怕的,令人不快的; [adv]恐怖地,惨白地; [a]/ˈɡæstli/; [or]yshx;
leave off: [v](使)停止; [a]/liv ɑf/; [or]yshx;
consecutive: [adj]连续的,连贯的; [a]/kənˈsekjətɪv/; [or]yshx;
exterminate: [v]消灭,灭绝;根除; [a]/ɪkˈstɜːrmɪneɪt/; [or]yshx;
muster: [vi]集合;聚集; [vt]集合;召集; [n]集合;集合人员; [a]/ˈmʌstər/; [or]yshx;
grind: [v]磨碎,碾碎;折磨;摩擦得吱吱作响; [n]苦差事,苦活儿;磨; [a]/ɡraɪnd/; [or]yshx;
tuition: [n]学费,教学,讲授; [a]/tuˈɪʃn/; [or]yshx;
shrewd: [adj]精明的;机灵的; [n]精明;精明者; [a]/ʃruːd/; [or]yshx;
look after: [phr]照顾,照看; [a]/lʊk ˈæftər/; [or]yshx;
hoist: [v]升起,吊起;向上推; [n]起重机;举起; [a]/hɔɪst/; [or]yshx;
professional: [adj]职业的;专业的; [n]专业人员; [a]/prəˈfeʃənl/; [or]yshx;
on and off: quant. 断断续续地; [a]/ɔn ənd ɑf/; [or]yshx;
spatial: [adj]空间的,关于空间的; [a]/ˈspeɪʃl/; [or]yshx;
foil: [n]箔;锡箔纸;衬托; [v]挫败;使受挫折; [a]/fɔɪl/; [or]yshx;
conceal: [v]隐藏,隐瞒,掩盖; [a]/kənˈsiːl/; [or]yshx;
moreover: [adv]此外,而且; [a]/mɔːrˈoʊvər/; [or]yshx;
snap at sb.: [v]对人厉声说; [a]/snæp æt ˈsʌmbədi/; [or]yshx;
postscript: [n]附言;后评; [a]/ˈpoʊstskrɪpt/; [or]yshx;
tertiary: [adj]第三的,第三级的;第三品级的; [n][地质学]第三纪;第三品级的神职人员; [a]/ˈtɜːrʃieri/; [or]yshx;
renovation: [n]修理;恢复; [a]/ˌrenəˈveɪʃn/; [or]yshx;
settle down: [phr]定居,安定下来; [a]/ˈset(ə)l daʊn/; [or]yshx;
take to sth.(sb.): [phr]喜欢;养成.习惯; [a]/teɪk tu ˈsʌmθɪŋ ˈsʌmbədi/; [or]yshx;
vivid: [adj](颜色)鲜艳的,强烈的(颜色,光);生动的,清晰的(记忆,描述); [a]/ˈvɪvɪd/; [or]yshx;
equal: [adj]相等的;平等的; [v]等于;比得上; [n]对手; [a]/ˈiːkwəl/; [or]yshx;
permanent: [adj]永久的,持久的; [n]电烫发; [a]/ˈpɜːrmənənt/; [or]yshx;
strenuous: [adj]费力的;奋发的;热心的;艰苦的;紧张的; [a]/ˈstrenjuəs/; [or]yshx;
tilt: [v](使)倾斜; [n]倾斜,斜坡; [a]/tɪlt/; [or]yshx;
fervent: [adj]热烈的,满怀热情的;狂热的; [a]/ˈfɜːrvənt/; [or]yshx;
vow: [n]誓约; [v]宣誓;立誓;发誓; [a]/vaʊ/; [or]yshx;
suicide: [n]自杀;自毁; [a]/ˈsuːɪsaɪd/; [or]yshx;
terminate: [adj]终止的;可结尾的; [vi]结束;结尾; [v]使结束,终止; [a]/ˈtɜːrmɪneɪt/; [or]yshx;
contaminate: [v]弄脏,污染; [a]/kənˈtæmɪneɪt/; [or]yshx;
automobile: [n]汽车,机动车; [v]开汽车;坐汽车; [adj]自动的; [a]/ˈɔːtəməbiːl/; [or]yshx;
fetch: [v]取来;接来;使发出;售得;带来;接住; [n]拿来,取来;诡计;风浪区; [a]/fetʃ/; [or]yshx;
module: [n]组件,模件,(航天器的)舱;(组成一门课程的)独立单元; [a]/ˈmɑːdʒuːl/; [or]yshx;
weave: [v]织;编织;编进;织布; [n]织法;织物; [a]/wiːv/; [or]yshx;
turnover: [n]成交量;营业收入;人员更替率;半圆卷饼; [a]/ˈtɜːrnoʊvər/; [or]yshx;
Easter: [n]复活节; [a]/ˈiːstər/; [or]yshx;
campaign: [n](社会性,政治性)活动,运动;战役; [v]从事活动,参加运动; [a]/kæmˈpeɪn/; [or]yshx;
humidity: [n]潮湿;湿气;湿度; [a]/hjuːˈmɪdəti/; [or]yshx;
take sth. out: [v]去掉;取得,取出; [a]/teɪk ˈsʌmθɪŋ aʊt/; [or]yshx;
combine: [v]使混合(结合,组合,联合);结合;联合;组合; [n]联合体,联合企业;联合收割机; [a]/kəmˈbaɪn/; [or]yshx;
leave for: [v]动身去; [a]/liv fɔr/; [or]yshx;
dam: [n]水坝;母兽; [v]用水坝阻止;阻塞,抑制; [a]/dæm/; [or]yshx;
status: [n]地位;状态;身份; [a]/ˈsteɪtəs/; [or]yshx;
palatable: [adj]美味的,合口味的,合心意的; [a]/ˈpælətəbl/; [or]yshx;
noxious: [adj]有害的,有毒的; [a]/ˈnɑːkʃəs/; [or]yshx;
dictate: [v]规定;命令;口授;听写; [n]命令;指令; [a]/ˈdɪkteɪt/; [or]yshx;
bid: [n]出价;投标;努力争取; [v]出价;投标;问候;道别;吩咐; [a]/bɪd/; [or]yshx;
nothing to do with: [v]与.无关; [a]/ˈnʌθɪŋ tu doʊ wɪθ/; [or]yshx;
clear out: [phr]匆忙离开;逃离;清空;腾空; [a]/klɪr aʊt/; [or]yshx;
lofty: [adj]极高的,巍峨的;崇高的;高傲的; [a]/ˈlɔːfti/; [or]yshx;
dot: [n]点,圆点; [v]点缀,作小点记号; [a]/dɑːt/; [or]yshx;
sprint: [v]疾跑,冲刺; [n]全速奔跑; [a]/sprɪnt/; [or]yshx;
opposite: [adj]相反的;对立的;对面的; [adv]对立地;反面地; [n]对立物;反义词; prep. 与.相对;在.对面;与.合演;与.联袂演出; [a]/ˈɑːpəzɪt/; [or]yshx;
hectic: [adj]紧张的,忙碌的;患肺病的;(因患肺病等)发烧的,有病态潮红的;脸上发红,发热的,兴奋的,狂热的,肺病的; [a]/ˈhektɪk/; [or]yshx;
pastime: [n]消遣,娱乐; [a]/ˈpæstaɪm/; [or]yshx;
solemn: [adj]严肃的;庄严的,隆重的;神圣的; [a]/ˈsɑːləm/; [or]yshx;
synthesis: [n]合成; [a]/ˈsɪnθəsɪs/; [or]yshx;
bleach: [v]漂白; [n]漂白剂; [a]/bliːtʃ/; [or]yshx;
out of stock: [v]无存货,已脱销; [a]/aʊt ɑv stɒk/; [or]yshx;
magnitude: [n]巨大;震级;重要性;[数]量值; [a]/ˈmæɡnɪtuːd/; [or]yshx;
take sb. in: [phr]收留;欺骗;带到警察局; [a]/teɪk ˈsʌmbədi ɪn/; [or]yshx;
pregnant: [adj]怀孕的;充满的,意味深长的; [a]/ˈpreɡnənt/; [or]yshx;
female: [adj]女性的;雌性的; [n]女子;雌性动物;雌性植物; [a]/ˈfiːmeɪl/; [or]yshx;
steer: [v]操纵,驾驶,掌舵,引导; [n]公牛,食用牛; [a]/stɪr/; [or]yshx;
ragged: [adj]破旧的;参差不齐的;未梳理的;粗糙的;精疲力竭的; [a]/ˈræɡɪd/; [or]yshx;
chic: [n]时髦,款式别致; [adj]别致的;时髦的; [a]/ʃiːk/; [or]yshx;
spectacular: [adj]壮观的,引人入胜的; [n]壮观的场面,精彩的表演; [a]/spekˈtækjələr/; [or]yshx;
humdrum: [adj]单调的;乏味的; [n]平凡;单调; [vi]单调乏味地进行; [a]/ˈhʌmdrʌm/; [or]yshx;
voltage: [n]电压; [a]/ˈvoʊltɪdʒ/; [or]yshx;
disclose: [v]公开,揭露,泄露; [a]/dɪsˈkloʊz/; [or]yshx;
inland: [adv]在内陆地; [adj]内陆的,国内的; [n]内陆; [a]/ˈɪnlænd/; [or]yshx;
investigate: [v]调查,研究; [a]/ɪnˈvestɪɡeɪt/; [or]yshx;
ascertain: [v]探知,弄清,查明(真相等); [a]/ˌæsərˈteɪn/; [or]yshx;
go about: [v]着手做;四处走动;传开;从事; [a]/ɡoʊ əˈbaʊt/; [or]yshx;
estimate: [v]估价,估计,评价; [n]估计,评价; [a]/ˈestɪmət/; [or]yshx;
postage: [n]邮费,邮资; [a]/ˈpoʊstɪdʒ/; [or]yshx;
enterprise: [n]企业(或事业)单位,公司;事业;事业心; [a]/ˈentərpraɪz/; [or]yshx;
ridiculous: [adj]可笑的,荒谬的; [a]/rɪˈdɪkjələs/; [or]yshx;
deposit: [v]存款,存放;沉淀; [n]存款,定金;沉积物,矿床; [a]/dɪˈpɑːzɪt/; [or]yshx;
hijack: [v]劫持,劫机,拦路抢劫;操纵(会议等,以推销自己的意图); [n]劫持;敲诈;威逼; [a]/ˈhaɪdʒæk/; [or]yshx;
bulletin: [n]公告;公报;公告牌; [a]/ˈbʊlətɪn/; [or]yshx;
go by: [phr]走过,过去;(时间)流逝; [a]/ɡoʊ baɪ/; [or]yshx;
lapse: [n]失误,过失;行为失检;(时间)流逝; [v]退步,倒退,衰退;失效;背弃,放弃(宗教信仰); [a]/læps/; [or]yshx;
boil: [v]烧开,沸腾;用开水煮,在沸水中煮; [n]煮沸,沸腾;疔,疖子;[医]疡肿,脓肿; [a]/bɔɪl/; [or]yshx;
resonant: [adj]洪亮的,共振的,共鸣的; [a]/ˈrezənənt/; [or]yshx;
suspect: [n]嫌疑犯,可疑分子; [v]怀疑,猜疑;推测; [adj]可疑的; [a]/səˈspekt/; [or]yshx;
detach: [v]使分开,拆卸;派遣; [a]/dɪˈtætʃ/; [or]yshx;
crust: [n]外壳,面包皮,硬外皮; [a]/krʌst/; [or]yshx;
helicopter: [n]直升机; [v]用直升飞机载送,乘直升机; [a]/ˈhelɪkɑːptər/; [or]yshx;
bond: [n]束缚物,联结物;凝聚力;债券;保释金;联系; [vi]结合;团结一致; [a]/bɑːnd/; [or]yshx;
abolish: [v]废除,废止;取消,革除; [a]/əˈbɑːlɪʃ/; [or]yshx;
trek: [n]艰苦跋涉; [v]拉(货车),搬运; [a]/trek/; [or]yshx;
precipitate: [v]促成,使..沉淀,猛摔;[气象]凝结; [n]沉淀物,冷凝物; [adj]突如其来的,仓促的,迅猛的;感情用事的; [a]/prɪˈsɪpɪteɪt/; [or]yshx;
spiral: [n]螺旋,螺线; [v]不断急剧地上升(或下降),螺旋形行进; [adj]螺旋的; [a]/ˈspaɪrəl/; [or]yshx;
deliberate: [adj]故意的;深思熟虑的;从容不迫的; [v]仔细考虑;研讨; [a]/dɪˈlɪbərət/; [or]yshx;
circuit: [n]电路,线路;巡游,环形; [a]/ˈsɜːrkɪt/; [or]yshx;
beloved: [n]爱人; [adj]心爱的,所钟爱的;受爱戴的; [a]/bɪˈlʌvɪd/; [or]yshx;
revenue: [n]收入;财政收入;国家的税收; [a]/ˈrevənuː/; [or]yshx;
oriental: [adj]东方的; [n]东方人; [a]/ˌɔːriˈentl/; [or]yshx;
diet: [n]日常饮食;(病人或减肥者的)特种饮食;大量; [v]节食; [a]/ˈdaɪət/; [or]yshx;
intermediate: [adj]中间的,居间的;中级的; [n]中间体,媒介物; [v]调解,干涉; [a]/ˌɪntərˈmiːdiət/; [or]yshx;
clear the air: [v]消除误会; [a]/klɪr ðə er/; [or]yshx;
boil down to: [v]归结起来是,问题是; [a]/bɔɪl daʊn tu/; [or]yshx;
square: [n]正方形;广场; [adj]正方形的;平方的;直角的; [v]把..弄成方形; [adv]直接地; [a]/skwer/; [or]yshx;
cater: [v]供应伙食;为(集会,婚礼等)承办酒席; [a]/ˈkeɪtər/; [or]yshx;
deputy: [n]副手;代表;代表,代理人; [a]/ˈdepjuti/; [or]yshx;
rhythm: [n]节奏;韵律;格律; [a]/ˈrɪðəm/; [or]yshx;
arch: [n]拱洞;拱门;拱起; [v]做成拱形; [adj]调皮的,淘气的; [a]/ɑːrtʃ/; [or]yshx;
surpass: [v]胜过;超出; [a]/sərˈpæs/; [or]yshx;
spit: [v]吐(唾沫); [n]唾液,唾沫,叉子; [a]/spɪt/; [or]yshx;
cast off: [v]解缆放船;抛弃,丢弃; [a]/kæst ɑf/; [or]yshx;
mushroom: [n]蘑菇; [vi]迅速发展;采蘑菇; [a]/ˈmʌʃrʊm/; [or]yshx;
break off (sth.): [v]折断;突然结束; [a]/breɪk ɑːf ˈsʌmθɪŋ/; [or]yshx;
statistics: [n]统计;统计数字,数据;统计学; [a]/stəˈtɪstɪks/; [or]yshx;
offer: [n]提供;特价;出价;录取(用)通知书;提议; [vt]给予,奉上;表示愿意 (做某事);提供;出价; [a]/ˈɔːfər/; [or]yshx;
loaf: [n](一条)面包; [v]虚度光阴; [a]/loʊf/; [or]yshx;
custom: [n]习惯;风俗; [adj]定制的; [a]/ˈkʌstəm/; [or]yshx;
mature: [adj]成熟的;到期的; [vt]使成熟; [vi]成熟; [a]/məˈtʃʊr/; [or]yshx;
outlet: [n]出口;插座;表现机会,发泄方法;廉价经销店; [a]/ˈaʊtlet/; [or]yshx;
pay for: [phr]付出代价,出钱;因.受处罚,为.而付钱; [a]/peɪ fɔr/; [or]yshx;
breakthrough: [n]突破,突破性进展,重要的新发现; [adj]突破性的; [a]/ˈbreɪkθruː/; [or]yshx;
galaxy: [n]星系; [a]/ˈɡæləksi/; [or]yshx;
digest: [v]消化;领会,理解; [n]摘要; [a]/daɪˈdʒest/; [or]yshx;
forge: [n]熔炉;锻工车间;铁匠店; [v]锻造;经锻炼而形成;伪造;推进,加强; [a]/fɔːrdʒ/; [or]yshx;
profuse: [adj]很多的,浪费的;丰富的; [a]/prəˈfjuːs/; [or]yshx;
stall: [n]分隔栏;售货摊;厩; [v]停止(因故障); [a]/stɔːl/; [or]yshx;
adverse: [adj]不利的;(方向上)逆的;在相反的方向上移动(或运转);相反的; [a]/ˈædvɜːrs/; [or]yshx;
reputation: [n]名声;声誉; [a]/ˌrepjuˈteɪʃn/; [or]yshx;
spray: [n]浪花;水雾;喷雾; [vi]飞溅,喷; [vt]喷;向..扫射;散布; [a]/spreɪ/; [or]yshx;
afflict: [v]使痛苦;使苦恼; [a]/əˈflɪkt/; [or]yshx;
segment: [n]部分;片段;(橘子等的)瓣; [v]分割; [a]/ˈseɡmənt/; [or]yshx;
entitle: [v]给(书)题名;给予.权利; [a]/ɪnˈtaɪtl/; [or]yshx;
supreme: [adj]至高的;最重要的;极度的; [a]/suːˈpriːm/; [or]yshx;
terse: [adj]简洁的,简明的; [a]/tɜːrs/; [or]yshx;
aquatic: [adj]水生的,水栖的,水中的,水上的; [n]水生动物,水生植物;水上运动; [a]/əˈkwætɪk/; [or]yshx;
hit it off (with sb./together): [v]一见如故,合得来; [a]/hɪt ɪt ɑːf wɪθ ˈsʌmbədi təˈɡeðər/; [or]yshx;
dip: [v]浸,蘸; [n]倾斜,下降;调味汁; [a]/dɪp/; [or]yshx;
look at: [phr]看,浏览,检查; [a]/lʊk ət/; [or]yshx;
giggle: [v]咯咯地笑,傻笑; [n]咯咯地笑,傻笑; [a]/ˈɡɪɡl/; [or]yshx;
give out: [v]停止;耗尽;分发;产生;发出; [a]/ɡɪv aʊt/; [or]yshx;
passive: [adj]被动的;消极的; [n]被动语态; [a]/ˈpæsɪv/; [or]yshx;
resilience: [n]恢复力;弹力;顺应力; [a]/rɪˈzɪliəns/; [or]yshx;
ease: [n]安逸;容易;不拘束; [v]解除痛苦;缓解;顺利进出; [a]/iːz/; [or]yshx;
knot: [n]绳结,结合,树的节; [v]打结; [a]/nɑːt/; [or]yshx;
apprehension: [n]忧虑,担心,疑惧;逮捕;理解; [a]/ˌæprɪˈhenʃn/; [or]yshx;
regulate: [v]管制,调整,控制; [a]/ˈreɡjuleɪt/; [or]yshx;
bite: [v]咬,叮,螫;剌穿; [n]咬;(咬下的)一口;少量食物;简单的一餐; [a]/baɪt/; [or]yshx;
look forward to: [phr]盼望; [a]/lʊk ˈfɔːrwərd tu/; [or]yshx;
content: [n]内容,目录;满足; [adj]满足的; [v]使满意; [a]/ˈkɑːntent/; [or]yshx;
passion: [n]激情; [a]/ˈpæʃn/; [or]yshx;
trumpet: [n]喇叭,小号;小号声;小号手;传声筒; [v]吹喇叭;发出喇叭般的声音;用喇叭吹出;发喇叭似的声音;大声宣布;宣扬; [a]/ˈtrʌmpɪt/; [or]yshx;
orientate: [v]给.定位;使适应; [a]/ˈɔːriənteɪt/; [or]yshx;
biography: [n]传记文学,传记; [a]/baɪˈɑːɡrəfi/; [or]yshx;
invigilate: [v]监考;监视; [a]/ɪnˈvɪdʒɪleɪt/; [or]yshx;
partial: [adj]偏爱的,特别喜欢的;偏袒的,不公平的,有偏见的;部分的;不完全的; [n][数学]偏微商; [a]/ˈpɑːrʃl/; [or]yshx;
convince: [v]使确信;使信服; [a]/kənˈvɪns/; [or]yshx;
compass: [n]罗盘,指南针;圆规; [v]达到;围绕;图谋; [a]/ˈkʌmpəs/; [or]yshx;
eligible: [adj]适合被选的,符合条件的;(尤指婚姻等)合适的,合意的; [a]/ˈelɪdʒəbl/; [or]yshx;
skim: [v]掠过;浏览,略读;抹去; [n]撇去浮沫;脱脂乳;(为逃税)隐匿的部分收入; [adj]撇去奶油的;用脱脂乳做的; [a]/skɪm/; [or]yshx;
tenancy: [n]租赁;租期; [a]/ˈtenənsi/; [or]yshx;
dump: [v]倾倒,丢弃;抛弃(某人); [n]垃圾场,废物堆;军需品临时堆放的地方; [a]/dʌmp/; [or]yshx;
not to say: [phr]并不是说; [a]/nɑːt tə seɪ/; [or]yshx;
junk: [n]废旧物品,垃圾,假货; [v]把.(当废物)丢弃; [a]/dʒʌŋk/; [or]yshx;
smuggle: [v]非法偷运;走私; [a]/ˈsmʌɡl/; [or]yshx;
audience: [n](演讲,音乐会等的)听众,观众;正式会见;拥护者; [a]/ˈɔːdiəns/; [or]yshx;
idiot: [n]愚蠢的人,白痴; [a]/ˈɪdiət/; [or]yshx;
bleak: [adj]凄凉的;萧瑟的;阴郁的;无希望的; [a]/bliːk/; [or]yshx;
considerable: [adj]相当大的;重要的;可观的; [a]/kənˈsɪdərəbl/; [or]yshx;
accessory: [n](妇女的)装饰品;附件;附属物;同谋; [adj]附属的;辅助的;同谋的; [a]/əkˈsesəri/; [or]yshx;
physician: [n]内科医生; [a]/fɪˈzɪʃn/; [or]yshx;
awkward: [adj]尴尬的;笨拙的;棘手的;不雅观的;不方便的;困难的,危险的; [a]/ˈɔːkwərd/; [or]yshx;
optimism: [n]乐观,乐观主义; [a]/ˈɑːptɪmɪzəm/; [or]yshx;
gist: [n]主旨,要点;依据; [a]/dʒɪst/; [or]yshx;
intricate: [adj]错综复杂的; [a]/ˈɪntrɪkət/; [or]yshx;
closet: [n]橱,壁橱,小储藏室; [v]把.引进密室会谈; [adj]私下的,秘密的; [a]/ˈklɑːzət/; [or]yshx;
havoc: [n](天灾,战争等造成的)大破坏,大毁灭; [vi]损毁; [vt]严重破坏; [a]/ˈhævək/; [or]yshx;
baffle: [v]使困惑;难住;阻碍; [n]挡板; [a]/ˈbæfl/; [or]yshx;
resign: [v]辞职; [a]/rɪˈzaɪn/; [or]yshx;
mercenary: [n]外国雇佣兵;唯利是图者; [adj]唯利是图的;雇佣的; [a]/ˈmɜːrsəneri/; [or]yshx;
be obsessed with: [v](指恐惧等)缠住;使烦扰;对.着迷; [a]/bi əbˈsest wɪð/; [or]yshx;
laden: [adj]装满的;负载的;苦恼的,沉重的; [a]/ˈleɪdn/; [or]yshx;
perceive: [v]意识到,察觉,发觉;看待,理解; [a]/pərˈsiːv/; [or]yshx;
spontaneous: [adj]自发的,无意识的;自然的,天真率直的; [a]/spɑːnˈteɪniəs/; [or]yshx;
nuisance: [n]讨厌的人;麻烦事;伤害; [a]/ˈnuːsns/; [or]yshx;
malnutrition: [n]营养不良; [a]/ˌmælnuːˈtrɪʃn/; [or]yshx;
receipt: [n]收据,收条;收入;收到; [a]/rɪˈsiːt/; [or]yshx;
drill: [n]训练;反复操练;钻头; [v]在..上钻孔;钻孔; [a]/drɪl/; [or]yshx;
nausea: [n]作呕,恶心; [a]/ˈnɔːziə/; [or]yshx;
divine: [adj]神的,神圣的;极好的; [v](凭直觉)发现,猜到; [n]神学家;圣职人员;教士;上帝; [a]/dɪˈvaɪn/; [or]yshx;
canal: [n]运河,河流;水渠;(人体的)导管,食管,气管; [a]/kəˈnæl/; [or]yshx;
behind time: [adj]迟到; [a]/bɪˈhaɪnd taɪm/; [or]yshx;
monsoon: [n]季雨,季风,大雨; [a]/ˌmɑːnˈsuːn/; [or]yshx;
cube: [n]立方体,立方; [a]/kjuːb/; [or]yshx;
all told: [adv]总共; [a]/ɔːl toʊld/; [or]yshx;
render: [v]使成为,致使,使处于(某种状态);提供,给予,以.回报;(以某种方式)表达,表现;翻译;粉刷,往(墙上)抹灰;将(脂肪)熬成油,使熔化; [n]粉刷,打底,交纳; [a]/ˈrendər/; [or]yshx;
proportion: [n]比例;部分;相称; [v]使成比例;分配; [a]/prəˈpɔːrʃn/; [or]yshx;
dimension: [n]维度;尺寸;尺度;方面; [a]/dɪˈmenʃn/; [or]yshx;
placid: [adj]安静的,平和的; [a]/ˈplæsɪd/; [or]yshx;
fault: [n]过失,过错;弱点,缺点;故障,缺陷;(地质学)断层;发球失误; [v]责备,挑错; [a]/fɔːlt/; [or]yshx;
anthem: [n]国歌,赞美诗,圣歌; [a]/ˈænθəm/; [or]yshx;
pine: [n]松树; [v](因死亡,离别等)难过,悲伤; [a]/paɪn/; [or]yshx;
forgive: [v]原谅,饶恕,宽恕;(国家,银行等)免除(债务); [a]/fərˈɡɪv/; [or]yshx;
directory: [n]人名地址录,(电话)号码簿;目录; [a]/dəˈrektəri/; [or]yshx;
consolidate: [v]巩固,加强;把.合为一体; [a]/kənˈsɑːlɪdeɪt/; [or]yshx;
correspond: [v]符合;相符,一致;通信; [a]/ˌkɔːrəˈspɑːnd/; [or]yshx;
flank: [v]位于.的侧面; [n]肋,肋腹,侧翼; [a]/flæŋk/; [or]yshx;
visible: [adj]看得见的,可见的;显然的,明显的; [a]/ˈvɪzəbl/; [or]yshx;
concede: [v]承认;承认失败;让给,让与;让步; [a]/kənˈsiːd/; [or]yshx;
subsequent: [adj]随后的; [a]/ˈsʌbsɪkwənt/; [or]yshx;
elaborate: [adj]精心设计的,精巧的;复杂的; [v]详细说明,详尽阐述; [vt]变得复杂; [a]/ɪˈlæbəreɪt/; [or]yshx;
pick sb. (sth.) out: [v]选出;认出,挑选; [a]/pɪk ˈsʌmbədi ˈsʌmθɪŋ aʊt/; [or]yshx;
thunder: [n]雷,雷声;轰隆声; [v]打雷;大声抱怨,吼叫; [a]/ˈθʌndər/; [or]yshx;
taxation: [n]税制,税项,税款; [a]/tækˈseɪʃn/; [or]yshx;
clockwise: [adj]顺时针方向的; [adv]顺时针方向地; [a]/ˈklɑːkwaɪz/; [or]yshx;
telecommunication: [n]远程通讯; [adj]与电信有关的; [a]/ˌtelikəˌmjuːnɪˈkeɪʃn/; [or]yshx;
objective: [n]目标;目的; [adj]客观的; [a]/əbˈdʒektɪv/; [or]yshx;
keep sth. to oneself: [v]不让他人分享,独自享用; [a]/kiːp ˈsʌmθɪŋ tu wʌnˈself/; [or]yshx;
slag: [n]炉渣,矿渣; [a]/slæɡ/; [or]yshx;
shepherd: [n]牧羊人; [v]带领; [a]/ˈʃepərd/; [or]yshx;
lay sth. aside: [phr]储蓄;放一边; [a]/leɪ ˈsʌmθɪŋ əˈsaɪd/; [or]yshx;
negotiable: [adj]可谈判的,可商议的;可兑换现金的;可通行的(道路,河流); [a]/nɪˈɡoʊʃiəbl/; [or]yshx;
withhold: [v]抑制,拒绝给某事物; [a]/wɪðˈhoʊld/; [or]yshx;
stagnant: [adj]不流动的;停滞的;萧条的; [a]/ˈstæɡnənt/; [or]yshx;
intellectual: [n]知识分子; [adj]智力的;理智的;需用智力的;聪明的; [a]/ˌɪntəˈlektʃuəl/; [or]yshx;
friction: [n]摩擦,摩擦力;争执,冲突; [a]/ˈfrɪkʃn/; [or]yshx;
episode: [n]插曲,片断;连续剧的一集;一段经历; [a]/ˈepɪsoʊd/; [or]yshx;
wilderness: [n]荒野,荒地; [a]/ˈwɪldərnəs/; [or]yshx;
grave: [adj]严重的;严肃的,庄重的; [n]墓; [adv]沉重地,庄重地;极慢地; [vt]雕刻;铭记; [a]/ɡreɪv/; [or]yshx;
recede: [vi]退去;渐渐远去;(尤指问题,感情或品质)逐渐减弱;(头发)从前向后减少;向后倾斜; [a]/rɪˈsiːd/; [or]yshx;
proximity: [n]接近;邻近; [a]/prɑːkˈsɪməti/; [or]yshx;
liner: [n]眼线笔;班轮;班机;内衬; [a]/ˈlaɪnər/; [or]yshx;
transaction: [n]交易;办理;事务;学报; [a]/trænˈzækʃn/; [or]yshx;
dedicate: [v]献给,致力于; [a]/ˈdedɪkeɪt/; [or]yshx;
hold the line: [phr]坚持下去;不挂断电话; [a]/hoʊld ðə laɪn/; [or]yshx;
administer: [v]管理;执行;实施;给予;用(药); [a]/ədˈmɪnɪstər/; [or]yshx;
undo: [v]松开,解开;取消; [a]/ʌnˈduː/; [or]yshx;
ingredient: [n](烹调的)原料;(构成的)要素,因素; [a]/ɪnˈɡriːdiənt/; [or]yshx;
perverse: [adj]邪恶的;堕落的;倔强的;违反常情的; [a]/pərˈvɜːrs/; [or]yshx;
acquire: [v](尤指靠自己的努力或行动或经过一个过程)获得;学到;取得; [a]/əˈkwaɪər/; [or]yshx;
infringe: [v]侵犯,违反,侵害; [a]/ɪnˈfrɪndʒ/; [or]yshx;
vital: [adj]生命所必需的;必不可少的;至关重要的;有活力的;生命攸关的; [n]要害;重要部分; [a]/ˈvaɪtl/; [or]yshx;
nursery: [n]托儿所;保育室;苗圃; [a]/ˈnɜːrsəri/; [or]yshx;
shave: [v]剃,刮; [n]剃须,修面,剃刀; [a]/ʃeɪv/; [or]yshx;
captive: [adj]被捕获的;被俘虏的; [n]俘虏; [a]/ˈkæptɪv/; [or]yshx;
utility: [n]功用,用途,公用事业,物业; [adj]实用的;通用性的; [a]/juːˈtɪləti/; [or]yshx;
burgeon: [v]发芽,迅速成长; [n]嫩枝; [a]/ˈbɜːrdʒən/; [or]yshx;
porcelain: [adj]瓷的;精美的;易碎的; [n]瓷,瓷器; [a]/ˈpɔːrsəlɪn/; [or]yshx;
on and on: [phr]继续不停地; [a]/ɔn ənd ɔn/; [or]yshx;
lounge: [n]候机室,休息室,酒吧间;沙发,躺椅;懒散的步子; [v](懒散地)倚,躺;闲逛; [a]/laʊndʒ/; [or]yshx;
exorbitant: [adj]要价过高的,过分的; [a]/ɪɡˈzɔːrbɪtənt/; [or]yshx;
onset: [n]开始;攻击,袭击; [a]/ˈɑːnset/; [or]yshx;
hose: [n]输水软管; [v]用水管冲洗(汽车等); [a]/hoʊz/; [or]yshx;
wield: [v]运用,行使;挥; [vt]使用; [a]/wiːld/; [or]yshx;
category: [n]类别;范畴; [a]/ˈkætəɡɔːri/; [or]yshx;
conform: [vi]一致;遵照,顺从;符合; [vt]使一致;使遵照; [adj]一致的; [a]/kənˈfɔːrm/; [or]yshx;
nominal: [adj]名义上的;象征性的,很少的;名词性的; [a]/ˈnɑːmɪnl/; [or]yshx;
take-away: [phr]外带,外卖; [a]/teɪk əˈweɪ/; [or]yshx;
auxiliary: [adj]备用的,辅助的,协助的; [a]/ɔːɡˈzɪliəri/; [or]yshx;
disarray: [n]混乱,漫无秩序; [a]/ˌdɪsəˈreɪ/; [or]yshx;
batter: [n](用鸡蛋,牛奶等调制的)面糊; [v]连续猛击; [a]/ˈbætər/; [or]yshx;
preserve: [v]贮鲜,保鲜;保存;保护; [n]独揽之事,独占的活动; [a]/prɪˈzɜːrv/; [or]yshx;
dialect: [n]方言;语调; [adj]方言的; [a]/ˈdaɪəlekt/; [or]yshx;
superb: [adj]极好的;壮丽的; [a]/suːˈpɜːrb/; [or]yshx;
feeble: [adj]虚弱的; [a]/ˈfiːbl/; [or]yshx;
piecemeal: [n]片;块; [v]粉碎; [adv]零碎地;逐个地; [adj]零碎的;逐渐的; [a]/ˈpiːsmiːl/; [or]yshx;
enlighten: [v]启发,开导; [a]/ɪnˈlaɪtn/; [or]yshx;
mammal: [n]哺乳动物; [a]/ˈmæml/; [or]yshx;
occasion: [n]场合,时候;活动;时机,机会; [v]导致;引起; [a]/əˈkeɪʒn/; [or]yshx;
overall: [adj]全面的,全部的; [n]罩衫,工装裤; [adv]总的来说;总共; [a]/ˌoʊvərˈɔːl/; [or]yshx;
fragrance: [n]香水;香味;芳香; [a]/ˈfreɪɡrəns/; [or]yshx;
fanatic: [n]狂热者,盲信者; [adj]狂热的,入迷的,盲信的; [a]/fəˈnætɪk/; [or]yshx;
clasp: [v]握紧;扣紧;扣住;抱紧; [n]扣子;钩子;紧抱;紧握; [a]/klæsp/; [or]yshx;
random: [adj]随机的;任意的;胡乱的; [a]/ˈrændəm/; [or]yshx;
magnificent: [adj]华丽的,宏伟的,壮丽的; [a]/mæɡˈnɪfɪsnt/; [or]yshx;
dense: [adj](物质) 密度大的;稠密的,浓密的;愚钝的;难懂的,费解的; [a]/dens/; [or]yshx;
back down (from): [phr]投降,认输; [a]/bæk daʊn frəm/; [or]yshx;
facility: [n]设施(车间等),设备;灵巧;才能,资质; [a]/fəˈsɪləti/; [or]yshx;
lenient: [adj]宽大的,宽容的,仁慈的; [a]/ˈliːniənt/; [or]yshx;
earnest: [adj]真诚的,诚挚的,认真的; [n]认真,严肃; [a]/ˈɜːrnɪst/; [or]yshx;
annihilate: [v]消灭; [a]/əˈnaɪəleɪt/; [or]yshx;
vacuum: [n]真空吸尘器;真空;空虚,茫然若失; [v]用吸尘器打扫; [a]/ˈvækjuəm/; [or]yshx;
chronic: [adj](疾病)慢性的;长期的;(人)久病的;积习难改的;严重的; [a]/ˈkrɑːnɪk/; [or]yshx;
learn/know sth. by heart: [phr]记住,背下; [a]/lɜːrn noʊ ˈsʌmθɪŋ baɪ hɑːrt/; [or]yshx;
cable: [n]电缆,缆,索; [v]拍电报; [a]/ˈkeɪbl/; [or]yshx;
slack: [adj]松弛的;懈怠的;萧条的; [n]松弛的部分,松散; [v]变松弛,逃避工作; [a]/slæk/; [or]yshx;
dread: [v]惧怕,害怕; [n]畏惧,恐惧; [adj]恐怖的,使人敬畏的; [a]/dred/; [or]yshx;
fame: [n]名望,名声,声誉; [vt]使有名,使著名; [a]/feɪm/; [or]yshx;
rendezvous: [n]集会,幽会,约会地点; [v]约会,幽会,(秘密)集会; [a]/ˈrɑːndɪvuː/; [or]yshx;
refrain: [v]抑制,避免; [n]歌曲的反复句,叠句; [a]/rɪˈfreɪn/; [or]yshx;
subdue: [v]征服,压制,减轻; [a]/səbˈduː/; [or]yshx;
sober: [vi]变得冷静; [adj]未饮醉的,清醒的;有节制的;严肃的; [v]使清醒;使冷静; [a]/ˈsoʊbər/; [or]yshx;
minus: prep. 减(去); [adj]负的; [n]减号;劣势; [a]/ˈmaɪnəs/; [or]yshx;
imaginative: [adj]想象的;富于想象力的;虚构的; [a]/ɪˈmædʒɪnətɪv/; [or]yshx;
rumor: [n]谣言;传闻; [a]/'ruːmə/; [or]yshx;
counterpart: [n]对应的人(物);副本;对手; [a]/ˈkaʊntərpɑːrt/; [or]yshx;
deduce: [v]演绎;推论,推断; [a]/dɪˈduːs/; [or]yshx;
stress: [n]强调;节拍;紧迫;压力; [vt]给.加压力;使紧张;强调; [a]/stres/; [or]yshx;
siege: [n]围困;包围; [a]/siːdʒ/; [or]yshx;
deplete: [v]使大大减少;耗尽,用尽; [a]/dɪˈpliːt/; [or]yshx;
reinforce: [v]加固;加强;增援;支持; [a]/ˌriːɪnˈfɔːrs/; [or]yshx;
stock: [n]股票;股份;存货;储备;家畜; [v]给..装满;储存; [adj]储备的; [a]/stɑːk/; [or]yshx;
revise: [v]修订;修改;温习(功课); [a]/rɪˈvaɪz/; [or]yshx;
eternal: [adj]永恒的,永不改变的; [a]/ɪˈtɜːrnl/; [or]yshx;
predictable: [adj]可预料的;可预报的;可预言的; [a]/prɪˈdɪktəbl/; [or]yshx;
legal: [adj]合法的,法定的;法律的; [a]/ˈliːɡl/; [or]yshx;
patio: [n]屋内庭院,天井;平台; [a]/ˈpætioʊ/; [or]yshx;
compatible: [adj]可和谐共存的;兼容的; [a]/kəmˈpætəbl/; [or]yshx;
take sth. apart: [phr]拆开; [a]/teɪk ˈsʌmθɪŋ əˈpɑːrt/; [or]yshx;
snatch: [v]强夺;攫取; [n]片断; [a]/snætʃ/; [or]yshx;
for the sake of: prep. 为.起见;为了.的利益; [a]/fɔr ði sek ʌv/; [or]yshx;
out of line (with): [phr]跟.(不)一致; [a]/aʊt ʌv laɪn wɪθ/; [or]yshx;
offspring: [n]后代; [a]/ˈɔːfsprɪŋ/; [or]yshx;
resolution: [n]决心,决定,解决,决议,分辨率; [a]/ˌrezəˈluːʃn/; [or]yshx;
stumble: [v]绊跌,绊倒;结结巴巴说话; [n]绊倒;失足;失误;失败; [a]/ˈstʌmbl/; [or]yshx;
sieve: [n]筛子,粗篮; [v]筛,滤; [a]/sɪv/; [or]yshx;
desolate: [adj]荒凉的;孤单寂寞的; [a]/ˈdesələt/; [or]yshx;
refreshing: [adj]使精神振作的,使人清爽的;清新悦目的; [a]/rɪˈfreʃɪŋ/; [or]yshx;
strip: [v]剥;夺去;脱衣服; [n]长条;长条形土地; [adj]脱衣舞的;被剥去外皮的; [a]/strɪp/; [or]yshx;
get sth. down: [v]吞下;写下; [a]/ɡet ˈsʌmθɪŋ daʊn/; [or]yshx;
specification: [n]规格,载明,详述; [a]/ˌspesɪfɪˈkeɪʃn/; [or]yshx;
give in (to sb.): [v]屈服,投降; [a]/ɡɪv ɪn tu ˈsʌmbədi/; [or]yshx;
carry through: [v]维持;使渡过难关,坚持下去; [a]/ˈkeri θru/; [or]yshx;
venture: [n]企业;(商业)冒险;投机,风险投资; [vi]冒险前进; [vt]冒.的危险;以.做赌注; [a]/ˈventʃər/; [or]yshx;
stale: [adj]不新鲜的;走了味的;陈腐的; [v]变得不新鲜;使陈旧; [n](猎人做掩蔽用的)假马;笑柄;受人愚弄成为笑谈的人;畜尿; [a]/steɪl/; [or]yshx;
cure: [n]对策,措施;治疗,医治; [v]治愈,治疗; [a]/kjʊr/; [or]yshx;
lame: [adj]跛的;瘸的;差劲的,乏味的;〔解释或借口〕无说服力的,站不住脚的,蹩脚的; [v](使)变跛; [a]/leɪm/; [or]yshx;
give oneself up: [phr]自首;投降; [a]/ɡɪv wʌnˈself ʌp/; [or]yshx;
pretext: [n]借口,托词; [a]/ˈpriːtekst/; [or]yshx;
devise: [v]设计,想出;密谋;遗赠(不动产); [n]设计,发明,遗赠; [a]/dɪˈvaɪz/; [or]yshx;
skeptical: [adj]表示怀疑的; [a]/ˈskeptɪkl/; [or]yshx;
the accused: [n]被告; [a]/ði əˈkjuːzd/; [or]yshx;
overtake: [v]超过,赶上;突然降临; [a]/ˌoʊvərˈteɪk/; [or]yshx;
poster: [n]海报,张贴的大幅广告;贴标语的人; [a]/ˈpoʊstər/; [or]yshx;
shrub: [n]灌木; [a]/ʃrʌb/; [or]yshx;
distend: [v]膨胀;胀大;扩张; [a]/dɪˈstend/; [or]yshx;
hamper: [v]阻碍,妨碍,牵制; [n](有盖的)大篮子; [a]/ˈhæmpər/; [or]yshx;
untold: [adj]无数的,数不清的; [a]/ˌʌnˈtoʊld/; [or]yshx;
legitimate: [adj]合法的;合理的; [vt]使合法;授权;宣布..为合法; [a]/lɪˈdʒɪtɪmət/; [or]yshx;
parade: [n]游行,检阅; [v]游行,(使)列队行进,炫耀; [a]/pəˈreɪd/; [or]yshx;
catch up with sb.: [v]赶上;逮捕; [a]/kætʃ ʌp wɪθ ˈsʌmbədi/; [or]yshx;
cash in on: [v]以.获利,营利; [a]/kæʃ ɪn ɔn/; [or]yshx;
drench: [v]使淋透;使湿透; [n]淋透;雨淋;浸渍液;(制革时浸泡熟皮的)脱灰水; [a]/drentʃ/; [or]yshx;
offshore: [adj]近海的,海岸的;(公司) 设在海外的; [adv]离岸地,近海地; [a]/ˌɔːfˈʃɔːr/; [or]yshx;
superstition: [n]迷信,盲目恐惧; [a]/ˌsuːpərˈstɪʃn/; [or]yshx;
pierce: [v]穿(孔);贯穿;突破; [a]/pɪrs/; [or]yshx;
belly: [n]圆形或凸起部分;肚子; [a]/ˈbeli/; [or]yshx;
uneasy: [adj]心神不安,不稳定的,不舒服; [a]/ʌnˈiːzi/; [or]yshx;
glimmer: [n]微光;闪光;少许; [v]闪烁;发微光; [a]/ˈɡlɪmər/; [or]yshx;
comic: [adj]滑稽的,喜剧的,漫画的; [n]连环漫画杂志;喜剧演员; [a]/ˈkɑːmɪk/; [or]yshx;
compose: [v]创作,作曲,形成,构成; [a]/kəmˈpoʊz/; [or]yshx;
repel: [v]击退,驱逐;排斥,抵制;使厌恶,使反感;使恐惧; [a]/rɪˈpel/; [or]yshx;
adapt: [vi]适应不同情况; [vt]使适合;改编; [a]/əˈdæpt/; [or]yshx;
block: [v]阻挡;妨碍;阻塞; [n]街区;块状物;积木;阻碍;大厦; [a]/blɑːk/; [or]yshx;
fidelity: [n]忠诚;逼真度,保真度; [a]/fɪˈdeləti/; [or]yshx;
take sb. off: [phr]带走; [a]/teɪk ˈsʌmbədi ɑːf/; [or]yshx;
secondary: [adj]次要的,第二的;(疾病,感染等) 继发性的;中学的; [a]/ˈsekənderi/; [or]yshx;
wrench: [n]扳手;痛苦,难受;猛扭,猛拉; [v]猛拧;挣脱;使扭伤; [a]/rentʃ/; [or]yshx;
rule of thumb: [n]单凭经验的做法;经验法则; [a]/rul ɑv θʌm/; [or]yshx;
outlaw: [n]歹徒,逃犯,丧失公权者; [v]将..放逐,宣布..为不合法; [a]/ˈaʊtlɔː/; [or]yshx;
flip: [v]把.往上抛;掷;抽打;用指轻弹;空翻; [adj]轻率的,无礼的; [a]/flɪp/; [or]yshx;
defer: [v]使推迟,使延期;听从,顺从; [vi]延期; [a]/dɪˈfɜːr/; [or]yshx;
cart: [n]手推车,运货马车; [v]用车装载; [a]/kɑːrt/; [or]yshx;
preceding: [adj]在前的,在先的; [a]/prɪˈsiːdɪŋ/; [or]yshx;
concerted: [adj]一致的,商定的; [a]/kənˈsɜːrtɪd/; [or]yshx;
chip: [n]木屑,碎片;缺口;圆形筹码;芯片;炸薯条,炸薯片; [v]碎裂;削,凿;将.削成,凿成; [a]/tʃɪp/; [or]yshx;
scheme: [n]方案,计划;阴谋,诡计; [v]图谋,密谋; [adj]计划的; [a]/skiːm/; [or]yshx;
terrific: [adj]极好的;可怕的;(尺寸或程度)极其巨大的,大的惊人的; [a]/təˈrɪfɪk/; [or]yshx;
impose: [v]把.强加;强制实行,强迫接受; [a]/ɪmˈpoʊz/; [or]yshx;
indifferent: [adj]不感兴趣的,不关心的;平庸的;冷漠的; [a]/ɪnˈdɪfrənt/; [or]yshx;
insert: [vt]插入,嵌入; [n]插入物;插页; [a]/ɪnˈsɜːrt/; [or]yshx;
canteen: [n]食堂,小卖部;水壶; [a]/kænˈtiːn/; [or]yshx;
chore: [n]日常家庭杂务,日常工作;琐碎烦人的杂务; [a]/tʃɔːr/; [or]yshx;
rectify: [v]纠正;修复; [a]/ˈrektɪfaɪ/; [or]yshx;
fret: [v]使烦恼,使焦急;使腐蚀;使磨损; [n](斑卓琴,吉他,曼陀林琴等弦乐器指板上定音的)档;侵蚀; [a]/fret/; [or]yshx;
malleable: [adj](金属)可锻的;有延展性的;(性格)可训练的;易适应的; [a]/ˈmæliəbl/; [or]yshx;
aggressive: [adj]好斗的,挑衅性的;有闯劲的,积极进取的; [a]/əˈɡresɪv/; [or]yshx;
nevertheless: [adv]然而,不过;尽管如此,不过,仍然; [a]/ˌnevərðəˈles/; [or]yshx;
smash: [v]粉碎,猛冲,击溃; [n]破碎(声),猛撞,巨大的成功; [adj]极为成功的; [a]/smæʃ/; [or]yshx;
assorted: [adj]各式各样的; [a]/əˈsɔːrtəd/; [or]yshx;
deter: [v]防止,阻止,使踌躇; [a]/dɪˈtɜːr/; [or]yshx;
all the time: [adv]始终;一直; [a]/ɔl ðə taɪm/; [or]yshx;
slide: [n]滑行;下落;滑面;幻灯片; [v]使滑动;使滑入;滑动;滑倒;滑落;下跌; [a]/slaɪd/; [or]yshx;
gravel: [n]沙砾,小石,砾石; [adj]粗重而沙哑的,刺耳的; [vt]用砾石铺;使困惑; [a]/ˈɡrævl/; [or]yshx;
sort: [v]把..分类,挑选;修理,整理; [n]种类; [a]/sɔːrt/; [or]yshx;
insolvent: [n]无力清偿债务者,破产者; [adj]无清偿能力的,破产的; [a]/ɪnˈsɑːlvənt/; [or]yshx;
insipid: [adj]淡而无味的;枯燥乏味的; [a]/ɪnˈsɪpɪd/; [or]yshx;
holocaust: [n]大屠杀,浩劫; [a]/ˈhɑːləkɔːst/; [or]yshx;
slate: [n]黑板,石板,候选人名单; [v]提名; [a]/sleɪt/; [or]yshx;
recipe: [n]方法;食谱; [a]/ˈresəpi/; [or]yshx;
section: [n]部分;区域;章节;截面;阶层;部门;路段,地段; [v]划分;切开; [a]/ˈsekʃn/; [or]yshx;
look sth. up: [phr]查字典; [a]/lʊk ˈsʌmθɪŋ ʌp/; [or]yshx;
speak one's mind: [phr]直言不讳,吐露心声; [a]/spik wʌnz maɪnd/; [or]yshx;
confident: [adj]自信的;确信的,深信的; [a]/ˈkɑːnfɪdənt/; [or]yshx;
beat about/around the bush: [v]转弯抹角; [a]/biːt əˈbaʊt əˈraʊnd ðə bʊʃ/; [or]yshx;
item: [n]物品;条,条款,项目; [a]/ˈaɪtəm/; [or]yshx;
bear with (sb.): [phr]耐心等待;宽容; [a]/ber wɪθ ˈsʌmbədi/; [or]yshx;
striking: [adj]容貌出众的,吸引人的;显著的,突出的; [n]罢工; [a]/ˈstraɪkɪŋ/; [or]yshx;
allegiance: [n]忠诚,拥护; [a]/əˈliːdʒəns/; [or]yshx;
thermostat: [n]恒温器; [a]/ˈθɜːrməstæt/; [or]yshx;
static: [adj]静电的,静态的,静止的; [n]静电,静电干扰; [a]/ˈstætɪk/; [or]yshx;
distress: [n]悲伤,疼痛;痛苦,焦虑;困难,困境; [adj]受灾的;受灾造成的,焦虑的; [v]使痛苦,使焦急;因紧张而困恼;使困苦;迫使; [a]/dɪˈstres/; [or]yshx;
excess: [adj]额外的,过量的,过度的,附加的; [n]超越,超过,过度; [a]/ɪkˈses/; [or]yshx;
organism: [n]生物,有机体;有机的组织; [a]/ˈɔːrɡənɪzəm/; [or]yshx;
barricade: [n]路障;障碍物;栅栏; [v]设路障;挡住; [a]/ˌbærɪˈkeɪd/; [or]yshx;
vex: [v]使烦恼,使苦恼,使恼怒; [a]/veks/; [or]yshx;
chasm: [n](地壳,冰上的)隐窟,深坑,峡谷;显著差距,巨大分歧; [a]/ˈkæzəm/; [or]yshx;
strategic: [adj]战略(上)的,对全局有重要意义的,关键的; [a]/strəˈtiːdʒɪk/; [or]yshx;
adjacent: [adj]邻接的,毗连的;邻近的; [a]/əˈdʒeɪsnt/; [or]yshx;
owe: [v]感谢;欠;把.归于;占有;欠钱; [a]/oʊ/; [or]yshx;
timidity: [n]胆怯; [a]/tɪˈmɪdəti/; [or]yshx;
appreciable: [adj]很可观的;可感知的;可察觉的;可评估的; [a]/əˈpriːʃəbl/; [or]yshx;
pivot: [n]枢轴,中心; [v]以..为中心转动; [adj]枢轴的;关键的; [a]/ˈpɪvət/; [or]yshx;
nought: [n]无;零; [a]/nɔːt/; [or]yshx;
go off: [phr]爆炸;进行;变质; [a]/ɡoʊ ɑf/; [or]yshx;
motif: [n]基本图案;主题,中心思想,[音]乐旨; [a]/moʊˈtiːf/; [or]yshx;
massive: [adj]巨大的;大规模的;大量的; [a]/ˈmæsɪv/; [or]yshx;
cumulative: [adj]渐增的;累积的; [a]/ˈkjuːmjəleɪtɪv/; [or]yshx;
disguise: [v]伪装;掩饰; [n]伪装物;伪装; [a]/dɪsˈɡaɪz/; [or]yshx;
casual: [adj]偶然的;临时的;随便的; [n]临时工;便服; [a]/ˈkæʒuəl/; [or]yshx;
finite: [adj]有限的;限定的; [a]/ˈfaɪnaɪt/; [or]yshx;
awful: [adj]可怕的,极坏的;糟糕的,讨厌的;极其; [adv]极其,非常; [a]/ˈɔːfl/; [or]yshx;
detect: [v]发现,发觉;侦察,探测; [a]/dɪˈtekt/; [or]yshx;
gloomy: [adj]愁容满面的,阴暗的,没有希望的; [a]/ˈɡluːmi/; [or]yshx;
context: [n]上下文,语境;背景; [a]/ˈkɑːntekst/; [or]yshx;
eclipse: [n](日,月)食;黯然失色; [v]掩盖..的重要性;使暗淡; [a]/ɪˈklɪps/; [or]yshx;
global: [adj]全球的;全面的; [a]/ˈɡloʊbl/; [or]yshx;
banner: [n]旗帜,横幅,大标题; [a]/ˈbænər/; [or]yshx;
carpenter: [n]木匠;木工; [a]/ˈkɑːrpəntər/; [or]yshx;
characteristic: [n]特点;特性;特色; [adj]典型的;特有的;独特的; [a]/ˌkærəktəˈrɪstɪk/; [or]yshx;
thrill: [n]兴奋,激动,引起激动的事物; [v](使)非常兴奋,(使)非常激动; [a]/θrɪl/; [or]yshx;
rivet: [n]铆钉; [v](用铆钉)铆接,敲打(螺栓)使成铆钉头,吸引(注意力); [a]/ˈrɪvɪt/; [or]yshx;
bonus: [n]奖金,额外津贴; [a]/ˈboʊnəs/; [or]yshx;
erupt: [v]爆发;(火山,喷泉,蒸汽等)喷发;使迸发;喷射出; [a]/ɪˈrʌpt/; [or]yshx;
catalog: [n]目录,目录册,商品目录; [v]为..编目录,登记; [a]/ˈkætəlɔːɡ/; [or]yshx;
intent: [adj]全神贯注的;专心致志的; [n]意图;意向;目的; [a]/ɪnˈtent/; [or]yshx;
damp: [adj]潮湿的,有湿气的; [a]/dæmp/; [or]yshx;
mediate: [v]调解,调停,斡旋; [a]/ˈmiːdieɪt/; [or]yshx;
practicable: [adj]能实行的,行得通的;适用的,能用的;可通行的; [a]/ˈpræktɪkəbl/; [or]yshx;
quit: [vt]辞职;停止;离开; [adj]被释放的;自由的;摆脱了.的;了清债务的; [a]/kwɪt/; [or]yshx;
portfolio: [n]公文包,文件夹,投资组合;股份单; [a]/pɔːrtˈfoʊlioʊ/; [or]yshx;
be hard to say: [phr]难以开口; [a]/bi hɑrd tu seɪ/; [or]yshx;
palm: [n]手掌,手心,棕榈树; [a]/pɑːm/; [or]yshx;
sewer: [n]排水沟,下水道,缝纫者; [v]用下水道排污水;铺设污水管道; [a]/ˈsuːər/; [or]yshx;
come to nought: [v]失败; [a]/kʌm tu nɔt/; [or]yshx;
hurl: [v]用力投掷; [n]猛投; [a]/hɜːrl/; [or]yshx;
wisdom: [n]智慧,学问;明智,正确判断; [a]/ˈwɪzdəm/; [or]yshx;
settle on (upon) sth.: [v]决定; [a]/ˈsetl ɑːn əˈpɔːn ˈsʌmθɪŋ/; [or]yshx;
plea: [n](法律)抗辩;恳求;请求,托词,口实; [a]/pliː/; [or]yshx;
pharmaceutical: [adj]制药的,药物的; [n]药物; [a]/ˌfɑːrməˈsuːtɪkl/; [or]yshx;
pursuit: [n]追求,寻找;追赶,跟踪;事业,消遣; [v]追踪,追击; [a]/pərˈsuːt/; [or]yshx;
overcome: [v]战胜;克服;压倒;得胜,征服; [a]/ˌoʊvərˈkʌm/; [or]yshx;
hazardous: [adj]有危险的;碰运气的; [adv]冒险地,有危险地; [n]冒险,危险; [a]/ˈhæzərdəs/; [or]yshx;
registrar: [n]登记员,记录员; [a]/ˌredʒɪˈstrɑːr/; [or]yshx;
dazzle: [n]光辉;令人赞叹的东西; [v]使眼花;使赞叹不已; [a]/ˈdæzl/; [or]yshx;
maneuver: [v]操纵; [n]操纵;花招;调遣;策略; [a]/məˈnʊvər/; [or]yshx;
session: [n]一段时间的(活动);(法庭的)开庭;(议会等的)开会;学期;讲习会; [adj]为录音的歌手或乐队伴奏的; [a]/ˈseʃn/; [or]yshx;
fortnight: [n]两星期,十四日; [a]/ˈfɔːrtnaɪt/; [or]yshx;
hearing: [n]听觉;听距;听证会;申辩的机会; [v]听到; [a]/ˈhɪrɪŋ/; [or]yshx;
look into: [v]研究;调查; [a]/lʊk ˈɪntu/; [or]yshx;
duplicate: [n]复制品; [v]复制;重复; [adj]完全一样的; [a]/ˈduːplɪkeɪt/; [or]yshx;
toneless: [adj]单调的;缺乏声调的; [adv]声调平板地; [a]/ˈtoʊnləs/; [or]yshx;
amount: [n]数量,总额; [v]合计,共计;等同,接近(to); [a]/əˈmaʊnt/; [or]yshx;
stand for sth.: [v]表示;代表; [a]/stænd fɔːr ˈsʌmθɪŋ/; [or]yshx;
supersede: [v]代替;紧接着而到来; [a]/ˌsuːpərˈsiːd/; [or]yshx;
penalty: [n]惩罚,处罚,不利,罚球; [adj]处罚的; [a]/ˈpenəlti/; [or]yshx;
at fault: [phr]⋯⋯过错,⋯⋯责任; [a]/ət fɔlt/; [or]yshx;
hold onto: [v]抓住,不放;不卖掉; [a]/hoʊld ˈɑntə/; [or]yshx;
extra: [adj]额外的,附加的;特优的; [adv]额外地; [n]附加物品;临时演员;(报纸)号外; [a]/ˈekstrə/; [or]yshx;
occupy: [v]占领,占据,侵占;住在,居住,住进;担任(职务),任职;占用(时间,空间等),占有;使用(房屋,建筑); [a]/ˈɑːkjupaɪ/; [or]yshx;
handbook: [n]手册;指南; [a]/ˈhændbʊk/; [or]yshx;
fort: [n]堡垒,要塞; [a]/fɔːrt/; [or]yshx;
wander: [v]漫游;蜿蜒;迷路;离题; [n]游荡;闲逛;失散; [a]/ˈwɑːndər/; [or]yshx;
calorie: [n]卡(热量单位); [a]/ˈkæləri/; [or]yshx;
project: [n]项目,工程;专题研究;课题方案; [v]映射,放映;计划,设计,打算,拟订方案;投掷,发射,喷射;表明..的特性,使呈现特性;阐述;突出,伸出;估计,预估; [a]/ˈprɑːdʒekt/; [or]yshx;
exquisite: [adj]精致的,精选的;细腻的;强烈的; [n]过分讲究穿戴的人; [a]/ɪkˈskwɪzɪt/; [or]yshx;
spotlight: [n]聚光灯; [v]聚光照明,使显著; [a]/ˈspɑːtlaɪt/; [or]yshx;
protract: [v]绘制;延长;伸展; [a]/proʊ'trækt/; [or]yshx;
oath: [n]誓言;誓约;咒骂;咒语; [a]/oʊθ/; [or]yshx;
costume: [n]服装,剧装; [vt]提供服装;为 ... 设计服装; [adj]服装打扮的; [a]/ˈkɑːstuːm/; [or]yshx;
prerogative: [n]权利;特权; [a]/prɪˈrɑːɡətɪv/; [or]yshx;
pull sth. off: [phr]努力实现; [a]/pʊl ˈsʌmθɪŋ ɑːf/; [or]yshx;
rally: [n]集会;公路汽车赛; [v]集合;恢复(健康等),重新振作; [a]/ˈræli/; [or]yshx;
succession: [n]连续,继续;一连串;继承权; [a]/səkˈseʃn/; [or]yshx;
wrestle: [v]摔跤,角斗;斗争,努力; [n]摔跤,角力,扭斗; [a]/ˈresl/; [or]yshx;
thermal: [adj]保暖的;温泉的;热的; [n]保暖内衣裤; [a]/ˈθɜːrml/; [or]yshx;
avert: [v]转移(目光,注意力等);防止;避开; [a]/əˈvɜːrt/; [or]yshx;
nominate sb. for: [v]提名,推荐; [a]/ˈnɑːmɪneɪt ˈsʌmbədi fɔːr/; [or]yshx;
plausible: [adj]似乎有理的;巧嘴的; [a]/ˈplɔːzəbl/; [or]yshx;
defeat: [n]挫败;击败,战胜; [v]打败;战胜; [a]/dɪˈfiːt/; [or]yshx;
chisel: [v]刻,凿; [n]凿子; [a]/ˈtʃɪzl/; [or]yshx;
exuberant: [adj](植物)茂盛的,(人)充满活力的; [a]/ɪɡˈzuːbərənt/; [or]yshx;
spare: [adj]备用的;多余的,闲置的;瘦的; [n]零件,备件; [v]抽出,腾出;免去; [a]/sper/; [or]yshx;
seam: [n]缝;接缝;地层; [a]/siːm/; [or]yshx;
for good (and all): [adv]永久地,一劳永逸地; [a]/fɔːr ɡʊd ənd ɔːl/; [or]yshx;
certify: [v](发给证书)证明;证实; [a]/ˈsɜːrtɪfaɪ/; [or]yshx;
stipulate: [v]规定;保证;保证;要求以.为条件; [a]/ˈstɪpjuleɪt/; [or]yshx;
civilian: [n]平民,百姓; [adj]平民的,百姓的,民用的; [a]/səˈvɪliən/; [or]yshx;
recital: [n]独奏,吟诵,演奏会; [a]/rɪˈsaɪtl/; [or]yshx;
odd: [adj]奇怪的;古怪的;奇数的;多种多样的;临时的; [n]奇特的事物;怪人;[高尔夫球]多于对方的一次击球; [adv](用于数字后)大约,左右,略多; [a]/ɑːd/; [or]yshx;
shuttle: [n]短程穿梭运行的车辆,接驳车;梭子;穿梭;航天飞机; [v]穿梭移动;穿梭往返;往返于两地之间; [a]/ˈʃʌtl/; [or]yshx;
regime: [n]政权;政治制度;养生法,生活规则; [a]/reɪˈʒiːm/; [or]yshx;
propose: [v]提议;求婚; [a]/prəˈpoʊz/; [or]yshx;
blank: [adj](纸等)空白的,茫然的; [n]空白,空白处; [v]忽视; [a]/blæŋk/; [or]yshx;
graze: [v](牲畜)吃草;放牧;擦过; [n]擦,擦伤; [a]/ɡreɪz/; [or]yshx;
eminent: [adj]显赫的;杰出的;有名的;(品质)优良的; [a]/ˈemɪnənt/; [or]yshx;
had better: [v]最好还是; [a]/hæd ˈbetər/; [or]yshx;
border: [n]边界;花坛;滚边,边沿,包边; [v]近似;毗邻;与..接壤;为..镶边; [a]/ˈbɔːrdər/; [or]yshx;
furious: [adj]狂怒的;愤怒的;猛烈的; [a]/ˈfjʊriəs/; [or]yshx;
funeral: [n]丧葬,葬礼; [a]/ˈfjuːnərəl/; [or]yshx;
sporadic: [adj]不定时发生的;零星的;分散的; [a]/spəˈrædɪk/; [or]yshx;
jealous: [adj]妒忌的,妒羡的; [a]/ˈdʒeləs/; [or]yshx;
scratch: [n]抓痕,擦伤; [v]划破,擦伤,挠; [a]/skrætʃ/; [or]yshx;
edible: [adj]可食的; [a]/ˈedəbl/; [or]yshx;
superficial: [adj]肤浅的;表面的;微不足道的; [n]表面文章; [a]/ˌsuːpərˈfɪʃl/; [or]yshx;
keep sb. down: [v]控制;为难;压制; [a]/kiːp ˈsʌmbədi daʊn/; [or]yshx;
tumble: [v]翻滚;不由自主地卷入;(价格等)暴跌;跌倒,摔下,滚下; [n]跌倒,摔倒; [a]/ˈtʌmbl/; [or]yshx;
function: [n]功能,作用;函数;应变量;盛大聚会;职务,职责; [v]起作用;正常运转; [a]/ˈfʌŋkʃn/; [or]yshx;
physique: [n]体格,体魄; [a]/fɪˈziːk/; [or]yshx;
hail: [n]冰雹;一阵; [v]下冰雹;歌颂; [a]/heɪl/; [or]yshx;
hostile: [adj]敌对的,敌方的;怀敌意的; [a]/ˈhɑːstl/; [or]yshx;
propel: [v]推进,推动,激励; [a]/prəˈpel/; [or]yshx;
gradual: [adj]逐渐的,逐步的,平缓的; [a]/ˈɡrædʒuəl/; [or]yshx;
get along: [v]与.和睦相处;进展; [a]/ɡet əˈlɔŋ/; [or]yshx;
delirium: [n]神志不清,极度兴奋; [a]/dɪˈlɪriəm/; [or]yshx;
ferocious: [adj]凶猛的;强烈的,严重的; [a]/fəˈroʊʃəs/; [or]yshx;
affix: [v]粘上;署名;将罪责加之于; [n]词缀;附加物; [a]/əˈfɪks/; [or]yshx;
indemnity: [n]赔偿物;补偿,赔偿;保障; [a]/ɪnˈdemnəti/; [or]yshx;
deaf: [adj]聋的;不愿听的; [n]聋子;耳聋的人; [a]/def/; [or]yshx;
inflation: [n]通货膨胀;(充气后)膨胀;自负; [a]/ɪnˈfleɪʃn/; [or]yshx;
allowance: [v]定量供应(食物,饮料等物品);配给; [n]零用钱;津贴,补贴;限额;免税额;允许,容忍,让步;考虑; [a]/əˈlaʊəns/; [or]yshx;
steward: [n]乘务员,服务员;管家; [a]/ˈstuːərd/; [or]yshx;
code: [n]编码,代码;准则,法典;密码; [v]将.编码; [a]/koʊd/; [or]yshx;
survival: [n]存活;生存; [a]/sərˈvaɪvl/; [or]yshx;
gentle: [adj]温和的,轻柔的,文雅的; [a]/ˈdʒentl/; [or]yshx;
detergent: [n]洗涤剂,清洁剂; [a]/dɪˈtɜːrdʒənt/; [or]yshx;
escort: [n]护送者; [v]护送; [a]/ˈeskɔːrt/; [or]yshx;
boast: [v]夸耀;吹牛,吹嘘;自负; [n]感到骄傲的事; [a]/boʊst/; [or]yshx;
expulsion: [n]驱逐;开除; [a]/ɪkˈspʌlʃn/; [or]yshx;
compromise: [n]妥协;折中; [v]妥协;使遭受危害; [a]/ˈkɑːmprəmaɪz/; [or]yshx;
bump: [n]隆起物;撞击;(碰撞造成的)肿块; [v]撞击;颠簸地行驶;凹凸不平;除名,撵走; [a]/bʌmp/; [or]yshx;
oppose: [v]反对;反抗; [a]/əˈpoʊz/; [or]yshx;
volcano: [n]火山; [a]/vɑːlˈkeɪnoʊ/; [or]yshx;
duly: [adv]适当地;按时地; [a]/ˈduːli/; [or]yshx;
plaintive: [adj]表示悲痛的,伤心的; [a]/ˈpleɪntɪv/; [or]yshx;
mutter: [n]低语;小声抱怨; [v]低声说;小声抱怨; [vt]低声说;抱怨地说; [a]/ˈmʌtər/; [or]yshx;
vertical: [adj]垂直的;顶点的; [n]垂直线,垂直面; [a]/ˈvɜːrtɪkl/; [or]yshx;
dizzy: [adj]眩晕的,头晕目眩的,头昏眼花的; [vt]使头晕目眩;使困惑; [a]/ˈdɪzi/; [or]yshx;
mischance: [n]不幸,灾难; [a]/ˌmɪsˈtʃæns/; [or]yshx;
yield: [v]出产;屈服;弯曲;让行; [n]收益; [a]/jiːld/; [or]yshx;
grant: [v]给予,许可,授予;承认; [n]许可;拨款,补助金; [a]/ɡrænt/; [or]yshx;
upkeep: [n]保养,维持;维修费; [a]/ˈʌpkiːp/; [or]yshx;
outcast: [n]被逐出者;流浪者; [adj]被抛弃的,被逐出的; [a]/ˈaʊtkæst/; [or]yshx;
crater: [n]火山口;弹坑; [v]在.上形成坑;毁坏; [a]/ˈkreɪtər/; [or]yshx;
script: [n]剧本,脚本,手稿;文字系统; [v]为电影(或戏剧等)写剧本; [a]/skrɪpt/; [or]yshx;
bear: [n]熊;(股市)看跌的人; [v]容忍,忍受;承担;带有;生育;开花结果,结(果实); [a]/ber/; [or]yshx;
expel: [v]罚出,开除;排出;开除;驱逐; [a]/ɪkˈspel/; [or]yshx;
reasonable: [adj]适当的;合理的;通情达理的;(价格)公道的; [a]/ˈriːznəbl/; [or]yshx;
pad: [n]衬垫;护具;便笺簿;(动物的)脚;浮叶; [v]填塞; [a]/pæd/; [or]yshx;
chart: [n]图表,表格;航海图;每周排行榜; [v]制成图表;制航海图; [a]/tʃɑːrt/; [or]yshx;
paradise: [n]天国;天堂;极乐世界; [a]/ˈpærədaɪs/; [or]yshx;
spill: [v]使溢出;使流出;撒;浇(花等); [n]溢出,溅出;溢出量;摔下; [a]/spɪl/; [or]yshx;
leave sth. (sb.) out: [phr]遗漏,不考虑; [a]/liːv ˈsʌmθɪŋ ˈsʌmbədi aʊt/; [or]yshx;
orthodox: [adj]正统的;传统的;(Orthodox)东正教的; [a]/ˈɔːrθədɑːks/; [or]yshx;
gratuity: [n]赏钱,小费; [a]/ɡrəˈtuːəti/; [or]yshx;
deck: [n]甲板,公共汽车一层的车厢,纸牌; [v]装饰;击倒; [a]/dek/; [or]yshx;
capital: [n]资金,资本;首都;大写(字母); [adj]大写的;资本的;优秀的;处以死刑的;致命的; [a]/ˈkæpɪtl/; [or]yshx;
medium: [adj]中等的;适中的; [n]手段;媒介;材料; [a]/ˈmiːdiəm/; [or]yshx;
furnace: [n]炉子,熔炉; [a]/ˈfɜːrnɪs/; [or]yshx;
multitude: [n]大量;众多;大批;群众; [a]/ˈmʌltɪtuːd/; [or]yshx;
impressive: [adj]给人深刻印象的;引人注目的; [a]/ɪmˈpresɪv/; [or]yshx;
stuff: [n]东西;材料;原料; [v]塞满;把..装进; [adj]毛织品做的; [a]/stʌf/; [or]yshx;
minister: [v]给予援助,救助;照料,服侍; [n]部长,大臣;公使,外交使节;牧师; [a]/ˈmɪnɪstər/; [or]yshx;
conducive: [adj]有益的,有助于.的; [a]/kənˈduːsɪv/; [or]yshx;
observatory: [n]天文台,气象台,瞭望台; [a]/əbˈzɜːrvətɔːri/; [or]yshx;
defiance: [n]蔑视;反抗;挑战; [a]/dɪˈfaɪəns/; [or]yshx;
speculate: [vi]推测,猜测;投机,做投机买卖; [vt]推测; [a]/ˈspekjuleɪt/; [or]yshx;
overwhelm: [v]压垮;不知所措;淹没;打败,压倒; [a]/ˌoʊvərˈwelm/; [or]yshx;
behave: [v]举动;举止端正(或良好,适当); [a]/bɪˈheɪv/; [or]yshx;
pertain: [vi]属于;适合;有关; [a]/pərˈteɪn/; [or]yshx;
hug: [v]紧抱;拥抱; [n]拥抱; [a]/hʌɡ/; [or]yshx;
relay: [n]替班;转播;接力赛跑; [v]转播;传递; [a]/ˈriːleɪ/; [or]yshx;
overlook: [v]忽视,未注意到;眺望,俯视; [n]忽视,远眺; [a]/ˌoʊvərˈlʊk/; [or]yshx;
scorn: [n]鄙视; [v]轻蔑;对.不屑一顾; [a]/skɔːrn/; [or]yshx;
ensemble: [n]合唱团,表演团体;总效果;全套服装;全套家具; [a]/ɑːnˈsɑːmbl/; [or]yshx;
furnish: [v](用家具等)布置(房间,公寓等);供应,提供; [a]/ˈfɜːrnɪʃ/; [or]yshx;
take pains to do: [phr]尽力去做;费劲苦心做某事; [a]/teɪk peɪnz tu doʊ/; [or]yshx;
decimal: [n]小数; [adj]小数的;十进制的; [a]/ˈdesɪml/; [or]yshx;
sway: [v]摇摆,摇曳;动摇(某人); [n]摇摆;支配,影响; [a]/sweɪ/; [or]yshx;
exhilarate: [v]使高兴;使兴奋; [adj]使人高兴的,令人兴奋的; [a]/ɪɡˈzɪləreɪt/; [or]yshx;
via: prep. 经过,通过; [a]/ˈvaɪə/; [or]yshx;
property: [n]房产;财产;特性;性能; [a]/ˈprɑːpərti/; [or]yshx;
jeopardise: [v]使受危害,使陷险境; [a]/'dʒepədaɪz/; [or]yshx;
retain: [v]保持,保留,保存;聘请; [a]/rɪˈteɪn/; [or]yshx;
come apart: [phr]破碎;瓦解;崩塌; [a]/kʌm əˈpɑrt/; [or]yshx;
dispatch: [v]派遣,调遣;发送(信件,电报等);结束,摆脱掉;匆匆办完; [vt]处决; [n]派遣,调遣;发送;快信,急件;迅速,敏捷; [a]/dɪˈspætʃ/; [or]yshx;
confirm: [v]确认;证实;批准; [a]/kənˈfɜːrm/; [or]yshx;
ingenious: [adj]聪明的;有发明天才的;有独创性的,别出心裁的; [a]/ɪnˈdʒiːniəs/; [or]yshx;
export: [v]出口,输出; [n]输出,出口,输出品; [a]/ˈekspɔːrt/; [or]yshx;
gloss: [n]光泽;假象;唇膏; [vt]使有光彩;掩盖; [a]/ɡlɑːs/; [or]yshx;
extend: [v]伸展,展开;延伸;涉及;扩展;提供;使.竭尽全力; [a]/ɪkˈstend/; [or]yshx;
sluggish: [adj]行动迟缓的,迟钝的;偷懒的; [a]/ˈslʌɡɪʃ/; [or]yshx;
prelude: [n]序幕,前奏; [a]/ˈpreljuːd/; [or]yshx;
plunge: [v]跳进,(使)投入;使陷入;暴跌; [n]卷入,参与;暴跌,骤减; [a]/plʌndʒ/; [or]yshx;
majestic: [adj]威严的;雄伟的;壮丽的; [a]/məˈdʒestɪk/; [or]yshx;
manure: [n]肥料; [v]施肥于;耕种; [a]/məˈnʊr/; [or]yshx;
antique: [n]古董;古玩;古物; [adj]古代的;古董的; [a]/ænˈtiːk/; [or]yshx;
moderate: [adj]适度的,适中的,温和的,稳健的,中等的; [v]使减轻,使缓和; [n]温和主义者;稳健的人; [a]/ˈmɑːdərət/; [or]yshx;
bathe: [v]给..洗澡;洗澡;洗澡,游泳; [a]/beɪð/; [or]yshx;
appropriate: [adj]合适的;适当的; [v]挪用;拨款;私占; [a]/əˈproʊpriət/; [or]yshx;
blush: [v]脸红;害臊; [n]脸红; [a]/blʌʃ/; [or]yshx;
do with: [phr]需要; [a]/duː wɪθ/; [or]yshx;
shallow: [adj]浅的;肤浅的; [v]变浅;使变浅; [n]浅滩;浅处; [a]/ˈʃæloʊ/; [or]yshx;
desirable: [adj]有吸引力的;性感的;令人向往的;令人满意的; [a]/dɪˈzaɪərəbl/; [or]yshx;
vanity: [n]自负;无价值的东西;(带镜子的)梳妆台; [a]/ˈvænəti/; [or]yshx;
patch: [n]补丁;眼罩;斑点; [v]打补丁;修补;匆忙拼凑; [a]/pætʃ/; [or]yshx;
faint: [vi]昏倒,晕厥;变得模糊; [n]晕厥,昏倒; [adj]虚弱的;微弱的;眩晕的; [a]/feɪnt/; [or]yshx;
ludicrous: [adj]荒谬的,可笑的,滑稽的; [a]/ˈluːdɪkrəs/; [or]yshx;
decay: [v]腐烂;衰退;腐朽; [n]腐烂;衰退;腐败; [a]/dɪˈkeɪ/; [or]yshx;
coarse: [adj]粗糙的;粗俗的;粗鲁的; [a]/kɔːrs/; [or]yshx;
foam: [n]泡沫;泡沫体;泡沫塑料; [vi]吐白沫,起泡沫; [a]/foʊm/; [or]yshx;
novice: [n]生手,新手; [a]/ˈnɑːvɪs/; [or]yshx;
bare: [adj]赤裸的,空的,贫瘠的; [v]使裸露,暴露; [a]/ber/; [or]yshx;
tedious: [adj]沉闷的,冗长乏味的; [a]/ˈtiːdiəs/; [or]yshx;
keep to the beaten track: [phr]循规蹈矩; [a]/kip tu ðə ˈbit(ə)n træk/; [or]yshx;
imperative: [adj]必要的;祈使的;急需的; [n]命令;必要的事;义务;驱使; [a]/ɪmˈperətɪv/; [or]yshx;
apply oneself (to sth.): [v]专心致志于; [a]/əˈplaɪ wʌnˈself tu ˈsʌmθɪŋ/; [or]yshx;
invade: [v]侵略;侵犯;侵害;涌入;渗透;侵略,侵犯; [a]/ɪnˈveɪd/; [or]yshx;
execute: [v]处决;完成(动作);实行;执行(计划); [a]/ˈeksɪkjuːt/; [or]yshx;
instantaneous: [adj]瞬间的;即刻的;猝发的; [a]/ˌɪnstənˈteɪniəs/; [or]yshx;
slum: [n]贫民窟,贫民区,陋巷; [v]去贫民窟,到贫民区去(参观,游玩等); [a]/slʌm/; [or]yshx;
talented: [adj]有才能的,天资高的; [a]/ˈtæləntɪd/; [or]yshx;
embrace: [v]拥抱;包含;欣然接受,乐意采纳; [n]拥抱;接受;领会; [a]/ɪmˈbreɪs/; [or]yshx;
slaughter: [v]屠杀,屠宰; [n]屠宰,屠杀; [a]/ˈslɔːtər/; [or]yshx;
slogan: [n]标语;口号;广告语; [a]/ˈsloʊɡən/; [or]yshx;
be (go) on board: [adv]在船上,在飞机上; [a]/biː ɡoʊ ɔːn bɔːrd/; [or]yshx;
make light of: [v]轻视; [a]/meɪk laɪt ɑv/; [or]yshx;
gamble: [v]赌博;投机;打赌; [n]赌博;冒险; [vt]赌输; [a]/ˈɡæmbl/; [or]yshx;
tick: [n]勾号,(钟表)滴答声,一刹那; [v]用勾作为记号,发出滴答声; [a]/tɪk/; [or]yshx;
bark: [v]狗吠;厉声发令; [n]树皮;吠声; [a]/bɑːrk/; [or]yshx;
pull sth. down: [phr]摧毁;破坏;拆除; [a]/pʊl ˈsʌmθɪŋ daʊn/; [or]yshx;
the present day: [phr]现代; [a]/ˌpreznt ˈdeɪ/; [or]yshx;
restore: [v]恢复;修补;归还; [a]/rɪˈstɔːr/; [or]yshx;
seismic: [adj]地震的;地震引起的;剧烈的; [a]/ˈsaɪzmɪk/; [or]yshx;
breakdown: [n]损坏;故障;分类,明细;倒塌,崩溃;衰退; [a]/ˈbreɪkdaʊn/; [or]yshx;
myth: [n]神话;虚构的信念(或观念,理论);杜撰出来的人(或事物); [a]/mɪθ/; [or]yshx;
dormant: [adj]睡眠的,休眠的;静止的,隐伏的; [a]/ˈdɔːrmənt/; [or]yshx;
outcry: [n]大声喊叫;强烈抗议;拍卖; [a]/ˈaʊtkraɪ/; [or]yshx;
collaboration: [n]合作,协作;勾结; [a]/kəˌlæbəˈreɪʃn/; [or]yshx;
survey: [n]调查;测量;鉴定; [v]测量,勘测;鉴定;调查; [a]/ˈsɜːrveɪ/; [or]yshx;
scrap: [n]碎片;口角,吵架;小块,小片;废金属;残羹冷炙; [v]报废;舍弃;打架; [a]/skræp/; [or]yshx;
contribute: [v]增进,起促成作用;捐献,捐助;..的原因之一;投稿; [a]/kənˈtrɪbjuːt/; [or]yshx;
crumble: [v]弄碎;使破碎;崩溃;破灭; [n]碎屑;面包屑; [a]/ˈkrʌmbl/; [or]yshx;
traverse: [v]横越;穿过; [n]横越; [a]/trəˈvɜːrs/; [or]yshx;
lunar: [adj]月亮的; [a]/ˈluːnər/; [or]yshx;
apparent: [adj]显然的,明白的,清晰可见的;表面上的,貌似(真实)的; [a]/əˈpærənt/; [or]yshx;
all the same to: [phr]对.说来都一样;无所谓; [a]/ɔl ðə seɪm tu/; [or]yshx;
augment: [v]增加;助长; [a]/ɔːɡˈment/; [or]yshx;
reception: [n]前台,接待处,接收,欢迎,招待会; [a]/rɪˈsepʃn/; [or]yshx;
plead guilty (not guilty): [v]服罪(不服罪); [a]/pliːd ˈɡɪlti nɑːt ˈɡɪlti/; [or]yshx;
pendulum: [n]摆,钟摆;摇摆不定的事态(或局面); [a]/ˈpendʒələm/; [or]yshx;
sightseeing: [n]观光;游览; [adj]观光的,浏览的; [a]/ˈsaɪtsiːɪŋ/; [or]yshx;
shaft: [n]柄;轴;杆状物; [v]苛刻地对待; [vt]给.装杆; [a]/ʃæft/; [or]yshx;
glamour: [n]魅力;诱惑力; [a]/ˈɡlæmər/; [or]yshx;
diminish: [v]减少;失势,削弱.的权势, 减弱.的权势; [a]/dɪˈmɪnɪʃ/; [or]yshx;
pervert: [v]使堕落,误导,曲解; [n]变态,色狼; [a]/ˈpɜːrvɜːrt/; [or]yshx;
lump: [n]团;肿块;粗笨的人;一小方块 (糖); [v]成团,成堆;使成块; [a]/lʌmp/; [or]yshx;
personality: [n]个性,性格;个性鲜明的人;(娱乐界或体育界的)名人; [a]/ˌpɜːrsəˈnæləti/; [or]yshx;
blunder: [n]愚蠢之举;大错; [vi]犯大错; [v]失策;绊倒; [a]/ˈblʌndər/; [or]yshx;
rotate: [v]以..轴转动,使旋转,使..轮流;轮换; [a]/ˈroʊteɪt/; [or]yshx;
maize: [n]玉米; [adj]黄色的,玉米色的; [a]/meɪz/; [or]yshx;
bleed: [vi]流血;散开; [vt]榨取,敲诈;使流血;使..排出液体; [n]出血; [adj][印]出血版的; [a]/bliːd/; [or]yshx;
alphabetical: [adj]字母(表)的;按字母(表)顺序的; [a]/ˌælfəˈbetɪkl/; [or]yshx;
enrolment: [n]登记,注册;入会,入学; [a]/ɪnˈroʊlmənt/; [or]yshx;
obvious: [adj]明显的,显然的;了无新意的;显而易见的; [a]/ˈɑːbviəs/; [or]yshx;
surgery: [n]外科手术;外科; [a]/ˈsɜːrdʒəri/; [or]yshx;
bypass: [v]绕过;回避; [n]旁路;心脏分流手术; [a]/ˈbaɪpæs/; [or]yshx;
amid: prep. 在.中间,被.围绕; [a]/əˈmɪd/; [or]yshx;
span: [n]跨度;时间段;范围;持续时间; [v]持续;横跨;包括; [a]/spæn/; [or]yshx;
criterion: [n]标准,准则; [a]/kraɪˈtɪriən/; [or]yshx;
nibble: [v]一点点地咬,慢慢啃,吹毛求疵; [n]细咬,轻咬,啃; [a]/ˈnɪbl/; [or]yshx;
lateral: [n]侧面部分;支线; [adj]侧面的;横向的; [a]/ˈlætərəl/; [or]yshx;
perish: [vi]死去;毁灭,灭亡; [v]脆裂,老化,腐烂; [a]/ˈperɪʃ/; [or]yshx;
metabolism: [n]新陈代谢; [a]/məˈtæbəlɪzəm/; [or]yshx;
fertile: [adj]肥沃的;多产的; [a]/ˈfɜːrtl/; [or]yshx;
credit: [n]信用;荣誉;学分;信贷;称赞;债权; [v]信赖;归因于;记学分; [a]/ˈkredɪt/; [or]yshx;
notary: [n]公证人;公证员; [a]/ˈnoʊtəri/; [or]yshx;
pester: [v]使烦恼,纠缠; [a]/ˈpestər/; [or]yshx;
ensue: [v]跟着发生,接踵而来;因而产生; [a]/ɪnˈsuː/; [or]yshx;
consult: [v]请教,咨询;查阅;商量; [a]/kənˈsʌlt/; [or]yshx;
supervise: [v]监督;指导;管理; [a]/ˈsuːpərvaɪz/; [or]yshx;
evaluate: [v]评价;评估; [a]/ɪˈvæljueɪt/; [or]yshx;
tendency: [n]趋向,趋势,倾向;癖好,意向;派别; [a]/ˈtendənsi/; [or]yshx;
buckle: [v]用扣子,把.扣紧(或扣住,扣上);扣紧,扣住;变弯曲,使弯曲; [n]金属扣,皮带扣; [a]/ˈbʌkl/; [or]yshx;
break away (from): [v]突然走开;放弃;革除; [a]/breɪk əˈweɪ frʌm/; [or]yshx;
emerge: [v]冲出,冒出;浮现;出现; [a]/iˈmɜːrdʒ/; [or]yshx;
breach: [n]破裂;裂痕;冲击;违反; [v]使有裂口;破坏; [a]/briːtʃ/; [or]yshx;
locomotive: [n]机车,火车头; [adj]运动的; [a]/ˌloʊkəˈmoʊtɪv/; [or]yshx;
pinnacle: [n](哥德式建筑的)小尖塔,顶峰; [v]置于尖顶上,置于高处; [a]/ˈpɪnəkl/; [or]yshx;
monotonous: [adj]单调的,无聊的; [a]/məˈnɑːtənəs/; [or]yshx;
prone: [adj]易于.的;有.倾向的;俯卧的; [a]/proʊn/; [or]yshx;
tissue: [n]面巾纸,(动植物的)组织,纱布; [a]/ˈtɪʃuː/; [or]yshx;
thesaurus: [n]词典,分类词汇汇编; [a]/θɪˈsɔːrəs/; [or]yshx;
ego: [n]自我;自负;自尊心; [a]/ˈiːɡoʊ/; [or]yshx;
pass the time of day with: [v]交谈;共渡; [a]/pæs ðə taɪm ɑv deɪ wɪθ/; [or]yshx;
lurk: [n]潜伏,潜行; [vi]潜伏;潜藏;鬼鬼祟祟地走; [a]/lɜːrk/; [or]yshx;
flour: [n]面粉;粉状物质; [v]撒上粉; [a]/ˈflaʊər/; [or]yshx;
suck: [v]啜,吸入,吸收;使卷入;糟糕,差劲; [n]吸吮,吸力; [a]/sʌk/; [or]yshx;
install: [v]安装,安置,使就职; [a]/ɪnˈstɔːl/; [or]yshx;
cozy: [adj]温暖舒适的,安逸的; [v]取悦; [a]/ˈkoʊzi/; [or]yshx;
embargo: [v]禁止出入港口;禁止或限制贸易;征用或扣押; [n]禁令;禁止;封港令; [a]/ɪmˈbɑːrɡoʊ/; [or]yshx;
drift: [v]漂流;游荡;使漂流;使堆积; [n]漂流;漂流物;趋势;主旨;漂移; [a]/drɪft/; [or]yshx;
corrode: [v]受腐蚀;腐蚀,侵蚀; [a]/kəˈroʊd/; [or]yshx;
give way (to sth.): [phr]给.让路;为.所代替; [a]/ɡɪv weɪ tuː ˈsʌmθɪŋ/; [or]yshx;
reimburse: [v]偿还;赔偿;退还(钱),付还; [a]/ˌriːɪmˈbɜːrs/; [or]yshx;
external: [adj]外面的,外部的;外国的; [a]/ɪkˈstɜːrnl/; [or]yshx;
harass: [v]使困扰,使烦恼,反复袭击; [a]/həˈræs/; [or]yshx;
impetus: [n]推动力;促进; [a]/ˈɪmpɪtəs/; [or]yshx;
hinder: [v]阻碍,妨碍; [adj]后面的,后方的; [a]/ˈhɪndər/; [or]yshx;
molest: [v]骚扰,干扰; [a]/məˈlest/; [or]yshx;
nobility: [n]贵族;高贵;高尚;高尚的精神; [a]/noʊˈbɪləti/; [or]yshx;
protrude: [v]伸出,突出,凸出; [a]/proʊˈtruːd/; [or]yshx;
thumb: [n]拇指; [vt]以拇指示意;迅速翻阅; [vi][口语]作手势要求搭车; [a]/θʌm/; [or]yshx;
underneath: [adv]在.下面,在.底下; prep. 在下面; [a]/ˌʌndərˈniːθ/; [or]yshx;
periscope: [n]潜望镜; [a]/ˈperɪskoʊp/; [or]yshx;
erroneous: [adj]错误的; [a]/ɪˈroʊniəs/; [or]yshx;
engrave: [v]雕刻;铭记; [a]/ɪnˈɡreɪv/; [or]yshx;
outset: [n]开始,开端; [a]/ˈaʊtset/; [or]yshx;
exclaim: [v]呼叫,惊叫; [a]/ɪkˈskleɪm/; [or]yshx;
later on: [adv]后来;稍后; [a]/'leɪtər ɔn/; [or]yshx;
above(beyond) reproach: [adv]无可指责,无可厚非; [a]/əˈbʌv bɪˈjɑːnd rɪˈproʊtʃ/; [or]yshx;
buffet: [n]自助餐,(火车内)餐室,冷餐桌; [v]反复敲打,打击,重击; [a]/bəˈfeɪ/; [or]yshx;
saline: [adj]咸的,含盐的; [a]/ˈseɪliːn/; [or]yshx;
automatic: [adj]无意识的;自动的;自发的; [n]自动手枪;自动工具; [a]/ˌɔːtəˈmætɪk/; [or]yshx;
outline: [n]外形,轮廓;大纲,概要; [v]描绘,画出..的轮廓; [a]/ˈaʊtlaɪn/; [or]yshx;
carry on: [v]继续开展;坚持;举止失常; [a]/'kæriː ɔn/; [or]yshx;
at full tilt: [adv]全速地;全力以赴地; [a]/ət fʊl tɪlt/; [or]yshx;
glow: [n]光辉,红光,热情; [v]发光,发红光,发热; [a]/ɡloʊ/; [or]yshx;
rampant: [adj]猖獗的,蔓生的; [a]/ˈræmpənt/; [or]yshx;
modify: [v]改装,修改,更改;修饰,限定; [a]/ˈmɑːdɪfaɪ/; [or]yshx;
snap at sth.: [v]咬住; [a]/snæp æt ˈsʌmθɪŋ/; [or]yshx;
fabric: [n]布料,织物;质地,结构; [a]/ˈfæbrɪk/; [or]yshx;
chunk: [n]大块;矮而厚的木块;大量; [a]/tʃʌŋk/; [or]yshx;
make sth. up: [phr]补足;弥补;编造;虚构;组成;准备; [a]/meɪk ˈsʌmθɪŋ ʌp/; [or]yshx;
provision: [n](法律等)条款;供应;预备,存粮;必需品; [v]为..提供必需品; [a]/prəˈvɪʒn/; [or]yshx;
impart: [v]传授,给予,将(某性质)给予或赋予某事物; [a]/ɪmˈpɑːrt/; [or]yshx;
germ: [n]微生物,细菌;(某事的)发端,萌芽; [v]萌芽;发生; [a]/dʒɜːrm/; [or]yshx;
cartoon: [n]卡通(片),动画片;(尤指报刊上讽刺政客或时事的)漫画,幽默画; [a]/kɑːrˈtuːn/; [or]yshx;
cafeteria: [n]自助食堂;自助餐馆; [a]/ˌkæfəˈtɪriə/; [or]yshx;
improvise: [v]即席创作,临时凑成; [a]/ˈɪmprəvaɪz/; [or]yshx;
questionnaire: [n]调查表,问卷; [a]/ˌkwestʃəˈner/; [or]yshx;
thoughtful: [adj]体贴的;沉思的; [a]/ˈθɔːtfl/; [or]yshx;
implement: [n]工具;器具; [v]实施,执行;执行; [a]/ˈɪmplɪment/; [or]yshx;
relinquish: [v]放弃,让出(权利,财产等),撤回; [a]/rɪˈlɪŋkwɪʃ/; [or]yshx;
strain: [n]负担;紧张;拉力;(生物体)品种,种类; [v]拉紧;劳累;过分使用; [a]/streɪn/; [or]yshx;
glimpse: [n]一瞥;初步的感受; [v]一瞥,瞥见; [a]/ɡlɪmps/; [or]yshx;
commit: [v]犯(罪);进行 (自杀);调拨 (钱,资源);监禁;送交 (到精神病院,监狱等);承诺,保证; [a]/kəˈmɪt/; [or]yshx;
reconcile: [v]和解;调解;调和; [a]/ˈrekənsaɪl/; [or]yshx;
jolt: [n]猛的一击,摇晃,震惊; [v](使)颠簸,摇晃;使震惊; [a]/dʒoʊlt/; [or]yshx;
calcium: [n]钙; [a]/ˈkælsiəm/; [or]yshx;
petroleum: [n]石油; [a]/pəˈtroʊliəm/; [or]yshx;
cupboard: [n]碗橱,衣柜,壁橱; [a]/ˈkʌbərd/; [or]yshx;
meteoric: [adj]流星的,转瞬即逝的,突然的; [a]/ˌmiːtiˈɔːrɪk/; [or]yshx;
reproach: [v]责备,指责; [n]指责; [a]/rɪˈproʊtʃ/; [or]yshx;
meek: [adj]温顺的,逆来顺受的;谦恭的; [n]温顺的人;谦恭的人; [a]/miːk/; [or]yshx;
intimate: [adj]亲密的,密切的;详细的; [v]暗示;宣布,通知; [n]密友,知己; [a]/ˈɪntɪmət/; [or]yshx;
commence: [v]开始; [a]/kəˈmens/; [or]yshx;
hold back: [phr]阻挡,抑制,控制; [v]隐瞒; [a]/hoʊld bæk/; [or]yshx;
carrot: [n]胡萝卜; [a]/ˈkærət/; [or]yshx;
irrespective: [adj]不考虑的,不顾的; [a]/ˌɪrɪˈspektɪv/; [or]yshx;
live up to: [phr]不辜负;做到; [a]/lɪv ʌp tu/; [or]yshx;
bubble: [v]起泡;兴奋,欢闹;充满生气,情绪高涨; [n]气泡,水泡;虚幻之事;靠不住的计划;泡影;幻想,妄想; [a]/ˈbʌbl/; [or]yshx;
interval: [n]间隔;中场休息,幕间休息;间距; [a]/ˈɪntərvl/; [or]yshx;
dine: [v]吃饭,用餐;招待..吃饭;用正餐(晚餐); [a]/daɪn/; [or]yshx;
be on to: [phr]意识到,识透;找..岔子; [a]/bi ɔn tu/; [or]yshx;
provoke: [v]激怒;对.挑衅;引起; [a]/prəˈvoʊk/; [or]yshx;
perimeter: [n]周长;周界; [a]/pəˈrɪmɪtər/; [or]yshx;
halt: [v]停止,止步,暂停; [n]停住,终止; [a]/hɔːlt/; [or]yshx;
sophisticated: [adj](仪器)精密的,复杂的;老于世故的,老练的,富有经验的;高雅的,精致的; [a]/səˈfɪstɪkeɪtɪd/; [or]yshx;
breed: [n]血统;种类; [v]产仔;繁殖;使繁殖; [a]/briːd/; [or]yshx;
flash: [n]闪光;刹那; [v]闪光,掠过;发火花;快速发送; [adj]炫耀的;浮夸的;一闪而过的; [a]/flæʃ/; [or]yshx;
caution: [n]小心;警告;告诫; [v]劝.谨慎小心;警告; [a]/ˈkɔːʃn/; [or]yshx;
flap: [n]慌乱(状态);拍打,挥动;(一端固定,可自由掀动的布或皮的) 垂悬平片; [v]拍打,挥动; [a]/flæp/; [or]yshx;
pay sb. back for sth.: [phr]向.报复,报答; [a]/peɪ ˈsʌmbədi bæk fɔːr ˈsʌmθɪŋ/; [or]yshx;
forte: [n]长处,特长; [adj]强音的;响的; [adv]响亮地; [a]/fɔːrt/; [or]yshx;
induce: [v]引导,劝诱,诱导; [a]/ɪnˈduːs/; [or]yshx;
ditch: [n]沟,沟渠; [v]迫降海上; [vt]丢弃;旷课; [a]/dɪtʃ/; [or]yshx;
anticipation: [n]预期,预料;期待;预知; [a]/ænˌtɪsɪˈpeɪʃn/; [or]yshx;
piston: [n]活塞,瓣; [a]/ˈpɪstən/; [or]yshx;
voucher: [n]代金券;证明人;收据;教育补助金券; [vt]为.准备凭据;证实.的可靠性; [a]/ˈvaʊtʃər/; [or]yshx;
scoop: [n]勺,铲子,独家新闻; [v]挖,掘; [adj](女服领口)汤匙式的; [a]/skuːp/; [or]yshx;
obligatory: [adj]强制性的;义务的;必须的; [a]/əˈblɪɡətɔːri/; [or]yshx;
bucket: [n]水桶,(机器上的)桶装物,大量; [v]颠簸行进,下倾盆大雨;装在桶里; [a]/ˈbʌkɪt/; [or]yshx;
come up with: [v]提出;想出; [a]/kʌm ʌp wɪð/; [or]yshx;
notion: [n]概念,观念;观点,看法;突然的念头;意图; [a]/ˈnoʊʃn/; [or]yshx;
plus: prep. 加,加上; [n]加号;有利因素; [adj]正的,多的;有利的;阳性的; [conj]此外,而且,况且; [a]/plʌs/; [or]yshx;
verdict: [n](陪审团)裁决;定论;意见; [a]/ˈvɜːrdɪkt/; [or]yshx;
merge: [v]合并;融合; [a]/mɜːrdʒ/; [or]yshx;
airing: [n]通风;讨论;晾干; [a]/ˈerɪŋ/; [or]yshx;
prolific: [adj]多育的,多产的;丰富的,富饶的; [a]/prəˈlɪfɪk/; [or]yshx;
acknowledge: [v]告知收到;对(人)打招呼,招呼(某人)以示相识,致意;就..表示谢忱,鸣谢,感谢,感激,答谢,对..表示感谢;承认(属实),承认(权威,地位); [a]/əkˈnɑːlɪdʒ/; [or]yshx;
journalist: [n]记者,新闻工作者; [a]/ˈdʒɜːrnəlɪst/; [or]yshx;
bent: [adj]弯曲的,决心的,不诚实的; [v]弯腰,弯曲(bend过去式); [n]爱好,癖好; [a]/bent/; [or]yshx;
incidence: [n]发生率,入射角度; [a]/ˈɪnsɪdəns/; [or]yshx;
definitive: [adj]可靠的,明确的,权威的;决定性的; [a]/dɪˈfɪnətɪv/; [or]yshx;
attain: [v]获得;达到(某个年纪,水平,条件);实现; [n]成就; [a]/əˈteɪn/; [or]yshx;
insight: [n]深刻的理解,洞察力,见识; [a]/ˈɪnsaɪt/; [or]yshx;
chant: [v]吟唱;诵扬; [n]圣歌;赞美诗;旋律; [a]/tʃænt/; [or]yshx;
commodity: [n]商品,货物; [a]/kəˈmɑːdəti/; [or]yshx;
ornament: [n]装饰; [v]装饰; [a]/ˈɔːrnəmənt/; [or]yshx;
learn sth. the hard way: [phr]经过艰难困苦而学到; [a]/lɜːrn ˈsʌmθɪŋ ðə hɑːrd weɪ/; [or]yshx;
extort: [vt]敲诈,勒索; [a]/ɪkˈstɔːrt/; [or]yshx;
be at odds (with sb.)(over sth.): [adj]与.有争执; [a]/biː æt ɑːdz wɪθ ˈsʌmbədi ˈoʊvər ˈsʌmθɪŋ/; [or]yshx;
contest: [n]比赛,竞争; [v]争夺,争论; [a]/ˈkɑːntest/; [or]yshx;
call (sth.) off: [phr]停止; [a]/kɔːl ˈsʌmθɪŋ ɑːf/; [or]yshx;
lay (sth.) bare: [phr]显示;揭露; [a]/leɪ ˈsʌmθɪŋ ber/; [or]yshx;
tweezers: [n]镊子,小钳子; [a]/ˈtwiːzərz/; [or]yshx;
influx: [n]流入,涌入;河口; [a]/ˈɪnflʌks/; [or]yshx;
entertainment: [n]娱乐;招待,款待; [a]/ˌentərˈteɪnmənt/; [or]yshx;
catching: [adj]传染的;迷人的,有魅力的; [a]/ˈkætʃɪŋ/; [or]yshx;
declare: [vt]表明;宣布;强调;申报(收益);申报(应纳税品); [vi]板球(在击球员还未全部出局时)宣布结束赛局; [a]/dɪˈkler/; [or]yshx;
sphere: [n]球;球形;领域; [a]/sfɪr/; [or]yshx;
get the better of: [phr]打败; [a]/ɡet ðə ˈbetər ɑv/; [or]yshx;
scandal: [n]丑闻;丢脸;流言蜚语;反感;愤慨; [v]诋毁; [a]/ˈskændl/; [or]yshx;
excrement: [n]排泄物,粪便; [a]/ˈekskrɪmənt/; [or]yshx;
sentiment: [n]感情;情绪; [a]/ˈsentɪmənt/; [or]yshx;
whilst: [conj]当..的时候; [n]一会儿;一段时间; [a]/waɪlst/; [or]yshx;
wholesale: [n]批发; [adv]大批大批地; [adj]大规模的;批发的; [v]批发; [a]/ˈhoʊlseɪl/; [or]yshx;
refusal: [n]拒绝,回绝; [a]/rɪˈfjuːzl/; [or]yshx;
oblivious: [adj]不在意的;忘却的,健忘的; [a]/əˈblɪviəs/; [or]yshx;
condolence: [n]吊唁;哀悼; [a]/kənˈdoʊləns/; [or]yshx;
mythology: [n]神话,神话学; [a]/mɪˈθɑːlədʒi/; [or]yshx;
restless: [adj]烦躁不安的,焦虑的;得不到休息的;不安宁的; [a]/ˈrestləs/; [or]yshx;
fester: [v]溃烂;化脓;使..痛苦;使..恶化; [n]溃烂;脓疮,脓疱; [a]/ˈfestər/; [or]yshx;
tentative: [adj]试探性的;不确定的;暂时的;犹豫不决的; [a]/ˈtentətɪv/; [or]yshx;
try one's hand at: [v]尝试着做.; [a]/traɪ wʌnz hænd æt/; [or]yshx;
defraud: [v]欺诈,诈取,骗取; [a]/dɪˈfrɔːd/; [or]yshx;
taboo: [n]禁忌,(宗教)戒律; [adj](因不道德或危险而)讳忌的,戒律的; [a]/təˈbuː/; [or]yshx;
signal: [n]信号;预兆; [v]发信号;标志; [adj]显著的,优越的;暗号的,作信号用的; [a]/ˈsɪɡnəl/; [or]yshx;
martyr: [n]烈士;受难者;乞怜者; [v]迫害,折磨; [a]/ˈmɑːrtər/; [or]yshx;
hierarchy: [n]阶层,等级制度; [a]/ˈhaɪərɑːrki/; [or]yshx;
donate: [v]捐献;捐赠; [vi]捐献;捐赠; [a]/ˈdoʊneɪt/; [or]yshx;
account: [n]账户;原因,理由;叙述; [v]报账,做出说明(或解释),为.负责,受罚;认为,考虑; [a]/əˈkaʊnt/; [or]yshx;
alliance: [n]联盟,同盟;盟约;盟国,同盟者;类同; [a]/əˈlaɪəns/; [or]yshx;
stick around: [v]逗留; [a]/stɪk ə'raʊnd/; [or]yshx;
permissible: [adj]容许的;许可的; [a]/pərˈmɪsəbl/; [or]yshx;
convert: [v]可转变为,可变换成;改变,转变,转化;使改变信仰; [n]皈依者;改变宗教信仰者; [a]/kənˈvɜːrt/; [or]yshx;
detrimental: [adj]有害的,不利的; [a]/ˌdetrɪˈmentl/; [or]yshx;
interact: [v]交流,沟通,互动;互相作用,互相影响; [a]/ˌɪntərˈækt/; [or]yshx;
cricket: [n]板球,板球运动;蟋蟀; [a]/ˈkrɪkɪt/; [or]yshx;
do sth. with a bad grace: [phr]勉强做某事; [a]/duː ˈsʌmθɪŋ wɪð ə bæd ɡreɪs/; [or]yshx;
sign: [v]签署;使眼色;做暗号;做手势; [n]记号,符号;标志,手势; [a]/saɪn/; [or]yshx;
feasible: [adj]可行的,行得通的; [a]/ˈfiːzəbl/; [or]yshx;
growl: [v](动物)咆哮,吼叫; [n]咆哮声,怨言,打嗝声; [a]/ɡraʊl/; [or]yshx;
incur: [v]遭受;招致;引起; [a]/ɪnˈkɜːr/; [or]yshx;
fetter: [n]脚镣;束缚; [vt]给.上脚镣;束缚; [a]/ˈfetər/; [or]yshx;
restrain: [v]制止(做);抑制(愤怒等),控制;监禁; [a]/rɪˈstreɪn/; [or]yshx;
protest: [v]抗议;反对; [n]声明,反对; [a]/ˈproʊtest/; [or]yshx;
brutal: [adj]残忍的,粗鲁的;严酷的,难以忍受的;严峻的; [a]/ˈbruːtl/; [or]yshx;
remittance: [n]汇款,汇款额; [a]/rɪˈmɪtns/; [or]yshx;
engross: [v]独占;正式誊写;使全神贯注于;用大字体书写; [a]/ɪnˈɡroʊs/; [or]yshx;
eloquent: [adj]有口才的;雄辩的;演说动人的; [a]/ˈeləkwənt/; [or]yshx;
literature: [n]文学;宣传册;文献; [a]/ˈlɪtrətʃər/; [or]yshx;
stitch: [v]缝,绣; [n]一针,线迹;缝法,编结法;(肋部的)突然剧痛;缝合(伤口); [a]/stɪtʃ/; [or]yshx;
appeal: [vi]呼吁,请求;申诉;有吸引力; [n]呼吁;恳求;(为慈善或好的事业所做的) 筹款努力;(人或物的)吸引力; [a]/əˈpiːl/; [or]yshx;
briefcase: [n]公文包; [a]/ˈbriːfkeɪs/; [or]yshx;
loom: [n]织布机; [v]阴森地逼近;隐现;即将来临; [a]/luːm/; [or]yshx;
ignorance: [n]不知,不懂;愚昧,无知; [a]/ˈɪɡnərəns/; [or]yshx;
agreeable: [adj](欣然)同意的;愉快的;可以接受的; [a]/əˈɡriːəbl/; [or]yshx;
sigh: [n]叹气,叹息; [v]叹息,叹气; [a]/saɪ/; [or]yshx;
oar: [n]桨,橹; [a]/ɔːr/; [or]yshx;
live with: [phr]接受,忍受;同居; [a]/lɪv wɪθ/; [or]yshx;
commemorate: [v]纪念,庆祝; [a]/kəˈmeməreɪt/; [or]yshx;
give oneself (put on) airs: [v]装腔作势; [a]/ɡɪv wʌnˈself pʊt ɔːn erz/; [or]yshx;
leave sb. (sth.) alone: [phr]不干涉某人(某事); [a]/liːv ˈsʌmbədi ˈsʌmθɪŋ əˈloʊn/; [or]yshx;
compliance: [n]遵守,依从;承诺,答应; [a]/kəmˈplaɪəns/; [or]yshx;
on behalf of: [phr]代表.,为了.; [a]/ɔn bɪˈhæf ɑv/; [or]yshx;
sculpture: [n]雕刻艺术;雕刻,雕塑; [a]/ˈskʌlptʃər/; [or]yshx;
curriculum: [n]课程,(学校或专业的)全部课程; [a]/kəˈrɪkjələm/; [or]yshx;
starch: [n]淀粉; [v]给.上浆; [a]/stɑːrtʃ/; [or]yshx;
set off: [phr]出发; [a]/set ɑf/; [or]yshx;
jeer: [n]嘲笑,戏弄,揶揄的言语; [v]嘲笑,戏弄; [a]/dʒɪr/; [or]yshx;
premium: [adj]高级的;高价的;(汽油)辛烷值高的; [n]额外费用,溢价;保险金; [a]/ˈpriːmiəm/; [or]yshx;
panel: [n]讨论小组;仪表板;面,板; [v]嵌镶; [a]/ˈpænl/; [or]yshx;
sanity: [n]心智健全,神智正常;头脑清楚; [a]/ˈsænəti/; [or]yshx;
illiterate: [n]文盲,目不识丁者; [adj]不识字的;缺乏(某方面)知识的;语法错误的; [a]/ɪˈlɪtərət/; [or]yshx;
chase: [v]追赶;驱逐;追求; [n]追逐;追求; [a]/tʃeɪs/; [or]yshx;
sweep: [v]打扫;快速移动; [n]清扫;一挥(手,胳膊等);范围,广度;绵延弯曲的地带; [a]/swiːp/; [or]yshx;
off-hand: [adj]不拘礼节的;临时的,未经准备的; [adv]当即,立即; [a]/'ɔːfh'ænd/; [or]yshx;
destination: [n]目的地,终点; [adj]目的地的; [a]/ˌdestɪˈneɪʃn/; [or]yshx;
obscene: [adj]下流的,淫秽的; [a]/əbˈsiːn/; [or]yshx;
flux: [n]流动,不断的变动; [a]/flʌks/; [or]yshx;
elastic: [adj]有弹性的;可伸缩的,(系统或计划)灵活的;弹力材料制成的; [n]松紧带,橡皮圈; [a]/ɪˈlæstɪk/; [or]yshx;
perpendicular: [adj]成直角的,垂直的;直立的; [n]垂直线; [a]/ˌpɜːrpənˈdɪkjələr/; [or]yshx;
flock: [n](鸟兽)群;一群人;(对牧师而言的)教徒; [v]聚集,成群而行; [a]/flɑːk/; [or]yshx;
intensify: [v]增强;加剧; [a]/ɪnˈtensɪfaɪ/; [or]yshx;
let sb. down: [n]使失望; [a]/let ˈsʌmbədi daʊn/; [or]yshx;
charge: [v]充电,充值;索价;控告;向.冲去; [n]费用;主管;控告; [a]/tʃɑːrdʒ/; [or]yshx;
warden: [n]看守人,管理员; [a]/ˈwɔːrdn/; [or]yshx;
provisional: [n]临时邮票; [adj]临时的,暂时的,暂定的; [a]/prəˈvɪʒənl/; [or]yshx;
represent: [v]代表;象征;表示;描述;阐明;说明;演绎; [a]/ˌreprɪˈzent/; [or]yshx;
teem: [vi]充满;大量存在于; [vt]生下; [a]/tiːm/; [or]yshx;
confront: [v]与某人对峙;与..对抗;正视; [a]/kənˈfrʌnt/; [or]yshx;
immune: [adj]免疫的,有免疫力的;不受影响的;免除的; [a]/ɪˈmjuːn/; [or]yshx;
foul: [adj]难闻的,发臭的;糟透了的;污秽的;犯规的; [n]犯规; [vi]犯规; [vt]弄脏,使污秽;使纠缠; [a]/faʊl/; [or]yshx;
campus: [n]校园,学校场地; [a]/ˈkæmpəs/; [or]yshx;
pledge: [v]发誓,保证,以.抵押,向.祝酒; [n]保证,誓言; [a]/pledʒ/; [or]yshx;
maintain: [v]维持,保持;断言,宣称;供养,赡养; [a]/meɪnˈteɪn/; [or]yshx;
tear: [v]撕裂,撕碎; [n]眼泪; [a]/ter/; [or]yshx;
avoid: [v]躲开,避开;避免,防止; [a]/əˈvɔɪd/; [or]yshx;
plague: [n]瘟疫;灾难;麻烦; [v]折磨;烦扰;造成麻烦; [a]/pleɪɡ/; [or]yshx;
patron: [n]老主顾;赞助人;支持者; [a]/ˈpeɪtrən/; [or]yshx;
discrete: [adj]分开的;不连续的; [a]/dɪˈskriːt/; [or]yshx;
pass off: [v]冒充,误导使把.当做.;发生; [a]/pæs ɑf/; [or]yshx;
sue: [v]控告,提起诉讼;控告;起诉; [n]女子名(Sue); [a]/suː/; [or]yshx;
crouch: [v]蹲;弯腰; [a]/kraʊtʃ/; [or]yshx;
primitive: [adj]原始的;简陋的; [n]原始人; [a]/ˈprɪmətɪv/; [or]yshx;
coed: [n]男女同校的女生; [adj]男女同校的; [a]/ˌkoʊˈed/; [or]yshx;
lull: [v]使平静,使安静,哄骗; [n]间歇,暂停,暂时平静; [a]/lʌl/; [or]yshx;
dual: [adj]双的;双重的; [a]/ˈduːəl/; [or]yshx;
terminal: [n]终点,终端;航站楼;终点站; [adj]末端的;晚期的; [a]/ˈtɜːrmɪnl/; [or]yshx;
uneven: [adj]不平坦的;不均匀的,不规则的;不公正的; [a]/ʌnˈiːvn/; [or]yshx;
nourish: [v]养育;培育(希望);增强(希望); [a]/ˈnɜːrɪʃ/; [or]yshx;
motion: [n]运动,移动;手势;提议; [v]示意; [a]/ˈmoʊʃn/; [or]yshx;
tenable: [adj]站得住脚的;无懈可击的;合理的; [a]/ˈtenəbl/; [or]yshx;
chop: [v](用力)切,砍;降低;向下猛击;终止; [n]砍;劈;剁;排骨;嘴周围的地方; [a]/tʃɑːp/; [or]yshx;
audition: [n]听力,听觉;试听;试镜; [vi]试唱; [vt]对.进行面试;让.试唱; [a]/ɔːˈdɪʃn/; [or]yshx;
rack: [n]挂架,搁架; [v]使痛苦; [a]/ræk/; [or]yshx;
summon: [v]召唤;召集;聚集; [a]/ˈsʌmən/; [or]yshx;
reluctant: [adj]不情愿的;勉强的; [a]/rɪˈlʌktənt/; [or]yshx;
nickel: [n]镍;美国五分镍币;五分钱; [a]/ˈnɪkl/; [or]yshx;
asset: [n]财产,资产,有价值的东西或人; [a]/ˈæset/; [or]yshx;
day in and day out: [adv]天天,一天又一天; [a]/deɪ ɪn ənd deɪ aʊt/; [or]yshx;
reverent: [adj]虔诚的,恭敬的; [a]/ˈrevərənt/; [or]yshx;
perplex: [v]使困惑; [a]/pərˈpleks/; [or]yshx;
curtail: [vt]截短;削减;剥夺.特权; [a]/kɜːrˈteɪl/; [or]yshx;
hit on (upon): [v]碰巧打到,偶然发现; [a]/hɪt ɔːn əˈpɔːn/; [or]yshx;
singular: [adj]单独的,单个的;奇怪的;非凡的,卓越的,显著的; [n]单数;单数形式; [a]/ˈsɪŋɡjələr/; [or]yshx;
optimum: [adj]最适宜的;最佳的; [n]最适条件;最适宜; [a]/ˈɑːptɪməm/; [or]yshx;
escalate: [v]逐步升高,逐步增强,加剧恶化; [a]/ˈeskəleɪt/; [or]yshx;
increment: [n]增长;增值; [a]/ˈɪŋkrəmənt/; [or]yshx;
go after sb. (sth.): [phr]追求,追逐; [a]/ɡoʊ ˈæftər ˈsʌmbədi ˈsʌmθɪŋ/; [or]yshx;
surge: [n]波涛汹涌;波动;激增; [v]波浪般汹涌奔腾;激增; [a]/sɜːrdʒ/; [or]yshx;
due: [adv]直接地,确切地; [adj]拖欠的;到期的,预期的;应得的;由于;适当的; [n]会费;应有的权利,应得到的东西; [a]/duː/; [or]yshx;
pillow: [n]枕头; [v]垫,枕着; [a]/ˈpɪloʊ/; [or]yshx;
behind the times: [adv]过时的; [a]/bɪˈhaɪnd ðə taɪmz/; [or]yshx;
clinic: [n]诊所;门诊(部,室); [a]/ˈklɪnɪk/; [or]yshx;
privacy: [n]隐私;秘密;私生活; [a]/ˈpraɪvəsi/; [or]yshx;
granular: [adj]粒状的,含颗粒的; [a]/ˈɡrænjələr/; [or]yshx;
vindicate: [vt]证明.无辜;维护,辩护; [a]/ˈvɪndɪkeɪt/; [or]yshx;
thrive: [v]茁壮成长;繁荣,兴旺; [a]/θraɪv/; [or]yshx;
stimulus: [n]刺激物;鼓励;促进因素; [a]/ˈstɪmjələs/; [or]yshx;
schedule: [n]时间表,日程,计划表;清单,节目表; [v]预定,安排; [a]/ˈskedʒuːl/; [or]yshx;
feel for: [phr]同情; [a]/fil fɔr/; [or]yshx;
garbage: [n]垃圾桶;垃圾; [a]/ˈɡɑːrbɪdʒ/; [or]yshx;
look for: [phr]寻找;期待; [a]/lʊk fɔr/; [or]yshx;
arrogant: [adj]傲慢的,妄自尊大的; [a]/ˈærəɡənt/; [or]yshx;
composite: [adj]合成的,复合的; [n]合成物,复合材料; [v]使合成,使混合; [a]/kəmˈpɑːzət/; [or]yshx;
filth: [n]污秽图片;污物;对警察的冒犯言辞; [a]/fɪlθ/; [or]yshx;
deluge: [n]洪水;暴雨;泛滥; [v]使泛滥;压倒; [a]/ˈdeljuːdʒ/; [or]yshx;
manipulate: [v]操纵,影响;正骨; [a]/məˈnɪpjuleɪt/; [or]yshx;
approximate: [adj]近似的,约略的; [v]接近,近似; [a]/əˈprɑːksɪmət/; [or]yshx;
diplomatic: [adj]外交的,从事外交的;老练的,圆滑的; [a]/ˌdɪpləˈmætɪk/; [or]yshx;
preliminary: [adj]初步的,预备的; [n]预赛;预考,初试;初步措施; [a]/prɪˈlɪmɪneri/; [or]yshx;
allocate: [v]分配,配给; [a]/ˈæləkeɪt/; [or]yshx;
depict: [v]描绘,描写; [a]/dɪˈpɪkt/; [or]yshx;
cite: [v]引用,引证;传唤,传讯;表彰,嘉奖; [a]/saɪt/; [or]yshx;
bacon: [n]熏猪肉,培根; [a]/ˈbeɪkən/; [or]yshx;
outlying: [adj]远离中心的;边远的; [a]/ˈaʊtlaɪɪŋ/; [or]yshx;
stern: [adj]严厉的;严峻的;苛刻的;坚决的; [n]船尾; [a]/stɜːrn/; [or]yshx;
patriotism: [n]爱国主义,爱国心,爱国精神; [a]/ˈpeɪtriətɪzəm/; [or]yshx;
starve: [v](使)饿死,挨饿; [a]/stɑːrv/; [or]yshx;
disturb: [v]打扰,妨碍;弄乱;使烦恼; [a]/dɪˈstɜːrb/; [or]yshx;
mint: [n]薄荷,薄荷糖,造币厂; [v]铸造(硬币); [a]/mɪnt/; [or]yshx;
sector: [n](经济等)部门,部分;战区,防区;扇形,扇区; [a]/ˈsektər/; [or]yshx;
bias: [n]倾斜;偏心;偏见; [v]使有偏见; [a]/ˈbaɪəs/; [or]yshx;
scar: [n]伤疤,伤痕;内心创伤; [v](给.)留下伤痕; [a]/skɑːr/; [or]yshx;
pit: [n]大坑,矿井;(赛车道旁的) 检修加油站; [v]除去(水果的)核;使凹陷; [a]/pɪt/; [or]yshx;
overhear: [v]无意中听到,偷听到; [a]/ˌoʊvərˈhɪr/; [or]yshx;
groan: [v]呻吟;抱怨; [n]呻吟; [a]/ɡroʊn/; [or]yshx;
intimidate: [v]恫吓,威胁; [a]/ɪnˈtɪmɪdeɪt/; [or]yshx;
omen: [n]征兆,预兆; [vt]预示;预告;有.的前兆; [a]/ˈoʊmən/; [or]yshx;
blonde: [adj](头发)亚麻色的,金色的; [n]金(浅)发女郎; [a]/blɑːnd/; [or]yshx;
zest: [n]兴趣,乐趣;滋味,风味; [v]给.调味; [a]/zest/; [or]yshx;
prime: [adj]首要的,主要的;最好的,第一流的; [n]青春,全盛期,青壮年时期; [v]使准备好; [a]/praɪm/; [or]yshx;
obsess: [vt]迷住,使着迷,使烦扰; [a]/əbˈses/; [or]yshx;
prototype: [n]原型,典型,样本; [a]/ˈproʊtətaɪp/; [or]yshx;
temporary: [adj]暂时的,临时的; [a]/ˈtempəreri/; [or]yshx;
dumb: [adj]哑的,暂不说话的,愚笨的; [v]使沉默; [a]/dʌm/; [or]yshx;
drowse: [v]打瞌睡;发呆;昏昏沉沉地消磨(时光); [n]瞌睡; [a]/draʊz/; [or]yshx;
vigorous: [adj]精力充沛的;强有力的,有活力的;强健的; [a]/ˈvɪɡərəs/; [or]yshx;
delegate: [n]代表; [v]委派..为代表,授权; [a]/ˈdelɪɡət/; [or]yshx;
mucous: [adj]黏液的,似黏液的; [a]/ˈmjuːkəs/; [or]yshx;
bring in: [v]增加,赚取,产生,引进; [a]/brɪŋ ɪn/; [or]yshx;
mortal: [adj]必有一死的;致命的;极端的; [n]人类; [a]/ˈmɔːrtl/; [or]yshx;
tuck: [v]把(衬衫,餐巾等的)边塞到里面;把.夹入,把.藏入; [n](衣服等的)褶,裥; [a]/tʌk/; [or]yshx;
wrought: [adj]锻造的;加工的;精细的; [a]/rɔːt/; [or]yshx;
bowel: [n]肠;内部; [a]/ˈbaʊəl/; [or]yshx;
everlasting: [adj]永恒的,持久的;无止境的;耐用的; [a]/ˌevərˈlæstɪŋ/; [or]yshx;
strive: [v]斗争;努力,奋斗; [a]/straɪv/; [or]yshx;
aesthetic: [n]美感;审美观; [adj]美学的;审美的;悦目的;雅致的; [a]/esˈθetɪk/; [or]yshx;
outspoken: [adj]直言的,坦率的; [a]/aʊtˈspoʊkən/; [or]yshx;
gale: [n]狂风,一阵(笑声); [a]/ɡeɪl/; [or]yshx;
orchestra: [n]管弦乐队; [adj]管弦乐队的; [a]/ˈɔːrkɪstrə/; [or]yshx;
think nothing of: [v]把.看作平常; [a]/θɪŋk ˈnʌθɪŋ ɑv/; [or]yshx;
patrol: [n]巡逻兵;巡逻; [v]巡逻;巡查,巡游; [a]/pəˈtroʊl/; [or]yshx;
surmount: [v]克服,战胜,越过; [a]/sərˈmaʊnt/; [or]yshx;
constrain: [v]约束;限制;强迫; [a]/kənˈstreɪn/; [or]yshx;
lay (sth.) out: [v]展示,摆开;布置,设计; [a]/leɪ ˈsʌmθɪŋ aʊt/; [or]yshx;
be better off: [phr]较富裕;更好; [a]/bi ˈbetər ɑf/; [or]yshx;
lap: [n]腰以下及大腿的前面部分;(跑道的)一圈; [v](赛跑中)比(某人)领先一圈;轻拍; [a]/læp/; [or]yshx;
adolescence: [n]青春期,青春; [a]/ˌædəˈlesns/; [or]yshx;
deprive: [v]使丧失;剥夺;免去.的职务; [a]/dɪˈpraɪv/; [or]yshx;
plaster: [n]灰泥,石膏; [v]抹泥; [a]/ˈplæstər/; [or]yshx;
spiritual: [adj]精神(上)的;宗教(上)的; [a]/ˈspɪrɪtʃuəl/; [or]yshx;
amend: [v]改进;修订;修正; [a]/əˈmend/; [or]yshx;
fare: [n]交通费;票价;食物;出租车乘客; [v](事情)进行得(好或坏); [a]/fer/; [or]yshx;
impromptu: [adj]一触即发的;即席的,即兴的; [adv]即席地,即兴地; [n]即兴之作; [a]/ɪmˈprɑːmptuː/; [or]yshx;
prophecy: [n]预言书;预言,预言能力; [a]/ˈprɑːfəsi/; [or]yshx;
cultivate: [v]耕作,养植,栽培;培养,陶冶,发展; [a]/ˈkʌltɪveɪt/; [or]yshx;
consequent: [adj]作为结果(或后果)的,随之发生的; [n]结果,随后的事; [a]/ˈkɑːnsəkwənt/; [or]yshx;
idle: [adj]空闲的;懒散的; [v]无所事事;虚度;空转;使空转; [vt]虚度; [a]/ˈaɪdl/; [or]yshx;
aquarium: [n]水族馆,水族箱,鱼缸; [a]/əˈkweriəm/; [or]yshx;
shed: [v]流出(眼泪);蜕皮;脱落;使清晰;流下;去除,摆脱; [n]棚屋; [a]/ʃed/; [or]yshx;
submerge: [v]沉没,淹没;遮掩; [a]/səbˈmɜːrdʒ/; [or]yshx;
keep sth. (back) from: [v]不让某事.;离开; [a]/kiːp ˈsʌmθɪŋ bæk frʌm/; [or]yshx;
sturdy: [adj]结实的;坚固的;强壮的;健壮的; [n](羊的)晕倒病; [a]/ˈstɜːrdi/; [or]yshx;
monologue: [n]独白,个人长篇演说; [a]/ˈmɑːnəlɔːɡ/; [or]yshx;
deadly: [adj]致命的,致死的,十足的; [adv]死一般地;非常; [a]/ˈdedli/; [or]yshx;
heritage: [n]遗产;继承物;传统;文化遗产; [a]/ˈherɪtɪdʒ/; [or]yshx;
take sth. down: [v]记录下来;拆除; [a]/teɪk ˈsʌmθɪŋ daʊn/; [or]yshx;
flaunt: [n]招摇;飘扬;藐视; [vi]炫耀;飘扬; [vt]炫耀; [a]/flɔːnt/; [or]yshx;
for the most part: [phr]多半;通常;在极大程度上; [a]/fɔr ðə moʊst pɑrt/; [or]yshx;
clear up: [v]放晴,清除,整理; [a]/klɪr ʌp/; [or]yshx;
mischief: [n]伤害;恶作剧;顽皮; [a]/ˈmɪstʃɪf/; [or]yshx;
virus: [n]病毒;(计算机) 病毒;病毒性疾病; [a]/ˈvaɪrəs/; [or]yshx;
axis: [n]轴;中心线;坐标轴;基准线; [a]/ˈæksɪs/; [or]yshx;
invalid: [adj]不能识别的;无效的;作废的,不能成立的; [n]病人,残疾人; [a]/ɪnˈvælɪd/; [or]yshx;
cordial: [adj]热情友好的,衷心的; [a]/ˈkɔːrdʒəl/; [or]yshx;
barbecue: [n]烧烤架;烧烤;烤肉; [v]红烧;烧烤; [a]/ˈbɑːrbɪkjuː/; [or]yshx;
collapse: [v](使)倒塌,(使)崩溃,(使)瓦解; [n]倒塌,崩溃,暴跌; [a]/kəˈlæps/; [or]yshx;
pliable: [adj]易弯的;柔韧的;圆滑的; [a]/ˈplaɪəbl/; [or]yshx;
dissolve: [v]使溶解;废除,使解散; [a]/dɪˈzɑːlv/; [or]yshx;
moped: [n]机动脚踏车; [a]/ˈmoʊped/; [or]yshx;
ribbon: [n]缎带,丝带,带状物; [a]/ˈrɪbən/; [or]yshx;
practical: [adj]实际的,实用的,实践的,切合实际的;〔人〕注重实际的,务实的;〔计划,方法等〕有效的,切实可行的;心灵手巧的; [n]实习课;实践课;实验考核; [a]/ˈpræktɪkl/; [or]yshx;
exotic: [adj]奇异的,珍奇的,来自异国的; [a]/ɪɡˈzɑːtɪk/; [or]yshx;
hand sth. over to sb.: [phr]移交; [a]/hænd ˈsʌmθɪŋ ˈoʊvər tu ˈsʌmbədi/; [or]yshx;
probation: [n]试用;缓刑;察看; [a]/proʊˈbeɪʃn/; [or]yshx;
stack: [n]堆,一大堆;烟囱; [v]堆积,堆放; [a]/stæk/; [or]yshx;
disorder: [n]混乱;紊乱;动乱; [vt]使混乱;使紊乱; [a]/dɪsˈɔːrdər/; [or]yshx;
get round to doing sth: [phr]抽出时间做; [a]/ɡet raʊnd tu ˈduːɪŋ ˈsʌmθɪŋ/; [or]yshx;
domain: [n]域名;领土;管区,势力圈; [a]/doʊˈmeɪn/; [or]yshx;
compact: [adj]小巧的,小型的,袖珍的,体积小的;紧密的,紧凑的,密集的; [v]把..压紧;变得坚实; [n]带镜小粉盒;合约,条约; [a]/ˈkɑːmpækt/; [or]yshx;
shutter: [n]百叶窗;照相机快门; [a]/ˈʃʌtər/; [or]yshx;
profile: [n]侧面像;外形,轮廓; [v]描绘..的轮廓,扼要描述; [a]/ˈproʊfaɪl/; [or]yshx;
mortgage: [n]按揭贷款,抵押贷款; [v]抵押; [a]/ˈmɔːrɡɪdʒ/; [or]yshx;
look out for sb.(sth.): [v]注意; [a]/lʊk aʊt fɔːrˈ sʌmbədi ˈsʌmθɪŋ/; [or]yshx;
crystal: [n]水晶,晶体;结晶;水晶做成的东西; [a]/ˈkrɪstl/; [or]yshx;
live it up: [v]过着逍遥的日子;狂欢一场; [a]/lɪv ɪt ʌp/; [or]yshx;
diagram: [n]图解,图表; [a]/ˈdaɪəɡræm/; [or]yshx;
mania: [n]癫狂,狂热; [a]/ˈmeɪniə/; [or]yshx;
potential: [n]潜力,潜能; [adj]潜在的,可能的; [a]/pəˈtenʃl/; [or]yshx;
evade: [v]躲避,回避; [a]/ɪˈveɪd/; [or]yshx;
concern: [n]关心,担忧; [v]感兴趣,涉及,关心,(使)担忧; [a]/kənˈsɜːrn/; [or]yshx;
integral: [adj](用于构成整体)必需的,不可缺少的,必不可少的;基本的,作为组成部分的,内置的;整体的,完整的; [a]/ˈɪntɪɡrəl/; [or]yshx;
oblige: [v]迫使,使感激,施恩于,帮忙,使.成为必要; [a]/əˈblaɪdʒ/; [or]yshx;
homestay: [n]在当地居民家中居住的时期;寄宿家庭; [a]/ˈhoʊmsteɪ/; [or]yshx;
dilemma: [n]进退两难的窘境; [a]/dɪˈlemə/; [or]yshx;
landscape: [n]风景;风景画;景观;横向打印格式; [v]美化环境; [a]/ˈlændskeɪp/; [or]yshx;
tremendous: [adj]巨大的;极大的;惊人的; [a]/trəˈmendəs/; [or]yshx;
consist of: [phr]由..组成; [a]/kənˈsɪst ɑv/; [or]yshx;
adept: [n]专家,能手; [adj]熟练的;巧妙的; [a]/əˈdept/; [or]yshx;
emergency: [n]紧急情况;突发事件; [a]/iˈmɜːrdʒənsi/; [or]yshx;
chin: [n]颏;下巴; [v]用下巴夹住;聊天;作引体向上动作; [a]/tʃɪn/; [or]yshx;
adjoin: [v]与.毗连;贴近; [a]/əˈdʒɔɪn/; [or]yshx;
shred: [n]碎片,少量,毁灭; [v]切成细条,撕成碎片; [a]/ʃred/; [or]yshx;
in the hands of: prep. 在.掌握中; [a]/ɪn ðə hændz ʌv/; [or]yshx;
sterling: [n]英国货币; [adj]高尚的;出色的,优秀的;英币的; [a]/ˈstɜːrlɪŋ/; [or]yshx;
bloc: [n]集团; [a]/blɑːk/; [or]yshx;
soluble: [adj]可溶解的;可解决的; [a]/ˈsɑːljəbl/; [or]yshx;
nostalgia: [n]怀旧之情,思乡病; [a]/nəˈstældʒə/; [or]yshx;
license: [n]许可;执照; [v]许可,准许;发许可证; [a]/ˈlaɪsns/; [or]yshx;
derive: [v]获取;得自;起源; [a]/dɪˈraɪv/; [or]yshx;
observance: [n](法律习俗等的)遵守;奉行;庆祝,礼仪,仪式; [a]/əbˈzɜːrvəns/; [or]yshx;
deem: [v]认为,视为;知道,相信; [a]/diːm/; [or]yshx;
be set on sth.: [adj]决心做某事; [a]/biː set ɔːn ˈsʌmθɪŋ/; [or]yshx;
robust: [adj]健壮的,强壮的;精力充沛的;坚固的;粗鲁的; [a]/roʊˈbʌst/; [or]yshx;
disregard: [v]不理会;漠视; [n]忽视,漠视; [a]/ˌdɪsrɪˈɡɑːrd/; [or]yshx;
fulfill: [v]履行,实现,完成;满足(愿望,要求等),使满意; [a]/fʊl'fɪl/; [or]yshx;
trap: [n]陷阱;捕兽夹;圈套,诡计;双轮轻便马车;嘴; [v]诱骗;困住; [a]/træp/; [or]yshx;
evict: [v]驱逐,逐出; [a]/ɪˈvɪkt/; [or]yshx;
riot: [v]闹事; [n]骚乱;暴乱;骚动;放纵; [a]/ˈraɪət/; [or]yshx;
nullify: [v]使无效,废弃,取消; [a]/ˈnʌlɪfaɪ/; [or]yshx;
gallery: [n]美术馆,画廊;(大厅的)旁听席,边座; [a]/ˈɡæləri/; [or]yshx;
recycle: [v]回收利用;改建; [n]再循环; [a]/ˌriːˈsaɪkl/; [or]yshx;
scant: [adj]不足的,缺乏的;勉强够的; [v]减少;节省;限制; [a]/skænt/; [or]yshx;
millennium: [n]千禧年;太平盛世; [a]/mɪˈleniəm/; [or]yshx;
the pick of: [phr]精华,最好部分; [a]/ðə pɪk ɑv/; [or]yshx;
coil: [n](一)卷,(一)圈;线圈; [v]卷,盘绕; [a]/kɔɪl/; [or]yshx;
penetrate: [v]刺穿,穿透;进入;了解; [a]/ˈpenətreɪt/; [or]yshx;
cash crop: [phr]经济作物; [a]/ˈkæʃ krɑːp/; [or]yshx;
moist: [adj](表面)潮湿的,湿润的; [a]/mɔɪst/; [or]yshx;
handicap: [n]障碍,阻碍,不利条件,不利因素;残疾,缺陷,生理缺陷;[高尔夫]给弱者增加的杆数(按击球次数计数,并随参赛者的进步而减少); [v]使不利,妨碍; [a]/ˈhændikæp/; [or]yshx;
harness: [n]挽具,马具,降落伞背带; [v]上挽具;治理(河流等);利用; [a]/ˈhɑːrnɪs/; [or]yshx;
gasp: [v]喘气;渴望;气喘吁吁地说出; [n]喘气; [a]/ɡæsp/; [or]yshx;
seal: [n]海豹;邮戳;封条;火漆印; [v]封(信封),密封,盖章;封锁;缄口; [a]/siːl/; [or]yshx;
counterfeit: [n]仿制品,伪造物; [adj]仿造的.假冒的; [v]伪造,仿造; [a]/ˈkaʊntərfɪt/; [or]yshx;
salute: [n]致意;致敬,欢迎; [v]向..行举手礼;敬礼; [a]/səˈluːt/; [or]yshx;
downpour: [n]倾盆大雨; [a]/ˈdaʊnpɔːr/; [or]yshx;
narcotic: [n]麻醉药;镇静剂;毒品; [adj]麻醉的;催眠的; [a]/nɑːrˈkɑːtɪk/; [or]yshx;
forum: [n]论坛;讨论会; [a]/ˈfɔːrəm/; [or]yshx;
keen: [adj]敏锐的;热衷的,热心的;强烈的,渴望的; [v]恸哭; [n]〈英〉号哭,恸哭; [adv]如饥似渴地; [a]/kiːn/; [or]yshx;
blur: [n]污点,模糊; [v]使.模糊;弄脏;变模糊; [a]/blɜːr/; [or]yshx;
sanction: [n]批准;制裁,处罚; [v]批准,支持,对..实施制裁; [a]/ˈsæŋkʃn/; [or]yshx;
subtle: [adj]微妙的;敏锐的;不明显的;精细的;狡猾的; [a]/ˈsʌtl/; [or]yshx;
indispensable: [adj]必不可少的;必需的; [a]/ˌɪndɪˈspensəbl/; [or]yshx;
reliable: [adj]可靠的;可信赖的;确实的; [a]/rɪˈlaɪəbl/; [or]yshx;
go down: [phr]下降;平静下来;被接受; [a]/ɡoʊ daʊn/; [or]yshx;
feast: [n]盛宴;筵席;节日; [v]尽情地吃; [a]/fiːst/; [or]yshx;
pasture: [n]牧场,草地;生活状况; [v]放牧; [a]/ˈpæstʃər/; [or]yshx;
rig: [n]钻井架;装备;帆具;成套器械; [v]操纵;装配;欺骗; [a]/rɪɡ/; [or]yshx;
momentum: [n](物理)动量;势头;动力; [a]/moʊˈmentəm/; [or]yshx;
slender: [adj]苗条的,修长的,纤细的; [a]/ˈslendər/; [or]yshx;
overrule: [v]否决,驳回;统治;对...施加影响; [a]/ˌoʊvərˈruːl/; [or]yshx;
ascent: [n]上升;上坡路;登高; [a]/əˈsent/; [or]yshx;
twinkle: [vi]闪烁;闪闪发光; [a]/ˈtwɪŋkl/; [or]yshx;
lure: [v]引诱;以诱饵吸引; [n]诱惑力;诱惑物;鱼饵; [a]/lʊr/; [or]yshx;
twist: [v]捻,搓;扭;歪曲; [n]搓,扭拧;意外进展;弯曲处; [a]/twɪst/; [or]yshx;
ordeal: [n]严峻考验,苦难的经历,折磨; [a]/ɔːrˈdiːl/; [or]yshx;
banquet: [n](正式的)宴会;盛宴; [adj]宴会的; [a]/ˈbæŋkwɪt/; [or]yshx;
get down to: [phr]开始认真对待;着手处理; [a]/ɡet daʊn tu/; [or]yshx;
traitor: [n]卖国贼,叛徒; [a]/ˈtreɪtər/; [or]yshx;
mock: [v]嘲笑;轻蔑,蔑视; [adj]不真诚的;伪造的; [n]模拟考; [a]/mɑːk/; [or]yshx;
invert: [v]倒置;倒转;颠倒; [a]/ɪnˈvɜːrt/; [or]yshx;
cut sth. (sb.) down: [phr]砍倒;削减;说服某人降价; [a]/kʌt ˈsʌmθɪŋ ˈsʌmbədi daʊn/; [or]yshx;
arbitrary: [adj]随意的,任性的,随心所欲的;霸道的,专制的,专横的;主观的,武断的; [a]/ˈɑːrbətreri/; [or]yshx;
confer: [v]授予(奖项,学位,荣誉或权利);商讨,协商; [a]/kənˈfɜːr/; [or]yshx;
appendix: [n]附录;阑尾;附属物; [a]/əˈpendɪks/; [or]yshx;
apparatus: [n]装置,仪器;设备;组织,机构; [a]/ˌæpəˈrætəs/; [or]yshx;
encyclopedia: [n]百科全书; [a]/ɪnˌsaɪkləˈpiːdiə/; [or]yshx;
fallacy: [n]谬论,谬见;错误,谬误; [a]/ˈfæləsi/; [or]yshx;
pass on: [phr]传给;去世; [a]/pæs ɔn/; [or]yshx;
pitch: [v]投掷;用沥青覆盖;[音]为...定音高;扎营;搭帐篷; [n]投掷;球场;沥青;音高; [a]/pɪtʃ/; [or]yshx;
gracious: [adj]和善的;亲切的;优美的;奢华的; [a]/ˈɡreɪʃəs/; [or]yshx;
pass sb. (sth.) by: [phr]经过,走过;打..旁边走过;忽视; [a]/pæs ˈsʌmbədi ˈsʌmθɪŋ baɪ/; [or]yshx;
presence: [n]出席,到场;存在;风度,仪态; [a]/ˈprezns/; [or]yshx;
designate: [adj]已受委派而尚未上任的; [v]标出,说出;委任,任命,提名;指定; [a]/ˈdezɪɡneɪt/; [or]yshx;
mercy: [n]宽恕,仁慈,怜悯,恩惠; [a]/ˈmɜːrsi/; [or]yshx;
in one's face: [adv]公开地;当着某人的面; [a]/ɪn wʌnz feɪs/; [or]yshx;
martial: [adj]武术的;好战的;军事的; [a]/ˈmɑːrʃl/; [or]yshx;
shield: [n]盾牌;防护物; [v]保护; [a]/ʃiːld/; [or]yshx;
surcharge: [n]额外费用,过高的要价; [v]追加罚款;使.装载过多;使.负担过重; [a]/ˈsɜːrtʃɑːrdʒ/; [or]yshx;
genuine: [adj]真正的;真的;真诚的; [a]/ˈdʒenjuɪn/; [or]yshx;
plead for sb.: [v]恳求;为.辩护; [a]/pliːd fɔːr ˈsʌmbədi/; [or]yshx;
retrieve: [v]取回,重新得到,挽回,检索; [a]/rɪˈtriːv/; [or]yshx;
electrical: [adj]有关电的;电气科学的; [a]/ɪˈlektrɪkl/; [or]yshx;
comet: [n]彗星; [a]/ˈkɑːmət/; [or]yshx;
address: [n]地址;致词; [v]致函;写姓名地址;向..讲话;处理; [a]/əˈdres/; [or]yshx;
charm: [n]魅力,吸引力,符咒; [v](使)着迷,施魔法; [a]/tʃɑːrm/; [or]yshx;
currency: [n]货币;流通;流行; [a]/ˈkɜːrənsi/; [or]yshx;
fluctuate: [v]波动;起伏;涨落; [a]/ˈflʌktʃueɪt/; [or]yshx;
stain: [n]污渍,污迹;染色; [v]弄脏;玷污;染色; [a]/steɪn/; [or]yshx;
reptile: [n]爬行动物,爬虫; [adj]爬行的,爬虫类的; [a]/ˈreptaɪl/; [or]yshx;
flicker: [v]闪烁,摇曳;颤动;扑动翅膀;假装昏倒; [n]闪烁,闪光; [a]/ˈflɪkər/; [or]yshx;
quest: [n]探索,寻求; [v]寻找,搜索; [a]/kwest/; [or]yshx;
foremost: [adj](位置或时间),最先的;首要的; [adv]首先,第一; [a]/ˈfɔːrmoʊst/; [or]yshx;
slip: [v]滑倒,跌落,溜走,疏忽;偷偷地给;被遗忘; [n]溜走;疏忽,错误;纸条; [adj]打有活结的;可拆卸的;滑动的; [a]/slɪp/; [or]yshx;
cling: [v]紧紧抓住;黏着,挨近;依恋,依附;坚持,墨守,忠实于; [a]/klɪŋ/; [or]yshx;
abrasion: [n]表面磨损;擦伤; [a]/əˈbreɪʒn/; [or]yshx;
monster: [n]怪物,怪兽,妖怪;巨兽,巨大的东西,庞然大物;极其残酷的人,恶人,恶魔;小恶棍,捣蛋鬼〔幽默用法〕; [adj]巨大的;庞大的; [a]/ˈmɑːnstər/; [or]yshx;
wage: [n]薪水,报酬; [v]开展,进行(战争,运动); [a]/weɪdʒ/; [or]yshx;
abort: [v]异常中断,中途失败,流产,发育不全; [a]/əˈbɔːrt/; [or]yshx;
bud: [n]蓓蕾,芽; [v]使发芽; [a]/bʌd/; [or]yshx;
dart: [n]飞镖;猛冲;标枪; [v]快速投掷;突然移动; [a]/dɑːrt/; [or]yshx;
paraphrase: [v]解释,释义; [n]转述,释义; [a]/ˈpærəfreɪz/; [or]yshx;
budget: [n]预算; [v]预算,安排; [adj]廉价的; [a]/ˈbʌdʒɪt/; [or]yshx;
amplify: [v]放大(声音等);扩大;增强;详述;进一步阐述; [a]/ˈæmplɪfaɪ/; [or]yshx;
take sth. to heart: [phr]牢记;为某事耿耿于怀; [a]/teɪk ˈsʌmθɪŋ tu hɑːrt/; [or]yshx;
buoyant: [adj]有浮力的;愉快的;(股市)保持高价的; [a]/ˈbɔɪənt/; [or]yshx;
granary: [n]谷仓,粮仓;产粮区;主要来源; [a]/ˈɡrænəri/; [or]yshx;
conscience: [n]良心,良知; [a]/ˈkɑːnʃəns/; [or]yshx;
dissipate: [v]消散,消失;浪费; [a]/ˈdɪsɪpeɪt/; [or]yshx;
soil: [n]泥土,土壤;土地,国土; [v]弄脏;污损; [a]/sɔɪl/; [or]yshx;
lever: [n]杠杆;控制杆;施加影响的手段; [v]用杠杆移动;撬开; [a]/ˈlevər/; [or]yshx;
scalpel: [n]外科手术刀,解剖刀; [a]/ˈskælpəl/; [or]yshx;
go without saying: [v]不言而喻,理所当然; [a]/ɡoʊ wɪðˈaʊt ˈseɪɪŋ/; [or]yshx;
sauce: [n]酱,调味汁;莽撞,冒失; [a]/sɔːs/; [or]yshx;
come along: [phr]一起;进步;出现; [a]/kʌm ə'lɔːŋ/; [or]yshx;
fry: [v]油煎;油炸; [n]鱼苗,鱼秧;弗赖伊(姓氏);油炸食物;(口语)烦恼,愤激; [adj]油炸的,油煎的(fried); [a]/fraɪ/; [or]yshx;
prior: [adj]在先的;优先的; [n]上司; [a]/ˈpraɪər/; [or]yshx;
pier: [n]码头;桥墩; [a]/pɪr/; [or]yshx;
mimic: [v]模仿,戏弄; [n]模仿者; [adj]模拟的;假的,伪装的; [a]/ˈmɪmɪk/; [or]yshx;
accommodate: [v]向.提供住处(或膳宿);给.提供方便;容纳;使适应,顺应; [a]/əˈkɑːmədeɪt/; [or]yshx;
nasty: [adj]令人讨厌的;严重的;恶劣的;下流的; [n](复数形式)令人不愉快或对人有害的事物; [a]/ˈnæsti/; [or]yshx;
potion: [n]一剂,一服;毒药,魔药; [a]/ˈpoʊʃn/; [or]yshx;
mire: [n]泥沼,困境; [a]/ˈmaɪər/; [or]yshx;
emit: [v]发表;散发;发射,发出; [a]/iˈmɪt/; [or]yshx;
yarn: [n]纱线,故事,奇谈; [a]/jɑːrn/; [or]yshx;
hospitality: [n]好客;款待; [a]/ˌhɑːspɪˈtæləti/; [or]yshx;
flourish: [vi]繁荣,茂盛,兴旺; [vt]挥舞;夸耀; [n]兴旺;茂盛;炫耀;挥舞; [a]/ˈflɜːrɪʃ/; [or]yshx;
once (and) for all: [adv]只此一次,彻底地; [a]/wʌns ənd fɔːr ɔːl/; [or]yshx;
enclose: [v]围住;圈起;装入信封;附有; [a]/ɪnˈkloʊz/; [or]yshx;
dilapidated: [adj]破旧的,破烂的;倾坍的; [a]/dɪˈlæpɪdeɪtɪd/; [or]yshx;
virtually: [adv]几乎;虚拟地;整个;实际上; [a]/ˈvɜːrtʃuəli/; [or]yshx;
tame: [adj]驯服的,温顺的;顺从的;枯燥的; [v]驯服; [a]/teɪm/; [or]yshx;
fracture: [n]骨折;折断;裂口; [v]使折断;使骨折; [a]/ˈfræktʃər/; [or]yshx;
tactic: [n](达到目的)手段,战术,策略; [adj]按顺序的;依次排列的; [a]/ˈtæktɪk/; [or]yshx;
principal: [n]校长,负责人;本金,资本; [adj]主要的,首要的; [a]/ˈprɪnsəpl/; [or]yshx;
humanity: [n]人性;人类;人道;慈爱;(复)人文学科; [a]/hjuːˈmænəti/; [or]yshx;
access: [n]进入;使用权;通道; [v]进入;访问; [a]/ˈækses/; [or]yshx;
domestic: [adj]国产的;国内的;家庭的;驯养的; [n]家仆;家庭纷争; [a]/dəˈmestɪk/; [or]yshx;
stick to sb. (sth.): [phr]忠于; [a]/stɪk tu ˈsʌmbədi (ˈsʌmθɪŋ)/; [or]yshx;
narrative: [n]叙述; [adj]叙述的; [a]/ˈnærətɪv/; [or]yshx;
marital: [adj]婚姻的; [a]/ˈmærɪtl/; [or]yshx;
arduous: [adj]艰巨的;努力的;陡峭的; [a]/ˈɑːrdʒuəs/; [or]yshx;
get away: [phr]离开,逃脱; [a]/ɡet, əˈweɪ/; [or]yshx;
grit: [n]沙粒;决心,勇气; [v]研磨;在.上铺砂砾;下定决心,咬紧牙关; [a]/ɡrɪt/; [or]yshx;
sociable: [adj]好交际的; [a]/ˈsoʊʃəbl/; [or]yshx;
look down on: [phr]轻视; [a]/lʊk daʊn ɑːn/; [or]yshx;
obstacle: [n]障碍;障碍物;妨碍; [a]/ˈɑːbstəkl/; [or]yshx;
decipher: [n]密电译文; [vt]解释;破译; [a]/dɪˈsaɪfər/; [or]yshx;
cute: [adj]可爱的;讨人喜爱的;聪明的; [a]/kjuːt/; [or]yshx;
as opposed to: [phr]与.形成对照; [a]/æz ə'poʊʊzd tu/; [or]yshx;
radar: [n]雷达,无线电探测器; [a]/ˈreɪdɑːr/; [or]yshx;
keep an eye on: [phr]密切注视; [a]/kiːp æn aɪɑːn/; [or]yshx;
enzyme: [n][生化]酶; [a]/ˈenzaɪm/; [or]yshx;
approval: [n]批准;赞同;试销; [a]/əˈpruːvl/; [or]yshx;
mobilize: [v]动员起来;动员;鼓动起; [a]/ˈmoʊbəlaɪz/; [or]yshx;
forthcoming: [adj]即将出现的,即将到来的;唾手可得的,可用的;乐于提供信息的; [a]/ˌfɔːrθˈkʌmɪŋ/; [or]yshx;
drought: [n]干旱,旱灾; [a]/draʊt/; [or]yshx;
crumple: [v]把.揉作一团,弄皱;压碎; [a]/ˈkrʌmpl/; [or]yshx;
ivory: [n]象牙,象牙制品;乳白色; [a]/ˈaɪvəri/; [or]yshx;
pry: [v]刺探,打听,撬开; [n]窥探;杠杆;爱打探的人; [a]/praɪ/; [or]yshx;
cooperate: [v]协作,合作; [a]/koʊˈɑːpəreɪt/; [or]yshx;
morality: [n]道德,道德观;道德规范,伦理体系; [a]/məˈræləti/; [or]yshx;
trial: [n]审判,审理;试验;试用;磨炼,苦难; [adj]试验的,试验性的;考验的;审判的; [v]测试; [a]/ˈtraɪəl/; [or]yshx;
dose: [n](药)剂量,用量,一剂; [vt]给..服药; [a]/doʊs/; [or]yshx;
come to sb.: [v]被想到; [a]/kʌm tu ˈsʌmbədi/; [or]yshx;
kidnap: [v]诱拐;绑架; [a]/ˈkɪdnæp/; [or]yshx;
illustrate: [v]举例说明,阐明;图解,加插图; [a]/ˈɪləstreɪt/; [or]yshx;
take sth. back: [phr]收回;取回; [a]/teɪk ˈsʌmθɪŋ bæk/; [or]yshx;
cassette: [n]磁带盒;录像带,盒式磁带; [a]/kəˈset/; [or]yshx;
dentist: [n]牙医; [a]/ˈdentɪst/; [or]yshx;
hilarious: [adj]有趣的;令人捧腹的;滑稽的;欢闹的; [a]/hɪˈleriəs/; [or]yshx;
charter: [n]宪章;特权,豁免权;契约,证书;租赁; [v]包,租(飞机,汽车等); [adj]包租的,租用的; [a]/ˈtʃɑːrtər/; [or]yshx;
din: [n]喧闹声,嘈杂声; [v]喧闹,喋喋不休地说; [a]/dɪn/; [or]yshx;
wedge: [v]楔入; [n]楔子; [a]/wedʒ/; [or]yshx;
demonstrate: [vt](用实例,实验)论证;演示,展示;示范; [vi]示威; [a]/ˈdemənstreɪt/; [or]yshx;
kernel: [n]子粒,谷粒;核心; [a]/ˈkɜːrnl/; [or]yshx;
esteem: [n]尊敬;尊重; [vt]尊敬;认为;考虑;估计; [a]/ɪˈstiːm/; [or]yshx;
luxury: [adj]奢侈的,豪华的; [n]奢侈,奢华; [a]/ˈlʌkʃəri/; [or]yshx;
pick sb. up: [v]结识;中途搭乘;举起; [a]/pɪk ˈsʌmbədi ʌp/; [or]yshx;
advocate: [v]提倡;主张;为.辩护; [n]辩护者;提倡者;律师; [a]/ˈædvəkeɪt/; [or]yshx;
ruthless: [adj]无情的;残忍的; [a]/ˈruːθləs/; [or]yshx;
steep: [v]沉浸于..; [adj]陡峭的;急剧的;过高的; [n]陡坡; [a]/stiːp/; [or]yshx;
meticulous: [adj]谨小慎微的;一丝不苟的; [a]/məˈtɪkjələs/; [or]yshx;
plight: [n]困境; [v]宣誓,保证; [a]/plaɪt/; [or]yshx;
boycott: [vt]抵制; [n]抵制; [a]/ˈbɔɪkɑːt/; [or]yshx;
ostentation: [n]卖弄,炫耀; [a]/ˌɑːstenˈteɪʃn/; [or]yshx;
positive: [adj]积极的;肯定的,明确的;正面的;阳性的; [n]正面;肯定;优点;正数; [a]/ˈpɑːzətɪv/; [or]yshx;
intuition: [n]直觉;感觉; [a]/ˌɪntuˈɪʃn/; [or]yshx;
get off: [phr]动身;免于受罚;从..下来;把手拿开; [a]/ɡet ɑf/; [or]yshx;
etiquette: [n]礼仪; [a]/ˈetɪket/; [or]yshx;
go without (sth.): [v]在缺少.的情况下勉强对付; [a]/ɡoʊ wɪˈðaʊt ˈsʌmθɪŋ/; [or]yshx;
bring up: [phr]养育;呕出;提出; [a]/brɪŋ ʌp/; [or]yshx;
setting: [n]设置,调整;环境,背景; [a]/ˈsetɪŋ/; [or]yshx;
condense: [v]压缩;精炼;冷凝; [a]/kənˈdens/; [or]yshx;
wane: [n]衰退(期);月亏(期);减少; [v](月)缺损;(光,势力,治理等)衰落;减少; [a]/weɪn/; [or]yshx;
minority: [n]少数;少数民族;未成年; [adj]构成少数的; [a]/maɪˈnɔːrəti/; [or]yshx;
flesh: [n]肉,肉体;果肉; [a]/fleʃ/; [or]yshx;
width: [n]宽度,广度,宽阔; [a]/wɪdθ/; [or]yshx;
subordinate: [n]部下;下属; [adj]次要的;从属的;下级的; [v]使从属于;使处于次要地位; [a]/səˈbɔːrdɪnət/; [or]yshx;
elbow: [n]手肘;衣服肘部; [v]用肘推,挤; [a]/ˈelboʊ/; [or]yshx;
prevail: [v]流行,盛行;战胜,压倒; [a]/prɪˈveɪl/; [or]yshx;
scorch: [v]烧焦;枯萎; [vi]高速行驶,疾驰,飞驰; [a]/skɔːrtʃ/; [or]yshx;
nucleus: [n]原子核,核心,细胞核; [a]/ˈnuːkliəs/; [or]yshx;
steady: [adj]稳定的,不变的;坚定的,扎实的,镇定的; [v](使)稳固,(使)稳定;使..冷静; [a]/ˈstedi/; [or]yshx;
circulate: [v](使)流通;(使)循环;(使)传播,流传; [a]/ˈsɜːrkjəleɪt/; [or]yshx;
flu: [n]流感; [a]/fluː/; [or]yshx;
encounter: [v]邂逅,遭遇,偶遇; [n]偶然碰见,遭遇; [a]/ɪnˈkaʊntər/; [or]yshx;
recline: [vi]躺,斜倚(常与on,upon或against连用);信赖; [vt]使后靠,使斜倚; [a]/rɪˈklaɪn/; [or]yshx;
ungainly: [adj]笨拙的,不雅的; [adv]笨拙地;不雅地; [a]/ʌnˈɡeɪnli/; [or]yshx;
glorious: [adj]辉煌的,壮丽的;光荣的,荣耀的; [a]/ˈɡlɔːriəs/; [or]yshx;
recover: [v]恢复;痊愈,恢复健康;收回;换回;重新获得;重新找到; [a]/rɪˈkʌvər/; [or]yshx;
profit: [n]利润,盈利;益处; [v]得益,有益于; [a]/ˈprɑːfɪt/; [or]yshx;
elementary: [adj]基本的;初级的;非常简单的; [a]/ˌelɪˈmentri/; [or]yshx;
emotion: [n]感情;情绪;强烈的感情;激动; [a]/ɪˈmoʊʃn/; [or]yshx;
catalyst: [n]催化剂;造成变化的人或事; [a]/ˈkætəlɪst/; [or]yshx;
chronological: [adj]按照时间顺序排列的; [a]/ˌkrɑːnəˈlɑːdʒɪkl/; [or]yshx;
violent: [adj]强烈的,猛烈的;暴力的,粗暴的; [a]/ˈvaɪələnt/; [or]yshx;
underlying: [adj]基本的;潜在的;在下面的; [a]/ˌʌndərˈlaɪɪŋ/; [or]yshx;
colonial: [adj]殖民地的,关于殖民的; [n]殖民地居民; [a]/kəˈloʊniəl/; [or]yshx;
ideology: [n]意识形态,思想(体系); [a]/ˌaɪdiˈɑːlədʒi/; [or]yshx;
anonymous: [adj]匿名的;无名的;不具名的;无特色的;无个性特征; [a]/əˈnɑːnɪməs/; [or]yshx;
bundle: [n]捆,包; [vt]捆; [a]/ˈbʌndl/; [or]yshx;
sarcasm: [n]讽刺,挖苦,嘲笑; [a]/ˈsɑːrkæzəm/; [or]yshx;
arena: [n]竞技场,角斗场;(活动,斗争或竞争的)场所,战场,(竞争)舞台; [a]/əˈriːnə/; [or]yshx;
punctual: [adj]准时的,守时的; [a]/ˈpʌŋktʃuəl/; [or]yshx;
abnormal: [adj]反常的;畸形的; [a]/æbˈnɔːrml/; [or]yshx;
altitude: [n]海拔,高度; [a]/ˈæltɪtuːd/; [or]yshx;
at full blast: [adv]最大地; [a]/æt fʊl blæst/; [or]yshx;
argue: [v]争吵;主张,认为;提供.证据,提出证明;表明(原因等); [a]/ˈɑːrɡjuː/; [or]yshx;
surplus: [adj]过剩的,多余的; [n]过剩,盈余;顺差; [a]/ˈsɜːrplʌs/; [or]yshx;
rouse: [vt]唤醒,唤起;激起; [a]/raʊz/; [or]yshx;
appetite: [n]食欲,胃口;欲望; [a]/ˈæpɪtaɪt/; [or]yshx;
coerce: [v]强迫,压制; [a]/koʊˈɜːrs/; [or]yshx;
originate: [vi]起源;开始; [vt]开创; [a]/əˈrɪdʒɪneɪt/; [or]yshx;
lose face: [phr]丢面子; [a]/luz feɪs/; [or]yshx;
splash: [v]泼洒,溅,使成斑驳状;将.置于显眼位置; [n]污点;飞溅的水;卖弄;拍打水的声音; 落入水的声音; [a]/splæʃ/; [or]yshx;
take sth. upon oneself: [phr]承担;担任; [a]/teɪk ˈsʌmθɪŋ əˈpɔːn wʌnˈself/; [or]yshx;
candidate: [n](官职,获奖资格等的)候选人;投考人;申请求职者; [a]/ˈkændɪdət/; [or]yshx;
excel: [vi]胜出; [vt]优于; [a]/ɪkˈsel/; [or]yshx;
salvage: [n]抢救;从灾难中抢救出的物资; [vt]拯救;打捞; [a]/ˈsælvɪdʒ/; [or]yshx;
break one's heart: [v]使人心碎; [a]/brek wʌnz hɑrt/; [or]yshx;
brace: [n][医学]牙齿定位器; [v]支柱;支撑;加固;使绷紧; [a]/breɪs/; [or]yshx;
stride: [v]大步走;越过;跨越; [vt]大步走过;跨骑在.上; [n]大步;阔步行走的姿势;一大步;跨越;正常的进展; [a]/straɪd/; [or]yshx;
safeguard: [v]保护,维护; [n]防卫措施,防范措施; [a]/ˈseɪfɡɑːrd/; [or]yshx;
permeate: [v]弥漫;普及;渗透; [a]/ˈpɜːrmieɪt/; [or]yshx;
sink: [n]水槽,洗碗池; [v](使)下沉,(使)降低;淹没,下落;使沉没; [adj]贫民窟的; [a]/sɪŋk/; [or]yshx;
cathedral: [n]大教堂; [adj]有权威的;大教堂的; [a]/kəˈθiːdrəl/; [or]yshx;
behalf: [n]代表(某人),因为某人;利益;赞同,支持; [a]/bɪˈhæf/; [or]yshx;
trait: [n]特征; [a]/treɪt/; [or]yshx;
intrinsic: [adj]固有的; [a]/ɪnˈtrɪnsɪk/; [or]yshx;
sustenance: [n]生计;食物,粮食; [a]/ˈsʌstənəns/; [or]yshx;
integrity: [n]正直,真诚;完整; [a]/ɪnˈteɡrəti/; [or]yshx;
oasis: [n]绿洲;令人欣慰的事物; [a]/oʊˈeɪsɪs/; [or]yshx;
multiply: [v]乘;繁殖;增加; [a]/ˈmʌltɪplaɪ/; [or]yshx;
dismiss: [v]开除;解散;摒除,不再考虑; [a]/dɪsˈmɪs/; [or]yshx;
tourism: [n]旅游,旅游业; [a]/ˈtʊrɪzəm/; [or]yshx;
find one's bearings: [v]指明方向;信心十足; [a]/faɪnd wʌnz ˈberɪŋs/; [or]yshx;
transparent: [adj]透明的,清澈的,明净的;易识破的,显而易见的; [a]/trænsˈpærənt/; [or]yshx;
pass sth. off: [phr]冒充,假装;蒙混过去,敷衍过去,搪塞过去; [a]/pæs ˈsʌmθɪŋ ɔːf/; [or]yshx;
look over: [phr]检查; [a]/lʊk ˈoʊvər/; [or]yshx;
decline: [n]下降;衰退; [v][语]使发生词尾变化,使变格;下降;拒绝; [a]/dɪˈklaɪn/; [or]yshx;
settle (sb.) in: [phr]迁入(新居),(使)习惯; [a]/ˈsetl ˈsʌmbədi ɪn/; [or]yshx;
expedition: [n]远征队;探险;短途旅行;迅速; [a]/ˌekspəˈdɪʃn/; [or]yshx;
traction: [n]拽;牵引;牵引力;附着磨擦力; [a]/ˈtrækʃn/; [or]yshx;
pollinate: [vt]传花粉给.; [a]/ˈpɑːləneɪt/; [or]yshx;
tug: [v]用力拖(或拉); [n]猛拉;牵引; [a]/tʌɡ/; [or]yshx;
intact: [adj]原封未动的,未受损的,完整无缺的; [a]/ɪnˈtækt/; [or]yshx;
string: [n]弦,线,细绳,一系列;一行; [v]串起;悬挂;使紧张; [adj]线的,线织的;由弦乐器组成的; [a]/strɪŋ/; [or]yshx;
trespass: [v]侵入;犯罪; [n]罪过;非法侵入; [a]/ˈtrespæs/; [or]yshx;
congestion: [n]拥挤,充血; [a]/kənˈdʒestʃən/; [or]yshx;
treatise: [n]论述;论文;专著; [a]/ˈtriːtɪs/; [or]yshx;
polish: [v]磨光,擦亮;润饰,使优美; [n]擦光剂;优美,完善; [adj]波兰的;波兰人的;波兰语的; [a]/ˈpɑːlɪʃ/; [or]yshx;
undergo: [v]经历;遭受; [a]/ˌʌndərˈɡoʊ/; [or]yshx;
set sth. off: [v]使爆炸;平衡; [a]/set ˈsʌmθɪŋ ɑːf/; [or]yshx;
destructive: [adj]破坏(性)的,毁灭(性)的; [a]/dɪˈstrʌktɪv/; [or]yshx;
cabin: [n](简陋的)小屋;船舱;客舱,机舱; [v]住在小屋里; [a]/ˈkæbɪn/; [or]yshx;
insurance: [n]保险;保险费;保险业;安全保证; [a]/ɪnˈʃʊrəns/; [or]yshx;
edition: [n]版,版本,版次; [a]/ɪˈdɪʃn/; [or]yshx;
synonym: [n]同义词;同义密码子; [a]/ˈsɪnənɪm/; [or]yshx;
interpret: [v]口译;解释;把..理解为; [a]/ɪnˈtɜːrprɪt/; [or]yshx;
knob: [n]圆形把手,旋钮,圆形突出物; [v]突出;使有球形突出物;在.上生疖(长瘤);给(门等)装球形捏手; [a]/nɑːb/; [or]yshx;
conflict: [n]冲突,(意见)分歧,战斗,斗争; [v]冲突,抵触,争执; [a]/ˈkɑːnflɪkt/; [or]yshx;
opt: [v]选择; [a]/ɑːpt/; [or]yshx;
subside: [vi]平息,减弱;减弱;(建筑)下陷;(尤指洪水的水位) 回落; [a]/səbˈsaɪd/; [or]yshx;
psychology: [n]心理学;心理状态;心理; [a]/saɪˈkɑːlədʒi/; [or]yshx;
cruise: [n]巡航;漫游;旅行; [v]航游;巡航;(出租车,船等)缓慢巡行; [a]/kruːz/; [or]yshx;
toast: [n]敬酒;烤面包,吐司; [v]为..祝酒;烤;烘; [a]/toʊst/; [or]yshx;
cereal: [n]谷物;谷类食物;谷类食品; [adj]谷类的;谷类制成的; [a]/ˈsɪriəl/; [or]yshx;
epidemic: [adj]流行性的,传染的; [n]流行病,传染病,(犯罪等的)盛行; [a]/ˌepɪˈdemɪk/; [or]yshx;
degrade: [v]贬低;降低品格(身价,价值等);分解;降低; [a]/dɪˈɡreɪd/; [or]yshx;
get into: [phr]穿上;陷入,染上(习惯);对.有兴趣; [a]/ɡet ˈɪntu/; [or]yshx;
mask: [n]面具;遮蔽物;伪装; [v]隐藏(感情);掩盖,掩饰,掩护;伪装; [a]/mæsk/; [or]yshx;
tolerance: [n]容忍,宽恕;忍耐力; [a]/ˈtɑːlərəns/; [or]yshx;
as well: [adv]同样地;也; [a]/əz wel/; [or]yshx;
reap: [v]收割;获得;收获; [a]/riːp/; [or]yshx;
controversial: [adj]引起争论的,有争议的; [a]/ˌkɑːntrəˈvɜːrʃl/; [or]yshx;
throughout: prep. 在..期间,贯穿;遍及; [adv]自始至终;到处; [a]/θruːˈaʊt/; [or]yshx;
pulp: [n]果肉;果肉酱;纸浆; [v]去除果肉,捣成浆状; [a]/pʌlp/; [or]yshx;
peer: [n]同龄人,同等地位的人;贵族; [v]仔细看,费力地看; [a]/pɪr/; [or]yshx;
inclination: [n]点头;做.的倾向;意愿;倾斜; [a]/ˌɪnklɪˈneɪʃn/; [or]yshx;
quench: [v]扑灭(火);止渴; [a]/kwentʃ/; [or]yshx;
hemisphere: [n](地球的)半球;大脑半球; [a]/ˈhemɪsfɪr/; [or]yshx;
denote: [v]是.的标志;指出; [vt]指示;代表(或表示); [a]/dɪˈnoʊt/; [or]yshx;
preface: [n]序言,前言,开端; [a]/ˈprefəs/; [or]yshx;
explore: [v]探险,探索,尝试; [a]/ɪkˈsplɔːr/; [or]yshx;
amphibian: [n]两栖动物;水陆两用飞机和车辆; [adj]两栖类的;[车辆]水陆两用的;具有双重性格的; [a]/æmˈfɪbiən/; [or]yshx;
snack: [n]零食,小吃,快餐; [a]/snæk/; [or]yshx;
slam: [v]砰地关上;猛力拉,扔;砰地放下;猛烈抨击; [n]砰的一声;大满贯; [a]/slæm/; [or]yshx;
situated: [adj]坐落在.的;处于某种境地的; [a]/ˈsɪtʃueɪtɪd/; [or]yshx;
rhetoric: [n]修辞学,浮夸的言语;雄辩术; [a]/ˈretərɪk/; [or]yshx;
locality: [n]地区;地点;位置;方位; [a]/loʊˈkæləti/; [or]yshx;
minimum: [adj]最少的,最低程度的; [n]最低限度,最小量; [a]/ˈmɪnɪməm/; [or]yshx;
loop: [n](用线,绳,带等打成的)环;环状物;环线; [vi]成圈; [vt]打成环状; [a]/luːp/; [or]yshx;
stand in (for sb.): [v]代替; [a]/stænd ɪn fɔːr ˈsʌmbədi/; [or]yshx;
get through (sth.): [v]通过(考试等); [a]/ɡet θruː ˈsʌmθɪŋ/; [or]yshx;
complicated: [adj]复杂的;难解的; [v]使复杂; [a]/ˈkɑːmplɪkeɪtɪd/; [or]yshx;
mediocre: [adj]普通的;平凡的;中等的; [a]/ˌmiːdiˈoʊkər/; [or]yshx;
layoff: [n]活动停止期间;裁员;临时解雇;操作停止;失业期; [a]/'leɪˌɔːf/; [or]yshx;
overlap: [n]重叠,重复; [v](部分地)重叠; [a]/ˌoʊvərˈlæp/; [or]yshx;
keep sb. up: [v]坚持,继续; [a]/kiːp ˈsʌmbədi ʌp/; [or]yshx;
go through (sth.): [v]仔细讨论;搜查;经受;用光(钱);穿过; [a]/ɡoʊ θruː ˈsʌmθɪŋ/; [or]yshx;
murmur: [v]低声说,低语;低声抱怨; [n]低语;喃喃说话声; [a]/ˈmɜːrmər/; [or]yshx;
precaution: [n]预防措施; [a]/prɪˈkɔːʃn/; [or]yshx;
back sb. up: [phr]支持某人; [a]/bæk ˈsʌmbədi ʌp/; [or]yshx;
magnate: [n]大人物;大亨,巨头;权贵; [a]/ˈmæɡneɪt/; [or]yshx;
numerous: [adj]为数众多的,许多的; [a]/ˈnuːmərəs/; [or]yshx;
in stock: [phr]有存货; [a]/ɪn stɒk/; [or]yshx;
flame: [v]脸变红;燃烧; [n]火焰;热情; [a]/fleɪm/; [or]yshx;
torrent: [n]湍流,洪流,奔流;迸发,连发,爆发;倾盆大雨; [a]/ˈtɔːrənt/; [or]yshx;
ambiguity: [n]模棱两可;歧义;误解; [a]/ˌæmbɪˈɡjuːəti/; [or]yshx;
wit: [n]富有机智的人;智力,才智;机智;风趣,措辞巧妙的能力; [a]/wɪt/; [or]yshx;
piracy: [n]海上掠夺;剽窃;侵犯版权; [a]/ˈpaɪrəsi/; [or]yshx;
well-to-do: [adj]富有的,有钱的,生活优裕的,小康的; [a]/ˌwel tə ˈduː/; [or]yshx;
precipice: [n]危险的处境,灾难的边缘,濒危点;悬崖; [a]/ˈpresəpɪs/; [or]yshx;
scatter: [v](使)分散,撒开,散播; [a]/ˈskætər/; [or]yshx;
plummet: [v]垂直或突然地堕下,骤然下降; [n]测锤(钓丝的)坠子;线锤;铅锤线;锤规; [a]/ˈplʌmɪt/; [or]yshx;
obscure: [v]隐藏,使.模糊;使变暗;遮掩; [adj]不清楚的;难以理解的; [n]某种模糊的或不清楚的东西; [a]/əbˈskjʊr/; [or]yshx;
ignite: [v]点燃,发光,燃烧; [a]/ɪɡˈnaɪt/; [or]yshx;
archives: [n]档案室,档案; [a]/ˈɑːrkaɪvz/; [or]yshx;
vigilant: [adj]警戒的,警惕的; [a]/ˈvɪdʒɪlənt/; [or]yshx;
inclusive: [adj]包含..在内的,包罗广泛的; [a]/ɪnˈkluːsɪv/; [or]yshx;
manacle: [v]上手铐,束缚; [n]手铐; [a]/ˈmænəkl/; [or]yshx;
scenery: [n]风景;布景; [a]/ˈsiːnəri/; [or]yshx;
curse: [n]诅咒;咒骂;祸因; [v]诅咒;咒骂;使受罪; [a]/kɜːrs/; [or]yshx;
inevitable: [adj]不可避免的,必然的; [n]必然发生的事; [a]/ɪnˈevɪtəbl/; [or]yshx;
keep at: [v]不断地做; [a]/kip ət/; [or]yshx;
rejoice: [v]欣喜,高兴; [a]/rɪˈdʒɔɪs/; [or]yshx;
be on edge: [phr]紧张不安; [a]/bi ɑn ɛdʒ/; [or]yshx;
adequate: [adj]充足的,充分的,足够的;尚可的,过得去的; [a]/ˈædɪkwət/; [or]yshx;
brink: [n](尤指崖边)边缘; [a]/brɪŋk/; [or]yshx;
turf: [n]草地,草皮; [v]覆草皮; [a]/tɜːrf/; [or]yshx;
brew: [v]调制;酿造;冲泡 (茶,咖啡等);酝酿;筹划; [n]酝酿的饮料;啤酒; [a]/bruː/; [or]yshx;
log: [n]原木;航海日志; [v]伐木;航行;记录;登录; [a]/lɔːɡ/; [or]yshx;
contact: [v]接触;联系; [n]接触;联系; [adj]保持接触的;由接触引起的;[航]可看见地面景物的; [adv][航]以目力观察(飞行); int. 开动; [a]/ˈkɑːntækt/; [or]yshx;
gear: [n]档位;齿轮;装备;衣物; [v]使适合; [a]/ɡɪr/; [or]yshx;
burial: [n]埋葬,葬礼;掩埋; [a]/ˈberiəl/; [or]yshx;
agony: [n]极大痛苦; [a]/ˈæɡəni/; [or]yshx;
ashamed: [adj]感到羞愧的;害臊的; [a]/əˈʃeɪmd/; [or]yshx;
thirst: [n]渴;干渴,缺水;渴求,渴望; [v]渴求; [a]/θɜːrst/; [or]yshx;
vessel: [n]船,容器,血管; [a]/ˈvesl/; [or]yshx;
entry: [n]入口处;登记;进入; [a]/ˈentri/; [or]yshx;
litter: [n]垃圾;杂乱; [v]乱丢; [a]/ˈlɪtər/; [or]yshx;
toil: [v]苦干;跋涉;费力地做; [n]辛苦;苦工;罗网; [a]/tɔɪl/; [or]yshx;
enthusiastic: [adj]狂热的,极感兴趣的,热情的; [a]/ɪnˌθuːziˈæstɪk/; [or]yshx;
go out: [v]外出,参加社交活动,熄灭,(衣服式样)过时,出去,交往; [a]/ɡoʊ aʊt/; [or]yshx;
scholarship: [n]学问;奖学金;学术界;学术成就; [a]/ˈskɑːlərʃɪp/; [or]yshx;
disc: [n]唱片;[计] 磁盘,磁碟片;椎间盘;圆盘,盘状物; [a]/dɪsk/; [or]yshx;
alternate: [adj]交替的,轮流的,间隔的; [v](使)交替,(使)轮流; [n]代替者; [a]/ˈɔːltərnət/; [or]yshx;
come up against: [v]碰到(困难,反对); [a]/kʌm ʌp əˈɡenst/; [or]yshx;
instinct: [n]天性;本能;直觉; [adj]充满的; [a]/ˈɪnstɪŋkt/; [or]yshx;
keep in with sb.: [phr]与(某人)友好相处; [a]/kiːp ɪn wɪθ ˈsʌmbədi/; [or]yshx;
look on (sb.) as: [v]当作..看待; [a]/lʊk ɔːn ˈsʌmbədi æz/; [or]yshx;
contrast: [n]差异,对照,对比;对照;对比; [v](with)使与..对比; [a]/ˈkɑːntræst/; [or]yshx;
overwrought: [adj]过分紧张的,过度兴奋的; [a]/ˌoʊvərˈrɔːt/; [or]yshx;
sole: [n]脚底,鞋底,袜底; [adj]唯一的;独有的;单独的; [v]装鞋底; [a]/soʊl/; [or]yshx;
poverty: [n]贫困;贫穷; [a]/ˈpɑːvərti/; [or]yshx;
languid: [adj]没精打采的,倦怠的; [a]/ˈlæŋɡwɪd/; [or]yshx;
go into: [phr]进入;加入;变得;探究; [a]/ɡoʊ ˈɪntu/; [or]yshx;
detain: [v]拘留,使延迟; [a]/dɪˈteɪn/; [or]yshx;
score: [n]得分;刻痕;二十;配乐; [vi]刻痕; [v]得分; [vt]在.上刻痕; [a]/skɔːr/; [or]yshx;
apt: [adj]恰当的;有(做某事的)倾向; [a]/æpt/; [or]yshx;
abundance: [n]丰富;大量; [a]/əˈbʌndəns/; [or]yshx;
conserve: [v]保藏,保存;节约; [n]蜜饯,果酱; [a]/kənˈsɜːrv/; [or]yshx;
agenda: [n]议事日程; [a]/əˈdʒendə/; [or]yshx;
generic: [n]无注册商标产品;通名; [adj]一般的;非商标的;属的,类的; [a]/dʒəˈnerɪk/; [or]yshx;
in no time: [adv]立刻; [a]/ɪn noʊ taɪm/; [or]yshx;
whirl: [v]回旋;使旋转; [n]回旋;一个接一个的活动; [a]/wɜːrl/; [or]yshx;
neglect: [v]忽视;忽略;疏忽; [n]疏忽;忽视; [a]/nɪˈɡlekt/; [or]yshx;
durable: [adj]耐用的,长久的; [n]耐用品; [a]/ˈdʊrəbl/; [or]yshx;
fend: [v](靠自己)照顾,照料;保护;力争; [a]/fend/; [or]yshx;
hedge: [v]防范,规避;避免直接答复,避免直接回答;围住;用树篱围起; [n]篱笆,树篱;保障; [a]/hedʒ/; [or]yshx;
attach: [v]系;贴;附上;附加;缚; [a]/əˈtætʃ/; [or]yshx;
sensible: [adj]明智的,理智的;可觉察的;实用耐穿的; [a]/ˈsensəbl/; [or]yshx;
marine: [adj]海洋的,航海的,海产的,海军的; [n]海军士兵; [a]/məˈriːn/; [or]yshx;
come to terms (with sb.): [phr]与..达成协议; [a]/kʌm tu tɜːrmz wɪθ ˈsʌmbədi/; [or]yshx;
statesman: [n]政治家; [a]/ˈsteɪtsmən/; [or]yshx;
submit: [v]提交;屈服,使...服从;建议,主张; [a]/səbˈmɪt/; [or]yshx;
ostensible: [adj]表面上的,伪装的; [a]/ɑːˈstensəbl/; [or]yshx;
excerpt: [n]摘录,节选; [v]摘,选;引用; [a]/ˈeksɜːrpt/; [or]yshx;
heal: [v]治愈,治疗;痊愈;恢复; [a]/hiːl/; [or]yshx;
essay: [n]文章;论文;尝试;随笔; [v]尝试; [a]/ˈeseɪ/; [or]yshx;
give way (to sb.): [v]让步,屈服; [a]/ɡɪv weɪ tu ˈsʌmbədi/; [or]yshx;
weary: [adj]疲倦的,困乏的,令人厌倦的; [v]使疲倦;使厌倦; [a]/ˈwɪri/; [or]yshx;
morbid: [adj]疾病的;(精神等)病态的;恐怖的; [a]/ˈmɔːrbɪd/; [or]yshx;
ballet: [n]芭蕾舞,芭蕾舞剧;芭蕾舞团; [a]/bæˈleɪ/; [or]yshx;
rigid: [adj]坚硬的;僵硬的;死板的; [a]/ˈrɪdʒɪd/; [or]yshx;
bald: [adj]秃头的; [a]/bɔːld/; [or]yshx;
distort: [v]扭曲,使变形;歪曲,曲解; [a]/dɪˈstɔːrt/; [or]yshx;
fastidious: [adj]难讨好的,爱挑剔的; [a]/fæˈstɪdiəs/; [or]yshx;
desperate: [adj]绝望的;孤注一掷的;极需要的,渴望的;(情况) 极严重的;极危险的;很危急的; [a]/ˈdespərət/; [or]yshx;
fuse: [n]导火线,引信,保险丝; [v](使)因保险丝熔断而中断工作,熔合,合并; [a]/fjuːz/; [or]yshx;
participate: [v]参与,加入; [a]/pɑːrˈtɪsɪpeɪt/; [or]yshx;
performance: [n]表演,演出;表现;执行;性能; [a]/pərˈfɔːrməns/; [or]yshx;
meteorology: [n]气象学; [a]/ˌmiːtiəˈrɑːlədʒi/; [or]yshx;
typical: [adj]典型的;代表性的; [a]/ˈtɪpɪkl/; [or]yshx;
boost: [v]增加;偷盗; [n]提高;激励;后推;助推发动机; [a]/buːst/; [or]yshx;
recall: [v]回想起,记起,回忆;召回; [n]召回(有问题的产品); [a]/rɪˈkɔːl/; [or]yshx;
perturb: [vt]使不安;烦扰;使紊乱; [a]/pərˈtɜːrb/; [or]yshx;
remind: [v]提醒,使想起; [a]/rɪˈmaɪnd/; [or]yshx;
apologetic: [adj]表示歉意的;赔罪的; [a]/əˌpɑːləˈdʒetɪk/; [or]yshx;
downtown: [adj]商业区的,闹市区的; [adv]在商业区,在市中心; [n]市中心区,市中心; [a]/ˈdaʊntaʊn/; [or]yshx;
perennial: [adj]终年的,永久的;四季不断的;反复的; [n]多年生植物; [a]/pəˈreniəl/; [or]yshx;
classic: [adj]经典的;古典的;高雅的;一流的; [n]经典著作;文豪;优秀典范; [a]/ˈklæsɪk/; [or]yshx;
transport: [v]运输;使狂喜;流放; [n]运输;运输工具;流放犯; [a]/ˈtrænspɔːrt/; [or]yshx;
orbit: [v]环绕..的轨道运行; [n]轨道; [vi]环绕..的轨道运行; [a]/ˈɔːrbɪt/; [or]yshx;
steak: [n]牛排;肉块;鱼块; [a]/steɪk/; [or]yshx;
capsule: [n]胶囊;航天舱,密封舱; [a]/ˈkæpsl/; [or]yshx;
kidney: [n]肾,腰子; [a]/ˈkɪdni/; [or]yshx;
envisage: [v]想象,设想; [a]/ɪnˈvɪzɪdʒ/; [or]yshx;
lose heart: [v]丧失信心; [a]/luz hɑrt/; [or]yshx;
identify: [v]认出,联系;识别;确定,鉴定,发现;认为.等同,认为.关系紧密;表明.的身份;认同,有共鸣,有同感; [a]/aɪˈdentɪfaɪ/; [or]yshx;
agreement: [n]协议,协定;一致,相合; [a]/əˈɡriːmənt/; [or]yshx;
constrict: [v]约束,收缩,妨碍; [a]/kənˈstrɪkt/; [or]yshx;
severe: [adj]严重的;严厉的;严酷的;剧烈的; [a]/sɪˈvɪr/; [or]yshx;
trigger: [n](枪等的)扳机,诱因; [v]触发,引起,激发,扣扳机; [a]/ˈtrɪɡər/; [or]yshx;
outfit: [n]装备,全部用品,(协同工作)的一组人; [v]提供装备; [a]/ˈaʊtfɪt/; [or]yshx;
ancestor: [n]祖宗;祖先;原型; [a]/ˈænsestər/; [or]yshx;
vogue: [n]时髦,时尚; [adj]流行的; [a]/voʊɡ/; [or]yshx;
perspective: [n]角度,视角,观点,想法;(对事物的)合理判断,正确认识;远景;透视图,透视法,透视效果; [adj]透视的; [a]/pərˈspektɪv/; [or]yshx;
surrender: [v]投降;屈服;放弃;交出;自首; [n]投降;放弃;屈服;(保险的)解约; [a]/səˈrendər/; [or]yshx;
stabilize: [v]使稳定; [a]/ˈsteɪbəlaɪz/; [or]yshx;
cemetery: [n]公墓;墓地; [a]/ˈseməteri/; [or]yshx;
radius: [n]半径;范围; [a]/ˈreɪdiəs/; [or]yshx;
misguided: [adj]被引入歧途的;被误导的; [v]使入歧途; [a]/ˌmɪsˈɡaɪdɪd/; [or]yshx;
take one's time (over sth.): [v]慢慢做; [a]/teɪk wʌnz taɪm ˈoʊvər ˈsʌmθɪŋ/; [or]yshx;
responsive: [adj]反应积极的,反应敏捷的;反应热烈的;响应的; [a]/rɪˈspɑːnsɪv/; [or]yshx;
sheer: [adj]陡峭的;纯粹的; [v](off)急转向,偏离; [n]透明薄纱,透明布料的衣服; [adv]完全地,全然;垂直地,陡峭地; [a]/ʃɪr/; [or]yshx;
shatter: [v]使粉碎;砸碎;打碎;粉碎; [a]/ˈʃætər/; [or]yshx;
ripple: [n]涟漪,波纹; [v](使)泛起层层细浪; [a]/ˈrɪpl/; [or]yshx;
denounce: [v]谴责,斥责; [a]/dɪˈnaʊns/; [or]yshx;
rely: [v]依赖,依靠;信赖; [a]/rɪˈlaɪ/; [or]yshx;
dissertation: [n](博士学位)论文;学术演讲;专题; [a]/ˌdɪsərˈteɪʃn/; [or]yshx;
beard: [n](下巴上的)胡须; [v]公开反对;抓住胡须; [a]/bɪrd/; [or]yshx;
advent: [n]来临;到来;出现; [a]/ˈædvent/; [or]yshx;
brochure: [n]手册,小册子; [a]/broʊˈʃʊr/; [or]yshx;
exceptional: [adj]优越的,杰出的;异常的; [a]/ɪkˈsepʃənl/; [or]yshx;
overt: [adj]明显的;公开的;公然的; [a]/oʊˈvɜːrt/; [or]yshx;
basement: [n][建筑学]地下室;根基; [a]/ˈbeɪsmənt/; [or]yshx;
meditate: [v]考虑,沉思,冥想; [a]/ˈmedɪteɪt/; [or]yshx;
at the mercy of: prep. 在.支配中,任凭.摆布; [a]/ət ðə ˈmɜrsi ɑv/; [or]yshx;
ramble: [vi]瞎扯;溜达;漫步于; [n]漫步; [a]/ˈræmbl/; [or]yshx;
outrageous: [adj]粗暴的,无礼的; [a]/aʊtˈreɪdʒəs/; [or]yshx;
contract: [n]合同,契约; [v]感染(疾病);招致;订合同;订立(婚约);缩减; [a]/ˈkɑːntrækt/; [or]yshx;
accord: [n]协议; [v]授予; [a]/əˈkɔːrd/; [or]yshx;
ponder: [v]仔细考虑,沉思; [a]/ˈpɑːndər/; [or]yshx;
infest: [v]骚扰,寄生于,大批出没; [a]/ɪnˈfest/; [or]yshx;
extinct: [adj]灭绝的;破灭了的,消亡了的; [a]/ɪkˈstɪŋkt/; [or]yshx;
gigantic: [adj]巨大的; [a]/dʒaɪˈɡæntɪk/; [or]yshx;
craft: [n]手工艺,手工制品,船,航天器; [v]手工制作,精心制作; [a]/kræft/; [or]yshx;
misgiving: [n]疑虑; [vt]担忧;使.疑虑;害怕(misgive的变形); [a]/ˌmɪsˈɡɪvɪŋ/; [or]yshx;
grand: [adj]壮丽的,宏伟的,重大的;傲慢的;极好的; [n]一千美元;大钢琴; [a]/ɡrænd/; [or]yshx;
underwrite: [v]给.保险,承诺支付;同意赔款(海上保险); [a]/ˌʌndərˈraɪt/; [or]yshx;
undermine: [v]暗中破坏;逐渐削弱;侵蚀.的基础;在...下挖坑道,从根基处损害; [a]/ˌʌndərˈmaɪn/; [or]yshx;
come off: [phr]从..掉下,发生,举行,(计划)实现; [a]/kʌm ɑf/; [or]yshx;
postgraduate: [n]研究生; [adj]大学毕业后的,研究生的; [a]/ˌpoʊstˈɡrædʒuət/; [or]yshx;
format: [n]版式;设计;格式; [v]设计一个版式;使格式化;设计.的版面; [a]/ˈfɔːrmæt/; [or]yshx;
brashness: [n]莽撞,无礼,轻率; [a]/ˈbræʃnəs/; [or]yshx;
glare: [v]怒目而视;发出强光; [n]眩目的光;瞪眼; [a]/ɡler/; [or]yshx;
take off: [phr](飞机)起飞;拿掉;取消;脱衣;(事业)突然成功,突然蹿红; [a]/teɪk, ɒf/; [or]yshx;
mundane: [adj]普通的,平凡的;单调的;现世的,世俗的; [a]/mʌnˈdeɪn/; [or]yshx;
lag: [n]落后,延迟; [v]落后;缓慢进行,减退; [a]/læɡ/; [or]yshx;
host: [n]东道主,主持人;大量; [v]主持,主办; [a]/hoʊst/; [or]yshx;
grin: [v]露齿而笑,咧嘴一笑; [n]龇牙笑; [a]/ɡrɪn/; [or]yshx;
diverse: [adj]不同的,差异的,多种多样的; [a]/daɪˈvɜːrs/; [or]yshx;
distinct: [adj]截然不同的;独特的;明显的;清晰的; [a]/dɪˈstɪŋkt/; [or]yshx;
attempt: [n]尝试;企图; [vt]努力去做;试图,尝试; [a]/əˈtempt/; [or]yshx;
wicked: [adj]邪恶的,恶毒的;淘气的,恶作剧的; [n]恶人;邪恶的人; [adv]用作加强语气用; [a]/ˈwɪkɪd/; [or]yshx;
at the outset: [phr]在开头时; [a]/ət ðə ˈaʊtˌset/; [or]yshx;
novel: [n]小说,长篇故事; [adj]新奇的,新颖的,不同的; [a]/ˈnɑːvl/; [or]yshx;
choke: [v]噎住,(使)窒息,阻塞; [n]窒息,噎住; [a]/tʃoʊk/; [or]yshx;
circus: [n]马戏团;杂技团;环形广场;闹剧(表示不满); [a]/ˈsɜːrkəs/; [or]yshx;
perpetual: [adj]永远的,永恒的;不断的; [a]/pərˈpetʃuəl/; [or]yshx;
maim: [v]使残废; [a]/meɪm/; [or]yshx;
badminton: [n]羽毛球;羽毛球运动; [a]/ˈbædmɪntən/; [or]yshx;
pungent: [adj]刺激性的;刺鼻的;尖锐的; [a]/ˈpʌndʒənt/; [or]yshx;
Antarctic: [adj]南极的; [n]南极区; [a]/ænˈtɑːrktɪk/; [or]yshx;
commercial: [adj]商业性的,贸易的; [n]商业广告; [a]/kəˈmɜːrʃl/; [or]yshx;
do sb. a favour: [v]为某人帮个忙; [a]/duːˈsʌmbədi ə ˈfeɪvər/; [or]yshx;
chill: [n]寒冷; [v](使)感到冷,使变冷; [adj]扫兴的; [a]/tʃɪl/; [or]yshx;
embed: [v]把.嵌入;使嵌入; [a]/ɪmˈbed/; [or]yshx;
scold: [v]怒骂,责骂,训斥; [n]斥责;爱责骂的人; [a]/skoʊld/; [or]yshx;
drown: [v]淹死;淹没; [a]/draʊn/; [or]yshx;
clause: [n]条款;从句; [a]/klɔːz/; [or]yshx;
neurosis: [n][心理]神经症,神经衰弱症; [a]/nʊˈroʊsɪs/; [or]yshx;
dean: [n](大学的)学院院长;系主任;资格最老者,泰斗;牧师; [a]/diːn/; [or]yshx;
get at sb.(sth.): [v]到达,得到;接近; [a]/ɡet æt ˈsʌmbədi ˈsʌmθɪŋ/; [or]yshx;
tramp: [n]流浪汉;无业游民;沉重的脚步声;长途跋涉; [v]重步行走;踏;践踏; [a]/træmp/; [or]yshx;
witness: [n]目击者,证人; [v]目击,亲眼看见;为..作证; [a]/ˈwɪtnəs/; [or]yshx;
panic: [n]恐慌;惊慌;慌乱; [v](使)恐慌;使..惊慌失措; [adj]恐慌的,惊慌的; [a]/ˈpænɪk/; [or]yshx;
rust: [v]生锈;氧化; [n]锈; [a]/rʌst/; [or]yshx;
virtuous: [adj]善良的,有德行的,贞洁的; [a]/ˈvɜːrtʃuəs/; [or]yshx;
absurd: [adj]荒唐的;可笑的;不合理的; [n]荒唐; [a]/əbˈsɜːrd/; [or]yshx;
dismay: [n]失望;沮丧;惊愕; [v]使惊恐; [a]/dɪsˈmeɪ/; [or]yshx;
put an end to: [v]停止,消灭; [a]/pʊt ən end tu/; [or]yshx;
transcend: [v]超越(经验,理性,信念等)的范围,超过; [a]/trænˈsend/; [or]yshx;
beat sb. (sth.) off: [v]击退; [a]/biːt ˈsʌmbədi ˈsʌmθɪŋ ɑːf/; [or]yshx;
nil: [n]零;无; [a]/nɪl/; [or]yshx;
liquor: [n]酒;烈性酒;液剂; [a]/ˈlɪkər/; [or]yshx;
bear sth.(sb.) out: [v]证实; [a]/ber ˈsʌmθɪŋ ˈsʌmbədi aʊt/; [or]yshx;
advertise: [v]为..做广告;公告;公布; [a]/ˈædvərtaɪz/; [or]yshx;
attendant: [n]服务员,侍者,随从; [adj]伴随的,随之而产生的; [a]/əˈtendənt/; [or]yshx;
Catholic: [adj](兴趣等)广泛的,(C大写)天主教的; [n](C大写)天主教徒; [a]/ˈkæθlɪk/; [or]yshx;
migrate: [vi]迁徙;迁移,移往;迁移; [a]/ˈmaɪɡreɪt/; [or]yshx;
custodian: [n]监护人,保管人,看守人; [a]/kʌˈstoʊdiən/; [or]yshx;
sweater: [n]毛衣,厚运动衫,羊毛衫; [a]/ˈswetər/; [or]yshx;
coalition: [n]结合;联盟;联合; [a]/ˌkoʊəˈlɪʃn/; [or]yshx;
outskirts: [n](尤指城市)郊区; [a]/ˈaʊtskɜːrts/; [or]yshx;
outdated: [adj]过时的,老式的;落伍的; [a]/ˌaʊtˈdeɪtɪd/; [or]yshx;
emigrate: [v]移居国外(或外地); [a]/ˈemɪɡreɪt/; [or]yshx;
colossal: [adj]巨像(似)的;巨大的,庞大的; [a]/kəˈlɑːsl/; [or]yshx;
lash: [v]鞭打;猛烈抨击;捆绑;摆动;猛击; [n]鞭梢;鞭打; [a]/læʃ/; [or]yshx;
expertise: [n]专门知识,专门技能; [a]/ˌekspɜːrˈtiːz/; [or]yshx;
defile: [v]污损,弄脏;以纵队前进; [n]狭谷;隘路; [a]/dɪˈfaɪl/; [or]yshx;
caption: [n](报刊的)标题;(插图,照片等的)说明文字; [v]给(图片,照片等)加说明文字; [a]/ˈkæpʃn/; [or]yshx;
rehabilitate: [v]使康复,使恢复名誉,使恢复原状; [a]/ˌriːəˈbɪlɪteɪt/; [or]yshx;
carrier: [n]搬运工,运送人;运输公司;航空母舰; [a]/ˈkæriər/; [or]yshx;
posthumous: [adj]遗腹的;著作者死后出版的;死后的; [a]/ˈpɑːstʃəməs/; [or]yshx;
barrel: [n]桶;枪管; [vi]快速移动; [a]/ˈbærəl/; [or]yshx;
commute: [n]在两地之间乘车往返; [v]经常乘车往返于两地之间; [vt]减免; [a]/kəˈmjuːt/; [or]yshx;
go with sb. (sth.): [phr]陪伴.去;与.相配; [a]/ɡoʊ wɪθ ˈsʌmbədi ˈsʌmθɪŋ/; [or]yshx;
attractive: [adj]有魅力的;吸引人的;引起兴趣的; [a]/əˈtræktɪv/; [or]yshx;
transistor: [n]晶体管;半导体收音机; [a]/trænˈzɪstər/; [or]yshx;
endeavour: [n]尝试; [v]努力; [a]/ɪnˈdevər/; [or]yshx;
elicit: [v]引出;诱出;探出; [a]/iˈlɪsɪt/; [or]yshx;
beam: [n]光线;(房屋等)大梁;(横)梁; [v]发光;照射;发射,播送;微笑;用梁支撑; [a]/biːm/; [or]yshx;
lose one's bearings: [phr]迷失方向;不知所措; [a]/luːz wʌnz ˈberɪŋs/; [or]yshx;
update: [v]更新;为..提供最新信息; [n]更新;最新的情况; [a]/ˌʌpˈdeɪt/; [or]yshx;
energetic: [adj]精力充沛的,充满活力的;有力的,积极的; [a]/ˌenərˈdʒetɪk/; [or]yshx;
cashier: [n]出纳员,收银员; [v]把..撤职;驱逐,革除,废除; [a]/kæˈʃɪr/; [or]yshx;
amuse: [v]娱乐,消遣,使发笑; [a]/əˈmjuːz/; [or]yshx;
pimple: [n]丘疹,脓疱; [a]/ˈpɪmpl/; [or]yshx;
rough: [adj]粗糙的;大致的,粗略的;(海)波涛汹涌的;困难的,令人不快的; [n]草稿; [adv]粗暴地; [v]艰苦生活; [a]/rʌf/; [or]yshx;
violate: [v]违反,违背;侵犯,妨碍;亵渎; [a]/ˈvaɪəleɪt/; [or]yshx;
component: [n]零件; [adj]组成的; [a]/kəmˈpoʊnənt/; [or]yshx;
staple: [v]用订书钉订; [n]订书钉;主食;主要产品; [adj]主要的;基本的;标准的; [a]/ˈsteɪpl/; [or]yshx;
outbreak: [n](战争,叛乱,感情等的)爆发;突然发生; [vi]爆发; [a]/ˈaʊtbreɪk/; [or]yshx;
qualitative: [adj](性)质的,定性的; [a]/ˈkwɑːləteɪtɪv/; [or]yshx;
prosecute: [v]起诉;做检察官;从事; [a]/ˈprɑːsɪkjuːt/; [or]yshx;
numerical: [adj]数字的,用数字表示的; [a]/nuːˈmerɪkl/; [or]yshx;
solitary: [adj]孤独的,单独的,隐居的; [n]独居者,隐士;单独禁闭; [a]/ˈsɑːləteri/; [or]yshx;
oblong: [n]长方形,椭圆形; [adj]椭圆形的;长方形的; [a]/ˈɑːblɔːŋ/; [or]yshx;
for one thing: [phr]首先;一则; [a]/fɔr wʌn θɪŋ/; [or]yshx;
simplify: [v]精简,使单纯; [a]/ˈsɪmplɪfaɪ/; [or]yshx;
standard: [n]标准,规格;规范; [adj]标准的; [a]/ˈstændərd/; [or]yshx;
resume: [n]简历; [v]重新开始;继续; [vt]回到;恢复;重新开始; [a]/ˈrezəmeɪ/; [or]yshx;
release: [v]释放;解放;发行; [n]解除;免除;发表; [a]/rɪˈliːs/; [or]yshx;
get on: [phr]上车(飞机,船),进展,使前进; [a]/ɡet ɔːn/; [or]yshx;
dispute: [n]争论,争端; [v]争执,驳斥; [a]/dɪˈspjuːt/; [or]yshx;
plagiarize: [v]剽窃,抄袭(别人学说,著作); [a]/ˈpleɪdʒəraɪz/; [or]yshx;
descend: [vi]走下;降临; [v]下降,下来;突然访问;下移,下降; [a]/dɪˈsend/; [or]yshx;
vent: [n]发泄;通风口,排气口;(上衣背部或两侧的)开衩;(小型动物的)排泄口; [v]发泄(情绪),开孔,泄露; [a]/vent/; [or]yshx;
accelerate: [v]加速,增长;使增速,促进; [a]/əkˈseləreɪt/; [or]yshx;
underline: [v]划线于.之下;突出显示;强调; [n]下划线;下期节目预告;图下说明文字; [a]/ˌʌndərˈlaɪn/; [or]yshx;
outcome: [n]结果,后果; [a]/ˈaʊtkʌm/; [or]yshx;
palpitate: [v](心脏)悸动,发抖; [a]/ˈpælpɪteɪt/; [or]yshx;
notable: [n]著名人士; [adj]值得注意的,显著的,显要的; [a]/ˈnoʊtəbl/; [or]yshx;
inaugurate: [v]为..揭幕;为.举行就职典礼;开展; [a]/ɪˈnɔːɡjəreɪt/; [or]yshx;
acute: [adj](疼痛,妒忌等)剧烈的,严重的;敏锐的;急性的;尖声的; [a]/əˈkjut/; [or]yshx;
percussion: [n]撞击,敲击;敲打乐器; [a]/pərˈkʌʃn/; [or]yshx;
guardian: [n]保护人;监护人; [a]/ˈɡɑːrdiən/; [or]yshx;
hypothesis: [n]假说;假设; [a]/haɪˈpɑːθəsɪs/; [or]yshx;
attorney: [n](辩护)律师; [a]/əˈtɜːrni/; [or]yshx;
inherent: [adj]内在的,固有的;生来就有的; [a]/ɪnˈhɪrənt/; [or]yshx;
impact: [n]碰撞,冲击;冲击力;影响; [v]冲击;压紧;产生影响;塞满; [a]/ˈɪmpækt/; [or]yshx;
creation: [n]创造,创作;创造物,作品; [a]/kriˈeɪʃn/; [or]yshx;
lubricate: [v]使.润滑;给.加润滑油; [a]/ˈluːbrɪkeɪt/; [or]yshx;
interrogate: [v]审问,审讯; [a]/ɪnˈterəɡeɪt/; [or]yshx;
take sth. into account: [v]考虑到某事; [a]/teɪk ˈsʌmθɪŋ ˈɪntu əˈkaʊnt/; [or]yshx;
muscular: [adj]肌肉的;肌肉发达的;强有力的; [a]/ˈmʌskjələr/; [or]yshx;
screw: [n]螺旋;螺丝; [v]拧紧; [vi]敲诈勒索; [vt]用螺钉固定;把.拧紧; [a]/skruː/; [or]yshx;
magnify: [v]放大,扩大;夸大,夸张; [a]/ˈmæɡnɪfaɪ/; [or]yshx;
monitor: [n]显示器;监视器;班长; [v]监视;监督;监测; [a]/ˈmɑːnɪtər/; [or]yshx;
ample: [adj]富足的,丰满的,宽敞的; [a]/ˈæmpl/; [or]yshx;
treble: [n]最高声部; [v]使成三倍; [adj]三倍的,最高声部的; [a]/ˈtrebl/; [or]yshx;
adopt: [v]收养;采纳,采用; [a]/əˈdɑːpt/; [or]yshx;
immense: [adj]巨大的,广大的; [a]/ɪˈmens/; [or]yshx;
deserve: [v]值得,应得;应受; [a]/dɪˈzɜːrv/; [or]yshx;
charity: [n]慈善团体;慈善;仁慈;施舍; [a]/ˈtʃærəti/; [or]yshx;
oblique: [adj]斜的,非直角的,隐射的; [v]倾斜; [n][解]斜肌(尤指腹部的肌肉);倾斜物;[军]倾斜航空照片; [adv][军]以45度角; [a]/əˈbliːk/; [or]yshx;
invest: [v]投资,投入;赋予,给予; [a]/ɪnˈvest/; [or]yshx;
draft: [n]气流;通风,通风装置;草稿;汇票;征兵; [v]起草;征兵; [a]/dræft/; [or]yshx;
leap: [v]跳跃;暴涨; [n]跳跃;跳动;上涨; [a]/liːp/; [or]yshx;
filter: [n]过滤器,滤纸; [v]过滤,渗透; [a]/ˈfɪltər/; [or]yshx;
bureaucracy: [n]官僚主义;政府机构; [a]/bjʊˈrɑːkrəsi/; [or]yshx;
lavish: [adj]奢华的;铺张浪费的; [v]浪费;慷慨给予; [a]/ˈlævɪʃ/; [or]yshx;
article: [n]物品;文章;条款;冠词; [a]/ˈɑːrtɪkl/; [or]yshx;
grate: [n]壁炉;格栅; [v]磨碎,使人烦燥; [a]/ɡreɪt/; [or]yshx;
rupture: [n]破裂;割裂; [v]使破裂;断绝(关系); [a]/ˈrʌptʃər/; [or]yshx;
tune: [n]曲调,旋律,协调,调动; [v][电子][通信]调谐;协调; [a]/tuːn/; [or]yshx;
ventilate: [v]使.通风,透风;公开讨论; [a]/ˈventɪleɪt/; [or]yshx;
bake: [v]烤,烘焙;烧制; [n]晒;烘烤食品; [a]/beɪk/; [or]yshx;
deplore: [v]谴责;对...深感遗憾;悲悼;痛惜; [a]/dɪˈplɔːr/; [or]yshx;
prejudice: [n]偏见;成见;损害;侵害; [vt]使抱偏见; [a]/ˈpredʒudɪs/; [or]yshx;
accountable for: [adj]对.应负责任; [a]/əˈkaʊntəb(ə)l fɔr/; [or]yshx;
stake: [n]木桩;赌注;利害关系;股份,股本;(赛马)奖金; [v]下注,以桩来支撑; [a]/steɪk/; [or]yshx;
aspirin: [n]阿斯匹林; [a]/ˈæsprɪn/; [or]yshx;
bloom: [v]开花; [n]开花期;青春时期;花;兴旺时期; [a]/bluːm/; [or]yshx;
obedient: [adj]服从的,顺从的;孝顺的; [a]/oʊˈbiːdiənt/; [or]yshx;
defense: [n]防御,防护; [a]/dɪ'fens/; [or]yshx;
exploit: [v]剥削,利用;开发,开拓; [n]辉煌功绩; [a]/ɪkˈsplɔɪt/; [or]yshx;
grab: [v]攫取,抓取,掠夺;赶紧做;吸引; [n]抓取,非法所得; [a]/ɡræb/; [or]yshx;
rarely: [adv]很少,难得; [a]/ˈrerli/; [or]yshx;
ominous: [adj]不祥的,不吉利的; [a]/ˈɑːmɪnəs/; [or]yshx;
affect: [v]影响,感动,作用; [n]感情,情感,心情;[精神病学](表露或觉察到的)情绪反应; [a]/əˈfekt/; [or]yshx;
gleam: [vi]闪烁;使发出微光; [n]闪光;微光;闪现; [a]/ɡliːm/; [or]yshx;
become of: [v](命运等)降临;使遭遇;发生.情况; [a]/bɪˈkʌm ɑv/; [or]yshx;
nicety: [n]细节,讲究; [a]/ˈnaɪsəti/; [or]yshx;
setback: [n]挫折;失败; [a]/ˈsetbæk/; [or]yshx;
gaily: [adv]快乐地,愉快地;装饰华丽地; [a]/ˈɡeɪli/; [or]yshx;
guarantee: [v]保证;担保;提供保修; [n]保证;担保;保修单;保证金; [a]/ˌɡærənˈtiː/; [or]yshx;
ammunition: [n]弹药;炮弹; [a]/ˌæmjuˈnɪʃn/; [or]yshx;
medal: [n]奖牌;勋章; [v]授予奖章; [a]/ˈmedl/; [or]yshx;
float: [vi]漂浮,飘浮,浮现;散布;漂泊; [vt]使漂浮;散布; [n]浮标,漂浮物,漂浮; [a]/floʊt/; [or]yshx;
commission: [n]委员会;任务;权限;委任;销售佣金; [v]委任; [a]/kəˈmɪʃn/; [or]yshx;
haunt: [v]常去,萦绕于..;(鬼,魂)常出没于;(思想)萦绕; [n]常去的地方; [a]/hɔːnt/; [or]yshx;
vulgar: [adj]粗俗的;下流的;平民的;通俗的; [n]平民;方言; [a]/ˈvʌlɡər/; [or]yshx;
conquer: [v]征服,攻克;破除; [a]/ˈkɑːŋkər/; [or]yshx;
atlas: [n]地图集; [a]/ˈætləs/; [or]yshx;
tenacious: [adj]坚忍不拔的,固执的,顽强的; [a]/təˈneɪʃəs/; [or]yshx;
reverse: [n]失败,挫折,倒退;相反,背面; [v]颠倒,翻转; [adj]相反的,反面的,颠倒的; [a]/rɪˈvɜːrs/; [or]yshx;
manifest: [adj]显然的,明白无误的,明了的; [v]使显现,使显露,表明; [n]货单,旅客名单; [a]/ˈmænɪfest/; [or]yshx;
go over: [v]仔细检查; [phr]复习,重温; [a]/ɡoʊ ˈoʊvər/; [or]yshx;
framework: [n]构架,框架,结构;体制,体系; [a]/ˈfreɪmwɜːrk/; [or]yshx;
twilight: [n]黄昏,薄暮,黎明;晚期,没落时期; [adj]微明的;界限不清的; [a]/ˈtwaɪlaɪt/; [or]yshx;
greedy: [adj]贪婪的,贪心的,贪吃的; [a]/ˈɡriːdi/; [or]yshx;
immerse: [v]沉浸,沉浸于;使陷入; [a]/ɪˈmɜːrs/; [or]yshx;
abbreviation: [n]缩短;缩写词;省略号; [a]/əˌbriːviˈeɪʃn/; [or]yshx;
bachelor: [n]单身汉;学士学位; [a]/ˈbætʃələr/; [or]yshx;
aggravate: [v]使恶化,加重;使气恼,激怒; [a]/ˈæɡrəveɪt/; [or]yshx;
dubious: [adj]可疑的;怀疑的;无把握的; [a]/ˈduːbiəs/; [or]yshx;
grudge: [n]怨恨;妒嫉;恶意;忿忿不平; [v]怨恨;嫉妒;不情愿做; [a]/ɡrʌdʒ/; [or]yshx;
reckon: [vt]计算;想,指望;把.看做; [v]认为; [vi]计算;估计; [a]/ˈrekən/; [or]yshx;
sabotage: [n]怠工,蓄意破坏,妨碍; [v]怠工,从事破坏活动,故意阻挠; [a]/ˈsæbətɑːʒ/; [or]yshx;
make off: [phr]逃走;离开;匆忙离开; [a]/meɪk ɑf/; [or]yshx;
fee: [n]费用,酬金; [a]/fiː/; [or]yshx;
be all set: [phr]准备就绪; [a]/bi ɔl set/; [or]yshx;
deteriorate: [v]恶化;变质;衰退; [a]/dɪˈtɪriəreɪt/; [or]yshx;
pamper: [v]纵容,过分关怀,精心照料; [a]/ˈpæmpər/; [or]yshx;
coincide: [v]巧合,一致,相符; [a]/ˌkoʊɪnˈsaɪd/; [or]yshx;
review: [v]温习,复习;评论;回顾,反思; [n]复习,回顾;检讨;评审,审查; [a]/rɪˈvjuː/; [or]yshx;
predisposition: [n]倾向;素质;易染病体质; [a]/ˌpriːdɪspəˈzɪʃn/; [or]yshx;
versatile: [adj]万能的,综合的,多才多艺的; [a]/ˈvɜːrsətl/; [or]yshx;
overture: [n]主动表示,姿态;前奏曲;序言,事件的开端;提出问题; [vt]作为一种主动姿态提出;向.提出建议; [a]/ˈoʊvərtʃər/; [or]yshx;
menace: [v]威胁,威吓; [n]威胁;具有危险性的人(或物); [a]/ˈmenəs/; [or]yshx;
stadium: [n](周围有看台的)体育场,露天大型运动场; [a]/ˈsteɪdiəm/; [or]yshx;
verbal: [adj]言语的,口头的,动词的; [a]/ˈvɜːrbl/; [or]yshx;
embody: [v]包含;体现,象征; [a]/ɪmˈbɑːdi/; [or]yshx;
suspend: [v]悬挂,吊;中止;推迟; [a]/səˈspend/; [or]yshx;
clearance: [n]清除;清理;清空;许可; [a]/ˈklɪrəns/; [or]yshx;
batch: [n]一批(人或物);一批生产量; [a]/bætʃ/; [or]yshx;
approach: [v]接近;靠近;着手处理; [n]接近;途径;方法; [a]/əˈproʊtʃ/; [or]yshx;
fancy: [adj]华丽装饰的,别致的,引人注目的;昂贵的,阔气的; [n]喜爱,幻想,想像力; [vt]想象,幻想;迷恋; [a]/ˈfænsi/; [or]yshx;
hover: [v](鸟,直升机)盘旋,翱翔;(人)逗留在附近,徘徊; [a]/ˈhʌvər/; [or]yshx;
desert: [n]沙漠; [v]离开; [a]/ˈdezərt/; [or]yshx;
diagnose: [v]诊断(疾病),对(病人)下诊断结论; [a]/ˌdaɪəɡˈnoʊs/; [or]yshx;
wail: [n]恸哭;哀诉; [vi]恸哭;悲叹; [vt]哀悼; [a]/weɪl/; [or]yshx;
periodical: [n]期刊;杂志; [a]/ˌpɪriˈɑːdɪkl/; [or]yshx;
fierce: [adj]凶猛的;激烈的;猛烈的; [a]/fɪrs/; [or]yshx;
terrestrial: [adj]地球的,陆地的; [n]陆地生物;地球上的人; [a]/təˈrestriəl/; [or]yshx;
melodious: [adj]音调悦耳的;旋律优美的; [a]/məˈloʊdiəs/; [or]yshx;
wither: [v]枯萎;凋谢; [vt]使枯萎,使凋谢,萎缩;使人感觉羞惭或迷惑; [a]/ˈwɪðər/; [or]yshx;
persevere with: [v]坚持,不屈不挠; [a]/ˌpɜːrsəˈvɪr wɪð/; [or]yshx;
have one's hands full: [phr]忙得不可开交;手头事情应接不暇;离不开手; [a]/hæv wʌnz hændz fʊl/; [or]yshx;
premise: [n]前提;房屋地基; [v]假定; [a]/ˈpremɪs/; [or]yshx;
fall behind: [v]落后; [a]/fɔl bɪˈhaɪnd/; [or]yshx;
stiff: [adj]僵直的,酸痛的;硬的;困难的; [a]/stɪf/; [or]yshx;
conservative: [adj]保守的;保守估计的;保守党的; [n]保守主义者;保守党党员; [a]/kənˈsɜːrvətɪv/; [or]yshx;
slab: [n]厚片,硬板; [v]把.分成厚片;用石板铺; [a]/slæb/; [or]yshx;
end up: [phr]以.告终; [a]/end ʌp/; [or]yshx;
jam: [n]果酱;阻塞; [v](使)阻塞,使塞满; [a]/dʒæm/; [or]yshx;
gang: [n]以某种方式结合的一群人;帮派; [v]成帮结伙;使集合成一群;使成套排列; [a]/ɡæŋ/; [or]yshx;
shamble: [v]蹒跚,拖沓; [n]蹒跚;摇晃的脚步;(pl.)混乱,废墟; [a]/ˈʃæmbl/; [or]yshx;
invisible: [adj]看不见的,无形的; [a]/ɪnˈvɪzəbl/; [or]yshx;
all in all: [phr]总而言之;总的来说; [a]/ɔːl ɪn ɔːl/; [or]yshx;
counter: [n]柜台;回击,反击; [v]抵消,抗衡; [adv]相反地; [a]/ˈkaʊntər/; [or]yshx;
sincere: [adj]真诚的,诚恳的; [a]/sɪnˈsɪr/; [or]yshx;
deviate: [v]偏离;背离; [adj]脱离常轨的; [n]脱离常轨的人; [a]/ˈdiːvieɪt/; [or]yshx;
bankrupt: [adj]破产的;彻底失败的;彻底缺乏的; [n]破产者; [v]使破产;使枯竭; [a]/ˈbæŋkrʌpt/; [or]yshx;
glacier: [n]冰川,冰河; [a]/ˈɡleɪʃər/; [or]yshx;
familiar: [adj]熟悉的;不拘礼节的;亲密的;随便的; [n]密友;常客;高级官吏的家属; [a]/fəˈmɪliər/; [or]yshx;
one another: [pron]彼此; [a]/ˌwʌn əˈnʌðər/; [or]yshx;
strap: [v]捆扎; [n]带子; [a]/stræp/; [or]yshx;
equitable: [adj]公正的,公平的; [a]/ˈekwɪtəbl/; [or]yshx;
oversee: [v]监督;偷看到,无意中看到;审查;俯瞰; [a]/ˌoʊvərˈsiː/; [or]yshx;
indulge: [v]沉迷于;放纵;满足; [a]/ɪnˈdʌldʒ/; [or]yshx;
occur: [vi]发生;出现,存在; [a]/əˈkɜːr/; [or]yshx;
goal: [n]目标;球门;(进球)得分; [a]/ɡoʊl/; [or]yshx;
oval: [adj]椭圆形的; [n]椭圆形; [a]/ˈoʊvl/; [or]yshx;
mishap: [n]不幸的事,灾祸;晦气; [a]/ˈmɪshæp/; [or]yshx;
keep sth. in mind: [v]记住; [a]/kiːp ˈsʌmθɪŋ ɪn maɪnd/; [or]yshx;
break down: [phr]发生故障;失败;(精神)垮下来; [a]/brek daʊn/; [or]yshx;
bring forward: [v]提出;提前; [a]/brɪŋ ˈfɔrwərd/; [or]yshx;
irrigation: [n]灌溉; [a]/ˌɪrɪˈɡeɪʃn/; [or]yshx;
stand in line: [v]排队; [a]/stænd ɪn laɪn/; [or]yshx;
get out: [phr]出去;逃脱;泄露; [a]/ɡet aʊt/; [or]yshx;
glue: [n]胶水; [v]用胶粘; [a]/ɡluː/; [or]yshx;
autonomy: [n]人身自由;自治;自治权; [a]/ɔːˈtɑːnəmi/; [or]yshx;
[kk9: 雅思核心/3272]