reply: [n&v]回答,答复; [ex]~ to sb/回复某人; [acc] /rɪˈplaɪ/;
secondhand: [adj]二手的,旧的;间接获得的; [adv]间接地;二手货地; [acc] /ˌsekənd ˈhænd/;
cry: [v]哭泣,大声叫喊; [n]哭声,嚎叫;口号;呼吁; [m] pl/cries; st/cries; pr/crying; pt/cried; pp/cried; [acc] /kraɪ/;
optimistic: [adj]乐观的,乐观主义的; [sim]optimist,optimism,pessimistic,optimize,altruistic;  [acc] /ˌɑːptɪˈmɪstɪk/;
rain: [n]雨(水); [v]下雨; [ex]in the rain/在雨中; [sim]grain,drain; [acc] /reɪn/;
fear: [n]顾虑,胆怯 [v]害怕,担心; [acc] /fɪr/;
shoot: [n]发芽; [v]射击,射杀; [sim]shot,soot; [acc] /ʃuːt/;
clean: [n]打扫,清洁; [adj]干净的; [v]打扫,清洁; [ex]~ the house; [sim]glean,clan,cleanse; [acc] /kliːn/;
fight: [n]搏斗;斗争; [vt]对抗,与..打架;[vi]争吵,斗争; [sim]flight,fright; [acc] /faɪt/;
mental: [adj]精神的 [ex]~ sickness 精神病; [sim]menial,rental;  [acc] /ˈmentl/;
deed: [n]行为 [ex]good ~/好事; [acc] /diːd/;
fortunate: [adj]幸运的; [sim]importunate;  [acc] /ˈfɔːrtʃənət/;
give: [v]给,交给 [sim]hive,gibe; [acc] /ɡɪv/;
delighted: [adj]欣喜的,快乐的 [sim]delight,blighted,delightful,enlighten,lighter; [acc] /dɪˈlaɪtɪd/;
painful: [adj]疼痛的;费力的 [sim]spoonful,rainfull,painter; [acc] /ˈpeɪnfl/;
angry: [adj]愤怒的,生气的 [sim]mangy,tangy,gangly;  [acc] /ˈæŋɡri/;
confidence: [n]自信,信心 [sim]confluence; [acc] /ˈkɑːnfɪdəns/;
shave: [v]剃,刮 [n]修面 [sim]shaver; 
peaceful: [adj]和平的;平静的,安宁的 [sim]graceful; [acc] /ˈpiːsfl/;
occupy: [x] v. 占领,占据,侵占;住在,居住,住进;担任(职务),任职;占用(时间,空间等),占有;使用(房屋,建筑); [acc] /ˈɑːkjupaɪ/;
courtyard: [x] n. 庭院,院子; [acc] /ˈkɔːrtjɑːrd/;
shout: [x] v. 呼喊,呼叫;  n. 呼喊,呼叫; [acc] /ʃaʊt/;
praise: [x] v. 表扬,称赞;赞扬,歌颂;  n. 称赞,赞美;赞美的话; [acc] /preɪz/;
crash: [x] n. 碰撞,坠落,轰隆声;  v. 碰撞,坠落,崩溃;  adj. 紧急的; [acc] /kræʃ/;
recognize: [x] v. 辨别,认出;赏识,表彰;承认;赞成; [acc] /ˈrekəɡnaɪz/;
schoolmate: [x] n. 同学,同窗; [acc] /ˈskuːlmeɪt/;
lunch: [x] n. 午餐,(美)便餐;  v. 吃(午餐),提供(午餐); [acc] /lʌntʃ/;
thirst: [x] n. 渴;干渴,缺水;渴求,渴望;  v. 渴求; [acc] /θɜːrst/;
striker: [x] n. 罢工者;(足球的)前锋;锤,报点时钟; [acc] /ˈstraɪkər/;
scarf: [x] n. 围巾,披肩;  v. 围(围巾);打(领带);披(披巾);用围巾[台布]围[盖];贪婪地吃;狼吞虎咽; [acc] /skɑːrf/;
brain: [x] n. 脑,脑髓;脑力,头脑,智力;  v. 猛击头部; [acc] /breɪn/;
middle: [x] n. 中部,中间;  adj. 中部的,中间的; [acc] /ˈmɪdl/;
northwest: [x] n. 西北方;西北;  adj. 在西北的;向西北的;来自西北的;  adv. 在西北;向西北;自西北; [acc] /ˌnɔːrθˈwest/;
coat: [x] n. 外套,上衣;表皮;  vt. 涂上;覆盖;包上; [acc] /koʊt/;
physicist: [x] n. 物理学者,物理学家; [acc] /ˈfɪzɪsɪst/;
bark: [x] v. 狗吠;厉声发令;  n. 树皮;吠声; [acc] /bɑːrk/;
hurry: [x] n. 匆忙,急忙;  vi. 赶紧;  vt. 催促; [acc] /ˈhɜːri/;
school: [x] n. 学校;学院;流派;(鱼,海豚的)一群;  v. 教育; [acc] /skuːl/;
chopsticks: [x] n. 筷子; [acc] /ˈtʃɑːpstɪks/;
convenient: [x] adj. 方便的;便利的; [acc] /kənˈviːniənt/;
sister: [x] n. 姐妹,姐,妹;修女;女会员;女同胞; [acc] /ˈsɪstər/;
missing: [x] adj. 失踪的;缺少的; [acc] /ˈmɪsɪŋ/;
inspector: [x] n. 检查员,督察员;视察者,检阅者;(英)查票员; [acc] /ɪnˈspektər/;
jeans: [x] n. 牛仔裤;工装裤; [acc] /dʒiːnz/;
defeat: [x] n. 挫败;击败,战胜;  v. 打败;战胜; [acc] /dɪˈfiːt/;
sport: [x] n. 运动,娱乐;  v. 炫耀,卖弄; [acc] /spɔːrt/;
rude: [x] adj. 粗鲁的,无礼貌的;猛烈的,狂暴的; [acc] /ruːd/;
instrument: [x] n. 仪器;工具;乐器;手段; [acc] /ˈɪnstrəmənt/;
step: [x] n. 脚步,脚印,脚步声;步骤,措施,阶段;台阶,门阶;  v. 踩;走,举步,移步; [acc] /step/;
spoon: [x] n. 匙,调羹;  vt. 用匙舀; [acc] /spuːn/;
metal: [x] n. 金属,合金,金属制品;  vt. (以金属)覆盖,装配;  adj. 金属制的; [acc] /ˈmetl/;
price: [x] n. 价格,价钱;代价;  v. 标价; [acc] /praɪs/;
jaw: [x] n. 颌,颚,下巴;  v. 唠唠叨叨,喋喋不休; [acc] /dʒɔː/;
themselves: [x] pron. 他/她/它们自己; [acc] /ðəmˈselvz/;
experience: [x] n. 经历,感受,体验,经验;  v. 体验,感受;经历; [acc] /ɪkˈspɪriəns/;
slow: [x] adj. 迟钝的,不活跃的,缓慢的;  adv. 缓慢地;  v. (使)慢下来,(使)减速,减缓; [acc] /sloʊ/;
Tokyo: [x] n. 东京; [acc] /ˈtəʊkɪəʊ/;
seldom: [x] adv. 很少,不常;  adj. 不常的;稀少的; [acc] /ˈseldəm/;
dictation: [x] n. 口授,口述;听写; [acc] /dɪkˈteɪʃn/;
moral: [x] adj. 道德(上)的,道义的;  n. 道德,品行;寓意; [acc] /ˈmɔːrəl/;
thirty: [x] num. 三十;  adj. 三十的;三十个的;  n. 三十,三十个; [acc] /ˈθɜːrti/;
off: [x] adv. (离)开;不再供应,停止,不再工作;  prep. 离开;在..之外;  adj. 空闲的;离开的;关闭的;  v. 离开;脱下;  int. 走开;  n. [板](打球员的)右前方; [acc] /ɔːf/;
festival: [x] n. 节日;欢宴,庆祝; [acc] /ˈfestɪvl/;
pond: [x] n. 池塘; [acc] /pɑːnd/;
nor: [x] conj. 也不;  adv. 也不; [acc] /nɔːr/;
murder: [x] n. 谋杀,凶杀,谋杀罪;遭罪的经历;  v. 谋杀,凶杀; [acc] /ˈmɜːrdər/;
hotel: [x] n. 酒店,旅馆,饭店,宾馆; [acc] /hoʊˈtel/;
himself: [x] pron. 他自己;他亲自; [acc] /hɪmˈself/;
persuade: [x] v. 说服,劝说;使相信; [acc] /pərˈsweɪd/;
photo: [x] n. 照片,相片; [acc] /ˈfoʊtoʊ/;
hold: [x] n. 掌握;拥有;货仓;  vt. 掌握;拥有;拿住,握住;  vi. 拿住;同意,赞成;保持不变;有效; [acc] /hoʊld/;
soccer: [x] n. 足球; [acc] /ˈsɑːkər/;
government: [x] n. 政府;治理;政治; [acc] /ˈɡʌvərnmənt/;
verb: [x] n. 动词; [acc] /vɜːrb/;
Christmas: [x] n. 圣诞节; [acc] /ˈkrɪsməs/;
exit: [x] n. 出口;退场;  v. 退出; [acc] /ˈeksɪt/;
society: [x] n. 社会;协会;社交界; [acc] /səˈsaɪəti/;
taste: [x] v. 品尝,尝起来;品鉴;体验,体会;  n. 滋味,味道;鉴赏力;品尝; [acc] /teɪst/;
note: [x] n. 笔记,便条,注释;纸币;音符;  v. 注意,记录; [acc] /noʊt/;
fluent: [x] adj. 流畅的,(说话)流利的;顺畅的,流畅熟练的; [acc] /ˈfluːənt/;
row: [x] n. 排,行;争吵;  vi. 划(船等);争吵;  vt. 划船; [acc] /roʊ/;
situation: [x] n. 形势,局面,处境,状况;位置,场所;职位,职务; [acc] /ˌsɪtʃuˈeɪʃn/;
argue: [x] v. 争吵;主张,认为;提供.证据,提出证明;表明(原因等); [acc] /ˈɑːrɡjuː/;
mooncake: [x] n. 月饼; [acc] /ˈmuːn keik/;
disappearance: [x] n. 失踪,消失;绝迹; [acc] /ˌdɪsəˈpɪrəns/;
earn: [x] v. 赚得,挣得,获得; [acc] /ɜːrn/;
pack: [x] v. 打包;包装;塞满;  n. 行李;背包;一群;一伙;  adj. 包装用的;搬运用的;由驮运牲畜组成的;填满了的; [acc] /pæk/;
disturb: [x] v. 打扰,妨碍;弄乱;使烦恼; [acc] /dɪˈstɜːrb/;
electric: [x] adj. 电的,电动的,带电的;刺激的;  n. 供电; [acc] /ɪˈlektrɪk/;
dig: [x] n. 挖,掘;  v. 挖掘,翻土; [acc] /dɪɡ/;
build: [x] v. 逐步增强;建造;建立;  n. 构造;体形;体格; [acc] /bɪld/;
Greece: [x] n. 希腊; [acc] /ɡriːs/;
kindergarten: [x] n. 幼儿园; [acc] /ˈkɪndərɡɑːrtn/;
funny: [x] n. 笑话;滑稽戏;反常的怪事;  adj. 有趣的,好玩的;奇怪的; [acc] /ˈfʌni/;
care: [x] n. 小心;照顾;  v. 介意;关心; [acc] /ker/;
chest: [x] n. 胸膛;箱子; [acc] /tʃest/;
collar: [x] n. 项圈,衣领,[机]轴环;  v. 抓住,为..戴上项圈,为..上领子; [acc] /ˈkɑːlər/;
leaf: [x] n. 叶,叶子; [acc] /liːf/;
farthest: [x] adv. 最远地;最大程度地;  adj. 最远的;最久的; [acc] /ˈfɑːrðɪst/;
ache: [x] n. 疼痛;  v. 觉得疼痛;渴望; [acc] /eɪk/;
heavy: [x] adj. 沉重的;重的;大量的;浓密的;重型的;  n. 重物;保镖;  adv. 密集地;大量地;笨重地; [acc] /ˈhevi/;
silly: [x] adj. 傻的;愚蠢的;  n. (通常指小孩子)淘气鬼;傻孩子; [acc] /ˈsɪli/;
bathing: [x] n. 沐浴;游泳;洗海水澡;洗浴; [acc] /ˈbeɪðɪŋ/;
menu: [x] n. 菜单,菜谱,菜; [acc] /ˈmenjuː/;
racket: [x] n. 吵闹声;球拍;  v. 嚷闹,吵闹,纵情欢闹;用球拍打; [acc] /ˈrækɪt/;
besides: [x] prep. 除..之外;  adv. 而且,还有; [acc] /bɪˈsaɪdz/;
supper: [x] n. 晚餐; [acc] /ˈsʌpər/;
increase: [x] v. 增加,提高;  n. 增加,增强,提高; [acc] /ɪnˈkriːs/;
performance: [x] n. 表演,演出;表现;执行;性能; [acc] /pərˈfɔːrməns/;
table tennis: [x] n. 乒乓球; [acc] /ˈteɪbl tenɪs/;
kiss: [x] v. 吻,接吻;  n. 吻; [acc] /kɪs/;
smog: [x] n. 烟雾; [acc] /smɑːɡ/;
production: [x] n. 生成,产生;产量;生产;(戏剧,电影等的)制作; [acc] /prəˈdʌkʃn/;
bad: [x] adj. 坏的,恶的,错的;低劣的,拙劣的;不舒服的,病的;严重的,糟糕的;  n. 坏人,坏事;  adv. 非常,不好地; [acc] /bæd/;
digital: [x] adj. 数字显示的;数字的,数码的;  n. 键;数字仪表,时钟; [acc] /ˈdɪdʒɪtl/;
English-speaking: [x] adj. 说英语的; [acc] /ˈɪŋɡlɪʃ ˈspikɪŋ/;
debt: [x] n. 债,债务,欠债;人情债; [acc] /det/;
supermarket: [x] n. 超级市场,自助售货商店; [acc] /ˈsuːpərmɑːrkət/;
body: [x] n. 身体;主体;尸体; [acc] /ˈbɑːdi/;
instead: [x] adv. 代替,顶替,反而; [acc] /ɪnˈsted/;
express: [x] adj. 特定的;明确的;快速的;  n. 快递;快车;  v. 表达;用快递邮出;挤,榨;  adv. 使用快速服务; [acc] /ɪkˈspres/;
confident: [x] adj. 自信的;确信的,深信的; [acc] /ˈkɑːnfɪdənt/;
interesting: [x] adj. 有趣的,吸引人的; [acc] /ˈɪntrəstɪŋ/;
chemist: [x] n. 化学家;(英)药剂师; [acc] /ˈkemɪst/;
way: [x] n. 方法;道路;方向;行业;习惯;  adv. 大大地;远远地; [acc] /weɪ/;
delight: [x] n. 高兴,愉快;高兴事;  v. 使高兴; [acc] /dɪˈlaɪt/;
pear: [x] n. 梨子,梨树; [acc] /per/;
mistake: [x] n. 错误,过失;  v. 误解,弄错;  adj. 错误;不正确;判断错误的;被误解的; [acc] /mɪˈsteɪk/;
afraid: [x] adj. 害怕的,恐怕,担心的; [acc] /əˈfreɪd/;
singer: [x] n. 歌手; [acc] /ˈsɪŋər/;
comfortable: [x] adj. 舒适的,安慰的;  n. 绒线围巾;〈美〉鸭绒被; [acc] /ˈkʌmfərtəbl/;
marriage: [x] n. 结婚;婚姻;婚礼;密切结合; [acc] /ˈmærɪdʒ/;
office: [x] n. 办公室;职位;处,局,社; [acc] /ˈɔːfɪs/;
make: [x] v. 使;做,制造;使成为;使产生;生产,制定;  n. 制造,生产量;性格;形状,样式; [acc] /meɪk/;
pyramid: [x] n. 金字塔; [acc] /ˈpɪrəmɪd/;
wardrobe: [x] n. 衣橱;全部服装;剧服; [acc] /ˈwɔːrdroʊb/;
beside: [x] prep. 在.旁边;与.相比; [acc] /bɪˈsaɪd/;
pine: [x] n. 松树;  v. (因死亡,离别等)难过,悲伤; [acc] /paɪn/;
teenager: [x] n. (13-19岁的)少年; [acc] /ˈtiːneɪdʒər/;
hundred: [x] num. 百,百个;  n. 许多; [acc] /ˈhʌndrəd/;
really: [x] adv. 真正地,事实上;确实;非常,极其; [acc] /ˈriːəli/;
pollution: [x] n. 污染;噪音污染,光污染;污染物; [acc] /pəˈluːʃn/;
beach: [x] n. 海滩,河滩;  v. 把..拖上岸,使(船)靠岸; [acc] /biːtʃ/;
empty: [x] adj. 空的,空洞的;  v. 倒空,使成为空的; [acc] /ˈempti/;
narrow: [x] adj. 狭窄的;差距小的,微小的;  n. 海峡;狭窄部分;  v. 使变窄,缩小; [acc] /ˈnæroʊ/;
soft: [x] adj. 软的;温柔的;细嫩的,光滑的;不含酒精的;  n. 柔软的东西;  adv. 柔软地,柔和地; [acc] /sɔːft/;
gesture: [x] n. 手势,表情;姿态;  v. 做手势,用动作示意;  vt. 用手势表达; [acc] /ˈdʒestʃər/;
grateful: [x] adj. 感激的;感谢的; [acc] /ˈɡreɪtfl/;
congratulation: [x] n. 祝贺;祝贺信; [acc] /kənˌɡrætʃuˈleɪʃn/;
begin: [x] v. 开始; [acc] /bɪˈɡɪn/;
pupil: [x] n. 小学生;瞳孔; [acc] /ˈpjuːpl/;
light: [x] v. 点火,照亮;  adj. 轻的;明亮的;不严重的;  n. 光亮;灯;  adv. 轻轻地; [acc] /laɪt/;
hooray: [x] excl. 万岁; [acc] /huˈreɪ/;
introduction: [x] n. 介绍;引进;引言; [acc] /ˌɪntrəˈdʌkʃn/;
hate: [x] v. 恨,憎恨;不喜欢;  n. 恨,憎恶; [acc] /heɪt/;
south: [x] adv. 在南方,向南方;  adj. 南的,南方的;  n. 南部,南方; [acc] /saʊθ/;
intelligence: [x] n. 智力;情报;理解力; [acc] /ɪnˈtelɪdʒəns/;
watermelon: [x] n. 西瓜; [acc] /ˈwɔːtərmelən/;
police: [x] n. 警察,警方;  v. 维持治安,管辖,监督; [acc] /pəˈliːs/;
fragile: [x] adj. 易碎的;易损坏的;虚弱的;脆弱的; [acc] /ˈfrædʒl/;
assistant: [x] n. 助理,助手;售货员;  adj. 助理的,辅助的; [acc] /əˈsɪstənt/;
nineteen: [x] num. 十九,十九个;  n. 十九点;十九岁; [acc] /ˌnaɪnˈtiːn/;
sonata: [x] n. 奏鸣曲; [acc] /səˈnɑːtə/;
lift: [x] v. (使)升起,举起;偷窃;运送;解除,终止;抄袭,偷窃;  n. <英>电梯;举起;免费搭车;情绪激昂,精神振奋; [acc] /lɪft/;
editor: [x] n. 编辑;主编; [acc] /ˈedɪtər/;
club: [x] n. 俱乐部,夜总会,球棒;  v. 用棍棒打; [acc] /klʌb/;
poem: [x] n. 诗,韵文,诗体文; [acc] /ˈpoʊəm/;
usual: [x] adj. 通常的,惯常的; [acc] /ˈjuːʒuəl/;
hotdog: [x] n. 热狗(面包);  vi. 卖弄,出风头; [acc] /'hɒtˌdɒg/;
mommy: [x] n. 妈咪; [acc] /ˈmɑːmi/;
against: [x] prep. 对(着),逆;反对;违反;靠近,倚在;对比;映衬;以..为背景; [acc] /əˈɡeɪnst/;
channel: [x] n. 频道;渠道,方法;海峡;  v. 引导;经沟槽输送; [acc] /ˈtʃænl/;
seal: [x] n. 海豹;邮戳;封条;火漆印;  v. 封(信封),密封,盖章;封锁;缄口; [acc] /siːl/;
may: [x] aux. 可以,能够,可能,也许,祝,愿; [acc] /meɪ/;
put: [x] v. 放,摆;使处于;表达,表述;对事件作出说明,提出意见;写上,记上; [acc] /pʊt/;
look: [x] v. 看,显得;  n. 看,浏览;样子; [acc] /lʊk/;
tailor: [x] n. 裁缝;  v. 修改;使合适;调整使适应;  vt. 裁制;剪裁; [acc] /ˈteɪlər/;
opposite: [x] adj. 相反的;对立的;对面的;  adv. 对立地;反面地;  n. 对立物;反义词;  prep. 与.相对;在.对面;与.合演;与.联袂演出; [acc] /ˈɑːpəzɪt/;
English: [x] n. 英语,英国人;  adj. 英国的,英国人的,英语的; [acc] /ˈɪŋɡlɪʃ/;
authority: [x] n. 权威;威信;当局,官方;权力,职权; [acc] /əˈθɔːrəti/;
satellite: [x] n. 卫星;人造卫星;随体;  adj. 卫视的; [acc] /ˈsætəlaɪt/;
repeat: [x] v. 重复;重做;  n. 复制;重奏; [acc] /rɪˈpiːt/;
sentence: [x] v. 判决,宣判;  n. 句子;判决; [acc] /ˈsentəns/;
time: [x] n. 时间;节拍;次数,时期;比赛限时;  v. 安排..的时间;计时,定时;打拍子;  adj. 时间的;定时的;分期的; [acc] /taɪm/;
ID: [x] abbr. 身份(identification,identity);  n. 私我;本我;  v. <口>认出;识别; [acc] /ˌaɪ ˈdiː/;
grandson: [x] n. 孙子,外孙; [acc] /ˈɡrænsʌn/;
headline: [x] n. 大字标题;新闻摘要;  v. 给..加标题;担当主角; [acc] /ˈhedlaɪn/;
virus: [x] n. 病毒;(计算机) 病毒;病毒性疾病; [acc] /ˈvaɪrəs/;
danger: [x] n. 危险,危险物(或人),威胁; [acc] /ˈdeɪndʒər/;
research: [x] v. 研究,调查;  n. 研究,调查; [acc] /ˈriːsɜːrtʃ/;
consider: [x] v. 考虑,细想;认为,觉得; [acc] /kənˈsɪdər/;
sharpen: [x] v. 削尖;磨快;使敏捷;使提高; [acc] /ˈʃɑːrpən/;
culture: [x] n. 文化;文明;修养;栽培;  v. 使有教养;培养; [acc] /ˈkʌltʃər/;
beneath: [x] prep. 在..下方;低于;  adv. 在下方; [acc] /bɪˈniːθ/;
cake: [x] n. 蛋糕,饼,糕;  v. (使)结块;(使)胶;涂厚厚的一层; [acc] /keɪk/;
guard: [x] n. 警卫员,哨兵,守卫,护卫队;  vi. 警惕;  vt. 保卫,守护,保护;看守,监视; [acc] /ɡɑːrd/;
clothes: [x] n. 衣服,服装; [acc] /kloʊðz/;
introduce: [x] v. 介绍;传入,引进;提出;采用; [acc] /ˌɪntrəˈduːs/;
appear: [x] v. 出现,露面;显得,好像,;出版; [acc] /əˈpɪr/;
ability: [x] n. 能力,技能,本领; [acc] /əˈbɪləti/;
grand: [x] adj. 壮丽的,宏伟的,重大的;傲慢的;极好的;  n. 一千美元;大钢琴; [acc] /ɡrænd/;
guide: [x] n. 导游;指南;  v. 引导,指导;给.领路;给.导游,带领; [acc] /ɡaɪd/;
coffee: [x] n. 咖啡;咖啡豆;咖啡色; [acc] /ˈkɔːfi/;
freeway: [x] n. 高速公路; [acc] /ˈfriːweɪ/;
dark: [x] n. 黑暗,暗处;深色;  adj. 神秘的;邪恶的;黑暗的,昏暗的;深色的; [acc] /dɑːrk/;
careless: [x] adj. 粗心的,漫不经心的; [acc] /ˈkerləs/;
tail: [x] n. 尾巴,末端;尾随者;  v. 紧跟,尾随; [acc] /teɪl/;
mask: [x] n. 面具;遮蔽物;伪装;  v. 隐藏(感情);掩盖,掩饰,掩护;伪装; [acc] /mæsk/;
discuss: [x] v. 讨论;论述; [acc] /dɪˈskʌs/;
madam: [x] n. 夫人;女士; [acc] /ˈmædəm/;
motor: [x] n. 发动机,马达;车; [acc] /ˈmoʊtər/;
toothbrush: [x] n. 牙刷; [acc] /ˈtuːθbrʌʃ/;
sure: [x] adv. 当然,确实地,无疑地;  adj. 肯定的;确信的; [acc] /ʃʊr/;
interest: [x] n. 兴趣;利息;利益;  v. 使感兴趣; [acc] /ˈɪntrəst/;
special: [x] adj. 特殊的,专门的;附加的,额外的;  n. 特色菜;特价;特别节目;专长; [acc] /ˈspeʃl/;
share: [x] v. 合用;分配,均分;分享;分担;  n. 一份,份额;股票,股份; [acc] /ʃer/;
plastic: [x] n. 塑料,塑料制品;  adj. 塑料的;塑性的,可塑的;  pl. 塑料,塑料制品(plastics); [acc] /ˈplæstɪk/;
loose: [x] adj. 宽松的;(指言行等)不严谨的;  v. 放松;  n. 自由;  adv. 松散地;不严格地; [acc] /luːs/;
love: [x] v. 爱,喜欢;  n. 爱; [acc] /lʌv/;
eyesight: [x] n. 视力,目力; [acc] /ˈaɪsaɪt/;
unit: [x] n. 整体,单位;部门;课本单元;(机器)一部分的装置,设备,部件; [acc] /ˈjuːnɪt/;
teamwork: [x] n. 团队合作,协力; [acc] /ˈtiːmwɜːrk/;
success: [x] n. 成功,成就,胜利,成功的人或事; [acc] /səkˈses/;
once: [x] adv. 一次,曾经;  n. 一次;  conj. 一旦,立刻; [acc] /wʌns/;
code: [x] n. 编码,代码;准则,法典;密码;  v. 将.编码; [acc] /koʊd/;
suppose: [x] vt. 想,认为;  vi. 推测;  v. 假定,假设;设想; [acc] /səˈpoʊz/;
married: [x] adj. 已婚的,夫妇的;密切结合的; [acc] /ˈmærid/;
regular: [x] adj. 有规律的,定期的,经常的,匀称的;  n. 常客;正式队员; [acc] /ˈreɡjələr/;
per: [x] prep. 每,每一;按照; [acc] /pər/;
sudden: [x] adj. 突然的,意外的; [acc] /ˈsʌdn/;
hungry: [x] adj. 饥饿的;渴望的; [acc] /ˈhʌŋɡri/;
professor: [x] n. 教授; [acc] /prəˈfesər/;
sleep: [x] v. 睡,睡觉;  n. 睡眠,梦乡; [acc] /sliːp/;
hot: [x] adj. 热的,辣的,强烈的;  adv. 激动地,趁热地;  v. (使)变热; [acc] /hɑːt/;
aggressive: [x] adj. 好斗的,挑衅性的;有闯劲的,积极进取的; [acc] /əˈɡresɪv/;
expect: [x] v. 期待;指望;预计; [acc] /ɪkˈspekt/;
operation: [x] n. 运转;操作;手术; [acc] /ˌɑːpəˈreɪʃn/;
sharpener: [x] n. 削尖用的器具; [acc] /ˈʃɑːrpnər/;
sharp: [x] adj. 锋利的;敏锐的;清晰的;  adv. 急剧地;锐利地;突然地;整点;  n. (音乐)升半音;磨; [acc] /ʃɑːrp/;
chart: [x] n. 图表,表格;航海图;每周排行榜;  v. 制成图表;制航海图; [acc] /tʃɑːrt/;
modest: [x] adj. 谦虚的,谦逊的;端庄的,羞怯的;不太大(或太贵,太重要)的,适度的; [acc] /ˈmɑːdɪst/;
queue: [x] v. 排队等候;  n. 行列; [acc] /kjuː/;
anyhow: [x] adv. 不论用何种方法,无论如何;随意地;尽管如此; [acc] /ˈenihaʊ/;
inspect: [x] v. 检查,审查; [acc] /ɪnˈspekt/;
lately: [x] adv. 最近; [acc] /ˈleɪtli/;
educate: [x] v. 教育,培养,训练; [acc] /ˈedʒukeɪt/;
pick: [x] v. 挑选;拾,捡起;摘,采摘;剔,戳;  n. 选择;精品; [acc] /pɪk/;
simple: [x] adj. 简单的;简朴的;天真的;无经验的; [acc] /ˈsɪmpl/;
salesgirl: [x] n. 女售货员; [acc] /ˈseɪlzɡɜːrl/;
foundation: [x] n. 地基;基础;基金(会);建立;粉底; [acc] /faʊnˈdeɪʃn/;
either: [x] det. 两方;二者之一;要么..要么..;  adv. 二者之一地;(用于否定句或短语后)也;  pron. 任一; [acc] /ˈaɪðər/;
granddaughter: [x] n. 孙女,外孙女; [acc] /ˈɡrændɔːtər/;
earth: [x] n. 地球;陆地;地面; [acc] /ɜːrθ/;
heel: [x] n. 脚后跟;(鞋)后跟;  v. 给(鞋)钉后掌,倾侧,紧跟; [acc] /hiːl/;
northern: [x] adj. 北部的,北方的,有北方特征的; [acc] /ˈnɔːrðərn/;
bleat: [x] v. 咩咩叫;胡扯;抱怨;  n. 咩咩叫声; [acc] /bliːt/;
British: [x] adj. 不列颠的,英联邦的;  n. 英国人;英式英语; [acc] /ˈbrɪtɪʃ/;
interpreter: [x] n. 口译员,口译者; [acc] /ɪnˈtɜːrprɪtər/;
among: [x] prep. 在.中间,在.之中;包括其中; [acc] /əˈmʌŋ/;
own: [x] adj. 自己的;  v. 有,拥有;  pron. 自己的; [acc] /oʊn/;
volleyball: [x] n. 排球; [acc] /ˈvɑːlibɔːl/;
policeman: [x] n. 警察; [acc] /pəˈliːsmən/;
century: [x] n. 世纪;百年; [acc] /ˈsentʃəri/;
produce: [x] v. 生产;创作;产生;  vi. 创作;生产;产生;  n. 农产品; [acc] /prəˈduːs/;
salt: [x] n. 食盐;  adj. 含盐的,腌制的;  v. 加盐于,用盐腌; [acc] /sɔːlt/;
phone: [x] n. 电话,电话机;  v. 打电话; [acc] /foʊn/;
interview: [x] n. 面谈,面试,采访;  v. 面试,采访; [acc] /ˈɪntərvjuː/;
center: [x] n. 中央,中心;  v. 集中;居中; [acc] /ˈsentər/;
Canadian: [x] adj. 加拿大的;  n. 加拿大人; [acc] /kəˈneɪdiən/;
product: [x] n. 产品,产物;(乘)积; [acc] /ˈprɑːdʌkt/;
butter: [x] n. 黄油;奉承话;  vt. 涂黄油于.上,用黄油烹调;讨好; [acc] /ˈbʌtər/;
cock: [x] n. 公鸡;雄鸟;龙头;首领;架子十足的人;  vt. 使某物竖起;使某物倾斜;使朝上;扳上扳机;  vi. 翘起,竖起;大摇大摆; [acc] /kɑːk/;
behind: [x] prep. 在..后面;迟于..,落后于;基于;追赶;  n. [口语]屁股;  adv. 在后面地,落后地,迟,不如; [acc] /bɪˈhaɪnd/;
dive: [x] n. 跳水;潜水;俯冲;骤降;  vi. 跳水;潜水;俯冲;急剧下降; [acc] /daɪv/;
cat: [x] n. 猫;猫科动物; [acc] /kæt/;
rose: [x] n. 玫瑰,蔷薇;  adj. 玫瑰色的; [acc] /roʊz/;
movement: [x] n. 动作,移动;运动;(交响乐)乐章; [acc] /ˈmuːvmənt/;
value: [x] v. 给.定价,评价;重视,珍视,尊重;  n. 价值;有用性; [acc] /ˈvæljuː/;
exist: [x] v. 生存,生活;存在; [acc] /ɪɡˈzɪst/;
back: [x] adj. 后面的;  adv. 回原处;退回;  n. 背部;  v. 支持;后退; [acc] /bæk/;
believe: [x] v. 相信;认为; [acc] /bɪˈliːv/;
piano: [x] n. 钢琴;  adv. (弹或唱时)轻柔地;  adj. (弹或唱时)轻柔的; [acc] /piˈænoʊ/;
bag: [x] n. 袋,包;  v. 把..装进口袋; [acc] /bæɡ/;
obey: [x] v. 服从,听从,遵从;顺从,听从摆布; [acc] /oʊˈbeɪ/;
air: [x] n. 空气;天空,空中;感觉,神态;曲调;  vi. 通风;  vt. 晾干;公开发表; [acc] /er/;
pleased: [x] adj. 高兴的,满意的;  v. 使高兴;使喜欢; [acc] /pliːzd/;
multiply: [x] v. 乘;繁殖;增加; [acc] /ˈmʌltɪplaɪ/;
spoil: [x] v. 溺爱;娇惯;(食物)变质;毁坏;  n. 溺爱;战利品;犒劳;成功所带来的好处; [acc] /spɔɪl/;
baby: [x] n. 宝宝;婴儿;孩子气的人;  adj. 幼嫩的; [acc] /ˈbeɪbi/;
alone: [x] adj. 单独的,独一无二的,孤独的,独自的;  adv. 独自地; [acc] /əˈloʊn/;
single: [x] adj. 单个的;未婚的;单身的;单人的;  n. 单程票;  v. 拣出,挑选(现通常与out连用);作一垒手; [acc] /ˈsɪŋɡl/;
form: [x] n. 形状,表格;形体,方式;  v. 形成,产生;排(队),列(队);组织,建立;塑造,养成;制作,做成; [acc] /fɔːrm/;
review: [x] v. 温习,复习;评论;回顾,反思;  n. 复习,回顾;检讨;评审,审查; [acc] /rɪˈvjuː/;
know-all: [x] n. 自以为无所不知的人;  adj. 自以为无所不知的; [acc] /ˈnoʊ ɔːl/;
destroy: [x] v. 破坏,消灭,毁灭; [acc] /dɪˈstrɔɪ/;
humor: [x] n. 幽默,诙谐; [acc] /ˈhjuːmər/;
continue: [x] v. 继续; [acc] /kənˈtɪnjuː/;
hurt: [x] v. 使受伤;疼痛,感到痛苦; [acc] /hɜːrt/;
favorite: [x] adj. 最爱的;  n. 最喜爱的人或物,有希望获胜的选手; [acc] /'feɪvərɪt/;
spaceship: [x] n. 宇宙飞船; [acc] /ˈspeɪsʃɪp/;
lion: [x] n. 狮子; [acc] /ˈlaɪən/;
weekend: [x] n. 周末,周末休假;  vi. 过周末; [acc] /ˈwiːkend/;
satisfy: [x] v. (使)满意,满足;符合.的标准;使确信,说服; [acc] /ˈsætɪsfaɪ/;
measure: [x] v. 测量;估量;  n. 措施;方法;尺寸;量度标准; [acc] /ˈmeʒər/;
twin: [x] adj. 孪生的;  n. 孪生儿; [acc] /twɪn/;
deer: [x] n. 鹿; [acc] /dɪr/;
picture: [x] v. 想像,设想;画;  n. 画,图片,照片; [acc] /ˈpɪktʃər/;
taxi: [x] n. 出租汽车;  v. (飞机) 缓慢滑行; [acc] /ˈtæksi/;
standard: [x] n. 标准,规格;规范;  adj. 标准的; [acc] /ˈstændərd/;
farm: [x] n. 农场,饲养场;  v. 种田,经营农牧业; [acc] /fɑːrm/;
farmland: [x] n. 农田; [acc] /ˈfɑːrmlænd/;
frightened: [x] adj. 受惊的,受恐吓的; [acc] /ˈfraɪtnd/;
sofa: [x] n. (长)沙发; [acc] /ˈsoʊfə/;
fix: [x] n. 方位,定位,位置;  vt. 使固定;修理;决定;凝视;  vi. 固着;变硬;安定; [acc] /fɪks/;
crowd: [x] n. 人群,一群;民众;朋友;  v. 聚集;涌入(脑海);挤满; [acc] /kraʊd/;
medical: [x] adj. 医学的,医疗的;内科的;  n. 体格检查; [acc] /ˈmedɪkl/;
include: [x] v. 包括,包含,列入; [acc] /ɪnˈkluːd/;
fifteen: [x] num. 十五,十五个;  n. 十五人制英式橄榄球队; [acc] /ˌfɪfˈtiːn/;
extra: [x] adj. 额外的,附加的;特优的;  adv. 额外地;  n. 附加物品;临时演员;(报纸)号外; [acc] /ˈekstrə/;
bush: [x] n. 灌木;灌木丛;矮树;  vi. 丛生;灌木般丛生;浓密(或茂密)地生长;生密枝;  vt. 加(金属)衬套于;加套管于;用耙耙平(耕地);以灌木(或灌木丛)装饰(或覆盖,围绕,围住,支撑,标志,保护等);  adj. (豆科植物等)如灌木般长得低矮的;粗野的;粗鲁的;粗糙但实用的; [acc] /bʊʃ/;
afternoon: [x] n. 午后,下午; [acc] /ˌæftərˈnuːn/;
pig: [x] n. 猪;小猪,野猪;  vi. 生小猪;像猪一样过活;  vt. 贪婪地吃; [acc] /pɪɡ/;
independent: [x] adj. 独立自主的,独自的,无偏见的;  n. 无党派者,独立派人士; [acc] /ˌɪndɪˈpendənt/;
service: [x] n. 服务,帮助;公共设施,公用事业;维修保养;服务机构;发球,发球方式;  v. 保养,维修;支付(借款)利息;为..服务,提供服务;  adj. (军队)服现役的,服务性的,仆人的,耐用的; [acc] /ˈsɜːrvɪs/;
trousers: [x] n. 裤子; [acc] /ˈtraʊzərz/;
work: [x] n. 工作;作品;  v. 工作,劳动,做体力工作,从事..工作,干活,精工细作; [acc] /wɜːrk/;
party: [x] n. 派对,聚会;(共同工作的)队,组; [acc] /ˈpɑːrti/;
east: [x] n. 东;东方;  adj. 东方的;朝(或向)东方的;  adv. 向东方;在东方; [acc] /iːst/;
track: [x] v. 跟踪追赶;用纤拉船;  n. 跑道;小路;行动路线;足迹;轨道; [acc] /træk/;
missile: [x] n. 导弹;投射出的物体或武器;  adj. 导弹的;可投掷的;用以发射导弹的; [acc] /ˈmɪsl/;
kangaroo: [x] n. 袋鼠; [acc] /ˌkæŋɡəˈruː/;
day: [x] n. (一)天,白昼,白天;  adj. 日间的;逐日的;  adv. 每天;经常在白天地; [acc] /deɪ/;
city: [x] n. 城市,都市; [acc] /ˈsɪti/;
company: [x] n. 公司;交往;陪伴;  v. 陪伴; [acc] /ˈkʌmpəni/;
behave: [x] v. 举动;举止端正(或良好,适当); [acc] /bɪˈheɪv/;
child: [x] n. 小孩,儿童;子女; [acc] /tʃaɪld/;
tomato: [x] n. 番茄,西红柿; [acc] /təˈmeɪtoʊ/;
relax: [x] v. 放松;使..放松;宽慰;放宽; [acc] /rɪˈlæks/;
pet: [x] n. 宠物;宠儿;  adj. 宠爱的,重要的;  v. 宠爱,爱抚; [acc] /pet/;
boxer: [x] n. 拳师;拳击手;拳师狗; [acc] /ˈbɑːksər/;
customer: [x] n. 顾客,主顾; [acc] /ˈkʌstəmər/;
parent: [x] n. 父母;母体; [acc] /ˈperənt/;
dialog: [x] n. 对话,对白;  v. 对话;用对话表达; [acc] /ˈdaɪəlɑːɡ/;
table: [x] n. 桌子;表格;  v. 搁置; [acc] /ˈteɪbl/;
pizza: [x] n. 比萨饼; [acc] /ˈpiːtsə/;
export: [x] v. 出口,输出;  n. 输出,出口,输出品; [acc] /ˈekspɔːrt/;
stream: [x] n. 小河,溪流;流,一股,一串;  v. 流(出),涌(出);按能力分班(或分组); [acc] /striːm/;
whom: [x] pron. 谁; [acc] /huːm/;
beyond: [x] adv. 更远处,更多,以后;  prep. 超过;在能力,理解力之外;除..之外; [acc] /bɪˈjɑːnd/;
Saturday: [x] n. 星期六; [acc] /ˈsætərdeɪ/;
refrigerator: [x] n. 冰箱,冷藏库; [acc] /rɪˈfrɪdʒəreɪtər/;
smooth: [x] adj. 光滑的;平稳的;  v. 使光滑;使平稳; [acc] /smuːð/;
design: [x] vt. 设计;  n. 设计;图样;  vi. 设计略图;(为工艺品,装潢项目等)设计;当设计师;构思; [acc] /dɪˈzaɪn/;
experiment: [x] n. 试验;  v. (on)进行实验; [acc] /ɪkˈsperɪmənt/;
guess: [x] v. 猜测,推测;  n. 猜测,推测; [acc] /ɡes/;
sick: [x] adj. 有病的,恶心的;  n. 病人;  v. 呕吐; [acc] /sɪk/;
bike: [x] n. 自行车;  v. 骑自行车; [acc] /baɪk/;
Britain: [x] n. 大不列颠,英国(包括英格兰,威尔士和苏格兰); [acc] /ˈbrɪtn/;
crazy: [x] adj. 疯狂的,荒唐的;狂热的,迷恋的;生气的,气愤的;  n. 荒唐的人;  adv. 疯狂地; [acc] /ˈkreɪzi/;
recycle: [x] v. 回收利用;改建;  n. 再循环; [acc] /ˌriːˈsaɪkl/;
fool: [x] n. 笨蛋,傻瓜;  v. 玩弄,愚弄; [acc] /fuːl/;
cold: [x] adj. 寒冷的;阴冷的;冷漠的;  n. 寒冷; [acc] /koʊld/;
background: [x] n. 图片背景,底色;出身;背景;时代背景; [acc] /ˈbækɡraʊnd/;
remove: [x] v. 把..免职;脱下,摘下;除掉,去除;移开;  n. 间距; [acc] /rɪˈmuːv/;
regard: [x] n. 尊敬;问候,关心;  v. 尊敬;把..视为; [acc] /rɪˈɡɑːrd/;
neighbor: [x] n. 邻居,邻人;邻国;  adj. 邻近的,邻接的;  vi. 友好;毗邻而居;  vt. 邻接; [acc] /'neɪbə/;
tidy: [x] adj. 整洁的,整齐的;  v. 整理,收拾;  n. 盛零碎物品的容器; [acc] /ˈtaɪdi/;
hope: [x] n. 希望;  v. 希望; [acc] /hoʊp/;
doubt: [x] n. 怀疑;疑虑;  v. 怀疑; [acc] /daʊt/;
windy: [x] adj. 刮风的;腹胀的,吹牛的; [acc] /ˈwɪndi/;
tonight: [x] n. 今晚,今夜;  adv. 今晚; [acc] /təˈnaɪt/;
drag: [x] v. 拉,拽,拖着(沉重的步伐或疲惫的身躯);拖动,拖沓;  n. 拖,拖累物;  adj. 女穿男服的;男穿女服的;  adv. 带有女伴; [acc] /dræɡ/;
presence: [x] n. 出席,到场;存在;风度,仪态; [acc] /ˈprezns/;
attend: [x] vi. 护理;照顾;  vt. 出席;参加;  v. 上(学); [acc] /əˈtend/;
lonely: [x] adj. 孤独的,孤单的;荒凉的; [acc] /ˈloʊnli/;
cross: [x] adj. 易怒的,脾气坏的;  v. 穿过;使交叉;  n. 十字架,十字物; [acc] /krɔːs/;
dozen: [x] n. 一打,十二个;一打的;十二个的; [acc] /ˈdʌzn/;
grandchild: [x] n. 孙子,孙女;孙女; [acc] /ˈɡræntʃaɪld/;
dim: [x] adj. 暗淡的;模糊的;朦胧的;  v. 变暗淡; [acc] /dɪm/;
noodle: [x] n. (常pl.)面条; [acc] /ˈnuːdl/;
rubber: [x] n. 橡皮,橡胶;橡胶制品,胶鞋; [acc] /ˈrʌbər/;
opening: [x] n. 开口;孔;开始;开幕;职位空缺;  adj. 开始的,开场的; [acc] /ˈoʊpnɪŋ/;
reliable: [x] adj. 可靠的;可信赖的;确实的; [acc] /rɪˈlaɪəbl/;
door: [x] n. 门;门口,通道;建筑物; [acc] /dɔːr/;
since: [x] adv. 从那时以来;  conj. 从..以来,..以后,由于;  prep. 从..以来; [acc] /sɪns/;
drown: [x] v. 淹死;淹没; [acc] /draʊn/;
reading: [x] n. 阅读;读物;读数; [acc] /ˈriːdɪŋ/;
sort: [x] v. 把..分类,挑选;修理,整理;  n. 种类; [acc] /sɔːrt/;
April: [x] n. 四月(略作Apr.); [acc] /ˈeɪprəl/;
project: [x] n. 项目,工程;专题研究;课题方案;  v. 映射,放映;计划,设计,打算,拟订方案;投掷,发射,喷射;表明..的特性,使呈现特性;阐述;突出,伸出;估计,预估; [acc] /ˈprɑːdʒekt/;
wife: [x] n. 妻子; [acc] /waɪf/;
bright: [x] adj. 明亮的,聪明的,欢快的;  adv. 光亮地;明亮地;  n. 头灯; [acc] /braɪt/;
stocking: [x] n. 长(筒)袜; [acc] /ˈstɑːkɪŋ/;
end: [x] n. 终点;末端;结果,结局;终止,结束,极限,终极;  adj. 最后的,最终的;  v. 结束; [acc] /end/;
travel: [x] n. 旅行,旅游;  v. 旅行;行进,被传播;走过,驶过; [acc] /ˈtrævl/;
helpful: [x] adj. 肯帮忙的,给予帮助的;有用的; [acc] /ˈhelpfl/;
detective: [x] n. 侦探,私人侦探;  adj. 侦探的; [acc] /dɪˈtektɪv/;
extreme: [x] adj. 极端的;极远的;极限的;极度的;偏激的;  n. 极端;极度(状态),最大程度; [acc] /ɪkˈstriːm/;
airline: [x] n. 航空公司,航空系统,(飞机的)航线;  adj. 航空公司的;在航线上的; [acc] /ˈerlaɪn/;
disaster: [x] n. 灾难,天灾; [acc] /dɪˈzæstər/;
food: [x] n. 食物,食品,养料; [acc] /fuːd/;
rainfall: [x] n. 降雨;降雨量; [acc] /ˈreɪnfɔːl/;
mount: [x] v. 登上;爬上;骑上;增长;组织,安排;  n. 山;峰; [acc] /maʊnt/;
press: [x] v. 按,压,逼迫;  n. 新闻界,出版社,报刊; [acc] /pres/;
shopping: [x] n. 购物;商品; [acc] /ˈʃɑːpɪŋ/;
sometime: [x] adv. 在某一时候;  adj. 某一时间的;以前的; [acc] /ˈsʌmtaɪm/;
dislike: [x] v. 不喜欢,厌恶;  n. 不喜欢,厌恶; [acc] /dɪsˈlaɪk/;
seat: [x] n. 座位,地位,位置;  v. 安装,使坐下; [acc] /siːt/;
darkness: [x] n. 黑暗;模糊;无知;邪恶; [acc] /ˈdɑːrknəs/;
Ottawa: [x] n. 渥太华; [acc] /ˈɑːtəwə/;
below: [x] prep. 在.之下,低于;  adv. 在下面,向下,在零下;  n. 下面; [acc] /bɪˈloʊ/;
something: [x] pron. 某事物,有价值或重要的人或事物,大致;  adv. 有点,非常;有点像,大约;  n. (表示不确切的描述或数量)某事,某物; [acc] /ˈsʌmθɪŋ/;
provide: [x] v. 提供,供给; [acc] /prəˈvaɪd/;
unlike: [x] adj. 不同的;  prep. 不像;和..不同; [acc] /ˌʌnˈlaɪk/;
cartoon: [x] n. 卡通(片),动画片;(尤指报刊上讽刺政客或时事的)漫画,幽默画; [acc] /kɑːrˈtuːn/;
leader: [x] n. 领导,领袖,指挥者,领先的人; [acc] /ˈliːdər/;
London: [x] n. 伦敦; [acc] /ˈlʌndən/;
burn: [x] v. 烧,燃烧;  n. 烧伤; [acc] /bɜːrn/;
happen: [x] v. 发生,碰巧,出现,偶遇;碰巧;恰好; [acc] /ˈhæpən/;
none: [x] pron. 没有(一人或一物);  adv. 毫不; [acc] /nʌn/;
wing: [x] n. 翅膀;机翼;门厅;  v. 飞过,空运; [acc] /wɪŋ/;
village: [x] n. 村庄,乡村;村民; [acc] /ˈvɪlɪdʒ/;
warm: [x] adj. 温暖的;  v. 使温暖;  adv. 温暖地,暖和地;  n. 暖和(的地方),保暖(的东西); [acc] /wɔːrm/;
boot: [x] n. (长筒)靴;箱子,行李箱;解雇;  v. 踢;启动; [acc] /buːt/;
glove: [x] n. 手套; [acc] /ɡlʌv/;
plain: [x] adj. 平凡的;明白的;坦率的;朴素的;不尚修饰的(尤指女人);  n. 大平原; [acc] /pleɪn/;
anger: [x] n. 怒,愤怒;  v. 使发怒,激怒; [acc] /ˈæŋɡər/;
manage: [x] v. 管理;控制;设法做成;有时间做,安排(时间)做;应付过去,设法对付过去;  n. 马术练习所; [acc] /ˈmænɪdʒ/;
person: [x] n. 人,本人,自身; [acc] /ˈpɜːrsn/;
speed: [x] n. 速度,速率;迅速;  v. 加速; [acc] /spiːd/;
emergency: [x] n. 紧急情况;突发事件; [acc] /iˈmɜːrdʒənsi/;
modern: [x] adj. 现代的,时髦的; [acc] /ˈmɑːdərn/;
basketball: [x] n. 篮球;篮球比赛; [acc] /ˈbæskɪtbɔːl/;
careful: [x] adj. 仔细的,小心的;细心的;精心的; [acc] /ˈkerfl/;
dormitory: [x] n. 宿舍楼 [美国英语];宿舍,学生宿舍;  adj. 住宅区的; [acc] /ˈdɔːrmətɔːri/;
pacific: [x] adj. 太平洋的;与太平洋有关的;爱好和平的,温和的;  n. 太平洋; [acc] /pəˈsɪfɪk/;
record: [x] v. 记录,把(声音,图像)录下;  n. 档案,记录; [acc] /rɪˈkɔːrd/;
night: [x] n. 夜,夜间;  adj. 夜晚的,夜间的; [acc] /naɪt/;
Chinese: [x] adj. 中国的;  n. 中国人;中文; [acc] /ˌtʃaɪˈniːz/;
academy: [x] n. 学院; [acc] /əˈkædəmi/;
coal: [x] n. 煤,煤块; [acc] /koʊl/;
pretty: [x] adj. 漂亮的,标致的,可爱的;  adv. 相当地,很;  n. 漂亮的东西,美人; [acc] /ˈprɪti/;
clinic: [x] n. 诊所;门诊(部,室); [acc] /ˈklɪnɪk/;
thin: [x] adj. 薄的;稀薄的,淡的;瘦的;空泛的;  v. 变薄,变细;变稀;  adv. 薄薄地; [acc] /θɪn/;
jump: [x] v. 跳;暴涨;  n. 跳跃,跳,跃; [acc] /dʒʌmp/;
amazing: [x] adj. 令人吃惊的,非凡的; [acc] /əˈmeɪzɪŋ/;
million: [x] num. 百万,许多; [acc] /ˈmɪljən/;
distance: [x] n. 距离;间距;远处; [acc] /ˈdɪstəns/;
importance: [x] n. 重要;重要性; [acc] /ɪmˈpɔːrtns/;
later: [x] adv. 后来;过一会儿;  adj. 后来的;以后的;接近末期的; [acc] /ˈleɪtər/;
worse: [x] n. 更坏的事,更恶劣的事;  adj. 更坏的,更恶劣的;  adv. 更坏地,更恶劣地; [acc] /wɜːrs/;
incident: [x] n. 事件;事变,军事冲突,冲突;事故;  adj. [法]附带的;[光]入射的;易发生的,伴随而来的; [acc] /ˈɪnsɪdənt/;
kilo: [x] n. 公斤;千克;公里(等于kilogram);  pref. 表示"千"; [acc] /ˈkiːloʊ/;
medal: [x] n. 奖牌;勋章;  v. 授予奖章; [acc] /ˈmedl/;
energy: [x] n. 能量;能源;活力;精力;能; [acc] /ˈenərdʒi/;
sixth: [x] num. 第六个;  n. 第六个;六分之一;  adj. 第六个的;  pron. 第六; [acc] /sɪksθ/;
ourselves: [x] pron. 我们自己; [acc] /ɑːrˈselvz/;
inside: [x] adj. 里面的,内部的,内幕的;  adv. 在里面,在内部;  n. 内部,里面,内侧;  prep. 在..里,在..内; [acc] /ˌɪnˈsaɪd/;
devote: [x] vt. 奉献;献身于,专心致力于; [acc] /dɪˈvoʊt/;
toilet: [x] n. 马桶,坐便器,厕所,卫生间; [acc] /ˈtɔɪlət/;
main: [x] adj. 主要的,最重要的;  n. 干线,总管道; [acc] /meɪn/;
picnic: [x] n. 郊游,野餐;  vi. 野餐; [acc] /ˈpɪknɪk/;
above: [x] adj. 上面的,上述的,上文的;  adv. 在上面,在上文;  prep. 在.上方,在.之上;过于,超出,超过;  n. 上面的东西,上文; [acc] /əˈbʌv/;
date: [x] n. 日期;约会对象;约会;枣子;  v. 约会;始于(某一历史时期);给..注明日期,记载日期;确定..的年代; [acc] /deɪt/;
likely: [x] adj. 有可能;可信的;适合的;  adv. 很可能; [acc] /ˈlaɪkli/;
factory: [x] n. 工厂,制造厂; [acc] /ˈfæktəri/;
wound: [x] n. 创伤,伤口;  v. 伤,伤害; [acc] /wuːnd/;
suck: [x] v. 啜,吸入,吸收;使卷入;糟糕,差劲;  n. 吸吮,吸力; [acc] /sʌk/;
organization: [x] n. 组织,体制,团体,机构; [acc] /ˌɔːrɡənəˈzeɪʃn/;
cover: [x] v. 报道,采访;足以支付,够付;  n. 盖子;封面;  vt. 盖住;包括,掩护;通过; [acc] /ˈkʌvər/;
mist: [x] n. 薄雾,朦胧;  v. 使模糊,下雾; [acc] /mɪst/;
cycle: [x] n. 自行车;周期,循环;  v. (英)骑自行车;循环; [acc] /ˈsaɪkl/;
abacus: [x] n. 算盘; [acc] /ˈæbəkəs/;
bath: [x] n. 洗澡,沐浴,浴缸;  v. 给..洗澡;洗澡;  adj. 沐浴着(光线);汗流浃背;泪流满面; [acc] /bæθ/;
early: [x] adj. 早的,早期的;  adv. 早,先; [acc] /ˈɜːrli/;
hers: [x] pron. 她的(所有格代词); [acc] /hɜːrz/;
amusement: [x] n. 娱乐,消遣;乐趣; [acc] /əˈmjuːzmənt/;
golden: [x] adj. 金黄色的;贵重的,极好的; [acc] /ˈɡoʊldən/;
physics: [x] n. 物理(学); [acc] /ˈfɪzɪks/;
movie: [x] n. 电影;电影院;电影制片业; [acc] /ˈmuːvi/;
onto: [x] prep. 到..上;面向; [acc] /ˈɑːntə/;
blackboard: [x] n. 黑板; [acc] /ˈblækbɔːrd/;
hear: [x] vi. 听见;  vt. 审讯;听说;听,听见; [acc] /hɪr/;
show: [x] v. 展示;显示,表明;  n. 演出,展览; [acc] /ʃoʊ/;
lively: [x] adj. 活泼的,生动的;轻快的,富有活力的;生机勃勃的; [acc] /ˈlaɪvli/;
examine: [x] v. 检查,细查;对..进行考试; [acc] /ɪɡˈzæmɪn/;
knife: [x] n. 小刀,刀,餐刀;  v. 用刀切割; [acc] /naɪf/;
handwriting: [x] n. 笔迹,字迹;书写;亲手写; [acc] /ˈhændraɪtɪŋ/;
hour: [x] n. 小时;时间,时刻; [acc] /ˈaʊər/;
instruction: [x] n. 说明;指令,命令;指示;指导,讲授;  adj. 说明用法的;操作指南的; [acc] /ɪnˈstrʌkʃn/;
period: [x] n. 句号;时期;例假; [acc] /ˈpɪriəd/;
necktie: [x] n. 领带; [acc] /ˈnektaɪ/;
name: [x] n. 名字;名声;  v. 给..取(或命)名;指出; [acc] /neɪm/;
think: [x] v. 想,思索,认为;以为,预料; [acc] /θɪŋk/;
accept: [x] v. 接受;接受(所提供或给予的物品); [acc] /əkˈsept/;
succeed: [x] v. 成功;接替;继承; [acc] /səkˈsiːd/;
lot: [x] pron. 大量,许多;场地;一批;某一类人;  adv. (与形容词和副词连用)很;非常;(与动词连用)非常;  v. 分组;把.划分(常与out连用);把(土地)划分成块;抽签;拈阄; [acc] /lɑːt/;
fossil: [x] n. 化石;  adj. 从地下发掘出来的;化石的;属于旧时代的;陈腐的; [acc] /ˈfɑːsl/;
especially: [x] adv. 特别;尤其;格外;异常地; [acc] /ɪˈspeʃəli/;
help: [x] v. 帮助;援助;  n. 帮助; [acc] /help/;
war: [x] n. 战争;作战;打仗; [acc] /wɔːr/;
egg: [x] n. 蛋;鸡蛋;卵;  vt. 用蛋覆盖;向..扔蛋; [acc] /eɡ/;
entrance: [x] n. 入口,通道,大门口;出场,登场;进入权;  v. 使出神,使入迷; [acc] /ˈentrəns/;
win: [x] v. (获)胜,赢得;  n. 赢,胜利; [acc] /wɪn/;
passage: [x] n. 通道,走廊;(法案的)通过;段落;推移;旅程; [acc] /ˈpæsɪdʒ/;
type: [x] n. 类型,种类;  v. 打字;[医学]测定(血型);按类型把.归类;成为.的典型;[印刷]浇铸(铅字等); [acc] /taɪp/;
find: [x] v. 找到;发现;找出,定位;  n. 发现物,被发现的人; [acc] /faɪnd/;
offer: [x] n. 提供;特价;出价;录取(用)通知书;提议;  vt. 给予,奉上;表示愿意 (做某事);提供;出价; [acc] /ˈɔːfər/;
tenth: [x] n. 第十;十分之一;  num. 第十;第十(的); [acc] /tenθ/;
waiter: [x] n. 侍者,服务员; [acc] /ˈweɪtər/;
jungle: [x] n. 丛林,密林;危险地带;丛林音乐; [acc] /ˈdʒʌŋɡl/;
farming: [x] n. 农业,耕作;  adj. 农业的;农场的; [acc] /ˈfɑːrmɪŋ/;
pleasure: [x] n. 愉快,快乐,乐事; [acc] /ˈpleʒər/;
fist: [x] n. 拳头;笔迹;  vt. 用拳头打;握成拳;紧握; [acc] /fɪst/;
forty: [x] num. 四十,第四十;四十的;四十(个);四十个的;  n. 四十年代; [acc] /ˈfɔːrti/;
remote: [x] n. 遥控器;  adj. 遥远的;偏僻的;关系远的; [acc] /rɪˈmoʊt/;
handsome: [x] adj. 英俊的,帅气的;漂亮的,大方的; [acc] /ˈhænsəm/;
biology: [x] n. 生物学;生物;生命周期; [acc] /baɪˈɑːlədʒi/;
kitchen: [x] n. 厨房;炊具; [acc] /ˈkɪtʃɪn/;
piece: [x] n. 块;件;篇;  v. 修补;接合;凑合; [acc] /piːs/;
slipper: [x] n. 拖鞋;便鞋;  v. 穿着拖鞋走;用拖鞋打; [acc] /ˈslɪpər/;
boyfriend: [x] n. 男朋友,情郎; [acc] /ˈbɔɪfrend/;
toward: [x] prep. 向;朝;对于; [acc] /tɔːrd/;
German: [x] adj. 德国的;  n. 德语,德国人; [acc] /ˈdʒɜːrmən/;
river: [x] n. 河,江; [acc] /ˈrɪvər/;
receiver: [x] n. 听筒;收受人,接待者,尤指收款员;接收器;收件人,收款人;〔破产企业或公司的〕管理人,接管人;买卖赃物者; [acc] /rɪˈsiːvər/;
part-time: [x] adj. 部分时间的;兼职的;  adv. 以部分时间;作为兼职; [acc] /ˌpɑːrt ˈtaɪm/;
refuse: [x] v. 拒绝;抵制;  n. 废料;垃圾;  adj. 无价值的; [acc] /rɪˈfjuːz/;
goodness: [x] n. 善良;仁慈;优良;精髓;  int. 天哪,哎呀; [acc] /ˈɡʊdnəs/;
bear: [x] n. 熊;(股市)看跌的人;  v. 容忍,忍受;承担;带有;生育;开花结果,结(果实); [acc] /ber/;
December: [x] n. 十二月; [acc] /dɪˈsembər/;
upon: [x] prep. 在..上面; [acc] /əˈpɑːn/;
engine: [x] n. 引擎;发动机;  v. 给..装引擎; [acc] /ˈendʒɪn/;
magic: [x] n. 魔术,戏法;魔法;  adj. 有魔力的,魔术的; [acc] /ˈmædʒɪk/;
walk: [x] n. 走;人行道;散步;  vi. 走;行走散步;  vt. 沿着.走;慢步走;护送.走; [acc] /wɔːk/;
nobody: [x] pron. 没有人;谁也不;  n. 无名小卒; [acc] /ˈnoʊbədi/;
skirt: [x] n. 裙子;  v. 装边于; [acc] /skɜːrt/;
muscle: [x] n. 肌肉,肌;体力;  v. 用强迫手段获得; [acc] /ˈmʌsl/;
pass: [x] n. 飞机或人造卫星等的一次掠过;  vt. 经过;通过;传递,度过; [acc] /pæs/;
aeroplane: [x] n. 飞机; [acc] /ˈerəpleɪn/;
ladder: [x] n. 梯子,阶梯;  vi. (长筒袜等)抽丝; [acc] /ˈlædər/;
watch: [x] v. 观看,注视;看守,监视;  n. 表;看守;监视; [acc] /wɑːtʃ/;
army: [x] n. 陆军,军队,大群,大军; [acc] /ˈɑːrmi/;
wise: [x] adj. 聪明的;有智慧的,博学的;知情的;  v. 知道,教导; [acc] /waɪz/;
dream: [x] v. 做梦,梦想;  n. 梦,梦想; [acc] /driːm/;
tale: [x] n. 故事,叙述,传说;流言;  v. 谈论,讲述,搬弄是非; [acc] /teɪl/;
tooth: [x] n. 牙齿,齿;齿状物; [acc] /tuːθ/;
Mexico: [x] n. 墨西哥; [acc] /ˈmeksɪkoʊ/;
uncle: [x] n. 伯父,叔父,舅夫,姑父;叔叔; [acc] /ˈʌŋkl/;
found: [x] v. 成立,建立,创办;发现(find的过去式); [acc] /faʊnd/;
brother: [x] n. 兄弟;同事;同胞;  excl. 表示生气或吃惊;  v. 和..结成弟兄; [acc] /ˈbrʌðər/;
direction: [x] n. 方向,方位;指令,说明; [acc] /dəˈrekʃn/;
turning: [x] n. 转弯处; [acc] /ˈtɜːrnɪŋ/;
soup: [x] n. 汤; [acc] /suːp/;
most: [x] adv. 最;非常,极其;最多;几乎;  adj. 大部分的,多数的;最多的;  n. 大部分,大多数;  pron. 大多数,大部分; [acc] /moʊst/;
disease: [x] n. 疾病; [acc] /dɪˈziːz/;
shoulder: [x] n. 肩膀,肩部;  vt. 肩负,承当; [acc] /ˈʃoʊldər/;
choose: [x] v. 选择,挑选; [acc] /tʃuːz/;
insert: [x] vt. 插入,嵌入;  n. 插入物;插页; [acc] /ɪnˈsɜːrt/;
medicine: [x] n. 内服药,医药,医学,内科学; [acc] /ˈmedɪsn/;
sometimes: [x] adv. 有时,间或; [acc] /ˈsʌmtaɪmz/;
color: [x] n. 颜色;颜料;肤色;  v. 上颜色;(观念等)受..影响;脸红; [acc] /ˈkʌlər/;
carry: [x] vt. 携带(疾病,病菌);运载;传送;  vi. 扔(或踢)到.距离;(马等)具有某种姿势;(声音)传得很远;  v. (报纸,海报)登载,刊登,印有;使提案通过,赞成;具有,带有(特点,后果等);  n. (枪炮,火箭等的)射程;运输,运送; [acc] /ˈkæri/;
candle: [x] n. 蜡烛; [acc] /ˈkændl/;
store: [x] n. 商店;储存品;  v. 贮藏,储存; [acc] /stɔːr/;
cottage: [x] n. 村舍,小屋;小房子; [acc] /ˈkɑːtɪdʒ/;
evening: [x] n. 傍晚,晚上;黄昏; [acc] /ˈiːvnɪŋ/;
garden: [x] n. 花园,菜园;公园;  v. 从事园艺; [acc] /ˈɡɑːrdn/;
spirit: [x] n. 灵魂,精神;心灵;幽灵;意志,精力;实质;情绪;烈酒(spirits);  v. 鼓励;使振作;诱拐; [acc] /ˈspɪrɪt/;
pie: [x] n. 甜馅饼;饼图,饼状图; [acc] /paɪ/;
moment: [x] n. 片刻,瞬间;时刻; [acc] /ˈmoʊmənt/;
sell: [x] v. 出售,卖; [acc] /sel/;
self-respect: [x] n. 自重,自尊; [acc] /ˌself rɪˈspekt/;
drought: [x] n. 干旱,旱灾; [acc] /draʊt/;
birthday: [x] n. 生日,诞生的日期; [acc] /ˈbɜːrθdeɪ/;
eye: [x] n. 眼睛;眼球;眼圈;眼神;注意;判断力;眼状物;视角;  v. 向.送秋波;注视;考虑; [acc] /aɪ/;
brown: [x] n. 褐色,棕色;  adj. 褐色的,棕色的;  v. (使)变褐色; [acc] /braʊn/;
case: [x] n. 箱子,盒;案例,例子,情况;  v. 装箱,踩点,仔细检查; [acc] /keɪs/;
decide: [x] v. 决定,决心,判断; [acc] /dɪˈsaɪd/;
subject: [x] n. 科目;主题;受试者;国民;  adj. 易患的,服从的;  vt. 使服从,使隶属,使遭遇; [acc] /ˈsʌbdʒɪkt/;
sightseeing: [x] n. 观光;游览;  adj. 观光的,浏览的; [acc] /ˈsaɪtsiːɪŋ/;
mercy: [x] n. 宽恕,仁慈,怜悯,恩惠; [acc] /ˈmɜːrsi/;
Mid-autumn: [x] n. 中秋; [acc] /mɪd ˈɔtəm/;
Australia: [x] n. 澳大利亚; [acc] /ɔ'streljə/;
mean: [x] n. 平均值,中庸;  v. 意思是,打算,导致;  adj. 吝啬的,低劣的,刻薄的,卑鄙的,平均的,中等的; [acc] /miːn/;
boss: [x] n. 老板,上司;  vt. 指挥;  vi. 当首领,发号施令;  adj. <俚>很好的,一流的; [acc] /bɔːs/;
exercise: [x] v. 运动;锻炼;行使,运用;  n. 操练,运动;习题; [acc] /ˈeksərsaɪz/;
dish: [x] n. 碟,盘子;菜肴; [acc] /dɪʃ/;
however: [x] adv. 然而,不过;无论如何,不管多么; [acc] /haʊˈevər/;
algebra: [x] n. 代数; [acc] /ˈældʒɪbrə/;
proper: [x] adj. 适合的,适用的;独特的;真正的;正确的;得体的;完全的; [acc] /ˈprɑːpər/;
bell: [x] n. 钟,铃,门铃;钟声; [acc] /bel/;
rapid: [x] adj. 迅速的;急促的; [acc] /ˈræpɪd/;
charge: [x] v. 充电,充值;索价;控告;向.冲去;  n. 费用;主管;控告; [acc] /tʃɑːrdʒ/;
whose: [x] det. 谁的;其;  pron. 那(些)人的;  conj. 谁的; [acc] /huːz/;
pain: [x] n. 痛,痛苦;努力,劳苦; [acc] /peɪn/;
dear: [x] adj. 亲爱的;昂贵的;  n. 亲爱的人;  excl. 啊; [acc] /dɪr/;
headmistress: [x] n. 女校长; [acc] /ˌhedˈmɪstrəs/;
tourist: [x] n. 旅行者,观光者; [acc] /ˈtʊrɪst/;
breath: [x] n. 呼吸;气息;气味; [acc] /breθ/;
judgment: [x] n. 审判,宣判;意见,看法;判断力; [acc] /'dʒʌdʒmənt/;
unless: [x] conj. 除非,如果不;除..外; [acc] /ənˈles/;
communication: [x] n. 沟通方式;交流,通讯;信息; [acc] /kəˌmjuːnɪˈkeɪʃn/;
pillow: [x] n. 枕头;  v. 垫,枕着; [acc] /ˈpɪloʊ/;
man-made: [x] adj. 人造的,人工的,合成的; [acc] /ˌmæn ˈmeɪd/;
eastern: [x] adj. 东方的,东部的,朝东的;  n. 东方人;(美国)东部地区的人;东正教信徒; [acc] /ˈiːstərn/;
peach: [x] n. 桃子,桃树;极可爱的(人或事物),非常迷人的(人或事物);桃红色;  adj. 桃红色的,用桃子制成的; [acc] /piːtʃ/;
hide: [x] vt. 躲藏,把.藏起来;隐瞒;  n. 藏身处;隐密场所,隐蔽处;(尤指买卖或用作皮革的)皮;兽皮;人身安全; [acc] /haɪd/;
fever: [x] n. 发热,狂热; [acc] /ˈfiːvər/;
zebra: [x] n. 斑马; [acc] /ˈziːbrə/;
terrific: [x] adj. 极好的;可怕的;(尺寸或程度)极其巨大的,大的惊人的; [acc] /təˈrɪfɪk/;
soon: [x] adv. 立刻,不久;快,早; [acc] /suːn/;
homeland: [x] n. 祖国;家园,故乡; [acc] /ˈhoʊmlænd/;
ordinary: [x] adj. 普通的,平常的,平凡的;平淡的,平庸的; [acc] /ˈɔːrdneri/;
fast: [x] adj. 迅速的,动作敏捷的;很快做完的;头脑灵活的;不褪色的;牢固的;扎牢的;耐..的;  adv. 迅速地;牢固地;彻底地;  n. 斋戒,禁食期;  v. 节制饮食,节食; [acc] /fæst/;
practical: [x] adj. 实际的,实用的,实践的,切合实际的;〔人〕注重实际的,务实的;〔计划,方法等〕有效的,切实可行的;心灵手巧的;  n. 实习课;实践课;实验考核; [acc] /ˈpræktɪkl/;
politeness: [x] n. 有礼貌;优雅; [acc] /pəˈlaɪtnəs/;
ham: [x] n. 火腿;  adj. 做作的,蹩脚的; [acc] /hæm/;
crossing: [x] n. 人行横道;十字路口;横渡; [acc] /ˈkrɔːsɪŋ/;
Asia: [x] n. 亚洲; [acc] /ˈeɪʒə/;
heart: [x] n. 心,内心;勇气; [acc] /hɑːrt/;
August: [x] n. 八月; [acc] /ˈɔːɡəst/;
sale: [x] n. 廉价出售,销售额,拍卖; [acc] /seɪl/;
fence: [x] n. 篱笆,围栏,栅栏;  v. 击剑;用篱笆围住;束缚; [acc] /fens/;
might: [x] n. 力量,强权,势力;  auxv. 可以;或许;可能,也许; [acc] /maɪt/;
lorry: [x] n. 卡车;运货汽车; [acc] /ˈlɔːri/;
fasten: [x] v. 系;扎牢;扣住;固定; [acc] /ˈfæsn/;
hostess: [x] n. 女主人,女主持人,女服务员(乘务员); [acc] /ˈhoʊstəs/;
fly: [x] n. 蝇,苍蝇;  v. 飞行;  adj. 机灵的;机警的;不会上当的;时髦迷人的; [acc] /flaɪ/;
foolish: [x] adj. 愚蠢的;傻乎乎的; [acc] /ˈfuːlɪʃ/;
nurse: [x] n. 护士,保姆;  v. 护理,看护; [acc] /nɜːrs/;
prevent: [x] v. 预防,阻止; [acc] /prɪˈvent/;
harm: [x] n. 伤害,损害;  v. 伤害; [acc] /hɑːrm/;
pound: [x] n. 英镑,磅;  v. (连续)猛击,捣碎; [acc] /paʊnd/;
rainy: [x] adj. 下雨的,多雨的; [acc] /ˈreɪni/;
someone: [x] pron. 有人,某人;重要人物; [acc] /ˈsʌmwʌn/;
skill: [x] n. 技能;技巧,技艺;巧妙; [acc] /skɪl/;
live: [x] v. 活着,过着,居住;  adj. 直播的;实况播送的;现场的;  adv. 现场; [acc] /lɪv/;
wide: [x] adj. 宽阔的;广泛的;  adv. 完全地;充分地; [acc] /waɪd/;
chairman: [x] n. 主席;议长,会长,董事长; [acc] /ˈtʃermən/;
wonderful: [x] adj. 惊人的,奇妙的;极好的,精彩的; [acc] /ˈwʌndərfl/;
rough: [x] adj. 粗糙的;大致的,粗略的;(海)波涛汹涌的;困难的,令人不快的;  n. 草稿;  adv. 粗暴地;  v. 艰苦生活; [acc] /rʌf/;
finger: [x] n. 手指;指状物;  v. 触碰,用指抚摸; [acc] /ˈfɪŋɡər/;
cyclist: [x] n. 骑脚踏车的人; [acc] /ˈsaɪklɪst/;
here: [x] adv. 这里;在这里,到这里,从这里,朝这里;  n. 这里;  int. 嘿;喂(用于引起注意); [acc] /hɪr/;
eat: [x] v. 吃,喝,吃饭; [acc] /iːt/;
mouth: [x] n. 口;嘴;  v. 做作地说,装腔作势地说;不出声地说,以嘴唇的动作不出声地讲; [acc] /maʊθ/;
protection: [x] n. 保护,防卫,警戒; [acc] /prəˈtekʃn/;
floor: [x] n. 地板,地面,楼层,底部;  vt. 铺地板,击倒,(油门)踩到底; [acc] /flɔːr/;
weekly: [x] adv. 一周一次地;  adj. 每周的,一周一次的;  n. 周报,周刊; [acc] /ˈwiːkli/;
June: [x] n. 六月; [acc] /dʒuːn/;
Sunday: [x] n. 星期日;  adj. 星期日的; [acc] /ˈsʌndeɪ/;
tofu: [x] n. 豆腐; [acc] /ˈtoʊfuː/;
stove: [x] n. 炉,火炉,电炉; [acc] /stoʊv/;
protect: [x] v. 保护;警戒; [acc] /prəˈtekt/;
same: [x] adj. 相同的,同样的,同一的,一模一样的;上述的;千篇一律的,单调的,无变化的,依然如故的;  pron. 同样的事物,同样的人;  adv. 同样地;仍然; [acc] /seɪm/;
till: [x] v. 翻地,耕地;  conj. 直到⋯⋯才;  prep. 直到⋯⋯才;  n. 放钱的抽屉,冰碛物; [acc] /tɪl/;
fog: [x] n. 雾;烟雾,尘雾;  v. 以雾笼罩,使模糊,迷惑; [acc] /fɔːɡ/;
gentle: [x] adj. 温和的,轻柔的,文雅的; [acc] /ˈdʒentl/;
twice: [x] adv. 两次,两倍; [acc] /twaɪs/;
try: [x] v. 试图,努力;试验;审讯;考验;  n. 努力,尝试; [acc] /traɪ/;
grammar: [x] n. 语法,语法书; [acc] /ˈɡræmər/;
youth: [x] n. 青年;青年时期;青年们;青春; [acc] /juːθ/;
Russia: [x] n. 俄罗斯,俄国; [acc] /ˈrʌʃə/;
disabled: [x] adj. 伤残的;有残疾的;丧失能力的; [acc] /dɪsˈeɪbld/;
hometown: [x] n. 故乡; [acc] /ˈhoʊmtaʊn/;
tie: [x] n. 领带;关系;束缚;  v. 系;打结;打成平局;绑,捆;打,打结; [acc] /taɪ/;
haircut: [x] n. 理发,发型; [acc] /ˈherkʌt/;
bill: [x] n. 账单;纸币,钞票;议案,法案;广告;鸟嘴;  v. 给..开账单; [acc] /bɪl/;
attention: [x] n. 专心,留心,注意,注意力,关心,体贴,礼貌;  excl. 立正,注意; [acc] /əˈtenʃn/;
rank: [x] v. 排名;把.分等级;列队;  n. 等级;军队中的官阶;  adj. 繁茂的,讨厌的,难闻的; [acc] /ræŋk/;
cafe: [x] n. 咖啡馆,餐馆; [acc] /kæˈfeɪ/;
yours: [x] pron. 你的,你们的(所属物);信末署名前用语; [acc] /jɔːrz/;
entire: [x] adj. 全部的,完整的,整个的;  n. 全部,整体; [acc] /ɪnˈtaɪər/;
delicious: [x] adj. 美味的,可口的; [acc] /dɪˈlɪʃəs/;
popcorn: [x] n. 爆米花; [acc] /ˈpɑːpkɔːrn/;
plenty: [x] n. 丰富,大量;充裕;  adv. 很多,绰绰有余的,非常; [acc] /ˈplenti/;
hunger: [x] n. 饥饿;渴望;  v. 渴望,饥饿; [acc] /ˈhʌŋɡər/;
over: [x] adv. 越过;翻倒;遍布;结束;  adj. 过去的;外面的;在上的;上级的;过分的,多余的;  n. 额外,剩余,剩余(或多余)的量,剩余物;  int. [电信学]报文完,请回复!;  prep. 在..上方;遍及;  vt. 走过,跳过,[美国方言]从.恢复过来; [acc] /ˈoʊvər/;
eighth: [x] num. 第八;  n. 八分之一; [acc] /eɪtθ/;
seven: [x] num. 七,七个;  n. 七个,七点; [acc] /ˈsevn/;
winner: [x] n. 获胜者,得奖者,稳操胜券者; [acc] /ˈwɪnər/;
riverside: [x] n. 河岸,河畔;  adj. 河边的,河畔的; [acc] /ˈrɪvərsaɪd/;
undersea: [x] adj. 水下的;海面下的;  adv. 在海面下; [acc] /ˈʌndərsiː/;
ending: [x] n. 结尾,结局,末尾; [acc] /ˈendɪŋ/;
gentleman: [x] n. 绅士;有教养的人; [acc] /ˈdʒentlmən/;
angel: [x] n. 天使;可爱的人;善人,好人(感激某人时所说); [acc] /ˈeɪndʒl/;
except: [x] prep. 除..之外;  v. 把..除外;  conj. 除.以外; [acc] /ɪkˈsept/;
physician: [x] n. 内科医生; [acc] /fɪˈzɪʃn/;
ever: [x] adv. 曾经,在任何时候,究竟,一直,永远;  pref. (构成形容词)表示"永远","持续"; [acc] /ˈevər/;
wood: [x] n. 木头,木材,木料;林地,树林; [acc] /wʊd/;
cushion: [x] n. 坐垫;  v. 减轻,缓和; [acc] /ˈkʊʃn/;
shoe: [x] n. 鞋;  v. 穿鞋;给(马)钉蹄铁; [acc] /ʃuː/;
steak: [x] n. 牛排;肉块;鱼块; [acc] /steɪk/;
cotton: [x] n. 棉花,棉线,棉布; [acc] /ˈkɑːtn/;
symbol: [x] n. 象征;符号,图标;记号;标志; [acc] /ˈsɪmbl/;
inch: [x] n. 英寸;少许,少量;  vi. 缓慢地移动;  vt. 使缓慢地移动,使渐进; [acc] /ɪntʃ/;
sunlight: [x] n. 日光,阳光; [acc] /ˈsʌnlaɪt/;
conference: [x] n. 会议;讨论会; [acc] /ˈkɑːnfərəns/;
street: [x] n. 街,街道; [acc] /striːt/;
wake: [x] v. 醒来,使觉醒;激发,引起;  n. 守灵,守夜;(船航过时的)尾波;年度假期; [acc] /weɪk/;
health: [x] n. 健康,健康状况; [acc] /helθ/;
labor: [x] n. 劳动,劳力,劳工;  v. 劳动,苦干;  adj. 劳动的; [acc] /'leɪbər/;
gym: [x] n. 体育馆,健身房;体育; [acc] /dʒɪm/;
traditional: [x] adj. 传统的; [acc] /trəˈdɪʃənl/;
merry: [x] adj. 欢乐的,愉快的;<口>微醉的; [acc] /ˈmeri/;
shy: [x] adj. 怕羞的,害羞的;畏缩的;  v. (马)惊走,惊退;  n. 惊退; [acc] /ʃaɪ/;
handbag: [x] n. (女用)手提包; [acc] /ˈhændbæɡ/;
tired: [x] adj. 疲劳的;厌倦的,厌烦的; [acc] /ˈtaɪərd/;
cousin: [x] n. 堂(或表)兄弟(姐妹);远亲; [acc] /ˈkʌzn/;
useful: [x] adj. 有用的,有益的; [acc] /ˈjuːsfl/;
north: [x] adj. 北方的,北的;  adv. 向北方;  n. 北方,北; [acc] /nɔːrθ/;
enjoy: [x] v. 享受..的乐趣,欣赏,喜爱;自得其乐; [acc] /ɪnˈdʒɔɪ/;
invention: [x] n. 发明,发明物;虚构;发明才能; [acc] /ɪnˈvenʃn/;
certainly: [x] adv. 无疑,确定;当然,没问题(用于回答); [acc] /ˈsɜːrtnli/;
let: [x] v. 允许,让;使;  n. 出租;阻碍;(网球等)触网重发; [acc] /let/;
grape: [x] n. 葡萄;葡萄藤; [acc] /ɡreɪp/;
between: [x] prep. 在..中间;  adv. 在中间; [acc] /bɪˈtwiːn/;
November: [x] n. 十一月; [acc] /noʊˈvembər/;
lid: [x] n. 盖,盖子; [acc] /lɪd/;
chicken: [x] n. 鸡;鸡肉;胆小者;  vi. 畏缩不前;  adj. 胆小的; [acc] /ˈtʃɪkɪn/;
sense: [x] n. 感官,官能;感觉;判断力;见识;  v. 觉得,意识到; [acc] /sens/;
teach: [x] v. 讲授;教授; [acc] /tiːtʃ/;
childhood: [x] n. 童年,幼年; [acc] /ˈtʃaɪldhʊd/;
difficulty: [x] n. 困难;难事,难点;经济拮据;障碍;麻烦; [acc] /ˈdɪfɪkəlti/;
silent: [x] adj. 沉默的,寂静的;  n. 无声电影; [acc] /ˈsaɪlənt/;
agree: [x] v. 同意,赞成,承认,符合; [acc] /əˈɡriː/;
stone: [x] n. 石头,石料,英石; [acc] /stoʊn/;
machine: [x] n. 机器,机械;  v. 用机器加工; [acc] /məˈʃiːn/;
constant: [x] adj. 不变的,始终如一的;持续不断的;  n. 常数,恒量; [acc] /ˈkɑːnstənt/;
purpose: [x] n. 目的,意图;用途,效果;决心;  v. 企图;打算; [acc] /ˈpɜːrpəs/;
touch: [x] n. 接触,联系;触觉;  v. 触摸;联系;接触;  vt. 触动;感动; [acc] /tʌtʃ/;
shake: [x] n. 摇动,摇;颤抖,震动;  v. 摇动; [acc] /ʃeɪk/;
swim: [x] v. 游泳;漂浮;  vi. 浸泡;眩晕;  n. 游泳; [acc] /swɪm/;
mind: [x] n. 头脑,精神;智能;想法;心情;记忆;有才智的人;  v. 注意;记住;照料;介意; [acc] /maɪnd/;
lap: [x] n. 腰以下及大腿的前面部分;(跑道的)一圈;  v. (赛跑中)比(某人)领先一圈;轻拍; [acc] /læp/;
hang: [x] v. 吊死,悬挂,悬浮;垂下;  n. 悬挂;绞刑; [acc] /hæŋ/;
airport: [x] n. 机场,航空站; [acc] /ˈerpɔːrt/;
basic: [x] adj. 含硅少的;基本的;基础的;初级的;  n. 根本;基础;[计]BASIC语言; [acc] /ˈbeɪsɪk/;
chapter: [x] n. 章,回,篇;时期; [acc] /ˈtʃæptər/;
decorate: [x] v. 装饰,布置;把(勋章)授给(某人); [acc] /ˈdekəreɪt/;
celebrate: [x] v. 庆祝;主持 (宗教仪式);赞美; [acc] /ˈselɪbreɪt/;
Brazil: [x] n. 巴西(拉丁美洲国家); [acc] /brəˈzɪl/;
hen: [x] n. 母鸡,雌禽; [acc] /hen/;
afford: [x] v. 买得起;抽得出时间;担负得起;提供;产生;赐予;  vi. 担负得起;买得起; [acc] /əˈfɔːrd/;
powder: [x] n. 粉;火药;  v. 抹粉; [acc] /ˈpaʊdər/;
load: [x] v. 使担负;装载;加载;填装;  vi. 装货;  n. 负载;负荷;工作量;装载量; [acc] /loʊd/;
meaning: [x] n. 意义,意思;意图;  adj. 意味深长的; [acc] /ˈmiːnɪŋ/;
trip: [x] n. 旅行,远足;  v. 绊倒,失足;轻快地走或跑; [acc] /trɪp/;
used: [x] adj. 用旧了的,旧的;习惯的,惯常的; [acc] /juːst/;
poet: [x] n. 诗人; [acc] /ˈpoʊət/;
rat: [x] n. 老鼠,耗子;  v. 揭发; [acc] /ræt/;
intention: [x] n. 意图,意向,目的,打算; [acc] /ɪnˈtenʃn/;
workplace: [x] n. 工作场所,车间; [acc] /ˈwɜːrkpleɪs/;
fetch: [x] v. 取来;接来;使发出;售得;带来;接住;  n. 拿来,取来;诡计;风浪区; [acc] /fetʃ/;
mark: [x] v. 打分数;  vt. 在..上作记号,标记出;  n. 分数;污点,痕迹;记号,符号,标志; [acc] /mɑːrk/;
freedom: [x] n. 自由;自主; [acc] /ˈfriːdəm/;
forget: [x] v. 忘记,遗忘; [acc] /fərˈɡet/;
familiar: [x] adj. 熟悉的;不拘礼节的;亲密的;随便的;  n. 密友;常客;高级官吏的家属; [acc] /fəˈmɪliər/;
steep: [x] v. 沉浸于..;  adj. 陡峭的;急剧的;过高的;  n. 陡坡; [acc] /stiːp/;
twelfth: [x] num. 第十二;第十二的;十二分之一的;  n. 第十二;十二日;第十二音; [acc] /twelfθ/;
shot: [x] n. 发射;炮弹,射击,枪声;射手;击球;少量烈酒;照片,影片,镜头;注射;  v. 射击;  adj. 用尽的;破旧的;杂色的,闪光的; [acc] /ʃɑːt/;
amaze: [x] v. 使惊奇,使惊诧; [acc] /əˈmeɪz/;
game: [x] n. 游戏,比赛;猎物;  adj. 甘愿尝试,有冒险精神;  v. 打赌,赌输赢; [acc] /ɡeɪm/;
fun: [x] n. 玩笑;娱乐,乐趣;  vi. 开玩笑,嬉戏;  adj. 有趣的,供娱乐用的; [acc] /fʌn/;
character: [x] n. 人物,角色;性格;(书写或印刷)符号,(汉)字;特点;人格,品性; [acc] /ˈkærəktər/;
everywhere: [x] adv. 到处,处处;  n. 每个地方; [acc] /ˈevriwer/;
harvest: [x] v. 收割;  n. 收获; [acc] /ˈhɑːrvɪst/;
straight: [x] adj. 直的;正直的;  adv. 直接地;不断地,一直地;立即;直地,笔直地;  n. 直线;直线部分; [acc] /streɪt/;
outdoors: [x] adv. 在户外,在野外;  n. 户外(活动),野外(活动);  adj. 在户外的; [acc] /ˌaʊtˈdɔːrz/;
lamp: [x] n. 灯,台灯; [acc] /læmp/;
October: [x] n. 十月; [acc] /ɑːkˈtoʊbər/;
author: [x] n. 作者;发起人;  v. 成为作家; [acc] /ˈɔːθər/;
sunrise: [x] n. 日出;朝霞;  adj. 新兴的; [acc] /ˈsʌnraɪz/;
agent: [x] n. 政府特工;代理商,代理人; [acc] /ˈeɪdʒənt/;
orange: [x] n. 柑,桔,橙子;橙色;  adj. 橙色的,橘色的,桔红色的; [acc] /ˈɔːrɪndʒ/;
cheer: [x] v. 鼓劲,使振作;欢呼;  n. 鼓励,振奋; [acc] /tʃɪr/;
fireplace: [x] n. 壁炉; [acc] /ˈfaɪərpleɪs/;
pottery: [x] n. 陶器;陶艺;陶艺厂; [acc] /ˈpɑːtəri/;
point: [x] n. 点,尖端;分数;要点;  v. 指向,指出;表明;加标点于; [acc] /pɔɪnt/;
plane: [x] n. 飞机,平面;  v. 刨平;  adj. 平的,飞机的; [acc] /pleɪn/;
advice: [x] n. (医生等的)意见,建议;劝告;忠告; [acc] /ədˈvaɪs/;
modem: [x] n. 调制解调器;  v. [计]通过调制解调器向.发送电子邮件;用调制解调器联通; [acc] /ˈmoʊdem/;
stay: [x] v. 停留,待在,暂住,坚持,止住,抑制,延缓,停(下);  n. 逗留,延缓;中止,支柱; [acc] /steɪ/;
Tuesday: [x] n. 星期二; [acc] /ˈtuːzdeɪ/;
port: [x] n. 舷窗;舱门;港口城市;葡萄酒;港,港口; [acc] /pɔːrt/;
welcome: [x] v. 欢迎;  n. 欢迎;  adj. 受欢迎的; [acc] /ˈwelkəm/;
sweet: [x] adj. 甜的,可爱的,美好的,芳香的;  n. 糖果,甜食;亲爱的(人),宝贝; [acc] /swiːt/;
melon: [x] n. (各种的)瓜; [acc] /ˈmelən/;
perfect: [x] adj. 完美的;极好的;精通的;  v. 使完美;  n. [语]完成时; [acc] /ˈpɜːrfɪkt/;
jazz: [x] n. 爵士乐; [acc] /dʒæz/;
male: [x] n. 男性,雄性;  adj. 男性的,雄性的; [acc] /meɪl/;
state: [x] n. 情况,情形,状态,状况;州;国家;  v. 说明,陈述;  adj. 国家的,州的;国务的,公务的;正式的; [acc] /steɪt/;
agreement: [x] n. 协议,协定;一致,相合; [acc] /əˈɡriːmənt/;
criminal: [x] n. 罪犯;  adj. 犯罪的,违法的,刑法的;可耻的; [acc] /ˈkrɪmɪnl/;
usually: [x] adv. 通常,平常; [acc] /ˈjuːʒuəli/;
seafood: [x] n. 海产食品,海味; [acc] /ˈsiːfuːd/;
star: [x] n. 星,恒星,明星,名角;  adj. 用星装饰的;  v. 主演; [acc] /stɑːr/;
arm: [x] n. 手臂;臂状物;武器;衣袖;海湾;  vt. 供给,提供,武装,装备;  vi. 准备(斗争),准备行动(against); [acc] /ɑːrm/;
drawer: [x] n. 抽屉; [acc] /drɔːr/;
parcel: [x] n. 包裹;一片,一块;  v. 打包; [acc] /ˈpɑːrsl/;
host: [x] n. 东道主,主持人;大量;  v. 主持,主办; [acc] /hoʊst/;
leather: [x] n. 皮革;皮制品;  vt. 用皮鞭抽打;用皮革覆盖; [acc] /ˈleðər/;
hopeless: [x] adj. 没有希望的,绝望的,不能胜任的,无望的; [acc] /ˈhoʊpləs/;
toe: [x] n. 脚趾;  v. 用脚尖走; [acc] /toʊ/;
allow: [x] v. 准许,允许;同意给;承认; [acc] /əˈlaʊ/;
sweater: [x] n. 毛衣,厚运动衫,羊毛衫; [acc] /ˈswetər/;
take: [x] v. 拿走;获得(财产),取得,得;采取,执行;修(课程);花费;搭乘;  n. 获得物; [acc] /teɪk/;
courage: [x] n. 勇气,胆量,胆识; [acc] /ˈkɜːrɪdʒ/;
headteacher: [x] n. (中小学的)校长; [acc] /ˌhedˈtiːtʃər/;
flour: [x] n. 面粉;粉状物质;  v. 撒上粉; [acc] /ˈflaʊər/;
owner: [x] n. 所有者,物主; [acc] /ˈoʊnər/;
cent: [x] n. 分;分币; [acc] /sent/;
successful: [x] adj. 成功的; [acc] /səkˈsesfl/;
pencil case: [x] n. 文具盒; [acc] /ˈpensl keɪs/;
elder: [x] n. 长辈;  adj. 年长的,资格老的; [acc] /ˈeldər/;
fisherman: [x] n. 渔民,渔夫,打渔人; [acc] /ˈfɪʃərmən/;
Hong Kong: [x] n. 香港; [acc] /hɒŋ kɒŋ/;
camel: [x] n. 骆驼,浮船箱,驼色; [acc] /ˈkæml/;
summer: [x] n. 夏季;  adj. 夏季的,在夏季的;  v. 避暑,过夏天; [acc] /ˈsʌmər/;
park: [x] n. 公园;(作为专用场地的)..区,..园;  v. 停放(汽车等); [acc] /pɑːrk/;
see: [x] v. 看;了解,领会;注意;经历;  n. 主教教区;主角权限; [acc] /siː/;
trap: [x] n. 陷阱;捕兽夹;圈套,诡计;双轮轻便马车;嘴;  v. 诱骗;困住; [acc] /træp/;
lovely: [x] adj. 可爱的;令人愉快的;  n. 美女,美人,佳人;漂亮的东西; [acc] /ˈlʌvli/;
join: [x] v. 参加;加入;结合;  n. 连接,结合,接合点; [acc] /dʒɔɪn/;
kid: [x] n. 小孩,儿童;年轻人;小山羊;  v. 开玩笑,欺骗;  adj. 年幼的;小山羊皮制的; [acc] /kɪd/;
small: [x] adj. 小的,少的;卑微的;感到惭愧的;  adv. 小地;小块地;小声地;  n. 狭小部分;(pl.)零星物品;(pl.)小件衣服;(人体的) 后腰; [acc] /smɔːl/;
cow: [x] n. 母牛,奶牛;母兽;  v. 恐吓,吓倒; [acc] /kaʊ/;
library: [x] n. 图书馆,藏书室;出租图书室;丛书;藏书;保存的资料; [acc] /ˈlaɪbreri/;
chair: [x] n. 椅子;主席(职位);大学教授;  v. 担任主席; [acc] /tʃer/;
salesman: [x] n. 售货员,推销员; [acc] /ˈseɪlzmən/;
oil: [x] n. 油,石油,油类;  v. 给(机器等)上油,涂油; [acc] /ɔɪl/;
pioneer: [x] n. 先驱,先锋,开拓者;  v. 开辟,首倡; [acc] /ˌpaɪəˈnɪr/;
political: [x] adj. 政治的,政治上的; [acc] /pəˈlɪtɪkl/;
permission: [x] n. 允许,同意; [acc] /pərˈmɪʃn/;
run: [x] v. 跑步,奔跑;组织,掌管,管理,运营(公司等);运转,运作;  n. 跑步,赛跑,跑的距离,跑的时间;(某产品一次性生产出的)数量;一连串,一系列; [acc] /rʌn/;
satisfactory: [x] adj. 令人满意的;良好的; [acc] /ˌsætɪsˈfæktəri/;
ceremony: [x] n. 典礼,仪式;礼节; [acc] /ˈserəmoʊni/;
field: [x] n. 田野,大片地方;运动场;领域;战场;全体参赛者;  v. 处理,应付;选派.上场;把.投入使用; [acc] /fiːld/;
inventor: [x] n. 发明家; [acc] /ɪnˈventər/;
course: [x] n. 发展;进程,课程,一道菜;  v. 跑过,穿过;追赶; [acc] /kɔːrs/;
pronunciation: [x] n. 发音,发音方法; [acc] /prəˌnʌnsiˈeɪʃn/;
instant: [x] n. 瞬间;  adj. 立即的;即食的;紧急的; [acc] /ˈɪnstənt/;
luck: [x] n. 运气,好运,幸运; [acc] /lʌk/;
celebration: [x] n. 庆典,庆祝; [acc] /ˌselɪˈbreɪʃn/;
edge: [x] n. (悬崖,峭壁的)边缘;边缘;锋利,尖锐;刀口,刃;优势;  v. 徐徐移动;给.开刃,使锐利; [acc] /edʒ/;
pink: [x] adj. 粉红色的;  n. 粉红色;  vi. 发出碰撞声; [acc] /pɪŋk/;
able: [x] adj. 能够..的;有能力的; [acc] /ˈeɪbl/;
kilometer: [x] n. 千米,公里; [acc] /kɪˈlɑːmɪtər/;
seagull: [x] n. 海鸥; [acc] /ˈsiːɡʌl/;
rush: [x] v. 冲,奔;赶忙做;匆忙;  n. 冲,急速行进;繁忙时期;仓促;(交通)繁忙时段; [acc] /rʌʃ/;
Sweden: [x] n. 瑞典; [acc] /ˈswiːdn/;
honest: [x] adj. 诚实的;正直的,坦率的; [acc] /ˈɑːnɪst/;
pocket: [x] n. 衣袋;钱;  adj. 袖珍的;  v. 把..装入口袋; [acc] /ˈpɑːkɪt/;
belong: [x] v. 属于,附属;归属; [acc] /bɪˈlɔːŋ/;
left: [x] adv. 在左边,往左边;  adj. 左边的;  n. 左边;左派,激进分子; [acc] /left/;
unusual: [x] adj. 不寻常的,不常见的;与众不同的; [acc] /ʌnˈjuːʒuəl/;
pan: [x] n. 平底锅;  v. 严厉批评;淘金; [acc] /pæn/;
create: [x] v. 创造;引起,产生; [acc] /kriˈeɪt/;
thing: [x] n. 东西,事物;事件,事态; [acc] /θɪŋ/;
explore: [x] v. 探险,探索,尝试; [acc] /ɪkˈsplɔːr/;
morning: [x] n. 早晨,上午; [acc] /ˈmɔːrnɪŋ/;
water: [x] n. 水;水域;雨水,海水;  vt. 给..浇水,给..供水; [acc] /ˈwɔːtər/;
tape: [x] n. 录音带,磁带;胶带,带子;  vt. 粘贴;录音; [acc] /teɪp/;
chairwoman: [x] n. 女主席,女会长,女议长; [acc] /ˈtʃerwʊmən/;
thank: [x] v. 感谢;  n. 谢意,感谢; [acc] /θæŋk/;
worker: [x] n. 工人; [acc] /ˈwɜːrkər/;
grass: [x] n. 草,草原,草地;<俚>大麻;  v. 放牧,种植草;告发; [acc] /ɡræs/;
justice: [x] n. 正义;公平;合理;妥当;应得的赏罚;审判;审判员; [acc] /ˈdʒʌstɪs/;
so-called: [x] adj. 所谓的,号称的; [acc] /ˌsoʊ ˈkɔːld/;
probably: [x] adv. 或许,大概; [acc] /ˈprɑːbəbli/;
fault: [x] n. 过失,过错;弱点,缺点;故障,缺陷;(地质学)断层;发球失误;  v. 责备,挑错; [acc] /fɔːlt/;
partner: [x] n. 伙伴,搭档;配偶,伴侣;合伙人;  v. 成为..的合伙人; [acc] /ˈpɑːrtnər/;
cheese: [x] n. 乳酪,干酪;  vt. 〈俚〉停止; [acc] /tʃiːz/;
fifth: [x] n. 五分之一;  num. 第五; [acc] /fɪfθ/;
artist: [x] n. 艺术家,画家; [acc] /ˈɑːrtɪst/;
lemonade: [x] n. 柠檬水; [acc] /ˌleməˈneɪd/;
lodge: [x] v. 住宿;存放,保管;  n. 小屋;兽穴; [acc] /lɑːdʒ/;
nature: [x] n. 大自然;性质;天性; [acc] /ˈneɪtʃər/;
brush: [x] vi. 刷牙;刷;掠过;  vt. 刷;涂;写,画;拭去;掠过;  n. 画笔;毛笔;刷子;刷状物;小冲突; [acc] /brʌʃ/;
headache: [x] n. 头痛;头痛的事; [acc] /ˈhedeɪk/;
forth: [x] adv. 向前;向外;离去;  prep. 出自,从.离开; [acc] /fɔːrθ/;
forward: [x] adv. 向前,前进;  adj. 向前的,前部的;进步的;冒失的;  v. 转交,转递;  n. 前锋; [acc] /ˈfɔːrwərd/;
truth: [x] n. 真理,真相;真实;真实性; [acc] /truːθ/;
swing: [x] v. 摇荡,来回摆动,转动,转向;使摇摆,使转动,使转向;  n. 秋千,摇摆,摆幅,转弯,打击,旋律; [acc] /swɪŋ/;
sausage: [x] n. 香肠; [acc] /ˈsɔːsɪdʒ/;
peace: [x] n. 和平;和睦;平静; [acc] /piːs/;
somebody: [x] pron. 某人;有人;大人物,重要人物; [acc] /ˈsʌmbədi/;
herself: [x] pron. 她自己;她本人; [acc] /hɜːrˈself/;
cool: [x] adj. 凉的,冷静的,极好的,绝妙的,"酷";  v. (使)冷却,(使)镇静;  n. 凉气,凉快的地方;凉爽,凉爽的空气; [acc] /kuːl/;
dollar: [x] n. 美元; [acc] /ˈdɑːlər/;
nothing: [x] pron. 没有东西,没有任何事;没有(别的)事情;无关紧要的事物(或人);极低的价格;没有什么;  adv. 毫不; [acc] /ˈnʌθɪŋ/;
farther: [x] adv. 更远地,再往前地;  adj. 更远的; [acc] /ˈfɑːrðər/;
cloudiness: [x] n. 阴沉;暗晦;朦胧; [acc] /ˈklaʊdinəs/;
after: [x] prep. 在.以后;  adv. 后来,以后;  conj. 在..之后,在..后面,模仿,与..一致,以..命名,后来的,后面的;  adj. 以后的;  n. 〈英俚〉正餐的最后一道食品(如点心,水果等); [acc] /ˈæftər/;
San Francisco: [x] n. 旧金山(美国城市); [acc] /sæn fræn'siskəu/;
Hawaii: [x] n. 夏威夷岛;夏威夷(美国州名); [acc] /hɑ:'waii:/;
march: [x] n. 行军,游行示威,三月;  vi. 行军,前进;游行示威;  vt. 使前进;使行军; [acc] /mɑːrtʃ/;
raise: [x] v. 养殖;养育;筹集(资金);举起;竖起,扶起;站直;提拔;唤起;和.取得联系;  n. 加薪;提高; [acc] /reɪz/;
round: [x] adj. 圆的,球形的;  n. 圆,圆形物;  adv. 围绕着,循环地;  v. 使成圆形;  prep. 围着,绕过,在周围; [acc] /raʊnd/;
blow: [x] v. 吹,吹动,吹气;吹响;打击,殴打;爆炸;  n. 打击,殴打; [acc] /bloʊ/;
thirteen: [x] num. 十三; [acc] /ˌθɜːrˈtiːn/;
discover: [x] v. 发现,找到;揭露; [acc] /dɪˈskʌvər/;
direct: [x] adj. 直达的;笔直的;直接的;率直的;  vt. 指导,引导;管理;引路,当向导;导演;  vi. 指导;导演;领唱;  adv. 直接地,径直地; [acc] /dəˈrekt/;
bamboo: [x] n. 竹,竹子; [acc] /ˌbæmˈbuː/;
hardly: [x] adv. 几乎不,简直不; [acc] /ˈhɑːrdli/;
robot: [x] n. 机器人;自动机; [acc] /ˈroʊbɑːt/;
someday: [x] adv. 有一天,有朝一日; [acc] /ˈsʌmˌdeɪ/;
whenever: [x] conj. 每当,无论何时;  adv. 不论何时;随便什么时候; [acc] /wenˈevər/;
population: [x] n. 人口,全体居民; [acc] /ˌpɑːpjuˈleɪʃn/;
pollute: [x] v. 弄脏,污染,沾污; [acc] /pəˈluːt/;
fail: [x] v. 失败,不及格;  n. 失败;失误; [acc] /feɪl/;
clerk: [x] n. 店员;职员;办事员;  vi. 当职员; [acc] /klɜːrk/;
pair: [x] n. 一对;  v. 成对,配对; [acc] /per/;
get-together: [x] n. 聚会; [acc] /ˈɡet təɡeðər/;
thousand: [x] num. 一千,一千个;  n. 许多,无数;  adj. 一千的;一千个的;成千的;许许多多的; [acc] /ˈθaʊznd/;
soil: [x] n. 泥土,土壤;土地,国土;  v. 弄脏;污损; [acc] /sɔɪl/;
recite: [x] vi. 背诵;朗诵;  vt. 背诵;朗诵;叙述;列举; [acc] /rɪˈsaɪt/;
hopeful: [x] adj. 有希望的;怀有希望的;给人以希望的;  n. 希望能成功的人; [acc] /ˈhoʊpfl/;
conversation: [x] n. 会话,谈话; [acc] /ˌkɑːnvərˈseɪʃn/;
anxious: [x] adj. (about)忧虑的,担心的,焦急的;渴望的; [acc] /ˈæŋkʃəs/;
dead: [x] adv. 完全地;  n. 死者,死人;  adj. 死的,无生命的; [acc] /ded/;
train: [x] n. 火车;行列;一系列;  v. 受教育;进行训练;训练,培养; [acc] /treɪn/;
mom: [x] n. 妈妈; [acc] /mɑːm/;
future: [x] n. 将来,未来;前途; [acc] /ˈfjuːtʃər/;
ox: [x] n. 牛,公牛; [acc] /ɑːks/;
space: [x] n. (两物或某物两部分之间的)空当,空隙,间隔,距离;(尤指有特定用途的)空地,余地,空间,空位,处所;空间,太空;(个人的)生活空间,个人自由(尤指在与别人的关系里);  v. 留间隔,隔开; [acc] /speɪs/;
China: [x] n. 中国;瓷器(china); [acc] /ˈtʃaɪnə/;
death: [x] n. 死,死亡;灭亡; [acc] /deθ/;
steam: [x] n. 蒸汽;轮船;  v. 蒸发,冒热气;蒸;快速行进; [acc] /stiːm/;
supply: [x] n. 供应(量);补给品,用品(supplies);  vt. 供应,提供,补充; [acc] /səˈplaɪ/;
sound: [x] v. 发声,听起来;听起来好像,让人听着好像;  n. 声音,声响;  adj. 健全的,完好的;正当的,有根据的;彻底的,充分的;  adv. 酣(睡),(睡得)沉; [acc] /saʊnd/;
real: [x] n. 实在的东西;  adj. 真实的;真的;  adv. 真正地; [acc] /ˈriːəl/;
say: [x] v. 说;  n. 发言权; [acc] /seɪ/;
different: [x] adj. 不同的,有差异的;各种的; [acc] /ˈdɪfrənt/;
splendid: [x] adj. 壮观的,辉煌的,华丽的;极好的,出色的; [acc] /ˈsplendɪd/;
spill: [x] v. 使溢出;使流出;撒;浇(花等);  n. 溢出,溅出;溢出量;摔下; [acc] /spɪl/;
eggplant: [x] n. 茄子,黑紫色; [acc] /ˈeɡplænt/;
brochure: [x] n. 手册,小册子; [acc] /broʊˈʃʊr/;
possibility: [x] n. 可能,可能性;可能的事,几率; [acc] /ˌpɑːsəˈbɪləti/;
excite: [x] v. 使激动,使兴奋;引起,激起; [acc] /ɪkˈsaɪt/;
text: [x] n. 正文,原文,课文,课本;  v. 发送短信; [acc] /tekst/;
competitor: [x] n. 竞争对手,参赛者; [acc] /kəmˈpetɪtər/;
art: [x] n. 艺术,艺术品,技艺; [acc] /ɑːrt/;
seventy: [x] num. 七十,七十个;七十的,七十个的;  n. 七十;从七十到七十九的数目,年数或温度; [acc] /ˈsevnti/;
midnight: [x] n. 午夜,半夜;午夜蓝; [acc] /ˈmɪdnaɪt/;
fall: [x] n. 秋天;  vi. 落下;跌倒;坠落;  adj. 秋天的;秋天成熟的;(衣服等)秋天用的; [acc] /fɔːl/;
stupid: [x] adj. 愚蠢的,麻木的,乏味的; [acc] /ˈstuːpɪd/;
wolf: [x] n. 狼;贪婪的人;  v. 狼吞虎咽地吃; [acc] /wʊlf/;
leak: [x] v. 漏;泄露;  n. 漏洞;泄漏,裂缝; [acc] /liːk/;
o'clock: [x] adv. .点钟; [acc] /əˈklɑːk/;
boy: [x] n. 男孩;少年;小家伙;  int. 表示惊奇,高兴,痛苦等; [acc] /bɔɪ/;
until: [x] prep. 到..为止,在..以前;  conj. 到..为止,在..以前,直到..才; [acc] /ənˈtɪl/;
town: [x] n. 城镇,市镇;闹市区;(市镇)居民;  adj. 城镇的; [acc] /taʊn/;
goat: [x] n. 山羊; [acc] /ɡoʊt/;
marry: [x] v. 娶,嫁,结婚; [acc] /ˈmæri/;
eighty: [x] num. 八十,八十个;  adj. 八十的;  n. 八十; [acc] /ˈeɪti/;
entry: [x] n. 入口处;登记;进入; [acc] /ˈentri/;
content: [x] n. 内容,目录;满足;  adj. 满足的;  v. 使满意; [acc] /ˈkɑːntent/;
silk: [x] n. 丝,丝绸; [acc] /sɪlk/;
apart: [x] adv. 相隔,相距; 分散地,分开地;  adj. 分隔的,拆开的,撇开的; [acc] /əˈpɑːrt/;
postcard: [x] n. 明信片; [acc] /ˈpoʊstkɑːrd/;
devotion: [x] n. 奉献,献身于...;热爱;投入;忠诚; [acc] /dɪˈvoʊʃn/;
tobacco: [x] n. 烟草,烟叶; [acc] /təˈbækoʊ/;
idiom: [x] n. 习语;成语;惯用语法; [acc] /ˈɪdiəm/;
less: [x] det. 更少的;  adv. 更少地; [acc] /les/;
kettle: [x] n. 茶壶; [acc] /ˈketl/;
stop: [x] v. 停止;塞住;阻止;逗留;  n. 停车站;停止,中止; [acc] /stɑːp/;
poor: [x] adj. 可怜的,贫穷的,贫乏的;  n. 穷人;贫困者; [acc] /pɔːr/;
policy: [x] n. 保险单;政策,方针;原则,策略; [acc] /ˈpɑːləsi/;
mail: [x] v. 邮寄;  n. 邮件; [acc] /meɪl/;
church: [x] n. 教堂; [acc] /tʃɜːrtʃ/;
normal: [x] adj. 正常的; [acc] /ˈnɔːrml/;
chocolate: [x] n. 巧克力;赭色;巧克力糖;巧克力饮料; [acc] /ˈtʃɑːklət/;
golf: [x] n. 高尔夫球运动; [acc] /ɡɑːlf/;
coral: [x] n. 珊瑚; [acc] /ˈkɔːrəl/;
set: [x] n. 一套,一副,一批,装置,趋势,布景;  adj. 固定的,规定的,坚决的;  v. 放置,使,树立,调整; [acc] /set/;
Arab: [x] n. 阿拉伯人;  adj. 阿拉伯的;阿拉伯语言的; [acc] /ˈærəb/;
eighteen: [x] num. 十八,十八个;十八; [acc] /ˌeɪˈtiːn/;
goal: [x] n. 目标;球门;(进球)得分; [acc] /ɡoʊl/;
shut: [x] v. 关上,闭上; [acc] /ʃʌt/;
cloth: [x] n. 布;衣料;桌布; [acc] /klɔːθ/;
conductor: [x] n. 售票员;指挥;导体; [acc] /kənˈdʌktər/;
pumpkin: [x] n. 南瓜,倭瓜; [acc] /ˈpʌmpkɪn/;
banana: [x] n. 香蕉;芭蕉属植物; [acc] /bəˈnænə/;
gun: [x] n. 枪,炮,手枪;  vt. 枪击,打开节流阀;  vi. 用枪打猎; [acc] /ɡʌn/;
download: [x] n. 下载,下载的文件;  v. 下载; [acc] /ˌdaʊnˈloʊd/;
drop: [x] v. 使落下;降低,落下;  prep. 顺道拜访(drop by);  n. 下降;滴剂;滴状物;下落物;随口说出;写;略去;放弃;输掉; [acc] /drɑːp/;
lead: [x] v. 带领;领导;导致;  n. 带领;引导;铅; [acc] /liːd/;
distant: [x] adj. 遥远的;远方的;疏远的; [acc] /ˈdɪstənt/;
eve: [x] n. (节日等的)前夜,前夕; [acc] /iːv/;
progress: [x] n. 进步;前进,进展;  v. 进步,发展; [acc] /ˈprɑːɡres/;
nest: [x] n. 巢;温床;  v. 筑巢;嵌入; [acc] /nest/;
cap: [x] n. 帽子;  v. 覆盖;给..定限额; [acc] /kæp/;
become: [x] v. 成为,开始变得,变成;适合,适宜;相称; [acc] /bɪˈkʌm/;
huge: [x] adj. 巨大的; [acc] /hjuːdʒ/;
heaven: [x] n. 天国;天堂;乐土;极乐世界; [acc] /ˈhevn/;
net: [x] n. 网,网状物;  adj. 纯利的,净值的,净的;  v. 用网捕;捕获;净赚;踢入球门; [acc] /net/;
fond: [x] adj. 喜欢的,喜爱的,溺爱的,精神错乱的;  v. 显出钟爱之情; [acc] /fɑːnd/;
baseball: [x] n. 棒球(运动);棒球; [acc] /ˈbeɪsbɔːl/;
essay: [x] n. 文章;论文;尝试;随笔;  v. 尝试; [acc] /ˈeseɪ/;
pea: [x] n. 豌豆; [acc] /piː/;
long: [x] adj. 长的,远的,长久的,长期的;  adv. 长久,长期地;  v. (for)渴望,极想; [acc] /lɔːŋ/;
steal: [x] v. 偷盗,行窃;悄悄地走;  n. 便宜货; [acc] /stiːl/;
telegram: [x] n. 电报; [acc] /ˈtelɪɡræm/;
miss: [x] v. 漏掉,没中;错过;想念;  n. 小姐; [acc] /mɪs/;
understand: [x] v. 理解,推断,熟悉; [acc] /ˌʌndərˈstænd/;
place: [x] n. 地方,地点;住所;  v. 放置; [acc] /pleɪs/;
check: [x] v. 检查;阻止;  n. 支票;阻止;检查;阻止物; [acc] /tʃek/;
chief: [x] n. 老板,头子;主管;(部落) 首领;酋长;长官;  adj. 主要的;首席的; [acc] /tʃiːf/;
study: [x] v. 学习;研究;  n. 学习;书房; [acc] /ˈstʌdi/;
nation: [x] n. 民族,国家;国民; [acc] /ˈneɪʃn/;
fridge: [x] n. 电冰箱; [acc] /frɪdʒ/;
penguin: [x] n. 企鹅; [acc] /ˈpeŋɡwɪn/;
nephew: [x] n. 侄子,外甥; [acc] /ˈnefjuː/;
face: [x] v. 面对,朝向,面临;  n. 表面;外表;脸,表情; [acc] /feɪs/;
jam: [x] n. 果酱;阻塞;  v. (使)阻塞,使塞满; [acc] /dʒæm/;
African: [x] adj. 非洲的,非洲人的;  n. 非洲人; [acc] /ˈæfrɪkən/;
down: [x] adv. 向下,在下面;  n. 绒毛,汗毛;  adj. 沮丧的,情绪低落的;  prep. 向下; [acc] /daʊn/;
attack: [x] n. (病)发作,攻击;  v. 攻击,进攻,抨击;毁坏; [acc] /əˈtæk/;
punish: [x] v. 惩罚,处罚; [acc] /ˈpʌnɪʃ/;
recorder: [x] n. 记录员;录音机; [acc] /rɪˈkɔːrdər/;
pretend: [x] v. 假装,装扮;  adj. 假装的,仿制的; [acc] /prɪˈtend/;
ear: [x] n. 耳朵;听力,听觉;穗; [acc] /ɪr/;
suffer: [x] v. 遭受,忍受,承受,受苦; [acc] /ˈsʌfər/;
short: [x] adj. 矮的,短的,短期的,短缺的,简略的,粗暴无礼的;  adv. 缺少,未达到,半中间(打断),过早地(终止);  n. 电影短片;少量烈酒;  vt. (比平时)快速完成;  v. 短路; [acc] /ʃɔːrt/;
kind: [x] n. 种类;  adj. 善良的,仁慈的,亲切的,和蔼的; [acc] /kaɪnd/;
contribution: [x] n. 贡献,投稿稿件,捐献物; [acc] /ˌkɑːntrɪˈbjuːʃn/;
nose: [x] n. 鼻子;前部;嗅觉;  v. 小心探索着前进;嗅; [acc] /noʊz/;
ball: [x] n. 球;舞会;  v. 使成球状; [acc] /bɔːl/;
valley: [x] n. 山谷,溪谷,低谷; [acc] /ˈvæli/;
diary: [x] n. 日记,日志;工作日程登记簿(或台历); [acc] /ˈdaɪəri/;
wind: [x] n. 风;呼吸;时势;  v. 蜿蜒曲折,缠绕,上发条; [acc] /wɪnd/;
behavior: [x] n. 行为;举止;态度; [acc] /bɪ'heɪvjə/;
beg: [x] v. 乞求,恳求;乞讨; [acc] /beɡ/;
through: [x] prep. 通过;  adv. 自始至终,彻底;  adj. 直达的,直通的; [acc] /θruː/;
giraffe: [x] n. 长颈鹿; [acc] /dʒəˈræf/;
wine: [x] n. 葡萄酒,果酒; [acc] /waɪn/;
lose: [x] vt. 失去;丧失;遗失;浪费;亏损;  vi. (在竞争或比赛中)输掉; [acc] /luːz/;
flu: [x] n. 流感; [acc] /fluː/;
steel: [x] n. 钢,钢铁,钢制品;  v. 使坚强;  adj. 钢的,与钢有关的; [acc] /stiːl/;
mile: [x] n. 英里; [acc] /maɪl/;
across: [x] prep. 越过,在..的那边;  adv. 横过,在对面; [acc] /əˈkrɔːs/;
notice: [x] n. 通知,告示;注意;  v. 注意,察觉; [acc] /ˈnoʊtɪs/;
mountain: [x] n. 山,山脉;大堆; [acc] /ˈmaʊntn/;
boring: [x] adj. 令人厌烦的;单调的;无聊的,乏味的; [acc] /ˈbɔːrɪŋ/;
drill: [x] n. 训练;反复操练;钻头;  v. 在..上钻孔;钻孔; [acc] /drɪl/;
photographer: [x] n. 摄影师; [acc] /fəˈtɑːɡrəfər/;
thankful: [x] adj. 感谢的,开心的; [acc] /ˈθæŋkfl/;
barn: [x] n. 谷仓,牲口棚;简陋的大房子; [acc] /bɑːrn/;
guilty: [x] adj. 内疚的;有罪的; [acc] /ˈɡɪlti/;
fairly: [x] adv. 相当地;公正地,公平地,正当地;清楚地;完全,简直; [acc] /ˈferli/;
motorcycle: [x] n. 摩托车;机动车;  vi. 骑摩托车; [acc] /ˈmoʊtərsaɪkl/;
tool: [x] n. 工具;爪牙,傀儡; [acc] /tuːl/;
apologize: [x] v. 道歉,认错; [acc] /əˈpɑːlədʒaɪz/;
sight: [x] n. 视力,看见,视线,景物;  v. 瞄准,看见,观测;  adj. 见票即付的;即席的; [acc] /saɪt/;
curtain: [x] n. 窗帘;幕(布);  v. 装帘子,遮掉; [acc] /ˈkɜːrtn/;
grade: [x] n. 等级,成绩;  v. 给(试卷或作业)评分;给..分等级; [acc] /ɡreɪd/;
screen: [x] n. 屏幕,荧光屏;纱窗;  v. 遮蔽;放映;检查; [acc] /skriːn/;
wheel: [x] n. 轮子,方向盘;轮转;  v. 旋转;推动; [acc] /wiːl/;
chick: [x] n. 小鸡;小鸟;[美俚]少妇;  adj. 胆小的;懦弱的; [acc] /tʃɪk/;
student: [x] n. 学生;学者; 大学生; [acc] /ˈstuːdnt/;
software: [x] n. 软件; [acc] /ˈsɔːftwer/;
speech: [x] n. 演说,讲话;言语,语言; [acc] /spiːtʃ/;
Olympic: [x] adj. 奥林匹克运动会的; [acc] /əˈlɪmpɪk/;
midday: [x] n. 中午,正午;  adj. 正午的; [acc] /ˌmɪdˈdeɪ/;
potato: [x] n. 马铃薯,土豆; [acc] /pəˈteɪtoʊ/;
sunshine: [x] n. 日光,日照; [acc] /ˈsʌnʃaɪn/;
lifetime: [x] n. 寿命,一生,终身;使用期,有效期限;  adj. 一生的,终生的; [acc] /ˈlaɪftaɪm/;
fare: [x] n. 交通费;票价;食物;出租车乘客;  v. (事情)进行得(好或坏); [acc] /fer/;
snowy: [x] adj. 下雪的;被雪覆盖的;洁白无瑕的; [acc] /ˈsnoʊi/;
improve: [x] v. 改进,改善,提高; [acc] /ɪmˈpruːv/;
judge: [x] v. 判决,审判,评价;  n. 裁判员;法官;鉴赏者; [acc] /dʒʌdʒ/;
hat: [x] n. 帽子(一般指有边的);  v. 给..戴上帽子,为..提供帽子;供应帽子;制造帽子; [acc] /hæt/;
invite: [x] v. 邀请;招待;招致; [acc] /ɪnˈvaɪt/;
servant: [x] n. 仆人; [acc] /ˈsɜːrvənt/;
generous: [x] adj. 慷慨的;充裕的,宽厚的;肥沃的; [acc] /ˈdʒenərəs/;
Indian: [x] n. 印度人;印第安人;印第安语;  adj. 印度的;印第安人的;印第安语的; [acc] /ˈɪndiən/;
jacket: [x] n. 短上衣,夹克衫;(书籍的)护封;唱片套;  v. 穿上夹克; [acc] /ˈdʒækɪt/;
comb: [x] v. 梳理;  n. 梳子;梳理; [acc] /koʊm/;
downstairs: [x] adv. 在楼下,往楼下;  adj. 楼下的;  n. 楼下; [acc] /ˌdaʊnˈsterz/;
divide: [x] v. 分开,划分;分配;除;产生分歧;分岔;分裂;  n. 差异;分水岭; [acc] /dɪˈvaɪd/;
treatment: [x] n. 对待;治疗,疗法; [acc] /ˈtriːtmənt/;
embarrass: [x] vt. 使窘迫,使尴尬(尤指在社交场合);困窘,困扰; [acc] /ɪmˈbærəs/;
although: [x] conj. 虽然,尽管; [acc] /ɔːlˈðoʊ/;
internet: [x] n. 互联网,英特网; [acc] /'ɪntərnet/;
top: [x] n. 顶部;尖端;上衣;上边,上面;  adj. 最高的;头等的;  v. 盖;达到顶端;结束;胜过; [acc] /tɑːp/;
beer: [x] n. 啤酒; [acc] /bɪr/;
theirs: [x] pron. 他们的(所有物),属于他们的(东西); [acc] /ðerz/;
visitor: [x] n. 访问者,来宾,游客; [acc] /ˈvɪzɪtər/;
pace: [x] n. 速度;步,步伐;  v. 踱步; [acc] /peɪs/;
district: [x] n. 地区;区域;  vt. 把..划分成区; [acc] /ˈdɪstrɪkt/;
visit: [x] n. 访问参观,游览;拜访;  vt. 参观,访问;拜访;看望,探望;  vi. 来访;访问,参观; [acc] /ˈvɪzɪt/;
aim: [x] v. 瞄准;以..为目标;  n. 目标;对准; [acc] /eɪm/;
honor: [x] n. 荣誉,荣幸;  v. 尊敬,使荣幸,对..表示敬意; [acc] /'ɑːnər/;
lucky: [x] adj. 幸运的;吉祥的,带来好运的; [acc] /ˈlʌki/;
France: [x] n. 法国; [acc] /fræns/;
ticket: [x] n. 票,入场券;  vt. 售票;给..门票;加标签于;指派;对..开交通违章通知单; [acc] /ˈtɪkɪt/;
task: [x] n. 作业;任务;  vt. 交给某人(任务);使过于劳累; [acc] /tæsk/;
other: [x] adj. 其他的,另外的;  n. 其他(人或物);  pron. 其他人(或事);  adv. 以其他方式; [acc] /ˈʌðər/;
farmer: [x] n. 农民,农夫;农场主; [acc] /ˈfɑːrmər/;
throw: [x] n. 投,掷;  v. 扔,抛,投掷; [acc] /θroʊ/;
separate: [x] adj. 独立的;分开的;单独的;  v. 使分开,分离,分割,划分; [acc] /ˈsepəreɪt/;
active: [x] adj. 积极的,主动的;活跃的,好动的;起作用的,有效的;现役的;  n. 积极分子;主动语态; [acc] /ˈæktɪv/;
housework: [x] n. 家务,劳动,家务事; [acc] /ˈhaʊswɜːrk/;
climb: [x] v. 攀登,爬,上升;  n. 爬,攀爬处; [acc] /klaɪm/;
dolphin: [x] n. 海豚; [acc] /ˈdɑːlfɪn/;
quiz: [x] n. 问答比赛,智力竞赛;小测验,小考;  v. 考查,盘问; [acc] /kwɪz/;
local: [x] adj. 当地的,本地的;(身体)局部的;  n. 当地人; [acc] /ˈloʊkl/;
milk: [x] n. 牛奶,乳状物;  v. 挤奶,抽取,套出(秘密等); [acc] /mɪlk/;
knowledge: [x] n. 知识,学识,知道,了解; [acc] /ˈnɑːlɪdʒ/;
geography: [x] n. 地理(学); [acc] /dʒiˈɑːɡrəfi/;
depth: [x] n. 纵深;深奥,奥妙;深度;深海;最深处; [acc] /depθ/;
Mexican: [x] adj. 墨西哥的;  n. 墨西哥人; [acc] /ˈmeksɪkən/;
difficult: [x] adj. 困难的,难做的;难解的;难对付的,不易相处的; [acc] /ˈdɪfɪkəlt/;
happiness: [x] n. 幸福,快乐; [acc] /ˈhæpinəs/;
American: [x] n. 美洲人;美国人,美国;  adj. 美洲的;美国的,美国人的; [acc] /əˈmerɪkən/;
aloud: [x] adv. 出声地,大声地; [acc] /əˈlaʊd/;
king: [x] n. 国王,君主; [acc] /kɪŋ/;
bit: [x] n. 少量,小片;比特; [acc] /bɪt/;
minibus: [x] n. 小型公共汽车,小型巴士; [acc] /ˈmɪnibʌs/;
comfort: [x] n. 舒适;安慰;  v. 安慰;使舒适; [acc] /ˈkʌmfərt/;
both: [x] pron. 两者(都);  conj. 既.且.;  det. 两个的;两者的;并;又;两者皆; [acc] /boʊθ/;
England: [x] n. 英格兰,英国; [acc] /ˈɪŋɡlənd/;
bless: [x] v. 保佑,祝福,赐福,有幸具有; [acc] /bles/;
quiet: [x] adj. 寂静的;安静的;(感情)克制的,稳重的,不张扬;  n. 安静,平静;  v. 使安静,平静; [acc] /ˈkwaɪət/;
riddle: [x] n. 谜,谜语;  v. 解谜,出谜题,满是弹孔; [acc] /ˈrɪdl/;
illegal: [x] adj. 不合法的,非法的;  n. 非法移民,非法劳工;间谍; [acc] /ɪˈliːɡl/;
word: [x] n. 字,词,话;  v. 用言词表达; [acc] /wɜːrd/;
runner: [x] n. 跑步者;信差;蔓藤植物; [acc] /ˈrʌnər/;
fat: [x] adj. 肥胖的;  n. 脂肪,油脂; [acc] /fæt/;
kind-hearted: [x] adj. 好心的; [acc] /ˌkaɪnd ˈhɑːrtɪd/;
support: [x] v. 支撑;支持;拥护;支援;资助;证实;  n. 支撑,支持;支撑者,支撑物; [acc] /səˈpɔːrt/;
essential: [x] adj. 必不可少的,必要的;本质的;重要的;基本的;  n. 要素;必需品; [acc] /ɪˈsenʃl/;
sweep: [x] v. 打扫;快速移动;  n. 清扫;一挥(手,胳膊等);范围,广度;绵延弯曲的地带; [acc] /swiːp/;
regards: [x] n. 问候,致意;  v. 认为;注意;(尤指以某种方式)注视;尊敬; [acc] /rɪˈɡɑːrdz/;
crop: [x] n. 作物,庄稼;(谷类等的)一熟收成;一批,大量;  v. 收获;啃吃;裁切;突然出现; [acc] /krɑːp/;
speaker: [x] n. 说话人,演讲人,扬声器; [acc] /ˈspiːkər/;
bottom: [x] n. 底部;尽头;末端;臀部;水底;  adj. 底部的;  v. 触底; [acc] /ˈbɑːtəm/;
display: [x] v. 展示;显示;陈列;  n. 表现,流露,展示;显示,显示器;陈列品; [acc] /dɪˈspleɪ/;
scissors: [x] n. 剪刀; [acc] /ˈsɪzərz/;
T-shirt: [x] n. T恤衫; [acc] /ˈtiː ʃɜːrt/;
mustache: [x] n. 髭,小胡子;触须; [acc] /ˈmʌstæʃ/;
circle: [x] n. 周期;范围;圆圈;  v. 围绕; [acc] /ˈsɜːrkl/;
spread: [x] v. 伸开,伸展,散布,传播,摊开,覆盖;  n. 伸开,伸展,散布,传播,摊开,范围;  adj. 广大的;大幅的;(宝石)薄而无光泽的; [acc] /spred/;
friendly: [x] adj. 友好的,友谊的;  adv. 友好地;朋友般地;  n. (足球等的)友谊赛; [acc] /ˈfrendli/;
fair: [x] adj. 公平的,合理的;相当的,尚好的;晴朗的;白皙的;金发的;  n. 集市,交易会;义卖会;  adv. 公平地;直接地;清楚地;正大光明地;  v. (卡通制作)顺利接合;(动作)衔接协调;(飞机)装配平整;使(飞机接合部)平滑;转晴; [acc] /fer/;
neither: [x] conj. 也不;既不;  adj. 两者都不的;  adv. 两个都不;既不..也不;  pron. 两者都不; [acc] /ˈnaɪðər, ˈniːðər/;
next: [x] adj. 下次的;贴近的;紧接的;  n. 下一个人(东西);  adv. 其次,然后,下次; [acc] /nekst/;
draw: [x] v. 画;拉;吸引;  n. 平局; [acc] /drɔː/;
spot: [x] n. 斑点;污点;地点,场所;排名位置;困境;滴;节目档;  v. 发现,认出;玷污; [acc] /spɑːt/;
manager: [x] n. 经理,管理人; [acc] /ˈmænɪdʒər/;
grow: [x] v. 生长,成长;增长;渐渐变得;种植; [acc] /ɡroʊ/;
before: [x] prep. 在..以前(时间);在..前面(空间);  adv. 以前;  conj. 在..之前(时间); [acc] /bɪˈfɔːr/;
primary: [x] adj. 初等教育的;初级的;基本的;首要的;主要的;  n. 首选;(美)初选; [acc] /ˈpraɪmeri/;
sing: [x] v. 唱;演唱;  n. 合唱会; [acc] /sɪŋ/;
voice: [x] n. 声音;意见;发言权;  v. 表达,吐露; [acc] /vɔɪs/;
ceiling: [x] n. 天花板;屋顶; [acc] /ˈsiːlɪŋ/;
cupboard: [x] n. 碗橱,衣柜,壁橱; [acc] /ˈkʌbərd/;
size: [x] n. 大小,尺寸,规模;尺码;  v. 估算,估量尺寸大小,估量,判断; [acc] /saɪz/;
easy: [x] adj. 舒适的,从容的;易受攻击的,易遭批评的;容易的,不费力的;友好的,好相处的;  adv. 小心地; [acc] /ˈiːzi/;
message: [x] n. 消息,信息,留言;启示;  v. 报信;通知; [acc] /ˈmesɪdʒ/;
scream: [x] vi. 发出歇斯底里的声音,尖叫;  vt. 尖叫着说出;  n. 尖叫声; [acc] /skriːm/;
overcoat: [x] n. 大衣,外套; [acc] /ˈoʊvərkoʊt/;
complain: [x] v. 抱怨;诉苦;申诉;控诉;诉说;控告;  vt. 申诉;  n. 抱怨,诉苦; [acc] /kəmˈpleɪn/;
risk: [x] n. 风险;危险;冒险;  v. 冒..的危险,使..冒风险; [acc] /rɪsk/;
nearby: [x] adj. 附近的;  adv. 在附近; [acc] /ˌnɪrˈbaɪ/;
necessary: [x] adj. 必要的,必需的;必然的,势必的;  n. 必需品; [acc] /ˈnesəseri/;
eighteenth: [x] n. (每月的)第十八日;第十八,十八分之一;  num. 第十八;十八分之一;  adj. 第十八的,第十八个的;十八分之一的; [acc] /ˌeɪˈtiːnθ/;
panda: [x] n. 熊猫; [acc] /ˈpændə/;
count: [x] v. 计算;认为;看作;重要,有价值;依赖;  n. 计数;总数;计算; [acc] /kaʊnt/;
large: [x] adj. 大量的;大的;  n. 自由(现仅用于at large,in the large);大号,大尺寸;  adv. 夸大地;  v. (尤指跳舞和饮酒)作乐; [acc] /lɑːrdʒ/;
side: [x] n. 边;面;一方,一面;  adj. 旁边的,侧面的,副的,枝节的;  v. 站在同一边; [acc] /saɪd/;
mutton: [x] n. 羊肉,羊; [acc] /ˈmʌtn/;
Easter: [x] n. 复活节; [acc] /ˈiːstər/;
furniture: [x] n. 家具;装置;设备; [acc] /ˈfɜːrnɪtʃər/;
leg: [x] n. 腿,腿部;  v. 逃逸,逃跑; [acc] /leɡ/;
happy: [x] adj. 快乐的;幸福的; [acc] /ˈhæpi/;
safety: [x] n. 安全,保险;安全设备,保险装置;安全场所;  adj. 保障安全的; [acc] /ˈseɪfti/;
flight: [x] n. 楼梯的一段;飞机的航程;航班;飞行;逃跑;  v. 使球在空中飞行; [acc] /flaɪt/;
weight: [x] n. 重力,重量,分量,砝码,重要(性),势力,负担,重累;  v. 加重量于,使变重; [acc] /weɪt/;
Wednesday: [x] n. 星期三; [acc] /ˈwenzdeɪ/;
disagreement: [x] n. 分歧,不和;不一致; [acc] /ˌdɪsəˈɡriːmənt/;
order: [x] v. 点(酒菜);订购;命令;安排,整理;  n. 顺序,条理,状况,规程;体制;治安,秩序;订单,订货;指令,命令;等级,阶层; [acc] /ˈɔːrdər/;
wonder: [x] v. 想知道;感到惊讶;  n. 奇迹,奇观;惊奇,惊异; [acc] /ˈwʌndər/;
pity: [x] n. 憾事,怜悯;  v. (觉得)可怜,惋惜; [acc] /ˈpɪti/;
hamburger: [x] n. 汉堡包;煎牛肉饼; [acc] /ˈhæmbɜːrɡər/;
minus: [x] prep. 减(去);  adj. 负的;  n. 减号;劣势; [acc] /ˈmaɪnəs/;
misty: [x] adj. 模糊的;有雾的;  n. [女名]女子名; [acc] /ˈmɪsti/;
Arabic: [x] adj. 阿拉伯的;  n. 阿拉伯语; [acc] /ˈærəbɪk/;
fourteen: [x] num. 十四; [acc] /ˌfɔːrˈtiːn/;
sand: [x] n. 沙,沙子,沙堆;  v. 用砂纸打磨; [acc] /sænd/;
wild: [x] adj. 野性的;野生的;狂热的;荒芜的;疯狂的; [acc] /waɪld/;
station: [x] n. 车站;站,台;身份,地位;  v. 安置,驻扎; [acc] /ˈsteɪʃn/;
ours: [x] pron. 我们的;我们的家; [acc] /ɑːrz/;
suggestion: [x] n. 建议,意见;细微的迹象;暗示;联想; [acc] /səˈdʒestʃən/;
neighborhood: [x] n. 社区,临近地区; [acc] /ˈneɪbərhʊd/;
wet: [x] adj. 湿的,多雨的;  v. 把.弄湿,使潮湿;  n. 湿地;液体;窝囊废;雨天; [acc] /wet/;
discovery: [x] n. 发现;被发现的事物; [acc] /dɪˈskʌvəri/;
congratulate: [x] v. 祝贺,向..致贺词; [acc] /kənˈɡrætʃuleɪt/;
hydrogen: [x] n. 氢,氢气; [acc] /ˈhaɪdrədʒən/;
group: [x] n. 群,组;  vi. 聚集; [acc] /ɡruːp/;
niece: [x] n. 侄女,外甥女; [acc] /niːs/;
role: [x] n. 角色;作用; [acc] /roʊl/;
ready: [x] adj. 准备好的;现成的;迅速的;愿意的;需要的;即将..的,可能..的;  v. 预备,准备;  n. 现款;准备好的状态;  adv. 已完成地,已就绪地; [acc] /ˈredi/;
autumn: [x] n. 秋天; [acc] /ˈɔːtəm/;
problem: [x] n. 问题;疑难问题,题目;成问题的,难对付的; [acc] /ˈprɑːbləm/;
exciting: [x] adj. 令人兴奋的;使人激动的; [acc] /ɪkˈsaɪtɪŋ/;
pardon: [x] v. 原谅,宽恕;  n. 原谅,饶恕,赦免;  excl. 对不起;请再说一遍; [acc] /ˈpɑːrdn/;
search: [x] v. 搜索;搜寻;探查;  n. 搜索;搜寻;探求; [acc] /sɜːrtʃ/;
treasure: [x] n. 金银财宝;财富;珍宝;不可多得的人才;  v. 珍藏;储藏;珍视; [acc] /ˈtreʒər/;
cause: [x] v. 引起,使发生;  n. 原因,理由;事业;目标; [acc] /kɔːz/;
scenery: [x] n. 风景;布景; [acc] /ˈsiːnəri/;
quarrel: [x] v. 争吵,争论;  n. 争吵,口角; [acc] /ˈkwɔːrəl/;
effort: [x] n. 努力;成就; [acc] /ˈefərt/;
limit: [x] n. 界限,限度,范围;  v. 限制,限定; [acc] /ˈlɪmɪt/;
eight: [x] num. 八;八个;  n. 八个;八点; [acc] /eɪt/;
condition: [x] n. 状况,状态;疾病,症状;环境,形势,条件;  v. 使适应,使处于良好状态; [acc] /kənˈdɪʃn/;
dust: [x] n. 尘土,灰尘;  vi. 掸尘;涂上粉末;  vt. 掸掉,擦去;使成粉末;  v. 擦去.的灰尘; [acc] /dʌst/;
profit: [x] n. 利润,盈利;益处;  v. 得益,有益于; [acc] /ˈprɑːfɪt/;
drink: [x] v. 饮,喝;  n. 饮料; [acc] /drɪŋk/;
iceberg: [x] n. 冰山; [acc] /ˈaɪsbɜːrɡ/;
hospital: [x] n. 医院; [acc] /ˈhɑːspɪtl/;
carpet: [x] n. 地毯;  v. 铺以地毯; [acc] /ˈkɑːrpɪt/;
deaf: [x] adj. 聋的;不愿听的;  n. 聋子;耳聋的人; [acc] /def/;
break: [x] n. 中断;破裂处;休息;  vt. 打破,弄破;(使)破,裂,碎;中断;违犯;背弃;把...换成零钱;找开;  vi. 破晓;(风暴)开始; [acc] /breɪk/;
colorful: [x] adj. 多彩的,华美的,色彩的,有趣的; [acc] /ˈkʌlərfl/;
noon: [x] n. 正午,中午;  v. 〈美〉午时休息; [acc] /nuːn/;
false: [x] adj. 错误的;假的;虚伪的; [acc] /fɔːls/;
during: [x] prep. 在.期间,在.过程中; [acc] /ˈdʊrɪŋ/;
spit: [x] v. 吐(唾沫);  n. 唾液,唾沫,叉子; [acc] /spɪt/;
add: [x] v. (to)加,增加;补充说,又说;  n. 加法,加法运算,(一篇报道的)补充部分; [acc] /æd/;
dress: [x] v. 打扮,穿着;给..穿衣;  n. 连衣裙;服装; [acc] /dres/;
training: [x] n. 训练,培养;培训; [acc] /ˈtreɪnɪŋ/;
green: [x] adj. 绿色的,青的,草绿色的;缺乏经验的;嫉妒的,眼红的;(赞成)环境保护的;生的,未熟的;  n. 绿色;草地,草坪,公共绿地;绿色蔬菜,绿叶蔬菜;  v. 使成为绿色,成为绿色,变绿;使..恢复活力; [acc] /ɡriːn/;
fact: [x] n. 事实,真相,实际; [acc] /fækt/;
bathroom: [x] n. 浴室;盥洗室; [acc] /ˈbæθruːm/;
master: [x] n. 主人;大师;硕士;  adj. 精通的,主要的;  v. 掌握,精通; [acc] /ˈmæstər/;
blood: [x] n. 血(液);血统,宗族,门第;  v. 抽血; [acc] /blʌd/;
scientist: [x] n. 科学家; [acc] /ˈsaɪəntɪst/;
patience: [x] n. 耐心,忍耐;毅力; [acc] /ˈpeɪʃns/;
noise: [x] n. 喧闹声,噪声,吵嚷声; [acc] /nɔɪz/;
clone: [x] n. 克隆;无性繁殖系个体;复制品;  v. 复制;克隆; [acc] /kloʊn/;
desk: [x] n. 书桌,办公桌;工作台;服务台;  adj. 书桌上用的;书桌的;  v. 派某人做办公室工作; [acc] /desk/;
act: [x] v. 行动,举止,假装,表演,扮演,充当,有效果;  n. 行为,行动,法案,(戏剧,歌剧等的)一幕;假装,装出,装作; [acc] /ækt/;
soap: [x] n. 肥皂;  v. 用肥皂擦洗; [acc] /soʊp/;
few: [x] adj. 很少的,几乎没有的;少数的;  pron. 很少;有些(人,事物,地方);少数人;不和.一般多;很少数;  det. 几个; [acc] /fjuː/;
shine: [x] v. 照耀,发光;擦亮;  n. 光泽,光; [acc] /ʃaɪn/;
weak: [x] adj. 虚弱的;软弱的;差的,衰弱的;淡薄的,无力的; [acc] /wiːk/;
literary: [x] adj. 文学的,文学上的;精通文学的;以写作为职业的;书本上的;书面的;书面语的; [acc] /ˈlɪtəreri/;
listen: [x] v. 听,倾听;听从,听信;  n. 听,倾听; [acc] /ˈlɪsn/;
Europe: [x] n. 欧洲; [acc] /ˈjʊrəp/;
yard: [x] n. 院,场地,码; [acc] /jɑːrd/;
again: [x] adv. 又,再次,此外,再一次; [acc] /əˈɡen/;
island: [x] n. 岛,岛屿; [acc] /ˈaɪlənd/;
writing: [x] n. 写作;著作;书面形式; [acc] /ˈraɪtɪŋ/;
hit: [x] v. 打击;命中;完成(指标);偶然遇见;突然想到;  n. 击打;碰撞;得分;风行一时的作品;引人注意的东西,技巧; [acc] /hɪt/;
copy: [x] v. 抄写,复制,复印;  n. 副本,拷贝; [acc] /ˈkɑːpi/;
house: [x] n. 房屋,住宅;商号;议会;机构;  v. 覆盖;给.房子住; [acc] /haʊs/;
buy: [x] v. 买;收买;  n. 所购的物品; [acc] /baɪ/;
millionaire: [x] n. 百万富翁,大富翁; [acc] /ˌmɪljəˈner/;
robber: [x] n. 强盗,盗贼; [acc] /ˈrɑːbər/;
gatekeeper: [x] n. 看门人;守门人;中介人;把守; [acc] /ˈɡeɪtkiːpər/;
teapot: [x] n. 茶壶; [acc] /ˈtiːpɑːt/;
porridge: [x] n. 粥,麦片粥; [acc] /ˈpɔːrɪdʒ/;
line: [x] n. 线,排,路线;  v. 画线;排队; [acc] /laɪn/;
enjoyable: [x] adj. 令人愉快的,可享受的; [acc] /ɪnˈdʒɔɪəbl/;
cough: [x] v. 咳嗽;  n. 咳嗽; [acc] /kɔːf/;
pattern: [x] n. 模型,模式;典型;图案;版式;样品;  vi. 形成图案;  vt. 用图案装饰; [acc] /ˈpætərn/;
ninety: [x] num. 九十; [acc] /ˈnaɪnti/;
onion: [x] n. 洋葱,洋葱头; [acc] /ˈʌnjən/;
fry: [x] v. 油煎;油炸;  n. 鱼苗,鱼秧;弗赖伊(姓氏);油炸食物;(口语)烦恼,愤激;  adj. 油炸的,油煎的(fried); [acc] /fraɪ/;
palace: [x] n. 宫殿,豪华住宅; [acc] /ˈpæləs/;
wheat: [x] n. 小麦; [acc] /wiːt/;
mainland: [x] n. 大陆;  adj. 大陆的; [acc] /ˈmeɪnlænd/;
old: [x] adj. 年纪大的,老的;..岁的;旧的,破旧的;  n. 老年人;旧时; [acc] /oʊld/;
monitor: [x] n. 显示器;监视器;班长;  v. 监视;监督;监测; [acc] /ˈmɑːnɪtər/;
storm: [x] n. 风暴;暴风雨,暴风雪;  vi. 起风暴;大发雷霆;横冲直撞;  vt. 使受到暴风雨的袭击;袭击; [acc] /stɔːrm/;
come: [x] v. 来,来到;(想法,主意或记忆等) 突然出现;源自,来自;  excl. 得啦;  prep. (提及的时间)到来; [acc] /kʌm/;
liberation: [x] n. 解脱,解放; [acc] /ˌlɪbəˈreɪʃn/;
please: [x] v. 使高兴,使满意,取悦;  excl. 请;得了吧,算了吧; [acc] /pliːz/;
like: [x] prep. 像;  v. 喜欢;  adj. 相似的;  n. 相类似的人[事物];爱好;  conj. 像.一样;如同,好像,仿佛;  adv. (非正式口语,代替 as)和.一样,如;(非正式口语,思考说下句话,解释或举例时用)大概;可能; [acc] /laɪk/;
railway: [x] n. 铁路,铁道;  vi. 乘火车旅行;在.铺设铁路; [acc] /ˈreɪlweɪ/;
shower: [x] n. 淋浴,淋浴器;阵雨;  v. 洗淋浴,淋湿; [acc] /ˈʃaʊər/;
black: [x] adj. 黑色的;黑暗的;  n. 黑人,黑色;  v. (使)变黑;把(眼睛)打得发青;拒绝; [acc] /blæk/;
lady: [x] n. 女士,夫人; [acc] /ˈleɪdi/;
whatever: [x] pron. 无论什么,不管什么,具体指到底,究竟;任何..的事物;  det. 无论什么样的;所有的,全部的;  adv. 任何,丝毫;不管什么,无论什么,任何..的事物; [acc] /wətˈevər/;
interrupt: [x] v. 打扰;打断,中断;插嘴;妨碍; [acc] /ˌɪntəˈrʌpt/;
Germany: [x] n. 德国; [acc] /ˈdʒɜːrməni/;
cleaner: [x] n. 清洁工;干洗店; [acc] /ˈkliːnər/;
theater: [x] n. 剧场,戏院,电影院;戏剧,戏剧事业;阶梯教室;战区,战场; [acc] /'θɪətə/;
reasonable: [x] adj. 适当的;合理的;通情达理的;(价格)公道的; [acc] /ˈriːznəbl/;
discussion: [x] n. 讨论,谈论;论述; [acc] /dɪˈskʌʃn/;
elephant: [x] n. 象; [acc] /ˈelɪfənt/;
restaurant: [x] n. 饭馆,餐馆; [acc] /ˈrestrɑːnt/;
literature: [x] n. 文学;宣传册;文献; [acc] /ˈlɪtrətʃər/;
basket: [x] n. 篮,篓,筐;  v. 把.装入篮内,把.丢入字纸篓里; [acc] /ˈbæskɪt/;
arrow: [x] n. 箭;箭头; [acc] /ˈæroʊ/;
box: [x] n. 盒子,箱子;  v. 拳击; [acc] /bɑːks/;
toothache: [x] n. 牙痛; [acc] /ˈtuːθeɪk/;
twelve: [x] num. 十二;十二个的;  n. 十二个;十二点钟; [acc] /twelv/;
dictionary: [x] n. 词典,字典; [acc] /ˈdɪkʃəneri/;
driver: [x] n. 驾驶员,司机;[机]传动器,驱动器,主动轮,[机]驱动程序; [acc] /ˈdraɪvər/;
kite: [x] n. 风筝;  vt. 涂改(支票),骗钱; [acc] /kaɪt/;
fire: [x] n. 火;火灾;  v. 开火;解雇; [acc] /ˈfaɪər/;
foreigner: [x] n. 外国人,外人; [acc] /ˈfɔːrənər/;
July: [x] n. 七月; [acc] /dʒuˈlaɪ/;
adventure: [x] n. 冒险,冒险活动;冒险精神; [acc] /ədˈventʃər/;
bitter: [x] adj. (有)苦(味)的;痛苦的;厉害的;严寒的;痛苦的,尖刻的,充满仇恨的;  v. 使变苦;  n. 苦;苦味物;苦啤酒;[航]系缆柱上的一圈缆索; [acc] /ˈbɪtər/;
disappear: [x] v. 消失,失踪;灭绝,消亡; [acc] /ˌdɪsəˈpɪr/;
along: [x] prep. 沿着;  adv. 向前地;一道地,一起; [acc] /əˈlɔːŋ/;
February: [x] n. 二月(略作Feb.); [acc] /ˈfebrueri/;
universe: [x] n. 宇宙,万物,世界,领域,范围; [acc] /ˈjuːnɪvɜːrs/;
companion: [x] n. 同伴,志同道合的人;参考书; [acc] /kəmˈpæniən/;
strange: [x] adj. 陌生的;奇怪的; [acc] /streɪndʒ/;
composition: [x] n. 构成;作文;(文章或音乐的)创作;成分; [acc] /ˌkɑːmpəˈzɪʃn/;
wherever: [x] conj. 无论在哪里;  adv. 无论在什么地方; [acc] /werˈevər/;
phrase: [x] n. 简短的警句;短语,习语;措辞,乐句;  v. 措辞,将(乐曲)分成乐句; [acc] /freɪz/;
cookie: [x] n. (英)甜面包;(美)小甜饼;饼干;[计]不经使用者的认可就由伺服器电脑直接写入使用者硬碟中的小型文字档案; [acc] /ˈkʊki/;
Africa: [x] n. 非洲; [acc] /ˈæfrɪkə/;
describe: [x] v. 描述;形容; [acc] /dɪˈskraɪb/;
write: [x] v. 书写,著述,写满;写信给;填写,记下; [acc] /raɪt/;
quite: [x] adv. 相当,十分; [acc] /kwaɪt/;
reach: [x] v. 伸手;够得着;到达;抵达;  n. 范围;影响力; [acc] /riːtʃ/;
mine: [x] n. 矿,矿山;地雷;  v. 开采,采矿;埋设地雷;  pron. 我的(所有物); [acc] /maɪn/;
laughter: [x] n. 笑,笑声; [acc] /ˈlæftər/;
proud: [x] adj. 骄傲的,引以自豪的;妄自尊大的;  adv. 使某人感到荣幸,给某人面子; [acc] /praʊd/;
generosity: [x] n. 慷慨,大方; [acc] /ˌdʒenəˈrɑːsəti/;
cinema: [x] n. 电影院;电影,影片; [acc] /ˈsɪnəmə/;
start: [x] v. 开始,着手;动身;吃惊;开办,开动;  n. 开端,起点,惊起,吃惊; [acc] /stɑːrt/;
free: [x] adj. 免费的;自由的,不受约束的;  v. 使自由,解放;  adv. 自由地;免费; [acc] /friː/;
remind: [x] v. 提醒,使想起; [acc] /rɪˈmaɪnd/;
bridge: [x] n. 桥,桥梁;起联系作用的东西,纽带;  v. 把..连结起来;缩短距离;架桥; [acc] /brɪdʒ/;
paragraph: [x] n. (文章的)段,节; [acc] /ˈpærəɡræf/;
girl: [x] n. 少女;女孩; [acc] /ɡɜːrl/;
die: [x] v. 消失,消亡;<口>渴望;死亡,死;  n. 钢型,硬模; [acc] /daɪ/;
nice: [x] adj. 美好的,令人愉快的; [acc] /naɪs/;
match: [x] n. 比赛;敌手;伙伴,搭档;婚姻,配偶;火柴;  v. 使相配,使对抗; [acc] /mætʃ/;
window: [x] n. 窗,窗口;一丝机会, 暂短的时机; [acc] /ˈwɪndoʊ/;
treat: [x] v. 对待;治疗;讨论;请客;  n. 请客; [acc] /triːt/;
surface: [x] v. 浮上水面;显露;  n. 表面,面,水面;外表,外观;  adj. 表面的;水面的;外观的;(对高架及地下铁路说的)平地上的; [acc] /ˈsɜːrfɪs/;
university: [x] n. 大学; [acc] /ˌjuːnɪˈvɜːrsəti/;
gold: [x] n. 黄金,金币;  adj. 金的;金制的; [acc] /ɡoʊld/;
score: [x] n. 得分;刻痕;二十;配乐;  vi. 刻痕;  v. 得分;  vt. 在.上刻痕; [acc] /skɔːr/;
weather: [x] n. 天气,气候,处境;  v. 风化,受风蚀,经受风雨;平安地渡过(难关); [acc] /ˈweðər/;
swimming: [x] n. 游泳;目眩;  adj. 游泳的;游泳用的;善于游泳的;晕眩的;  v. 游泳;漂浮;旋转; [acc] /ˈswɪmɪŋ/;
whether: [x] conj. 两者中的哪一个;是否; [acc] /ˈweðər/;
tiny: [x] adj. 很少的;微小的;矮小的;  n. 小孩子;[医]癣;[女名]女子名; [acc] /ˈtaɪni/;
first: [x] det. 第一;  adv. 最初;  n. 第一个;最初; [acc] /fɜːrst/;
send: [x] v. 送,寄;发送;  adj. [仅用作定语]用于发送的;  n. 波浪的推(进)力; [acc] /send/;
spend: [x] v. 花费,用钱;花(时间或精力);度过;  n. (为某目的或某段时间内的)花销,花费,开销; [acc] /spend/;
suggest: [x] v. 建议,提议;使人想起,暗示; [acc] /səˈdʒest/;
dog: [x] n. 狗,犬,犬科动物;  v. (灾难等)缠住;跟踪;尾随; [acc] /dɔːɡ/;
patient: [x] n. 病人,患者;  adj. 有耐心的,能忍耐的; [acc] /ˈpeɪʃnt/;
news: [x] n. 新闻,消息; [acc] /nuːz/;
hobby: [x] n. 业余爱好,癖好; [acc] /ˈhɑːbi/;
license: [x] n. 许可;执照;  v. 许可,准许;发许可证; [acc] /ˈlaɪsns/;
meeting: [x] n. 会议;会合,聚集; [acc] /ˈmiːtɪŋ/;
develop: [x] v. 生长,发育,发展,开发,显影; [acc] /dɪˈveləp/;
keep: [x] v. 保持,坚持,保留,继续,贮藏,经营,遵守,供给,照管;  n. 保持,保养;城堡主楼;生活,生计;饲料;牧草; [acc] /kiːp/;
mushroom: [x] n. 蘑菇;  vi. 迅速发展;采蘑菇; [acc] /ˈmʌʃrʊm/;
Oceania: [x] n. 大洋洲; [acc] /ˌoʊʃiˈɑːniə/;
sea: [x] n. 海洋,海域,许多; [acc] /siː/;
outer: [x] adj. 外部的,外面的,外层的;  n. 靶子环外的部分;环外命中; [acc] /ˈaʊtər/;
seventeen: [x] num. 十七;十七岁的,十七(个)的; [acc] /ˌsevnˈtiːn/;
eagle: [x] n. 鹰,老鹰;鹰状标志;(高尔夫球赛中)少击两棒入穴的成绩;  vt. (高尔夫球赛中)比标准杆数少击两杆入; [acc] /ˈiːɡl/;
continent: [x] n. 大陆,洲;  adj. 克制的,禁欲的; [acc] /ˈkɑːntɪnənt/;
need: [x] v. 需要,必需;  n. 需要,必要,缺乏; [acc] /niːd/;
diver: [x] n. 潜水员; [acc] /ˈdaɪvər/;
downtown: [x] adj. 商业区的,闹市区的;  adv. 在商业区,在市中心;  n. 市中心区,市中心; [acc] /ˈdaʊntaʊn/;
ninth: [x] num. 第九;  n. 九分之一; [acc] /naɪnθ/;
mention: [x] v. 提及,提名;  n. 谈到,提及; [acc] /ˈmenʃn/;
mirror: [x] n. 镜子;真实的写照,反映;  v. 反射,反映; [acc] /ˈmɪrər/;
flag: [x] v. (以旗子)标出,标记;疲乏,热情衰减;  n. 国旗,旗帜; [acc] /flæɡ/;
laugh: [x] v. 笑,发笑;  n. 笑; [acc] /læf/;
prefer: [x] v. 更喜欢,宁愿;提出; [acc] /prɪˈfɜːr/;
subway: [x] n. 地铁; [acc] /ˈsʌbweɪ/;
grandparent: [x] n. 祖父或祖母,祖父母; [acc] /ˈɡrænperənt/;
somewhere: [x] adv. 到某处,在某处;  n. 某处; [acc] /ˈsʌmwer/;
French: [x] n. 法国人;法语;  adj. 法国的;法国人的;法语的; [acc] /frentʃ/;
similar: [x] adj. 相似的;类似的;  n. 类似物;相像的人;相似物; [acc] /ˈsɪmələr/;
January: [x] n. 一月; [acc] /ˈdʒænjueri/;
fill: [x] v. 装满,盛满,加满;占满;填补,满足; [acc] /fɪl/;
head: [x] n. 头;上端;领导人;  v. 率领;前进;出发; [acc] /hed/;
waste: [x] n. 浪费;废物;  v. 浪费;消耗;未充分利用;  adj. 无用的;废弃的; [acc] /weɪst/;
action: [x] n. 行动,行为,动作,运转;  v. 对...进行处理; [acc] /ˈækʃn/;
total: [x] adj. 完全的;整个的,总体的;  n. 总数,总额; [acc] /ˈtoʊtl/;
video: [x] n. 视频,录像;录像带;  v. 制作..的录像; [acc] /ˈvɪdioʊ/;
yellow: [x] adj. 黄色的,胆小的;  n. 黄色;  v. (使某物)变黄或发黄; [acc] /ˈjeloʊ/;
broom: [x] n. 扫帚;金雀花; [acc] /bruːm/;
librarian: [x] n. 图书管理员,图书馆馆长; [acc] /laɪˈbreriən/;
keyboard: [x] n. 键盘;琴键;  v. 录入信息; [acc] /ˈkiːbɔːrd/;
quickly: [x] adv. 迅速地,快速地;很快地; [acc] /ˈkwɪkli/;
disagree: [x] v. 不同意,反对,(意见)有分歧;(有关同一事件或形势的陈述,数字或报道)不一致,不相符; [acc] /ˌdɪsəˈɡriː/;
cook: [x] n. 厨师;  v. 烹饪;  vi. 烹调,煮,烧; [acc] /kʊk/;
credit: [x] n. 信用;荣誉;学分;信贷;称赞;债权;  v. 信赖;归因于;记学分; [acc] /ˈkredɪt/;
recent: [x] adj. 最近的,近来的; [acc] /ˈriːsnt/;
custom: [x] n. 习惯;风俗;  adj. 定制的; [acc] /ˈkʌstəm/;
wait: [x] v. 等候,等,等待;耽搁,搁置;  n. 等待,等待时间; [acc] /weɪt/;
granny: [x] n. 祖母,奶奶,外婆;老奶奶;  adj. 奶奶的,老婆婆的; [acc] /ˈɡræni/;
kick: [x] v. 踢;踢腿;  n. 踢; [acc] /kɪk/;
nine: [x] num. 九;九个; [acc] /naɪn/;
market: [x] n. 市场;行情;销路;  v. 销售;出售; [acc] /ˈmɑːrkɪt/;
illness: [x] n. 病,疾病; [acc] /ˈɪlnəs/;
square: [x] n. 正方形;广场;  adj. 正方形的;平方的;直角的;  v. 把..弄成方形;  adv. 直接地; [acc] /skwer/;
compare: [x] v. 比较,比作;  n. 比较;对照; [acc] /kəmˈper/;
opinion: [x] n. 意见,看法,主张; [acc] /əˈpɪnjən/;
Egypt: [x] n. 埃及; [acc] /ˈiːdʒɪpt/;
hill: [x] n. 小山,山岗;斜坡; [acc] /hɪl/;
sink: [x] n. 水槽,洗碗池;  v. (使)下沉,(使)降低;淹没,下落;使沉没;  adj. 贫民窟的; [acc] /sɪŋk/;
apology: [x] n. 道歉,(表达)歉意; [acc] /əˈpɑːlədʒi/;
pride: [x] v. 使得意,以.自豪;  n. 自豪;骄傲; [acc] /praɪd/;
victim: [x] n. 牺牲品,受害者,替罪羊; [acc] /ˈvɪktɪm/;
right: [x] n. 正义;正确,权利;右边;  adj. 正当的;对的,正确的;合适的;健康的;完全的;  adv. 正当地;正确地;立即地;完全地,彻底地,在右边; [acc] /raɪt/;
homework: [x] n. 家庭作业,功课;(重要活动之前的)准备工作; [acc] /ˈhoʊmwɜːrk/;
common: [x] adj. 普通的;共同的;  n. 公地;平民;普通;公园; [acc] /ˈkɑːmən/;
thought: [x] n. 想法;思维,思考;思想,思潮;  v. 想,认为; [acc] /θɔːt/;
class: [x] n. 课,上课;种类,门类;阶级,社会等级,阶层,等级制度;班级,同届学生;等级,级别,舱位等级;  v. 把..分组,分组,分班;把..归入某等级; [acc] /klæs/;
while: [x] conj. 但是,然而;虽然;正值...之时 (表示一件事是在另一件事发生过程中的某个时间发生的);在..的时候,和..同时;  n. 一会儿,一段时间;  prep. 〈古〉直至(某时); [acc] /waɪl/;
clear: [x] adj. 清澈的;显然的;容易看见的,清楚的,清晰的;没有的;  vi. 变明朗;变清澈;  vt. 扫净;清除;消除;  n. 空隙;空间;  adv. 清晰地;整整;完全; [acc] /klɪr/;
film: [x] n. 电影;胶卷;薄层;  v. 拍摄; [acc] /fɪlm/;
federal: [x] adj. 联邦制的;联邦政府的; [acc] /ˈfedərəl/;
upstairs: [x] n. 楼上;  adj. 楼上的;  adv. 在楼上;往高处; [acc] /ˌʌpˈsterz/;
breathe: [x] vi. 呼吸;  vt. 呼吸; [acc] /briːð/;
pipe: [x] n. 管子,导管;烟斗;笛;  v. 安静下来(pipe down);用管子输送;用管乐器演奏; [acc] /paɪp/;
possible: [x] adj. 可能的;  n. 可能性,潜在性,可能的人物,可能有的事,最高分; [acc] /ˈpɑːsəbl/;
employ: [x] v. 雇用;雇佣;使忙于;使用;用于.;  n. 受雇;职业;使用; [acc] /ɪmˈplɔɪ/;
aunt: [x] n. 小姨,姑妈,伯母,舅妈;阿姨; [acc] /ænt/;
grandma: [x] n. 奶奶,外婆; [acc] /ˈɡrænmɑː/;
tower: [x] n. 塔,楼塔;  v. 高耸;胜过; [acc] /ˈtaʊər/;
jeep: [x] n. 吉普车; [acc] /dʒiːp/;
kingdom: [x] n. 王国,领域; [acc] /ˈkɪŋdəm/;
demand: [x] n. 要求(坚决的),需求;  v. 强烈要求,需要; [acc] /dɪˈmænd/;
Japanese: [x] adj. 日本的,日本人的,日语的;  n. 日本人,日语; [acc] /ˌdʒæpəˈniːz/;
ask: [x] v. 询问;要求;邀请;  n. 要求,开价; [acc] /æsk/;
worst: [x] n. 最坏的事;  adj. 最坏的,最差的;  v. 打击,胜过;  adv. 最坏地; [acc] /wɜːrst/;
twenty: [x] num. 二十;二十个;  adj. 二十的; [acc] /ˈtwenti/;
salad: [x] n. 色拉,沙拉;凉拌菜; [acc] /ˈsæləd/;
accident: [x] n. 事故;意外;偶然; [acc] /ˈæksɪdənt/;
horse: [x] n. 马;马科动物; [acc] /hɔːrs/;
president: [x] n. 总统;院长; [acc] /ˈprezɪdənt/;
area: [x] n. 范围,面积,区域,空地; [acc] /ˈeriə/;
god: [x] n. 神; [acc] /ɡɑːd/;
friendship: [x] n. 友谊,友好; [acc] /ˈfrendʃɪp/;
sheep: [x] n. 羊,绵羊,羞答答的人,胆小鬼,信徒; [acc] /ʃiːp/;
unfair: [x] adj. 不公正的,不公平的; [acc] /ˌʌnˈfer/;
hunt: [x] n. 打猎;搜寻;  v. 打猎;搜索;猎杀,追捕; [acc] /hʌnt/;
identity: [x] n. 身份;特性;一致; [acc] /aɪˈdentəti/;
home: [x] n. 家,家庭;  adj. 家的;主场的;本国的;  adv. 在家,到家;到正确的位置;  v. 回家,有家,朝向,自动导航; [acc] /hoʊm/;
people: [x] n. 人,人民,民族;  v. 居住于; [acc] /ˈpiːpl/;
breakfast: [x] n. 早饭,早餐;  v. 吃早饭; [acc] /ˈbrekfəst/;
outside: [x] adv. 在户外,在外面,向外面;  n. 外部;外表;  adj. 外部的;  prep. 在..外面,不在..范围内; [acc] /ˌaʊtˈsaɪd/;
little: [x] adj. 幼小的,小的;少的;  adv. 甚少,毫不,难得;  det. 几乎没有; [acc] /ˈlɪtl/;
clap: [x] v. 拍(手),鼓(掌);轻拍,轻敲;砰然出声,啪地关上,发出噼啪声;  n. 轻拍(以示热情招呼),拍手(喝彩),鼓掌(欢迎),善意的拍打;霹雳声,破裂声,噼啪声,突然的爆炸声,砰然巨响; [acc] /klæp/;
powerful: [x] adj. 强有力的;有权威的;  adv. 很;非常; [acc] /ˈpaʊərfl/;
handkerchief: [x] n. 手帕;头巾;方巾; [acc] /ˈhæŋkərtʃɪf/;
Italian: [x] adj. 意大利的,意大利人的,意大利语的;  n. 意大利人,意大利语; [acc] /ɪˈtæliən/;
cigarette: [x] n. 香烟,纸烟,卷烟; [acc] /ˈsɪɡəret/;
enemy: [x] n. 敌人;敌国;敌军;危害物; [acc] /ˈenəmi/;
read: [x] v. 读,看懂;写着;  n. 阅读,读物;  adj. 博学的; [acc] /riːd/;
excited: [x] adj. (人)兴奋的;激动的;紧张的; [acc] /ɪkˈsaɪtɪd/;
dip: [x] v. 浸,蘸;  n. 倾斜,下降;调味汁; [acc] /dɪp/;
graduate: [x] v. 毕业;渐变;渐渐变为;取得资格;授予.学位;  n. 大学毕业生;学位获得者;  adj. 毕业的;研究生的; [acc] /ˈɡrædʒuət/;
litter: [x] n. 垃圾;杂乱;  v. 乱丢; [acc] /ˈlɪtər/;
snowman: [x] n. 雪人; [acc] /ˈsnoʊmæn/;
sorry: [x] adj. 遗憾的,对不起的,可怜的,抱歉的;  int. 对不起,抱歉; [acc] /ˈsɑːri/;
useless: [x] adj. 无用的,无价值的,无效的; [acc] /ˈjuːsləs/;
amazon: [x] n. 亚马逊(河);古希腊女战士; [acc] /ˈæməzən/;
secretary: [x] n. 秘书;干事,文书;部长,大臣; [acc] /ˈsekrəteri/;
explain: [x] v. 解释;说明; [acc] /ɪkˈspleɪn/;
strong: [x] adj. 强壮的,坚固的;强烈的;强大的;强硬的; [acc] /strɔːŋ/;
grandfather: [x] n. 祖父,外祖父;祖先; [acc] /ˈɡrænfɑːðər/;
remain: [x] v. 剩余;逗留;保持不变;依然,继续;  n. 剩余物;遗迹;残骸; [acc] /rɪˈmeɪn/;
competition: [x] n. 比赛;竞争;竞争者; [acc] /ˌkɑːmpəˈtɪʃn/;
environment: [x] n. 环境;外界;工作平台; [acc] /ɪnˈvaɪrənmənt/;
southwest: [x] n. 西南;  adj. 西南方的;  adv. 在西南方,来自西南; [acc] /ˌsaʊθˈwest/;
foot: [x] n. 脚;最下部;英尺;  vi. 步行;  vt. 步行;走在..之上; [acc] /fʊt/;
rent: [x] n. 租金;  v. 租用,出租; [acc] /rent/;
connect: [x] v. 连接;联想;使有联系; [acc] /kəˈnekt/;
following: [x] adj. 接着的;下列的;  n. 下列事物;一批追随者;  prep. 随后,在.以后; [acc] /ˈfɑːloʊɪŋ/;
classmate: [x] n. 同班同学; [acc] /ˈklæsmeɪt/;
ground: [x] n. 地面,土壤,场地,原因;  adj. 磨细的;剁碎的; [acc] /ɡraʊnd/;
rule: [x] v. 统治,控制;支配;裁决;  n. 规定,规章,条例;习惯;统治,管辖; [acc] /ruːl/;
dessert: [x] n. 甜点; [acc] /dɪˈzɜːrt/;
away: [x] adv. 离开,远离;..掉;  adj. 不在的;遥远的;[棒]出局的;客场的; [acc] /əˈweɪ/;
juice: [x] n. 液,(水果等)汁;  v. 榨汁; [acc] /dʒuːs/;
pianist: [x] n. 钢琴家,钢琴演奏家; [acc] /ˈpiːənɪst/;
lightning: [x] n. 闪电;意外的好运;  vi. 闪电;  adj. 闪电的;闪电般的,迅速的; [acc] /ˈlaɪtnɪŋ/;
drive: [x] v. 驾车;驱使;  n. 驾车旅行;驾车路程;强烈欲望;动力,干劲;驱动器; [acc] /draɪv/;
address: [x] n. 地址;致词;  v. 致函;写姓名地址;向..讲话;处理; [acc] /əˈdres/;
pool: [x] n. 水塘,集中起来的一批人;  v. 挖掘,集中资源(或材料); [acc] /puːl/;
freeze: [x] v. 冻结;使冻僵;  n. 严寒,冻结; [acc] /friːz/;
correction: [x] n. 改正,修正;更正; [acc] /kəˈrekʃn/;
contain: [x] vt. 包含,容纳;  vi. 自制,抑制,克制; [acc] /kənˈteɪn/;
exam: [x] n. 考试;检查,细查; [acc] /ɪɡˈzæm/;
parking: [x] n. 停车; [acc] /ˈpɑːrkɪŋ/;
model: [x] n. 模型;模特;  v. 模仿;当模特;(用黏土,木头等)做..的造型,塑造;当模特展示服装;  adj. 模范的;典型的; [acc] /ˈmɑːdl/;
disk: [x] n. 圆盘,唱片;磁盘; [acc] /dɪsk/;
biscuit: [x] n. 饼干;软饼;褐色; [acc] /ˈbɪskɪt/;
package: [x] n. 包裹;一揽子,一整套; [acc] /ˈpækɪdʒ/;
lamb: [x] n. 小羊;羊羔肉; [acc] /læm/;
average: [x] n. 平均数,平均水平;  adj. 通常的,一般的;平均的;  v. 平均为; [acc] /ˈævərɪdʒ/;
sir: [x] n. 先生;敬启者;爵士; [acc] /sɜːr/;
shorts: [x] n. 短裤;运动短裤; [acc] /ʃɔːrts/;
coach: [x] n. 四轮大马车;教练;长途汽车;  v. 训练,指导; [acc] /koʊtʃ/;
dare: [x] v. 敢,胆敢;  n. 激将;挑战,挑逗; [acc] /der/;
frustrate: [x] v. 使灰心;挫败;阻挠; [acc] /ˈfrʌstreɪt/;
father: [x] n. 父亲;神父;创始人;  v. 发明,创立; [acc] /ˈfɑːðər/;
surfing: [x] n. 冲浪运动;网上冲浪; [acc] /ˈsɜːrfɪŋ/;
pay: [x] v. 支付,偿还;获利,受益;  n. 工资,薪金; [acc] /peɪ/;
strawberry: [x] n. 草莓; [acc] /ˈstrɔːberi/;
trust: [x] v. 信任;盼望,希望;委托;  n. 信任;委托; [acc] /trʌst/;
smile: [x] v. 微笑;  n. 微笑; [acc] /smaɪl/;
environmental: [x] adj. 周围的;环境的; [acc] /ɪnˌvaɪrənˈmentl/;
cheek: [x] n. 面颊,脸蛋;  vt. [口语]无礼地说; [acc] /tʃiːk/;
goods: [x] n. 货物,商品; [acc] /ɡʊdz/;
reason: [x] n. 原因,理由,理智,理性;  v. 理论,论证,推理,劝说; [acc] /ˈriːzn/;
captain: [x] n. 船长,机长;上校,上尉;队长;领袖;消防中队长;  vt. 做..的首领; [acc] /ˈkæptɪn/;
showery: [x] adj. 阵雨的;多阵雨的; [acc] /ˈʃaʊəri/;
bed: [x] n. 床,床位;圃;河床;  vt. 把..固定在;(某人)发生性关系;给人铺床;  vi. 上床;分层; [acc] /bed/;
repair: [x] v. 修理;补救;纠正;  n. 修理,修补; [acc] /rɪˈper/;
guy: [x] n. 男人;家伙; [acc] /ɡaɪ/;
victory: [x] n. 胜利;成功; [acc] /ˈvɪktəri/;
flat: [x] adj. 平坦的;浅的;平面的;单调的;  n. 平面;公寓;  adv. 平直地; [acc] /flæt/;
ancient: [x] adj. 远古的,古代的,古老的;  n. 古代人;古文明国的国民; [acc] /ˈeɪnʃənt/;
feed: [x] v. 喂(养),吃饲料;  n. 饲料,一餐,饲养; [acc] /fiːd/;
late: [x] adj. 已故的;去世不久的;最近的;迟的;晚期的,后期的;  adv. 迟,晚; [acc] /leɪt/;
avoid: [x] v. 躲开,避开;避免,防止; [acc] /əˈvɔɪd/;
follow: [x] vi. 跟随;接踵而至;  v. 追随;跟随;理解;力求上进,追赶;跟随,追随;追踪;继承;随后做;采用;遵循;沿着..走;能理解;追求; [acc] /ˈfɑːloʊ/;
final: [x] adj. 最后的;决定性的;  n. 决赛;期末考试;当日报纸的末版; [acc] /ˈfaɪnl/;
smoking: [x] n. 抽烟,冒烟; [acc] /ˈsmoʊkɪŋ/;
correct: [x] adj. 正确的;恰当的,合适的;  v. 改正,纠正;矫正;批改; [acc] /kəˈrekt/;
postage: [x] n. 邮费,邮资; [acc] /ˈpoʊstɪdʒ/;
description: [x] n. 描写,形容,叙述;种类,类型; [acc] /dɪˈskrɪpʃn/;
everyday: [x] adj. 日常的,每天的; [acc] /ˈevrideɪ/;
schoolbag: [x] n. 书包; [acc] /'skuːlbæg/;
toothpaste: [x] n. 牙膏; [acc] /ˈtuːθpeɪst/;
encourage: [x] v. 鼓励,支持;促使;怂恿; [acc] /ɪnˈkɜːrɪdʒ/;
newspaper: [x] n. 报纸,报;旧报纸; [acc] /ˈnuːzpeɪpər/;
relative: [x] n. 亲戚,家人,亲属;相关物,关系词,同类事物;  adj. 相对的;有关系的,(语)关系的; [acc] /ˈrelətɪv/;
yet: [x] adv. 尚,还,仍然;  conj. 然而,但是; [acc] /jet/;
indeed: [x] adv. 的确,真正地,事实上; [acc] /ɪnˈdiːd/;
dangerous: [x] adj. 有危险的,不安全的,引起危险的; [acc] /ˈdeɪndʒərəs/;
nowadays: [x] adv. 现今,现在;  n. 当今,现代; [acc] /ˈnaʊədeɪz/;
relationship: [x] n. 关系,关联; [acc] /rɪˈleɪʃnʃɪp/;
escape: [x] v. 逃跑,避开,避免;泄露;  n. 逃跑,逃脱; [acc] /ɪˈskeɪp/;
stand: [x] n. 讲台;货摊;看台;  vi. 站立;起立;  vt. 使站立;维持原状;位于; [acc] /stænd/;
capital: [x] n. 资金,资本;首都;大写(字母);  adj. 大写的;资本的;优秀的;处以死刑的;致命的; [acc] /ˈkæpɪtl/;
year: [x] n. 年,年龄,年岁; [acc] /jɪr/;
Asian: [x] adj. 亚洲人的;亚洲的;  n. 亚洲人; [acc] /ˈeɪʃn/;
probable: [x] adj. 可能的;大概的;  n. 很可能的事物;很有希望被选中的人; [acc] /ˈprɑːbəbl/;
thirsty: [x] adj. 口渴的,口干的;渴望的,渴求的; [acc] /ˈθɜːrsti/;
rich: [x] adj. 富有的;肥沃的;昂贵的; [acc] /rɪtʃ/;
mother: [x] n. 母亲,妈妈;  adj. 母亲的;母体的;  v. 生育;像母亲一样关爱; [acc] /ˈmʌðər/;
industry: [x] n. 工业,产业;勤劳;专题研究; [acc] /ˈɪndəstri/;
grasp: [x] v. 抓住;领会;理解;  n. 紧握;理解;把手; [acc] /ɡræsp/;
immediately: [x] adv. 立即,马上;直接地;靠近地;  conj. 一..(就); [acc] /ɪˈmiːdiətli/;
require: [x] v. 需要;(of)要求,命令; [acc] /rɪˈkwaɪər/;
quick: [x] adj. 迅速的,快捷的;  adv. 迅速地;  n. (指甲下的)活肉; [acc] /kwɪk/;
ton: [x] n. 吨;大量,许多; [acc] /tʌn/;
loud: [x] adj. 大声的,吵闹的,喧嚣的; [acc] /laʊd/;
snake: [x] n. 蛇;  v. 迂回前进; [acc] /sneɪk/;
completely: [x] adv. 完整地,彻底地; [acc] /kəmˈpliːtli/;
oneself: [x] pron. 亲自;自己; [acc] /wʌnˈself/;
reality: [x] n. 现实,实际;真实; [acc] /riˈæləti/;
bus: [x] n. 公共汽车;  v. 用公共汽车运送; [acc] /bʌs/;
neck: [x] vt. 与..亲嘴;使变细;  n. 颈,脖子;衣领;  vi. 搂脖子亲嘴; [acc] /nek/;
riverbed: [x] n. 河床; [acc] /ˈrɪvərˌbed/;
public: [x] adj. 公共的;公众的;公开的;公然的;  n. 公众,民众; [acc] /ˈpʌblɪk/;
hero: [x] n. 英雄;男主角;勇士; [acc] /ˈhɪroʊ/;
week: [x] n. 星期,周; [acc] /wiːk/;
platform: [x] n. 站台;平台;讲台;舞台;论坛; [acc] /ˈplætfɔːrm/;
thread: [x] n. 线;主线;  vt. 穿过;穿线于; [acc] /θred/;
hair: [x] n. 头发,毛发;毛; [acc] /her/;
gift: [x] n. 礼物,赠品;天赋;  v. 赋予,赠送; [acc] /ɡɪft/;
meal: [x] n. 膳食,一餐; [acc] /miːl/;
together: [x] adv. 一起;共同;合起来;集拢地;  adj. 新潮的;情绪稳定的,做事有效率的; [acc] /təˈɡeðər/;
dismiss: [x] v. 开除;解散;摒除,不再考虑; [acc] /dɪsˈmɪs/;
bird: [x] n. 鸟,禽;家伙;  v. 观察研究野鸟; [acc] /bɜːrd/;
outing: [x] n. 远足;短途旅游; [acc] /ˈaʊtɪŋ/;
get: [x] v. 得到,获得,赢得;成为,变成,变为,变得;生(病),得(病),感染上(病);购买,买到;理解,记住; [acc] /ɡet/;
cost: [x] n. 价格,成本;花费;  vi. 花费;需要付出高昂代价;  vt. 估算..的费用;使付出; [acc] /kɔːst/;
rabbit: [x] n. 兔子,(野)兔; [acc] /ˈræbɪt/;
joy: [x] n. 欢乐,喜悦,乐事; [acc] /dʒɔɪ/;
oral: [x] adj. 口腔的,口头的,口语的;  n. 口试; [acc] /ˈɔːrəl/;
insect: [x] n. 昆虫; [acc] /ˈɪnsekt/;
furthest: [x] adj. 最远的;最遥远的;  adv. 最远地;最大程度地; [acc] /ˈfɜːrðɪst/;
lip: [x] n. 嘴唇;唇状物;  v. 接吻;说话;拍打;  adj. 唇的;口头上的; [acc] /lɪp/;
nut: [x] n. 坚果;疯子,怪人; [acc] /nʌt/;
fur: [x] n. 毛皮,毛皮外套,人造毛; [acc] /fɜːr/;
chalk: [x] n. 粉笔,白垩;  vt. 用粉笔写;  adj. 用粉笔写的; [acc] /tʃɔːk/;
answer: [x] n. 答案,回答;反响,响应;  v. 回答说,答复说,符合; [acc] /ˈænsər/;
today: [x] n. 今天;现今;  adv. 现在;在今天; [acc] /təˈdeɪ/;
yourself: [x] pron. 你自己; [acc] /jɔːrˈself/;
cattle: [x] n. (总称)牛,牲口; [acc] /ˈkætl/;
shelf: [x] n. 架子,搁板; [acc] /ʃelf/;
ink: [x] n. 墨水,油墨; [acc] /ɪŋk/;
around: [x] prep. 在..周围,四处;  adv. 大约;周围,环绕;存在着; [acc] /əˈraʊnd/;
invent: [x] v. 发明;编造; [acc] /ɪnˈvent/;
electrical: [x] adj. 有关电的;电气科学的; [acc] /ɪˈlektrɪkl/;
four: [x] num. 四;  n. 四个;板球中得四分的一击; [acc] /fɔːr/;
wall: [x] n. 围墙;墙;  v. 堵塞;  vt. 用墙围住; [acc] /wɔːl/;
dentist: [x] n. 牙医; [acc] /ˈdentɪst/;
radio: [x] n. 无线电;收音机;  v. 用无线电通讯; [acc] /ˈreɪdioʊ/;
available: [x] adj. 可得到的,可利用的,有空的,有效的; [acc] /əˈveɪləbl/;
unlucky: [x] adj. 不幸的;不吉利的,不祥的; [acc] /ʌnˈlʌki/;
rise: [x] n. 上升,上涨,增加;  v. 上升,上涨,升起,起身,增长; [acc] /raɪz/;
important: [x] adj. 重要的,重大的,有地位的,有权力的; [acc] /ɪmˈpɔːrtnt/;
September: [x] n. 九月; [acc] /sepˈtembər/;
deep: [x] adj. 深的,深刻的,深切的;  adv. 深深地;  n. 深处;海; [acc] /diːp/;
wear: [x] v. 穿,穿着;磨损;带着(表情);  n. 穿着;穿戴物,衣物;磨损; [acc] /wer/;
claw: [x] n. 爪,钳;(某些节肢动物的),钳;  v. 抓,挖;  vi. 抓,挖; [acc] /klɔː/;
truck: [x] n. 卡车;载重汽车;  vt. 用卡车装运;  vi. 驾驶卡车;以物易物; [acc] /trʌk/;
rope: [x] n. 绳,索;一串;绞刑;  v. 用绳捆(或扎等); [acc] /roʊp/;
full: [x] n. 完全,全部;盛期;  adj. 满的,充满的;详尽的;饱的;完全的;最高度的;同父同母的;很受感动的;专心的;  adv. 直接地,径直地;完全地,充分地,到最大程度;整整,足(足); [acc] /fʊl/;
chemistry: [x] n. 化学; [acc] /ˈkemɪstri/;
central: [x] adj. 中心的;主要的; [acc] /ˈsentrəl/;
car: [x] n. 汽车,小汽车,轿车;车厢; [acc] /kɑːr/;
dry: [x] adj. 干的;  v. 弄干; [acc] /draɪ/;
southern: [x] adj. 南的,南方的;  n. 南方人,南部人; [acc] /ˈsʌðərn/;
three: [x] num. 三;三个; [acc] /θriː/;
know: [x] v. 知道;认识;通晓;  n. 知情; [acc] /noʊ/;
noisy: [x] adj. 嘈杂的;喧闹的; [acc] /ˈnɔɪzi/;
relief: [x] n. 安慰;解脱;减轻;浮雕;凸显,起伏;救济金;救济物资;换班人;接替人; [acc] /rɪˈliːf/;
feeling: [x] n. 情绪,感觉,知觉,气氛,鉴赏力;  v. 感觉; [acc] /ˈfiːlɪŋ/;
education: [x] n. 教育,培养;教育学; [acc] /ˌedʒuˈkeɪʃn/;
member: [x] n. 成员,一员;会员; [acc] /ˈmembər/;
distinction: [x] n. 差别,区分;优秀,卓越,杰出;特性,独特,不同凡响;优等评分,荣誉分数,殊荣; [acc] /dɪˈstɪŋkʃn/;
chain: [x] v. 束缚;用链条拴住;  n. 链;链条;项圈;连锁;一系列; [acc] /tʃeɪn/;
temperature: [x] n. 热度,发烧;温度,气温,体温;〔人们反应的〕激烈程度,气氛; [acc] /ˈtemprətʃər/;
glory: [x] vi. 因某事而喜悦,为某事而欣喜;  n. 光荣,荣誉; [acc] /ˈɡlɔːri/;
excuse: [x] n. 借口,辩解;  vt. 原谅;免除;  vi. 作为借口;请示宽恕;表示宽恕; [acc] /ɪkˈskjuːs/;
jewelry: [x] n. 珠宝; [acc] /ˈdʒuːəlri/;
matter: [x] v. 要紧;有关系;  n. 问题,事件,物质; [acc] /ˈmætər/;
fantastic: [x] adj. 极好的;极大的;不真实的;荒诞离奇的;不可思议的;  n. 〈古〉古怪的人; [acc] /fænˈtæstɪk/;
story: [x] n. 故事,小说;叙述,描述;新闻报道;谎言,假话;楼层; [acc] /ˈstɔːri/;
Greek: [x] n. 希腊人,希腊语;  adj. 希腊的,希腊人的,希腊语的; [acc] /ɡriːk/;
nail: [x] n. 指甲,爪;钉;  v. 将..钉牢,钉住; [acc] /neɪl/;
computer: [x] n. 计算机,电脑;计算者; [acc] /kəmˈpjuːtər/;
legal: [x] adj. 合法的,法定的;法律的; [acc] /ˈliːɡl/;
alien: [x] n. 外国人;外星人;  adj. 陌生的;外国的,外星(人)的;异己的,不相容的; [acc] /ˈeɪliən/;
grandpa: [x] n. 爷爷; [acc] /ˈɡrænpɑː/;
directory: [x] n. 人名地址录,(电话)号码簿;目录; [acc] /dəˈrektəri/;
ruler: [x] n. 尺,直尺;统治者,支配者; [acc] /ˈruːlər/;
front: [x] adj. 前面的,正面的;  n. 前部,前面,正面;  adv. 在前面,向前;  v. 面对,朝向,对付; [acc] /frʌnt/;
personal: [x] adj. 个人的,私人的;  n. 个人;人身攻击;[法]动产;[语]人称代名词; [acc] /ˈpɜːrsənl/;
western: [x] adj. 西的,西方的,来自西方的人,有西方特征的;  n. 西方人,西部片,西部小说; [acc] /ˈwestərn/;
novel: [x] n. 小说,长篇故事;  adj. 新奇的,新颖的,不同的; [acc] /ˈnɑːvl/;
daughter: [x] n. 女儿; [acc] /ˈdɔːtər/;
tomorrow: [x] n. 明天,未来;  adv. 在明天,在明日; [acc] /təˈmɔːroʊ/;
map: [x] v. 测绘,为..绘制地图;  n. 地图;路线图;天体图; [acc] /mæp/;
fountain: [x] n. 泉水,喷泉;源泉;人造喷泉装置; [acc] /ˈfaʊntn/;
holiday: [x] n. 假日,节日,假期,休假;  v. 度假,休假;  adj. 节日适用的;活泼的; [acc] /ˈhɑːlədeɪ/;
pump: [x] v. 抽水,抽取;用泵输送;向.灌注;盘问;  n. 打气筒;泵,抽水(机);胶底帆布鞋; [acc] /pʌmp/;
feel: [x] v. 有知觉;触,摸; [acc] /fiːl/;
close: [x] v. 关闭;  n. 结束,(私人)围地;  adj. 关闭着的,密闭的,严丝合缝的;严密的;亲密的,相似的;  adv. (时间/距离)接近地; [acc] /kloʊz/;
letter: [x] n. 信;证书;字母;  vt. 用字母标明;加标题; [acc] /ˈletər/;
building: [x] n. 建筑物,大楼;建筑; [acc] /ˈbɪldɪŋ/;
least: [x] adj. 最小的,最少的;  adv. 最少地,最小地;  n. 最小,最少量; [acc] /liːst/;
social: [x] adj. 社会的;交际的,社交的;  n. 联谊会,联欢会;社交聚会; [acc] /ˈsoʊʃl/;
process: [x] v. 加工;处理;  n. 过程,进程;工序,程序;传票; [acc] /ˈprɑːses/;
seem: [x] v. 似乎,好像; [acc] /siːm/;
reduce: [x] v. 减少,减小,降低,精简; [acc] /rɪˈduːs/;
enter: [x] v. 走进,参加,加入;  n. 输入,[计]回车; [acc] /ˈentər/;
woman: [x] n. 女人,妇女;女仆;  adj. 女人的,女性的,妇女的;  vt. 为..配备妇女,使成女人腔; [acc] /ˈwʊmən/;
accent: [x] n. 口音,腔调;重音;重音符号;  v. 重读; [acc] /ˈæksent/;
rest: [x] v. 休息,静止;  n. 剩余的部分;休息,静止; [acc] /rest/;
nursery: [x] n. 托儿所;保育室;苗圃; [acc] /ˈnɜːrsəri/;
band: [x] n. 乐队;帮伙;带;  v. 用带捆扎;联合; [acc] /bænd/;
passport: [x] n. 护照;途径,手段; [acc] /ˈpæspɔːrt/;
activity: [x] n. 活动;行动;活跃; [acc] /ækˈtɪvəti/;
roadside: [x] n. 路边,路旁;  adj. 路边的,路旁的; [acc] /ˈroʊdsaɪd/;
cage: [x] n. 笼;鸟笼;囚笼;  v. 关进(笼子); [acc] /keɪdʒ/;
document: [x] n. 文件,公文;(计算机的)文档;  v. 记录;证明; [acc] /ˈdɑːkjumənt/;
corner: [x] n. 角落;拐角;困境;  v. 将..逼入困境; [acc] /ˈkɔːrnər/;
bookshop: [x] n. 书店; [acc] /ˈbʊkʃɑːp/;
call: [x] v. 把.叫做;叫,喊;打电话给.;  n. 通话,打电话; [acc] /kɔːl/;
base: [x] n. 地基,基础;底座;[化]碱;  adj. 卑鄙的,无耻的;  vt. 以..作基础; [acc] /beɪs/;
polite: [x] adj. 有礼貌的,客气的,文雅的;高雅的,上流的; [acc] /pəˈlaɪt/;
shame: [x] n. 羞耻,羞愧;羞愧感;耻辱;  vt. 使感到羞耻;使蒙羞; [acc] /ʃeɪm/;
southeast: [x] n. 东南(方),东南部;  adv. 向东南;  adj. 东南方的,东南部的; [acc] /ˌsaʊθˈiːst/;
question: [x] n. 问题,疑问,发问;  v. 询问;怀疑;审问; [acc] /ˈkwestʃən/;
almost: [x] adv. 几乎,差不多;相近的; [acc] /ˈɔːlmoʊst/;
Turkey: [x] n. 土耳其; [acc] /ˈtɜːrki/;
five: [x] num. 五,五个;  adj. 五个的;  n. 五,五个; [acc] /faɪv/;
mend: [x] v. 修理,缝补;改正,改进;好转;治愈;  n. 痊愈;改进; [acc] /mend/;
ought: [x] v. 应该,应当,本该;应该(指道义上有责任);(表示可能性,希望) 该,可能会;(表示推测)预料会做(某事); [acc] /ɔːt/;
minute: [x] adj. 微小的;详细的;  n. 一分钟,瞬间;  v. 记录; [acc] /ˈmɪnɪt/;
young: [x] adj. 年轻的,年纪小的;没有经验的;尚早的;初期的;  n. (动物的)崽; [acc] /jʌŋ/;
joke: [x] v. 说笑话;  n. 笑话; [acc] /dʒoʊk/;
wealth: [x] n. 财富;财产;大量; [acc] /welθ/;
pour: [x] v. 注,倒,灌;下(雨);不断地大量投入,倾注;  n. 倾泻;倾盆大雨; [acc] /pɔːr/;
boyhood: [x] n. 童年,少年时代;男孩们; [acc] /ˈbɔɪhʊd/;
shark: [x] n. 鲨鱼;骗子; [acc] /ʃɑːrk/;
promise: [x] n. 诺言;有成功希望的预示;允诺的事;  vt. 保证,允诺;  vi. 有指望;允诺,保证; [acc] /ˈprɑːmɪs/;
red: [x] adj. 红色的;  n. 红色; [acc] /red/;
talk: [x] v. 讲话;谈论;  n. 谈话; [acc] /tɔːk/;
sour: [x] adj. 酸的;(人)尖酸刻薄的,不友好的;  v. (友谊,局势,态度等)变坏;使恶化; [acc] /ˈsaʊər/;
tractor: [x] n. 拖拉机,牵引车; [acc] /ˈtræktər/;
shepherd: [x] n. 牧羊人;  v. 带领; [acc] /ˈʃepərd/;
asleep: [x] adj. 睡着的,睡熟的; [acc] /əˈsliːp/;
fierce: [x] adj. 凶猛的;激烈的;猛烈的; [acc] /fɪrs/;
spell: [x] n. 符咒,魅力,一段时间,轮班;  v. 拼写,拼成,意味着,轮值,招致,迷住;  vi. 轮替,拼字; [acc] /spel/;
plan: [x] n. 平面图,计划;  v. 计划,打算; [acc] /plæn/;
quality: [x] n. 特性;品性;质量;  adj. 优质的; [acc] /ˈkwɑːləti/;
lifestyle: [x] n. 生活方式;  adj. 关于时尚生活的 (杂志,电视节目,产品等); [acc] /ˈlaɪfstaɪl/;
hard: [x] adj. 坚硬的,困难的,严厉的;  adv. 努力地,艰难地,费力地;猛烈地,重重地; [acc] /hɑːrd/;
mobile: [x] n. 风铃,悬挂饰物;手机,移动电话;  adj. 可移动的;行动方便的; [acc] /ˈmoʊbl/;
iron: [x] v. 烫(衣),熨;  n. 铁;熨斗;  adj. 铁的;刚强的;严酷的; [acc] /ˈaɪərn/;
myself: [x] pron. 我亲自;我自己; [acc] /maɪˈself/;
favor: [x] n. 偏爱,帮助,特权,赞成;  vt. 偏爱,支持,利于,长得像; [acc] /ˈfeɪvər/;
habit: [x] n. 习惯,习性,脾性; [acc] /ˈhæbɪt/;
cut: [x] v. 切,割,剪;减少;  n. 伤口;划口;(锋利物留下的)开口;缩减; [acc] /kʌt/;
sail: [x] n. 帆,航行;  v. 航行; [acc] /seɪl/;
worry: [x] v. (使)焦虑,(使)烦恼;  n. 烦恼,焦虑,担忧; [acc] /ˈwɜːri/;
desert: [x] n. 沙漠;  v. 离开; [acc] /ˈdezərt/;
already: [x] adv. 已经; [acc] /ɔːlˈredi/;
everybody: [x] pron. 每人,人人; [acc] /ˈevribɑːdi/;
control: [x] n. 控制;对照实验;控制装置;  vt. 控制,管理; [acc] /kənˈtroʊl/;
tiger: [x] n. 老虎; [acc] /ˈtaɪɡər/;
hike: [x] n. 远足,徒步旅行;(数量,价格等)增加,上升;  v. 作长途徒步旅行;使高涨,提高(价格); [acc] /haɪk/;
technology: [x] n. 科技;技术,工艺; [acc] /tekˈnɑːlədʒi/;
toy: [x] n. 玩具;  v. 不认真考虑,玩弄;  adj. 作为玩具的; [acc] /tɔɪ/;
forest: [x] n. 森林;  v. 植树于,使成为森林; [acc] /ˈfɔːrɪst/;
canoe: [x] n. 独木舟,轻舟;  v. 乘独木舟; [acc] /kəˈnuː/;
depend: [x] v. 依靠,相信,依赖; [acc] /dɪˈpend/;
suddenly: [x] adv. 突然地; [acc] /ˈsʌdənli/;
never: [x] adv. 永不,决不;不; [acc] /ˈnevər/;
alike: [x] adj. 相同的,相似的;相像的;  adv. 相像地,相似地;同样都; [acc] /əˈlaɪk/;
football: [x] n. [英]足球,[美]橄榄球;  v. 踢足球,打橄榄球; [acc] /ˈfʊtbɔːl/;
attract: [x] v. 吸引,引诱; [acc] /əˈtrækt/;
report: [x] n. 报告,汇报,报道;  v. 报告,汇报,报道; [acc] /rɪˈpɔːrt/;
disappointed: [x] adj. 失望的; [acc] /ˌdɪsəˈpɔɪntɪd/;
province: [x] n. 省;领域,部门; [acc] /ˈprɑːvɪns/;
equipment: [x] n. 设备;装备,装置; [acc] /ɪˈkwɪpmənt/;
speak: [x] v. 说话;说某种语言;发言,表述意见;说出;朗读; [acc] /spiːk/;
umbrella: [x] n. 伞,雨伞; [acc] /ʌmˈbrelə/;
bye: [x] excl. 再见;  n. 轮空; [acc] /baɪ/;
hearing: [x] n. 听觉;听距;听证会;申辩的机会;  v. 听到; [acc] /ˈhɪrɪŋ/;
embassy: [x] n. 大使馆;大使馆全体人员; [acc] /ˈembəsi/;
skate: [x] v. 溜冰,滑冰;掠过;  n. 冰鞋,滑冰; [acc] /skeɪt/;
third: [x] adj. 第三的;  num. 第三;  n. 三分之一; [acc] /θɜːrd/;
ocean: [x] n. 海洋; [acc] /ˈoʊʃn/;
beeper: [x] n. BP机;能发出哔哔声音的仪器;导弹遥控员; [acc] /ˈbiːpər/;
monument: [x] n. 纪念碑;遗迹,遗址; [acc] /ˈmɑːnjumənt/;
impress: [x] v. 使有印象,使铭记; [acc] /ɪmˈpres/;
force: [x] v. 强迫;推动;凭借武力前进;  n. 力量;武力;势力; [acc] /fɔːrs/;
family: [x] n. 族,科;家,家庭成员;氏族,家庭;  adj. 家庭的,家族的,适合于全家的; [acc] /ˈfæməli/;
cruel: [x] adj. 残忍的,残酷的;伤人的; [acc] /ˈkruːəl/;
tick: [x] n. 勾号,(钟表)滴答声,一刹那;  v. 用勾作为记号,发出滴答声; [acc] /tɪk/;
tasty: [x] adj. 好吃的;(尤指女子)迷人的,性感的; [acc] /ˈteɪsti/;
knock: [x] v. 敲击,重击;  n. 敲,敲门,打击; [acc] /nɑːk/;
play: [x] v. 玩,游戏;扮演,演奏;  n. 剧本;戏剧;游戏;玩耍; [acc] /pleɪ/;
sixteen: [x] num. 十六,十六个;十六岁的,十六年的;十六的;  n. 十六,十六个;十六岁;十六点钟;十六的记号; [acc] /ˌsɪksˈtiːn/;
cabbage: [x] n. 洋白菜,卷心菜; [acc] /ˈkæbɪdʒ/;
fit: [x] v. 适合;安装;  adj. 健康的;合适的;  n. 合身;发作;匹配,相配; [acc] /fɪt/;
cheat: [x] v. 欺骗,哄骗,蒙骗;作弊;  n. 欺骗,作弊;骗子,骗术; [acc] /tʃiːt/;
click: [x] v. 点击(鼠标);(使)发出咔哒声;情投意合;博得喝彩;  n. 咔哒声,点击; [acc] /klɪk/;
puzzle: [x] n. 拼图;谜;迷惑;难题;  v. 使迷惑; [acc] /ˈpʌzl/;
rub: [x] v. 抚摸;摩擦;擦破;  n. 蹭;障碍;磨损处; [acc] /rʌb/;
properly: [x] adv. 适当地;正确地;恰当地;得体地;完全; [acc] /ˈprɑːpərli/;
difference: [x] n. 差别;差额;分歧; [acc] /ˈdɪfrəns/;
use: [x] v. 使用,利用,对待;  n. 使用,运用;用法;使用权;; [acc] /juːz/;
dustbin: [x] n. 垃圾箱; [acc] /ˈdʌstbɪn/;
corn: [x] n. 玉米;谷物,谷粒;  v. 形成(颗粒状);腌;(用谷物)喂; [acc] /kɔːrn/;
printing: [x] n. 印刷;印刷术;打印; [acc] /ˈprɪntɪŋ/;
tall: [x] adj. 身材高的,高大的;用于询问某人/某物的高度; [acc] /tɔːl/;
international: [x] adj. 国际的,世界的;  n. 国际比赛,参加国际运动或体育比赛的选手,外国人; [acc] /ˌɪntərˈnæʃnəl/;
quantity: [x] n. 数量,数目;大量,许多; [acc] /ˈkwɑːntəti/;
sunny: [x] adj. 阳光充足的;乐观的,快乐的; [acc] /ˈsʌni/;
silver: [x] n. 银,银子;银器;银币;银牌;  adj. 银的;银色的;银婚的;  vt. 镀银于,使..成银色; [acc] /ˈsɪlvər/;
suit: [x] n. 服装;诉讼;套装;  v. 合适;适宜于;使穿上套服; [acc] /suːt/;
household: [x] n. 同住在一家的人;家务;家常普通的;  adj. 家庭的,家内的,一家的;家喻户晓的; [acc] /ˈhaʊshoʊld/;
broken: [x] adj. 坏掉的,破裂的,破碎(了)的; [acc] /ˈbroʊkən/;
permit: [x] vt. 允许,许可;  n. 执照;  v. 使可能; [acc] /pərˈmɪt/;
politics: [x] n. 政治,政治学;政纲,政见; [acc] /ˈpɑːlətɪks/;
money: [x] n. 货币;金钱,财富; [acc] /ˈmʌni/;
shellfish: [x] n. 贝;有壳的水生动物; [acc] /ˈʃelfɪʃ/;
advise: [x] v. 劝告,忠告;建议;通知; [acc] /ədˈvaɪz/;
defense: [x] n. 防御,防护; [acc] /dɪ'fens/;
friend: [x] n. 朋友,友人;支持者; [acc] /frend/;
itself: [x] pron. 它自己;自身,本身; [acc] /ɪtˈself/;
secret: [x] n. 秘密;  adj. 秘密的,机密的; [acc] /ˈsiːkrət/;
shopkeeper: [x] n. 店主; [acc] /ˈʃɑːpkiːpər/;
hunter: [x] n. 猎人;猎犬;搜寻者;猎户座; [acc] /ˈhʌntər/;
Macao: [x] n. 澳门; [acc] /məˈkaʊ/;
punishment: [x] n. 惩罚,处罚; [acc] /ˈpʌnɪʃmənt/;
hall: [x] n. 会堂,门厅,过道;学生宿舍,学生食堂; [acc] /hɔːl/;
insist: [x] v. 坚持;坚持要求;坚持认为; [acc] /ɪnˈsɪst/;
vegetable: [x] n. 蔬菜,植物;植物人;  adj. 蔬菜的,植物的; [acc] /ˈvedʒtəbl/;
save: [x] v. 救,救助;节省;  vt. 拯救;保留;节省;储蓄;  n. 救球,救援;  prep. 除...外; [acc] /seɪv/;
kindness: [x] n. 仁慈,亲切;好意;友好行为; [acc] /ˈkaɪndnəs/;
countryside: [x] n. 乡村,郊野; [acc] /ˈkʌntrisaɪd/;
beef: [x] n. 牛肉;  v. 抱怨; [acc] /biːf/;
seventh: [x] n. 第七;七分之一;  adj. 第七的;七分之一的;  adv. 居第七位地;  num. 第七;七分之一; [acc] /ˈsevnθ/;
camp: [x] v. 露营;  n. 野营;帐篷;阵营; [acc] /kæmp/;
deserve: [x] v. 值得,应得;应受; [acc] /dɪˈzɜːrv/;
another: [x] det. 另外的,又一,不同的;另一个,类似的一个,别的;  prep. 另一个,另一个人,同类的东西; [acc] /əˈnʌðər/;
part: [x] n. 部分;角色;零件;  adj. 部分的;  v. 分离;分配;断裂;分手;  adv. 部分地; [acc] /pɑːrt/;
sixty: [x] num. 六十,六十个;六十的;  n. 六十,六十个; [acc] /ˈsɪksti/;
rob: [x] v. 抢劫,盗取,非法剥夺; [acc] /rɑːb/;
zero: [x] num. 零;  n. 零,零度;  adj. 零的;无价值的;零视度的;  v. 把 ... 调零;瞄准;集中注意;迫近; [acc] /ˈzɪroʊ/;
chant: [x] v. 吟唱;诵扬;  n. 圣歌;赞美诗;旋律; [acc] /tʃænt/;
vet: [x] n. 兽医;  v. 作兽医;诊疗;审查; [acc] /vet/;
sugar: [x] n. 食糖;糖;[口语]心爱的人,心肝,宝贝;  vi. 糖化;  vt. 加糖于; [acc] /ˈʃʊɡər/;
animal: [x] n. 动物;  adj. 动物的,本能的; [acc] /ˈænɪml/;
country: [x] n. 国家;乡村; [acc] /ˈkʌntri/;
blind: [x] adj. 瞎的,盲目的;  v. 使失明;蒙蔽;  n. 盲点,百叶窗;  adv. 盲目地; [acc] /blaɪnd/;
heal: [x] v. 治愈,治疗;痊愈;恢复; [acc] /hiːl/;
everyone: [x] pron. 每个人,人人;  n. 每个人,人人; [acc] /ˈevriwʌn/;
bakery: [x] n. 面包房; [acc] /ˈbeɪkəri/;
adjustable: [x] adj. 可调整的; [acc] /əˈdʒʌstəbl/;
lazy: [x] adj. 懒惰的;懒散的;慢吞吞的; [acc] /ˈleɪzi/;
often: [x] adv. 经常,时常,屡次; [acc] /ˈɑːfn/;
feather: [x] n. 羽毛; [acc] /ˈfeðər/;
terrible: [x] adj. 极糟的;可怕的;极度的; [acc] /ˈterəbl/;
cancer: [x] n. 癌,癌症;迅速蔓延的恶劣的或危险的事物; [acc] /ˈkænsər/;
quarter: [x] v. 驻扎,扎营;把..四等分;  n. 四分之一;季度;一刻钟; [acc] /ˈkwɔːrtər/;
general: [x] adj. 普遍的,全面的,一般性的,大致的,笼统的,常规的,总的;  n. 将军,一般; [acc] /ˈdʒenrəl/;
drawing: [x] n. 绘图,图样; [acc] /ˈdrɔːɪŋ/;
degree: [x] n. 程度,等级;学位;度;阶层; [acc] /dɪˈɡriː/;
loudspeaker: [x] n. 喇叭,扬声器,扩音器; [acc] /ˌlaʊdˈspiːkər/;
sunglasses: [x] n. 太阳镜,墨镜;凸透镜; [acc] /ˈsʌnɡlæsɪz/;
ill: [x] adj. 生病的,有病的;坏的;恶意的,引起痛苦的;  adv. 恶劣地,勉强地;  n. 邪恶,不幸,祸害,坏话; [acc] /ɪl/;
advantage: [x] v. 使处于有利地位;有利于;有助于;  n. 优势,利益,有利条件; [acc] /ədˈvæntɪdʒ/;
determine: [x] v. 确定,决定; [acc] /dɪˈtɜːrmɪn/;
motherland: [x] n. 祖国; [acc] /ˈmʌðərlænd/;
alive: [x] adj. 活着的;活跃的,有生气的;存在的; [acc] /əˈlaɪv/;
highway: [x] n. 大路,高速公路;公路; [acc] /ˈhaɪweɪ/;
paint: [x] v. 描绘,绘画;粉饰,涂油漆,涂色于;  n. 颜料;油漆,涂料; [acc] /peɪnt/;
land: [x] n. 陆地,土地;国土,国家;  v. (使)登陆;(使)着陆; [acc] /lænd/;
object: [x] n. 物体;宾语;目标;  v. 提出..作为反对的理由;反对; [acc] /ˈɑːbdʒekt/;
carrot: [x] n. 胡萝卜; [acc] /ˈkærət/;
human: [x] n. 人;  adj. 人的,人类的; [acc] /ˈhjuːmən/;
recover: [x] v. 恢复;痊愈,恢复健康;收回;换回;重新获得;重新找到; [acc] /rɪˈkʌvər/;
wallet: [x] n. 皮夹,钱包; [acc] /ˈwɑːlɪt/;
warn: [x] v. 警告,告诫; [acc] /wɔːrn/;
boat: [x] n. 小船,艇;  vi. 乘船;  vt. 用船运输; [acc] /boʊt/;
open: [x] v. 打开;睁开;  adj. 营业的;打开的,公开的;  n. 户外,野外; [acc] /ˈoʊpən/;
yourselves: [x] pron. 你们自己;你们本人; [acc] /jə'selvz/;
stick: [x] v. 坚持;粘贴,刺,戳,扎;  n. 棍,棒,手杖; [acc] /stɪk/;
tap: [x] n. 塞子;水龙头;轻敲;  v. 轻叩,轻敲;监听,窃听 (电话);开发,发掘;利用; [acc] /tæp/;
chimney: [x] n. 烟囱; [acc] /ˈtʃɪmni/;
pleasant: [x] adj. 令人愉快的,舒适的;友好的,和蔼的,有礼貌的; [acc] /ˈpleznt/;
reward: [x] n. 奖品,报酬,回报;悬赏;  v. 报答,酬谢; [acc] /rɪˈwɔːrd/;
journalist: [x] n. 记者,新闻工作者; [acc] /ˈdʒɜːrnəlɪst/;
textbook: [x] n. 教科书; [acc] /ˈtekstbʊk/;
Canada: [x] n. 加拿大; [acc] /'kænədə/;
unite: [x] v. 团结,联合,统一,合并; [acc] /juˈnaɪt/;
focus: [x] n. 焦点,聚焦;焦距;关注;  v. 使聚焦,集中注意力; [acc] /ˈfoʊkəs/;
robbery: [x] n. 抢掠,抢夺; [acc] /ˈrɑːbəri/;
surf: [x] n. 海浪,拍岸浪;  vi. 作冲浪运动;  vt. 在激浪上驾(船),在..冲浪; [acc] /sɜːrf/;
junior: [x] adj. 年少的;下级的;低年级的;  n. 年少者,晚辈;(美国四年制大学)三年级学生;职位较低者; [acc] /ˈdʒuːniər/;
pop: [x] v. 发出(砰的响声),突然出现,爆开,开枪;  n. 砰的一声爆破声;流行音乐;汽水;  adj. 流行的,大众的; [acc] /pɑːp/;
ice: [x] n. 冰,冰块;  v. 冰镇; [acc] /aɪs/;
coin: [x] n. 硬币;  v. 铸造(硬币);创造;  adj. 硬币的;投币的; [acc] /kɔɪn/;
change: [x] n. 改变,变化;零钱;  v. 兑换;  vi. 变化;  vt. 改变; [acc] /tʃeɪndʒ/;
dad: [x] n. 爸爸,爹爹; [acc] /dæd/;
bury: [x] v. 埋葬;隐藏,埋藏;埋头于;抛开; [acc] /ˈberi/;
sandwich: [x] n. 三明治,夹肉面包;  vt. 夹入,挤进; [acc] /ˈsænwɪtʃ/;
classroom: [x] n. 教室,课堂; [acc] /ˈklæsruːm/;
always: [x] adv. 总是;一直,不断地;在任何时候;毫无例外地; [acc] /ˈɔːlweɪz/;
math: [x] n. 数学;计算过程; [acc] /mæθ/;
road: [x] n. 路,道路;公路,大道;  adj. 巡回的; [acc] /roʊd/;
collect: [x] v. 收集;领取;聚集;募捐;  adj. 接收者付费的;  adv. 接收者付费地; [acc] /kəˈlekt/;
dining: [x] n. 吃饭,进餐; [acc] /ˈdaɪnɪŋ/;
network: [x] n. 广播网,电视网;网络;  vi. 建立关系网;  vt. 联播;使联网; [acc] /ˈnetwɜːrk/;
struggle: [x] n. 奋斗;斗争;  v. 挣扎,抗争;奋斗; [acc] /ˈstrʌɡl/;
result: [x] n. 结果,成效;  v. 导致,..的结果; [acc] /rɪˈzʌlt/;
injury: [x] n. 损害,伤害;受伤; [acc] /ˈɪndʒəri/;
kill: [x] v. 杀死;消磨(时间);使停止;缓解 (疼痛等); [acc] /kɪl/;
expression: [x] n. 表情,神情;表达,表述;措辞; [acc] /ɪkˈspreʃn/;
sleepy: [x] adj. 困乏的,欲睡的; [acc] /ˈsliːpi/;
business: [x] n. 商业,生意;事务; [acc] /ˈbɪznəs/;
strike: [x] v. 击打;袭击;罢工;  n. 罢工;打击;袭击; [acc] /straɪk/;
lesson: [x] n. 功课,课;课程;教训,经验; [acc] /ˈlesn/;
post: [x] n. 柱;邮政,邮寄;邮件;职位,岗位;哨所;  vt. 贴出;公告;邮寄; [acc] /poʊst/;
violin: [x] n. 小提琴; [acc] /ˌvaɪəˈlɪn/;
flood: [x] n. 洪水;大量;  v. 淹没,充满;(河)溢出; [acc] /flʌd/;
camera: [x] n. 照相机,摄影机; [acc] /ˈkæmərə/;
underground: [x] adj. 地下的,秘密的;  adv. 在地下,秘密地;  n. 地铁;地下; [acc] /ˌʌndərˈɡraʊnd/;
lawyer: [x] n. 律师; [acc] /ˈlɔːjər/;
month: [x] n. 月,月份; [acc] /mʌnθ/;
gas: [x] n. 煤气;气体;汽油;  v. 使吸入毒气;毒(死);给 ... 加汽油;空谈;加汽油;  adj. 〈美俚〉喝醉酒的; [acc] /ɡæs/;
foreign: [x] adj. 外国的,外来的;陌生的,非自身的; [acc] /ˈfɔːrən/;
view: [x] n. 风景;视野;见解;  v. 观看,看,望;查看,察看,视察,检查;看待,将..看成是,把..视为,认为; [acc] /vjuː/;
jar: [x] n. 罐坛,广口瓶,坛子,刺耳声,震动;  v. 冲突,震动,刺激,发出刺耳声;刺激(神经);给.不快之感(神经); [acc] /dʒɑːr/;
fee: [x] n. 费用,酬金; [acc] /fiː/;
great: [x] adj. 伟大的;重大的;很好的,美妙的;大量的,极大的;  n. 大师;大人物;伟人们; [acc] /ɡreɪt/;
realize: [x] v. 认识到,体会到;实现; [acc] /ˈriːəlaɪz/;
book: [x] n. 书,书籍;  v. 预订;预约; [acc] /bʊk/;
advertisement: [x] n. 广告;公告;登广告;宣传; [acc] /ˌædvərˈtaɪzmənt/;
test: [x] n. 测试,考验,试验;  vt. 测试,考验,试验; [acc] /test/;
present: [x] n. 礼物,赠送物;  adj. 出席的,当前的;  v. 赠送,呈现;提出,提供,递交; [acc] /ˈpreznt/;
communicate: [x] v. 沟通,交流;传达,传递;传染;相连,相通;显露; [acc] /kəˈmjuːnɪkeɪt/;
frost: [x] n. 霜冻,严寒;  v. 结霜,冻死; [acc] /frɔːst/;
carpenter: [x] n. 木匠;木工; [acc] /ˈkɑːrpəntər/;
six: [x] num. 六,六个; [acc] /sɪks/;
function: [x] n. 功能,作用;函数;应变量;盛大聚会;职务,职责;  v. 起作用;正常运转; [acc] /ˈfʌŋkʃn/;
laptop: [x] n. 笔记本电脑;  adj. 膝上型的; [acc] /ˈlæptɑːp/;
creature: [x] n. 人;生物;动物;工具; [acc] /ˈkriːtʃər/;
job: [x] n. 职业,职位;工作;责任; [acc] /dʒɑːb/;
else: [x] adv. 别的;其他的;  n. [女名]女子名; [acc] /els/;
cancel: [x] v. 取消;撤消;删去; [acc] /ˈkænsl/;
son: [x] n. 儿子;(长者对晚辈的爱称)孩子; [acc] /sʌn/;
pale: [x] adj. 苍白的,灰白的,暗淡的,无力的;  vi. 变苍白;  n. 栅栏;  vt. 用栅栏围;使失色;使变苍白; [acc] /peɪl/;
opera: [x] n. 歌剧,歌剧艺术;歌剧团;歌剧院; [acc] /ˈɑːprə/;
eleven: [x] num. 十一,十一个;  n. 由十一人组成的足球队,棒球队等;十一个一组;  adj. 十一的;  pron. 十一个; [acc] /ɪˈlevn/;
eastwards: [x] adv. 向东; [acc] /ˈiːstwərdz/;
drug: [x] n. 药物,麻醉品,毒品;  v. 下麻药; [acc] /drʌɡ/;
fame: [x] n. 名望,名声,声誉;  vt. 使有名,使著名; [acc] /feɪm/;
electricity: [x] n. 电,电力;电流;电学; [acc] /ɪˌlekˈtrɪsəti/;
bring: [x] vt. 带来,引起,劝诱;  v. 产生;促使; [acc] /brɪŋ/;
remember: [x] v. 记得,想起;记住; [acc] /rɪˈmembər/;
big: [x] adj. 大的,巨大的;  adv. 大大,给人印象深地;  n. 大亨,大公司; [acc] /bɪɡ/;
badly: [x] adv. 坏,恶劣地;严重地,非常; [acc] /ˈbædli/;
arrive: [x] v. 到达;(时间等)来临;达成; [acc] /əˈraɪv/;
white: [x] adj. 白色的,白种人的;  n. 眼白 (指眼球中的白色部分);白色,白种人,蛋白; [acc] /waɪt/;
still: [x] n. 寂静,剧照,照片;  v. 使安静,使镇定下来;  adj. 静止的,静寂的;  adv. 还,仍,尽管如此,依然;  conj. 但是,然而; [acc] /stɪl/;
X-ray: [x] n. X射线;X光照片;  v. 用X射线检查; [acc] /ˈeks reɪ/;
gray: [x] adj. 灰色的;暗淡的;  n. 灰色,暗淡;  v. 变灰色,使..变灰色; [acc] /ɡreɪ/;
Egyptian: [x] n. 埃及人; [acc] /iˈdʒɪpʃn/;
schoolboy: [x] n. 男学生;学童;  adj. 男学生的; [acc] /ˈskuːlbɔɪ/;
seed: [x] n. 种子,籽;种子选手;  v. 播种,结籽; [acc] /siːd/;
busy: [x] adj. 忙的,忙碌的,正被占用的;  v. 使忙于;  n. 包打听; [acc] /ˈbɪzi/;
communist: [x] adj. 共产主义的;  n. 共产主义者,共产党员; [acc] /ˈkɑːmjənɪst/;
information: [x] n. 信息,情报,资料,通知; [acc] /ˌɪnfərˈmeɪʃn/;
greengrocer: [x] n. (英)蔬菜水果商; [acc] /ˈɡriːnɡroʊsər/;
lab: [x] n. 实验室,研究室; [acc] /læb/;
knee: [x] n. 膝,膝盖;  vt. 用膝盖碰; [acc] /niː/;
exhibition: [x] n. 展览,展览会;陈列;奖学金; [acc] /ˌeksɪˈbɪʃn/;
board: [x] n. 木板;董事会;甲板;膳食;  v. 乘船,登机;用板铺;供膳食;寄宿; [acc] /bɔːrd/;
card: [x] n. 卡,卡片,名片;  v. (纺纱前纤维)梳理,梳,刷;把..记入卡片,把..制成卡片; [acc] /kɑːrd/;
ship: [x] n. 船,海船,舰,飞船;  v. 装上船;运送,航运; [acc] /ʃɪp/;
heat: [x] n. 高温;压力;热度;[物理学]热;热烈;  vt. 给..加热;使激动,激发; [acc] /hiːt/;
birth: [x] n. 分娩,出生;出身;创始; [acc] /bɜːrθ/;
shape: [x] v. 使形成,塑造;  n. 外形,形状,轮廓;状态;结构; [acc] /ʃeɪp/;
power: [x] n. 力量,能力,权力;电源;电力;功率;  v. 提供动力;驱动; [acc] /ˈpaʊər/;
candy: [x] n. 糖果;  vt. (用糖煮过以)保存;使结晶为砂糖;  adj. 〈美俚〉(服饰)花哨的;甜言蜜语的; [acc] /ˈkændi/;
blank: [x] adj. (纸等)空白的,茫然的;  n. 空白,空白处;  v. 忽视; [acc] /blæŋk/;
hire: [x] v. 雇用,出租;  n. 租金,雇用,租用; [acc] /ˈhaɪər/;
income: [x] n. 收入; [acc] /ˈɪnkʌm/;
decision: [x] n. 决定;决断力;做决定; [acc] /dɪˈsɪʒn/;
low: [x] adj. 低的,矮的;低下的;  adv. 低声地;谦卑地;低下地;  n. 低点;低水平;牛的叫声;  vi. (牛)哞哞叫; [acc] /loʊ/;
dumpling: [x] n. 饺子;水果布丁; [acc] /ˈdʌmplɪŋ/;
hand: [x] n. 手;手掌;指针;掌管;  vt. 传递;交给;搀扶;支持; [acc] /hænd/;
inn: [x] n. 客栈,小旅馆; [acc] /ɪn/;
Japan: [x] n. 日本; [acc] /dʒəˈpæn/;
purple: [x] adj. 紫色的;  n. 紫色; [acc] /ˈpɜːrpl/;
equal: [x] adj. 相等的;平等的;  v. 等于;比得上;  n. 对手; [acc] /ˈiːkwəl/;
past: [x] adv. 过,经过;  prep. 过,经过,越过;  adj. 过去的,结束的;  n. 过去; [acc] /pæst/;
purse: [x] n. 钱包(尤指女用的),小钱袋,手袋;  v. 使皱起,噘起; [acc] /pɜːrs/;
fifty: [x] n. 五十,五十个;  num. 五十,五十个;五十的,五十个的; [acc] /ˈfɪfti/;
rock: [x] v. 摇晃,震动,演奏摇滚;  n. 岩石;摇滚乐; [acc] /rɑːk/;
husband: [x] n. 丈夫;  v. 节约,节俭,节省,节用; [acc] /ˈhʌzbənd/;
bank: [x] n. 银行,岸,库,堤;  v. 把钱存入银行,筑堤防护; [acc] /bæŋk/;
painting: [x] n. 画作,绘画;将(画作)挂起来; [acc] /ˈpeɪntɪŋ/;
rather: [x] adv. 宁愿,宁可,相当;  excl. <英口> 好呀; [acc] /ˈræðər/;
electronic: [x] adj. 电子的;电子学的;电子操控的;电子设备的; [acc] /ɪˌlekˈtrɑːnɪk/;
nod: [x] v. 点(头),打盹;  n. 点头;点头同意;打瞌睡,打盹;粗心大意; [acc] /nɑːd/;
meat: [x] n. 肉; [acc] /miːt/;
life: [x] n. 生命;生活,生存; [acc] /laɪf/;
outgoing: [x] adj. 外向的;外出的;乐于助人的;即将离职的,卸任的;  n. 流出;开支; [acc] /ˈaʊtɡoʊɪŋ/;
frighten: [x] v. 使惊恐,使害怕; [acc] /ˈfraɪtn/;
glass-topped: [x] adj. 玻璃罩的; [acc] /'glaːsˌtɒpt/;
move: [x] v. 移动;发展,推移,变化;感动;  n. 迁居;移动; [acc] /muːv/;
want: [x] v. 想要;需要;短缺;缺少;  n. 短缺,必需品; [acc] /wɑːnt/;
bookseller: [x] n. 书商;售书员; [acc] /ˈbʊkselər/;
beautiful: [x] adj. 美丽的,美好的,极好的;出色的; [acc] /ˈbjuːtɪfl/;
season: [x] n. 季(节),节期,时期;  v. 给.调味,风干(木柴); [acc] /ˈsiːzn/;
Italy: [x] n. 意大利; [acc] /ˈɪtəli/;
ugly: [x] adj. 丑陋的;险恶的;  n. (十九世纪流行的)女帽(上的丝质)遮阳; [acc] /ˈʌɡli/;
dial: [x] v. 拨(电话号码);打电话;  n. 钟面;仪表盘;拨号盘; [acc] /ˈdaɪəl/;
abroad: [x] adv. 到国外,在国外;在户外; [acc] /əˈbrɔːd/;
west: [x] n. 西方,西部;  adj. 西的,西方的;  adv. 向西方; [acc] /west/;
block: [x] v. 阻挡;妨碍;阻塞;  n. 街区;块状物;积木;阻碍;大厦; [acc] /blɑːk/;
private: [x] adj. 私人的;私密的;私下的;  n. 士兵; [acc] /ˈpraɪvət/;
billion: [x] num. [美]十亿,[英]万亿;万亿,一万亿;大量,无数;  adj. 大量的; [acc] /ˈbɪljən/;
vacation: [x] n. 休假,假期;  v. 休假,度假; [acc] /veɪˈkeɪʃn/;
memory: [x] n. 记忆;回忆;存储; [acc] /ˈmeməri/;
fine: [x] v. 罚款;  n. 罚款,罚金;  adj. 好的,优质的,精致的,晴朗的;  adv. 合适地,恰好地; [acc] /faɪn/;
flow: [x] v. 流动;飘垂;涨潮;来自..的结果;流畅;  n. 流动;流畅; [acc] /floʊ/;
certain: [x] adj. 有把握的;肯定的,必然的;某个,特定的;  pron. 某些,某几个; [acc] /ˈsɜːrtn/;
climate: [x] n. 气候;(社会思想等)趋势; [acc] /ˈklaɪmət/;
clock: [x] n. 钟,仪表;  v. 测时间,为..计时; [acc] /klɑːk/;
imagine: [x] v. 想象;设想;料想;认为; [acc] /ɪˈmædʒɪn/;
hello: [x] int. 喂(打电话时的招呼语);哈啰;  n. 你好(打招呼用语);表示问候,惊奇或唤起注意时的用语; [acc] /həˈloʊ/;
maybe: [x] adv. 可能,大概,也许;  n. 不确定性; [acc] /ˈmeɪbi/;
science: [x] n. 科学;(科学的) 学科; [acc] /ˈsaɪəns/;
defend: [x] v. 防卫,保卫,防守;为..辩护,为..辩解;捍卫,维护; [acc] /dɪˈfend/;
disability: [x] n. 残疾;残疾状态; [acc] /ˌdɪsəˈbɪləti/;
ant: [x] n. 蚂蚁; [acc] /ænt/;
unfit: [x] adj. 不适宜的,不合适的;不适当的;不健康的;  v. 不适合; [acc] /ʌnˈfɪt/;
excellent: [x] adj. 优秀的;卓越的;极好的; [acc] /ˈeksələnt/;
locust: [x] n. 蝗虫; [acc] /ˈloʊkəst/;
steer: [x] v. 操纵,驾驶,掌舵,引导;  n. 公牛,食用牛; [acc] /stɪr/;
rubbish: [x] n. 垃圾,废物;废话; [acc] /ˈrʌbɪʃ/;
snow: [x] n. 雪;  v. 下雪; [acc] /snoʊ/;
beggar: [x] n. 乞丐;  v. 使贫穷; [acc] /ˈbeɡər/;
boxing: [x] n. 拳击;盒式包装,制箱材料; [acc] /ˈbɑːksɪŋ/;
law: [x] n. 法律,法令,法则; [acc] /lɔː/;
fox: [x] n. 狐狸;狡猾的人;时髦女郎;  v. 用诡计,假装;欺骗,迷惑; [acc] /fɑːks/;
length: [x] n. 长,长度,持续时间;一段 (绳子,布,木头等); [acc] /leŋθ/;
best-seller: [x] n. 畅销书; [acc] /ˌbest'selər/;
bake: [x] v. 烤,烘焙;烧制;  n. 晒;烘烤食品; [acc] /beɪk/;
sit: [x] v. 坐;(使)就座,(使)坐; [acc] /sɪt/;
greet: [x] v. 问候,招呼;对..作出反应; [acc] /ɡriːt/;
pigeon: [x] n. 鸽子; [acc] /ˈpɪdʒɪn/;
chance: [x] n. 机会;偶发事件;可能性;几率;  vi. 偶然发生;  adj. 偶然的;  vt. 冒.的险; [acc] /tʃæns/;
weekday: [x] n. 工作日,平日; [acc] /ˈwiːkdeɪ/;
each: [x] det. 每人的,每个的;  pron. 每人,每个,每件;  adv. 每个; [acc] /iːtʃ/;
only: [x] adj. 唯一的;  adv. 只,仅仅;  conj. 但是;除非;然而;毕竟; [acc] /ˈoʊnli/;
lend: [x] v. 把.借给,贷(款); [acc] /lend/;
influence: [x] n. 影响,势力;有影响的人或事;  v. 影响; [acc] /ˈɪnfluəns/;
half: [x] n. 半,一半;  adj. 一半的; [acc] /hæf/;
diet: [x] n. 日常饮食;(病人或减肥者的)特种饮食;大量;  v. 节食; [acc] /ˈdaɪət/;
elevator: [x] n. 电梯;起重机;升降舵;粮库; [acc] /ˈelɪveɪtər/;
auditorium: [x] n. 〈美〉讲堂;听众席; [acc] /ˌɔːdɪˈtɔːriəm/;
pancake: [x] n. 烙饼,薄饼; [acc] /ˈpænkeɪk/;
world: [x] n. 世界;生活世界,生活圈; [acc] /wɜːrld/;
invitation: [x] n. 请柬;邀请;招致; [acc] /ˌɪnvɪˈteɪʃn/;
mailbox: [x] n. 邮筒;邮箱; [acc] /ˈmeɪlbɑːks/;
postcode: [x] n. (英)邮政编码;  v. 为(某一邮区)提供邮政编码; [acc] /ˈpoʊstkoʊd/;
serve: [x] v. 为.服务;招待;供应;服役;  n. 网球等发球;发球权;所发的球; [acc] /sɜːrv/;
solid: [x] adj. 结实的;坚固的;固体的;  n. 固体; [acc] /ˈsɑːlɪd/;
traveler: [x] n. 旅行者,旅客,旅行推销员; [acc] /ˈtrævələr/;
gate: [x] n. 大门;登机口;观众数; [acc] /ɡeɪt/;
brave: [x] adj. 勇敢的;崭新的;  v. 勇敢面对;不怕,不顾;  n. 勇士;美洲印第安武士; [acc] /breɪv/;
envy: [x] n. 妒忌;妒忌的对象;  v. 嫉妒,羡慕; [acc] /ˈenvi/;
satisfaction: [x] n. 满足,满意;乐事;补偿; [acc] /ˌsætɪsˈfækʃn/;
petrol: [x] n. (英)汽油; [acc] /ˈpetrəl/;
music: [x] n. 音乐,乐曲,乐谱; [acc] /ˈmjuːzɪk/;
worth: [x] adj. 值..钱;有..价值;  n. 价值,财产; [acc] /wɜːrθ/;
perhaps: [x] adv. 也许,可能; [acc] /pərˈhæps/;
flower: [x] n. 花,花卉;精华;  v. 开花; [acc] /ˈflaʊər/;
cloudy: [x] adj. 多云的;混浊的; [acc] /ˈklaʊdi/;
doorbell: [x] n. 门铃; [acc] /ˈdɔːrbel/;
bottle: [x] n. 瓶(子);  v. 装瓶;抑制,约束,遏制,控制; [acc] /ˈbɑːtl/;
solve: [x] v. 解决;解释,解答; [acc] /sɔːlv/;
return: [x] n. 返回;回答;  adj. 返回的;报答的;重现的;  v. 返回;归还;回报;回答; [acc] /rɪˈtɜːrn/;
balloon: [x] n. 气球;热气球;  v. 充气;膨胀;  adj. 气球般的; [acc] /bəˈluːn/;
teacher: [x] n. 教师,老师,教员; [acc] /ˈtiːtʃər/;
dinner: [x] n. 正餐,(现通例指)晚餐;午[晚]宴,宴会; [acc] /ˈdɪnər/;
plant: [x] n. 植物;工厂;设备;发电厂;  v. 种植;安置; [acc] /plænt/;
bookmark: [x] n. 书签; [acc] /ˈbʊkmɑːrk/;
print: [x] n. 印刷,印刷品,;出版;字体;  v. 印刷,出版;洗印;印染; [acc] /prɪnt/;
team: [x] n. 队,组;  v. 结成一队,使结成一队; [acc] /tiːm/;
though: [x] conj. 虽然,可是;  adv. 可是,但是;不过;然而;话虽这样说;  prep. 但; [acc] /ðoʊ/;
tear: [x] v. 撕裂,撕碎;  n. 眼泪; [acc] /ter/;
injection: [x] n. 打针;注射,注入;充满; [acc] /ɪnˈdʒekʃn/;
website: [x] n. [网]网站; [acc] /ˈwebsaɪt/;
relation: [x] n. 家属,亲属;关系,联系; [acc] /rɪˈleɪʃn/;
Russian: [x] adj. 俄罗斯的,俄国的,俄国人的,俄语的;  n. 俄罗斯人,俄语; [acc] /ˈrʌʃn/;
best: [x] adj. 最好的,最优的;  v. 打败,胜过; [acc] /best/;
Friday: [x] n. 星期五; [acc] /ˈfraɪdeɪ/;
pipette: [x] n. 移液管;吸移管;  v. 用移液器吸取; [acc] /paɪˈpet/;
planet: [x] n. 行星; [acc] /ˈplænɪt/;
canteen: [x] n. 食堂,小卖部;水壶; [acc] /kænˈtiːn/;
league: [x] n. 联盟;社团;里格(=3.18海里);  v. 使..结盟,与..联合; [acc] /liːɡ/;
fruit: [x] n. 水果;成果,产物;  vi. 结果实;  vt. 使结果实; [acc] /fruːt/;
room: [x] n. 房间;空间;机会,可能性;  v. 合住; [acc] /ruːm/;
key: [x] n. 钥匙;键;答案;(达到目的或解决问题的)方法,手段,关键,要诀;[音]调,主音;  adj. 关键的;  v. 用键盘输入,键控,发报; [acc] /kiː/;
pencil: [x] n. 铅笔;  vt. 用铅笔写; [acc] /ˈpensl/;
easily: [x] adv. 容易地,无疑地,很可能地; [acc] /ˈiːzəli/;
wish: [x] n. 愿望;希望得到的东西;希望;祝愿;  v. 希望,想要;祝愿;但愿;  vt. 渴望; [acc] /wɪʃ/;
washroom: [x] n. 盥洗室; [acc] /ˈwɑːʃruːm/;
ride: [x] v. 骑,乘;  n. 乘坐,骑;搭便车;兜风; [acc] /raɪd/;
Thursday: [x] n. 星期四; [acc] /ˈθɜːrzdeɪ/;
worried: [x] adj. 发愁的,担心的,烦恼的; [acc] /ˈwɜːrid/;
telephone: [x] v. 打电话;  n. 电话(机); [acc] /ˈtelɪfoʊn/;
frequently: [x] adv. 频繁,经常地; [acc] /ˈfriːkwəntli/;
businessman: [x] n. 商人; [acc] /ˈbɪznəsmæn/;
spanish: [x] adj. 西班牙(人)的;  n. 西班牙语; [acc] /ˈspænɪʃ/;
serious: [x] adj. 严重的,危急的;重要的,重大的;认真的,严肃的; [acc] /ˈsɪriəs/;
turn: [x] v. 使变成,转动,超过(年龄,数量);  n. 转动,轮流,时机,倾向,转弯; [acc] /tɜːrn/;
forever: [x] adv. 永远;总是,老是; [acc] /fərˈevər/;
percent: [x] n. 百分之..; [acc] /pərˈsent/;
cream: [x] n. 面霜;奶油,乳脂;奶油色;精英;  v. 凝成乳脂,起泡沫; [acc] /kriːm/;
several: [x] det. 几个,若干,数个;  adj. 各自的,分别的; [acc] /ˈsevrəl/;
daily: [x] adj. 每日的,日常的;  n. 日报;  adv. 每日,天天; [acc] /ˈdeɪli/;
closed: [x] adj. 关着的;不公开的;  v. 关;结束;接近; [acc] /kloʊzd/;
shall: [x] aux. 表示提供建议,将要,应该,一定; [acc] /ʃæl/;
wool: [x] n. 羊毛;毛线;毛织品; [acc] /wʊl/;
why: [x] adv. 为什么,..的(理由);  int. (表吃惊,满意等)哎呀什么?;  conj. ..的理由;为什么;  n. 原因;原因,理由; [acc] /waɪ/;
thus: [x] adv. 因此;这样,如此; [acc] /ðʌs/;
notebook: [x] n. 笔记本电脑;笔记本;手册; [acc] /ˈnoʊtbʊk/;
safe: [x] n. 保险箱;冷藏箱;  adj. 安全的;可靠的;有把握的;稳妥的;可靠的,稳妥的;  adv. 安全地; [acc] /seɪf/;
earthquake: [x] n. 地震; [acc] /ˈɜːrθkweɪk/;
doll: [x] n. 玩具娃娃,玩偶; [acc] /dɑːl/;
Scotland: [x] n. 苏格兰; [acc] /ˈskɑːtlənd/;
impossible: [x] adj. 不可能的;  n. 不可能的事; [acc] /ɪmˈpɑːsəbl/;
push: [x] n. 推,推力,促进,推进;  v. 推,逼迫,推进; [acc] /pʊʃ/;
event: [x] n. 事件,大事;社交活动;比赛项目; [acc] /ɪˈvent/;
surprise: [x] n. 惊奇,诧异;惊喜;  v. 出其不意地袭击;使惊奇,使诧异,使感到意外; [acc] /sərˈpraɪz/;
dirty: [x] adj. 不干净的,肮脏的,有灰尘的;下流的,黄色的,色情的,猥亵的;卑鄙的,不道德的;  v. 弄脏,玷污;  adv. 不公平地,不诚实地; [acc] /ˈdɜːrti/;
clever: [x] adj. 聪明的;机智的,熟练的; [acc] /ˈklevər/;
fold: [x] v. 折叠;彻底失败;合拢;  n. 折叠;褶; [acc] /foʊld/;
museum: [x] n. 博物馆,展览馆; [acc] /mjuˈziːəm/;
catch: [x] v. 捕捉,接住;赶上;噎住;  n. 陷阱,圈套,诡计;料不到的困难;接球; [acc] /kætʃ/;
tongue: [x] n. 舌头;语言,说话方式;  vt. 舔;  vi. 吹管乐器; [acc] /tʌŋ/;
duck: [x] n. 鸭,雌鸭;鸭肉;  v. 回避,躲闪; [acc] /dʌk/;
term: [x] n. 措辞;期限;学期,任期;(pl.)条款;(pl.)关系;  vt. 把.称为,把.叫作; [acc] /tɜːrm/;
absent: [x] adj. 缺席的,不在的;心不在焉的,出神的;  v. 缺席;使缺席;  prep. 缺乏; [acc] /ˈæbsənt/;
India: [x] n. 印度; [acc] /'ɪndɪə/;
choice: [x] n. 选择(机会),抉择;选项;精华;  adj. (食物)精选的,上等的,优等的; [acc] /tʃɔɪs/;
far: [x] adv. 远,(时间)久远,很,远远,进展程度;  adj. 较远的,最远的,远方的;  n. 远方; [acc] /fɑːr/;
traffic: [x] n. 交通,车流;交通量;交通运输;非法买卖,非法交易;  v. 用.作交换;在.通行;交易;买卖; [acc] /ˈtræfɪk/;
crayon: [x] n. 蜡笔,彩色粉笔;  v. 以蜡笔作画,用彩色粉笔画; [acc] /ˈkreɪən/;
bee: [x] n. 蜜蜂;忙碌的人; [acc] /biː/;
duty: [x] n. 责任,职责,义务,税; [acc] /ˈduːti/;
position: [x] n. 位置;职位;姿势;观点;  v. 安置; [acc] /pəˈzɪʃn/;
mosquito: [x] n. 蚊子; [acc] /məˈskiːtoʊ/;
wave: [x] n. 波浪;(挥手)示意;起伏;涌现的人,涌现的事物;卷发,卷曲;  v. (挥手)示意,波动,飘动波浪; [acc] /weɪv/;
tour: [x] n. 旅游;巡游;  v. 旅游;做巡回演出; [acc] /tʊr/;
near: [x] adv. 近,接近;  adj. 近的;  prep. 靠近;  v. 接近,靠近; [acc] /nɪr/;
fax: [x] n. 传真(机);传真件;  v. 用传真传输; [acc] /fæks/;
prison: [x] n. 监狱;监禁;  v. 监禁; [acc] /ˈprɪzn/;
yesterday: [x] n. 昨天;往昔;  adv. 昨天;  adj. 过时的; [acc] /ˈjestərdeɪ/;
player: [x] n. 演奏者;选手,队员;重要参与者;播放器; [acc] /ˈpleɪər/;
without: [x] prep. 没有,不,(表条件)如果没有,要没有;  adv. 在外,在屋外;在没有(某种不言而喻的东西)的情况下,在缺乏的情况下; [acc] /wɪˈðaʊt/;
printer: [x] n. 印刷机,印刷工;打印机; [acc] /ˈprɪntər/;
annoy: [x] v. 使烦恼,使生气;  n. 烦恼(等于annoyance); [acc] /əˈnɔɪ/;
performer: [x] n. 表演者; [acc] /pərˈfɔːrmər/;
writer: [x] n. 作家;文书;作曲者; [acc] /ˈraɪtər/;
America: [x] n. 美国;美洲; [acc] /ə'merɪkə/;
leave: [x] v. 离开;留下;  n. 许可,准假;告别; [acc] /liːv/;
relay: [x] n. 替班;转播;接力赛跑;  v. 转播;传递; [acc] /ˈriːleɪ/;
department: [x] n. 部门;系;部; [acc] /dɪˈpɑːrtmənt/;
pill: [x] n. 药丸; [acc] /pɪl/;
interested: [x] adj. 感兴趣的;有权益的; [acc] /ˈɪntrəstɪd/;
helicopter: [x] n. 直升机;  v. 用直升飞机载送,乘直升机; [acc] /ˈhelɪkɑːptər/;
bowl: [x] n. 碗;保龄球戏;  vi. 参加保龄球赛;[体]投球;[体]玩滚木球;稳而快地行驶;  vt. 投掷或滚动(球);滚球得分;表演保龄球;打倒;撞击; [acc] /boʊl/;
soldier: [x] n. 士兵,军人;  v. 当兵; [acc] /ˈsoʊldʒər/;
guitar: [x] n. 吉他,六弦琴; [acc] /ɡɪˈtɑːr/;
regret: [x] n. 后悔,遗憾;  vt. 懊悔,后悔;抱歉;  vi. 感到后悔,感到抱歉; [acc] /rɪˈɡret/;
silence: [x] n. 沉默;  v. 使沉默; [acc] /ˈsaɪləns/;
borrow: [x] vt. 借,借入;借用; [acc] /ˈbɑːroʊ/;
pork: [x] n. 猪肉; [acc] /pɔːrk/;
official: [x] n. 官员;行政官员;裁判;  adj. 官方的,正式的,公务的; [acc] /əˈfɪʃl/;
vehicle: [x] n. 交通工具,机动车;传播媒介;工具,手段; [acc] /ˈviːəkl/;
even: [x] adj. 实力相当的;均等的;偶数的;  adv. 甚至;即使,竟然;  v. 使平,使相等; [acc] /ˈiːvn/;
chips: [x] n. (pl.)炸土豆条(片); [acc] /tʃɪps/;
spring: [x] n. 春天;弹簧,弹性;泉,泉源;跳跃;  v. 反弹,跳,跃,(使)跳起,(使)弹开;生长,涌出,跃出; [acc] /sprɪŋ/;
penny: [x] n. 便士;美分; [acc] /ˈpeni/;
rice: [x] n. 米饭;米;稻;  v. 筛选; [acc] /raɪs/;
overcome: [x] v. 战胜;克服;压倒;得胜,征服; [acc] /ˌoʊvərˈkʌm/;
stranger: [x] n. 陌生人;新来者; [acc] /ˈstreɪndʒər/;
shop: [x] n. 商店,店铺;  v. 买东西;购货; [acc] /ʃɑːp/;
age: [x] n. 年龄,时代,时期;  v. (使)变老,(使)陈化; [acc] /eɪdʒ/;
route: [x] n. 路线;固定路线;途径;渠道;  vt. 按某路线发送;给.规定路线[次序,程序]; [acc] /raʊt/;
greeting: [x] n. 问候,致敬; [acc] /ˈɡriːtɪŋ/;
pineapple: [x] n. 凤梨,菠萝; [acc] /ˈpaɪnæpl/;
sun: [x] n. 太阳;阳光;恒星;  v. 晒; [acc] /sʌn/;
sad: [x] adj. 难过的,悲伤的,忧愁的;悲哀的,令人悲痛的,令人伤心的;(状况)糟糕的,令人无法接受的;乏味的,无趣的; [acc] /sæd/;
smoke: [x] n. 烟,烟尘;  v. 抽(烟),冒烟; [acc] /smoʊk/;
tree: [x] n. 树; [acc] /triː/;
couple: [x] n. 夫妇;(一)对;几个;  v. 配对,连接,结合; [acc] /ˈkʌpl/;
magazine: [x] n. 杂志,期刊;弹夹;弹药库; [acc] /ˈmæɡəziːn/;
sky: [x] n. 天空;  v. 将..击向空中; [acc] /skaɪ/;
height: [x] n. 高,高度;高处;非常,极度; [acc] /haɪt/;
playground: [x] n. 操场,游乐区;活动场所; [acc] /ˈpleɪɡraʊnd/;
foggy: [x] adj. 有雾的;模糊的; [acc] /ˈfɔːɡi/;
frog: [x] n. 蛙; [acc] /frɔːɡ/;
winter: [x] n. 冬,冬季;  adj. 冬天的;  v. 过冬; [acc] /ˈwɪntər/;
needle: [x] n. 针;针状物;指针;  v. 刺激; [acc] /ˈniːdl/;
officer: [x] n. 官员;干事;军官;警官; [acc] /ˈɑːfɪsər/;
headmaster: [x] n. 男校长(尤指私立学校); [acc] /ˌhedˈmæstər/;
national: [x] n. 国民;  adj. 国家的,民族的; [acc] /ˈnæʃnəl/;
bedroom: [x] n. 卧室;  adj. 两性关系的; [acc] /ˈbedruːm/;
history: [x] n. 历史,历史课;历史记录; [acc] /ˈhɪstri/;
attempt: [x] n. 尝试;企图;  vt. 努力去做;试图,尝试; [acc] /əˈtempt/;
blue: [x] adj. 蓝色的;忧郁的;  n. 蓝色; [acc] /bluː/;
operate: [x] v. 操作;运转;施行手术;运营;(军队)在某一地区作战,执行任务; [acc] /ˈɑːpəreɪt/;
pronounce: [x] v. 发音;发表,宣布; [acc] /prəˈnaʊns/;
weigh: [x] vt. 称重;认真考虑;  vi. 重压,有影响; [acc] /weɪ/;
number: [x] n. 数,数字;号码;  v. 达,总计;编号; [acc] /ˈnʌmbər/;
Monday: [x] n. 星期一; [acc] /ˈmʌndeɪ/;
rocket: [x] n. 火箭;芝麻菜;  vi. 飞快地移动;猛涨; [acc] /ˈrɑːkɪt/;
pilot: [x] n. 领航员;飞行员;  adj. 试验性的;  v. 给..领航,驾驶;试验; [acc] /ˈpaɪlət/;
meet: [x] v. 遇见,相遇,开会;满足;  n. 集会; [acc] /miːt/;
pause: [x] vi. 暂停,中止,停顿;  vt. 暂停播放;  n. 中止,暂停;暂停键; [acc] /pɔːz/;
zoo: [x] n. 动物园; [acc] /zuː/;
fork: [x] n. 叉,餐叉;耙子;分叉,分岔处,岔路; [acc] /fɔːrk/;
every: [x] det. 每个,每一,每一个;每隔(一定的数目或时间)的,每..之中的;一切可能的,所有可能的; [acc] /ˈevri/;
twentieth: [x] num. 第二十;第二十的;二十分之一的;  n. 二十分之一;第二十日; [acc] /ˈtwentiəθ/;
fan: [x] n. 扇子,风扇;(影,球等)迷;  v. 扇;成扇形;[棒]三振出局; [acc] /fæn/;
lock: [x] n. 锁;  v. 锁上,锁住; [acc] /lɑːk/;
pub: [x] n. 酒吧,酒馆; [acc] /pʌb/;
diamond: [x] n. 钻石,金刚石;方块牌;菱形;棒球内场; [acc] /ˈdaɪəmənd/;
about: [x] adv. 附近,大约,转向,左右,周围;  prep. 在附近,关于,在..周围,忙于;  adj. 即将的,正要的,在流行中的; [acc] /əˈbaʊt/;
telegraph: [x] n. 电报;电报机;  v. 打电报;流露 (要做某事);显示; [acc] /ˈtelɪɡræf/;
smart: [x] adj. 时髦的,衣着讲究的;聪明的;干净的,整洁的;  v. 剧痛,刺疼; [acc] /smɑːrt/;
chess: [x] n. 棋;国际象棋; [acc] /tʃes/;
towel: [x] n. 毛巾,手巾;  v. 用毛巾擦; [acc] /ˈtaʊəl/;
lemon: [x] n. 柠檬;柠檬黄;柠檬汁;  adj. 浅黄色的; [acc] /ˈlemən/;
achieve: [x] v. 完成,达到,获得,实现; [acc] /əˈtʃiːv/;
super: [x] adj. 极好的;超级的;  adv. 非常地;十分,非常;  n. 警长;(一栋楼的)监管人; [acc] /ˈsuːpər/;
fourth: [x] num. 第四的,第四个的,四分之一的;第四;  n. 四分之一,第四档; [acc] /fɔːrθ/;
bat: [x] n. 蝙蝠;球棒,球拍;  v. 用球板击球;拍打(空中飞舞的小东西); [acc] /bæt/;
prize: [x] n. 奖品,奖赏;  adj. 作为奖品的,得奖的;  v. 珍视,宝贵; [acc] /praɪz/;
necklace: [x] n. 项链; [acc] /ˈnekləs/;
cloud: [x] n. 云;云状物;阴影;  v. 使混浊,使混乱,搅浑(问题),混淆;在(心)上投下苦恼的暗影,使心情黯然,使不快;覆盖,遮蔽;使阴暗,使变黑暗; [acc] /klaʊd/;
Atlantic: [x] n. 大西洋;  adj. 大西洋的; [acc] /æt'læntɪk/;
born: [x] v. 出世;  adj. 天生的; [acc] /bɔːrn/;
lie: [x] n. 谎话,假象;  vi. 躺,位于;说谎,欺骗; [acc] /laɪ/;
tell: [x] v. 告诉;辨别;断定;讲述;告发,泄密;识别; [acc] /tel/;
coke: [x] n. 可乐;焦炭; [acc] /koʊk/;
envelope: [x] n. 信封;包装物,外壳,膜;气囊; [acc] /ˈenvəloʊp/;
vase: [x] n. 花瓶; [acc] /veɪs/;
wash: [x] v. 洗,洗掉;冲洗,冲刷;  n. 洗,冲积物,洗涤物; [acc] /wɑːʃ/;
dinosaur: [x] n. 恐龙; [acc] /ˈdaɪnəsɔːr/;
challenge: [x] n. 挑战;质疑;  v. 挑战;质疑; [acc] /ˈtʃælɪndʒ/;
queen: [x] n. 王后;女王;出众的女人;皇后; [acc] /kwiːn/;
cannon: [x] n. 大炮;机关炮;  v. 相撞;开炮; [acc] /ˈkænən/;
button: [x] n. 纽扣;按钮(开关);  v. 扣紧;扣上纽扣; [acc] /ˈbʌtn/;
popular: [x] adj. 受欢迎的;大众的; [acc] /ˈpɑːpjələr/;
cup: [x] n. 杯子;(一)杯(的容量);杯状物;杯,杯子;奖杯;  v. 拔火罐;窝成杯形;使成杯状;用杯盛;为.拔火罐; [acc] /kʌp/;
aircraft: [x] n. 飞机,飞行器,航空器; [acc] /ˈerkræft/;
horrible: [x] adj. 可怕的,恐怖的;讨厌的,糟糕的;粗鲁的,不友好的; [acc] /ˈhɔːrəbl/;
thick: [x] adj. 厚的,粗的;稠的,浓的; [acc] /θɪk/;
sunset: [x] n. 日落;  adj. 日落的; [acc] /ˈsʌnset/;
mild: [x] adj. 味淡的;温暖的;轻微的;温和的;  n. 淡味啤酒; [acc] /maɪld/;
article: [x] n. 物品;文章;条款;冠词; [acc] /ˈɑːrtɪkl/;
eraser: [x] n. 橡皮擦,擦除器; [acc] /ɪˈreɪsər/;
journey: [x] n. 旅行,旅程;  v. 旅行; [acc] /ˈdʒɜːrni/;
postal: [x] adj. 邮政的,邮局的;邮件的; [acc] /ˈpoʊstl/;
famous: [x] adj. 著名的,出名的; [acc] /ˈfeɪməs/;
paper: [x] n. 纸;试卷,论文,报纸;  v. 裱糊;  adj. 纸制的,似纸的,有名无实的; [acc] /ˈpeɪpər/;
online: [x] adj. (活动,服务)在线的,网上的,受电脑控制的,联机的;  adv. 联机地,在运行,开始运行;  n. 在线;联机; [acc] /ˌɑːnˈlaɪn/;
boil: [x] v. 烧开,沸腾;用开水煮,在沸水中煮;  n. 煮沸,沸腾;疔,疖子;[医]疡肿,脓肿; [acc] /bɔɪl/;
moon: [x] n. 月球,月亮;卫星; [acc] /muːn/;
guest: [x] n. 客人,宾客;旅客;特邀嘉宾;  vi. 做特邀嘉宾; [acc] /ɡest/;
butterfly: [x] n. 蝴蝶;  vt. (烹饪时把鱼肉等)切开摊平; [acc] /ˈbʌtərflaɪ/;
ring: [x] n. 戒指;环;集团;响声;  v. 套上环;成环状;敲钟;打电话; [acc] /rɪŋ/;
concert: [x] n. 音乐会;一致;和谐,合作; [acc] /ˈkɑːnsərt/;
settle: [x] v. 安顿;定居;解决;调停;(目光)停留;结算,算清;  n. 背长椅,座位;定居,安顿; [acc] /ˈsetl/;
trouble: [x] n. 烦恼,动乱,纠纷;故障;疾病;  v. (使)烦恼,麻烦; [acc] /ˈtrʌbl/;
daytime: [x] n. 白天;  adj. 白天的,日间的; [acc] /ˈdeɪtaɪm/;
title: [x] n. 标题;头衔;权利;  vt. 加标题于;授予.称号;  adj. 标题的,题目的;称呼的; [acc] /ˈtaɪtl/;
pen: [x] n. 笔,钢笔;围栏,畜栏;  v. 书写;关押,监禁; [acc] /pen/;
otherwise: [x] adv. 否则,要不然;除此之外;  conj. 否则,不然; [acc] /ˈʌðərwaɪz/;
glass: [x] n. 玻璃;玻璃杯;  v. 用玻璃杯击(某人)的脸部; [acc] /ɡlæs/;
postman: [x] n. 邮递员; [acc] /ˈpoʊstmən/;
healthy: [x] adj. 健康的;健全的;有益健康的;合理的;兴旺发达的; [acc] /ˈhelθi/;
tea: [x] n. 茶(叶);茶点;  v. 给..沏茶;喝茶; [acc] /tiː/;
audience: [x] n. (演讲,音乐会等的)听众,观众;正式会见;拥护者; [acc] /ˈɔːdiəns/;
director: [x] n. 导演;指导者;主管;董事; [acc] /dəˈrektər/;
Antarctica: [x] n. 南极洲; [acc] /ænˈtɑːrktɪkə/;
liquid: [x] n. 液体;  adj. 液体的;清脆的; [acc] /ˈlɪkwɪd/;
failure: [x] n. 失败;失败者;破产; [acc] /ˈfeɪljər/;
backache: [x] n. 背痛; [acc] /ˈbækeɪk/;
plus: [x] prep. 加,加上;  n. 加号;有利因素;  adj. 正的,多的;有利的;阳性的;  conj. 此外,而且,况且; [acc] /plʌs/;
exact: [x] adj. 确切的,精密严谨的;  v. 强求; [acc] /ɪɡˈzækt/;
beat: [x] v. 敲打;打败;打;(心脏)跳动;搅拌;  n. 敲打;拍子;  adj. 精疲力竭的,疲惫不堪的;垮掉的,属于"垮掉的一代"的; [acc] /biːt/;
practice: [x] v. 练习,实践;  n. 练习;习惯;业务;实践,实行; [acc] /ˈpræktɪs/;
race: [x] n. (速度上的)比赛;人种,种族;属,种;  v. 全速行进;参加竞赛;(使)比速度; [acc] /reɪs/;
last: [x] det. 末尾的,最后(剩下)的,最终的;最新(流行)的,最时髦的;  v. 度过,拖过;持续,继续,延续,存续;  n. 最后,最终,终于;上个;末尾;  adv. 最后,终于,最终,终结;最近; [acc] /læst/;
prove: [x] v. 证实; [acc] /pruːv/;
expert: [x] n. 专家;  adj. 熟练的,专业的; [acc] /ˈekspɜːrt/;
expensive: [x] adj. 昂贵的; [acc] /ɪkˈspensɪv/;
stamp: [x] n. 印,章;邮票;  v. 盖印;贴邮票于;毁掉;标出,表示;跺脚; [acc] /stæmp/;
true: [x] adj. 真实的,真正的;忠诚的;符合的;  adv. 精准地;正确地;真正地;  n. 真实,真理; [acc] /truː/;
list: [x] n. 目录,表,名单;倾斜;  v. 列举;记入名单内; [acc] /lɪst/;
cooker: [x] n. 炉灶; [acc] /ˈkʊkər/;
dance: [x] v. 跳舞;摇晃;  n. 舞;  adj. 舞的,舞蹈的;用于跳舞的; [acc] /dæns/;
liter: [x] n. (=litre)升,公升; [acc] /ˈliːtər/;
roof: [x] n. 屋顶;顶部;  vt. 覆盖,给..盖屋顶; [acc] /ruːf/;
glad: [x] adj. 高兴的;乐意的; [acc] /ɡlæd/;
educator: [x] n. 教育者,教师;教育学家; [acc] /ˈedʒukeɪtər/;
shirt: [x] n. 衬衫,衬衣;  v. 给..穿上衬衫; [acc] /ʃɜːrt/;
nervous: [x] adj. 紧张的,焦虑不安的;害怕的;神经系统的,神经方面的; [acc] /ˈnɜːrvəs/;
awake: [x] adj. 醒着的,警觉的;  v. 唤醒;觉醒,认识到;认识到; [acc] /əˈweɪk/;
comrade: [x] n. 同伴;同志;战友; [acc] /ˈkɑːmræd/;
prepare: [x] v. 准备,预备;做好准备; [acc] /prɪˈper/;
airplane: [x] n. 飞机; [acc] /ˈerpleɪn/;
innocent: [x] adj. 天真的,单纯的;无辜的,清白的;无恶意的;  n. 天真无邪的人; [acc] /ˈɪnəsnt/;
cigar: [x] n. 雪茄烟; [acc] /sɪˈɡɑːr/;
deal: [x] n. 协议;交易,生意;待遇;大量,很多;交易;  v. 处理;  adj. 冷杉木制的,松木制的; [acc] /diːl/;
thief: [x] n. 小偷,贼; [acc] /θiːf/;
ping-pong: [x] n. 乒乓球; [acc] /ˈpɪŋ pɔːŋ/;
nearly: [x] adv. 将近,几乎;接近地; [acc] /ˈnɪrli/;
oxygen: [x] n. 氧气; [acc] /ˈɑːksɪdʒən/;
monkey: [x] n. 猴子,猿;顽童,淘气精,调皮鬼,捣蛋鬼;五百英镑;  v. 恶戏,恶作剧,捣蛋,胡闹; [acc] /ˈmʌŋki/;
raincoat: [x] n. 雨衣; [acc] /ˈreɪnkoʊt/;
program: [x] n. 程序;节目;计划;  v. 给..编写程序; [acc] /ˈproʊɡræm/;
learn: [x] v. 学习; [acc] /lɜːrn/;
tent: [x] n. 帐篷; [acc] /tent/;
cheap: [x] adj. 便宜的;低劣的,不值钱的;  adv. 便宜地,卑鄙地; [acc] /tʃiːp/;
bread: [x] n. 面包;食物;粮食;  vt. 在..上撒面包屑; [acc] /bred/;
fresh: [x] adj. 新鲜的,清新的,新近的,无经验的;  n. 开始;新生;  adv. 最近地; [acc] /freʃ/;
pepper: [x] n. 胡椒粉,胡椒;辣椒;  v. 使布满;加胡椒粉于; [acc] /ˈpepər/;
language: [x] n. 语言,语言文字,表达方式; [acc] /ˈlæŋɡwɪdʒ/;
example: [x] n. 例子,实例;模范; [acc] /ɪɡˈzæmpl/;
tennis: [x] n. 网球;  adj. 网球的,用于网球运动的;  vi. 打网球; [acc] /ˈtenɪs/;
development: [x] n. 发展,逐渐形成;开发区;开发; [acc] /dɪˈveləpmənt/;
natural: [x] adj. 天然的,正常的,自然的;自然界的;天赋的,天生的; [acc] /ˈnætʃrəl/;
idea: [x] n. 想法,主意;思想,概念; [acc] /aɪˈdiːə/;
diagram: [x] n. 图解,图表; [acc] /ˈdaɪəɡræm/;
explorer: [x] n. 探险家; [acc] /ɪkˈsplɔːrər/;
magical: [x] adj. 不可思议的;有魔力的;魔术的,魔法的; [acc] /ˈmædʒɪkl/;
mad: [x] adj. 异常狂暴的;蠢笨的;精神错乱的;疯狂的;狂热的;生气的,狂怒的;  n. 狂怒; [acc] /mæd/;
plate: [x] n. 盘子,板,片;  v. 电镀; [acc] /pleɪt/;
glue: [x] n. 胶水;  v. 用胶粘; [acc] /ɡluː/;
method: [x] n. 办法,方法;秩序,规律; [acc] /ˈmeθəd/;
tomb: [x] n. 墓穴,坟墓;  vt. 埋葬; [acc] /tuːm/;
receive: [x] vt. 收到;遭受;对.作出反应;接待,会客,接见,招待;获得;接受,容纳;[电子学] 接收;  v. 接球; [acc] /rɪˈsiːv/;
dusk: [x] n. 薄暮,黄昏;  v. (天)变黑;变暗; [acc] /dʌsk/;
desire: [x] n. 渴望;欲望;愿望;要求;  vi. 有希望,期望,愿望;  vt. 希望,渴望;请求,要求; [acc] /dɪˈzaɪər/;
means: [x] n. 方法,手段;工具;财富,收入;  v. 意味着(mean的第三人称单数);打算或注定要某人成为或做某事; [acc] /miːnz/;
court: [x] n. 法院,法庭;庭院;球场;宫廷;  v. 讨好,取悦;招致危险;追求; [acc] /kɔːrt/;
instruct: [x] v. 指导;教;指示;通知; [acc] /ɪnˈstrʌkt/;
complete: [x] adj. 完整的;完成的;  v. 完成;使完整; [acc] /kəmˈpliːt/;
engineer: [x] n. 工程师;技师;火车司机;技工;  v. 设计;建造;当工程师;计划; [acc] /ˌendʒɪˈnɪr/;
forgive: [x] v. 原谅,饶恕,宽恕;(国家,银行等)免除(债务); [acc] /fərˈɡɪv/;
clothing: [x] n. 衣服;被褥; [acc] /ˈkloʊðɪŋ/;
song: [x] n. 歌曲;诗歌,韵文;鸟鸣;低价; [acc] /sɔːŋ/;
album: [x] n. 相册;唱片集,专辑;集邮册; [acc] /ˈælbəm/;
ago: [x] adv. 以前; [acc] /əˈɡoʊ/;
doctor: [x] n. 医生,医师;博士;  v. 诊治;修理,修复,改写文稿; [acc] /ˈdɑːktər/;
pressure: [x] n. 压力;压迫,[物] 压强;迫使;  v. 对..施加压力;密封; [acc] /ˈpreʃər/;
strict: [x] adj. 严厉的;严格的(条例,法规等);恪守信条的;确切的; [acc] /strɪkt/;
extraordinary: [x] adj. 非同寻常的;特别的; [acc] /ɪkˈstrɔːrdəneri/;
sign: [x] v. 签署;使眼色;做暗号;做手势;  n. 记号,符号;标志,手势; [acc] /saɪn/;
spy: [x] n. 间谍,密探;  v. 当间谍,暗中监视(或侦察); [acc] /spaɪ/;
pavement: [x] n. 人行道; [acc] /ˈpeɪvmənt/;
European: [x] adj. 欧洲的;欧洲人的;  n. 欧洲人; [acc] /ˌjʊrəˈpiːən/;
level: [x] n. 水平面,水平,标准,等级;  vi. 瞄准;拉平;  adj. 水平的;平坦的;等高的;  vt. 使平等;对准目标; [acc] /ˈlevl/;
one-way: [x] adj. 单程的;单行道的;单方面的; [acc] /ˌwʌn ˈweɪ/;
meter: [x] n. 计,表,仪表;米;  v. 用仪表测量; [acc] /ˈmiːtər/;
fish: [x] n. 鱼,鱼肉;  v. 钓鱼; [acc] /fɪʃ/;
stomach: [x] n. 胃,胃口;  vt. 忍受;吃得下; [acc] /ˈstʌmək/;
growth: [x] n. 生长,发展;增长;肿瘤; [acc] /ɡroʊθ/;
playhouse: [x] n. 剧场;玩具房屋;儿童游戏室; [acc] /ˈpleɪhɑʊs/;
lay: [x] vt. 躺着,置放,铺设;下蛋;设置;  adj. 世俗的;外行的;没有经验的;  n. 叙事诗;性伙伴; [acc] /leɪ/;
whole: [x] n. 全部;整体;  adj. 完全的;整个的;全部的;  adv. 完全,整个; [acc] /hoʊl/;
ten: [x] num. 十,十个;  n. 十个人;十点钟;十岁;十元纸币; [acc] /ten/;
whale: [x] n. 鲸; [acc] /weɪl/;
dirt: [x] n. 灰尘,泥土,污垢;丑事,丑行; [acc] /dɜːrt/;
Australian: [x] adj. 澳洲的;澳洲人的;  n. 澳洲人; [acc] /ɔːˈstreɪliən/;
forgetful: [x] adj. 健忘的;不注意的;疏忽的;使遗忘的; [acc] /fərˈɡetfl/;
under: [x] prep. 在..之下,在..之内;在..领导下,假借;少于,低于;根据,按照;处于..情况之下;  adj. 下面的,下方的;  adv. 在下面,在下方; [acc] /ˈʌndər/;
Frenchman: [x] n. 法国人; [acc] /ˈfrentʃmən/;
coast: [x] n. 海岸,湖岸;  v. 一帆风顺,沿海航行; [acc] /koʊst/;
Himalaya: [x] n. 喜马拉雅山脉; [acc] /ˌhɪmə'leɪə/;
pot: [x] n. 罐,壶,锅,盆; [acc] /pɑːt/;
enough: [x] det. 足够的;  adv. 足够地;  pron. 很多;充足;  excl. 够了; [acc] /ɪˈnʌf/;
roast: [x] v. 烤,炙,烘;挖苦;逗乐;  n. 烤肉;  adj. 烤的,烘的; [acc] /roʊst/;
pull: [x] v. 拉,拖,扯,拔;得到;驾驶;  n. 拉力,吸引力,影响力; [acc] /pʊl/;
Swedish: [x] adj. 瑞典语的;瑞典人的;瑞典的;  n. 瑞典语; [acc] /ˈswiːdɪʃ/;
path: [x] n. 路,小道,道路; [acc] /pæθ/;
impression: [x] n. 印记;印象,感觉,感想;压痕; [acc] /ɪmˈpreʃn/;
apple: [x] n. 苹果; [acc] /ˈæpl/;
high: [x] n. 高处;天空;高潮;最高水平;  adj. 高的;昂贵的;高级的;高尚的;高傲的;  adv. 高;高高地;高价地;强烈地;奢侈地; [acc] /haɪ/;
lake: [x] n. 湖; [acc] /leɪk/;
college: [x] n. 学院,高等专科学校;大学; [acc] /ˈkɑːlɪdʒ/;
housewife: [x] n. 家庭主妇; [acc] /ˈhaʊswaɪf/;
translate: [x] v. 翻译;转化; [acc] /trænsˈleɪt/;
television: [x] n. 电视(机); [acc] /ˈtelɪvɪʒn/;
finish: [x] v. 完成,结束,最后加工,用完;  n. 结束,完成; [acc] /ˈfɪnɪʃ/;
because: [x] conj. 因为; [acc] /bɪˈkɔːz/;
rail: [x] n. 铁轨;扶手,栏杆;  v. 咒骂; [acc] /reɪl/;
wrong: [x] adj. 违法的;不合适的;错误的;有故障的;  adv. 错;不公正地;  n. 坏事;不公正;  vt. 无理地对待;冤枉;欺骗; [acc] /rɔːŋ/;
drum: [x] v. 击鼓;连续敲击;  n. 鼓;圆桶; [acc] /drʌm/;

[kk9:中考词汇2364个]

# appendix: 词形近似词的含义
optimist: [n]乐天派;
optimism: [n]乐观主义;
pessimistic: [adj]悲观(主义)的;
optimize: [vt]使完善,优化;
altruistic: [adj]无私的;
grain: [n]谷物;
drain: [v]排出,流干,耗尽;
soot: [n]油烟;
glean: [v]收集(资料); 
clan: [n]家族;部落; 
cleanse: [v]净化;
fright: [n]恐吓,惊吓; 
hive: [n]蜂房; [v]分隔;
gibe: [n&v]嘲笑; 
blighted: [adj]完蛋了的,生病了的
delightful: [adj]令人愉悦的,可喜的
enlighten: [v]启发,开导
lighter: [n]打火机
menial: [n]家仆; 
rental: [n]租金;[adj]租借的
importunate: [adj]讨厌的,缠扰不休的;
spoonful: [n]一匙(的量)
rainfull: [n]降雨(量)
mangy: [adj]污秽的,肮脏的
tangy: [adj]扑鼻的,有刺激性的,强烈的
gangly: [adj]身材瘦长的
graceful: [adj]优雅的,优美的,得体的
shaver: [n]理发师;电动剃须刀; [acc] /ʃeɪv/;
confluence: [n](河流的)汇流点;(人或物的)聚集