conform: [vi]一致;遵照,顺从;符合; [vt]使一致;使遵照; [adj]一致的; [a]/kənˈfɔːrm/; [or]gmat;
fracture: [n]骨折;折断;裂口; [v]使折断;使骨折; [a]/ˈfræktʃər/; [or]gmat;
appropriate: [adj]合适的;适当的; [v]挪用;拨款;私占; [a]/əˈproʊpriət/; [or]gmat;
aspire: [vi]渴望,有志于(与to,for,after连用或后接不定式); [a]/əˈspaɪər/; [or]gmat;
appliance: [n]家用器具;家用电器;装置;应用; [a]/əˈplaɪəns/; [or]gmat;
exonerate: [v]使免罪; [a]/ɪɡˈzɑːnəreɪt/; [or]gmat;
tropical: [adj]热带的; [a]/ˈtrɑːpɪkl/; [or]gmat;
tag: [n]附加语;标签; [v]装包头于(鞋带等);加标签于;连接,合并; [a]/tæɡ/; [or]gmat;
biography: [n]传记文学,传记; [a]/baɪˈɑːɡrəfi/; [or]gmat;
detach: [v]使分开,拆卸;派遣; [a]/dɪˈtætʃ/; [or]gmat;
facilitate: [v]为他人提供方便;使便利; [vt]促进; [a]/fəˈsɪlɪteɪt/; [or]gmat;
neuron: [n]神经元,神经细胞; [a]/ˈnʊrɑːn/; [or]gmat;
appeal: [vi]呼吁,请求;申诉;有吸引力; [n]呼吁;恳求;(为慈善或好的事业所做的) 筹款努力;(人或物的)吸引力; [a]/əˈpiːl/; [or]gmat;
correspond: [v]符合;相符,一致;通信; [a]/ˌkɔːrəˈspɑːnd/; [or]gmat;
conversion: [n]转变,转换;宗教,信仰上的转变;[经济学]兑换; [a]/kənˈvɜːrʒn/; [or]gmat;
conduct: [v]指挥;进行;实施;处理;传导(电,热等);护送; [n]行为,举止;指挥,带领; [a]/kənˈdʌkt/; [or]gmat;
context: [n]上下文,语境;背景; [a]/ˈkɑːntekst/; [or]gmat;
default: [n]违约;缺席;缺乏;默认; [vi]不履行义务;拖欠; [vt]不履行;不参加; [a]/dɪˈfɔːlt/; [or]gmat;
intense: [adj]强烈的,激烈的;紧张的;认真的;热情的; [a]/ɪnˈtens/; [or]gmat;
contemplate: [v]沉思;对..周密考虑;注视; [a]/ˈkɑːntəmpleɪt/; [or]gmat;
sedentary: [adj]久坐不动的;静止的;坐惯的,定栖的; [a]/ˈsednteri/; [or]gmat;
metaphor: [n]暗喻,隐喻; [a]/ˈmetəfər/; [or]gmat;
grim: [adj]严酷的,无情的;令人沮丧的,令人失望的;讨厌的,糟糕的; [a]/ɡrɪm/; [or]gmat;
leaven: [n]发酵剂,影响力; [v]发酵,影响,渐变; [a]/ˈlevn/; [or]gmat;
potent: [adj]强有力的;有权势的;有说服力的; [a]/ˈpoʊtnt/; [or]gmat;
monarch: [n]君主;帝王;统治者; [a]/ˈmɑːnərk/; [or]gmat;
hail: [n]冰雹;一阵; [v]下冰雹;歌颂; [a]/heɪl/; [or]gmat;
shed: [v]流出(眼泪);蜕皮;脱落;使清晰;流下;去除,摆脱; [n]棚屋; [a]/ʃed/; [or]gmat;
eminent: [adj]显赫的;杰出的;有名的;(品质)优良的; [a]/ˈemɪnənt/; [or]gmat;
succumb: [v]屈从,屈服,因.死亡(to); [a]/səˈkʌm/; [or]gmat;
pharmaceutical: [adj]制药的,药物的; [n]药物; [a]/ˌfɑːrməˈsuːtɪkl/; [or]gmat;
allowance: [v]定量供应(食物,饮料等物品);配给; [n]零用钱;津贴,补贴;限额;免税额;允许,容忍,让步;考虑; [a]/əˈlaʊəns/; [or]gmat;
pinpoint: [v]准确地解释或说明; [adj]精确的; [n]针尖,极小之物,极不重要的事物; [a]/ˈpɪnpɔɪnt/; [or]gmat;
diverse: [adj]不同的,差异的,多种多样的; [a]/daɪˈvɜːrs/; [or]gmat;
prime number: [phr]质数; [a]/ˌpraɪm ˈnʌmbər/; [or]gmat;
entitle: [v]给(书)题名;给予.权利; [a]/ɪnˈtaɪtl/; [or]gmat;
overview: [n]综述,概观; [a]/ˈoʊvərvjuː/; [or]gmat;
fodder: [n]饲料,草料;(创作的)素材;弹药; [v]喂; [a]/ˈfɑːdər/; [or]gmat;
methane: [n][有化]甲烷,[能源]沼气; [a]/ˈmeθeɪn/; [or]gmat;
assess: [v]评估;估值; [a]/əˈses/; [or]gmat;
gentry: [n]人们(多用贬义),贵族们,(英)上流社会人士; [a]/ˈdʒentri/; [or]gmat;
genuine: [adj]真正的;真的;真诚的; [a]/ˈdʒenjuɪn/; [or]gmat;
deluge: [n]洪水;暴雨;泛滥; [v]使泛滥;压倒; [a]/ˈdeljuːdʒ/; [or]gmat;
errand: [n]差使;差事;使命; [a]/ˈerənd/; [or]gmat;
resent: [v]愤恨; [a]/rɪˈzent/; [or]gmat;
livestock: [n]家畜,牲畜; [a]/ˈlaɪvstɑːk/; [or]gmat;
pluralistic: [adj]兼职的,［哲］多元论的; [a]/ˌplʊərə'lɪstɪk/; [or]gmat;
snapdragon: [n]［植］金鱼草属植物,金鱼草; [a]/ˈsnæpdræɡən/; [or]gmat;
possess: [v]拥有,占有;缠住,迷住;支配; [a]/pəˈzes/; [or]gmat;
deplete: [v]使大大减少;耗尽,用尽; [a]/dɪˈpliːt/; [or]gmat;
parish: [n]教区; [a]/ˈpærɪʃ/; [or]gmat;
sympathetic: [adj]有同情心的,同情的;支持的;称心的; [a]/ˌsɪmpəˈθetɪk/; [or]gmat;
resolve: [n]决心; [v]解决,决定,表决; [a]/rɪˈzɑːlv/; [or]gmat;
elicit: [v]引出;诱出;探出; [a]/iˈlɪsɪt/; [or]gmat;
interact: [v]交流,沟通,互动;互相作用,互相影响; [a]/ˌɪntərˈækt/; [or]gmat;
expulsion: [n]驱逐;开除; [a]/ɪkˈspʌlʃn/; [or]gmat;
motion: [n]运动,移动;手势;提议; [v]示意; [a]/ˈmoʊʃn/; [or]gmat;
retard: [v]延迟,使减速; [n]妨碍,阻碍; [a]/rɪˈtɑːrd/; [or]gmat;
prudent: [adj]谨慎的,精明的; [a]/ˈpruːdnt/; [or]gmat;
supersede: [v]代替;紧接着而到来; [a]/ˌsuːpərˈsiːd/; [or]gmat;
saline: [adj]咸的,含盐的; [a]/ˈseɪliːn/; [or]gmat;
glacier: [n]冰川,冰河; [a]/ˈɡleɪʃər/; [or]gmat;
martial: [adj]武术的;好战的;军事的; [a]/ˈmɑːrʃl/; [or]gmat;
vacuum: [n]真空吸尘器;真空;空虚,茫然若失; [v]用吸尘器打扫; [a]/ˈvækjuəm/; [or]gmat;
preservative: [n]防腐剂;预防法;防护层; [adj]有保存力的;防腐的;有保存力的;有保护性的; [a]/prɪˈzɜːrvətɪv/; [or]gmat;
illegal: [adj]不合法的,非法的; [n]非法移民,非法劳工;间谍; [a]/ɪˈliːɡl/; [or]gmat;
subconscious: [adj]下意识的; [n]潜意识; [a]/ˌsʌbˈkɑːnʃəs/; [or]gmat;
apparent: [adj]显然的,明白的,清晰可见的;表面上的,貌似(真实)的; [a]/əˈpærənt/; [or]gmat;
excise: [v]切除,删去; [n]消费税,货物税,国产税; [a]/ˈeksaɪz/; [or]gmat;
accidental: [adj]偶然的,意外的;非本质的; [a]/ˌæksɪˈdentl/; [or]gmat;
vicious: [adj]罪恶的;恶意的;凶猛的,残忍的; [a]/ˈvɪʃəs/; [or]gmat;
stationary: [adj]静止的;固定的; [n]定居者,驻军; [a]/ˈsteɪʃəneri/; [or]gmat;
lag: [n]落后,延迟; [v]落后;缓慢进行,减退; [a]/læɡ/; [or]gmat;
peripheral: [adj]外围的; [n]外围设备; [a]/pəˈrɪfərəl/; [or]gmat;
endowment: [n]捐赠,捐助,捐款;(人的)天赋,天资; [a]/ɪnˈdaʊmənt/; [or]gmat;
concentrate: [v]全神贯注于,集中于;浓缩; [n]浓缩物; [a]/ˈkɑːnsntreɪt/; [or]gmat;
dialect: [n]方言;语调; [adj]方言的; [a]/ˈdaɪəlekt/; [or]gmat;
fade: [vi]褪色,褪去;失去;逐渐消失; [vt]使褪色; [n]淡入,淡出; [adj]乏味的; [a]/feɪd/; [or]gmat;
optimal: [adj]最佳的,最理想的; [a]/ˈɑːptɪməl/; [or]gmat;
pledge: [v]发誓,保证,以.抵押,向.祝酒; [n]保证,誓言; [a]/pledʒ/; [or]gmat;
sculpture: [n]雕刻艺术;雕刻,雕塑; [a]/ˈskʌlptʃər/; [or]gmat;
radiant: [adj]光芒四射的,绚丽的;喜悦的; [a]/ˈreɪdiənt/; [or]gmat;
protoplasm: [n]原生质,原浆,细胞质; [adj]〈生〉原生质的; [a]/ˈproʊtəplæzəm/; [or]gmat;
overall: [adj]全面的,全部的; [n]罩衫,工装裤; [adv]总的来说;总共; [a]/ˌoʊvərˈɔːl/; [or]gmat;
interfere: [v]干涉,妨碍;妨碍;干涉; [vi]妨碍; [a]/ˌɪntərˈfɪr/; [or]gmat;
coriander: [n]［植］芫荽,香菜; [a]/ˌkɔːriˈændər/; [or]gmat;
crunch: [n]嘎吱嘎吱的声音; [vt]嘎吱嘎吱地咀嚼; [vi]嘎吱嘎吱地咀嚼;嘎吱嘎吱地动;发嘎吱嘎吱声; [a]/krʌntʃ/; [or]gmat;
proceeds: [n]收入; [v]进行;前进;(沿特定路线)行进;(尤指打断后)继续说; [a]/ˈproʊsiːdz/; [or]gmat;
segment: [n]部分;片段;(橘子等的)瓣; [v]分割; [a]/ˈseɡmənt/; [or]gmat;
collective: [adj]集体的,共同的; [n]集体; [a]/kəˈlektɪv/; [or]gmat;
ingenuity: [n]机灵,心灵手巧,富于创造天赋; [a]/ˌɪndʒəˈnuːəti/; [or]gmat;
psychotherapy: [n]心理疗法,精神疗法; [a]/ˌsaɪkoʊˈθerəpi/; [or]gmat;
anthology: [n](诗,文,曲,画等的)选集; [a]/ænˈθɑːlədʒi/; [or]gmat;
undertake: [v]保证;承担,承包; [a]/ˌʌndərˈteɪk/; [or]gmat;
standpoint: [n]立场,观点; [a]/ˈstændpɔɪnt/; [or]gmat;
positive: [adj]积极的;肯定的,明确的;正面的;阳性的; [n]正面;肯定;优点;正数; [a]/ˈpɑːzətɪv/; [or]gmat;
mitigate: [v]减轻,缓和; [a]/ˈmɪtɪɡeɪt/; [or]gmat;
objective: [n]目标;目的; [adj]客观的; [a]/əbˈdʒektɪv/; [or]gmat;
dubious: [adj]可疑的;怀疑的;无把握的; [a]/ˈduːbiəs/; [or]gmat;
ratio: [n]比率,比例; [a]/ˈreɪʃioʊ/; [or]gmat;
lunar: [adj]月亮的; [a]/ˈluːnər/; [or]gmat;
nominate: [v]提名;任命; [adj]有特定名字的;被提名的;被指定的; [a]/ˈnɑːmɪneɪt/; [or]gmat;
pedagogical: [adj]教育的;教学法的; [a]/ˌpedəˈɡɑdʒɪk(ə)l/; [or]gmat;
treaty: [n]条约;协议;协定; [a]/ˈtriːti/; [or]gmat;
mint: [n]薄荷,薄荷糖,造币厂; [v]铸造(硬币); [a]/mɪnt/; [or]gmat;
transform: [v]将..变形,改变,转换; [a]/trænsˈfɔːrm/; [or]gmat;
liability: [n]责任;债务;倾向;可能性;不利因素;惹麻烦的人(或事); [a]/ˌlaɪəˈbɪləti/; [or]gmat;
inherent: [adj]内在的,固有的;生来就有的; [a]/ɪnˈhɪrənt/; [or]gmat;
distribute: [v]分发,分配,配送;散布; [a]/dɪˈstrɪbjuːt/; [or]gmat;
overlord: [n]封建领主; [a]/ˈoʊvərlɔːrd/; [or]gmat;
consistency: [n]连结,结合;坚固性;浓度,密度;一致性;连贯性; [a]/kənˈsɪstənsi/; [or]gmat;
compile: [v]收集,汇编; [a]/kəmˈpaɪl/; [or]gmat;
round: [adj]圆的,球形的; [n]圆,圆形物; [adv]围绕着,循环地; [v]使成圆形; prep. 围着,绕过,在周围; [a]/raʊnd/; [or]gmat;
circle: [n]周期;范围;圆圈; [v]围绕; [a]/ˈsɜːrkl/; [or]gmat;
circuit: [n]电路,线路;巡游,环形; [a]/ˈsɜːrkɪt/; [or]gmat;
era: [n]时代,年代;纪元; [a]/ˈɪrə/; [or]gmat;
subject: [n]科目;主题;受试者;国民; [adj]易患的,服从的; [vt]使服从,使隶属,使遭遇; [a]/ˈsʌbdʒɪkt/; [or]gmat;
circular: [adj]圆形的;环形的; [n]通知; [a]/ˈsɜːrkjələr/; [or]gmat;
character: [n]人物,角色;性格;(书写或印刷)符号,(汉)字;特点;人格,品性; [a]/ˈkærəktər/; [or]gmat;
status: [n]地位;状态;身份; [a]/ˈsteɪtəs/; [or]gmat;
charter: [n]宪章;特权,豁免权;契约,证书;租赁; [v]包,租(飞机,汽车等); [adj]包租的,租用的; [a]/ˈtʃɑːrtər/; [or]gmat;
note: [n]笔记,便条,注释;纸币;音符; [v]注意,记录; [a]/noʊt/; [or]gmat;
comment: [n]评论,议论;批评,意见;注解; [vt]评论; [vi]进行评论;为.作评语; [a]/ˈkɑːment/; [or]gmat;
pad: [n]衬垫;护具;便笺簿;(动物的)脚;浮叶; [v]填塞; [a]/pæd/; [or]gmat;
circulation: [n]流传,传播;发行,发行量;(体液的)循环;(水,空气等的)流通;(货币等的)流通; [a]/ˌsɜːrkjəˈleɪʃn/; [or]gmat;
desire: [n]渴望;欲望;愿望;要求; [vi]有希望,期望,愿望; [vt]希望,渴望;请求,要求; [a]/dɪˈzaɪər/; [or]gmat;
length: [n]长,长度,持续时间;一段 (绳子,布,木头等); [a]/leŋθ/; [or]gmat;
faith: [n]信任;信心;信仰; int. 实在,确实; [a]/feɪθ/; [or]gmat;
charge: [v]充电,充值;索价;控告;向.冲去; [n]费用;主管;控告; [a]/tʃɑːrdʒ/; [or]gmat;
various: [adj]各种各样的;不同的; [a]/ˈveriəs/; [or]gmat;
particular: [adj]特殊的;特定的;特别的;不寻常的;挑剔的; [n]详细情况; [a]/pərˈtɪkjələr/; [or]gmat;
evil: [adj]邪恶的,罪恶的; [n]邪恶,罪恶; [a]/ˈiːvl/; [or]gmat;
property: [n]房产;财产;特性;性能; [a]/ˈprɑːpərti/; [or]gmat;
bound: [adj]受约束的;有义务的;一定的; [v]束缚;跳跃着前行; [n]跳跃;范围;界限; [a]/baʊnd/; [or]gmat;
authority: [n]权威;威信;当局,官方;权力,职权; [a]/əˈθɔːrəti/; [or]gmat;
spring: [n]春天;弹簧,弹性;泉,泉源;跳跃; [v]反弹,跳,跃,(使)跳起,(使)弹开;生长,涌出,跃出; [a]/sprɪŋ/; [or]gmat;
produce: [v]生产;创作;产生; [vi]创作;生产;产生; [n]农产品; [a]/prəˈduːs/; [or]gmat;
domain: [n]域名;领土;管区,势力圈; [a]/doʊˈmeɪn/; [or]gmat;
religious: [adj]宗教的;虔诚的; [a]/rɪˈlɪdʒəs/; [or]gmat;
minute: [adj]微小的;详细的; [n]一分钟,瞬间; [v]记录; [a]/ˈmɪnɪt/; [or]gmat;
access: [n]进入;使用权;通道; [v]进入;访问; [a]/ˈækses/; [or]gmat;
movement: [n]动作,移动;运动;(交响乐)乐章; [a]/ˈmuːvmənt/; [or]gmat;
rate: [n]比率,率;速率;价格;频率; [v]评估;认为; [a]/reɪt/; [or]gmat;
species: [n](单复同)物种;种类;人类; [adj]物种上的; [a]/ˈspiːʃiːz/; [or]gmat;
illuminate: [vt]照亮;阐释;说明; [a]/ɪˈluːmɪneɪt/; [or]gmat;
surface: [v]浮上水面;显露; [n]表面,面,水面;外表,外观; [adj]表面的;水面的;外观的;(对高架及地下铁路说的)平地上的; [a]/ˈsɜːrfɪs/; [or]gmat;
file: [n]文件夹,档案,文件; [vi]把文件归档,提交(申请等); [vt]把(文件等)归档; [a]/faɪl/; [or]gmat;
distribution: [n]分布;分配;分发;散布; [a]/ˌdɪstrɪˈbjuːʃn/; [or]gmat;
peculiar: [adj]奇怪的,古怪的;特有的,特别的; [a]/pɪˈkjuːliər/; [or]gmat;
secure: [adj]安心的;安全的; [v]使安全;保卫,保护;确保;获得; [a]/səˈkjʊr/; [or]gmat;
stage: [n]阶段;舞台;戏剧; [v]举行;展现;上演;筹划;适于上演;适合在舞台上演出;乘公交车(或驿车)旅行;[军事]中间集结;扎营; [a]/steɪdʒ/; [or]gmat;
claim: [v]声称;要求;断言;主张;认领;索赔; [n]索赔;主张;声称;断言;要求; [a]/kleɪm/; [or]gmat;
mass: [n]众多;大多数;[物]质量;群众; [adj]大量的,大规模的; [v]聚集; [a]/mæs/; [or]gmat;
check: [v]检查;阻止; [n]支票;阻止;检查;阻止物; [a]/tʃek/; [or]gmat;
divine: [adj]神的,神圣的;极好的; [v](凭直觉)发现,猜到; [n]神学家;圣职人员;教士;上帝; [a]/dɪˈvaɪn/; [or]gmat;
principal: [n]校长,负责人;本金,资本; [adj]主要的,首要的; [a]/ˈprɪnsəpl/; [or]gmat;
slight: [adj]轻微的,微小的;纤细的,瘦弱的;少量的; [n]轻视,蔑视; [vt]轻视,忽略; [a]/slaɪt/; [or]gmat;
pointed: [adj]尖锐的;率直的; [a]/ˈpɔɪntɪd/; [or]gmat;
immediate: [adj]直系的;立即的,立刻的;紧邻的; [a]/ɪˈmiːdiət/; [or]gmat;
consequence: [n]结果,后果;重要性; [a]/ˈkɑːnsɪkwens/; [or]gmat;
sacred: [adj]神圣的,宗教(性)的;神圣不可侵犯的; [a]/ˈseɪkrɪd/; [or]gmat;
priest: [n]教士,神父; [a]/priːst/; [or]gmat;
fault: [n]过失,过错;弱点,缺点;故障,缺陷;(地质学)断层;发球失误; [v]责备,挑错; [a]/fɔːlt/; [or]gmat;
edge: [n](悬崖,峭壁的)边缘;边缘;锋利,尖锐;刀口,刃;优势; [v]徐徐移动;给.开刃,使锐利; [a]/edʒ/; [or]gmat;
vessel: [n]船,容器,血管; [a]/ˈvesl/; [or]gmat;
square: [n]正方形;广场; [adj]正方形的;平方的;直角的; [v]把..弄成方形; [adv]直接地; [a]/skwer/; [or]gmat;
previous: [adj]以前的;早先的;过早的; [a]/ˈpriːviəs/; [or]gmat;
constant: [adj]不变的,始终如一的;持续不断的; [n]常数,恒量; [a]/ˈkɑːnstənt/; [or]gmat;
credit: [n]信用;荣誉;学分;信贷;称赞;债权; [v]信赖;归因于;记学分; [a]/ˈkredɪt/; [or]gmat;
control: [n]控制;对照实验;控制装置; [vt]控制,管理; [a]/kənˈtroʊl/; [or]gmat;
superior: [n]上级,高手; [adj]较高级的,上层的,出众的; [a]/suːˈpɪriər/; [or]gmat;
increase: [v]增加,提高; [n]增加,增强,提高; [a]/ɪnˈkriːs/; [or]gmat;
admit: [v]承认;准许.进入,允许.加入;容许,可容纳; [a]/ədˈmɪt/; [or]gmat;
delicate: [adj]易碎的,易坏的,脆弱的;(人)娇弱的,体弱多病的;精美的,精致的,精巧的;微妙的,需要谨慎处理的;优美的,优雅的;柔和的,清淡的,淡雅的; [a]/ˈdelɪkət/; [or]gmat;
release: [v]释放;解放;发行; [n]解除;免除;发表; [a]/rɪˈliːs/; [or]gmat;
addition: [n]加法;添加;附加物; [a]/əˈdɪʃn/; [or]gmat;
chamber: [n]会议室;(作特殊用途的)房间;议院; [a]/ˈtʃeɪmbər/; [or]gmat;
sacrifice: [vt]牺牲;祭献; [vi]奉献;做出牺牲; [n]祭品;牺牲; [a]/ˈsækrɪfaɪs/; [or]gmat;
conscience: [n]良心,良知; [a]/ˈkɑːnʃəns/; [or]gmat;
description: [n]描写,形容,叙述;种类,类型; [a]/dɪˈskrɪpʃn/; [or]gmat;
throne: [n]王座;君主; [a]/θroʊn/; [or]gmat;
total: [adj]完全的;整个的,总体的; [n]总数,总额; [a]/ˈtoʊtl/; [or]gmat;
extreme: [adj]极端的;极远的;极限的;极度的;偏激的; [n]极端;极度(状态),最大程度; [a]/ɪkˈstriːm/; [or]gmat;
intention: [n]意图,意向,目的,打算; [a]/ɪnˈtenʃn/; [or]gmat;
civil: [adj]公民的,民用的;国内的;有礼貌的,客气的; [a]/ˈsɪvl/; [or]gmat;
comply: [vi]依从,服从,遵守; [a]/kəmˈplaɪ/; [or]gmat;
evident: [adj]显然的,明显的,明白的; [a]/ˈevɪdənt/; [or]gmat;
rare: [adj]罕见的,稀有的,难得的;半熟的;不寻常的;美好的; [a]/rer/; [or]gmat;
stock: [n]股票;股份;存货;储备;家畜; [v]给..装满;储存; [adj]储备的; [a]/stɑːk/; [or]gmat;
accustomed: [adj]通常的,惯常的;独特的;习惯的,适应了的(to); [a]/əˈkʌstəmd/; [or]gmat;
flat: [adj]平坦的;浅的;平面的;单调的; [n]平面;公寓; [adv]平直地; [a]/flæt/; [or]gmat;
ruin: [v]毁灭,毁坏;(使)破产;(使)堕落; [n]毁灭;废墟; [a]/ˈruːɪn/; [or]gmat;
consent: [n]同意,准许;赞成; [v]同意; [a]/kənˈsent/; [or]gmat;
bold: [adj]大胆的,勇敢的;无耻的,放肆的;醒目的; [n]粗体字; [a]/boʊld/; [or]gmat;
severe: [adj]严重的;严厉的;严酷的;剧烈的; [a]/sɪˈvɪr/; [or]gmat;
triumph: [n]喜悦,狂喜;凯旋,胜利; [v]成功,获胜; [a]/ˈtraɪʌmf/; [or]gmat;
eternal: [adj]永恒的,永不改变的; [a]/ɪˈtɜːrnl/; [or]gmat;
base: [n]地基,基础;底座;[化]碱; [adj]卑鄙的,无耻的; [vt]以..作基础; [a]/beɪs/; [or]gmat;
fierce: [adj]凶猛的;激烈的;猛烈的; [a]/fɪrs/; [or]gmat;
rage: [n]极怒;盛怒; [v]迅速蔓延,快速扩散;(战争等)激烈地进行; [a]/reɪdʒ/; [or]gmat;
confess: [v](向神父或上帝)忏悔;承认,坦白; [a]/kənˈfes/; [or]gmat;
expedition: [n]远征队;探险;短途旅行;迅速; [a]/ˌekspəˈdɪʃn/; [or]gmat;
doctrine: [n]教条,学说,信条,原则; [a]/ˈdɑːktrɪn/; [or]gmat;
estate: [n]地产,(上有大片建筑物的)土地,住宅,财产,遗产; [a]/ɪˈsteɪt/; [or]gmat;
reign: [v]占主导地位,统治,当政; [n](君主)统治时期; [a]/reɪn/; [or]gmat;
humble: [adj]卑微的;(级别或地位)低下的,简陋的;谦逊的; [v]使⋯谦逊,使⋯卑下;轻松打败(尤指强大的对手); [a]/ˈhʌmbl/; [or]gmat;
compliance: [n]遵守,依从;承诺,答应; [a]/kəmˈplaɪəns/; [or]gmat;
philosophy: [n]哲学,哲学体系;哲学思想; [a]/fəˈlɑːsəfi/; [or]gmat;
melancholy: [n]忧郁,悲哀; [adj]忧郁的,令人伤感的; [a]/ˈmelənkɑːli/; [or]gmat;
suspicion: [n]怀疑,猜疑,疑心;少许; [a]/səˈspɪʃn/; [or]gmat;
indicate: [vt]指出,指示,标示;表明,表示,显示; [a]/ˈɪndɪkeɪt/; [or]gmat;
donate: [v]捐献;捐赠; [vi]捐献;捐赠; [a]/ˈdoʊneɪt/; [or]gmat;
proceed: [v]前进(尤指停止后继续进行);继续进行,继续做; [n]收入,获利; [a]/proʊˈsiːd/; [or]gmat;
rapid: [adj]迅速的;急促的; [a]/ˈræpɪd/; [or]gmat;
distinct: [adj]截然不同的;独特的;明显的;清晰的; [a]/dɪˈstɪŋkt/; [or]gmat;
doubtless: [adv]无疑地;肯定地; [adj]无疑的;肯定的; [a]/ˈdaʊtləs/; [or]gmat;
fatal: [adj]致命的;毁灭性的;决定性的; [a]/ˈfeɪtl/; [or]gmat;
render: [v]使成为,致使,使处于(某种状态);提供,给予,以.回报;(以某种方式)表达,表现;翻译;粉刷,往(墙上)抹灰;将(脂肪)熬成油,使熔化; [n]粉刷,打底,交纳; [a]/ˈrendər/; [or]gmat;
commercial: [adj]商业性的,贸易的; [n]商业广告; [a]/kəˈmɜːrʃl/; [or]gmat;
domestic: [adj]国产的;国内的;家庭的;驯养的; [n]家仆;家庭纷争; [a]/dəˈmestɪk/; [or]gmat;
profit: [n]利润,盈利;益处; [v]得益,有益于; [a]/ˈprɑːfɪt/; [or]gmat;
hitherto: [adv]到目前为止,迄今为止; [a]/ˌhɪðərˈtuː/; [or]gmat;
frame: [n]构架,框,结构,体格; [v]表达;制定;拟订;陷害;构成,制定,给..装框架;使..适合; [a]/freɪm/; [or]gmat;
substance: [n]物质;实质,本质;药物; [a]/ˈsʌbstəns/; [or]gmat;
division: [n]分,分配,除法,部门,分裂; [a]/dɪˈvɪʒn/; [or]gmat;
rear: [n]后部; [adj]背面的; [v]抚养,举起; [a]/rɪr/; [or]gmat;
community: [n]社区;团体;(生)群落;人群,很多个体的集合体; [a]/kəˈmjuːnəti/; [or]gmat;
scheme: [n]方案,计划;阴谋,诡计; [v]图谋,密谋; [adj]计划的; [a]/skiːm/; [or]gmat;
equivalent: [adj]相等的;等值的; [n]同义词;等价物; [a]/ɪˈkwɪvələnt/; [or]gmat;
drastic: [adj]极端的;猛烈的;激烈的; [a]/ˈdræstɪk/; [or]gmat;
cabin: [n](简陋的)小屋;船舱;客舱,机舱; [v]住在小屋里; [a]/ˈkæbɪn/; [or]gmat;
cease: [v]停止,结束; [n]停止,停息; [a]/siːs/; [or]gmat;
permanent: [adj]永久的,持久的; [n]电烫发; [a]/ˈpɜːrmənənt/; [or]gmat;
preserve: [v]贮鲜,保鲜;保存;保护; [n]独揽之事,独占的活动; [a]/prɪˈzɜːrv/; [or]gmat;
burden: [n]负担,重担; [v]使负重,装载;烦扰; [a]/ˈbɜːrdn/; [or]gmat;
district: [n]地区;区域; [vt]把..划分成区; [a]/ˈdɪstrɪkt/; [or]gmat;
sentiment: [n]感情;情绪; [a]/ˈsentɪmənt/; [or]gmat;
grant: [v]给予,许可,授予;承认; [n]许可;拨款,补助金; [a]/ɡrænt/; [or]gmat;
enormous: [adj]极大的,极大量的;巨大的;庞大的; [a]/ɪˈnɔːrməs/; [or]gmat;
conviction: [n]定罪;信服;坚强信念; [a]/kənˈvɪkʃn/; [or]gmat;
yield: [v]出产;屈服;弯曲;让行; [n]收益; [a]/jiːld/; [or]gmat;
instrument: [n]仪器;工具;乐器;手段; [a]/ˈɪnstrəmənt/; [or]gmat;
idle: [adj]空闲的;懒散的; [v]无所事事;虚度;空转;使空转; [vt]虚度; [a]/ˈaɪdl/; [or]gmat;
permit: [vt]允许,许可; [n]执照; [v]使可能; [a]/pərˈmɪt/; [or]gmat;
sovereign: [adj]至高无上的,具有独立主权的,有最高统治权的; [n]最高统治者,君主,元首; [a]/ˈsɑːvrən/; [or]gmat;
shelter: [n]隐蔽处,躲避处(常用来指住处);庇护; [v]遮蔽,掩护,庇护; [a]/ˈʃeltər/; [or]gmat;
territory: [n]地区,领土;版图;领域;范围;属地; [a]/ˈterətɔːri/; [or]gmat;
prospect: [n]前景,展望;视野;景象; [v]勘察;有前途;勘探;对..进行仔细调查; [a]/ˈprɑːspekt/; [or]gmat;
profound: [adj]深刻的;知识渊博的;深奥的;极度的,完全的;深远的;渊博的; [n]深渊;深海; [a]/prəˈfaʊnd/; [or]gmat;
exceedingly: [adv]过分地;非常; [a]/ɪkˈsiːdɪŋli/; [or]gmat;
folly: [n]愚蠢; [a]/ˈfɑːli/; [or]gmat;
uniform: [n]制服,军服; [adj]相同的,一致的,统一的; [a]/ˈjuːnɪfɔːrm/; [or]gmat;
venture: [n]企业;(商业)冒险;投机,风险投资; [vi]冒险前进; [vt]冒.的危险;以.做赌注; [a]/ˈventʃər/; [or]gmat;
perceive: [v]意识到,察觉,发觉;看待,理解; [a]/pərˈsiːv/; [or]gmat;
version: [n]版本;译文;(某人对于某件事不同于其他人的)描述,说法; [a]/ˈvɜːrʒn/; [or]gmat;
vague: [adj]含糊的,模糊的,不明确的,茫然的; [n]模糊不定状态; [a]/veɪɡ/; [or]gmat;
odd: [adj]奇怪的;古怪的;奇数的;多种多样的;临时的; [n]奇特的事物;怪人;[高尔夫球]多于对方的一次击球; [adv](用于数字后)大约,左右,略多; [a]/ɑːd/; [or]gmat;
sensible: [adj]明智的,理智的;可觉察的;实用耐穿的; [a]/ˈsensəbl/; [or]gmat;
capacity: [n]产能;容量;本领;才能;负载量;职位; [a]/kəˈpæsəti/; [or]gmat;
council: [n]议会;理事会;委员会; [a]/ˈkaʊnsl/; [or]gmat;
charity: [n]慈善团体;慈善;仁慈;施舍; [a]/ˈtʃærəti/; [or]gmat;
bar: [n]酒吧;(金属)棒;闩;障碍;柜台; [vt]阻挡;禁止;闩住; prep. 除.之外; [a]/bɑːr/; [or]gmat;
derive: [v]获取;得自;起源; [a]/dɪˈraɪv/; [or]gmat;
bid: [n]出价;投标;努力争取; [v]出价;投标;问候;道别;吩咐; [a]/bɪd/; [or]gmat;
interior: [adj]内部的; [n]内部,内心; [a]/ɪnˈtɪriər/; [or]gmat;
scarce: [adj]缺乏的,不足的;稀少的,罕见的; [adv]仅仅,几乎不; [a]/skers/; [or]gmat;
supreme: [adj]至高的;最重要的;极度的; [a]/suːˈpriːm/; [or]gmat;
strain: [n]负担;紧张;拉力;(生物体)品种,种类; [v]拉紧;劳累;过分使用; [a]/streɪn/; [or]gmat;
intimate: [adj]亲密的,密切的;详细的; [v]暗示;宣布,通知; [n]密友,知己; [a]/ˈɪntɪmət/; [or]gmat;
enterprise: [n]企业(或事业)单位,公司;事业;事业心; [a]/ˈentərpraɪz/; [or]gmat;
format: [n]版式;设计;格式; [v]设计一个版式;使格式化;设计.的版面; [a]/ˈfɔːrmæt/; [or]gmat;
scale: [n]天平,磅秤;刻度,尺度,标度;等级,级别, 等级体系;鳞片,鳞状物;规模;水垢,牙垢; [v]攀登;按比例决定;称重;刮鳞,剥落; [a]/skeɪl/; [or]gmat;
average: [n]平均数,平均水平; [adj]通常的,一般的;平均的; [v]平均为; [a]/ˈævərɪdʒ/; [or]gmat;
concern: [n]关心,担忧; [v]感兴趣,涉及,关心,(使)担忧; [a]/kənˈsɜːrn/; [or]gmat;
campaign: [n](社会性,政治性)活动,运动;战役; [v]从事活动,参加运动; [a]/kæmˈpeɪn/; [or]gmat;
indignation: [n]愤慨; [a]/ˌɪndɪɡˈneɪʃn/; [or]gmat;
gloomy: [adj]愁容满面的,阴暗的,没有希望的; [a]/ˈɡluːmi/; [or]gmat;
victim: [n]牺牲品,受害者,替罪羊; [a]/ˈvɪktɪm/; [or]gmat;
absurd: [adj]荒唐的;可笑的;不合理的; [n]荒唐; [a]/əbˈsɜːrd/; [or]gmat;
pronounced: [adj]非常明显的;显著的;断然的; [v]发音;宣告;断言; [a]/prəˈnaʊnst/; [or]gmat;
obedience: [n]服从,顺从; [a]/oʊˈbiːdiəns/; [or]gmat;
succession: [n]连续,继续;一连串;继承权; [a]/səkˈseʃn/; [or]gmat;
resist: [v]抗拒;抵抗,抵制; [a]/rɪˈzɪst/; [or]gmat;
commission: [n]委员会;任务;权限;委任;销售佣金; [v]委任; [a]/kəˈmɪʃn/; [or]gmat;
merchant: [n]商人;批发商; [a]/ˈmɜːrtʃənt/; [or]gmat;
solitary: [adj]孤独的,单独的,隐居的; [n]独居者,隐士;单独禁闭; [a]/ˈsɑːləteri/; [or]gmat;
vanity: [n]自负;无价值的东西;(带镜子的)梳妆台; [a]/ˈvænəti/; [or]gmat;
lane: [n]小径,巷,行车道; [a]/leɪn/; [or]gmat;
testimony: [n]证据,证词;表明,说明;见证,证明; [a]/ˈtestɪmoʊni/; [or]gmat;
suspect: [n]嫌疑犯,可疑分子; [v]怀疑,猜疑;推测; [adj]可疑的; [a]/səˈspekt/; [or]gmat;
feeble: [adj]虚弱的; [a]/ˈfiːbl/; [or]gmat;
prophet: [n]先知,预言者; [a]/ˈprɑːfɪt/; [or]gmat;
rival: [n]竞争者,对手; [v]与.竞争,与.匹敌; [adj]竞争的,敌对的; [a]/ˈraɪvl/; [or]gmat;
foe: [n]敌人,敌军;危害物; [a]/foʊ/; [or]gmat;
recall: [v]回想起,记起,回忆;召回; [n]召回(有问题的产品); [a]/rɪˈkɔːl/; [or]gmat;
novel: [n]小说,长篇故事; [adj]新奇的,新颖的,不同的; [a]/ˈnɑːvl/; [or]gmat;
inferior: [adj](等级,地位等)下等的,低等的;低劣的; [n]部下,地位低的人;次品; [a]/ɪnˈfɪriər/; [or]gmat;
portrait: [n]肖像,(人物)描写,标本; [a]/ˈpɔːrtrət/; [or]gmat;
responsible: [adj]有责任,负责的; [a]/rɪˈspɑːnsəbl/; [or]gmat;
vengeance: [n]复仇,报仇; [a]/ˈvendʒəns/; [or]gmat;
indifference: [n]不关心,冷淡; [a]/ɪnˈdɪfrəns/; [or]gmat;
assume: [v]猜想;以为,假设;呈现;就职;(想当然地)认为;承担(责任); [a]/əˈsuːm/; [or]gmat;
estimate: [v]估价,估计,评价; [n]估计,评价; [a]/ˈestɪmət/; [or]gmat;
steep: [v]沉浸于..; [adj]陡峭的;急剧的;过高的; [n]陡坡; [a]/stiːp/; [or]gmat;
mutual: [adj]互相的;彼此的;共同的; [a]/ˈmjuːtʃuəl/; [or]gmat;
scorn: [n]鄙视; [v]轻蔑;对.不屑一顾; [a]/skɔːrn/; [or]gmat;
external: [adj]外面的,外部的;外国的; [a]/ɪkˈstɜːrnl/; [or]gmat;
receipt: [n]收据,收条;收入;收到; [a]/rɪˈsiːt/; [or]gmat;
discipline: [n]纪律;学科;训练; [v]训练;惩罚;管制; [a]/ˈdɪsəplɪn/; [or]gmat;
slip: [v]滑倒,跌落,溜走,疏忽;偷偷地给;被遗忘; [n]溜走;疏忽,错误;纸条; [adj]打有活结的;可拆卸的;滑动的; [a]/slɪp/; [or]gmat;
revolution: [n]革命;旋转; [a]/ˌrevəˈluːʃn/; [or]gmat;
stroke: [n]击打;一击,一次,一举;中风;抚摸;笔画; [v]拭去;轻抚; [a]/stroʊk/; [or]gmat;
exquisite: [adj]精致的,精选的;细腻的;强烈的; [n]过分讲究穿戴的人; [a]/ɪkˈskwɪzɪt/; [or]gmat;
platform: [n]站台;平台;讲台;舞台;论坛; [a]/ˈplætfɔːrm/; [or]gmat;
privilege: [n]特权,优待;荣幸; [v]给..特权; [a]/ˈprɪvəlɪdʒ/; [or]gmat;
convey: [v]传送,运送;表达,传达; [a]/kənˈveɪ/; [or]gmat;
sensation: [n]感觉;知觉;轰动; [a]/senˈseɪʃn/; [or]gmat;
submit: [v]提交;屈服,使...服从;建议,主张; [a]/səbˈmɪt/; [or]gmat;
tragedy: [n]悲剧; [a]/ˈtrædʒədi/; [or]gmat;
specific: [adj]具体的,明确的;特定的;特殊的;针对..的; [n]详情;特性; [a]/spəˈsɪfɪk/; [or]gmat;
virgin: [n]处女;处男;贞女; [adj]处女的; [a]/ˈvɜːrdʒɪn/; [or]gmat;
proprietary: [adj]所有的;专利的;私人拥有的; [n]所有权;所有物;所有人; [a]/prəˈpraɪəteri/; [or]gmat;
customs: [n]海关;风俗;关税; [adj]定做的;专做定货的; [a]/ˈkʌstəmz/; [or]gmat;
inevitable: [adj]不可避免的,必然的; [n]必然发生的事; [a]/ɪnˈevɪtəbl/; [or]gmat;
reserve: [n]储备;保留;保护区; [v]保留;预定;储备; [a]/rɪˈzɜːrv/; [or]gmat;
bark: [v]狗吠;厉声发令; [n]树皮;吠声; [a]/bɑːrk/; [or]gmat;
reception: [n]前台,接待处,接收,欢迎,招待会; [a]/rɪˈsepʃn/; [or]gmat;
abruptly: [adv]突然地,无礼地; [a]/əˈbrʌptli/; [or]gmat;
dwelling: [n]住所; [a]/ˈdwelɪŋ/; [or]gmat;
depart: [v]离开;起程;出发;起程;出发;离职; [a]/dɪˈpɑːrt/; [or]gmat;
reverence: [n]崇敬,尊严,敬礼; [v]敬畏,尊敬; [a]/ˈrevərəns/; [or]gmat;
conceive: [v]怀孕;设想,想出; [a]/kənˈsiːv/; [or]gmat;
fetch: [v]取来;接来;使发出;售得;带来;接住; [n]拿来,取来;诡计;风浪区; [a]/fetʃ/; [or]gmat;
hint: [v]作暗示;透露; [n]暗示,示意;建议; [a]/hɪnt/; [or]gmat;
solicit: [v]乞求,恳求给予(帮助,金钱); [a]/səˈlɪsɪt/; [or]gmat;
derivative: [n]派生物;[化学]衍生物; [adj]被引申出的,被诱导的;衍生的;第二手的; [a]/dɪˈrɪvətɪv/; [or]gmat;
primitive: [adj]原始的;简陋的; [n]原始人; [a]/ˈprɪmətɪv/; [or]gmat;
deserve: [v]值得,应得;应受; [a]/dɪˈzɜːrv/; [or]gmat;
plot: [n]情节,阴谋,小块土地; [v]密谋,计划,为小说写情节; [a]/plɑːt/; [or]gmat;
modest: [adj]谦虚的,谦逊的;端庄的,羞怯的;不太大(或太贵,太重要)的,适度的; [a]/ˈmɑːdɪst/; [or]gmat;
tremendous: [adj]巨大的;极大的;惊人的; [a]/trəˈmendəs/; [or]gmat;
treasury: [n]国库,金库;财政部;宝库; [a]/ˈtreʒəri/; [or]gmat;
shield: [n]盾牌;防护物; [v]保护; [a]/ʃiːld/; [or]gmat;
distinguish: [v]区别,识别,辨别,使显著; [a]/dɪˈstɪŋɡwɪʃ/; [or]gmat;
esteem: [n]尊敬;尊重; [vt]尊敬;认为;考虑;估计; [a]/ɪˈstiːm/; [or]gmat;
restore: [v]恢复;修补;归还; [a]/rɪˈstɔːr/; [or]gmat;
temporary: [adj]暂时的,临时的; [a]/ˈtempəreri/; [or]gmat;
reproach: [v]责备,指责; [n]指责; [a]/rɪˈproʊtʃ/; [or]gmat;
federal: [adj]联邦制的;联邦政府的; [a]/ˈfedərəl/; [or]gmat;
remedy: [v]治疗;恢复;补救; [n]治疗;补救;矫正; [a]/ˈremədi/; [or]gmat;
pursue: [v]进行,从事;追求,追赶; [a]/pərˈsuː/; [or]gmat;
representative: [n]代表;代理; [adj]典型的,有代表性的; [a]/ˌreprɪˈzentətɪv/; [or]gmat;
siege: [n]围困;包围; [a]/siːdʒ/; [or]gmat;
modification: [n]修改,改进,改造; [a]/ˌmɑːdɪfɪˈkeɪʃn/; [or]gmat;
brass: [n]黄铜(器);铜管乐器;[口语]厚脸皮;高级将领官员;黄铜; [v]付(款); [a]/bræs/; [or]gmat;
obscure: [v]隐藏,使.模糊;使变暗;遮掩; [adj]不清楚的;难以理解的; [n]某种模糊的或不清楚的东西; [a]/əbˈskjʊr/; [or]gmat;
summit: [n]山顶,顶点;(政府间的)峰会; [a]/ˈsʌmɪt/; [or]gmat;
center: [n]中央,中心; [v]集中;居中; [a]/ˈsentər/; [or]gmat;
alter: [v]改变;改动,使变样;改做; [a]/ˈɔːltər/; [or]gmat;
contract: [n]合同,契约; [v]感染(疾病);招致;订合同;订立(婚约);缩减; [a]/ˈkɑːntrækt/; [or]gmat;
combination: [n]结合,联合,组合;(保险锁等的)暗码; [a]/ˌkɑːmbɪˈneɪʃn/; [or]gmat;
intent: [adj]全神贯注的;专心致志的; [n]意图;意向;目的; [a]/ɪnˈtent/; [or]gmat;
corps: [n](由两个或以上师组成的)军,兵团;一群人;特别小组; [a]/kɔːr/; [or]gmat;
institution: [n]机构;制度;惯例;习俗;建立,设立,制定; [a]/ˌɪnstɪˈtuːʃn/; [or]gmat;
capture: [v]捕获,俘获;俘虏;掌控;使迷住;捕捉,留存; [n]战利品; [a]/ˈkæptʃər/; [or]gmat;
ample: [adj]富足的,丰满的,宽敞的; [a]/ˈæmpl/; [or]gmat;
identify: [v]认出,联系;识别;确定,鉴定,发现;认为.等同,认为.关系紧密;表明.的身份;认同,有共鸣,有同感; [a]/aɪˈdentɪfaɪ/; [or]gmat;
discharge: [n]发射;释放;解雇;放电; [v]卸掉负担;发射;放电;卸(货);使爆炸;履行;解雇;允许.离开;排出,放出;清偿(债务); [a]/dɪsˈtʃɑːrdʒ/; [or]gmat;
interval: [n]间隔;中场休息,幕间休息;间距; [a]/ˈɪntərvl/; [or]gmat;
occupy: [v]占领,占据,侵占;住在,居住,住进;担任(职务),任职;占用(时间,空间等),占有;使用(房屋,建筑); [a]/ˈɑːkjupaɪ/; [or]gmat;
foul: [adj]难闻的,发臭的;糟透了的;污秽的;犯规的; [n]犯规; [vi]犯规; [vt]弄脏,使污秽;使纠缠; [a]/faʊl/; [or]gmat;
subsequent: [adj]随后的; [a]/ˈsʌbsɪkwənt/; [or]gmat;
formidable: [adj]令人畏惧的;可怕的;难以克服的;难应付的; [a]/ˈfɔːrmɪdəbl/; [or]gmat;
product: [n]产品,产物;(乘)积; [a]/ˈprɑːdʌkt/; [or]gmat;
economic: [adj]经济上的,经济学的;合算的;有利可图的; [a]/ˌekəˈnɑːmɪk/; [or]gmat;
subtle: [adj]微妙的;敏锐的;不明显的;精细的;狡猾的; [a]/ˈsʌtl/; [or]gmat;
slope: [n]山坡,斜坡,倾斜; [v]倾斜; [a]/sloʊp/; [or]gmat;
heed: [vt]注意;留心; [v]注意; [vi]留心; [n]注意;留心; [a]/hiːd/; [or]gmat;
calculate: [vt]计算;估计;计划; [vi]计算;估计; [a]/ˈkælkjuleɪt/; [or]gmat;
dine: [v]吃饭,用餐;招待..吃饭;用正餐(晚餐); [a]/daɪn/; [or]gmat;
sensitive: [adj]敏感的,过敏的;灵敏的;善解人意的,体恤的; [a]/ˈsensətɪv/; [or]gmat;
robin: [n]欧鸲,知更鸟; [a]/ˈrɑːbɪn/; [or]gmat;
appetite: [n]食欲,胃口;欲望; [a]/ˈæpɪtaɪt/; [or]gmat;
courtesy: [n]礼貌; [a]/ˈkɜːrtəsi/; [or]gmat;
sphere: [n]球;球形;领域; [a]/sfɪr/; [or]gmat;
welfare: [n]福利;幸福,健康; [a]/ˈwelfer/; [or]gmat;
perish: [vi]死去;毁灭,灭亡; [v]脆裂,老化,腐烂; [a]/ˈperɪʃ/; [or]gmat;
encounter: [v]邂逅,遭遇,偶遇; [n]偶然碰见,遭遇; [a]/ɪnˈkaʊntər/; [or]gmat;
amiable: [adj]和蔼的,亲切的;温和的; [a]/ˈeɪmiəbl/; [or]gmat;
economy: [n]经济,经济制度;节约; [a]/ɪˈkɑːnəmi/; [or]gmat;
parallel: [adj]平行的;相似的; [n]相似物;平行线; [v]与..相似;与..匹配; [adv]并行地,平行地; [a]/ˈpærəlel/; [or]gmat;
frontier: [n]边境,边疆;新领域;<美>边远地区,边界地区; [adj]开拓的; [a]/frʌnˈtɪr/; [or]gmat;
decent: [adj]体面的;像样的;合宜的;正直的; [a]/ˈdiːsnt/; [or]gmat;
artificial: [adj]人造的,人工的,假的;假装的,虚伪的; [n]人造肥料;<美>假花; [a]/ˌɑːrtɪˈfɪʃl/; [or]gmat;
naval: [adj]海军的,军舰的; [a]/ˈneɪvl/; [or]gmat;
abundant: [adj]丰富的;大量的; [a]/əˈbʌndənt/; [or]gmat;
clergy: [n]教牧人员,神职人员; [a]/ˈklɜːrdʒi/; [or]gmat;
mount: [v]登上;爬上;骑上;增长;组织,安排; [n]山;峰; [a]/maʊnt/; [or]gmat;
array: [n]一系列;陈列;编队; [v]排列;部署; [a]/əˈreɪ/; [or]gmat;
landscape: [n]风景;风景画;景观;横向打印格式; [v]美化环境; [a]/ˈlændskeɪp/; [or]gmat;
sue: [v]控告,提起诉讼;控告;起诉; [n]女子名(Sue); [a]/suː/; [or]gmat;
maximum: [n]最大值;最大限度; [adj]最大的; [a]/ˈmæksɪməm/; [or]gmat;
commit: [v]犯(罪);进行 (自杀);调拨 (钱,资源);监禁;送交 (到精神病院,监狱等);承诺,保证; [a]/kəˈmɪt/; [or]gmat;
miracle: [n]奇迹; [a]/ˈmɪrəkl/; [or]gmat;
tariff: [n]关税,价目表; [vt]征收关税;定税率;定收费标准; [a]/ˈtærɪf/; [or]gmat;
extend: [v]伸展,展开;延伸;涉及;扩展;提供;使.竭尽全力; [a]/ɪkˈstend/; [or]gmat;
copper: [n]铜;铜币;警官;铜色;铜(制); [a]/ˈkɑːpər/; [or]gmat;
imperial: [adj]帝王的,壮丽的,至尊的; [n]帝国,皇家; [a]/ɪmˈpɪriəl/; [or]gmat;
victor: [n]胜利者; [adj]胜利者的; [a]/ˈvɪktər/; [or]gmat;
bargain: [n]交易,特价商品;便宜货;契约; [vi]讨价还价,讲价;成交; [vt]经讨价还价成交;用.交换; [adj](价格),低廉的; [a]/ˈbɑːrɡən/; [or]gmat;
sketch: [n]梗概,素描; [v]速写,打草稿; [a]/sketʃ/; [or]gmat;
virtuous: [adj]善良的,有德行的,贞洁的; [a]/ˈvɜːrtʃuəs/; [or]gmat;
retain: [v]保持,保留,保存;聘请; [a]/rɪˈteɪn/; [or]gmat;
mob: [n]乌合之众,(尤指)暴民; [v](指民众)包围(为攻击或赞赏); [a]/mɑːb/; [or]gmat;
palm: [n]手掌,手心,棕榈树; [a]/pɑːm/; [or]gmat;
tribute: [n]致敬;悼念;贡品;称赞; [a]/ˈtrɪbjuːt/; [or]gmat;
procure: [vt](努力)取得;获得;导致;完成; [vi]介绍娼妓;拉皮条; [a]/prəˈkjʊr/; [or]gmat;
relieve: [v]消除,减轻;换班; [a]/rɪˈliːv/; [or]gmat;
project: [n]项目,工程;专题研究;课题方案; [v]映射,放映;计划,设计,打算,拟订方案;投掷,发射,喷射;表明..的特性,使呈现特性;阐述;突出,伸出;估计,预估; [a]/ˈprɑːdʒekt/; [or]gmat;
threshold: [n]门槛;开端; [a]/ˈθreʃhoʊld/; [or]gmat;
session: [n]一段时间的(活动);(法庭的)开庭;(议会等的)开会;学期;讲习会; [adj]为录音的歌手或乐队伴奏的; [a]/ˈseʃn/; [or]gmat;
torture: [v]对.施以酷刑,拷问,折磨; [n]酷刑,折磨; [adj]遭受重创的;饱受煎熬的; [a]/ˈtɔːrtʃər/; [or]gmat;
ridge: [n]脊,岭,山脉,垄; [a]/rɪdʒ/; [or]gmat;
spoil: [v]溺爱;娇惯;(食物)变质;毁坏; [n]溺爱;战利品;犒劳;成功所带来的好处; [a]/spɔɪl/; [or]gmat;
liable: [adj](for)有责任的;有义务的;(to)有.倾向的;易于.的,有可能.; [a]/ˈlaɪəbl/; [or]gmat;
ardent: [adj]热心的,热烈的; [a]/ˈɑːrdnt/; [or]gmat;
prejudice: [n]偏见;成见;损害;侵害; [vt]使抱偏见; [a]/ˈpredʒudɪs/; [or]gmat;
probability: [n]可能性;几率,概率; [a]/ˌprɑːbəˈbɪləti/; [or]gmat;
strife: [n]纷争,倾轧; [a]/straɪf/; [or]gmat;
disturb: [v]打扰,妨碍;弄乱;使烦恼; [a]/dɪˈstɜːrb/; [or]gmat;
flock: [n](鸟兽)群;一群人;(对牧师而言的)教徒; [v]聚集,成群而行; [a]/flɑːk/; [or]gmat;
faculty: [n]教职工,全体教员;系;科;能力; [a]/ˈfæklti/; [or]gmat;
cannon: [n]大炮;机关炮; [v]相撞;开炮; [a]/ˈkænən/; [or]gmat;
manuscript: [n]手稿;底稿;手抄本; [a]/ˈmænjuskrɪpt/; [or]gmat;
warrior: [n]战士,武士,勇士; [a]/ˈwɔːriər/; [or]gmat;
combat: [n]战斗,格斗; [v]与.战斗,与.斗争; [adj]战斗的; [a]/ˈkɑːmbæt/; [or]gmat;
cliff: [n]悬崖;峭壁; [a]/klɪf/; [or]gmat;
adopt: [v]收养;采纳,采用; [a]/əˈdɑːpt/; [or]gmat;
revenue: [n]收入;财政收入;国家的税收; [a]/ˈrevənuː/; [or]gmat;
subscribe: [vi]捐款;订阅;认购(股份); [vt]申请; [a]/səbˈskraɪb/; [or]gmat;
transcribe: [v]抄写,转录; [a]/trænˈskraɪb/; [or]gmat;
descend: [vi]走下;降临; [v]下降,下来;突然访问;下移,下降; [a]/dɪˈsend/; [or]gmat;
disaster: [n]灾难,天灾; [a]/dɪˈzæstər/; [or]gmat;
entertainment: [n]娱乐;招待,款待; [a]/ˌentərˈteɪnmənt/; [or]gmat;
engage: [vt]吸引住(注意力,兴趣);雇,聘; [vi]使加入,使融入;订婚; [v](军队)交战;啮合; [a]/ɪnˈɡeɪdʒ/; [or]gmat;
herd: [n]兽群,牧群; [v]放牧,群集; [a]/hɜːrd/; [or]gmat;
attain: [v]获得;达到(某个年纪,水平,条件);实现; [n]成就; [a]/əˈteɪn/; [or]gmat;
convert: [v]可转变为,可变换成;改变,转变,转化;使改变信仰; [n]皈依者;改变宗教信仰者; [a]/kənˈvɜːrt/; [or]gmat;
outline: [n]外形,轮廓;大纲,概要; [v]描绘,画出..的轮廓; [a]/ˈaʊtlaɪn/; [or]gmat;
comprehend: [v]由.组成;了解;领会;包含; [a]/ˌkɑːmprɪˈhend/; [or]gmat;
withdraw: [v]取款;撤退,收回,撤离; [a]/wɪðˈdrɔː/; [or]gmat;
compassion: [n]同情;怜悯; [a]/kəmˈpæʃn/; [or]gmat;
latitude: [n]纬度;地区;(言论,行动的)自由; [a]/ˈlætɪtuːd/; [or]gmat;
betray: [v]背叛;失信于;泄露(秘密等);(非故意地)暴露; [a]/bɪˈtreɪ/; [or]gmat;
disguise: [v]伪装;掩饰; [n]伪装物;伪装; [a]/dɪsˈɡaɪz/; [or]gmat;
block: [v]阻挡;妨碍;阻塞; [n]街区;块状物;积木;阻碍;大厦; [a]/blɑːk/; [or]gmat;
barren: [adj]贫瘠的,不孕的; [n]荒原,不毛之地; [a]/ˈbærən/; [or]gmat;
dense: [adj](物质) 密度大的;稠密的,浓密的;愚钝的;难懂的,费解的; [a]/dens/; [or]gmat;
fiction: [n]虚构;想象;小说; [a]/ˈfɪkʃn/; [or]gmat;
recommend: [v]推荐,介绍;劝告,建议; [a]/ˌrekəˈmend/; [or]gmat;
lodge: [v]住宿;存放,保管; [n]小屋;兽穴; [a]/lɑːdʒ/; [or]gmat;
disorder: [n]混乱;紊乱;动乱; [vt]使混乱;使紊乱; [a]/dɪsˈɔːrdər/; [or]gmat;
sheer: [adj]陡峭的;纯粹的; [v](off)急转向,偏离; [n]透明薄纱,透明布料的衣服; [adv]完全地,全然;垂直地,陡峭地; [a]/ʃɪr/; [or]gmat;
fare: [n]交通费;票价;食物;出租车乘客; [v](事情)进行得(好或坏); [a]/fer/; [or]gmat;
binary: [adj]二进位的,二元的; [n]一双;双体;二进制数;双子星; [a]/ˈbaɪnəri/; [or]gmat;
elaborate: [adj]精心设计的,精巧的;复杂的; [v]详细说明,详尽阐述; [vt]变得复杂; [a]/ɪˈlæbəreɪt/; [or]gmat;
essence: [n]本质,实质;精髓,精华; [a]/ˈesns/; [or]gmat;
realm: [n]王国;领域;国土; [a]/relm/; [or]gmat;
accord: [n]协议; [v]授予; [a]/əˈkɔːrd/; [or]gmat;
exile: [n]流亡国外;流放,充军; [vt]使流亡,放逐;使离乡背井; [a]/ˈeksaɪl/; [or]gmat;
arch: [n]拱洞;拱门;拱起; [v]做成拱形; [adj]调皮的,淘气的; [a]/ɑːrtʃ/; [or]gmat;
respective: [adj]各自的; [a]/rɪˈspektɪv/; [or]gmat;
consult: [v]请教,咨询;查阅;商量; [a]/kənˈsʌlt/; [or]gmat;
doom: [v]注定;命定; [n]毁灭;厄运;劫数; [a]/duːm/; [or]gmat;
scent: [n]气味;香味;迹象; [v]嗅到;察觉; [a]/sent/; [or]gmat;
cultivation: [n]耕种,种植;培养,教化;文雅; [a]/ˌkʌltɪˈveɪʃn/; [or]gmat;
rigid: [adj]坚硬的;僵硬的;死板的; [a]/ˈrɪdʒɪd/; [or]gmat;
venerable: [adj]令人尊敬的;(因历史悠久而) 神圣庄严的; [a]/ˈvenərəbl/; [or]gmat;
swell: [v](使)膨胀,(使)鼓起; [n]增大,膨胀,肿胀,汹涌; [adj]时髦的;一流的;很好的; [a]/swel/; [or]gmat;
wreck: [n]沉船,失事船;失事;(事故中)遭严重损坏的汽车(飞机等); [v]破坏,使毁灭; [a]/rek/; [or]gmat;
convince: [v]使确信;使信服; [a]/kənˈvɪns/; [or]gmat;
congregation: [n]集合在一起的群众; [a]/ˌkɑːŋɡrɪˈɡeɪʃn/; [or]gmat;
theme: [n]主题;主旨;主旋律; [adj]主题的; [v]赋予.某种主题; [a]/θiːm/; [or]gmat;
eloquent: [adj]有口才的;雄辩的;演说动人的; [a]/ˈeləkwənt/; [or]gmat;
rational: [adj]理性的;理智的;合理的; [a]/ˈræʃnəl/; [or]gmat;
accurate: [adj]精确的;正确的;符合标准的; [a]/ˈækjərət/; [or]gmat;
resort: [vi]采取;求助; [n]求助;凭借;诉诸,采取;度假胜地; [a]/rɪˈzɔːrt/; [or]gmat;
bond: [n]束缚物,联结物;凝聚力;债券;保释金;联系; [vi]结合;团结一致; [a]/bɑːnd/; [or]gmat;
vicinity: [n]附近地区;近邻;附近; [a]/vəˈsɪnəti/; [or]gmat;
ingenious: [adj]聪明的;有发明天才的;有独创性的,别出心裁的; [a]/ɪnˈdʒiːniəs/; [or]gmat;
vacant: [adj]空的,未被占用的;闲置的;空缺的;茫然的; [a]/ˈveɪkənt/; [or]gmat;
antiquity: [n]古代,古时候(尤指古希腊和古罗马时期);古代的遗物,古物; [a]/ænˈtɪkwəti/; [or]gmat;
despise: [vt]轻视,蔑视,看不起; [a]/dɪˈspaɪz/; [or]gmat;
ultimate: [adj]根本的;最后的,最终的; [a]/ˈʌltɪmət/; [or]gmat;
entry: [n]入口处;登记;进入; [a]/ˈentri/; [or]gmat;
hardy: [adj](植物)耐寒的;能吃苦耐劳的;勇敢的; [n]强壮的人; [a]/ˈhɑːrdi/; [or]gmat;
captive: [adj]被捕获的;被俘虏的; [n]俘虏; [a]/ˈkæptɪv/; [or]gmat;
adjoining: [adj]毗邻的; [a]/əˈdʒɔɪnɪŋ/; [or]gmat;
cathedral: [n]大教堂; [adj]有权威的;大教堂的; [a]/kəˈθiːdrəl/; [or]gmat;
plague: [n]瘟疫;灾难;麻烦; [v]折磨;烦扰;造成麻烦; [a]/pleɪɡ/; [or]gmat;
apparatus: [n]装置,仪器;设备;组织,机构; [a]/ˌæpəˈrætəs/; [or]gmat;
assert: [v]断言;肯定地说;坚持;维护; [a]/əˈsɜːrt/; [or]gmat;
dismay: [n]失望;沮丧;惊愕; [v]使惊恐; [a]/dɪsˈmeɪ/; [or]gmat;
navy: [n]海军; [a]/ˈneɪvi/; [or]gmat;
fortress: [n]堡垒;要塞; [a]/ˈfɔːrtrəs/; [or]gmat;
acquire: [v](尤指靠自己的努力或行动或经过一个过程)获得;学到;取得; [a]/əˈkwaɪər/; [or]gmat;
mask: [n]面具;遮蔽物;伪装; [v]隐藏(感情);掩盖,掩饰,掩护;伪装; [a]/mæsk/; [or]gmat;
parlor: [n]店,营业室,客厅; [adj]客厅的; [a]/'pɑːlə/; [or]gmat;
perception: [n]洞察力,理解力;洞察力,理解力,认识,观念,看法; [a]/pərˈsepʃn/; [or]gmat;
function: [n]功能,作用;函数;应变量;盛大聚会;职务,职责; [v]起作用;正常运转; [a]/ˈfʌŋkʃn/; [or]gmat;
excessive: [adj]过多的; [a]/ɪkˈsesɪv/; [or]gmat;
bind: [v]捆绑;装订;约束;结合; [n]窘境,困境;讨厌的事情;捆绑;植物的藤蔓; [a]/baɪnd/; [or]gmat;
identical: [adj]相同的,同样的,一模一样的;相似的; [n]完全相同的事物; [a]/aɪˈdentɪkl/; [or]gmat;
superstition: [n]迷信,盲目恐惧; [a]/ˌsuːpərˈstɪʃn/; [or]gmat;
bulk: [n]大批;容量;体积;大块; [adj]大量的;散装的; [v]膨胀;显得重要; [a]/bʌlk/; [or]gmat;
bunch: [n]束;串;群,伙; [v]集中,挤在一起;使成一束(或一群等); [a]/bʌntʃ/; [or]gmat;
debate: [n]辩论;讨论; [v]辩论;争论;议论; [a]/dɪˈbeɪt/; [or]gmat;
corruption: [n]腐败,受贿,贪污,堕落;词的变体,变化了的形式; [a]/kəˈrʌpʃn/; [or]gmat;
partial: [adj]偏爱的,特别喜欢的;偏袒的,不公平的,有偏见的;部分的;不完全的; [n][数学]偏微商; [a]/ˈpɑːrʃl/; [or]gmat;
cabinet: [n]橱;柜;内阁; [a]/ˈkæbɪnət/; [or]gmat;
surgeon: [n]外科医生; [a]/ˈsɜːrdʒən/; [or]gmat;
abstract: [adj]抽象的; [n]摘要,抽象; [v]提取; [a]/ˈæbstrækt/; [or]gmat;
bestow: [v]给予; [a]/bɪˈstoʊ/; [or]gmat;
legitimate: [adj]合法的;合理的; [vt]使合法;授权;宣布..为合法; [a]/lɪˈdʒɪtɪmət/; [or]gmat;
approve: [v]称许,赞成,批准; [a]/əˈpruːv/; [or]gmat;
petition: [n]请愿;请愿书;祈求; [v]请愿; [a]/pəˈtɪʃn/; [or]gmat;
crack: [v]敲出裂痕,敲破;垮掉;断裂,折断;说(笑话); [n]裂缝;破裂声;挖苦话;强效纯可卡因; [adj]最好的,一流的; [adv]尖锐地; [vi]断裂,折断; [a]/kræk/; [or]gmat;
reverse: [n]失败,挫折,倒退;相反,背面; [v]颠倒,翻转; [adj]相反的,反面的,颠倒的; [a]/rɪˈvɜːrs/; [or]gmat;
survey: [n]调查;测量;鉴定; [v]测量,勘测;鉴定;调查; [a]/ˈsɜːrveɪ/; [or]gmat;
contemporary: [adj]同时代的;当代的,现代的; [n]同龄人,同时代的人; [a]/kənˈtempəreri/; [or]gmat;
deliberate: [adj]故意的;深思熟虑的;从容不迫的; [v]仔细考虑;研讨; [a]/dɪˈlɪbərət/; [or]gmat;
precise: [adj]精确的;恰好的; [a]/prɪˈsaɪs/; [or]gmat;
negative: [adj]消极的,负面的;否定的; [n]否定,否定词;底片; [a]/ˈneɡətɪv/; [or]gmat;
exclusively: [adv]专门地;特定地;排外地;仅仅; [a]/ɪkˈskluːsɪvli/; [or]gmat;
stem: [n]茎,(树)干; [v]阻止;起源于;遏制,抑制; [a]/stem/; [or]gmat;
shrill: [adj]尖声的,刺耳的; [vi]尖叫; [vt]尖叫着说; [n]尖叫声; [adv]尖声地,无节制地; [a]/ʃrɪl/; [or]gmat;
reduce: [v]减少,减小,降低,精简; [a]/rɪˈduːs/; [or]gmat;
code: [n]编码,代码;准则,法典;密码; [v]将.编码; [a]/koʊd/; [or]gmat;
dismal: [n]低落的情绪; [adj]惨淡的;沉闷的,凄凉的; [a]/ˈdɪzməl/; [or]gmat;
concert: [n]音乐会;一致;和谐,合作; [a]/ˈkɑːnsərt/; [or]gmat;
prompt: [v]提示;激起;促进,推动;敦促; [adj]迅速的,及时的; [n]提示; [a]/prɑːmpt/; [or]gmat;
paperwork: [n]日常文书工作; [a]/ˈpeɪpərwɜːrk/; [or]gmat;
inherited: [adj]遗传的(病等),继承权的,通过继承得到的; [a]/ɪnˈherɪtɪd/; [or]gmat;
bronze: [n]青铜,青铜色,青铜器; [a]/brɑːnz/; [or]gmat;
garment: [n]服装; [vt]给 ... 披上衣服;覆上...; [a]/ˈɡɑːrmənt/; [or]gmat;
hue: [n]色彩;色度,颜色;叫声; [a]/hjuː/; [or]gmat;
envelope: [n]信封;包装物,外壳,膜;气囊; [a]/ˈenvəloʊp/; [or]gmat;
startling: [adj]令人吃惊的;颜色极鲜亮的; [a]/ˈstɑːrtlɪŋ/; [or]gmat;
acute: [adj](疼痛,妒忌等)剧烈的,严重的;敏锐的;急性的;尖声的; [a]/əˈkjut/; [or]gmat;
offspring: [n]后代; [a]/ˈɔːfsprɪŋ/; [or]gmat;
indispensable: [adj]必不可少的;必需的; [a]/ˌɪndɪˈspensəbl/; [or]gmat;
grip: [v]握紧,抓牢; [n]紧握,握力; [a]/ɡrɪp/; [or]gmat;
blast: [n]一阵(疾风等);爆炸;冲击波; [v](用炸药)炸,摧毁; [a]/blæst/; [or]gmat;
diameter: [n]直径; [a]/daɪˈæmɪtər/; [or]gmat;
brutal: [adj]残忍的,粗鲁的;严酷的,难以忍受的;严峻的; [a]/ˈbruːtl/; [or]gmat;
penalty: [n]惩罚,处罚,不利,罚球; [adj]处罚的; [a]/ˈpenəlti/; [or]gmat;
corridor: [n]走廊,长条地带,回廊,通道; [a]/ˈkɔːrɪdɔːr/; [or]gmat;
alternate: [adj]交替的,轮流的,间隔的; [v](使)交替,(使)轮流; [n]代替者; [a]/ˈɔːltərnət/; [or]gmat;
identity: [n]身份;特性;一致; [a]/aɪˈdentəti/; [or]gmat;
screen: [n]屏幕,荧光屏;纱窗; [v]遮蔽;放映;检查; [a]/skriːn/; [or]gmat;
shrewd: [adj]精明的;机灵的; [n]精明;精明者; [a]/ʃruːd/; [or]gmat;
alternative: [adj]可供选择的;替代的;不寻常的; [n]可供选择的事物; [a]/ɔːlˈtɜːrnətɪv/; [or]gmat;
compact: [adj]小巧的,小型的,袖珍的,体积小的;紧密的,紧凑的,密集的; [v]把..压紧;变得坚实; [n]带镜小粉盒;合约,条约; [a]/ˈkɑːmpækt/; [or]gmat;
kin: [n]亲属; [a]/kɪn/; [or]gmat;
transport: [v]运输;使狂喜;流放; [n]运输;运输工具;流放犯; [a]/ˈtrænspɔːrt/; [or]gmat;
manufacture: [v]生产;制造; [n]制造,生产;制造业;(复)产品; [a]/ˌmænjuˈfæktʃər/; [or]gmat;
quest: [n]探索,寻求; [v]寻找,搜索; [a]/kwest/; [or]gmat;
crest: [n]鸟冠,盔上的装饰(如羽毛),顶部,顶峰; [v]到达绝顶,加以顶饰; [a]/krest/; [or]gmat;
constitute: [v]构成,组成;任命; [a]/ˈkɑːnstətuːt/; [or]gmat;
complex: [adj]复杂的,难解的;复合的; [n]情结;建筑群;综合体,集合体; [a]/ˈkɑːmpleks/; [or]gmat;
controversy: [n]争论,辩论; [a]/ˈkɑːntrəvɜːrsi/; [or]gmat;
conspiracy: [n]密谋,阴谋; [a]/kənˈspɪrəsi/; [or]gmat;
restrain: [v]制止(做);抑制(愤怒等),控制;监禁; [a]/rɪˈstreɪn/; [or]gmat;
grove: [n]小树林;果园; [a]/ɡroʊv/; [or]gmat;
candidate: [n](官职,获奖资格等的)候选人;投考人;申请求职者; [a]/ˈkændɪdət/; [or]gmat;
patron: [n]老主顾;赞助人;支持者; [a]/ˈpeɪtrən/; [or]gmat;
celestial: [adj]天体的,天上的; [n]天人,神仙;(指封建时代的)中国人,天朝之人; [a]/səˈlestʃl/; [or]gmat;
modify: [v]改装,修改,更改;修饰,限定; [a]/ˈmɑːdɪfaɪ/; [or]gmat;
inspection: [n]检查,细看; [a]/ɪnˈspekʃn/; [or]gmat;
substitute: [v]代替; [n]代替者,代用品,替补队员; [a]/ˈsʌbstɪtuːt/; [or]gmat;
jurisdiction: [n]司法权,审判权;管辖权;权限,权力; [a]/ˌdʒʊrɪsˈdɪkʃn/; [or]gmat;
primary: [adj]初等教育的;初级的;基本的;首要的;主要的; [n]首选;(美)初选; [a]/ˈpraɪmeri/; [or]gmat;
beam: [n]光线;(房屋等)大梁;(横)梁; [v]发光;照射;发射,播送;微笑;用梁支撑; [a]/biːm/; [or]gmat;
hereditary: [adj]世袭的,遗传的; [a]/həˈredɪteri/; [or]gmat;
suffice: [v]足够; [a]/səˈfaɪs/; [or]gmat;
accuracy: [n]准确(性);准确度; [a]/ˈækjərəsi/; [or]gmat;
plead: [v]恳求,辩护,(不)认罪;提出.为理由; [a]/pliːd/; [or]gmat;
hinder: [v]阻碍,妨碍; [adj]后面的,后方的; [a]/ˈhɪndər/; [or]gmat;
cord: [n]细绳,索,(电工学)电绳;索,(电工学)电绳; [a]/kɔːrd/; [or]gmat;
extract: [v]取出;提取;摘录;设法得到;索取; [n]摘录;提出物; [a]/ɪkˈstrækt/; [or]gmat;
pint: [n]品脱(液量,干量名〈美〉液量=0.47升,干量=0.55升); [a]/paɪnt/; [or]gmat;
mute: [n]弱音器; [adj]缄默的;哑的; [vt]减弱.的声音; [a]/mjuːt/; [or]gmat;
cargo: [n]货物; [a]/ˈkɑːrɡoʊ/; [or]gmat;
compromise: [n]妥协;折中; [v]妥协;使遭受危害; [a]/ˈkɑːmprəmaɪz/; [or]gmat;
rugged: [adj]崎岖的,不平的,强壮的,艰苦的; [a]/ˈrʌɡɪd/; [or]gmat;
refrain: [v]抑制,避免; [n]歌曲的反复句,叠句; [a]/rɪˈfreɪn/; [or]gmat;
consumption: [n]消耗,消费,耗尽;肺痨; [a]/kənˈsʌmpʃn/; [or]gmat;
sustain: [v]维持;支撑,承受;供养;忍受;遭受,蒙受; [a]/səˈsteɪn/; [or]gmat;
resemble: [v]像,相像,相似; [a]/rɪˈzembl/; [or]gmat;
quote: [v]报价;引用,援引; [n]引用; [a]/kwoʊt/; [or]gmat;
aristocracy: [n]贵族;贵族统治;贵族政治;贵族品质; [a]/ˌærɪˈstɑːkrəsi/; [or]gmat;
gradual: [adj]逐渐的,逐步的,平缓的; [a]/ˈɡrædʒuəl/; [or]gmat;
detached: [adj]孤立的,分开的,超然公平的; [a]/dɪˈtætʃt/; [or]gmat;
execute: [v]处决;完成(动作);实行;执行(计划); [a]/ˈeksɪkjuːt/; [or]gmat;
strive: [v]斗争;努力,奋斗; [a]/straɪv/; [or]gmat;
endeavor: [n]尝试,努力,尽力; [v]努力,尽力; [a]/ɪnˈdevər/; [or]gmat;
barrier: [n]障碍;屏障;隔阂;壁垒; [v]用栅栏围住; [a]/ˈbæriər/; [or]gmat;
flora: [n]植物群; [a]/ˈflɔːrə/; [or]gmat;
mantle: [n]外壳;披风;地幔; [v]覆盖; [a]/ˈmæntl/; [or]gmat;
judicial: [adj]司法的,法庭的,法律的,审判(上)的; [a]/dʒuˈdɪʃl/; [or]gmat;
ridicule: [v]嘲笑,愚弄; [n]嘲笑,愚弄; [a]/ˈrɪdɪkjuːl/; [or]gmat;
barrel: [n]桶;枪管; [vi]快速移动; [a]/ˈbærəl/; [or]gmat;
tedious: [adj]沉闷的,冗长乏味的; [a]/ˈtiːdiəs/; [or]gmat;
expedient: [n]权宜之计,手段; [adj]有利的,方便的;权宜之计的; [a]/ɪkˈspiːdiənt/; [or]gmat;
genial: [adj]愉快的,脾气好的,友好的; [a]/ˈdʒiːniəl/; [or]gmat;
hostility: [n]虐待,敌意;不友善;敌对; [a]/hɑːˈstɪləti/; [or]gmat;
obstacle: [n]障碍;障碍物;妨碍; [a]/ˈɑːbstəkl/; [or]gmat;
posterity: [n]子孙,后裔,后代; [a]/pɑːˈsterəti/; [or]gmat;
mason: [n]泥瓦匠,共济会会员(等于freemason); [a]/ˈmeɪsn/; [or]gmat;
patriotic: [adj]爱国的,有爱国心的,显示爱国精神的; [a]/ˌpeɪtriˈɑːtɪk/; [or]gmat;
foster: [adj]收养的; [vt]养育;培养,促进; [a]/ˈfɔːstər/; [or]gmat;
patch: [n]补丁;眼罩;斑点; [v]打补丁;修补;匆忙拼凑; [a]/pætʃ/; [or]gmat;
skull: [n]颅骨;脑壳; [a]/skʌl/; [or]gmat;
legislature: [n]立法机关,立法机构; [a]/ˈledʒɪsleɪtʃər/; [or]gmat;
famine: [n]饥荒;严重的缺乏; [a]/ˈfæmɪn/; [or]gmat;
fuel: [v]给.加燃料; [n]燃料;刺激因素; [a]/ˈfjuːəl/; [or]gmat;
plunge: [v]跳进,(使)投入;使陷入;暴跌; [n]卷入,参与;暴跌,骤减; [a]/plʌndʒ/; [or]gmat;
subordinate: [n]部下;下属; [adj]次要的;从属的;下级的; [v]使从属于;使处于次要地位; [a]/səˈbɔːrdɪnət/; [or]gmat;
patent: [n]专利; [adj]显然的,明显的;专利的;独创的; [v]取得.的专利权; [a]/ˈpætnt/; [or]gmat;
compel: [v]强迫;迫使屈服;(使)不得已; [a]/kəmˈpel/; [or]gmat;
margin: [n]页边的空白,边缘;优势;利润; [a]/ˈmɑːrdʒən/; [or]gmat;
resume: [n]简历; [v]重新开始;继续; [vt]回到;恢复;重新开始; [a]/ˈrezəmeɪ/; [or]gmat;
compound: [n]复合物;[化学]化合物; [adj]合成的;复合的;多功能的; [vi]妥协;和解; [vt]混合;调和;调停;使恶化; [a]/ˈkɑːmpaʊnd/; [or]gmat;
imitate: [v]模仿; [a]/ˈɪmɪteɪt/; [or]gmat;
depression: [n]抑郁,沮丧;不景气,萧条(期);洼地,凹陷; [a]/dɪˈpreʃn/; [or]gmat;
prodigious: [adj]异常的,奇妙的;巨大的; [a]/prəˈdɪdʒəs/; [or]gmat;
vegetation: [n]植被; [a]/ˌvedʒəˈteɪʃn/; [or]gmat;
superb: [adj]极好的;壮丽的; [a]/suːˈpɜːrb/; [or]gmat;
confidential: [adj]机密的;表示信任的;悄悄的; [a]/ˌkɑːnfɪˈdenʃl/; [or]gmat;
sturdy: [adj]结实的;坚固的;强壮的;健壮的; [n](羊的)晕倒病; [a]/ˈstɜːrdi/; [or]gmat;
verdict: [n](陪审团)裁决;定论;意见; [a]/ˈvɜːrdɪkt/; [or]gmat;
penetrate: [v]刺穿,穿透;进入;了解; [a]/ˈpenətreɪt/; [or]gmat;
spark: [n]火花,火星;丝毫,微量; [v]发出火花;发动;激励; [a]/spɑːrk/; [or]gmat;
ally: [n]盟友;同盟国;(二战时的) 同盟国; [v]结盟; [a]/ˈælaɪ/; [or]gmat;
tract: [n]器官系统;一大片地;短文,小册子; [a]/trækt/; [or]gmat;
plus: prep. 加,加上; [n]加号;有利因素; [adj]正的,多的;有利的;阳性的; [conj]此外,而且,况且; [a]/plʌs/; [or]gmat;
condemn: [v]谴责,责备;判(某人某罪); [a]/kənˈdem/; [or]gmat;
unique: [adj]独特的,独一无二的;(唯一的)特有的;不同寻常的; [a]/juˈniːk/; [or]gmat;
navigation: [n]导航,航行,航海; [a]/ˌnævɪˈɡeɪʃn/; [or]gmat;
verge: [n]边缘;边界; [v]接近;濒临; [a]/vɜːrdʒ/; [or]gmat;
sanction: [n]批准;制裁,处罚; [v]批准,支持,对..实施制裁; [a]/ˈsæŋkʃn/; [or]gmat;
approbation: [n]称赞,认可;批准; [a]/ˌæprəˈbeɪʃn/; [or]gmat;
allegiance: [n]忠诚,拥护; [a]/əˈliːdʒəns/; [or]gmat;
expressly: [adv]清楚地,明显地;特别地,专门地; [a]/ɪkˈspresli/; [or]gmat;
dispose: [v]处理,处置,除去;使愿意; [a]/dɪˈspoʊz/; [or]gmat;
precaution: [n]预防措施; [a]/prɪˈkɔːʃn/; [or]gmat;
stature: [n]身高,身材;(精神,道德等的)高度; [a]/ˈstætʃər/; [or]gmat;
shift: [n]转移;替换;轮值; [v]移动;售卖(难卖的物品);换挡;改换,替换; [a]/ʃɪft/; [or]gmat;
factor: [n]因素;[数]因子,商; [a]/ˈfæktər/; [or]gmat;
sanctuary: [n]圣堂,避难所; [a]/ˈsæŋktʃueri/; [or]gmat;
shrink: [v]收缩;缩小;退缩; [n](非正式用法)心理医生,精神病医生; [a]/ʃrɪŋk/; [or]gmat;
crude: [adj]天然的;粗糙的;粗鲁的;简陋的; [n]原油; [a]/kruːd/; [or]gmat;
bolt: [n]门栓,螺栓;闪电;弩箭; [v]闩门;(马受惊)脱缰; [adv]突然地;像箭似地;直立地; [a]/boʊlt/; [or]gmat;
captivity: [n]囚禁;被关; [a]/kæpˈtɪvəti/; [or]gmat;
vein: [n]静脉;血管;叶脉;纹理;迹象;风格,性情; [a]/veɪn/; [or]gmat;
passive: [adj]被动的;消极的; [n]被动语态; [a]/ˈpæsɪv/; [or]gmat;
mystic: [adj]神秘的,神秘主义的; [n]神秘主义者; [a]/ˈmɪstɪk/; [or]gmat;
infancy: [n]婴儿期,幼年; [a]/ˈɪnfənsi/; [or]gmat;
censure: [v]责难,责备; [n]责难,责备; [a]/ˈsenʃər/; [or]gmat;
monotonous: [adj]单调的,无聊的; [a]/məˈnɑːtənəs/; [or]gmat;
catastrophe: [n]大灾难; [a]/kəˈtæstrəfi/; [or]gmat;
furnace: [n]炉子,熔炉; [a]/ˈfɜːrnɪs/; [or]gmat;
deem: [v]认为,视为;知道,相信; [a]/diːm/; [or]gmat;
punctuation: [n]标点;全部标点符号; [a]/ˌpʌŋktʃuˈeɪʃn/; [or]gmat;
pamphlet: [n]小册子; [a]/ˈpæmflət/; [or]gmat;
phase: [n](月等的)变相;盈亏;方面;阶段; [a]/feɪz/; [or]gmat;
discern: [v]辨别;识别;看出; [a]/dɪˈsɜːrn/; [or]gmat;
arbitrary: [adj]随意的,任性的,随心所欲的;霸道的,专制的,专横的;主观的,武断的; [a]/ˈɑːrbətreri/; [or]gmat;
parliament: [n]议会;国会; [a]/ˈpɑːrləmənt/; [or]gmat;
emergency: [n]紧急情况;突发事件; [a]/iˈmɜːrdʒənsi/; [or]gmat;
synonymous: [adj]同义的;同义词的;同义突变的; [a]/sɪˈnɑːnɪməs/; [or]gmat;
advocate: [v]提倡;主张;为.辩护; [n]辩护者;提倡者;律师; [a]/ˈædvəkeɪt/; [or]gmat;
confirm: [v]确认;证实;批准; [a]/kənˈfɜːrm/; [or]gmat;
resign: [v]辞职; [a]/rɪˈzaɪn/; [or]gmat;
fragment: [n]片段;碎片; [v]使成碎片; [a]/ˈfræɡmənt/; [or]gmat;
balcony: [n]阳台,剧院楼厅; [a]/ˈbælkəni/; [or]gmat;
hypothesis: [n]假说;假设; [a]/haɪˈpɑːθəsɪs/; [or]gmat;
width: [n]宽度,广度,宽阔; [a]/wɪdθ/; [or]gmat;
outrage: [n]残暴;暴行,愤怒; [v]使震怒,使愤慨; [a]/ˈaʊtreɪdʒ/; [or]gmat;
attorney: [n](辩护)律师; [a]/əˈtɜːrni/; [or]gmat;
vent: [n]发泄;通风口,排气口;(上衣背部或两侧的)开衩;(小型动物的)排泄口; [v]发泄(情绪),开孔,泄露; [a]/vent/; [or]gmat;
ranch: [n]大农场; [a]/ræntʃ/; [or]gmat;
ascending: [adj]上升的; [a]/əˈsendɪŋ/; [or]gmat;
odds: [n]几率;可能性;投注赔率;优势;差异,不平等; [a]/ɑːdz/; [or]gmat;
pension: [n]养老金,抚恤金;廉租屋; [v]发给..养老金; [a]/ˈpenʃn/; [or]gmat;
hazard: [n]公害;危险;危险的事物;机会; [v]使冒危险;冒险做; [a]/ˈhæzərd/; [or]gmat;
marine: [adj]海洋的,航海的,海产的,海军的; [n]海军士兵; [a]/məˈriːn/; [or]gmat;
antique: [n]古董;古玩;古物; [adj]古代的;古董的; [a]/ænˈtiːk/; [or]gmat;
orthodox: [adj]正统的;传统的;(Orthodox)东正教的; [a]/ˈɔːrθədɑːks/; [or]gmat;
alien: [n]外国人;外星人; [adj]陌生的;外国的,外星(人)的;异己的,不相容的; [a]/ˈeɪliən/; [or]gmat;
recourse: [n]求援(对象),求助(对象,[商][律]追索权; [a]/ˈriːkɔːrs/; [or]gmat;
illustrate: [v]举例说明,阐明;图解,加插图; [a]/ˈɪləstreɪt/; [or]gmat;
clumsy: [adj]笨拙的,不灵活的;拙劣的,不得体的; [a]/ˈklʌmzi/; [or]gmat;
odor: [n]气味; [a]/ˈoʊdər/; [or]gmat;
prairie: [n]大草原,(尤指)北美大草原;草原地带; [a]/ˈpreri/; [or]gmat;
feudal: [adj]领地的;封建制度的;封建时代的;世仇的; [a]/ˈfjuːdl/; [or]gmat;
adoption: [n]收养,采用,采纳; [a]/əˈdɑːpʃn/; [or]gmat;
notorious: [adj]臭名昭著的,声名狼藉的; [a]/noʊˈtɔːriəs/; [or]gmat;
pasture: [n]牧场,草地;生活状况; [v]放牧; [a]/ˈpæstʃər/; [or]gmat;
confinement: [n]限制;监禁;分娩; [a]/kənˈfaɪnmənt/; [or]gmat;
outfit: [n]装备,全部用品,(协同工作)的一组人; [v]提供装备; [a]/ˈaʊtfɪt/; [or]gmat;
adjacent: [adj]邻接的,毗连的;邻近的; [a]/əˈdʒeɪsnt/; [or]gmat;
exceptional: [adj]优越的,杰出的;异常的; [a]/ɪkˈsepʃənl/; [or]gmat;
deposit: [v]存款,存放;沉淀; [n]存款,定金;沉积物,矿床; [a]/dɪˈpɑːzɪt/; [or]gmat;
fragrance: [n]香水;香味;芳香; [a]/ˈfreɪɡrəns/; [or]gmat;
call for: [v]需要;邀请;呼吁; [a]/kɔːl fɔr/; [or]gmat;
superficial: [adj]肤浅的;表面的;微不足道的; [n]表面文章; [a]/ˌsuːpərˈfɪʃl/; [or]gmat;
extinct: [adj]灭绝的;破灭了的,消亡了的; [a]/ɪkˈstɪŋkt/; [or]gmat;
excursion: [n]远足;短途旅行; [a]/ɪkˈskɜːrʒn/; [or]gmat;
lump: [n]团;肿块;粗笨的人;一小方块 (糖); [v]成团,成堆;使成块; [a]/lʌmp/; [or]gmat;
magnitude: [n]巨大;震级;重要性;[数]量值; [a]/ˈmæɡnɪtuːd/; [or]gmat;
coral: [n]珊瑚; [a]/ˈkɔːrəl/; [or]gmat;
bondage: [n]奴役,束缚; [a]/ˈbɑːndɪdʒ/; [or]gmat;
hospitable: [adj]好客的;有利的;宜人的; [a]/hɑːˈspɪtəbl/; [or]gmat;
harness: [n]挽具,马具,降落伞背带; [v]上挽具;治理(河流等);利用; [a]/ˈhɑːrnɪs/; [or]gmat;
syllable: [n]音节; [a]/ˈsɪləbl/; [or]gmat;
spur: [v]策马,用踢马刺驱马前进;激励,鞭策;推动; [n]踢马刺,靴刺;刺激,鞭策,鼓励;尖坡; [a]/spɜːr/; [or]gmat;
neutral: [adj]中立的;中性的; [n]中立国;中性色; [a]/ˈnuːtrəl/; [or]gmat;
vine: [n]藤,蔓; [a]/vaɪn/; [or]gmat;
compose: [v]创作,作曲,形成,构成; [a]/kəmˈpoʊz/; [or]gmat;
crust: [n]外壳,面包皮,硬外皮; [a]/krʌst/; [or]gmat;
sting: [v]叮;刺疼;使苦闷;蜇; [n](因被刺而引起的)疼痛;(警方为抓捕罪犯精心设计的)圈套; [a]/stɪŋ/; [or]gmat;
episode: [n]插曲,片断;连续剧的一集;一段经历; [a]/ˈepɪsoʊd/; [or]gmat;
habitation: [n]住处; [a]/ˌhæbɪˈteɪʃn/; [or]gmat;
flourish: [vi]繁荣,茂盛,兴旺; [vt]挥舞;夸耀; [n]兴旺;茂盛;炫耀;挥舞; [a]/ˈflɜːrɪʃ/; [or]gmat;
underline: [v]划线于.之下;突出显示;强调; [n]下划线;下期节目预告;图下说明文字; [a]/ˌʌndərˈlaɪn/; [or]gmat;
impose: [v]把.强加;强制实行,强迫接受; [a]/ɪmˈpoʊz/; [or]gmat;
accommodation: [n]住宿,食宿;调解;住处; [a]/əˌkɑːməˈdeɪʃn/; [or]gmat;
anonymous: [adj]匿名的;无名的;不具名的;无特色的;无个性特征; [a]/əˈnɑːnɪməs/; [or]gmat;
calf: [n]小牛,小牛皮,小腿; [a]/kæf/; [or]gmat;
manual: [n]手册;指南; [adj]手的;手制的;手工的;体力的; [a]/ˈmænjuəl/; [or]gmat;
pang: [n]剧痛,痛苦; [v]使剧痛,折磨; [a]/pæŋ/; [or]gmat;
masculine: [adj]男性的;男子气概的; [a]/ˈmæskjəlɪn/; [or]gmat;
remnant: [n]遗迹;边角剩料; [a]/ˈremnənt/; [or]gmat;
ale: [n]麦芽啤酒; [a]/eɪl/; [or]gmat;
truce: [n]停战;休战;休战协定; [a]/truːs/; [or]gmat;
aversion: [n]厌恶;讨厌的人,(或东西); [a]/əˈvɜːrʒn/; [or]gmat;
lapse: [n]失误,过失;行为失检;(时间)流逝; [v]退步,倒退,衰退;失效;背弃,放弃(宗教信仰); [a]/læps/; [or]gmat;
enforce: [v]实施;执行;强制; [a]/ɪnˈfɔːrs/; [or]gmat;
skeleton: [n]骨骼,梗概;骨瘦如柴的人或动物; [a]/ˈskelɪtn/; [or]gmat;
confine: [v]限制;监禁; [n]范围,界限,约束,限制; [a]/kənˈfaɪn/; [or]gmat;
reconcile: [v]和解;调解;调和; [a]/ˈrekənsaɪl/; [or]gmat;
appoint: [v]委派,任命;约定;确定,指定; [a]/əˈpɔɪnt/; [or]gmat;
suppress: [v]镇压;禁止发表;抑制(感情等);阻止.的生长; [a]/səˈpres/; [or]gmat;
mature: [adj]成熟的;到期的; [vt]使成熟; [vi]成熟; [a]/məˈtʃʊr/; [or]gmat;
guarantee: [v]保证;担保;提供保修; [n]保证;担保;保修单;保证金; [a]/ˌɡærənˈtiː/; [or]gmat;
procedure: [n]步骤,过程;程序;手续; [a]/prəˈsiːdʒər/; [or]gmat;
futile: [adj]无益的,无用的; [a]/ˈfjuːtl/; [or]gmat;
baptism: [n]洗礼;严峻考验; [a]/ˈbæptɪzəm/; [or]gmat;
intrigue: [n]阴谋;诡计; [v]密谋;欺骗;引起极大兴趣; [a]/ɪnˈtriːɡ/; [or]gmat;
imply: [vt]暗示;暗指;意味着; [a]/ɪmˈplaɪ/; [or]gmat;
absurdity: [n]荒谬,谬论,荒谬的言行; [a]/əbˈsɜːrdəti/; [or]gmat;
beset: [v]困扰;镶嵌;围绕; [a]/bɪˈset/; [or]gmat;
radical: [n]激进分子;基础;原子团;根数,根式; [adj]重大的,彻底的;激进的; [a]/ˈrædɪkl/; [or]gmat;
concrete: [n]混凝土; [adj]具体的,实质性的; [v]给 (道路等) 浇混凝土; [a]/ˈkɑːŋkriːt/; [or]gmat;
combine: [v]使混合(结合,组合,联合);结合;联合;组合; [n]联合体,联合企业;联合收割机; [a]/kəmˈbaɪn/; [or]gmat;
peak: [n]顶峰;山顶;尖端; [v]达到最高点; [adj]最高度的;高峰时期的;巅峰状态的; [a]/piːk/; [or]gmat;
currency: [n]货币;流通;流行; [a]/ˈkɜːrənsi/; [or]gmat;
reluctant: [adj]不情愿的;勉强的; [a]/rɪˈlʌktənt/; [or]gmat;
patronage: [n]惠顾;赞助;任免权; [a]/ˈpætrənɪdʒ/; [or]gmat;
mound: [n]堆,高地,护堤; [v]堆起,积成堆; [a]/maʊnd/; [or]gmat;
confer: [v]授予(奖项,学位,荣誉或权利);商讨,协商; [a]/kənˈfɜːr/; [or]gmat;
tempt: [v]诱惑;吸引;冒..的风险,不顾; [a]/tempt/; [or]gmat;
renown: [n]声誉;名望; [vt]使有声望; [a]/rɪˈnaʊn/; [or]gmat;
peer: [n]同龄人,同等地位的人;贵族; [v]仔细看,费力地看; [a]/pɪr/; [or]gmat;
outcome: [n]结果,后果; [a]/ˈaʊtkʌm/; [or]gmat;
strand: [n](线等的)股,缕;一个组成部分;海滨,河岸,海滩,湖滨; [v]使陷入困境;使滞留,使搁浅; [a]/strænd/; [or]gmat;
Spaniard: [n]西班牙人; [a]/ˈspænjərd/; [or]gmat;
hum: [v]发出嗡嗡声,哼(歌曲); [n]轰鸣声,嗡嗡营营声; [a]/hʌm/; [or]gmat;
acquisition: [n]并购;获得;掌握;获得物;取得物; [a]/ˌækwɪˈzɪʃn/; [or]gmat;
trench: [n]沟;壕沟,战壕;海沟; [a]/trentʃ/; [or]gmat;
exert: [v]尽(力),运用,发挥; [a]/ɪɡˈzɜːrt/; [or]gmat;
veteran: [n]老兵;退役军人; [adj]经验丰富的;老练的; [a]/ˈvetərən/; [or]gmat;
meek: [adj]温顺的,逆来顺受的;谦恭的; [n]温顺的人;谦恭的人; [a]/miːk/; [or]gmat;
judicious: [adj]有判断力的;明智的; [a]/dʒuˈdɪʃəs/; [or]gmat;
testify: [vt]作证; [vi]证明; [v]声明;见证(上帝的存在);证实; [a]/ˈtestɪfaɪ/; [or]gmat;
orchestra: [n]管弦乐队; [adj]管弦乐队的; [a]/ˈɔːrkɪstrə/; [or]gmat;
maternal: [adj]母亲的,母性的;母方的,母系的; [a]/məˈtɜːrnl/; [or]gmat;
strata: [n]层;地层;阶层; [a]/ˈstreɪtə/; [or]gmat;
miniature: [adj]小型的,微小的; [n]微小的模型,缩影,微型人物像; [vt]使成小型;把.画成纤细画;缩写; [a]/ˈmɪnətʃər/; [or]gmat;
flavor: [n]味,风味;调味品; [v]给..调味; [a]/ˈfleɪvər/; [or]gmat;
inconsistent: [adj]不一致的,前后矛盾的; [a]/ˌɪnkənˈsɪstənt/; [or]gmat;
emancipation: [n]释放;解放; [a]/ɪˌmænsɪˈpeɪʃn/; [or]gmat;
asunder: [adv]分离;化为碎片; [a]/əˈsʌndər/; [or]gmat;
bustle: [n]喧闹,熙攘;腰垫;奔走,奔忙; [v]喧闹;忙乱,奔忙; [a]/ˈbʌsl/; [or]gmat;
pastoral: [adj]田园生活的,牧师的; [n]牧歌;田园诗;田园景色;牧师写给教区居民的公开信; [a]/ˈpæstərəl/; [or]gmat;
specimen: [n]标本,样本,样品; [a]/ˈspesɪmən/; [or]gmat;
fabric: [n]布料,织物;质地,结构; [a]/ˈfæbrɪk/; [or]gmat;
preface: [n]序言,前言,开端; [a]/ˈprefəs/; [or]gmat;
outdated: [adj]过时的,老式的;落伍的; [a]/ˌaʊtˈdeɪtɪd/; [or]gmat;
pecuniary: [adj]金钱(上)的; [a]/pɪˈkjuːnieri/; [or]gmat;
dire: [adj]可怕的;悲惨的;极端的; [a]/ˈdaɪər/; [or]gmat;
instruct: [v]指导;教;指示;通知; [a]/ɪnˈstrʌkt/; [or]gmat;
Puritan: [n]清教徒,极端拘谨的人; [adj]清教徒的; [a]/ˈpjʊrɪtən/; [or]gmat;
intermediate: [adj]中间的,居间的;中级的; [n]中间体,媒介物; [v]调解,干涉; [a]/ˌɪntərˈmiːdiət/; [or]gmat;
formula: [n]公式,方程式;配方;方案;方法;配方奶; [a]/ˈfɔːrmjələ/; [or]gmat;
ore: [n]矿石;矿砂;矿,矿石; [a]/ɔːr/; [or]gmat;
haunt: [v]常去,萦绕于..;(鬼,魂)常出没于;(思想)萦绕; [n]常去的地方; [a]/hɔːnt/; [or]gmat;
faction: [n]派别,小集团,小派系;派系斗争,内讧; [a]/ˈfækʃn/; [or]gmat;
architect: [n]设计师;建筑师; [a]/ˈɑːrkɪtekt/; [or]gmat;
ransom: [n]赎金,赎身; [v]赎回,解救; [a]/ˈrænsəm/; [or]gmat;
surplus: [adj]过剩的,多余的; [n]过剩,盈余;顺差; [a]/ˈsɜːrplʌs/; [or]gmat;
contemptuous: [adj]藐视的,倨傲的; [a]/kənˈtemptʃuəs/; [or]gmat;
reef: [n]礁; [v]收帆,缩帆; [a]/riːf/; [or]gmat;
tissue: [n]面巾纸,(动植物的)组织,纱布; [a]/ˈtɪʃuː/; [or]gmat;
epic: [adj]史诗的,叙事诗的;壮丽的,宏大的; [n]史诗;叙事诗;史诗般的作品; [a]/ˈepɪk/; [or]gmat;
impart: [v]传授,给予,将(某性质)给予或赋予某事物; [a]/ɪmˈpɑːrt/; [or]gmat;
statute: [n]法令,法规,条例; [a]/ˈstætʃuːt/; [or]gmat;
girdle: [n]腰带;妇女紧身褡; [v]围,包围,环绕; [a]/ˈɡɜːrdl/; [or]gmat;
tenant: [n]承租人,租客,佃户; [a]/ˈtenənt/; [or]gmat;
humane: [adj]人道的;仁慈的; [a]/hjuːˈmeɪn/; [or]gmat;
fertility: [n]多产;肥沃;[农经]生产力;丰饶; [a]/fərˈtɪləti/; [or]gmat;
millennium: [n]千禧年;太平盛世; [a]/mɪˈleniəm/; [or]gmat;
spectator: [n]旁观者;观众;目击者; [a]/ˈspekteɪtər/; [or]gmat;
imperative: [adj]必要的;祈使的;急需的; [n]命令;必要的事;义务;驱使; [a]/ɪmˈperətɪv/; [or]gmat;
steer: [v]操纵,驾驶,掌舵,引导; [n]公牛,食用牛; [a]/stɪr/; [or]gmat;
imminent: [adj]迫近的,紧迫的,即将来临的; [a]/ˈɪmɪnənt/; [or]gmat;
apprehend: [vt]理解,领会;逮捕;对.忧虑;把.视作; [vi]忧虑; [a]/ˌæprɪˈhend/; [or]gmat;
hem: [n]边,缘;摺边; [v]给..缝边;包围; [a]/hem/; [or]gmat;
renounce: [vt]宣布放弃,与...断绝关系;抛弃; [vi]垫牌; [n]垫牌; [a]/rɪˈnaʊns/; [or]gmat;
commend: [v]称赞;推荐;委托保管; [a]/kəˈmend/; [or]gmat;
revive: [v](使)苏醒;(使)复苏;再兴起;重做; [a]/rɪˈvaɪv/; [or]gmat;
intervention: [n]介入;调停;干涉,干预; [a]/ˌɪntərˈvenʃn/; [or]gmat;
susceptible: [adj]易受感染的;易受影响的;多情的; [a]/səˈseptəbl/; [or]gmat;
subsistence: [n]存在,生存;生活; [adj]收成仅够自身口粮的; [a]/səbˈsɪstəns/; [or]gmat;
disciple: [n]信徒,门徒;耶稣的信徒(或门徒,使徒); [a]/dɪˈsaɪpl/; [or]gmat;
revival: [n]复活,复兴; [a]/rɪˈvaɪvl/; [or]gmat;
mechanism: [n]机械装置;机制,机理,原理; [a]/ˈmekənɪzəm/; [or]gmat;
loaf: [n](一条)面包; [v]虚度光阴; [a]/loʊf/; [or]gmat;
index: [n]索引;指标,标志;指数; [v]附以索引,编入索引; [a]/ˈɪndeks/; [or]gmat;
transmit: [v]传送;传播,传导;发射; [a]/trænsˈmɪt/; [or]gmat;
liver: [n]肝脏;(供食用的动物)肝脏; [a]/ˈlɪvər/; [or]gmat;
dip: [v]浸,蘸; [n]倾斜,下降;调味汁; [a]/dɪp/; [or]gmat;
inexplicable: [adj]无法解释的,难理解的,莫名其妙的; [a]/ˌɪnɪkˈsplɪkəbl/; [or]gmat;
diminish: [v]减少;失势,削弱.的权势, 减弱.的权势; [a]/dɪˈmɪnɪʃ/; [or]gmat;
rim: [n](圆形物体的)边;轮辋,轮缘,轮圈; [v]形成边缘; [a]/rɪm/; [or]gmat;
monopoly: [n]垄断;专卖;垄断商品;专卖商品; [a]/məˈnɑːpəli/; [or]gmat;
temperate: [adj]温和的;适度的,有节制的; [a]/ˈtempərət/; [or]gmat;
amber: [n]琥珀,琥珀色; [v]使呈琥珀色; [adj]琥珀色的,琥珀制的; [a]/ˈæmbər/; [or]gmat;
howl: [v](狼,狗等)嗥叫;(风等)呼啸;(因愤怒,痛苦等)吼叫,哀号; [n]嚎叫,哀号; [a]/haʊl/; [or]gmat;
submarine: [n]潜水艇; [adj]水底的,海底的; [a]/ˈsʌbməriːn/; [or]gmat;
perpendicular: [adj]成直角的,垂直的;直立的; [n]垂直线; [a]/ˌpɜːrpənˈdɪkjələr/; [or]gmat;
fervent: [adj]热烈的,满怀热情的;狂热的; [a]/ˈfɜːrvənt/; [or]gmat;
wreath: [n]花圈;花环;圈状物; [a]/riːθ/; [or]gmat;
undergo: [v]经历;遭受; [a]/ˌʌndərˈɡoʊ/; [or]gmat;
haze: [n]阴霾;薄雾;疑惑,迷糊; [v](使)变朦胧;(使)变糊涂; [a]/heɪz/; [or]gmat;
concession: [n]让步;特许,特许权;承认; [a]/kənˈseʃn/; [or]gmat;
caste: [n](印度社会中的)种姓;(具有严格等级差别的)社会地位;(排他的)社会团体; [a]/kæst/; [or]gmat;
fortitude: [n]坚强意志(精神),坚忍,刚毅; [a]/ˈfɔːrtətuːd/; [or]gmat;
anticipate: [v]预测;期待;提早(做); [a]/ænˈtɪsɪpeɪt/; [or]gmat;
discord: [n]不和,争吵;(声音)不和谐; [a]/ˈdɪskɔːrd/; [or]gmat;
vehement: [adj]猛烈的,强烈的; [a]/ˈviːəmənt/; [or]gmat;
wage: [n]薪水,报酬; [v]开展,进行(战争,运动); [a]/weɪdʒ/; [or]gmat;
drain: [vi]排出,排水; [v]流干,沥干;喝光,耗尽,减少,消逝; [vt]使流出,排掉水; [n]下水道,排水管;消耗,排水; [a]/dreɪn/; [or]gmat;
frivolous: [adj]轻佻的,不重要的,缺乏基础的; [a]/ˈfrɪvələs/; [or]gmat;
provoke: [v]激怒;对.挑衅;引起; [a]/prəˈvoʊk/; [or]gmat;
reside: [v]居住; [a]/rɪˈzaɪd/; [or]gmat;
apparel: [n]服装,衣服; [vt]给.穿衣服(尤指华丽或特殊的服装); [a]/əˈpærəl/; [or]gmat;
colossal: [adj]巨像(似)的;巨大的,庞大的; [a]/kəˈlɑːsl/; [or]gmat;
stimulus: [n]刺激物;鼓励;促进因素; [a]/ˈstɪmjələs/; [or]gmat;
digest: [v]消化;领会,理解; [n]摘要; [a]/daɪˈdʒest/; [or]gmat;
plateau: [n]高原; [vi]到达平稳阶段; [a]/plæˈtoʊ/; [or]gmat;
presentation: [n]演讲;报告;介绍;颁奖仪式; [a]/ˌpriːzenˈteɪʃn/; [or]gmat;
devise: [v]设计,想出;密谋;遗赠(不动产); [n]设计,发明,遗赠; [a]/dɪˈvaɪz/; [or]gmat;
exclude: [vt]不包括;排挤;排除;驱逐,赶出; [a]/ɪkˈskluːd/; [or]gmat;
inflict: [v]使遭受(损伤,痛苦等);使承担(负担等); [a]/ɪnˈflɪkt/; [or]gmat;
explore: [v]探险,探索,尝试; [a]/ɪkˈsplɔːr/; [or]gmat;
whirl: [v]回旋;使旋转; [n]回旋;一个接一个的活动; [a]/wɜːrl/; [or]gmat;
ballad: [n]歌谣;小曲; [a]/ˈbæləd/; [or]gmat;
cylinder: [n]圆柱体,圆筒;汽缸,泵(或桶)体; [a]/ˈsɪlɪndər/; [or]gmat;
maxim: [n]格言;准则;座右铭; [a]/ˈmæksɪm/; [or]gmat;
bust: [n]半身塑像;胸部; [v]打碎;搜捕;降级;终止; [adj]破产的;打碎的; [a]/bʌst/; [or]gmat;
intuition: [n]直觉;感觉; [a]/ˌɪntuˈɪʃn/; [or]gmat;
mingle: [v]使混合,使相混; [vi]相交往,相往来; [a]/ˈmɪŋɡl/; [or]gmat;
client: [n]委托人,当事人,主顾,客户;客户端; [a]/ˈklaɪənt/; [or]gmat;
tenor: [n]男高音,要点,要旨,稳定的进程; [adj](乐器)次中音的;(组钟中的)最低音的;男高音的; [a]/ˈtenər/; [or]gmat;
strenuous: [adj]费力的;奋发的;热心的;艰苦的;紧张的; [a]/ˈstrenjuəs/; [or]gmat;
analogy: [n]比拟,比喻;类比;相似;类似; [a]/əˈnælədʒi/; [or]gmat;
infer: [vt]做出推论,推断;推理;暗示; [vi]推断; [a]/ɪnˈfɜːr/; [or]gmat;
launch: [v]发射;出海;创办,开始从事; [n]发射,投放市场;(游艇,汽艇)下水;发行; [a]/lɔːntʃ/; [or]gmat;
adverse: [adj]不利的;(方向上)逆的;在相反的方向上移动(或运转);相反的; [a]/ˈædvɜːrs/; [or]gmat;
strait: [n]海峡;窘迫; [a]/streɪt/; [or]gmat;
scrap: [n]碎片;口角,吵架;小块,小片;废金属;残羹冷炙; [v]报废;舍弃;打架; [a]/skræp/; [or]gmat;
pirate: [n]海盗;剽窃者; [v]剽窃; [a]/ˈpaɪrət/; [or]gmat;
prevalent: [adj]普遍的,流行的; [a]/ˈprevələnt/; [or]gmat;
snap: [v]使喀嚓一声折断,使发出吧嗒一声(关上或打开); [n]吧嗒声;快照; [adj]仓促的,突然的; [a]/snæp/; [or]gmat;
geese: [n]鹅; [a]/ɡiːs/; [or]gmat;
magnetic: [adj]有磁性的;有吸引力的; [a]/mæɡˈnetɪk/; [or]gmat;
predecessor: [n]前辈;(被取代的)原有事物; [a]/ˈpredəsesər/; [or]gmat;
impartial: [adj]公平的,不偏不倚的; [a]/ɪmˈpɑːrʃl/; [or]gmat;
wig: [n]假发;呵斥; [v]呵斥; [adj]戴假发的; [a]/wɪɡ/; [or]gmat;
feat: [n]绝技,功绩,武艺; [a]/fiːt/; [or]gmat;
sultan: [n]苏丹(某些伊斯兰国家最高统治者称号); [a]/ˈsʌltən/; [or]gmat;
certificate: [n]合格证书,文凭;证明,证明书; [v]给..发证书; [a]/sərˈtɪfɪkət/; [or]gmat;
subdue: [v]征服,压制,减轻; [a]/səbˈduː/; [or]gmat;
ancestor: [n]祖宗;祖先;原型; [a]/ˈænsestər/; [or]gmat;
cluster: [n]一串;一簇; [v]群集;丛生; [a]/ˈklʌstər/; [or]gmat;
plausible: [adj]似乎有理的;巧嘴的; [a]/ˈplɔːzəbl/; [or]gmat;
rhetoric: [n]修辞学,浮夸的言语;雄辩术; [a]/ˈretərɪk/; [or]gmat;
scrape: [n]擦伤;刮,擦; [v]刮,擦; [a]/skreɪp/; [or]gmat;
congenial: [adj]意气相投的,令人愉快的,意气相投的,协调的; [a]/kənˈdʒiːniəl/; [or]gmat;
bureau: [n]局,司,处,社,所; [a]/ˈbjʊroʊ/; [or]gmat;
slice: [v]把..切成片;大幅度削减;切开; [n]薄片;份额,部分; [a]/slaɪs/; [or]gmat;
renaissance: [n]新生,复兴;文艺复兴; [a]/ˈrenəsɑːns/; [or]gmat;
perspiration: [n]汗水;出汗; [a]/ˌpɜːrspəˈreɪʃn/; [or]gmat;
courier: [n]快递员,通讯员,导游; [a]/ˈkʊriər/; [or]gmat;
womb: [n]子宫,发源地; [vi]容纳; [vt]容纳; [a]/wuːm/; [or]gmat;
mortality: [n]死亡数,死亡率;必死的命运; [a]/mɔːrˈtæləti/; [or]gmat;
envious: [adj]羡慕的,嫉妒的; [a]/ˈenviəs/; [or]gmat;
sojourn: [n]逗留,旅居; [vi]逗留,旅居; [a]/ˈsoʊdʒɜːrn/; [or]gmat;
amateur: [n]业余爱好者;外行; [adj]外行的;业余爱好的,业余(身份)的; [a]/ˈæmətʃər/; [or]gmat;
originality: [n]创造性;独创性; [a]/əˌrɪdʒəˈnæləti/; [or]gmat;
isolation: [n]孤独,孤立状态;孤立;隔离;[电]绝缘;[化学]离析; [a]/ˌaɪsəˈleɪʃn/; [or]gmat;
perspective: [n]角度,视角,观点,想法;(对事物的)合理判断,正确认识;远景;透视图,透视法,透视效果; [adj]透视的; [a]/pərˈspektɪv/; [or]gmat;
withstand: [v]忍受;抵挡; [a]/wɪðˈstænd/; [or]gmat;
robust: [adj]健壮的,强壮的;精力充沛的;坚固的;粗鲁的; [a]/roʊˈbʌst/; [or]gmat;
allude: [v]间接提到,暗指,暗示; [a]/əˈluːd/; [or]gmat;
psychological: [adj]心理的,心理学的; [a]/ˌsaɪkəˈlɑːdʒɪkl/; [or]gmat;
intricate: [adj]错综复杂的; [a]/ˈɪntrɪkət/; [or]gmat;
limestone: [n][地质学]石灰岩;石灰石; [a]/ˈlaɪmstoʊn/; [or]gmat;
foresee: [v]预知,预料,预测; [a]/fɔːrˈsiː/; [or]gmat;
clan: [n]家族;氏族;部落;宗派;亲族; [a]/klæn/; [or]gmat;
Canon: [n]标准,教规,正典圣经,教士; [a]/ˈkænən/; [or]gmat;
oval: [adj]椭圆形的; [n]椭圆形; [a]/ˈoʊvl/; [or]gmat;
cedar: [n]雪松,香柏,西洋杉木; [a]/ˈsiːdər/; [or]gmat;
contradict: [v]与..发生矛盾,与..抵触,与..对立; [a]/ˌkɑːntrəˈdɪkt/; [or]gmat;
advent: [n]来临;到来;出现; [a]/ˈædvent/; [or]gmat;
gear: [n]档位;齿轮;装备;衣物; [v]使适合; [a]/ɡɪr/; [or]gmat;
accompaniment: [n]伴奏;伴随物; [a]/əˈkʌmpənimənt/; [or]gmat;
lumber: [v]缓慢地移动;拖累,迫使担负;伐木;杂乱地堆积;隆隆地行进; [n]木材;废旧家具,不用的大件物品;无用的杂物;隆隆声; [a]/ˈlʌmbər/; [or]gmat;
sentinel: [n]哨兵,看守; [v]守卫,放哨; [a]/ˈsentɪnl/; [or]gmat;
bower: [n]凉亭,树荫下凉快之处; [a]/ˈbaʊər/; [or]gmat;
scout: [v]侦察;监视;嘲笑; [n]童子军,侦察员,守卫; [a]/skaʊt/; [or]gmat;
heritage: [n]遗产;继承物;传统;文化遗产; [a]/ˈherɪtɪdʒ/; [or]gmat;
battalion: [n]营,军营;军队,部队; [a]/bəˈtæliən/; [or]gmat;
persist: [v]坚持,固执;继续存留; [a]/pərˈsɪst/; [or]gmat;
outlet: [n]出口;插座;表现机会,发泄方法;廉价经销店; [a]/ˈaʊtlet/; [or]gmat;
inherit: [v]经遗传而得(特性等);接受遗产;沿袭;继任; [a]/ɪnˈherɪt/; [or]gmat;
velocity: [n]速度;迅速,快速; [a]/vəˈlɑːsəti/; [or]gmat;
chart: [n]图表,表格;航海图;每周排行榜; [v]制成图表;制航海图; [a]/tʃɑːrt/; [or]gmat;
omen: [n]征兆,预兆; [vt]预示;预告;有.的前兆; [a]/ˈoʊmən/; [or]gmat;
bleak: [adj]凄凉的;萧瑟的;阴郁的;无希望的; [a]/bliːk/; [or]gmat;
clerical: [adj]书记的;牧师的;办事员的; [n]牧师; [a]/ˈklerɪkl/; [or]gmat;
ordinance: [n]法令;条例;条例;圣餐式; [a]/ˈɔːrdɪnəns/; [or]gmat;
pallid: [adj]苍白的,病态的,无生气的; [a]/ˈpælɪd/; [or]gmat;
ritual: [n](宗教等的)仪式,例行公事,老规矩; [adj]作为仪式一部分的,例行的; [a]/ˈrɪtʃuəl/; [or]gmat;
fiscal: [adj]会计的;财政的;国库的; [a]/ˈfɪskl/; [or]gmat;
cynical: [adj]愤世嫉俗的;恶意的;悲观的; [a]/ˈsɪnɪkl/; [or]gmat;
turbulent: [adj]湍急的;混乱的,动荡的;骚动的; [a]/ˈtɜːrbjələnt/; [or]gmat;
chant: [v]吟唱;诵扬; [n]圣歌;赞美诗;旋律; [a]/tʃænt/; [or]gmat;
initial: [adj]第一的;最初的;开始的; [n]首字母; [a]/ɪˈnɪʃl/; [or]gmat;
minimum: [adj]最少的,最低程度的; [n]最低限度,最小量; [a]/ˈmɪnɪməm/; [or]gmat;
overlook: [v]忽视,未注意到;眺望,俯视; [n]忽视,远眺; [a]/ˌoʊvərˈlʊk/; [or]gmat;
inhabit: [v]居住于; [a]/ɪnˈhæbɪt/; [or]gmat;
tout: [v]招徕顾客,极力赞扬; [a]/taʊt/; [or]gmat;
stroll: [n]漫步;散步;闲荡;溜达; [vi]散步; [vt]溜达;游荡;在.散步;在.漫步; [a]/stroʊl/; [or]gmat;
temperance: [n]自制;节制;禁酒; [a]/ˈtempərəns/; [or]gmat;
austere: [adj]严峻的;简朴的;苦行的;无装饰的; [a]/ɔːˈstɪr/; [or]gmat;
administer: [v]管理;执行;实施;给予;用(药); [a]/ədˈmɪnɪstər/; [or]gmat;
benefactor: [n]恩人;捐助者;施主; [a]/ˈbenɪfæktər/; [or]gmat;
scatter: [v](使)分散,撒开,散播; [a]/ˈskætər/; [or]gmat;
dexterity: [n]纯熟;灵巧; [a]/dekˈsterəti/; [or]gmat;
pernicious: [adj]有害的,恶性的,致命的; [a]/pərˈnɪʃəs/; [or]gmat;
economical: [adj]节约的;经济的;合算的; [a]/ˌekəˈnɑːmɪkl/; [or]gmat;
brazen: [adj]厚脸皮的,厚颜无耻的;黄铜(制)的; [v]厚着脸皮干,使变得无耻; [a]/ˈbreɪzn/; [or]gmat;
mythology: [n]神话,神话学; [a]/mɪˈθɑːlədʒi/; [or]gmat;
stride: [v]大步走;越过;跨越; [vt]大步走过;跨骑在.上; [n]大步;阔步行走的姿势;一大步;跨越;正常的进展; [a]/straɪd/; [or]gmat;
circumference: [n]圆周长度,圆周;周围; [a]/sərˈkʌmfərəns/; [or]gmat;
secluded: [adj]隐遁的,隔绝的; [a]/sɪˈkluːdɪd/; [or]gmat;
reliable: [adj]可靠的;可信赖的;确实的; [a]/rɪˈlaɪəbl/; [or]gmat;
collapse: [v](使)倒塌,(使)崩溃,(使)瓦解; [n]倒塌,崩溃,暴跌; [a]/kəˈlæps/; [or]gmat;
lore: [n]传说;(专门的)知识,学问; [a]/lɔːr/; [or]gmat;
scrupulous: [adj]小心谨慎的;严谨的;细心的; [a]/ˈskruːpjələs/; [or]gmat;
redress: [n]纠正,革除,救济; [v]修正,救济,革除; [a]/rɪˈdres/; [or]gmat;
solar: [adj]太阳的;太阳系的;日光的; [n]日光浴室; [a]/ˈsoʊlər/; [or]gmat;
raid: [n]突袭;袭击; [v]袭击;劫掠;攫取;突然搜捕; [a]/reɪd/; [or]gmat;
Quaker: [n]夸克党,教友派信徒; [a]/ˈkweɪkər/; [or]gmat;
lease: [v]出租,租得; [n]租约,租契; [a]/liːs/; [or]gmat;
friction: [n]摩擦,摩擦力;争执,冲突; [a]/ˈfrɪkʃn/; [or]gmat;
stale: [adj]不新鲜的;走了味的;陈腐的; [v]变得不新鲜;使陈旧; [n](猎人做掩蔽用的)假马;笑柄;受人愚弄成为笑谈的人;畜尿; [a]/steɪl/; [or]gmat;
intermittent: [adj]断断续续的,间歇的; [a]/ˌɪntərˈmɪtənt/; [or]gmat;
wholesale: [n]批发; [adv]大批大批地; [adj]大规模的;批发的; [v]批发; [a]/ˈhoʊlseɪl/; [or]gmat;
recreation: [n]娱乐活动,消遣; [a]/ˌrekriˈeɪʃn/; [or]gmat;
rivalry: [n]竞争,敌对; [a]/ˈraɪvlri/; [or]gmat;
whim: [n]一时的兴致,心血来潮,奇想,幻想; [a]/wɪm/; [or]gmat;
ceremonial: [n]宗教仪式;礼节; [adj]仪式的;礼仪的,正式的; [a]/ˌserɪˈmoʊniəl/; [or]gmat;
sample: [n]样品,样本;(用于检验,分析的) 试样; [adj]样品的,作为例子的; [vi]抽样检查; [vt]抽取.的试样; [v]品尝;体验,尝试; [a]/ˈsæmpl/; [or]gmat;
mutiny: [n]兵变,叛乱,暴动; [v]反叛,暴动,参加叛乱; [a]/ˈmjuːtəni/; [or]gmat;
farce: [n]闹剧;胡闹;笑剧; [a]/fɑːrs/; [or]gmat;
pair: [n]一对; [v]成对,配对; [a]/per/; [or]gmat;
profile: [n]侧面像;外形,轮廓; [v]描绘..的轮廓,扼要描述; [a]/ˈproʊfaɪl/; [or]gmat;
lessen: [v]减少;减轻; [a]/ˈlesn/; [or]gmat;
capricious: [adj]变化无常的,任性的; [a]/kəˈprɪʃəs/; [or]gmat;
paltry: [adj]不足取的,无价值的,琐碎的,卑鄙的; [a]/ˈpɔːltri/; [or]gmat;
periodical: [n]期刊;杂志; [a]/ˌpɪriˈɑːdɪkl/; [or]gmat;
premature: [adj]早产的,过早的,早熟的; [n]早产儿; [a]/ˌpriːməˈtʃʊr/; [or]gmat;
multiply: [v]乘;繁殖;增加; [a]/ˈmʌltɪplaɪ/; [or]gmat;
prosper: [v](生意等)成功;(城市,文化,植物生长等)繁荣; [a]/ˈprɑːspər/; [or]gmat;
subscription: [n]订阅;捐款;签署;同意;会费; [adj]收费的; [a]/səbˈskrɪpʃn/; [or]gmat;
particle: [n]粒子,微粒;[语]小品词; [a]/ˈpɑːrtɪkl/; [or]gmat;
innate: [adj]与生俱来的,天生的; [a]/ɪˈneɪt/; [or]gmat;
clump: [n]土块; [v]丛生; [a]/klʌmp/; [or]gmat;
emerald: [n]祖母绿,翡翠; [adj]翠绿色的; [a]/ˈemərəld/; [or]gmat;
foresight: [n]先见,预见;远见,深谋远虑; [a]/ˈfɔːrsaɪt/; [or]gmat;
ape: [n]无尾猿,类人猿;模仿者;粗野的大汉; [adj]〈俚〉疯狂的; [v]模仿; [a]/eɪp/; [or]gmat;
span: [n]跨度;时间段;范围;持续时间; [v]持续;横跨;包括; [a]/spæn/; [or]gmat;
snuff: [v](伤风鼻阻时)用鼻子使劲地吸,扑灭; [n]灯花,烛花,鼻吸气息,气息; [a]/snʌf/; [or]gmat;
inquisitive: [adj]好奇的,好打听的; [a]/ɪnˈkwɪzətɪv/; [or]gmat;
affirmative: [adj]肯定的,积极的; [n]肯定语,赞成的一方; [a]/əˈfɜːrmətɪv/; [or]gmat;
dispense: [v]分发,分配,免除,执行; [a]/dɪˈspens/; [or]gmat;
demonstrate: [vt](用实例,实验)论证;演示,展示;示范; [vi]示威; [a]/ˈdemənstreɪt/; [or]gmat;
arithmetic: [n]计算;算术; [a]/əˈrɪθmətɪk/; [or]gmat;
impunity: [n]不受惩罚;无患; [a]/ɪmˈpjuːnəti/; [or]gmat;
remainder: [n]剩下的人;剩余物,残留部分; [v]减价出售,削价处理; [adj]剩余的;留存下的; [a]/rɪˈmeɪndər/; [or]gmat;
tinge: [n]淡淡的(颜色,神色),轻微,少量; [v]给.染色,轻微地影响; [a]/tɪndʒ/; [or]gmat;
trait: [n]特征; [a]/treɪt/; [or]gmat;
quarry: [n]采石场;猎物;来源; [v]挖出;努力挖掘; [a]/ˈkwɔːri/; [or]gmat;
abnormal: [adj]反常的;畸形的; [a]/æbˈnɔːrml/; [or]gmat;
omission: [n]省略;遗漏,疏忽; [a]/əˈmɪʃn/; [or]gmat;
sequence: [n]顺序,次序;连续,继续; [a]/ˈsiːkwəns/; [or]gmat;
canopy: [n]华盖;天篷;顶篷;苍穹; [vt]用天篷遮盖;遮蔽; [a]/ˈkænəpi/; [or]gmat;
assign: [v]布置;分配;指定;指派;归因;确定; [a]/əˈsaɪn/; [or]gmat;
curb: [v]勒住;抑制;控制;约束; [n]路缘;控制;约束; [a]/kɜːrb/; [or]gmat;
lever: [n]杠杆;控制杆;施加影响的手段; [v]用杠杆移动;撬开; [a]/ˈlevər/; [or]gmat;
mortgage: [n]按揭贷款,抵押贷款; [v]抵押; [a]/ˈmɔːrɡɪdʒ/; [or]gmat;
spouse: [n]配偶,夫妇;夫,妻; [v]和.结婚; [a]/spaʊs/; [or]gmat;
proximity: [n]接近;邻近; [a]/prɑːkˈsɪməti/; [or]gmat;
derision: [n]嘲笑,嘲笑的目标,笑柄; [a]/dɪˈrɪʒn/; [or]gmat;
accommodate: [v]向.提供住处(或膳宿);给.提供方便;容纳;使适应,顺应; [a]/əˈkɑːmədeɪt/; [or]gmat;
relic: [n]遗迹;神圣的遗物;纪念物; [a]/ˈrelɪk/; [or]gmat;
vocal: [n]声乐作品; [adj]畅言无忌的;声音的; [a]/ˈvoʊkl/; [or]gmat;
undue: [adj]过分的,不适当的;过度的;尚未到期的; [a]/ˌʌnˈduː/; [or]gmat;
explicit: [adj]充分表达清楚的,明确的;直率的,直截了当的;〔描绘性或暴力的语言或画面〕清晰露骨的; [a]/ɪkˈsplɪsɪt/; [or]gmat;
well-being: [n]健康,幸福,福利; [a]/ˈwel biːɪŋ/; [or]gmat;
turmoil: [n]骚动,骚乱; [a]/ˈtɜːrmɔɪl/; [or]gmat;
blot: [n]墨水渍;污点;缺点; [v]涂污;(用吸水纸)吸干墨水;遮暗; [a]/blɑːt/; [or]gmat;
cessation: [n]停止,中止,中断; [a]/seˈseɪʃn/; [or]gmat;
laurel: [n]月桂树,桂冠,殊荣; [v]使戴桂冠;给以荣誉; [a]/ˈlɔːrəl/; [or]gmat;
livelihood: [n]生活,生计;谋生方式; [a]/ˈlaɪvlihʊd/; [or]gmat;
wary: [adj]谨慎的,小心的,提防的;考虑周到的; [a]/ˈweri/; [or]gmat;
brace: [n][医学]牙齿定位器; [v]支柱;支撑;加固;使绷紧; [a]/breɪs/; [or]gmat;
variable: [adj]易变的,可变的; [n]变量,可变物; [a]/ˈveriəbl/; [or]gmat;
wrap: [v]裹,包,捆;覆盖; [n]包裹物,覆盖物;外衣; [a]/ræp/; [or]gmat;
prestige: [n]威望,声望; [a]/preˈstiːʒ/; [or]gmat;
negligence: [n]疏忽; [a]/ˈneɡlɪdʒəns/; [or]gmat;
discrimination: [n]歧视,偏见; [a]/dɪˌskrɪmɪˈneɪʃn/; [or]gmat;
dictate: [v]规定;命令;口授;听写; [n]命令;指令; [a]/ˈdɪkteɪt/; [or]gmat;
grievance: [n]牢骚,委屈,抱怨; [a]/ˈɡriːvəns/; [or]gmat;
rabble: [n]下层社会;乌合之众;暴民; [a]/ˈræbl/; [or]gmat;
rally: [n]集会;公路汽车赛; [v]集合;恢复(健康等),重新振作; [a]/ˈræli/; [or]gmat;
rumor: [n]谣言;传闻; [a]/'ruːmə/; [or]gmat;
unscrupulous: [adj]肆无忌惮的,无天理的; [a]/ʌnˈskruːpjələs/; [or]gmat;
outrageous: [adj]粗暴的,无礼的; [a]/aʊtˈreɪdʒəs/; [or]gmat;
appropriation: [n]挪用,拨款; [a]/əˌproʊpriˈeɪʃn/; [or]gmat;
hurricane: [n]飓风; [a]/ˈhɜːrəkeɪn/; [or]gmat;
smite: [n]重击,猛打; [vi]打,重击,猛烈撞击; [vt]猛打,杀死,惩罚; [a]/smaɪt/; [or]gmat;
apprentice: [v]使当学徒; [n]学徒; [a]/əˈprentɪs/; [or]gmat;
grind: [v]磨碎,碾碎;折磨;摩擦得吱吱作响; [n]苦差事,苦活儿;磨; [a]/ɡraɪnd/; [or]gmat;
injunction: [n][法]指令,禁令; [a]/ɪnˈdʒʌŋkʃn/; [or]gmat;
scarcity: [n]缺乏,不足; [a]/ˈskersəti/; [or]gmat;
outright: [adj]完全的,彻底的,全部地;直率的; [adv]完全地;直率地,痛快地;直截了当地; [a]/ˈaʊtraɪt/; [or]gmat;
fraction: [n]部分,片断,碎片;分数; [a]/ˈfrækʃn/; [or]gmat;
aggregate: [n]合计;总数;混凝料;总计; [v]集合;聚集;合计; [adj]总的,总数的;集合的; [a]/ˈæɡrɪɡət/; [or]gmat;
inexorable: [adj]不为所动的,坚决不变的; [n]坚定不移的人; [a]/ɪnˈeksərəbl/; [or]gmat;
sap: [n]树液,汁液;易上当的人; [v]削弱;逐渐耗竭; [vt]使伤元气; [vi]挖坑道进攻; [a]/sæp/; [or]gmat;
assassination: [n]暗杀; [a]/əˌsæsəˈneɪʃn/; [or]gmat;
pompous: [adj]傲慢的,浮华的; [a]/ˈpɑːmpəs/; [or]gmat;
exploit: [v]剥削,利用;开发,开拓; [n]辉煌功绩; [a]/ɪkˈsplɔɪt/; [or]gmat;
vacancy: [n]空,空白,空房;(职位)空缺;空虚; [a]/ˈveɪkənsi/; [or]gmat;
executioner: [n]刽子手,死刑执行人; [a]/ˌeksɪˈkjuːʃənər/; [or]gmat;
needy: [adj]贫困的;贫穷的;生活艰苦的; [a]/ˈniːdi/; [or]gmat;
affinity: [n]姻亲关系;密切关系;近似,类似关系;亲近; [a]/əˈfɪnəti/; [or]gmat;
immoral: [adj]不道德的;邪恶的;淫荡的; [a]/ɪˈmɔːrəl/; [or]gmat;
birch: [n]桦木,桦树,赤杨; [a]/bɜːrtʃ/; [or]gmat;
embark: [v]上船或飞机;开始,着手,从事; [a]/ɪmˈbɑːrk/; [or]gmat;
apiece: [adv]每人;每个;各自地; [a]/əˈpiːs/; [or]gmat;
invade: [v]侵略;侵犯;侵害;涌入;渗透;侵略,侵犯; [a]/ɪnˈveɪd/; [or]gmat;
sequel: [n]续集;结局;继续;后果; [a]/ˈsiːkwəl/; [or]gmat;
havoc: [n](天灾,战争等造成的)大破坏,大毁灭; [vi]损毁; [vt]严重破坏; [a]/ˈhævək/; [or]gmat;
distraction: [n]分心,分神;分心的事物;消遣,娱乐; [a]/dɪˈstrækʃn/; [or]gmat;
tablet: [n]药片;便笺簿;碑,匾; [a]/ˈtæblət/; [or]gmat;
publicity: [n]公开(性),公众的关注;宣传;名声; [a]/pʌbˈlɪsəti/; [or]gmat;
tumble: [v]翻滚;不由自主地卷入;(价格等)暴跌;跌倒,摔下,滚下; [n]跌倒,摔倒; [a]/ˈtʌmbl/; [or]gmat;
forge: [n]熔炉;锻工车间;铁匠店; [v]锻造;经锻炼而形成;伪造;推进,加强; [a]/fɔːrdʒ/; [or]gmat;
degenerate: [v]堕落,衰减; [adj]腐化的,颓废的,退化的;变质的; [n]堕落者; [a]/dɪˈdʒenəreɪt/; [or]gmat;
underlying: [adj]基本的;潜在的;在下面的; [a]/ˌʌndərˈlaɪɪŋ/; [or]gmat;
fossil: [n]化石; [adj]从地下发掘出来的;化石的;属于旧时代的;陈腐的; [a]/ˈfɑːsl/; [or]gmat;
constraint: [n]限制;强迫,拘束;强制; [a]/kənˈstreɪnt/; [or]gmat;
aurora: [n]极光;曙光; [a]/ɔːˌrɔːrə/; [or]gmat;
triple: [v]使成三倍,三倍于; [adj]三倍的; [a]/ˈtrɪpl/; [or]gmat;
pyramid: [n]金字塔; [a]/ˈpɪrəmɪd/; [or]gmat;
crater: [n]火山口;弹坑; [v]在.上形成坑;毁坏; [a]/ˈkreɪtər/; [or]gmat;
shrub: [n]灌木; [a]/ʃrʌb/; [or]gmat;
boom: [n]隆隆声;繁荣;景气;激增; [v]发出低沉有回响的声音;迅速发展,蓬勃发展;以低沉有回响的声音发出; [a]/buːm/; [or]gmat;
traverse: [v]横越;穿过; [n]横越; [a]/trəˈvɜːrs/; [or]gmat;
forthcoming: [adj]即将出现的,即将到来的;唾手可得的,可用的;乐于提供信息的; [a]/ˌfɔːrθˈkʌmɪŋ/; [or]gmat;
congress: [n]国会(美);代表大会;议会;立法机关; [a]/ˈkɑːŋɡrəs/; [or]gmat;
haven: [n]港湾;避难所; [vt]为.提供庇护所; [a]/ˈheɪvn/; [or]gmat;
equity: [n]公平,公正;衡平法;普通股;抵押资产的净值; [a]/ˈekwəti/; [or]gmat;
visionary: [n]有远见的人;幻想家; [adj]有远见的;爱幻想的; [a]/ˈvɪʒəneri/; [or]gmat;
archives: [n]档案室,档案; [a]/ˈɑːrkaɪvz/; [or]gmat;
decrease: [v]减少;减; [n]减;减少; [a]/dɪˈkriːs/; [or]gmat;
incur: [v]遭受;招致;引起; [a]/ɪnˈkɜːr/; [or]gmat;
antagonism: [n]对抗,敌对;敌意; [a]/ænˈtæɡənɪzəm/; [or]gmat;
slander: [n]诽谤,诋毁; [v]讲坏话,污蔑,诽谤; [a]/ˈslændər/; [or]gmat;
spruce: [n]云杉; [v](弄)整洁,(把)打扮漂亮; [adj]整洁的,潇洒的; [a]/spruːs/; [or]gmat;
panel: [n]讨论小组;仪表板;面,板; [v]嵌镶; [a]/ˈpænl/; [or]gmat;
relentless: [adj]顽强的;持续的;坚定地;冷酷的; [a]/rɪˈlentləs/; [or]gmat;
fictitious: [adj]虚构的; [a]/fɪkˈtɪʃəs/; [or]gmat;
anatomy: [n]人体;解剖学;剖析; [a]/əˈnætəmi/; [or]gmat;
preoccupied: [adj]全神贯注的,心事重重的,被先占的; [a]/priˈɑːkjupaɪd/; [or]gmat;
astronomy: [n]天文学; [a]/əˈstrɑːnəmi/; [or]gmat;
rupture: [n]破裂;割裂; [v]使破裂;断绝(关系); [a]/ˈrʌptʃər/; [or]gmat;
hazardous: [adj]有危险的;碰运气的; [adv]冒险地,有危险地; [n]冒险,危险; [a]/ˈhæzərdəs/; [or]gmat;
blockade: [n]封锁,阻碍物; [v]封锁; [a]/blɑːˈkeɪd/; [or]gmat;
altitude: [n]海拔,高度; [a]/ˈæltɪtuːd/; [or]gmat;
stew: [v]炖,焖,受闷热;使焦虑不安; [n]炖肉(或菜);鱼塘; [a]/stuː/; [or]gmat;
denote: [v]是.的标志;指出; [vt]指示;代表(或表示); [a]/dɪˈnoʊt/; [or]gmat;
thrive: [v]茁壮成长;繁荣,兴旺; [a]/θraɪv/; [or]gmat;
export: [v]出口,输出; [n]输出,出口,输出品; [a]/ˈekspɔːrt/; [or]gmat;
abolish: [v]废除,废止;取消,革除; [a]/əˈbɑːlɪʃ/; [or]gmat;
adjust: [v]调整,调节;校正;改变.以适应; [a]/əˈdʒʌst/; [or]gmat;
terrestrial: [adj]地球的,陆地的; [n]陆地生物;地球上的人; [a]/təˈrestriəl/; [or]gmat;
adhere: [v]遵守;坚持;粘附;附着,粘在..上; [a]/ədˈhɪr/; [or]gmat;
triangle: [n]三角形; [a]/ˈtraɪæŋɡl/; [or]gmat;
compulsory: [adj]强制的,必修的; [a]/kəmˈpʌlsəri/; [or]gmat;
hydrogen: [n]氢,氢气; [a]/ˈhaɪdrədʒən/; [or]gmat;
fragile: [adj]易碎的;易损坏的;虚弱的;脆弱的; [a]/ˈfrædʒl/; [or]gmat;
contingent: [n]分遣队; [adj]意外的,视情况条件而定的; [a]/kənˈtɪndʒənt/; [or]gmat;
chronic: [adj](疾病)慢性的;长期的;(人)久病的;积习难改的;严重的; [a]/ˈkrɑːnɪk/; [or]gmat;
dilemma: [n]进退两难的窘境; [a]/dɪˈlemə/; [or]gmat;
contraction: [n]收缩,紧缩;缩写式; [a]/kənˈtrækʃn/; [or]gmat;
symptom: [n]症状;征兆; [a]/ˈsɪmptəm/; [or]gmat;
bouquet: [n]花束,(酒的)芳香; [a]/buˈkeɪ/; [or]gmat;
sluggish: [adj]行动迟缓的,迟钝的;偷懒的; [a]/ˈslʌɡɪʃ/; [or]gmat;
lure: [v]引诱;以诱饵吸引; [n]诱惑力;诱惑物;鱼饵; [a]/lʊr/; [or]gmat;
outlaw: [n]歹徒,逃犯,丧失公权者; [v]将..放逐,宣布..为不合法; [a]/ˈaʊtlɔː/; [or]gmat;
spiral: [n]螺旋,螺线; [v]不断急剧地上升(或下降),螺旋形行进; [adj]螺旋的; [a]/ˈspaɪrəl/; [or]gmat;
wayside: [n]路边; [adj]路边的; [a]/ˈweɪsaɪd/; [or]gmat;
partisan: [adj]党派的;效忠的;偏袒的;盲目推崇的; [n]党羽;虔诚信徒;游击队; [a]/ˈpɑːrtəzn/; [or]gmat;
precipitous: [adj]险峻的;急躁的,鲁莽的; [a]/prɪˈsɪpɪtəs/; [or]gmat;
ripple: [n]涟漪,波纹; [v](使)泛起层层细浪; [a]/ˈrɪpl/; [or]gmat;
celebrity: [n]名人;名流; [adj]有名望的;名人的; [a]/səˈlebrəti/; [or]gmat;
eligible: [adj]适合被选的,符合条件的;(尤指婚姻等)合适的,合意的; [a]/ˈelɪdʒəbl/; [or]gmat;
prosecute: [v]起诉;做检察官;从事; [a]/ˈprɑːsɪkjuːt/; [or]gmat;
relinquish: [v]放弃,让出(权利,财产等),撤回; [a]/rɪˈlɪŋkwɪʃ/; [or]gmat;
repeal: [n]撤销; [v]废除;废止; [a]/rɪˈpiːl/; [or]gmat;
violate: [v]违反,违背;侵犯,妨碍;亵渎; [a]/ˈvaɪəleɪt/; [or]gmat;
intact: [adj]原封未动的,未受损的,完整无缺的; [a]/ɪnˈtækt/; [or]gmat;
incumbent: [n]在职者,现任者; [adj]现任的;依靠的;负有职责的; [a]/ɪnˈkʌmbənt/; [or]gmat;
tack: [n]平头钉;行动步骤; [v]钉住;使(船)抢风转变航向; [a]/tæk/; [or]gmat;
surpass: [v]胜过;超出; [a]/sərˈpæs/; [or]gmat;
marginal: [adj]微小的,不重要的;仅以微弱多数票获胜的; [n](议会或地方委员会的)边缘席位; [a]/ˈmɑːrdʒɪnl/; [or]gmat;
spine: [n]脊椎; [a]/spaɪn/; [or]gmat;
chord: [n]和弦;和音;心弦;(数学)弦; [a]/kɔːrd/; [or]gmat;
focus: [n]焦点,聚焦;焦距;关注; [v]使聚焦,集中注意力; [a]/ˈfoʊkəs/; [or]gmat;
detection: [n]察觉;侦察;检测,检验; [a]/dɪˈtekʃn/; [or]gmat;
nocturnal: [adj]夜晚的,夜间发生的; [a]/nɑːkˈtɜːrnl/; [or]gmat;
porcelain: [adj]瓷的;精美的;易碎的; [n]瓷,瓷器; [a]/ˈpɔːrsəlɪn/; [or]gmat;
arid: [adj](土地或气候)干燥的,干旱的,贫瘠的,荒芜的;无创见的,无新意的; [a]/ˈærɪd/; [or]gmat;
loom: [n]织布机; [v]阴森地逼近;隐现;即将来临; [a]/luːm/; [or]gmat;
overflow: [v]满得外溢,外流,泛滥;充满,洋溢; [n]溢流口,溢流管;容纳不下的物(或人);溢出,满出;超出额; [adj]充满的; [a]/ˌoʊvərˈfloʊ/; [or]gmat;
stitch: [v]缝,绣; [n]一针,线迹;缝法,编结法;(肋部的)突然剧痛;缝合(伤口); [a]/stɪtʃ/; [or]gmat;
ascribe: [v]把.归因于;把.归属于; [a]/əˈskraɪb/; [or]gmat;
stark: [adj]完全的,明显的,荒凉的; [adv]完全,明显地; [a]/stɑːrk/; [or]gmat;
animosity: [n]憎恶,仇恨; [a]/ˌænɪˈmɑːsəti/; [or]gmat;
shroud: [n]寿衣,覆盖物; [v]覆盖,包以尸衣; [a]/ʃraʊd/; [or]gmat;
moth: [n]蛾; [a]/mɔːθ/; [or]gmat;
budget: [n]预算; [v]预算,安排; [adj]廉价的; [a]/ˈbʌdʒɪt/; [or]gmat;
strategy: [n]谋略,策略,计谋; [a]/ˈstrætədʒi/; [or]gmat;
rigorous: [adj]严厉的,严格的; [a]/ˈrɪɡərəs/; [or]gmat;
civic: [adj]城市的;公民的,市民的; [a]/ˈsɪvɪk/; [or]gmat;
obnoxious: [adj]非常讨厌的;可憎的; [a]/əbˈnɑːkʃəs/; [or]gmat;
paramount: [n]元首;最高; [adj]最高的,至上的,首要的; [a]/ˈpærəmaʊnt/; [or]gmat;
insert: [vt]插入,嵌入; [n]插入物;插页; [a]/ɪnˈsɜːrt/; [or]gmat;
listless: [adj]无精打采的,倦怠的,情绪低落的;冷漠的; [a]/ˈlɪstləs/; [or]gmat;
pollen: [n]花粉; [a]/ˈpɑːlən/; [or]gmat;
flexible: [adj]易曲的,柔软的,灵活的; [a]/ˈfleksəbl/; [or]gmat;
switch: [n]开关;转变;转向;转辙器; [v]转换,转变;调换;转移;打开,关上; [vt]交换; [a]/swɪtʃ/; [or]gmat;
aspiration: [n]抱负,志向;发 h 音; [a]/ˌæspəˈreɪʃn/; [or]gmat;
decade: [n]十年,十年间; [a]/ˈdekeɪd/; [or]gmat;
multiple: [adj]多重的,复合的,倍数的; [n]倍数; [a]/ˈmʌltɪpl/; [or]gmat;
counterfeit: [n]仿制品,伪造物; [adj]仿造的.假冒的; [v]伪造,仿造; [a]/ˈkaʊntərfɪt/; [or]gmat;
cripple: [n]跛子,伤残人(或动物); [v]使跛;使受伤致残;严重削弱; [a]/ˈkrɪpl/; [or]gmat;
patrol: [n]巡逻兵;巡逻; [v]巡逻;巡查,巡游; [a]/pəˈtroʊl/; [or]gmat;
marrow: [n]骨髓,精华; [a]/ˈmæroʊ/; [or]gmat;
tenure: [n]任期;终身职位; [a]/ˈtenjər/; [or]gmat;
absorb: [vt]吸收;汲取;吸引..的注意;理解,掌握;承受; [a]/əbˈzɔːrb/; [or]gmat;
cone: [n]圆锥体;球果;甜筒; [vt]使成锥形; [a]/koʊn/; [or]gmat;
latch: [n]闩,碰锁,弹簧锁; [v]用闩把..闩上; [a]/lætʃ/; [or]gmat;
corral: [n]畜栏,环形车阵; [v]把.关进畜栏,捕捉,把.布成车阵; [a]/kəˈræl/; [or]gmat;
uneven: [adj]不平坦的;不均匀的,不规则的;不公正的; [a]/ʌnˈiːvn/; [or]gmat;
chronicle: [n]编年史,年代记,记录; [v]记录,把.载入编年史; [a]/ˈkrɑːnɪkl/; [or]gmat;
lateral: [n]侧面部分;支线; [adj]侧面的;横向的; [a]/ˈlætərəl/; [or]gmat;
defendant: [n]被告; [a]/dɪˈfendənt/; [or]gmat;
mosque: [n]伊斯兰教寺院;清真寺; [a]/mɑːsk/; [or]gmat;
exhaust: [v]使筋疲力尽;耗尽;详尽论述; [n]排气装置;废气; [a]/ɪɡˈzɔːst/; [or]gmat;
penitence: [n]后悔,忏悔; [a]/ˈpenɪtəns/; [or]gmat;
nucleus: [n]原子核,核心,细胞核; [a]/ˈnuːkliəs/; [or]gmat;
disperse: [v]使散开;分散,散开; [a]/dɪˈspɜːrs/; [or]gmat;
stumble: [v]绊跌,绊倒;结结巴巴说话; [n]绊倒;失足;失误;失败; [a]/ˈstʌmbl/; [or]gmat;
evade: [v]躲避,回避; [a]/ɪˈveɪd/; [or]gmat;
dogma: [n]教条;武断的意见; [adj]教义的,教条的,信条的; [a]/ˈdɔːɡmə/; [or]gmat;
mite: [n]极小量,小虫; [a]/maɪt/; [or]gmat;
tyrannical: [adj]暴君的,专制的,残酷的; [a]/tɪˈrænɪkl/; [or]gmat;
impersonal: [adj]客观的,没有人情味的,不及物的; [n][语]非人称动词;非人称代名词;不具人格的事物; [a]/ɪmˈpɜːrsənl/; [or]gmat;
auction: [n]拍卖; [v]拍卖; [a]/ˈɔːkʃn/; [or]gmat;
reservation: [n](住处,席位的)预订;保留态度,保留意见;(美国印第安部落的)居留地; [a]/ˌrezərˈveɪʃn/; [or]gmat;
sterile: [adj]不孕的,无细菌的,贫瘠的; [a]/ˈsterəl/; [or]gmat;
unprecedented: [adj]前所未有的,空前的,无前例的; [a]/ʌnˈpresɪdentɪd/; [or]gmat;
lounge: [n]候机室,休息室,酒吧间;沙发,躺椅;懒散的步子; [v](懒散地)倚,躺;闲逛; [a]/laʊndʒ/; [or]gmat;
onset: [n]开始;攻击,袭击; [a]/ˈɑːnset/; [or]gmat;
fickle: [adj](在感情等方面)反复无常的,轻浮的,善变的; [a]/ˈfɪkl/; [or]gmat;
magnet: [n]磁体,磁铁; [a]/ˈmæɡnət/; [or]gmat;
carcass: [n](动物,人)尸体;(屠宰后)兽体;(废屋,废船等的)骨架,遗骸; [a]/ˈkɑːrkəs/; [or]gmat;
transit: [n]运输;运送; [v]运送;通过; [a]/ˈtrænzɪt/; [or]gmat;
enlist: [v]得到.的赞助或帮助,应募,招募,参加,加入; [a]/ɪnˈlɪst/; [or]gmat;
census: [n]人口普查,人口调查;统计; [v]调查(某地区等的)人口数字;统计.的数字; [a]/ˈsensəs/; [or]gmat;
sustenance: [n]生计;食物,粮食; [a]/ˈsʌstənəns/; [or]gmat;
extinguish: [v]熄灭,扑灭;根除,消灭; [a]/ɪkˈstɪŋɡwɪʃ/; [or]gmat;
membrane: [n]膜;薄膜;羊皮纸; [a]/ˈmembreɪn/; [or]gmat;
hoary: [adj]年纪高迈的;(头发等)灰白的;古老的; [a]/ˈhɔːri/; [or]gmat;
complacency: [n]自满,自鸣得意;满足; [a]/kəmˈpleɪsnsi/; [or]gmat;
commodity: [n]商品,货物; [a]/kəˈmɑːdəti/; [or]gmat;
reciprocal: [adj]相互的,互惠的; [n]倒数;互相关联的事物; [a]/rɪˈsɪprəkl/; [or]gmat;
enrich: [v]使丰富;使富裕; [a]/ɪnˈrɪtʃ/; [or]gmat;
starch: [n]淀粉; [v]给.上浆; [a]/stɑːrtʃ/; [or]gmat;
intrinsic: [adj]固有的; [a]/ɪnˈtrɪnsɪk/; [or]gmat;
bias: [n]倾斜;偏心;偏见; [v]使有偏见; [a]/ˈbaɪəs/; [or]gmat;
ensue: [v]跟着发生,接踵而来;因而产生; [a]/ɪnˈsuː/; [or]gmat;
pulp: [n]果肉;果肉酱;纸浆; [v]去除果肉,捣成浆状; [a]/pʌlp/; [or]gmat;
levy: [v]征收(税等); [n]征税;税款; [a]/ˈlevi/; [or]gmat;
utilize: [v]利用;使用; [a]/ˈjuːtəlaɪz/; [or]gmat;
finite: [adj]有限的;限定的; [a]/ˈfaɪnaɪt/; [or]gmat;
scramble: [v]争夺,攀登; [a]/ˈskræmbl/; [or]gmat;
academic: [adj]学术的;学院的,大学的;理论的; [n]学者; [a]/ˌækəˈdemɪk/; [or]gmat;
inveterate: [adj]积习已深的,根深蒂固的,长期形成的; [a]/ɪnˈvetərət/; [or]gmat;
validity: [n]正确(性);有效(性),效力; [a]/vəˈlɪdəti/; [or]gmat;
prosaic: [adj]平凡的,乏味的,散文体的; [a]/prəˈzeɪɪk/; [or]gmat;
soar: [v]高飞,翱翔;飞腾;猛增;高飞越过; [n]高飞;高涨; [a]/sɔːr/; [or]gmat;
bereft: [adj]丧失的;被剥夺的;失去亲人的; [a]/bɪˈreft/; [or]gmat;
adapt: [vi]适应不同情况; [vt]使适合;改编; [a]/əˈdæpt/; [or]gmat;
admonition: [n]告诫,劝告,警告; [a]/ˌædməˈnɪʃn/; [or]gmat;
exodus: [n]大批离去,成群外出; [a]/ˈeksədəs/; [or]gmat;
animate: [v]使有生气,使活泼;鼓舞,推动; [adj]有生命的; [a]/ˈænɪmeɪt/; [or]gmat;
saturated: [adj]湿透的;充满的;饱和的; [a]/ˈsætʃəreɪtɪd/; [or]gmat;
buoyant: [adj]有浮力的;愉快的;(股市)保持高价的; [a]/ˈbɔɪənt/; [or]gmat;
ancestry: [n]祖先;血统; [a]/ˈænsestri/; [or]gmat;
broker: [n]经纪人,掮客; [v]作为经纪人进行谈判,以中间人等身份安排; [a]/ˈbroʊkər/; [or]gmat;
staple: [v]用订书钉订; [n]订书钉;主食;主要产品; [adj]主要的;基本的;标准的; [a]/ˈsteɪpl/; [or]gmat;
abstinence: [n]节制,禁欲; [a]/ˈæbstɪnəns/; [or]gmat;
molten: [adj]熔化的; [a]/ˈmoʊltən/; [or]gmat;
niche: [n]壁龛;合适的职业,生活方式;(有利可图的)市场,商机; [vt]放在适当的位置; [a]/nɪtʃ/; [or]gmat;
designate: [adj]已受委派而尚未上任的; [v]标出,说出;委任,任命,提名;指定; [a]/ˈdezɪɡneɪt/; [or]gmat;
exemplary: [adj]模范的,可仿效的; [a]/ɪɡˈzempləri/; [or]gmat;
projection: [n]预测,投射,投影规划; [a]/prəˈdʒekʃn/; [or]gmat;
tease: [v]取笑;挑逗;逗弄;使..渴望;逆梳; [n]爱戏弄别人者; [a]/tiːz/; [or]gmat;
maize: [n]玉米; [adj]黄色的,玉米色的; [a]/meɪz/; [or]gmat;
recipe: [n]方法;食谱; [a]/ˈresəpi/; [or]gmat;
enclose: [v]围住;圈起;装入信封;附有; [a]/ɪnˈkloʊz/; [or]gmat;
laudable: [adj]值得称赞的; [a]/ˈlɔːdəbl/; [or]gmat;
simultaneous: [adj]同时发生的; [a]/ˌsaɪmlˈteɪniəs/; [or]gmat;
plow: [v]犁,耕; [n]犁; [a]/plau/; [or]gmat;
wither: [v]枯萎;凋谢; [vt]使枯萎,使凋谢,萎缩;使人感觉羞惭或迷惑; [a]/ˈwɪðər/; [or]gmat;
physiological: [adj]生理的,生理学的; [a]/ˌfɪziəˈlɑːdʒɪkl/; [or]gmat;
category: [n]类别;范畴; [a]/ˈkætəɡɔːri/; [or]gmat;
comet: [n]彗星; [a]/ˈkɑːmət/; [or]gmat;
vestige: [n]遗迹,(生)退化的器官,残余,微量(一般用于否定句); [a]/ˈvestɪdʒ/; [or]gmat;
confront: [v]与某人对峙;与..对抗;正视; [a]/kənˈfrʌnt/; [or]gmat;
medieval: [adj]中世纪的,中古(时代)的; [a]/ˌmediˈiːvl/; [or]gmat;
propensity: [n]嗜好,习性;倾向; [a]/prəˈpensəti/; [or]gmat;
docile: [adj]驯服的,温顺的; [a]/ˈdɑːsl/; [or]gmat;
lobby: [n]门厅,大厅;休息室;游说团;投票厅; [vt]向(议员,政府官员等)进行游说(或疏通); [a]/ˈlɑːbi/; [or]gmat;
compensate: [v]补偿,赔偿,给..报酬; [a]/ˈkɑːmpenseɪt/; [or]gmat;
carol: [v]欢唱,歌颂; [n]颂歌,赞美诗,欢乐之歌; [a]/ˈkærəl/; [or]gmat;
aggression: [n]侵略;侵犯行为;攻击行为,(挑衅)行为;攻击性; [a]/əˈɡreʃn/; [or]gmat;
propitious: [adj]适合的;吉利的;顺利的; [a]/prəˈpɪʃəs/; [or]gmat;
thwart: [n][船]横坐板; [v]阻挠,阻碍,横过; [adj]横放的; [adv]横过; prep. 〈古〉横跨,横过; [a]/θwɔːrt/; [or]gmat;
prescribe: [v]给..开药;命令,指示; [a]/prɪˈskraɪb/; [or]gmat;
novice: [n]生手,新手; [a]/ˈnɑːvɪs/; [or]gmat;
frugal: [adj]节俭的,俭朴的;不昂贵的,廉价的,花钱少的,不充足的; [a]/ˈfruːɡl/; [or]gmat;
impetus: [n]推动力;促进; [a]/ˈɪmpɪtəs/; [or]gmat;
paralysis: [n]瘫痪(症),麻痹(症); [a]/pəˈræləsɪs/; [or]gmat;
reservoir: [n]水库;贮藏量; [a]/ˈrezərvwɑːr/; [or]gmat;
contagious: [adj](病)有传染性的;(人)患传染病的;有感染力的; [a]/kənˈteɪdʒəs/; [or]gmat;
trigger: [n](枪等的)扳机,诱因; [v]触发,引起,激发,扣扳机; [a]/ˈtrɪɡər/; [or]gmat;
counterpart: [n]对应的人(物);副本;对手; [a]/ˈkaʊntərpɑːrt/; [or]gmat;
instantaneous: [adj]瞬间的;即刻的;猝发的; [a]/ˌɪnstənˈteɪniəs/; [or]gmat;
responsive: [adj]反应积极的,反应敏捷的;反应热烈的;响应的; [a]/rɪˈspɑːnsɪv/; [or]gmat;
mold: [vt]塑造;使形成; [v]把..塑造成; [n]霉菌;模子;气质; [a]/moʊld/; [or]gmat;
chip: [n]木屑,碎片;缺口;圆形筹码;芯片;炸薯条,炸薯片; [v]碎裂;削,凿;将.削成,凿成; [a]/tʃɪp/; [or]gmat;
mole: [n][动]鼹鼠;黑痣;[化]克分子(量),摩尔;长期潜伏的间谍,内奸;防波堤; [a]/moʊl/; [or]gmat;
pottery: [n]陶器;陶艺;陶艺厂; [a]/ˈpɑːtəri/; [or]gmat;
surge: [n]波涛汹涌;波动;激增; [v]波浪般汹涌奔腾;激增; [a]/sɜːrdʒ/; [or]gmat;
perennial: [adj]终年的,永久的;四季不断的;反复的; [n]多年生植物; [a]/pəˈreniəl/; [or]gmat;
beverage: [n](水,酒等之外的)饮料; [a]/ˈbevərɪdʒ/; [or]gmat;
articulate: [adj]善于表达的;发音清晰的; [v]清晰地发音;清楚地讲话;连接,接合;与.合成整体 ,使相互连贯; [a]/ɑːrˈtɪkjuleɪt/; [or]gmat;
amend: [v]改进;修订;修正; [a]/əˈmend/; [or]gmat;
wield: [v]运用,行使;挥; [vt]使用; [a]/wiːld/; [or]gmat;
embryo: [n][动物学]胚胎; [a]/ˈembrioʊ/; [or]gmat;
democrat: [n]民主党人,民主主义者; [a]/ˈdeməkræt/; [or]gmat;
inlet: [n]水湾,小湾;进口,入口; [a]/ˈɪnlet/; [or]gmat;
juvenile: [n]青少年;雏鸟; [adj]青少年的;幼稚的; [a]/ˈdʒuːvənl/; [or]gmat;
overwhelm: [v]压垮;不知所措;淹没;打败,压倒; [a]/ˌoʊvərˈwelm/; [or]gmat;
overrun: [v]溢出,泛滥;(侵略军)横行; [n]泛滥成灾;超出限度; [a]/ˈoʊvərʌn/; [or]gmat;
predicament: [n]困境,穷境,尴尬的处境; [a]/prɪˈdɪkəmənt/; [or]gmat;
elevate: [v]上升;提高;举起;提拔; [a]/ˈelɪveɪt/; [or]gmat;
irrational: [adj]无理性的,失去理性的; [a]/ɪˈræʃənl/; [or]gmat;
outlying: [adj]远离中心的;边远的; [a]/ˈaʊtlaɪɪŋ/; [or]gmat;
indicative: [adj]指示的;暗示的;陈述的; [n]陈述语气; [a]/ɪnˈdɪkətɪv/; [or]gmat;
paradox: [n]矛盾;似矛盾而正确的说法; [a]/ˈpærədɑːks/; [or]gmat;
exaggerate: [vi]夸张; [vt]夸大,夸张;使扩大; [a]/ɪɡˈzædʒəreɪt/; [or]gmat;
intercept: [v]中途拦截,截取; [n]拦截;[数]截距;侦听; [a]/ˌɪntərˈsept/; [or]gmat;
cue: [n]提示;暗号;球杆; [v]给.提示; [a]/kjuː/; [or]gmat;
restitution: [n]归还,赔偿; [a]/ˌrestɪˈtuːʃn/; [or]gmat;
runner: [n]跑步者;信差;蔓藤植物; [a]/ˈrʌnər/; [or]gmat;
dormant: [adj]睡眠的,休眠的;静止的,隐伏的; [a]/ˈdɔːrmənt/; [or]gmat;
negotiate: [v]谈判,交涉,商议;成功越过,渡过; [a]/nɪˈɡoʊʃieɪt/; [or]gmat;
premium: [adj]高级的;高价的;(汽油)辛烷值高的; [n]额外费用,溢价;保险金; [a]/ˈpriːmiəm/; [or]gmat;
inducement: [n]诱因;刺激物;犯罪动因; [a]/ɪnˈduːsmənt/; [or]gmat;
regime: [n]政权;政治制度;养生法,生活规则; [a]/reɪˈʒiːm/; [or]gmat;
voluminous: [adj]大量的;长篇的,多产的;庞大的; [adv]宽松地;容量大地;篇幅长地; [n]宽松;容量大,篇幅长; [a]/vəˈluːmɪnəs/; [or]gmat;
crusade: [n]改革运动,十字军东侵; [v]加入十字军,从事改革运动; [a]/kruːˈseɪd/; [or]gmat;
epidemic: [adj]流行性的,传染的; [n]流行病,传染病,(犯罪等的)盛行; [a]/ˌepɪˈdemɪk/; [or]gmat;
mishap: [n]不幸的事,灾祸;晦气; [a]/ˈmɪshæp/; [or]gmat;
output: [n]产量,输出; [vt]生产,出产,制造;输出; [vi]生产,出产,制造;输出; [a]/ˈaʊtpʊt/; [or]gmat;
bankruptcy: [n]破产; [a]/ˈbæŋkrʌptsi/; [or]gmat;
anterior: [adj]前面的,先前的; [a]/ænˈtɪriər/; [or]gmat;
impediment: [n]妨碍,阻碍;障碍物;(言语)障碍;口吃; [a]/ɪmˈpedɪmənt/; [or]gmat;
antiquated: [adj]陈旧的,过时的; [v]使古旧,废弃; [a]/ˈæntɪkweɪtɪd/; [or]gmat;
oblique: [adj]斜的,非直角的,隐射的; [v]倾斜; [n][解]斜肌(尤指腹部的肌肉);倾斜物;[军]倾斜航空照片; [adv][军]以45度角; [a]/əˈbliːk/; [or]gmat;
cult: [n]异教;风尚,热潮;信徒; [adj]流行的;风靡一时的; [a]/kʌlt/; [or]gmat;
insidious: [adj](暗中或逐渐)为害的; [a]/ɪnˈsɪdiəs/; [or]gmat;
hatch: [n]船舱盖; [v]孵出,孵;策划; [a]/hætʃ/; [or]gmat;
brevity: [n]简短,短小,精炼; [a]/ˈbrevəti/; [or]gmat;
recruit: [v]招募(新兵),招收(新成员); [n]新兵,新成员; [a]/rɪˈkruːt/; [or]gmat;
coalition: [n]结合;联盟;联合; [a]/ˌkoʊəˈlɪʃn/; [or]gmat;
sensational: [adj]轰动性的;使人感动的,非常好的;引起哗然的; [a]/senˈseɪʃənl/; [or]gmat;
concede: [v]承认;承认失败;让给,让与;让步; [a]/kənˈsiːd/; [or]gmat;
insatiable: [adj]不能满足的,贪得无厌的; [a]/ɪnˈseɪʃəbl/; [or]gmat;
prevalence: [n]盛行;广泛分布;普遍; [a]/ˈprevələns/; [or]gmat;
bout: [n]一回合,较量,一阵; [a]/baʊt/; [or]gmat;
stagnant: [adj]不流动的;停滞的;萧条的; [a]/ˈstæɡnənt/; [or]gmat;
venom: [n]毒液;恶意;怨恨; [vt]使有毒;放毒; [a]/ˈvenəm/; [or]gmat;
ambiguous: [adj]含糊不清的,引起歧义的,模棱两可的; [a]/æmˈbɪɡjuəs/; [or]gmat;
caricature: [n]讽刺画,滑稽模仿;扭曲,夸张的描述; [a]/ˈkærɪkətʃər/; [or]gmat;
kinship: [n][法]亲属关系,家属关系;亲密关系; [a]/ˈkɪnʃɪp/; [or]gmat;
gut: [n](pl.)内脏,(幽门到直肠间的)肠子,勇气,剧情,内容,肚子,内脏,海峡; [adj]情感的;直觉的,本能的; [vt]取出内脏,摧毁(房屋等的)内部装置; [a]/ɡʌt/; [or]gmat;
counteract: [v]抵消;中和;阻碍; [a]/ˌkaʊntərˈækt/; [or]gmat;
florid: [adj]涨红的,华丽的,红润的; [a]/ˈflɔːrɪd/; [or]gmat;
reptile: [n]爬行动物,爬虫; [adj]爬行的,爬虫类的; [a]/ˈreptaɪl/; [or]gmat;
natal: [adj]出生的;分娩的;与生俱来的; [a]/ˈneɪtl/; [or]gmat;
spleen: [n]脾,脾气,怒气; [a]/spliːn/; [or]gmat;
residue: [n]剩余物;残渣;渣;残数; [a]/ˈrezɪduː/; [or]gmat;
irrelevant: [adj]不相关的; [a]/ɪˈreləvənt/; [or]gmat;
preside: [v]主持; [a]/prɪˈzaɪd/; [or]gmat;
forage: [v]搜寻,翻寻,觅食; [n](牛马的)饲料,粮草; [a]/ˈfɔːrɪdʒ/; [or]gmat;
bland: [vi]变得平淡无奇,变得枯燥无味; [adj]温和的;(食物等)清淡的;漠不关心的; [vt]使变得淡而无味,使变得枯燥无味;除掉.的特性; [a]/blænd/; [or]gmat;
extricate: [v]拯救,救出; [n]解脱;解脱者; [a]/ˈekstrɪkeɪt/; [or]gmat;
verify: [v]查证,证明,证实; [a]/ˈverɪfaɪ/; [or]gmat;
tribal: [adj]部落的; [n]部落成员; [a]/ˈtraɪbl/; [or]gmat;
dissent: [v]不同意;不信奉国教; [n]异议;(大写)不信奉国教; [a]/dɪˈsent/; [or]gmat;
bog: [n]沼泽;泥塘; [v]陷于泥沼;动弹不得; [a]/bɑːɡ/; [or]gmat;
illiterate: [n]文盲,目不识丁者; [adj]不识字的;缺乏(某方面)知识的;语法错误的; [a]/ɪˈlɪtərət/; [or]gmat;
speculate: [vi]推测,猜测;投机,做投机买卖; [vt]推测; [a]/ˈspekjuleɪt/; [or]gmat;
combustion: [n]燃烧; [a]/kəmˈbʌstʃən/; [or]gmat;
allay: [v]减轻;使缓和;使平静; [a]/əˈleɪ/; [or]gmat;
cocoa: [n]可可粉; [a]/ˈkoʊkoʊ/; [or]gmat;
lucrative: [adj]合算的;获利的;有利可图的; [a]/ˈluːkrətɪv/; [or]gmat;
blemish: [v]损害,玷污; [n]瑕疵,缺点; [a]/ˈblemɪʃ/; [or]gmat;
nitrogen: [n]氮; [a]/ˈnaɪtrədʒən/; [or]gmat;
afflict: [v]使痛苦;使苦恼; [a]/əˈflɪkt/; [or]gmat;
fortify: [v]设防于;增强; [a]/ˈfɔːrtɪfaɪ/; [or]gmat;
invoke: [v]调用,祈求,恳求,引起; [a]/ɪnˈvoʊk/; [or]gmat;
mimic: [v]模仿,戏弄; [n]模仿者; [adj]模拟的;假的,伪装的; [a]/ˈmɪmɪk/; [or]gmat;
impoverished: [adj]穷困的,用尽了的,无创造性的; [a]/ɪmˈpɑːvərɪʃt/; [or]gmat;
perpetuate: [adj]长存的; [vt]使永久存在,使不朽; [a]/pərˈpetʃueɪt/; [or]gmat;
volatile: [adj]易气化的;爆炸性的;反复无常的;短暂的;不稳定的; [a]/ˈvɑːlətl/; [or]gmat;
accumulate: [vi]聚积,堆积; [vt]积攒,积累; [a]/əˈkjuːmjəleɪt/; [or]gmat;
immaterial: [adj]非实体的,无关紧要的; [a]/ˌɪməˈtɪriəl/; [or]gmat;
quail: [n]鹌鹑; [v]畏缩;感到恐惧; [a]/kweɪl/; [or]gmat;
implication: [n]暗示;含意;牵连;卷入;可能的后果; [a]/ˌɪmplɪˈkeɪʃn/; [or]gmat;
pop: [v]发出(砰的响声),突然出现,爆开,开枪; [n]砰的一声爆破声;流行音乐;汽水; [adj]流行的,大众的; [a]/pɑːp/; [or]gmat;
incentive: [n]刺激,激励;鼓励; [a]/ɪnˈsentɪv/; [or]gmat;
degrade: [v]贬低;降低品格(身价,价值等);分解;降低; [a]/dɪˈɡreɪd/; [or]gmat;
recipient: [n]接受者;容器;间接宾语; [adj]接受的;善于接受的;接受能力强的; [a]/rɪˈsɪpiənt/; [or]gmat;
indigenous: [adj]土生土长的,本土的; [a]/ɪnˈdɪdʒənəs/; [or]gmat;
rudimentary: [adj]基本的,初期的;发育不完全的;退化的; [a]/ˌruːdɪˈmentri/; [or]gmat;
complement: [v]补充;与.相配; [n]补充;互为补充的东西;补语; [a]/ˈkɑːmplɪment/; [or]gmat;
constituent: [adj]组成的;有选举权的; [n]选民;成分; [a]/kənˈstɪtʃuənt/; [or]gmat;
specious: [adj]外表美观,华而不实的,徒有其表的; [a]/ˈspiːʃəs/; [or]gmat;
seductive: [adj]有魅力的;性感的;引人注意的; [a]/sɪˈdʌktɪv/; [or]gmat;
villainy: [n]邪恶,恶行,腐化堕落,道德败坏,(复)犯罪行为; [a]/ˈvɪləni/; [or]gmat;
contingency: [n]偶然性;[安全]意外事故;可能性;[审计]意外开支; [a]/kənˈtɪndʒənsi/; [or]gmat;
terminate: [adj]终止的;可结尾的; [vi]结束;结尾; [v]使结束,终止; [a]/ˈtɜːrmɪneɪt/; [or]gmat;
opulent: [adj]富裕的,充足的; [a]/ˈɑːpjələnt/; [or]gmat;
qualify: [v]胜任,使具有资格;描述,形容; [a]/ˈkwɑːlɪfaɪ/; [or]gmat;
corporate: [adj]公司的;全体的;共同的;(法人)团体的; [a]/ˈkɔːrpərət/; [or]gmat;
originate: [vi]起源;开始; [vt]开创; [a]/əˈrɪdʒɪneɪt/; [or]gmat;
marshy: [adj]沼泽的;湿地的; [a]/ˈmɑːrʃi/; [or]gmat;
retail: [adj]零售的; [n]零售; [v]零售,零售价是; [adv]以零售方式,以零售形式; [a]/ˈriːteɪl/; [or]gmat;
fallacy: [n]谬论,谬见;错误,谬误; [a]/ˈfæləsi/; [or]gmat;
chisel: [v]刻,凿; [n]凿子; [a]/ˈtʃɪzl/; [or]gmat;
compatible: [adj]可和谐共存的;兼容的; [a]/kəmˈpætəbl/; [or]gmat;
tinker: [n](流动的)补锅工人; [v]做拙劣修补; [a]/ˈtɪŋkər/; [or]gmat;
sanitary: [adj]卫生的;清洁的; [a]/ˈsænəteri/; [or]gmat;
physiology: [n]生理机能,生理学; [a]/ˌfɪziˈɑːlədʒi/; [or]gmat;
bead: [n]珠子;水珠; [a]/biːd/; [or]gmat;
decorous: [adj]端庄稳重的,正派得体的,有礼貌的,高雅的; [a]/ˈdekərəs/; [or]gmat;
dispel: [v]驱散,驱逐;消除(烦恼等); [a]/dɪˈspel/; [or]gmat;
duplicate: [n]复制品; [v]复制;重复; [adj]完全一样的; [a]/ˈduːplɪkeɪt/; [or]gmat;
lobster: [n]龙虾; [v]捕龙虾; [a]/ˈlɑːbstər/; [or]gmat;
booth: [n]小舍;隔开的小间;公用电话亭;有篷的售货摊;窝棚; [a]/buːθ/; [or]gmat;
portfolio: [n]公文包,文件夹,投资组合;股份单; [a]/pɔːrtˈfoʊlioʊ/; [or]gmat;
opaque: [adj]不透明的;难懂的; [a]/oʊˈpeɪk/; [or]gmat;
acquiesce: [v]默许;勉强同意; [adj]默认的; [a]/ˌækwiˈes/; [or]gmat;
polar: [adj]极地的;南北两极的;截然对立的,正好相反的; [a]/ˈpoʊlər/; [or]gmat;
consecutive: [adj]连续的,连贯的; [a]/kənˈsekjətɪv/; [or]gmat;
discount: [n](价格,债款等)折扣; [v]打折扣,不全信,怀疑地看待; [a]/ˈdɪskaʊnt/; [or]gmat;
acupuncture: [n]针刺(疗法); [vt]用针灸术治疗;用针刺法麻醉,对.施行针灸治疗; [a]/ˈækjupʌŋktʃər/; [or]gmat;
predict: [v]预言,预告,预测; [a]/prɪˈdɪkt/; [or]gmat;
hierarchy: [n]阶层,等级制度; [a]/ˈhaɪərɑːrki/; [or]gmat;
vernacular: [adj]本国的,地方的,用本地语写成的; [n]方言;土语;(建筑的)民间风格; [a]/vərˈnækjələr/; [or]gmat;
outlay: [v]花费; [n][会计]费用;支出;经费; [a]/ˈaʊtleɪ/; [or]gmat;
contiguous: [adj]相接的;邻近的,附近的; [a]/kənˈtɪɡjuəs/; [or]gmat;
tentative: [adj]试探性的;不确定的;暂时的;犹豫不决的; [a]/ˈtentətɪv/; [or]gmat;
arable: [adj]可耕的,适合种植的; [n]耕地; [a]/ˈærəbl/; [or]gmat;
plumb: [n]铅锤,测锤; [vi]垂直悬挂; [adj]垂直的; [vt]用铅锤测量; [adv]垂直地; [a]/plʌm/; [or]gmat;
endanger: [v]危及,危害; [a]/ɪnˈdeɪndʒər/; [or]gmat;
expire: [v]期满,(期限)终止;断气,死亡; [a]/ɪkˈspaɪər/; [or]gmat;
hover: [v](鸟,直升机)盘旋,翱翔;(人)逗留在附近,徘徊; [a]/ˈhʌvər/; [or]gmat;
debris: [n]废墟,残骸; [a]/dəˈbriː/; [or]gmat;
lizard: [n]蜥蜴; [a]/ˈlɪzərd/; [or]gmat;
obeisance: [n]鞠躬,敬礼;尊敬; [a]/oʊˈbiːsns/; [or]gmat;
poke: [v]刺,戳;拨开,拨(弄);探(出),露出; [n]戳,捅; [a]/poʊk/; [or]gmat;
deter: [v]防止,阻止,使踌躇; [a]/dɪˈtɜːr/; [or]gmat;
elude: [v]逃避,躲避;使.错过,使.找不到;使.不记得;把.难住; [a]/iˈluːd/; [or]gmat;
salient: [adj]显著的;突出的;跳跃的; [n]凸角;突出部分; [a]/ˈseɪliənt/; [or]gmat;
immutable: [adj]永远不变的,永恒的; [a]/ɪˈmjuːtəbl/; [or]gmat;
inflection: [n]弯曲,变形,音调变化; [a]/ɪnˈflekʃn/; [or]gmat;
retaliation: [n]反击;回敬;报复; [a]/rɪˌtæliˈeɪʃn/; [or]gmat;
pinnacle: [n](哥德式建筑的)小尖塔,顶峰; [v]置于尖顶上,置于高处; [a]/ˈpɪnəkl/; [or]gmat;
impact: [n]碰撞,冲击;冲击力;影响; [v]冲击;压紧;产生影响;塞满; [a]/ˈɪmpækt/; [or]gmat;
fiber: [n]纤维(物质);纤维组织;(植物) 纤维; [a]/ˈfaɪbər/; [or]gmat;
sip: [v]啜饮; [n]一小口; [a]/sɪp/; [or]gmat;
persecute: [v](尤指因宗教或政治信仰不同)迫害;烦扰,纠缠; [a]/ˈpɜːrsɪkjuːt/; [or]gmat;
omnipotent: [adj]全能的,万能的; [n]全能者; [a]/ɑːmˈnɪpətənt/; [or]gmat;
annuity: [n]年金,养老金;年金保险;年金享受权; [a]/əˈnuːəti/; [or]gmat;
visual: [adj]看的,视觉的; [n]视觉资料(指说明性的图片,影片等); [a]/ˈvɪʒuəl/; [or]gmat;
impartiality: [n]公正,公平;不偏不倚; [a]/ˌɪmˌpɑːrʃiˈæləti/; [or]gmat;
parole: [n]特别口令;假释; [v]有条件释放,假释;使假释出狱;宣誓后释放; [adj]假释的; [a]/pəˈroʊl/; [or]gmat;
apothecary: [n]药剂师; [a]/əˈpɑːθəkeri/; [or]gmat;
mosquito: [n]蚊子; [a]/məˈskiːtoʊ/; [or]gmat;
plaintiff: [n]原告; [a]/ˈpleɪntɪf/; [or]gmat;
feasible: [adj]可行的,行得通的; [a]/ˈfiːzəbl/; [or]gmat;
elusive: [adj]难懂的;难捉摸的;难找的;难懂的;易忘的;逃避的;难捉摸的; [a]/iˈluːsɪv/; [or]gmat;
wrestle: [v]摔跤,角斗;斗争,努力; [n]摔跤,角力,扭斗; [a]/ˈresl/; [or]gmat;
minus: prep. 减(去); [adj]负的; [n]减号;劣势; [a]/ˈmaɪnəs/; [or]gmat;
symmetrical: [adj]对称的; [a]/sɪˈmetrɪkl/; [or]gmat;
mosaic: [n]镶嵌细工,马赛克; [adj]摩西的;拼花的; [vt]镶嵌;用马赛克装饰; [a]/moʊˈzeɪɪk/; [or]gmat;
effigy: [n]肖像,模拟像; [a]/ˈefɪdʒi/; [or]gmat;
infectious: [adj]传染的;感染性的;易传播的; [a]/ɪnˈfekʃəs/; [or]gmat;
condescending: [adj]贬低的;有优越感的; [a]/ˌkɑːndɪˈsendɪŋ/; [or]gmat;
memoir: [n]回忆录,自传(memoirs);传略; [a]/ˈmemwɑːr/; [or]gmat;
coinage: [n]铸币造币(权);货币,货币制度; [a]/ˈkɔɪnɪdʒ/; [or]gmat;
smallpox: [n]天花; [a]/ˈsmɔːlpɑːks/; [or]gmat;
authorize: [v]批准;授权; [a]/ˈɔːθəraɪz/; [or]gmat;
tilt: [v](使)倾斜; [n]倾斜,斜坡; [a]/tɪlt/; [or]gmat;
digit: [n]阿拉伯数字,手指,足趾,一指之宽; [a]/ˈdɪdʒɪt/; [or]gmat;
antidote: [n][药]解毒剂,解药;矫正方法; [a]/ˈæntidoʊt/; [or]gmat;
noxious: [adj]有害的,有毒的; [a]/ˈnɑːkʃəs/; [or]gmat;
constellation: [n]星座,星群,一系列,一群; [a]/ˌkɑːnstəˈleɪʃn/; [or]gmat;
herring: [n]鲱鱿; [a]/ˈherɪŋ/; [or]gmat;
preoccupation: [n]抢先占据;全神贯注;首先要做的事,急务; [a]/priˌɑːkjuˈpeɪʃn/; [or]gmat;
fraudulent: [adj]欺诈的,欺骗性的,骗得的; [a]/ˈfrɔːdʒələnt/; [or]gmat;
inordinate: [adj]过度的,无节制的;紊乱的; [a]/ɪnˈɔːrdɪnət/; [or]gmat;
proportional: [adj]成比例的,相称的; [n][数]比例项,比例量; [a]/prəˈpɔːrʃənl/; [or]gmat;
astute: [adj]机敏的,精明的,狡猾的; [a]/əˈstuːt/; [or]gmat;
bountiful: [adj]充足的,慷慨的,丰裕的; [a]/ˈbaʊntɪfl/; [or]gmat;
fatality: [n]死亡;宿命;致命性;不幸,灾祸; [a]/fəˈtæləti/; [or]gmat;
approximate: [adj]近似的,约略的; [v]接近,近似; [a]/əˈprɑːksɪmət/; [or]gmat;
erudition: [n]博学,学识,学问; [a]/ˌeruˈdɪʃn/; [or]gmat;
betrayal: [n]背叛;辜负;暴露; [a]/bɪˈtreɪəl/; [or]gmat;
fraternal: [adj]兄弟的,兄弟般的,友爱的; [a]/frəˈtɜːrnl/; [or]gmat;
enumeration: [n]列举; [a]/ɪˌnuːməˈreɪʃn/; [or]gmat;
artery: [n]动脉;干线; [a]/ˈɑːrtəri/; [or]gmat;
precipitation: [n]猛然摔下;促使;急促;沉淀;降水; [a]/prɪˌsɪpɪˈteɪʃn/; [or]gmat;
sloth: [n]懒惰;树懒; [a]/slɑːθ/; [or]gmat;
erratic: [adj]古怪的;反复无常的,不稳定的; [a]/ɪˈrætɪk/; [or]gmat;
forecast: [n]预测;预报; [v]预报,预测; [a]/ˈfɔːrkæst/; [or]gmat;
knack: [n]诀窍;本领;熟练技术;巧妙手法; [a]/næk/; [or]gmat;
exotic: [adj]奇异的,珍奇的,来自异国的; [a]/ɪɡˈzɑːtɪk/; [or]gmat;
drab: [adj]枯黄色的,无聊的,单调的; [n]单调;淡褐色;[印,纺]淡褐色厚呢;邋遢女人; [a]/dræb/; [or]gmat;
lyrical: [adj]抒情诗调的;感情丰富的;充满愉悦的; [a]/ˈlɪrɪkl/; [or]gmat;
enhance: [v]提高(强度,力量,数量等);增加,加强; [a]/ɪnˈhæns/; [or]gmat;
enumerate: [v]列举; [a]/ɪˈnuːməreɪt/; [or]gmat;
poll: [n]投票,投票数;投票站;民意测验; [v]获得(票数); [adj][法]当事人一方作成的; [a]/poʊl/; [or]gmat;
rigor: [n]严厉;精确;困难境地; [a]/'rɪgə/; [or]gmat;
caliph: [n]哈里发(伊斯兰国家政教合一的领袖称号); [a]/ˈkeɪlɪf/; [or]gmat;
component: [n]零件; [adj]组成的; [a]/kəmˈpoʊnənt/; [or]gmat;
pendant: [n]吊坠,下垂物; [a]/ˈpendənt/; [or]gmat;
decorate: [v]装饰,布置;把(勋章)授给(某人); [a]/ˈdekəreɪt/; [or]gmat;
confederation: [n]同盟,联盟; [a]/kənˌfedəˈreɪʃn/; [or]gmat;
secretion: [n]分泌,分泌物;隐藏; [a]/sɪˈkriːʃn/; [or]gmat;
coincide: [v]巧合,一致,相符; [a]/ˌkoʊɪnˈsaɪd/; [or]gmat;
purge: [v]通便,净化,使(身,心)清净; [n]驱赶,泻药,净化; [a]/pɜːrdʒ/; [or]gmat;
scan: [v]细看;浏览;扫描; [n]扫描;浏览; [a]/skæn/; [or]gmat;
urine: [n]尿; [a]/ˈjʊrən/; [or]gmat;
ravenous: [adj]贪婪的;渴望的,极饿的;狼吞虎咽的; [a]/ˈrævənəs/; [or]gmat;
elective: [adj]选修的,选举的,选任的; [n]选修课程; [a]/ɪˈlektɪv/; [or]gmat;
funnel: [n]漏斗;烟囱; [v]汇集;通过漏斗等;(使)成漏斗形; [a]/ˈfʌnl/; [or]gmat;
embody: [v]包含;体现,象征; [a]/ɪmˈbɑːdi/; [or]gmat;
metropolitan: [adj]大城市的,大都会的;大主教区的; [a]/ˌmetrəˈpɑːlɪtən/; [or]gmat;
cosmic: [adj]宇宙的;广大无边的; [a]/ˈkɑːzmɪk/; [or]gmat;
renegade: [n]叛教者,脱党者,叛徒; [v]背叛,背教,变节; [adj]叛教的,背叛的,变节的; [a]/ˈrenɪɡeɪd/; [or]gmat;
incipient: [adj]初期的;刚出现的; [a]/ɪnˈsɪpiənt/; [or]gmat;
cupidity: [n]贪婪; [a]/kjuːˈpɪdəti/; [or]gmat;
aquatic: [adj]水生的,水栖的,水中的,水上的; [n]水生动物,水生植物;水上运动; [a]/əˈkwætɪk/; [or]gmat;
propagation: [n]繁殖;传播; [a]/ˌprɑːpəˈɡeɪʃn/; [or]gmat;
dominate: [v]在.中占首要地位;支配,统治,控制;耸立于,俯视;处于支配地位,拥有优势; [a]/ˈdɑːmɪneɪt/; [or]gmat;
graze: [v](牲畜)吃草;放牧;擦过; [n]擦,擦伤; [a]/ɡreɪz/; [or]gmat;
practitioner: [n](医生或律师等)开业者;实践者,从事者; [a]/prækˈtɪʃənər/; [or]gmat;
stench: [n]臭气,恶臭; [vi](使)发恶臭; [vt]发恶臭; [a]/stentʃ/; [or]gmat;
hamper: [v]阻碍,妨碍,牵制; [n](有盖的)大篮子; [a]/ˈhæmpər/; [or]gmat;
reflex: [n]条件反射,反映; [adj]有反应的;反作用的(效果,音响等);反省的;回想的; [a]/ˈriːfleks/; [or]gmat;
semicircle: [n]半圆形; [a]/ˈsemisɜːrkl/; [or]gmat;
burrow: [n]洞穴,地道;藏身处,住处; [v]挖;钻进;搜寻; [vt]掩蔽; [a]/ˈbɜːroʊ/; [or]gmat;
collateral: [adj]间接的,旁系的; [n]抵押品; [a]/kəˈlætərəl/; [or]gmat;
strategic: [adj]战略(上)的,对全局有重要意义的,关键的; [a]/strəˈtiːdʒɪk/; [or]gmat;
psyche: [n]灵魂;心智; [a]/ˈsaɪki/; [or]gmat;
sensuality: [n]淫荡,好色; [a]/ˌsenʃuˈæləti/; [or]gmat;
prodigy: [n]天才; [a]/ˈprɑːdədʒi/; [or]gmat;
influx: [n]流入,涌入;河口; [a]/ˈɪnflʌks/; [or]gmat;
falter: [v]蹒跚,摇摆;踌躇;畏缩; [n]踌躇;支吾;颤抖; [a]/ˈfɔːltər/; [or]gmat;
stimulant: [n][药]兴奋剂;刺激物;酒精饮料; [adj]激励的;使人兴奋的; [a]/ˈstɪmjələnt/; [or]gmat;
microscopic: [adj]极小的;用显微镜可见的; [a]/ˌmaɪkrəˈskɑːpɪk/; [or]gmat;
humid: [adj]潮湿的;湿润的;多湿气的; [a]/ˈhjuːmɪd/; [or]gmat;
mythological: [adj]神话的,虚构的; [a]/ˌmɪθəˈlɑːdʒɪkl/; [or]gmat;
eliminate: [v]消灭,铲除;消除,根除;(在比赛中)淘汰; [a]/ɪˈlɪmɪneɪt/; [or]gmat;
personnel: [n]人事部门,员工,人员; [a]/ˌpɜːrsəˈnel/; [or]gmat;
circulate: [v](使)流通;(使)循环;(使)传播,流传; [a]/ˈsɜːrkjəleɪt/; [or]gmat;
perversion: [n]堕落,曲解;性怪癖; [a]/pərˈvɜːrʒn/; [or]gmat;
notify: [v]通知,告知;报告; [a]/ˈnoʊtɪfaɪ/; [or]gmat;
irreconcilable: [adj]不能妥协的,不能和解的,不能协调的; [n]不能和解的人,(政治上的)死硬派; [a]/ɪˈrekənsaɪləbl/; [or]gmat;
narrator: [n]叙述者;解说员; [a]/ˈnæreɪtər/; [or]gmat;
illicit: [adj]违法的,违禁的; [a]/ɪˈlɪsɪt/; [or]gmat;
artisan: [n]工匠,手艺人; [a]/ˈɑːrtəzn/; [or]gmat;
discard: [v]丢弃;抛弃;遗弃; [a]/dɪsˈkɑːrd/; [or]gmat;
measles: [n][医]麻疹; [a]/ˈmiːzlz/; [or]gmat;
explode: [v]爆炸;激增;爆发;使爆炸;驳倒; [a]/ɪkˈsploʊd/; [or]gmat;
pry: [v]刺探,打听,撬开; [n]窥探;杠杆;爱打探的人; [a]/praɪ/; [or]gmat;
ingredient: [n](烹调的)原料;(构成的)要素,因素; [a]/ɪnˈɡriːdiənt/; [or]gmat;
deficit: [n]亏损;赤字;不足额; [a]/ˈdefɪsɪt/; [or]gmat;
heretical: [adj]异端的,异教的; [a]/həˈretɪkl/; [or]gmat;
antithesis: [n]对立面,对照; [a]/ænˈtɪθəsɪs/; [or]gmat;
evacuation: [n]疏散,撤离,排泄; [a]/ɪˌvækjuˈeɪʃn/; [or]gmat;
insuperable: [adj]难以克服的,无敌的; [a]/ɪnˈsuːpərəbl/; [or]gmat;
chronology: [n]年代学;(事件等)按年月次序的排列;年表; [a]/krəˈnɑːlədʒi/; [or]gmat;
credence: [n]信任,相信; [a]/ˈkriːdns/; [or]gmat;
fallow: [adj]休耕的;不活跃的;休闲地,休闲的; [n]休耕地;休耕; [v]使(翻耕后的土地)休闲; [a]/ˈfæloʊ/; [or]gmat;
palatable: [adj]美味的,合口味的,合心意的; [a]/ˈpælətəbl/; [or]gmat;
obligatory: [adj]强制性的;义务的;必须的; [a]/əˈblɪɡətɔːri/; [or]gmat;
indiscriminate: [adj]任意的;不加区别的,不加选择的; [a]/ˌɪndɪˈskrɪmɪnət/; [or]gmat;
rib: [n]肋骨,伞骨; [v]装肋于;用肋状物支撑; [a]/rɪb/; [or]gmat;
adept: [n]专家,能手; [adj]熟练的;巧妙的; [a]/əˈdept/; [or]gmat;
stringent: [adj]严厉的;迫切的;银根紧的; [a]/ˈstrɪndʒənt/; [or]gmat;
intriguing: [adj]迷人的,有迷惑力的,引起兴趣(或好奇心)的; [a]/ɪnˈtriːɡɪŋ/; [or]gmat;
nickel: [n]镍;美国五分镍币;五分钱; [a]/ˈnɪkl/; [or]gmat;
penitentiary: [n]监狱,感化院; [adj]应处监禁的,监禁的,忏悔的; [a]/ˌpenɪˈtenʃəri/; [or]gmat;
unwieldy: [adj]使用不便的,不灵巧的,难处理的;笨重的; [a]/ʌnˈwiːldi/; [or]gmat;
reticent: [adj]沉默不语的;有保留的;含蓄的; [a]/ˈretɪsnt/; [or]gmat;
exhort: [vt]敦促,劝告; [vi]规劝,劝告; [a]/ɪɡˈzɔːrt/; [or]gmat;
canary: [n]金丝雀,女歌星; [adj]加那利群岛的;鲜黄色的; [a]/kəˈneri/; [or]gmat;
tile: [n]瓦;瓷砖; [v]贴砖于;用瓦盖; [a]/taɪl/; [or]gmat;
homogeneous: [adj]同类的,同质的,有相同特征的; [a]/ˌhoʊməˈdʒiːniəs/; [or]gmat;
missile: [n]导弹;投射出的物体或武器; [adj]导弹的;可投掷的;用以发射导弹的; [a]/ˈmɪsl/; [or]gmat;
spin: [v](使)旋转;纺织;疾驰;眩晕; [n]旋转;纺织;眩晕; [a]/spɪn/; [or]gmat;
deterioration: [n]变坏,退化,恶化;堕落; [a]/dɪˌtɪriəˈreɪʃn/; [or]gmat;
rhinoceros: [n]犀牛; [a]/raɪˈnɑːsərəs/; [or]gmat;
pliant: [adj]易弯的,柔软的; [n]顺从; [a]/ˈplaɪənt/; [or]gmat;
dividend: [n](股份的)红利,回报,效益,被除数; [a]/ˈdɪvɪdend/; [or]gmat;
computation: [n]估计,计算; [a]/ˌkɑːmpjuˈteɪʃn/; [or]gmat;
impede: [v]妨碍,阻碍; [a]/ɪmˈpiːd/; [or]gmat;
depict: [v]描绘,描写; [a]/dɪˈpɪkt/; [or]gmat;
reinforce: [v]加固;加强;增援;支持; [a]/ˌriːɪnˈfɔːrs/; [or]gmat;
propeller: [n]螺旋桨;推进器; [a]/prəˈpelər/; [or]gmat;
chef: [n]主厨;厨师; [a]/ʃef/; [or]gmat;
pertinent: [adj]有关的;适当的;中肯的; [n]附属物;参考; [a]/ˈpɜːrtnənt/; [or]gmat;
rewind: [v]倒回(磁带等),倒带; [a]/ˌriːˈwaɪnd/; [or]gmat;
parasite: [n]寄生虫;靠他人为生的人; [a]/ˈpærəsaɪt/; [or]gmat;
coherent: [adj]协调一致的;条理清楚的,有条理的;连贯的;有黏性的,黏合在一起的,粘着的; [a]/koʊˈhɪrənt/; [or]gmat;
frustrate: [v]使灰心;挫败;阻挠; [a]/ˈfrʌstreɪt/; [or]gmat;
potassium: [n]钾; [a]/pəˈtæsiəm/; [or]gmat;
retrieve: [v]取回,重新得到,挽回,检索; [a]/rɪˈtriːv/; [or]gmat;
intentional: [adj]故意的;有意图的; [a]/ɪnˈtenʃənl/; [or]gmat;
algebra: [n]代数; [a]/ˈældʒɪbrə/; [or]gmat;
painstaking: [adj](不辞)劳苦的,辛勤的; [n]辛劳,煞费苦心; [a]/ˈpeɪnzteɪkɪŋ/; [or]gmat;
Catholic: [adj](兴趣等)广泛的,(C大写)天主教的; [n](C大写)天主教徒; [a]/ˈkæθlɪk/; [or]gmat;
alleviate: [v]减轻;缓解;缓和; [a]/əˈliːvieɪt/; [or]gmat;
entice: [v]怂恿,引诱; [a]/ɪnˈtaɪs/; [or]gmat;
optical: [adj]光学的;视觉的; [a]/ˈɑːptɪkl/; [or]gmat;
enact: [v]颁布;制定法律;扮演; [a]/ɪˈnækt/; [or]gmat;
tuition: [n]学费,教学,讲授; [a]/tuˈɪʃn/; [or]gmat;
installation: [n]安装,装置;就职; [a]/ˌɪnstəˈleɪʃn/; [or]gmat;
amenable: [adj]愿意的,顺从的,服从的;经得起检验的; [a]/əˈmiːnəbl/; [or]gmat;
discriminate: [v]区别,辨别;歧视; [a]/dɪˈskrɪmɪneɪt/; [or]gmat;
disarm: [vt]放下武器;使人消除敌意; [vi]解除武装; [a]/dɪsˈɑːrm/; [or]gmat;
caterpillar: [n]毛虫,蝴蝶的幼虫; [a]/ˈkætərpɪlər/; [or]gmat;
crucial: [adj]关键的;决定性的; [a]/ˈkruːʃl/; [or]gmat;
meteor: [n]流星,大气现象; [a]/ˈmiːtiər/; [or]gmat;
quota: [n]配额;限额;定额; [a]/ˈkwoʊtə/; [or]gmat;
slick: [adj]光滑的;圆滑的;顺利的;不费力的; [n]海面浮油;小块湿润的区域; [v]使平滑; [a]/slɪk/; [or]gmat;
larva: [n]幼虫,幼体; [a]/ˈlɑːrvə/; [or]gmat;
calcium: [n]钙; [a]/ˈkælsiəm/; [or]gmat;
oatmeal: [n]燕麦片,燕麦粥; [a]/ˈoʊtmiːl/; [or]gmat;
wreak: [v]实施(报复);造成(破坏或混乱); [a]/riːk/; [or]gmat;
revere: [v]敬畏;尊敬;崇敬; [a]/rɪˈvɪr/; [or]gmat;
Titanic: [adj]巨人的,力大无比的; [n]泰坦尼克号; [a]/taɪˈtænɪk/; [or]gmat;
nuclear: [adj]原子核的;原子能的;细胞核的; [a]/ˈnuːkliər/; [or]gmat;
dissipate: [v]消散,消失;浪费; [a]/ˈdɪsɪpeɪt/; [or]gmat;
spectrum: [n]光谱,范围,系列; [a]/ˈspektrəm/; [or]gmat;
perfunctory: [adj]草率的,敷衍搪塞的; [a]/pərˈfʌŋktəri/; [or]gmat;
sodium: [n][化学]钠(11号元素,符号Na); [a]/ˈsoʊdiəm/; [or]gmat;
urchin: [n]海胆,刺猬,小淘气,顽童; [a]/ˈɜːrtʃɪn/; [or]gmat;
harmonize: [v]使调和,使一致; [a]/ˈhɑːrmənaɪz/; [or]gmat;
divest: [v]剥夺;使脱去;迫使放弃; [a]/daɪˈvest/; [or]gmat;
pup: [n]小狗;幼畜; [v]生(小狗等小动物); [a]/pʌp/; [or]gmat;
convalescence: [n]康复,恢复,病后康复期; [a]/ˌkɑːnvəˈlesns/; [or]gmat;
expound: [v]详细说明,解释,阐述; [a]/ɪkˈspaʊnd/; [or]gmat;
anomaly: [n]异常,不规则,反常事物; [a]/əˈnɑːməli/; [or]gmat;
besiege: [v]围攻,困扰; [a]/bɪˈsiːdʒ/; [or]gmat;
facade: [n]建筑物的正面,外表; [a]/fəˈsɑːd/; [or]gmat;
conspire: [v]密谋策划;共谋,串通一气; [a]/kənˈspaɪər/; [or]gmat;
comprise: [v]包含,包括;构成; [a]/kəmˈpraɪz/; [or]gmat;
ostensible: [adj]表面上的,伪装的; [a]/ɑːˈstensəbl/; [or]gmat;
deft: [adj]灵巧的,敏捷的,熟练的; [a]/deft/; [or]gmat;
incongruity: [n]不协调,不一致,不适宜; [a]/ˌɪnkɑːnˈɡruːəti/; [or]gmat;
acquittal: [n]宣告无罪,开释; [a]/əˈkwɪtl/; [or]gmat;
prototype: [n]原型,典型,样本; [a]/ˈproʊtətaɪp/; [or]gmat;
observatory: [n]天文台,气象台,瞭望台; [a]/əbˈzɜːrvətɔːri/; [or]gmat;
intangible: [adj]不可捉摸的,无形的; [n]无形的东西; [a]/ɪnˈtændʒəbl/; [or]gmat;
priority: [n]优先;优先权;优先考虑的事;重要事项; [a]/praɪˈɔːrəti/; [or]gmat;
replete: [adj]充满的,装满的; [n][昆]贮蜜蚁; [a]/rɪˈpliːt/; [or]gmat;
offset: [v]抵消; [adj]胶印的,透印版印刷的; [n]分支;抵销; [a]/ˈɔːfset/; [or]gmat;
unbridled: [adj]无拘束的;激烈的;放纵的;放纵的,无约束的; [a]/ʌnˈbraɪdld/; [or]gmat;
cascade: [n]层叠;小瀑布;喷流; [v]像瀑布般冲下或倾泻; [a]/kæˈskeɪd/; [or]gmat;
nutrition: [n]营养,营养学; [a]/nuˈtrɪʃn/; [or]gmat;
pedestrian: [n]步行者,行人; [adj]步行的;平庸无奇的,无聊的; [a]/pəˈdestriən/; [or]gmat;
deferential: [adj]恭敬的; [a]/ˌdefəˈrenʃl/; [or]gmat;
monitor: [n]显示器;监视器;班长; [v]监视;监督;监测; [a]/ˈmɑːnɪtər/; [or]gmat;
repudiate: [v]拒绝,否定,驳斥; [a]/rɪˈpjuːdieɪt/; [or]gmat;
allege: [v]断言;硬说; [a]/əˈledʒ/; [or]gmat;
fresco: [n]壁画;壁画法; [v]在..上做壁画;用壁画法画出; [a]/ˈfreskoʊ/; [or]gmat;
null: [adj]无效的;不存在的; [n]零; [a]/nʌl/; [or]gmat;
emulate: [v]努力赶上(超过),仿效; [n]仿真; [a]/ˈemjuleɪt/; [or]gmat;
upheaval: [n]动乱,大变动; [a]/ʌpˈhiːvl/; [or]gmat;
sickle: [n]镰刀; [vt]用镰刀割.;使(红血细胞)成镰状; [vi]呈现出一种异常的月牙状,用于指红血细胞; [a]/ˈsɪkl/; [or]gmat;
propagate: [v]繁殖,增殖; [vt]传播,宣传; [a]/ˈprɑːpəɡeɪt/; [or]gmat;
probe: [v]探测,探索; [n]探索,调查;探针,探测器; [a]/proʊb/; [or]gmat;
untenable: [adj]防守不住的,站不住脚的; [a]/ʌnˈtenəbl/; [or]gmat;
gender: [n]性,性别;[语法]性,某些语言的(名词,代词和形容词)性的区分; [a]/ˈdʒendər/; [or]gmat;
tickle: [v]呵.痒,使发痒;使高兴; [n]痒; [a]/ˈtɪkl/; [or]gmat;
intestine: [n]肠; [a]/ɪnˈtestɪn/; [or]gmat;
portray: [v]描绘;描述; [a]/pɔːrˈtreɪ/; [or]gmat;
incandescent: [adj]白热的,热烈的; [a]/ˌɪnkænˈdesnt/; [or]gmat;
unobtrusive: [adj]不唐突的,谦虚的,不引人注目的; [a]/ˌʌnəbˈtruːsɪv/; [or]gmat;
didactic: [adj]说教的;教诲的; [a]/daɪˈdæktɪk/; [or]gmat;
aggravate: [v]使恶化,加重;使气恼,激怒; [a]/ˈæɡrəveɪt/; [or]gmat;
coy: [adj]腼腆的,怕羞的;卖弄风情的; [a]/kɔɪ/; [or]gmat;
reclaim: [v]开拓,开垦;感化;取回;改造;废物回收利用; [a]/rɪˈkleɪm/; [or]gmat;
synthesis: [n]合成; [a]/ˈsɪnθəsɪs/; [or]gmat;
darn: [v]缝补; [adj]可恶的;完全的; [adv]极其; int. 可恶; [n]补丁;织补之处; [a]/dɑːrn/; [or]gmat;
flippant: [adj]无礼的,轻率的,随意的; [a]/ˈflɪpənt/; [or]gmat;
universality: [n]普遍性,一般性; [a]/ˌjuːnɪvɜːrˈsæləti/; [or]gmat;
subsidiary: [adj]辅助的,次要的,附属的; [n]子公司,附属机构; [a]/səbˈsɪdieri/; [or]gmat;
bizarre: [adj]稀奇古怪的; [a]/bɪˈzɑːr/; [or]gmat;
communal: [adj]公社的;公共的; [a]/kəˈmjuːnl/; [or]gmat;
relay: [n]替班;转播;接力赛跑; [v]转播;传递; [a]/ˈriːleɪ/; [or]gmat;
depreciation: [n](货币的)贬值;减价;折旧;蔑视; [a]/dɪˌpriːʃiˈeɪʃn/; [or]gmat;
malaria: [n]瘴气;疟疾; [a]/məˈleriə/; [or]gmat;
indelible: [adj](印记等)无法擦除的,无法忘怀的; [a]/ɪnˈdeləbl/; [or]gmat;
inertia: [n]惯性,惰性; [a]/ɪˈnɜːrʃə/; [or]gmat;
peddler: [n]小贩; [a]/ˈpedlər/; [or]gmat;
gruesome: [adj]阴森的;可怕的; [a]/ˈɡruːsəm/; [or]gmat;
kidney: [n]肾,腰子; [a]/ˈkɪdni/; [or]gmat;
spectacular: [adj]壮观的,引人入胜的; [n]壮观的场面,精彩的表演; [a]/spekˈtækjələr/; [or]gmat;
revise: [v]修订;修改;温习(功课); [a]/rɪˈvaɪz/; [or]gmat;
clandestine: [adj]秘密的,私下的,暗中的; [a]/klænˈdestɪn/; [or]gmat;
cellular: [adj]细胞的,无线的;蜂窝式的; [a]/ˈseljələr/; [or]gmat;
behest: [n]命令,训谕; [a]/bɪˈhest/; [or]gmat;
perplex: [v]使困惑; [a]/pərˈpleks/; [or]gmat;
trite: [adj]陈腐的;平庸的;老一套的; [a]/traɪt/; [or]gmat;
mundane: [adj]普通的,平凡的;单调的;现世的,世俗的; [a]/mʌnˈdeɪn/; [or]gmat;
obviate: [v]排除,避免,消除; [a]/ˈɑːbvieɪt/; [or]gmat;
comedian: [n]喜剧演员; [a]/kəˈmiːdiən/; [or]gmat;
decipher: [n]密电译文; [vt]解释;破译; [a]/dɪˈsaɪfər/; [or]gmat;
facial: [n]面部按摩,美容; [adj]表面的,面部的; [a]/ˈfeɪʃl/; [or]gmat;
subterfuge: [n]托词,借口,诡计; [a]/ˈsʌbtərfjuːdʒ/; [or]gmat;
regenerate: [v]新生,再生,使革新; [adj]改过自新的,新生的; [n]重生者;再生器官; [a]/rɪˈdʒenəreɪt/; [or]gmat;
steerage: [n]驾驶,操纵,下等客舱; [a]/ˈstɪrɪdʒ/; [or]gmat;
exterminate: [v]消灭,灭绝;根除; [a]/ɪkˈstɜːrmɪneɪt/; [or]gmat;
roost: [n]鸟窝,巢穴,栖木; [vi]栖息; [a]/ruːst/; [or]gmat;
parity: [n]相等;同等;平价; [a]/ˈpærəti/; [or]gmat;
ornamentation: [n]装饰品; [a]/ˌɔːrnəmenˈteɪʃn/; [or]gmat;
equip: [v]装备;具备; [a]/ɪˈkwɪp/; [or]gmat;
hybrid: [n]杂种,混血儿,混合物; [adj]混合的;杂种的; [a]/ˈhaɪbrɪd/; [or]gmat;
pigment: [n]天然色素,颜料; [a]/ˈpɪɡmənt/; [or]gmat;
scour: [v]搜查;洗涤,洗刷,擦洗;冲刷成,冲刷出; [a]/ˈskaʊər/; [or]gmat;
etymology: [n]语源,语源学; [a]/ˌetɪˈmɑːlədʒi/; [or]gmat;
deduce: [v]演绎;推论,推断; [a]/dɪˈduːs/; [or]gmat;
proficient: [adj]精通的,熟练的; [a]/prəˈfɪʃnt/; [or]gmat;
chalice: [n](高脚)酒杯;圣餐杯;［植］杯状花; [a]/ˈtʃælɪs/; [or]gmat;
depress: [vt]使沮丧;使萧条;压下,压低; [a]/dɪˈpres/; [or]gmat;
sophisticated: [adj](仪器)精密的,复杂的;老于世故的,老练的,富有经验的;高雅的,精致的; [a]/səˈfɪstɪkeɪtɪd/; [or]gmat;
infuse: [v]沏(茶),泡(草药);灌输;使充满; [a]/ɪnˈfjuːz/; [or]gmat;
alligator: [n]短吻鳄(一种鳄鱼); [a]/ˈælɪɡeɪtər/; [or]gmat;
locomotion: [n]运动;移动;旅行; [a]/ˌloʊkəˈmoʊʃn/; [or]gmat;
sediment: [n]沉渣,沉淀物,沉淀; [a]/ˈsedɪmənt/; [or]gmat;
specify: [v]详细说明; [a]/ˈspesɪfaɪ/; [or]gmat;
dislodge: [v]驱逐;移去;取出; [a]/dɪsˈlɑːdʒ/; [or]gmat;
espouse: [v]支持,拥护; [a]/ɪˈspaʊz/; [or]gmat;
disparity: [n]不同,不一致,不等; [a]/dɪˈspærəti/; [or]gmat;
accrue: [v](利息等)增大,增多; [a]/əˈkruː/; [or]gmat;
discrepancy: [n]不一致,差异,不符; [a]/dɪsˈkrepənsi/; [or]gmat;
pneumonia: [n]肺炎; [a]/nuːˈmoʊniə/; [or]gmat;
usurp: [vi]篡夺,篡位; [vt]篡夺,强夺; [a]/juːˈzɜːrp/; [or]gmat;
ironic: [adj]讽刺的; [a]/aɪˈrɑːnɪk/; [or]gmat;
fauna: [n]动物区系,动物群; [a]/ˈfɔːnə/; [or]gmat;
intersection: [n]交点,十字路口; [a]/ˌɪntərˈsekʃn/; [or]gmat;
gorilla: [n]大猩猩,打手,暴徒; [a]/ɡəˈrɪlə/; [or]gmat;
iniquitous: [adj]邪恶的;不公正的; [a]/ɪˈnɪkwɪtəs/; [or]gmat;
solidarity: [n]团结一致; [a]/ˌsɑːlɪˈdærəti/; [or]gmat;
paraphrase: [v]解释,释义; [n]转述,释义; [a]/ˈpærəfreɪz/; [or]gmat;
certify: [v](发给证书)证明;证实; [a]/ˈsɜːrtɪfaɪ/; [or]gmat;
dummy: [n]哑巴,笨蛋,傀儡,人形靶; [adj]虚拟的,假的; [a]/ˈdʌmi/; [or]gmat;
crypt: [n]地窟,［解］腺窝,小囊; pref. 隐藏的;秘密的(=crypto); [a]/krɪpt/; [or]gmat;
phonograph: [n]留声机; [a]/ˈfoʊnəɡræf/; [or]gmat;
brew: [v]调制;酿造;冲泡 (茶,咖啡等);酝酿;筹划; [n]酝酿的饮料;啤酒; [a]/bruː/; [or]gmat;
homicide: [n]杀人,杀人者; [a]/ˈhɑːmɪsaɪd/; [or]gmat;
disinclination: [n]不感兴趣,厌恶; [a]/ˌdɪsˌɪnklɪˈneɪʃn/; [or]gmat;
syndicate: [n]辛迪加;企业联合;财团; [v]联合成辛迪加;组成企业联合组织;在多家报刊上同时发表; [a]/ˈsɪndɪkət/; [or]gmat;
divulge: [v]泄露,透露; [a]/daɪˈvʌldʒ/; [or]gmat;
forestall: [v]领先;占先一步;先发制人,阻止,妨碍;垄断;占先一步; [a]/fɔːrˈstɔːl/; [or]gmat;
deprivation: [n]剥夺;免职;匮乏;丧失;损失;免职; [a]/ˌdeprɪˈveɪʃn/; [or]gmat;
alienate: [v]疏远;挑拨; [a]/ˈeɪliəneɪt/; [or]gmat;
generate: [v]产生(热,电等能量),创造; [a]/ˈdʒenəreɪt/; [or]gmat;
commensurate: [adj]相称的,相应的;同量的;同样大小的; [a]/kəˈmenʃərət/; [or]gmat;
snout: [n]猪嘴,猪鼻子; [v]装管嘴; [a]/snaʊt/; [or]gmat;
morale: [n]士气,斗志; [a]/məˈræl/; [or]gmat;
circumspect: [adj]慎重的,仔细的; [a]/ˈsɜːrkəmspekt/; [or]gmat;
inalienable: [adj]不可分割的; [a]/ɪnˈeɪliənəbl/; [or]gmat;
classify: [v]把.分类; [a]/ˈklæsɪfaɪ/; [or]gmat;
inflammatory: [adj]炎症性的;煽动性的;激动的; [a]/ɪnˈflæmətɔːri/; [or]gmat;
disproportionate: [adj]不成比例的; [a]/ˌdɪsprəˈpɔːrʃənət/; [or]gmat;
parochial: [adj]教区的;地方范围的; [a]/pəˈroʊkiəl/; [or]gmat;
curriculum: [n]课程,(学校或专业的)全部课程; [a]/kəˈrɪkjələm/; [or]gmat;
splinter: [n]碎片;微小的东西;极瘦的人; [v]分裂;裂成碎片; [a]/ˈsplɪntər/; [or]gmat;
pant: [v]喘息;气喘吁吁地说;喘气; [n]喘气; [a]/pænt/; [or]gmat;
bonus: [n]奖金,额外津贴; [a]/ˈboʊnəs/; [or]gmat;
asset: [n]财产,资产,有价值的东西或人; [a]/ˈæset/; [or]gmat;
delta: [n](河流的)三角洲; [a]/ˈdeltə/; [or]gmat;
illusory: [adj]错觉的,幻影的,虚假的,产生幻觉的; [a]/ɪˈluːsəri/; [or]gmat;
detrimental: [adj]有害的,不利的; [a]/ˌdetrɪˈmentl/; [or]gmat;
ambiguity: [n]模棱两可;歧义;误解; [a]/ˌæmbɪˈɡjuːəti/; [or]gmat;
filament: [n]灯丝,细丝; [a]/ˈfɪləmənt/; [or]gmat;
weld: [v]焊接;使结合,使成整体; [n]焊接; [a]/weld/; [or]gmat;
handicap: [n]障碍,阻碍,不利条件,不利因素;残疾,缺陷,生理缺陷;[高尔夫]给弱者增加的杆数(按击球次数计数,并随参赛者的进步而减少); [v]使不利,妨碍; [a]/ˈhændikæp/; [or]gmat;
jolt: [n]猛的一击,摇晃,震惊; [v](使)颠簸,摇晃;使震惊; [a]/dʒoʊlt/; [or]gmat;
demur: [n]异议; [v]异议,反对,拒绝; [a]/dɪˈmɜːr/; [or]gmat;
diagonal: [n]对角线; [adj]对角线的;斜的;斜纹的; [a]/daɪˈæɡənl/; [or]gmat;
adamant: [adj]强硬的,固执的; [n]坚硬的东西;坚石; [a]/ˈædəmənt/; [or]gmat;
terse: [adj]简洁的,简明的; [a]/tɜːrs/; [or]gmat;
indigent: [adj]贫困的,贫穷的; [a]/ˈɪndɪdʒənt/; [or]gmat;
stave: [n]梯子,杖,梯级; [v]延缓,破碎,穿孔; [a]/steɪv/; [or]gmat;
ailment: [n]疾病(尤指微恙),不宁,不安; [a]/ˈeɪlmənt/; [or]gmat;
taboo: [n]禁忌,(宗教)戒律; [adj](因不道德或危险而)讳忌的,戒律的; [a]/təˈbuː/; [or]gmat;
refugee: [n]避难者,难民; [v]避难; [adj]避难的; [a]/ˌrefjuˈdʒiː/; [or]gmat;
shuttle: [n]短程穿梭运行的车辆,接驳车;梭子;穿梭;航天飞机; [v]穿梭移动;穿梭往返;往返于两地之间; [a]/ˈʃʌtl/; [or]gmat;
protein: [n]蛋白质; [adj]蛋白质的; [a]/ˈproʊtiːn/; [or]gmat;
interlude: [n]插曲;穿插;间歇;幕间节目; [a]/ˈɪntərluːd/; [or]gmat;
dump: [v]倾倒,丢弃;抛弃(某人); [n]垃圾场,废物堆;军需品临时堆放的地方; [a]/dʌmp/; [or]gmat;
tally: [n]计数器;标签;记账;完全相似; [v]使符合;计算;记录;一致; [a]/ˈtæli/; [or]gmat;
skeptical: [adj]表示怀疑的; [a]/ˈskeptɪkl/; [or]gmat;
evolve: [v]使进化;使发展; [a]/iˈvɑːlv/; [or]gmat;
refine: [v]精炼,改进; [a]/rɪˈfaɪn/; [or]gmat;
sentient: [adj]有感情的,有感觉力的,意识到的; [n]有知觉的人; [a]/ˈsentiənt/; [or]gmat;
demise: [n]死亡,终结; [a]/dɪˈmaɪz/; [or]gmat;
delinquent: [n]少年罪犯,违犯者; [adj]不尽责的;怠工的;〈美〉拖欠(税款)的; [a]/dɪˈlɪŋkwənt/; [or]gmat;
definitive: [adj]可靠的,明确的,权威的;决定性的; [a]/dɪˈfɪnətɪv/; [or]gmat;
initiate: [v]开始,发动; [n]新加入组织的人; [a]/ɪˈnɪʃieɪt/; [or]gmat;
affluent: [adj]富裕的,丰富的; [a]/ˈæfluənt/; [or]gmat;
affluence: [n]丰富,富裕,流入; [a]/ˈæfluəns/; [or]gmat;
divergent: [adj]叉开的;分歧的; [a]/daɪˈvɜːrdʒənt/; [or]gmat;
coyote: [n](美国西部的)郊狼,小狼; [a]/kaɪˈoʊti/; [or]gmat;
shatter: [v]使粉碎;砸碎;打碎;粉碎; [a]/ˈʃætər/; [or]gmat;
squash: [v]压扁,压制; [n]南瓜,易压烂的物品,拥挤的人群,壁球; [a]/skwɑːʃ/; [or]gmat;
mobility: [n]活动性,灵活性,迁移率,机动性; [a]/moʊˈbɪləti/; [or]gmat;
monsoon: [n]季雨,季风,大雨; [a]/ˌmɑːnˈsuːn/; [or]gmat;
sparse: [adj]稀少的;稀疏的; [a]/spɑːrs/; [or]gmat;
clipping: [n]剪下物,剪辑,剪报; [adj]快速的; [a]/ˈklɪpɪŋ/; [or]gmat;
aggregation: [n]集合,集合体,聚合; [a]/ˌæɡrɪˈɡeɪʃn/; [or]gmat;
substantive: [adj]有实质的;大量的;真实的;独立存在的; [n]实词,名词,名词性词组; [a]/səbˈstæntɪv/; [or]gmat;
habitat: [n]自然环境,栖息地; [a]/ˈhæbɪtæt/; [or]gmat;
sinew: [n]腱,筋,中坚力量; [v]用腱连结,(好像使用肌筋似的)给..以力量,支持; [a]/ˈsɪnjuː/; [or]gmat;
exigency: [n]紧急(状态);危急(关头);事变; [a]/ˈeksɪdʒənsi/; [or]gmat;
dilute: [v]使变淡,稀释;使病弱; [a]/daɪˈluːt/; [or]gmat;
potter: [n]陶工; [v]懒散;闲逛;慢条斯理地做事; [a]/ˈpɑːtər/; [or]gmat;
ensemble: [n]合唱团,表演团体;总效果;全套服装;全套家具; [a]/ɑːnˈsɑːmbl/; [or]gmat;
agrarian: [adj]耕地的; [a]/əˈɡreriən/; [or]gmat;
embargo: [v]禁止出入港口;禁止或限制贸易;征用或扣押; [n]禁令;禁止;封港令; [a]/ɪmˈbɑːrɡoʊ/; [or]gmat;
saliva: [n]唾液; [vi]分泌唾液; [a]/səˈlaɪvə/; [or]gmat;
congestion: [n]拥挤,充血; [a]/kənˈdʒestʃən/; [or]gmat;
cube: [n]立方体,立方; [a]/kjuːb/; [or]gmat;
glean: [v]收集(资料); [a]/ɡliːn/; [or]gmat;
regimen: [n]养生法,生活规则; [a]/ˈredʒɪmən/; [or]gmat;
slam: [v]砰地关上;猛力拉,扔;砰地放下;猛烈抨击; [n]砰的一声;大满贯; [a]/slæm/; [or]gmat;
tactical: [adj]手段的,战术的; [a]/ˈtæktɪkl/; [or]gmat;
overt: [adj]明显的;公开的;公然的; [a]/oʊˈvɜːrt/; [or]gmat;
memento: [n]纪念品; [a]/məˈmentoʊ/; [or]gmat;
versatility: [n]多功能;多用途; [a]/ˌvɜːrsəˈtɪləti/; [or]gmat;
precursor: [n]先兆,先驱,前体; [a]/priːˈkɜːrsər/; [or]gmat;
displace: [v]取代,替代,迫使(某人)离开家园,使离开原位; [a]/dɪsˈpleɪs/; [or]gmat;
conglomerate: [n]砾岩;联合大企业; [vi]聚集; [adj]混合的;联合大企业的; [vt]使聚集;使结成;结合; [a]/kənˈɡlɑːmərət/; [or]gmat;
autonomy: [n]人身自由;自治;自治权; [a]/ɔːˈtɑːnəmi/; [or]gmat;
accountant: [n]会计人员,会计师; [a]/əˈkaʊntənt/; [or]gmat;
nitric: [adj]氮的,含氮的; [a]/'naɪtrɪk/; [or]gmat;
availability: [n]可得到的人(或物);可用性; [a]/əˌveɪləˈbɪləti/; [or]gmat;
stipend: [n]奖学金;固定薪金;定期津贴;养老金; [a]/ˈstaɪpend/; [or]gmat;
skepticism: [n]怀疑态度;怀疑论;多疑癖; [a]/ˈskeptɪsɪzəm/; [or]gmat;
graph: [n](曲线)图,图表; [vt]用曲线图表示,把.绘入图表;用胶版印刷; [a]/ɡræf/; [or]gmat;
phosphate: [n]磷酸盐,磷酸酯; [a]/ˈfɑːsfeɪt/; [or]gmat;
jasper: [n]［矿］碧玉,墨绿色; [a]/'dʒæspə/; [or]gmat;
larvae: [n]幼虫;幼体; [a]/'lɑːrviː/; [or]gmat;
primordial: [adj]原始的;根本的;原生的; [a]/praɪˈmɔːrdiəl/; [or]gmat;
fungi: [n]菌类;真菌; [a]/ˈfʌŋɡaɪ/; [or]gmat;
obtrusive: [adj]突出的,爱管闲事的,冒失的,强迫人的; [a]/əbˈtruːsɪv/; [or]gmat;
diploma: [n]毕业文凭,毕业证书;文凭课程; [a]/dɪˈploʊmə/; [or]gmat;
smear: [n]油渍,污点,中伤; [v]涂上,玷污,诽谤,抹去; [a]/smɪr/; [or]gmat;
strut: [n]高视阔步,抗压装置; [v]昂首阔步地走,趾高气昂地走; [a]/strʌt/; [or]gmat;
literacy: [n]读写能力;识字;有文化;教养; [a]/ˈlɪtərəsi/; [or]gmat;
fume: [n]烟;愤怒; [v]冒烟;发怒; [a]/fjuːm/; [or]gmat;
certitude: [n]确实;确信;必然性; [a]/ˈsɜːrtɪtuːd/; [or]gmat;
espionage: [n]间谍活动,侦查,监视; [a]/ˈespiənɑːʒ/; [or]gmat;
disrupt: [v]扰乱; [a]/dɪsˈrʌpt/; [or]gmat;
ferret: [n]雪貂;白鼬;侦探; [v]搜寻;查获;驱出;用雪貂猎取; [adj]雪貂似的;搜索者般的;爱窥探的; [a]/ˈferɪt/; [or]gmat;
envelop: [v]包围,包上; [n]信封(同"envelope"); [a]/ɪnˈveləp/; [or]gmat;
clog: [v]阻塞,阻碍; [n]障碍;木底鞋; [a]/klɑːɡ/; [or]gmat;
conserve: [v]保藏,保存;节约; [n]蜜饯,果酱; [a]/kənˈsɜːrv/; [or]gmat;
fabrication: [n]制作;构成;捏造;伪造物;装配工; [a]/ˌfæbrɪˈkeɪʃn/; [or]gmat;
eradicate: [v]根除;消灭; [a]/ɪˈrædɪkeɪt/; [or]gmat;
transmitter: [n]传送者,送话器;发射机;发射台;话筒; [a]/trænsˈmɪtər/; [or]gmat;
deride: [v]嘲弄,愚弄; [a]/dɪˈraɪd/; [or]gmat;
derogatory: [adj]不敬的,诽谤的; [a]/dɪˈrɑːɡətɔːri/; [or]gmat;
subscriber: [n]订购者,捐献者; [a]/səbˈskraɪbər/; [or]gmat;
fake: [adj]假的,伪造的; [n]骗子;假货,赝品; [v]假造,杜撰;伪造;冒充,假装;假装; [a]/feɪk/; [or]gmat;
spawn: [n]卵;菌丝;产物; [v]产卵;酿成,造成;大量生产; [a]/spɔːn/; [or]gmat;
calamitous: [adj]造成灾祸的,灾难的,悲惨的; [a]/kəˈlæmɪtəs/; [or]gmat;
capsule: [n]胶囊;航天舱,密封舱; [a]/ˈkæpsl/; [or]gmat;
provocative: [adj]挑衅的,煽动的,刺激的;挑逗的; [a]/prəˈvɑːkətɪv/; [or]gmat;
mow: [n]干草堆;谷堆; [v]刈,收割庄稼;扫除,扫倒; [a]/moʊ/; [or]gmat;
infect: [v]传染,感染;使受影响; [a]/ɪnˈfekt/; [or]gmat;
incisive: [adj]一针见血的,敏锐的; [a]/ɪnˈsaɪsɪv/; [or]gmat;
premise: [n]前提;房屋地基; [v]假定; [a]/ˈpremɪs/; [or]gmat;
stunt: [n]惊人表演,特技;矮小的人(或物); [v]阻碍..发育;作惊人表演;使绝招; [a]/stʌnt/; [or]gmat;
bolster: [n]枕垫; [v]支持,鼓励,增强; [a]/ˈboʊlstər/; [or]gmat;
protege: [n]被保护人,门徒,门生; [a]/ˈproʊtəʒeɪ/; [or]gmat;
secrete: [v]藏匿;私下侵吞;分泌; [a]/sɪˈkriːt/; [or]gmat;
quiescent: [adj]静止的,沉寂的,不活动的; [a]/kwaɪˈesnt/; [or]gmat;
donor: [n]捐献者; [a]/ˈdoʊnər/; [or]gmat;
embellish: [vt]装饰; [v]吹嘘;润色(文章); [vi]装饰起来;加以润色;添加细节,对...添枝加叶; [a]/ɪmˈbelɪʃ/; [or]gmat;
conceal: [v]隐藏,隐瞒,掩盖; [a]/kənˈsiːl/; [or]gmat;
patronize: [v]惠顾;赞助,资助; [a]/ˈpeɪtrənaɪz/; [or]gmat;
demolition: [n]拆除(等于demolishment);破坏,毁坏; [a]/ˌdeməˈlɪʃn/; [or]gmat;
trenchant: [adj]犀利的,锐利的,有力的,清晰的,一针见血的; [a]/ˈtrentʃənt/; [or]gmat;
debut: [n]初次登台,在社交场合的初次露脸; [v]初次露面,初次表演;首次推出; [adj]首张的,首场的,首次的; [a]/deɪˈbjuː/; [or]gmat;
radiate: [v]辐射,发出(光或热);流露,显示;(使)从中心发散; [a]/ˈreɪdieɪt/; [or]gmat;
drizzle: [v]下毛毛雨; [n]细雨,毛毛雨; [a]/ˈdrɪzl/; [or]gmat;
elite: [n]精英; [adj]高级的; [a]/ɪˈliːt/; [or]gmat;
putty: [n]［建］腻子,易于被人摆弄的人; [v]用油灰填塞; [a]/ˈpʌti/; [or]gmat;
amplitude: [n]振幅;广阔;幅度; [a]/ˈæmplɪtuːd/; [or]gmat;
infest: [v]骚扰,寄生于,大批出没; [a]/ɪnˈfest/; [or]gmat;
dimension: [n]维度;尺寸;尺度;方面; [a]/dɪˈmenʃn/; [or]gmat;
rugby: [n]英式橄榄球;拉格比(英格兰中部的城市); [a]/ˈrʌɡbi/; [or]gmat;
concurrent: [adj]一致的;同时发生的; [n]同时发生的事件; [a]/kənˈkɜːrənt/; [or]gmat;
encroach: [v]侵犯,侵占;蚕食(on); [a]/ɪnˈkroʊtʃ/; [or]gmat;
corroborate: [v]支持或证实,强化; [n]确证者,证物; [a]/kəˈrɑːbəreɪt/; [or]gmat;
quantum: [n]量子论; [a]/ˈkwɑːntəm/; [or]gmat;
maneuver: [v]操纵; [n]操纵;花招;调遣;策略; [a]/məˈnʊvər/; [or]gmat;
churn: [n](炼制黄油用的)搅乳器; [v]用搅乳器搅拌; [a]/tʃɜːrn/; [or]gmat;
accelerate: [v]加速,增长;使增速,促进; [a]/əkˈseləreɪt/; [or]gmat;
intensify: [v]增强;加剧; [a]/ɪnˈtensɪfaɪ/; [or]gmat;
dwindle: [v]日渐减少,变小,缩小; [a] /ˈdwɪndl/; [or]gmat;
bounce: [vi]弹起,蹦跳; [vt]使弹起; [v]拒付 (支票); [n]弹跳,弹力,活力; [a] /baʊns/; [or]gmat;
salvage: [n]抢救;从灾难中抢救出的物资; [vt]拯救;打捞; [a] /ˈsælvɪdʒ/; [or]gmat;
feline: [n]猫科动物; [adj]猫科的,猫的; [a] /ˈfiːlaɪn/; [or]gmat;
intermediary: [adj]中间的;媒介的;中途的; [n]中间人;仲裁者;调解者;媒介物; [a] /ˌɪntərˈmiːdieri/; [or]gmat;
glut: [n]供过于求,过多; [vt]使吃饱;使充斥; [vi]过量地吃; [a] /ɡlʌt/; [or]gmat;
tuberculosis: [n]肺结核; [a] /tuːˌbɜːrkjəˈloʊsɪs/; [or]gmat;
deprecate: [v]反对;轻视; [a] /ˈdeprəkeɪt/; [or]gmat;
prowl: [n](鬼鬼祟祟)徘徊,觅食,游荡; [vi]徘徊,潜行; [vt]在.搜寻;潜行于; [a] /praʊl/; [or]gmat;
evaporate: [v]蒸发,失去水分;消失; [a] /ɪˈvæpəreɪt/; [or]gmat;
encyclopedia: [n]百科全书; [a] /ɪnˌsaɪkləˈpiːdiə/; [or]gmat;
cache: [n]隐藏处所,隐藏的粮食或物资,贮藏物; [vt]贮藏; [vi]躲藏; [a] /kæʃ/; [or]gmat;
scorch: [v]烧焦;枯萎; [vi]高速行驶,疾驰,飞驰; [a] /skɔːrtʃ/; [or]gmat;
ethnic: [adj]种族的,少数民族的; [n]少数民族成员;人种学; [a] /ˈeθnɪk/; [or]gmat;
pare: [v]削去,剥去; [a] /per/; [or]gmat;
linear: [adj]线的,线性的;直线的;长度的; [a] /ˈlɪniər/; [or]gmat;
compress: [v]压紧,压缩,压榨; [a] /kəmˈpres/; [or]gmat;
egregious: [adj]非常恶劣的,过分的;恶名昭彰的;惊人的; [a] /ɪˈɡriːdʒiəs/; [or]gmat;
marital: [adj]婚姻的; [a] /ˈmærɪtl/; [or]gmat;
encompass: [vt]环绕,包围;包含;完成; [a] /ɪnˈkʌmpəs/; [or]gmat;
repository: [n]储藏室;仓库;智囊人物;知识库; [a] /rɪˈpɑːzətɔːri/; [or]gmat;
cumbersome: [adj]笨重的;麻烦的; [a] /ˈkʌmbərsəm/; [or]gmat;
condense: [v]压缩;精炼;冷凝; [a] /kənˈdens/; [or]gmat;
tempo: [n][音]节奏,拍子;行进速度; [a] /ˈtempoʊ/; [or]gmat;
immune: [adj]免疫的,有免疫力的;不受影响的;免除的; [a] /ɪˈmjuːn/; [or]gmat;
bilateral: [adj]双边的,有两面的; [a] /ˌbaɪˈlætərəl/; [or]gmat;
irate: [adj]发怒的,愤怒的; [a] /aɪˈreɪt/; [or]gmat;
endorsement: [n]认可,支持;背书;签注(文件); [a] /ɪnˈdɔːrsmənt/; [or]gmat;
clarity: [n]清楚;清澈; [a] /ˈklærəti/; [or]gmat;
panacea: [n]灵丹妙药,万能药; [a] /ˌpænəˈsiːə/; [or]gmat;
molecule: [n]分子,微粒; [a] /ˈmɑːlɪkjuːl/; [or]gmat;
inextricable: [adj]无法摆脱的,纠缠的; [adv]无法摆脱地,解不开地; [a] /ˌɪnɪkˈstrɪkəbl/; [or]gmat;
configuration: [n]配置,布局,构造; [a] /kənˌfɪɡjəˈreɪʃn/; [or]gmat;
overweening: [adj]自负的,过于自信的,傲慢的; [a] /ˌoʊvərˈwiːnɪŋ/; [or]gmat;
quantitative: [adj]定量的; [a] /ˈkwɑːntəteɪtɪv/; [or]gmat;
emanate: [v]发出;放射; [a] /ˈeməneɪt/; [or]gmat;
abdicate: [adj]放弃权力的;退位的; [n]放弃权力者;退位者; [vi]退位,辞职; [vt]辞;放弃; [a] /ˈæbdɪkeɪt/; [or]gmat;
clam: [n]蛤,蚶;沉默寡言的人; [a] /klæm/; [or]gmat;
brewery: [n]啤酒厂; [a] /ˈbruːəri/; [or]gmat;
intake: [n]吸入,收纳;纳入(数量); [a] /ˈɪnteɪk/; [or]gmat;
virtuoso: [n]艺术品鉴赏家,古董收藏家,艺术大师; [adj]行家里手的,艺术爱好者的; [a] /ˌvɜːrtʃuˈoʊsoʊ/; [or]gmat;
endorse: [v]赞同,认可;签注(文件); [a] /ɪnˈdɔːrs/; [or]gmat;
dope: [n]毒品;粘稠物,胶状物,添加剂;傻瓜,蠢货;内幕消息; [v]给.服用麻醉剂; [adj]<俚>极好的; [a] /doʊp/; [or]gmat;
scurrilous: [adj]下流的,恶言毁谤的; [a] /ˈskɜːrələs/; [or]gmat;
isolate: [v]使隔离;使孤立; [adj]孤立的;单独的; [a] /ˈaɪsəleɪt/; [or]gmat;
pulsation: [n]有节奏的鼓动,脉动; [a] /pʌlˈseɪʃn/; [or]gmat;
captivate: [v]吸引,迷惑; [a] /ˈkæptɪveɪt/; [or]gmat;
aviator: [n]飞行员; [a] /ˈeɪvieɪtər/; [or]gmat;
longevity: [n]长寿,长命;寿命; [a] /lɔːnˈdʒevəti/; [or]gmat;
cinder: [n]余烬,矿渣; [a] /ˈsɪndər/; [or]gmat;
elliptical: [adj]椭圆的;省略的; [a] /ɪˈlɪptɪkl/; [or]gmat;
incursion: [n]入侵,侵犯; [a] /ɪnˈkɜːrʒn/; [or]gmat;
liken: [v]把..比作,比拟; [a] /ˈlaɪkən/; [or]gmat;
cereal: [n]谷物;谷类食物;谷类食品; [adj]谷类的;谷类制成的; [a] /ˈsɪriəl/; [or]gmat;
recur: [v]重新出现;再次发生;重新提起;诉诸;反复; [a] /rɪˈkɜːr/; [or]gmat;
captious: [adj]挑剔的,吹毛求疵的; [a] /'kæpʃəs/; [or]gmat;
pact: [n]合同;协约; [a] /pækt/; [or]gmat;
aura: [n](人或物发出的)气味,气氛,先兆; [a] /ˈɔːrə/; [or]gmat;
asthma: [n]哮喘症; [a] /ˈæzmə/; [or]gmat;
terminology: [n]术语,术语学; [a] /ˌtɜːrməˈnɑːlədʒi/; [or]gmat;
engender: [v]产生; [a] /ɪnˈdʒendər/; [or]gmat;
gregarious: [adj]群居的,爱社交的; [a] /ɡrɪˈɡeriəs/; [or]gmat;
hedgehog: [n]刺猬; [a] /ˈhedʒhɔːɡ/; [or]gmat;
lymph: [n]［医］淋巴,淋巴液,(淋巴液似的)浆,苗; [a] /lɪmf/; [or]gmat;
circumvent: [v]用计避免,规避; [a] /ˌsɜːrkəmˈvent/; [or]gmat;
electorate: [n]选民;选区; [a] /ɪˈlektərət/; [or]gmat;
erase: [v](计算机)擦除;抹去;擦掉; [a] /ɪˈreɪs/; [or]gmat;
mediate: [v]调解,调停,斡旋; [a] /ˈmiːdieɪt/; [or]gmat;
propound: [v]提出(问题,计划)供考虑; [a] /prəˈpaʊnd/; [or]gmat;
intersect: [v]横截,横断;贯穿;相交;交叉; [a] /ˌɪntərˈsekt/; [or]gmat;
aluminum: [n]铝; [a] /əˈluːmɪnəm/; [or]gmat;
alfalfa: [n]茴蓿,紫苜蓿; [a] /ælˈfælfə/; [or]gmat;
balk: [v]畏缩;阻止;停止; [n]障碍;错误; [a] /bɔːk/; [or]gmat;
denouement: [n]结局,终场; [a] /ˌdeɪnuːˈmɑ̃ː/; [or]gmat;
interrogate: [v]审问,审讯; [a] /ɪnˈterəɡeɪt/; [or]gmat;
static: [adj]静电的,静态的,静止的; [n]静电,静电干扰; [a] /ˈstætɪk/; [or]gmat;
fad: [n]风尚,风行一时的东西; [adj]极好的; [a] /fæd/; [or]gmat;
seedling: [n]幼苗,籽苗; [a] /ˈsiːdlɪŋ/; [or]gmat;
casualty: [n]伤亡人员,死伤者,受害人;急诊室(英); [a] /ˈkæʒuəlti/; [or]gmat;
pragmatic: [adj]国事的,团体事务的;实际的,注重实效的; [n]爱管闲事的人;专断的人;国事诏书;实际家; [a] /præɡˈmætɪk/; [or]gmat;
beneficiary: [n][金融]受益人,受惠者;封臣; [adj]拥有封地的;受圣俸的; [a] /ˌbenɪˈfɪʃieri/; [or]gmat;
tangent: [n]切线; [adj]无关的; [a] /ˈtændʒənt/; [or]gmat;
mural: [n]壁画;壁饰; [adj]墙壁的;挂在墙壁上的; [a] /ˈmjʊrəl/; [or]gmat;
fixture: [n]固定装置;体育项目; [a] /ˈfɪkstʃər/; [or]gmat;
lobe: [n]耳垂,波瓣,(脑,肺等的)叶,裂片; [a] /loʊb/; [or]gmat;
expedite: [v]加快;促进;发出; [adj]畅通的;迅速的;方便的; [a] /ˈekspədaɪt/; [or]gmat;
debase: [v]贬值,降低; [a] /dɪˈbeɪs/; [or]gmat;
resonance: [n]共振;回声;(情感等的)共鸣; [a] /ˈrezənəns/; [or]gmat;
install: [v]安装,安置,使就职; [a] /ɪnˈstɔːl/; [or]gmat;
bulge: [n]凸出部分; [v]凸出,膨胀; [a] /bʌldʒ/; [or]gmat;
tenet: [n]信念,原则,教条; [a] /ˈtenɪt/; [or]gmat;
scrutinize: [v]仔细检查,细看; [a] /ˈskruːtənaɪz/; [or]gmat;
tamper: [v]篡改;玩弄;贿赂; [n]填塞者;捣棒; [a] /ˈtæmpər/; [or]gmat;
protocol: [n]外交礼节;草案;外交议定书; [vi]拟定议定书; [vt]把.写入议定书; [a] /ˈproʊtəkɔːl/; [or]gmat;
curtail: [vt]截短;削减;剥夺.特权; [a] /kɜːrˈteɪl/; [or]gmat;
milieu: [n]周围环境;背景;周围;出身背景; [a] /mɪlˈjuː/; [or]gmat;
dioxide: [n]二氧化物; [a] /daɪˈɑːksaɪd/; [or]gmat;
distort: [v]扭曲,使变形;歪曲,曲解; [a] /dɪˈstɔːrt/; [or]gmat;
nomad: [n]流浪者,游牧民; [adj]游牧的;流浪的; [a] /ˈnoʊmæd/; [or]gmat;
browse: [v]浏览;随意翻阅;(牛,羊等)吃草; [a] /braʊz/; [or]gmat;
galaxy: [n]星系; [a] /ˈɡæləksi/; [or]gmat;
migrant: [n]候鸟;移民; [a] /ˈmaɪɡrənt/; [or]gmat;
adolescent: [adj]青春期的;青少年的; [n]青少年; [a] /ˌædəˈlesnt/; [or]gmat;
thyroid: [adj]［解］甲状腺的; [n]甲状腺; [a] /ˈθaɪrɔɪd/; [or]gmat;
decimal: [n]小数; [adj]小数的;十进制的; [a] /ˈdesɪml/; [or]gmat;
complementary: [adj]补足的,补充的,互补的; [a] /ˌkɑːmplɪˈmentri/; [or]gmat;
outstrip: [v]比.优越,胜过,比.跑得快; [a] /ˌaʊtˈstrɪp/; [or]gmat;
dislocation: [n]转位,混乱,[医]脱臼; [a] /ˌdɪsloʊˈkeɪʃn/; [or]gmat;
lingo: [n]外国话(贬义),行话,方言,隐语; [a] /ˈlɪŋɡoʊ/; [or]gmat;
deleterious: [adj]有害的;有毒的; [a] /ˌdeləˈtɪriəs/; [or]gmat;
crate: [n]板条箱,篓; [v]将某物装入大木箱或板条箱中; [a] /kreɪt/; [or]gmat;
unification: [n]统一,联合,一致; [a] /ˌjuːnɪfɪˈkeɪʃn/; [or]gmat;
sewage: [n](下水道)污水;污物; [a] /ˈsuːɪdʒ/; [or]gmat;
inscribe: [v]刻; [a] /ɪnˈskraɪb/; [or]gmat;
diphtheria: [n]［医］白喉［症］; [a] /dɪfˈθɪriə/; [or]gmat;
sponsor: [n]倡导者;提案人;赞助人;担保人;教父,教母; [vt]发起;倡议;做.的保人;赞助;资助; [a] /ˈspɑːnsər/; [or]gmat;
vertebrate: [adj]有脊椎的; [n]脊椎动物; [a] /ˈvɜːrtɪbrət/; [or]gmat;
pseudonym: [n]笔名,假名; [a] /ˈsuːdənɪm/; [or]gmat;
quandary: [n]困惑;窘境;为难; [a] /ˈkwɑːndəri/; [or]gmat;
insomnia: [n]失眠; [a] /ɪnˈsɑːmniə/; [or]gmat;
discretionary: [adj]分立的,自理自由的;任意的; [a] /dɪˈskreʃəneri/; [or]gmat;
portrayal: [n]画像,描画,描写; [a] /pɔːrˈtreɪəl/; [or]gmat;
matrix: [n][数]矩阵,模子; [a] /ˈmeɪtrɪks/; [or]gmat;
perpetrator: [n]作恶者,犯罪者,行凶者; [a] /ˈpɜːrpətreɪtər/; [or]gmat;
idiosyncrasy: [n]特殊癖性或行为; [a] /ˌɪdiəˈsɪŋkrəsi/; [or]gmat;
stun: [v]使昏迷,使发愣; [a] /stʌn/; [or]gmat;
topple: [v]摇摇欲坠,推翻,颠覆; [a] /ˈtɑːpl/; [or]gmat;
scapegoat: [n]替罪羊; [a] /ˈskeɪpɡoʊt/; [or]gmat;
veneer: [n](镶于劣质东西上的)镶面板;掩饰; [v]虚饰;给.镶以饰片; [a] /vəˈnɪr/; [or]gmat;
delineate: [v]描画;画出..轮廓; [a] /dɪˈlɪnieɪt/; [or]gmat;
consensus: [n]一致同意,合意; [a] /kənˈsensəs/; [or]gmat;
contentious: [adj]好辩的,爱争论的; [a] /kənˈtenʃəs/; [or]gmat;
linguist: [n]语言学家;会多国语言的人; [a] /ˈlɪŋɡwɪst/; [or]gmat;
underlie: [v]位于..之下;成为..的基础; [a] /ˌʌndərˈlaɪ/; [or]gmat;
morphine: [n]吗啡; [a] /ˈmɔːrfiːn/; [or]gmat;
transplant: [n]移种;移植; [v]移植(器官),使移居,移种(植物等); [a] /trænsˈplænt/; [or]gmat;
granular: [adj]粒状的,含颗粒的; [a] /ˈɡrænjələr/; [or]gmat;
bugbear: [n]使人恐惧的东西,妖怪; [a] /ˈbʌɡber/; [or]gmat;
lush: [adj]草木茂盛的,多的,丰富豪华的; [n]酒;醉汉; [a] /lʌʃ/; [or]gmat;
steppe: [n](尤指东南欧或西伯利地区)无树林的大平原; [a] /step/; [or]gmat;
portend: [v]预兆,预示; [a] /pɔːrˈtend/; [or]gmat;
fluctuation: [n]波动;起伏; [a] /ˌflʌktʃuˈeɪʃn/; [or]gmat;
simulate: [v]假装;模仿;模拟; [a] /ˈsɪmjuleɪt/; [or]gmat;
abolitionist: [n]废奴主义者; [a] /ˌæbəˈlɪʃənɪst/; [or]gmat;
sedan: [n]轿子,轿车,单舱汽艇; [a] /sɪˈdæn/; [or]gmat;
slot: [n]狭缝,狭槽,(机构的)职位; [v]把.放入狭长开口中,把.纳入; [a] /slɑːt/; [or]gmat;
altruism: [n]利他主义,不自私; [a] /ˈæltruɪzəm/; [or]gmat;
samurai: [n](日本)武士阶层,陆军军官,军阀; [a] /ˈsæmuraɪ/; [or]gmat;
disavow: [v]不承认,抵赖,拒绝对..承担责任; [a] /ˌdɪsəˈvaʊ/; [or]gmat;
eschew: [v]避开;戒绝; [a] /ɪsˈtʃuː/; [or]gmat;
engrave: [v]雕刻;铭记; [a] /ɪnˈɡreɪv/; [or]gmat;
manipulate: [v]操纵,影响;正骨; [a] /məˈnɪpjuleɪt/; [or]gmat;
vegetarian: [n]吃素的人; [adj]素食的; [a] /ˌvedʒəˈteriən/; [or]gmat;
quadrant: [n]象限,四分之一圆; [a] /ˈkwɑːdrənt/; [or]gmat;
reiterate: [vt]反复讲,重申,反复做; [a] /riˈɪtəreɪt/; [or]gmat;
cuisine: [n]烹饪;菜肴; [a] /kwɪˈziːn/; [or]gmat;
amass: [vi]聚集; [vt]收集;积累,积聚; [a] /əˈmæs/; [or]gmat;
recast: [v]重建; [a] /ˌriːˈkæst/; [or]gmat;
arbitrator: [n]公断人; [a] /ˈɑːrbɪtreɪtər/; [or]gmat;
obituary: [n]讣告; [adj]关于死者的,讣告的; [a] /oʊˈbɪtʃueri/; [or]gmat;
mutation: [n]变化,突变;变异; [a] /mjuːˈteɪʃn/; [or]gmat;
ion: [n]［物］离子; [a] /ˈaɪən/; [or]gmat;
landlocked: [adj]被陆地包围的,地处内陆的; [a] /ˈlændlɑːkt/; [or]gmat;
specter: [n]鬼魂,幽灵,恐惧; [a] /'spektə/; [or]gmat;
modem: [n]调制解调器; [v][计]通过调制解调器向.发送电子邮件;用调制解调器联通; [a] /ˈmoʊdem/; [or]gmat;
malleable: [adj](金属)可锻的;有延展性的;(性格)可训练的;易适应的; [a] /ˈmæliəbl/; [or]gmat;
stipulate: [v]规定;保证;保证;要求以.为条件; [a] /ˈstɪpjuleɪt/; [or]gmat;
differentiate: [v]使有差异;区别; [a] /ˌdɪfəˈrenʃieɪt/; [or]gmat;
emission: [n]排放物;放射物; [a] /iˈmɪʃn/; [or]gmat;
induce: [v]引导,劝诱,诱导; [a] /ɪnˈduːs/; [or]gmat;
kidnap: [v]诱拐;绑架; [a] /ˈkɪdnæp/; [or]gmat;
primate: [n]首领,大主教,灵长类的动物; [a] /'praɪmeɪt/; [or]gmat;
overlap: [n]重叠,重复; [v](部分地)重叠; [a] /ˌoʊvərˈlæp/; [or]gmat;
terra-cotta: [n]赤土,赤陶,一种带褐色的柑子; [a] /ˌterəˈkɑtə/; [or]gmat;
radial: [adj]光线的,放射状的,半径的; [n]光线,射线; [a] /ˈreɪdiəl/; [or]gmat;
beatific: [adj]祝福的,有福的; [a] /ˌbiːəˈtɪfɪk/; [or]gmat;
vendor: [n]小贩,卖主,供应商; [a] /ˈvendər/; [or]gmat;
oust: [v]罢免,驱逐,剥夺,取代; [a] /aʊst/; [or]gmat;
audit: [v]审计,查账;旁听; [n]审计;查帐; [a] /ˈɔːdɪt/; [or]gmat;
deduct: [v]减去; [a] /dɪˈdʌkt/; [or]gmat;
olfactory: [adj]嗅觉的; [a] /ɑːlˈfæktəri/; [or]gmat;
folklore: [n]民俗学,民间传说;民间看法;民俗; [a] /ˈfoʊklɔːr/; [or]gmat;
hike: [n]远足,徒步旅行;(数量,价格等)增加,上升; [v]作长途徒步旅行;使高涨,提高(价格); [a] /haɪk/; [or]gmat;
vascular: [adj]血管的,脉管的; [a] /ˈvæskjələr/; [or]gmat;
rubble: [n]碎石,瓦砾; [a] /ˈrʌbl/; [or]gmat;
entree: [n]进入,入场权,［美］主菜,(歌剧等)开始的乐章; [a] /ˈɑːntreɪ/; [or]gmat;
alto: [n]女低音,男声最高音,中音乐器; [adj]中音部的; [a] /ˈæltoʊ/; [or]gmat;
concerto: [n][音乐]协奏曲; [a] /kənˈtʃɜːrtoʊ/; [or]gmat;
terrorism: [n]恐怖主义; [a] /ˈterərɪzəm/; [or]gmat;
recession: [n](经济)衰退,不景气;后退,撤回;凹处; [a] /rɪˈseʃn/; [or]gmat;
autonomous: [adj]自动驾驶的;自治的,独立自主的;自主的; [a] /ɔːˈtɑːnəməs/; [or]gmat;
mileage: [n]英里数; [a] /ˈmaɪlɪdʒ/; [or]gmat;
stellar: [adj]星的,星球的,主要的; [a] /ˈstelər/; [or]gmat;
probate: [n]遗嘱检验; [v]遗嘱认证; [adj][法] 遗嘱认证的; [a] /ˈproʊbeɪt/; [or]gmat;
exemplify: [v]举例说明;例示,是..的典范; [a] /ɪɡˈzemplɪfaɪ/; [or]gmat;
dietary: [adj]饮食的,与饮食有关的; [a] /ˈdaɪəteri/; [or]gmat;
cartel: [n]卡特尔;企业联合;垄断联盟;俘虏交换条约; [a] /kɑːrˈtel/; [or]gmat;
repertory: [n]储备;仓库;全部剧目; [a] /ˈrepərtɔːri/; [or]gmat;
pelvis: [n]骨盆; [a] /ˈpelvɪs/; [or]gmat;
seance: [n]［法］集会,会议,降神会; [a] /ˈseɪɑːns/; [or]gmat;
offshoot: [n]分支,支流,衍生物; [a] /ˈɔːfʃuːt/; [or]gmat;
ignition: [n]点火,着火;点火开关; [a] /ɪɡˈnɪʃn/; [or]gmat;
scurry: [v]快速疾走,急跑,急躁不安地来回走动; [n]快步急跑;疾走;仓皇奔跑声;骤雨; [a] /ˈskɜːri/; [or]gmat;
hyperbole: [n]夸张的语句;夸张法; [a] /haɪˈpɜːrbəli/; [or]gmat;
buffer: [n]缓冲,缓冲区; [v]缓冲; [a] /ˈbʌfər/; [or]gmat;
beehive: [n]蜂箱; [a] /ˈbiːhaɪv/; [or]gmat;
coalesce: [v]联合,合并,结合; [a] /ˌkoʊəˈles/; [or]gmat;
engulf: [v]吞噬,吞没,狼吞虎咽; [a] /ɪnˈɡʌlf/; [or]gmat;
median: [n]中值,中位数;中线; [adj]中值的;中央的; [a] /ˈmiːdiən/; [or]gmat;
aquarium: [n]水族馆,水族箱,鱼缸; [a] /əˈkweriəm/; [or]gmat;
cryptic: [adj]秘密的,含义模糊的,神秘的,隐藏的; [a] /ˈkrɪptɪk/; [or]gmat;
grill: [n]烤架; [v]烤;拷问; [a] /ɡrɪl/; [or]gmat;
parallelogram: [n]平行四边形; [a] /ˌpærəˈleləɡræm/; [or]gmat;
plummet: [v]垂直或突然地堕下,骤然下降; [n]测锤(钓丝的)坠子;线锤;铅锤线;锤规; [a] /ˈplʌmɪt/; [or]gmat;
teem: [vi]充满;大量存在于; [vt]生下; [a] /tiːm/; [or]gmat;
deteriorate: [v]恶化;变质;衰退; [a] /dɪˈtɪriəreɪt/; [or]gmat;
cocaine: [n]可卡因,古柯碱; [a] /koʊˈkeɪn/; [or]gmat;
dynamics: [n]动力学;力学; [a] /daɪ'næmɪks/; [or]gmat;
pervasive: [adj]深入人心的,普遍的; [a] /pərˈveɪsɪv/; [or]gmat;
increment: [n]增长;增值; [a] /ˈɪŋkrəmənt/; [or]gmat;
segregation: [n]分离,隔离,种族隔离; [a] /ˌseɡrɪˈɡeɪʃn/; [or]gmat;
cardiac: [adj]心脏的,心脏病的; [n]心脏病患者;强心剂;健胃剂; [a] /ˈkɑːrdiæk/; [or]gmat;
prohibitive: [adj]禁止性的,阻止的;(费用,价格等)过高的;类同禁止的; [a] /prəˈhɪbətɪv/; [or]gmat;
islamic: [adj]伊斯兰教的,穆斯林的; [a] /ɪzˈlæmɪk/; [or]gmat;
bucolic: [adj]乡村的;牧羊的; [a] /bjuːˈkɑːlɪk/; [or]gmat;
metric: [adj]米制的,公制的; [n]度量标准;[数学]度量;诗体,韵文,诗韵; [a] /ˈmetrɪk/; [or]gmat;
boycott: [vt]抵制; [n]抵制; [a] /ˈbɔɪkɑːt/; [or]gmat;
aftermath: [n]不幸事件之后果,余波; [a] /ˈæftərmæθ/; [or]gmat;
sophomore: [n]大二年级学生; [adj]二年级的;二年级学生的; [a] /ˈsɑːfəmɔːr/; [or]gmat;
quiz: [n]问答比赛,智力竞赛;小测验,小考; [v]考查,盘问; [a] /kwɪz/; [or]gmat;
mannerism: [n](说话,举止等的)习气,癖性,矫揉造作; [a] /ˈmænərɪzəm/; [or]gmat;
rinse: [v](用清水)刷,冲洗掉,漂净,漱口; [n]嗽洗,漂洗,漂清,冲洗; [a] /rɪns/; [or]gmat;
hockey: [n]曲棍球; [a] /ˈhɑːki/; [or]gmat;
whisker: [n]胡须;腮须; [a] /ˈwɪskər/; [or]gmat;
chameleon: [n]蜥蜴;变色龙;善变的人; [a] /kəˈmiːliən/; [or]gmat;
hegemony: [n]霸权,领导权; [a] /hɪˈdʒemoʊni/; [or]gmat;
verisimilitude: [n]逼真,真实性; [a] /ˌverɪsɪˈmɪlɪtuːd/; [or]gmat;
criteria: [n]标准,条件; [a] /kraɪ'tɪəriə/; [or]gmat;
hydrocarbon: [n]碳氢化合物,烃; [a] /ˌhaɪdrəˈkɑːrbən/; [or]gmat;
skeptic: [n]怀疑论者;怀疑者;无神论者; [a] /ˈskeptɪk/; [or]gmat;
magnesium: [n]镁; [a] /mæɡˈniːziəm/; [or]gmat;
crass: [adj]粗鲁的,粗俗的,愚钝的; [a] /kræs/; [or]gmat;
geometric: [adj]几何学的,几何图形的; [a] /ˌdʒiːəˈmetrɪk/; [or]gmat;
ozone: [n]臭氧;(口语)新鲜空气;能使人兴奋的力量; [a] /ˈoʊzoʊn/; [or]gmat;
pharmacy: [n]药房,药剂学,配药业,制药业,一批备用药品; [a] /ˈfɑːrməsi/; [or]gmat;
qualitative: [adj](性)质的,定性的; [a] /ˈkwɑːləteɪtɪv/; [or]gmat;
promulgate: [v]公布;传播;发表; [a] /ˈprɑːmlɡeɪt/; [or]gmat;
impoverish: [v]使成赤贫,使枯竭; [a] /ɪmˈpɑːvərɪʃ/; [or]gmat;
periphery: [n]外围,不重要的部份; [a] /pəˈrɪfəri/; [or]gmat;
enroll: [v]入学,加入,登记,入伍; [a] /ɪnˈroʊl/; [or]gmat;
extrinsic: [adj]外在的,外部的; [a] /eksˈtrɪnzɪk/; [or]gmat;
referendum: [n]公民投票,复决权; [a] /ˌrefəˈrendəm/; [or]gmat;
laudatory: [adj]表扬的,赞扬的; [a] /ˈlɔːdətɔːri/; [or]gmat;
genetic: [adj]遗传的,起源的; [a] /dʒəˈnetɪk/; [or]gmat;
repertoire: [n](剧团,演员等的)全部节目;全部才能; [a] /ˈrepərtwɑːr/; [or]gmat;
excerpt: [n]摘录,节选; [v]摘,选;引用; [a] /ˈeksɜːrpt/; [or]gmat;
rectangle: [n]长方形,矩形; [a] /ˈrektæŋɡl/; [or]gmat;
kelp: [n]海草,巨藻;海草灰(从中可提取碘); [a] /kelp/; [or]gmat;
reimburse: [v]偿还;赔偿;退还(钱),付还; [a] /ˌriːɪmˈbɜːrs/; [or]gmat;
rotate: [v]以..轴转动,使旋转,使..轮流;轮换; [a] /ˈroʊteɪt/; [or]gmat;
culminate: [v]使达高潮,使结束; [a] /ˈkʌlmɪneɪt/; [or]gmat;
apportion: [v]分配; [a] /əˈpɔːrʃn/; [or]gmat;
internecine: [adj]互相残杀的,两败俱伤的,内部冲突的; [a] /ˌɪntərˈniːsaɪn/; [or]gmat;
disseminate: [v]宣传,传播;散布; [a] /dɪˈsemɪneɪt/; [or]gmat;
delve: [v]钻研;探究;挖; [n]穴;洞; [a] /delv/; [or]gmat;
scenario: [n]剧情梗概;情况,情节;设想; [a] /səˈnærioʊ/; [or]gmat;
invigorate: [v]鼓舞;提神,使精力充沛; [adj]生气勃勃的,精力充沛的,健壮的; [n]滋补;鼓舞; [a] /ɪnˈvɪɡəreɪt/; [or]gmat;
grandiloquent: [adj](语言等)夸张的,夸大的; [a] /ɡrænˈdɪləkwənt/; [or]gmat;
ignite: [v]点燃,发光,燃烧; [a] /ɪɡˈnaɪt/; [or]gmat;
aspersion: [n]诽谤,中伤; [a] /ə'spɜːʒən/; [or]gmat;
boost: [v]增加;偷盗; [n]提高;激励;后推;助推发动机; [a] /buːst/; [or]gmat;
inconsequential: [adj]不重要的,不合理的,不合逻辑的; [a] /ɪnˌkɑːnsɪˈkwenʃl/; [or]gmat;
uranium: [n]铀; [a] /juˈreɪniəm/; [or]gmat;
connive: [v]默许,共谋; [a] /kəˈnaɪv/; [or]gmat;
amenity: [n]适意;舒适;便利设施;舒适,愉快;礼仪; [a] /əˈmenəti/; [or]gmat;
cognitive: [adj]认识能力的;认知的; [a] /ˈkɑːɡnətɪv/; [or]gmat;
unwitting: [adj]不知情的;无意的; [a] /ʌnˈwɪtɪŋ/; [or]gmat;
coordinate: [v]使协调,使一致,调整; [n]坐标,同等的人物,配套服装; [adj]并列的;同等的; [a] /koʊˈɔːrdɪneɪt/; [or]gmat;
outnumber: [v]在数量上超过; [a] /ˌaʊtˈnʌmbər/; [or]gmat;
nadir: [n]最低点,无底; [a] /ˈneɪdɪr/; [or]gmat;
maim: [v]使残废; [a] /meɪm/; [or]gmat;
clarify: [v]阐明,澄清;净化; [a] /ˈklærəfaɪ/; [or]gmat;
rekindle: [v]重新点燃,使再振作精神; [a] /ˌriːˈkɪndl/; [or]gmat;
estrange: [v]使疏远,离间; [a] /ɪ'streɪndʒ/; [or]gmat;
juror: [n]审查委员,陪审员; [a] /ˈdʒʊrər/; [or]gmat;
toxic: [n]毒物; [adj]有毒的;中毒的; [a] /ˈtɑːksɪk/; [or]gmat;
endemic: [adj]地方性的; [n]地方病; [a] /enˈdemɪk/; [or]gmat;
integrated: [adj]综合的,完整的,互相协调的; [a] /ˈɪntɪɡreɪtɪd/; [or]gmat;
gravitate: [v]受引力作用;被吸引; [a] /ˈɡrævɪteɪt/; [or]gmat;
slump: [v]突然倒下;暴跌; [n]下降;经济萧条时期; [a] /slʌmp/; [or]gmat;
cater: [v]供应伙食;为(集会,婚礼等)承办酒席; [a] /ˈkeɪtər/; [or]gmat;
relativity: [n]相关性;相对性; [a] /ˌreləˈtɪvəti/; [or]gmat;
unearth: [vt]发掘,掘出,揭露,发现;揭发; [a] /ʌnˈɜːrθ/; [or]gmat;
permeate: [v]弥漫;普及;渗透; [a] /ˈpɜːrmieɪt/; [or]gmat;
lethal: [adj]致命的,致死的;杀伤性的; [n]致死因子; [a] /ˈliːθl/; [or]gmat;
gel: [n]［物］［化］凝胶(体),冻胶; [v]胶化; [a] /dʒel/; [or]gmat;
char: [n]炭,木炭,［常用复］家庭杂物; [v](把..)烧成炭,烧焦; [a] /tʃɑːr/; [or]gmat;
seminal: [adj]重要的,精液的,种子的; [a] /ˈsemɪnl/; [or]gmat;
parallax: [n]［物］［天］视差,［天］周年(日)视差; [a] /ˈpærəlæks/; [or]gmat;
proctor: [n]代理人,学监; [vt]监督; [a] /ˈprɑːktər/; [or]gmat;
asteroid: [n]小行星; [adj]星状的; [a] /ˈæstərɔɪd/; [or]gmat;
actuate: [v]开动(机器);激励,驱使; [a] /ˈæktʃueɪt/; [or]gmat;
obese: [adj]肥胖的;过胖的; [a] /oʊˈbiːs/; [or]gmat;
subtract: [v]减少;减去;扣除; [vt]减去; [a] /səbˈtrækt/; [or]gmat;
archaeologist: [n]考古学家; [a] /ˌɑːrkiˈɑːlədʒɪst/; [or]gmat;
pinto: [n]杂色马,斑豆; [adj]杂色的; [a] /ˈpɪntoʊ/; [or]gmat;
placate: [vt]安抚,抚慰; [a] /ˈpleɪkeɪt/; [or]gmat;
amplify: [v]放大(声音等);扩大;增强;详述;进一步阐述; [a] /ˈæmplɪfaɪ/; [or]gmat;
sanitarium: [n]疗养院,休养地; [a] /ˌsænəˈteriəm/; [or]gmat;
preeminent: [adj]卓越的,超群的; [adv]卓越地,杰出地; [a] /priˈemɪnənt/; [or]gmat;
terrain: [n]地面,地形; [a] /təˈreɪn/; [or]gmat;
overlay: [n]覆盖图;覆盖物; [vt]在表面上铺一薄层,镀; [a] /ˌoʊvərˈleɪ/; [or]gmat;
shareholder: [n]股东,股票持有者; [a] /ˈʃerhoʊldər/; [or]gmat;
jeopardize: [v]危及,损害(也作jeopardise); [a] /ˈdʒepərdaɪz/; [or]gmat;
obsidian: [n]黑曜石; [a] /əbˈsɪdiən/; [or]gmat;
microbe: [n]微生物;细菌; [a] /ˈmaɪkroʊb/; [or]gmat;
contaminate: [v]弄脏,污染; [a] /kənˈtæmɪneɪt/; [or]gmat;
whirligig: [n]旋转玩具,循环变迁; [a] /ˈwɜːrliɡɪɡ/; [or]gmat;
irritant: [adj]刺激的,刺激性的; [n][医]刺激物,刺激剂; [a] /ˈɪrɪtənt/; [or]gmat;
obesity: [n]肥胖; [a] /oʊˈbiːsəti/; [or]gmat;
inflate: [v]充气,膨胀,扩大; [a] /ɪnˈfleɪt/; [or]gmat;
raccoon: [n]浣熊;浣熊毛皮; [a] /ræˈkuːn/; [or]gmat;
embalm: [v]以香油(或药料)涂,防腐,使不朽; [a] /ɪmˈbɑːm/; [or]gmat;
sketchy: [adj]概略的,粗略的; [a] /ˈsketʃi/; [or]gmat;
gradient: [n]斜坡;倾斜度;坡度;渐变; [adj]倾斜的;渐倾的; [a] /ˈɡreɪdiənt/; [or]gmat;
mandatory: [adj]命令的,强制性的; [a] /ˈmændətɔːri/; [or]gmat;
rescind: [v]废除;取消;撤回; [a] /rɪˈsɪnd/; [or]gmat;
crumple: [v]把.揉作一团,弄皱;压碎; [a] /ˈkrʌmpl/; [or]gmat;
fjord: [n]峡湾(尤指挪威海岸边的); [a] /ˈfjɔːrd/; [or]gmat;
brokerage: [n]中间人业务,经济业;付给经纪人的经手费,佣金,回扣; [a] /ˈbroʊkərɪdʒ/; [or]gmat;
coupon: [n](债券等)息券;赠券;配给券;折扣券; [a] /ˈkuːpɑːn/; [or]gmat;
turnover: [n]成交量;营业收入;人员更替率;半圆卷饼; [a] /ˈtɜːrnoʊvər/; [or]gmat;
rodent: [n]啮齿类动物(如鼠等); [a] /ˈroʊdnt/; [or]gmat;
circumscribe: [v]限制;在.周围画线;[数]使外接,使外切; [a] /ˈsɜːrkəmskraɪb/; [or]gmat;
rabies: [n](单复同型)狂犬病; [a] /ˈreɪbiːz/; [or]gmat;
orientation: [n]信仰;倾向;[计]定向;(学生)迎新会;定向,方向;(任职,上学等之前的) 情况介绍;训练; [a] /ˌɔːriənˈteɪʃn/; [or]gmat;
organism: [n]生物,有机体;有机的组织; [a] /ˈɔːrɡənɪzəm/; [or]gmat;
deform: [v](使)变形; [adj]畸形的;丑陋的; [a] /dɪˈfɔːrm/; [or]gmat;
luminosity: [n]光明,发光体;发光度; [a] /ˌluːmɪˈnɑːsəti/; [or]gmat;
tactile: [adj]有触觉的;能触知的; [a] /ˈtæktl/; [or]gmat;
thermal: [adj]保暖的;温泉的;热的; [n]保暖内衣裤; [a] /ˈθɜːrml/; [or]gmat;
inept: [adj]无能的;不称职的;笨拙的; [a] /ɪˈnept/; [or]gmat;
somatic: [adj]肉体的; [a] /soʊ'mætɪk/; [or]gmat;
stereotype: [n]老套的模式,陈规,成见; [v]对..产生成见; [a] /ˈsteriətaɪp/; [or]gmat;
masculinity: [n]男性(气概); [a] /ˌmæskjuˈlɪnəti/; [or]gmat;
kinetic: [adj]运动的; [a] /kɪˈnetɪk/; [or]gmat;
implant: [v]嵌入,注入,灌输; [n][医]植入物,植入管; [a] /ɪmˈplænt/; [or]gmat;
fleck: [n]斑点,斑纹;雀斑;微粒,小片; [v]使起斑点;使有斑纹; [a] /flek/; [or]gmat;
instigate: [v]发起,煽动; [a] /ˈɪnstɪɡeɪt/; [or]gmat;
agenda: [n]议事日程; [a] /əˈdʒendə/; [or]gmat;
foreclose: [v]排除,取消抵押品的赎回权; [a] /fɔːrˈkloʊz/; [or]gmat;
saturate: [v]使充满,使饱和,使湿透; [a] /ˈsætʃəreɪt/; [or]gmat;
deflect: [v](使)偏斜,(使)偏转; [a] /dɪˈflekt/; [or]gmat;
elongation: [n]伸长,伸长率,延伸率; [a] /ˌiːlɔːŋˈɡeɪʃn/; [or]gmat;
hinterland: [n]内地;腹地;穷乡僻壤;远离城镇的地方; [a] /ˈhɪntərlænd/; [or]gmat;
viola: [n]中提琴; [a] /viˈoʊlə/; [or]gmat;
devastate: [v]摧毁;使垮掉,使不知所措,使陷于混乱; [a] /ˈdevəsteɪt/; [or]gmat;
accretion: [n]自然的增加,增加物; [a] /əˈkriːʃn/; [or]gmat;
rendition: [n]表演,演奏;译文;给予,提供; [a] /renˈdɪʃn/; [or]gmat;
nostalgia: [n]怀旧之情,思乡病; [a] /nəˈstældʒə/; [or]gmat;
pituitary: [adj]［解］脑垂体的,粘液的; [n]垂体,脑垂体; [a] /pɪˈtuːəteri/; [or]gmat;
tamarind: [n]［植］罗望子树,罗望子果(味酸,常做清凉轻泻剂用); [a] /ˈtæmərɪnd/; [or]gmat;
indices: [n]目录,指数; [a] /ˈɪndɪsiːz/; [or]gmat;
cosmetic: [n]化妆品; [adj]化妆用的,美容的;装门面的 [表不满]; [a] /kɑːzˈmetɪk/; [or]gmat;
dissenter: [n]持异议者;反对者; [a] /dɪˈsentər/; [or]gmat;
foreshadow: [v]预示; [n]预兆; [a] /fɔːrˈʃædoʊ/; [or]gmat;
Hispanic: [adj]拉丁美洲的;西班牙人的;西班牙的; [n]讲西班牙语的人;拉美裔美国人; [a] /hɪˈspænɪk/; [or]gmat;
meander: [n]蜿蜒曲折,迂回曲折的旅程;漫步; [v]迂回曲折;漫步;漫谈; [a] /miˈændər/; [or]gmat;
hone: [n]细磨刀石; [v]磨刀; [a] /hoʊn/; [or]gmat;
graphite: [n]石墨; [a] /ˈɡræfaɪt/; [or]gmat;
caveat: [n]警告;防止误解的说明; [a] /ˈkæviæt/; [or]gmat;
rationale: [n]基本原理;原理的阐述; [a] /ˌræʃəˈnæl/; [or]gmat;
corrosion: [n]侵蚀,腐蚀状态; [a] /kəˈroʊʒn/; [or]gmat;
supplicant: [n]乞求者,恳求者; [a] /ˈsʌplɪkənt/; [or]gmat;
dismember: [v]肢解;瓜分; [a] /dɪsˈmembər/; [or]gmat;
vintner: [n]葡萄酒商; [a] /ˈvɪntnər/; [or]gmat;
narcissistic: [adj]自我陶醉的,自恋的; [a] /ˌnɑːrsɪˈsɪstɪk/; [or]gmat;
therapy: [n]治疗,理疗;疗法; [a] /ˈθerəpi/; [or]gmat;
cornerstone: [n]奠基石;基础; [a] /ˈkɔːrnərstoʊn/; [or]gmat;
pentagon: [n]五边形; [a] /ˈpentəɡɑːn/; [or]gmat;
mainstream: [n]主流,主要倾向; [v]使.成为主流;将(残障儿童等)纳入正规班级; [adj]主流的; [a] /ˈmeɪnstriːm/; [or]gmat;
problematic: [adj]问题的;有疑问的;不确定的; [a] /ˌprɑːbləˈmætɪk/; [or]gmat;
pelvic: [adj]［解］骨盆的; [n]骨盆部; [a] /ˈpelvɪk/; [or]gmat;
collide: [vi]碰撞;互撞;抵触; [a] /kəˈlaɪd/; [or]gmat;
carbohydrate: [n][化]碳水化合物;淀粉质食物; [a] /ˌkɑːrboʊˈhaɪdreɪt/; [or]gmat;
fanfare: [n]夸耀,嘹亮的喇叭声; [v]热闹地介绍[宣布]; [a] /ˈfænfer/; [or]gmat;
invertebrate: [adj]无脊椎的(动物);没骨气的,懦弱的; [n]无脊椎动物;没骨气的人; [a] /ɪnˈvɜːrtɪbrət/; [or]gmat;
conceptual: [adj]概念的; [a] /kənˈseptʃuəl/; [or]gmat;
algae: [n]藻类; [a] /ˈældʒiː/; [or]gmat;
brochure: [n]手册,小册子; [a] /broʊˈʃʊr/; [or]gmat;
prerequisite: [n]先决条件,必要条件; [adj]必须先具备的,必要的; [a] /ˌpriːˈrekwəzɪt/; [or]gmat;
lexicographer: [n]词典编纂人; [a] /ˌleksɪˈkɑːɡrəfər/; [or]gmat;
bipartisan: [adj]由两党成员组成的;被两党支持的; [a] /ˌbaɪˈpɑːrtɪzn/; [or]gmat;
radioactive: [adj]放射性的; [a] /ˌreɪdioʊˈæktɪv/; [or]gmat;
spatial: [adj]空间的,关于空间的; [a] /ˈspeɪʃl/; [or]gmat;
specialize: [v]专门研究,专门从事; [a] /ˈspeʃəlaɪz/; [or]gmat;
input: [n]投入;[电学,计算机]输入; [vt]输入; [a] /ˈɪnpʊt/; [or]gmat;
culpability: [n]有罪,该受谴责; [a] /ˌkʌlpəˈbɪləti/; [or]gmat;
condor: [n][动物]神鹰;秃鹫; [a] /ˈkɑːndɔːr/; [or]gmat;
arthritis: [n][外科]关节炎; [a] /ɑːrˈθraɪtɪs/; [or]gmat;
leeway: [n]［海］［空］风压差;余地; [a] /ˈliːweɪ/; [or]gmat;
clientele: [n]顾客,常客; [a] /ˌklaɪənˈtel/; [or]gmat;
jawbone: [v]赊买或借贷; [n]颚骨,牙床骨; [adv]〈美俚〉凭信用地; [a] /ˈdʒɔːboʊn/; [or]gmat;
bloc: [n]集团; [a] /blɑːk/; [or]gmat;
inhibit: [v]阻碍;阻止,防止;抑制,约束; [a] /ɪnˈhɪbɪt/; [or]gmat;
distill: [v]抽出..的精华;蒸馏; [a] /dɪˈstɪl/; [or]gmat;
diabetes: [n]糖尿病,多尿症; [a] /ˌdaɪəˈbiːtiːz/; [or]gmat;
inoculate: [v][医]给..接种,给..注射预防针,[植]嫁接,灌输; [a] /ɪˈnɑːkjuleɪt/; [or]gmat;
vaccine: [n]牛痘苗,疫苗; [adj]牛痘的;预防疫苗的;种痘的; [a] /vækˈsiːn/; [or]gmat;
dismantle: [v]拆开;拆除; [a] /dɪsˈmæntl/; [or]gmat;
impasse: [n]僵局;死路; [a] /ˈɪmpæs/; [or]gmat;
Baroque: [adj]巴洛克式的,结构复杂的,形式怪样的; [n]巴洛克风格,巴洛克艺术; [a] /bəˈroʊk/; [or]gmat;
fledgling: [n]刚学飞的幼鸟,无经验的人; [adj]刚开始的;无经验的; [a] /ˈfledʒlɪŋ/; [or]gmat;
Pleistocene: [n]更新世,更新世岩; [a] /'plaistəusi:n/; [or]gmat;
filibuster: [n]冗长演说; [v]拖延议事; [a] /ˈfɪlɪbʌstər/; [or]gmat;
irreversible: [adj]不能翻转的;不可撤销的;不可逆的; [a] /ˌɪrɪˈvɜːrsəbl/; [or]gmat;
stultify: [v]使显得愚蠢,愚弄,使无效,使无价值; [a] /ˈstʌltɪfaɪ/; [or]gmat;
ragtime: [n]拉格泰姆音乐; [adj]滑稽的;不严肃的; [a] /ˈræɡtaɪm/; [or]gmat;
salable: [adj]可出售的,畅销的,有销路的; [a] /'seɪləbəl/; [or]gmat;
recoup: [v]收回;恢复;偿还;扣除; [n]获得补偿; [a] /rɪˈkuːp/; [or]gmat;
solvency: [n]偿付能力;溶解力; [a] /ˈsɑːlvənsi/; [or]gmat;
inadvertent: [adj]疏忽的,漫不经心的,无意中的; [a] /ˌɪnədˈvɜːrtənt/; [or]gmat;
oats: [n]燕麦,燕麦片,燕麦粥; [a] /oʊts/; [or]gmat;
diagnose: [v]诊断(疾病),对(病人)下诊断结论; [a] /ˌdaɪəɡˈnoʊs/; [or]gmat;
aeronautics: [n]航空学; [adj]航空(学)的; [a] /ˌerəˈnɔːtɪks/; [or]gmat;
iguana: [n]美洲大蜥蜴; [a] /ɪˈɡwɑːnə/; [or]gmat;
ideology: [n]意识形态,思想(体系); [a] /ˌaɪdiˈɑːlədʒi/; [or]gmat;
reptilian: [adj]爬虫类的;卑下的; [n]两栖动物;卑劣的人; [a] /repˈtɪliən/; [or]gmat;
coronary: [adj]冠的,冠状的,花冠的; [n]冠状动脉;(病理学)冠状动脉血栓形成; [a] /ˈkɔːrəneri/; [or]gmat;
peddle: [v]叫卖,散播; [a] /ˈpedl/; [or]gmat;
gullible: [adj]易受骗的;轻信的; [a] /ˈɡʌləbl/; [or]gmat;
quadrilateral: [adj]四边形的; [a] /ˌkwɑːdrɪˈlætərəl/; [or]gmat;
chore: [n]日常家庭杂务,日常工作;琐碎烦人的杂务; [a] /tʃɔːr/; [or]gmat;
pliers: [n]钳子; [a] /ˈplaɪərz/; [or]gmat;
optimum: [adj]最适宜的;最佳的; [n]最适条件;最适宜; [a] /ˈɑːptɪməm/; [or]gmat;
abduct: [v]绑架,拐走; [a] /æbˈdʌkt/; [or]gmat;
impinge: [v]侵犯,撞击,碰撞; [a] /ɪmˈpɪndʒ/; [or]gmat;
anthropologist: [n]人类学家,人类学者; [a] /ˌænθrəˈpɑːlədʒɪst/; [or]gmat;
sulfur: [n]硫磺; [a] /ˈsʌlfər/; [or]gmat;
cortex: [n][解剖]皮质,树皮,果皮; [a] /ˈkɔːrteks/; [or]gmat;
disparate: [adj]迥然不同的; [a] /ˈdɪspərət/; [or]gmat;
trajectory: [n]弹道,航线;轨线; [a] /trəˈdʒektəri/; [or]gmat;
parenthetical: [adj]作为插入语的,放在括号里的,［喻］插曲的; [a] /ˌpærənˈθetɪkl/; [or]gmat;
directive: [n]指示,指令; [adj]指导的,管理的;方向的; [a] /dəˈrektɪv/; [or]gmat;
nexus: [n]关系;连结; [a] /ˈneksəs/; [or]gmat;
noncommittal: [adj]态度不明朗的;不承担义务的;无明确意义的; [a] /ˌnɒnkə'mɪtəl/; [or]gmat;
ferrous: [adj]含铁的; [a] /ˈferəs/; [or]gmat;
electromagnetic: [adj]电磁的; [a] /ɪˌlektroʊmæɡˈnetɪk/; [or]gmat;
varicose: [adj]［医］静脉曲张的,治疗静脉曲张用的; [a] /'værɪˌkoʊs/; [or]gmat;
gravitational: [adj]重力的;万有引力的; [a] /ˌɡrævɪˈteɪʃənl/; [or]gmat;
nicotine: [n]尼古丁; [a] /ˈnɪkətiːn/; [or]gmat;
stance: [n]立场,姿态,位置; [a] /stæns/; [or]gmat;
spate: [n]洪水;一阵;大雨;突然迸发; [a] /speɪt/; [or]gmat;
metamorphose: [v]使变形,使变质; [a] /ˌmetəˈmɔːrfoʊz/; [or]gmat;
caviar: [n]鱼子酱; [a] /ˈkæviɑːr/; [or]gmat;
incompatible: [adj]不兼容的,矛盾的,不调和的; [a] /ˌɪnkəmˈpætəbl/; [or]gmat;
domesticate: [vt]使习惯于家庭生活;驯养;引进; [a] /dəˈmestɪkeɪt/; [or]gmat;
rebut: [v](律)辩驳,揭露,戳穿; [a] /rɪˈbʌt/; [or]gmat;
commute: [n]在两地之间乘车往返; [v]经常乘车往返于两地之间; [vt]减免; [a] /kəˈmjuːt/; [or]gmat;
lactic: [adj]乳汁的,乳的; [a] /'læktɪk/; [or]gmat;
monochrome: [adj]单色的; [n]单色画;单色照片,黑白照片; [a] /ˈmɑːnəkroʊm/; [or]gmat;
payroll: [n]工资单; [a] /ˈpeɪroʊl/; [or]gmat;
hormone: [n]荷尔蒙,激素; [a] /ˈhɔːrmoʊn/; [or]gmat;
gourmet: [n]美食家,讲究吃喝的人; [adj]菜肴精美的; [a] /ˈɡʊrmeɪ/; [or]gmat;
plaque: [n]饰板,匾,斑块; [a] /plæk/; [or]gmat;
renal: [adj]肾脏的; [a] /ˈriːnl/; [or]gmat;
collaborate: [v]合作; [a] /kəˈlæbəreɪt/; [or]gmat;
osprey: [n]［动］鹗,鱼鹰;白色装饰羽毛; [a] /ˈɑːspreɪ/; [or]gmat;
polygon: [n]多角形,多边形; [a] /ˈpɑːliɡɑːn/; [or]gmat;
expertise: [n]专门知识,专门技能; [a] /ˌekspɜːrˈtiːz/; [or]gmat;
anesthesia: [n]麻醉;麻木(等于anaesthesia); [a] /ˌænəsˈθiʒə/; [or]gmat;
periwinkle: [n]［植］常春花; [a] /ˈperiwɪŋkl/; [or]gmat;
bumblebee: [n](动)野蜂,大蜂; [a] /ˈbʌmblbiː/; [or]gmat;
echelon: [n]等级,阶层,梯形,梯次编队; [vi]形成梯队; [vt]排成梯队; [a] /ˈeʃəlɑːn/; [or]gmat;
rampage: [n]粗暴;胡闹; [v]暴跳;暴怒;狂暴地乱冲; [a] /ræmˈpeɪdʒ/; [or]gmat;
electron: [n]电子; [a] /ɪˈlektrɑːn/; [or]gmat;
cancerous: [adj]癌的,患癌症的; [a] /ˈkænsərəs/; [or]gmat;
adipose: [adj]脂肪质的,脂肪多的; [n]动物脂肪; [a] /ˈædɪpoʊs/; [or]gmat;
sabotage: [n]怠工,蓄意破坏,妨碍; [v]怠工,从事破坏活动,故意阻挠; [a] /ˈsæbətɑːʒ/; [or]gmat;
feminist: [n]男女平等主义者,女权扩张论者; [adj]主张男女平等的,女权主义的; [a] /ˈfemənɪst/; [or]gmat;
gymnast: [n]体操运动员; [a] /ˈdʒɪmnæst/; [or]gmat;
bicker: [v]斗嘴,流动,闪动; [n]口角,流水声; [a] /ˈbɪkər/; [or]gmat;
cobble: [v]修,拙劣地修补;铺鹅卵石,用圆石铺面; [n]鹅卵石,圆石; [a] /ˈkɑːbl/; [or]gmat;
convoluted: [adj]旋绕的,费解的; [a] /ˈkɑːnvəluːtɪd/; [or]gmat;
irradiation: [n]照射,发光,放射; [a] /ɪˌreɪdiˈeɪʃn/; [or]gmat;
paleolithic: [adj]旧石器时代的; [a] /ˌpeɪlɪə'lɪθɪk/; [or]gmat;
diaper: [n]尿布; [a] /ˈdaɪpər/; [or]gmat;
addict: [n]上瘾的人;入迷的人; [v]使沉迷,使上瘾; [a] /ˈædɪkt/; [or]gmat;
laser: [n]激光,激光器; [a] /ˈleɪzər/; [or]gmat;
meteorite: [n]流星;陨星; [a] /ˈmiːtiəraɪt/; [or]gmat;
anecdotal: [adj]轶事的,趣闻的;多逸事趣闻的;举例说明的; [a] /ˌænɪkˈdoʊtl/; [or]gmat;
ceramic: [adj]陶器的,陶瓷的; [n]陶瓷制品; [a] /səˈræmɪk/; [or]gmat;
vitriolic: [adj]刻薄的,强烈的,硫酸(盐)的,由硫酸制成的; [a] /ˌvɪtriˈɑːlɪk/; [or]gmat;
sprinkler: [n]洒水装置,洒水车; [a] /ˈsprɪŋklər/; [or]gmat;
ovarian: [adj]［解］卵巢的,［植］子房的; [a] /oʊˈveriən/; [or]gmat;
detractor: [n](批评者)诽谤者,恶意批评者; [a] /dɪˈtræktər/; [or]gmat;
criminology: [n]犯罪学,刑事学; [a] /ˌkrɪmɪˈnɑːlədʒi/; [or]gmat;
enervation: [n]虚弱,无力; [a] /ˌenərˈveɪʃn/; [or]gmat;
boreal: [adj]北的,北方的,北风的,北半球北部山区的; [a] /'bɔːriːl/; [or]gmat;
nuance: [n]细微差别; [a] /ˈnuːɑːns/; [or]gmat;
pathogenic: [adj]病原的,致病的,发病的; [a] /ˌpæθəˈdʒenɪk/; [or]gmat;
antedate: [n]比实际提前的日期; [vt]在.上写上早于实际的日期;发生于.以前;使提前发生;使回到过去; [a] /ˌæntiˈdeɪt/; [or]gmat;
timber: [n]木料;树木;性格,素质; excl. 树要倒啦!; [adj]木材的,木制的; [v]用木材作骨架;以林木覆盖; [a] /ˈtɪmbər/; [or]gmat;
hefty: [adj]重的,肌肉发达的,异常大的; [adv]强有力地,非常; [n]体格健壮的人; [a] /ˈhefti/; [or]gmat;
decimate: [v]大量杀死,十中抽一,大量毁灭; [a] /ˈdesɪmeɪt/; [or]gmat;
fallout: [n]［原］微粒回降,放射性尘埃;附带的后果;不良后果; [v]争吵,争议; [a] /ˈfɔːlaʊt/; [or]gmat;
helium: [n][化学]氦(元素符号He); [a] /ˈhiːliəm/; [or]gmat;
expatriate: [v](使)移居国外;(使)放弃国籍;流放,放逐; [n]被流放者;移居国外者; [adj]移居国外的;被流放的; [a] /ˌeksˈpeɪtriət/; [or]gmat;
absenteeism: [n]旷工;旷课; [a] /ˌæbsənˈtiːɪzəm/; [or]gmat;
pornography: [n]色情描写,色情文学,色情画; [a] /pɔːrˈnɑːɡrəfi/; [or]gmat;
bilingual: [adj]使用两种语言的,用两种文字写成的; [a] /ˌbaɪˈlɪŋɡwəl/; [or]gmat;
lobbyist: [n]院外活动集团的成员,说客; [a] /ˈlɑːbiɪst/; [or]gmat;
anesthetic: [n]麻醉剂,麻药; [adj]麻醉的,感觉缺失的; [a] /ˌænəs'θetɪk/; [or]gmat;
perimeter: [n]周长;周界; [a] /pəˈrɪmɪtər/; [or]gmat;
plasma: [n]血浆;等离子体;深绿玉髓; [a] /ˈplæzmə/; [or]gmat;
chromosome: [n]染色体; [a] /ˈkroʊməsoʊm/; [or]gmat;
ongoing: [n]进行,前进,发展; [adj]进行中的,不间断的; [a] /ˈɑːnɡoʊɪŋ/; [or]gmat;
neural: [adj]神经的;神经系统的;背的;神经中枢的; [a] /ˈnʊrəl/; [or]gmat;
integer: [n]整数;整体; [a] /ˈɪntɪdʒər/; [or]gmat;
gyroscope: [n]陀螺仪,回转仪; [a] /ˈdʒaɪrəskoʊp/; [or]gmat;
carnivore: [n]食肉动物,食虫植物; [a] /ˈkɑːrnɪvɔːr/; [or]gmat;
heterogeneity: [n]异类,不同,不均匀性,不纯一性,异质性; [a] /ˌhetərədʒəˈniːəti/; [or]gmat;
haberdashery: [n](总称)男子服饰用品,缝纫用品; [a] /ˈhæbərdæʃəri/; [or]gmat;
elongate: [v]延长,伸长; [adj]延长了的;细长的; [a] /ɪˈlɔːŋɡeɪt/; [or]gmat;
bacterium: [n]细菌; [a] /bæk'tɪriəm/; [or]gmat;
seismic: [adj]地震的;地震引起的;剧烈的; [a] /ˈsaɪzmɪk/; [or]gmat;
evict: [v]驱逐,逐出; [a] /ɪˈvɪkt/; [or]gmat;
entrepreneur: [n]企业家,演出承包人; [a] /ˌɑːntrəprəˈnɜːr/; [or]gmat;
cheetah: [n]猎豹; [a] /ˈtʃiːtə/; [or]gmat;
broccoli: [n]硬花球花椰菜;花茎甘蓝; [a] /ˈbrɑːkəli/; [or]gmat;
segregate: [v]分开,隔离,进行种族隔离; [a] /ˈseɡrɪɡeɪt/; [or]gmat;
perk: [v]昂首,意气洋洋,振作; [n]好处;福利; [adj]〈罕〉同"perky"; [a] /pɜːrk/; [or]gmat;
gyration: [n]旋转,回旋;［动］螺层; [a] /dʒaɪˈreɪʃn/; [or]gmat;
perturb: [vt]使不安;烦扰;使紊乱; [a] /pərˈtɜːrb/; [or]gmat;
medication: [n]药物;药物治疗;药物处理; [a] /ˌmedɪˈkeɪʃn/; [or]gmat;
trauma: [n]精神创伤,外伤; [a] /ˈtraʊmə/; [or]gmat;
sequester: [v]使隔离,隔绝,使隐退,没收,扣押; [a] /sɪˈkwestər/; [or]gmat;
vector: [n][数]向量;矢量;带菌者; [a] /ˈvektər/; [or]gmat;
tactic: [n](达到目的)手段,战术,策略; [adj]按顺序的;依次排列的; [a] /ˈtæktɪk/; [or]gmat;
follicle: [n]［解］小囊,滤泡,卵泡; [a] /ˈfɑːlɪkl/; [or]gmat;
inhumane: [adj]残忍的,无人情味的; [a] /ˌɪnhjuːˈmeɪn/; [or]gmat;
anemia: [n]贫血,贫血症; [a] /ə'niːmiːə/; [or]gmat;
ordinate: [n]纵坐标; [a] /ˈɔːrdɪnət/; [or]gmat;
alumnus: [n]男毕业生,男校友; [a] /əˈlʌmnəs/; [or]gmat;
clone: [n]克隆;无性繁殖系个体;复制品; [v]复制;克隆; [a] /kloʊn/; [or]gmat;
hypnotist: [n]施行催眠术的人; [a] /ˈhɪpnətɪst/; [or]gmat;
insulate: [v]隔离,使隔绝(以免受到影响);使隔热; [a] /ˈɪnsəleɪt/; [or]gmat;
viable: [adj]可行的;能养活的;能生育的; [a] /ˈvaɪəbl/; [or]gmat;
viscosity: [n]黏性;黏度; [a] /vɪˈskɑːsəti/; [or]gmat;
dinosaur: [n]恐龙; [a] /ˈdaɪnəsɔːr/; [or]gmat;
arcane: [adj]神秘的;秘传的;晦涩难解的; [a] /ɑːrˈkeɪn/; [or]gmat;
obsolescence: [n]即将过时; [a] /ˌɑːbsəˈlesns/; [or]gmat;
soloist: [n]独奏者,独唱者,［空］单飞者; [a] /ˈsoʊloʊɪst/; [or]gmat;
clothesline: [n]晒衣绳; [vt](用胳膊勾住脖子)击倒对手; [a] /'kloʊzˌlaɪn/; [or]gmat;
subsidize: [v]给予补助金; [a] /ˈsʌbsɪdaɪz/; [or]gmat;
tonality: [n]音质,音调; [a] /toʊˈnæləti/; [or]gmat;
multiplier: [n]乘数; [a] /ˈmʌltɪplaɪər/; [or]gmat;
psychosis: [n]精神病,精神错乱,精神变态; [a] /saɪˈkoʊsɪs/; [or]gmat;
coda: [n]［音］结尾,符尾; [a] /ˈkoʊdə/; [or]gmat;
quintessential: [adj]精华的,典型的; [a] /ˌkwɪntɪˈsenʃl/; [or]gmat;
ballistic: [adj]弹道(学)的,发射的,衡量冲击强度的; [a] /bəˈlɪstɪk/; [or]gmat;
smokestack: [n]烟囱,烟窗; [adj]低技术制造业的,大工厂的; [a] /ˈsmoʊkstæk/; [or]gmat;
hexagon: [n]六角形,六边形; [adj]六角形的; [a] /ˈheksəɡɑːn/; [or]gmat;
undercut: [v]廉价出售;较便宜的工资工作;从下边削球; [n]底切;牛腰部下侧嫩肉;砍口;切球; [adj]下部被削去[切去,挖掉,凿去]的; [a] /ˌʌndərˈkʌt/; [or]gmat;
scintillate: [v]闪烁,(淡吐)流露机智; [a] /'sɪntlˌeɪt/; [or]gmat;
blob: [n]一滴,一抹,难以名状的一团; [v]弄脏,把.做错,得零分; [a] /blɑːb/; [or]gmat;
interstellar: [adj]星际的; [a] /ˌɪntərˈstelər/; [or]gmat;
migraine: [n]［法］［医］周期性偏头痛; [a] /ˈmaɪɡreɪn/; [or]gmat;
helicopter: [n]直升机; [v]用直升飞机载送,乘直升机; [a] /ˈhelɪkɑːptər/; [or]gmat;
questionnaire: [n]调查表,问卷; [a] /ˌkwestʃəˈner/; [or]gmat;
toxin: [n]毒素,毒质; [a] /ˈtɑːksɪn/; [or]gmat;
analog: [adj]有长短针的;模拟的; [n]类似物;模拟; [a] /ˈænəlɑːɡ/; [or]gmat;
calorie: [n]卡(热量单位); [a] /ˈkæləri/; [or]gmat;
excrete: [v]排泄,分泌; [a] /ɪkˈskriːt/; [or]gmat;
myopic: [n]近视; [adj]近视的;目光短浅的; [a] /maɪˈɑːpɪk/; [or]gmat;
obstetrical: [adj]产科(学)的,助产的; [a] /əb'stetrɪkl/; [or]gmat;
psychiatric: [adj]精神病的; [a] /ˌsaɪkiˈætrɪk/; [or]gmat;
fluorescent: [adj]荧光的;莹光的; [a] /ˌflɔːˈresnt/; [or]gmat;
syndrome: [n]［医］综合征;一系列表现; [a] /ˈsɪndroʊm/; [or]gmat;
carpal: [n]［解］腕骨; [adj]腕骨的; [a] /ˈkɑːrpl/; [or]gmat;
zing: [n](子弹等的)尖啸声,精力,省略; [v]对.挑剔,发尖啸声; [a] /zɪŋ/; [or]gmat;
paradigm: [n]范例,示范; [a] /ˈpærədaɪm/; [or]gmat;
diva: [n]著名女歌唱家,歌剧女主角; [a] /ˈdiːvə/; [or]gmat;
amnesia: [n][医学]遗忘症; [a] /æmˈniːʒə/; [or]gmat;
underscore: [v]强调,加强,划线于.下; [n]底线; [a] /ˌʌndərˈskɔːr/; [or]gmat;
toddler: [n]蹒跚而行的人,学步小孩; [a] /ˈtɑːdlər/; [or]gmat;
provenance: [n]出处,起源; [a] /ˈprɑːvənəns/; [or]gmat;
posit: [v]假定; [n]安置;论断; [a] /ˈpɑːzɪt/; [or]gmat;
potpourri: [n]百花香,杂物,杂曲,杂文集; [a] /ˌpoʊpʊˈriː/; [or]gmat;
detergent: [n]洗涤剂,清洁剂; [a] /dɪˈtɜːrdʒənt/; [or]gmat;
leery: [adj]机警的,狡猾的; [a] /ˈlɪri/; [or]gmat;
debilitate: [v]使衰弱; [a] /dɪˈbɪlɪteɪt/; [or]gmat;
windshield: [n]挡风玻璃; [a] /ˈwɪndʃiːld/; [or]gmat;
bureaucrat: [n]官僚,官僚主义者; [a] /ˈbjʊrəkræt/; [or]gmat;
ecology: [n]生态,生态学; [a] /iˈkɑːlədʒi/; [or]gmat;
activate: [v]使活动起来;使开始起作用; [a] /ˈæktɪveɪt/; [or]gmat;
cure-all: [n]万灵药; [a] /ˈkjʊr ɔːl/; [or]gmat;
marijuana: [n]大麻,大麻中的毒质; [a] /ˌmærəˈwɑːnə/; [or]gmat;
ideographic: [adj]表意的,表意文字的; [a] /ˌɪdɪə'græfɪk/; [or]gmat;
hallmark: [n]特点;品质证明; [v]给.盖上品质证明印记;使具有.标志; [a] /ˈhɔːlmɑːrk/; [or]gmat;
takeover: [n]接收,接管,接任;收买; [a] /ˈteɪkoʊvər/; [or]gmat;
statistic: [n]统计;统计数值;统计学; [a] /stəˈtɪstɪk/; [or]gmat;
methodology: [n]方法论,方法学;(某一学科的)一套方法; [a] /ˌmeθəˈdɑːlədʒi/; [or]gmat;
outdistance: [v](指赛跑或竞争中)把..远远抛在后面,大大超越; [a] /ˌaʊtˈdɪstəns/; [or]gmat;
sequential: [adj]连续的;相继的;有顺序的; [n]〈美俚〉按期服食的避孕丸; [a] /sɪˈkwenʃl/; [or]gmat;
Inuit: [n]因纽特人; [adj]因纽特人的; [a] /ˈɪnjuɪt/; [or]gmat;
doctorate: [n]博士头衔; [a] /ˈdɑːktərət/; [or]gmat;
linguistics: [n]语言学; [a] /lɪŋˈɡwɪstɪks/; [or]gmat;
iridium: [n]铱; [a] /ɪˈrɪdiəm/; [or]gmat;
revitalize: [v]使复活,使重新充满活力,使复兴; [a] /ˌriːˈvaɪtəlaɪz/; [or]gmat;
sidestep: [n](侧面)台阶;拳击等横跨一步躲避打击;［喻］回避(困难); [v]回避;横跨一步躲避; [a] /ˈsaɪdstep/; [or]gmat;
hypotenuse: [n](直角三角形的)斜边; [a] /haɪˈpɑːtənuːs/; [or]gmat;
blurry: [adj]模糊的,难辩认的; [a] /ˈblɜːri/; [or]gmat;
jettison: [v]向外抛弃,投弃(船舶遇难时投弃货物以为减轻负载); [n]抛弃的货物; [a] /ˈdʒetɪsn/; [or]gmat;
hypertension: [n]［医］高血压,过度紧张; [a] /ˌhaɪpərˈtenʃn/; [or]gmat;
bisect: [n]对剖邮票; [vi]分开; [vt]把.分切为二,把.二等分;二等分; [a] /baɪˈsekt/; [or]gmat;
desktop: [n]桌面;台式机; [adj]台式的;桌上用的; [a] /ˈdesktɑːp/; [or]gmat;
overlie: [v]躺在..上面,压在..上面,盖得使窒息; [a] /ˌoʊvərˈlaɪ/; [or]gmat;
underwrite: [v]给.保险,承诺支付;同意赔款(海上保险); [a] /ˌʌndərˈraɪt/; [or]gmat;
congruent: [adj]和谐一致的,全等的; [a] /ˈkɑːŋɡruənt/; [or]gmat;
trapezium: [n](英)梯形,(美)不规则四边形; [a] /trəˈpiːziəm/; [or]gmat;
iconography: [n]肖像画法,肖像学,插画,图解; [a] /ˌaɪkəˈnɑːɡrəfi/; [or]gmat;
dichotomy: [n]二分,本质对立; [a] /daɪˈkɑːtəmi/; [or]gmat;
allocate: [v]分配,配给; [a] /ˈæləkeɪt/; [or]gmat;
insecticide: [n]杀虫剂; [a] /ɪnˈsektɪsaɪd/; [or]gmat;
codify: [v]编纂;将..编成法典; [a] /ˈkɑːdɪfaɪ/; [or]gmat;
obsess: [vt]迷住,使着迷,使烦扰; [a] /əbˈses/; [or]gmat;
exacerbate: [v]加重;恶化;激怒; [a] /ɪɡˈzæsərbeɪt/; [or]gmat;
hedonist: [n]享乐主义者,［心］欢乐主义者; [adj]享乐主义者的; [a] /ˈhiːdənɪst/; [or]gmat;
outmoded: [adj]不再流行的,过时的; [a] /ˌaʊtˈmoʊdɪd/; [or]gmat;
parameter: [n]决定因素;界限;参(变)数;参量; [a] /pəˈræmɪtər/; [or]gmat;
bottleneck: [n]瓶颈口,(喻)交通易阻塞的狭口;妨碍生产流程的一环; [v]阻碍;交通堵塞; [adj](街道等)狭隘的; [a] /ˈbɑːtlnek/; [or]gmat;
pollination: [n]授粉; [a] /ˌpɑːləˈneɪʃn/; [or]gmat;
schizophrenia: [n][内科]精神分裂症; [a] /ˌskɪtsəˈfriːniə/; [or]gmat;
spray: [n]浪花;水雾;喷雾; [vi]飞溅,喷; [vt]喷;向..扫射;散布; [a] /spreɪ/; [or]gmat;
erode: [v]腐蚀;遭侵蚀,腐蚀,侵蚀;削弱; [vt]损害; [a] /ɪˈroʊd/; [or]gmat;
divisive: [adj]分裂的;区分的;造成不和的; [a] /dɪˈvaɪsɪv/; [or]gmat;
hypersensitive: [adj]敏感的;很容易生气的;过敏的;超感光度的; [a] /ˌhaɪpərˈsensətɪv/; [or]gmat;
seminar: [n]研究班;研讨会; [a] /ˈsemɪnɑːr/; [or]gmat;
burgeon: [v]发芽,迅速成长; [n]嫩枝; [a] /ˈbɜːrdʒən/; [or]gmat;
chauvinism: [n]沙文主义者,盲目爱国主义; [a] /ˈʃoʊvɪnɪzəm/; [or]gmat;
upturn: [n]情况好转; [v]朝上,向上;翻转; [a] /ˈʌptɜːrn/; [or]gmat;
bummer: [n]懒汉,游手好闲的人; [adj]差劲的; [v]流浪,乞讨; [a] /ˈbʌmər/; [or]gmat;
odometer: [n](汽车的)里程表,[车辆]里程; [a] /oʊˈdɑːmɪtər/; [or]gmat;
demographic: [adj]人口统计学的;人口学的; [a] /ˌdeməˈɡræfɪk/; [or]gmat;
enzyme: [n][生化]酶; [a] /ˈenzaɪm/; [or]gmat;
semiconductor: [n]半导体; [a] /ˌsemikənˈdʌktər/; [or]gmat;
effluent: [n]污水; [adj]流出的; [a] /ˈefluənt/; [or]gmat;
pasta: [n]意大利面食; [a] /ˈpɑːstə/; [or]gmat;
synthesize: [v][化]合成;综合;人工合成; [a] /ˈsɪnθəsaɪz/; [or]gmat;
totalitarian: [n]极权主义者; [adj]极权主义的; [a] /toʊˌtæləˈteriən/; [or]gmat;
additive: [n]添加剂,添加物; [adj]附加的;[数]加法的; [a] /ˈædətɪv/; [or]gmat;
integral: [adj](用于构成整体)必需的,不可缺少的,必不可少的;基本的,作为组成部分的,内置的;整体的,完整的; [a] /ˈɪntɪɡrəl/; [or]gmat;
clockwise: [adj]顺时针方向的; [adv]顺时针方向地; [a] /ˈklɑːkwaɪz/; [or]gmat;
deluxe: [adj]豪华的,华丽的; [a] /dɪˈlʌks/; [or]gmat;
constrict: [v]约束,收缩,妨碍; [a] /kənˈstrɪkt/; [or]gmat;
breakthrough: [n]突破,突破性进展,重要的新发现; [adj]突破性的; [a] /ˈbreɪkθruː/; [or]gmat;
highlight: [vt]使突出,强调,高亮; [n]最精彩的部分,最重要的事件; [a] /ˈhaɪlaɪt/; [or]gmat;
eggnog: [n]蛋奶酒; [a] /ˈeɡnɑːɡ/; [or]gmat;
cartographer: [n]制图师;地图制作者; [a] /kɑːrˈtɑːɡrəfər/; [or]gmat;
catalyst: [n]催化剂;造成变化的人或事; [a] /ˈkætəlɪst/; [or]gmat;
reactor: [n]［原］反应堆; [a] /riˈæktər/; [or]gmat;
artifact: [n]人工制品;手工艺品; [a] /ˈɑːrtɪfækt/; [or]gmat;
malfunction: [v]发生故障;不起作用; [n]故障;失灵;疾病; [a] /ˌmælˈfʌŋkʃn/; [or]gmat;
rehash: [v]重讲,重新处理; [n]改头换面地作品; [a] /ˈriːhæʃ/; [or]gmat;
paleontologist: [n]古生物学家; [a] /ˌpelɪɑn'tɑlədʒɪst/; [or]gmat;
abscissa: [n]横座标,横线; [a] /æbˈsɪsə/; [or]gmat;
forebear: [n]祖先,祖宗; [v]忍住; [a] /ˈfɔːrber/; [or]gmat;
proponent: [n]支持者;提议者;主张者;提出认证遗嘱者; [adj]建议的;支持的;辩护的; [a] /prəˈpoʊnənt/; [or]gmat;
racist: [n]种族主义者; [adj]种族主义的; [a] /ˈreɪsɪst/; [or]gmat;
plywood: [n]胶合板,层压木板; [a] /ˈplaɪwʊd/; [or]gmat;
lionize: [v]崇拜,把..奉为名人; [a] /ˈlaɪənaɪz/; [or]gmat;
hemoglobin: [n]［生化］血红蛋白; [a] /ˌhiːmə'gloʊbɪn/; [or]gmat;
envision: [v]预测,想象,展望; [a] /ɪnˈvɪʒn/; [or]gmat;
profitability: [n]赢利能力;收益性;利益率; [a] /ˌprɑːfɪtəˈbɪləti/; [or]gmat;
archenemy: [n]天敌,主要敌人; [a] /'ɑːtʃ'enəmɪ/; [or]gmat;
semiotic: [n]［哲］符号学; [adj]症状的,符号学的,记号语言的; [a] /ˌsemiˈɑːtɪk/; [or]gmat;
nylon: [n]尼龙,尼龙长袜; [a] /ˈnaɪlɑːn/; [or]gmat;
benchmark: [n]基准;标准检查程序; [v]用基准问题测试(计算机系统等); [a] /ˈbentʃmɑːrk/; [or]gmat;
jumbo: [adj]巨大的,特大的; [n]体大而笨拙的人或物;大型喷气式客机;庞然大物; [a] /ˈdʒʌmboʊ/; [or]gmat;
zoom: [v](镜头)拉近(拉远);急速上升,嗡嗡作响; [n]车辆疾驰的声音,嗡嗡声,(摄影)变焦; [a] /zuːm/; [or]gmat;
holistic: [adj]整体的;全盘的; [a] /hoʊˈlɪstɪk/; [or]gmat;
luminescence: [n]发光; [a] /ˌluːmɪˈnesns/; [or]gmat;
antebellum: [adj](美国南北)战争前的; [a] /ˌæntiˈbeləm/; [or]gmat;
zoning: [n]分区制,都市的区域划分; [a] /ˈzoʊnɪŋ/; [or]gmat;
encode: [v]把(电文等)译成电码(或密码),编码; [a] /ɪnˈkoʊd/; [or]gmat;
infrared: [adj]红外线的; [n]红外线; [a] /ˌɪnfrəˈred/; [or]gmat;
stockpile: [n]储备; [v]储备,贮存; [a] /ˈstɑːkpaɪl/; [or]gmat;
termite: [n]白蚁; [a] /ˈtɜːrmaɪt/; [or]gmat;
hepatitis: [n]肝炎; [a] /ˌhepəˈtaɪtɪs/; [or]gmat;
escalate: [v]逐步升高,逐步增强,加剧恶化; [a] /ˈeskəleɪt/; [or]gmat;
backdrop: [n]背景幕;(事件的)背景; [a] /ˈbækdrɑːp/; [or]gmat;
revamp: [v]翻新,整修,升级; [n]改进,换新鞋面; [a] /ˈriːvæmp/; [or]gmat;
analgesic: [n]镇痛药; [adj]止痛的; [a] /ˌænəlˈdʒiːzɪk/; [or]gmat;
realtor: [n]房地产经纪人; [a] /ˈriːəltər/; [or]gmat;
gynecologist: [n]妇科医生; [a] /ˌgaɪnə'kɒlədʒɪst/; [or]gmat;
ersatz: [adj]代用的,人造的,合成的; [n]代用品,仿制品; [a] /ˈersɑːts/; [or]gmat;
corny: [adj]谷类的,乡下味的,粗野的,有鸡眼的; [a] /ˈkɔːrni/; [or]gmat;
proton: [n]质子; [a] /ˈproʊtɑːn/; [or]gmat;
xenophobia: [n]仇外,对外国人的恐惧或憎恨; [a] /ˌzenəˈfoʊbiə/; [or]gmat;
airborne: [adj]空运的;在空中的; [a] /ˈerbɔːrn/; [or]gmat;
proliferate: [v]激增,繁殖,增殖; [a] /prəˈlɪfəreɪt/; [or]gmat;
ingest: [v]咽下;摄取;吸收;接待; [a] /ɪnˈdʒest/; [or]gmat;
ecosystem: [n]生态系统; [a] /ˈiːkoʊsɪstəm/; [or]gmat;
diesel: [n]内燃机,柴油机; [a] /ˈdiːzl/; [or]gmat;
denigrate: [v]抹黑,贬低; [a] /ˈdenɪɡreɪt/; [or]gmat;
smog: [n]烟雾; [a] /smɑːɡ/; [or]gmat;
ambivalent: [adj]矛盾的;摇摆不定的;好恶相克的; [n]两性人; [a] /æmˈbɪvələnt/; [or]gmat;
leukemia: [n][医]白血病; [a] /luː'kiːmɪə/; [or]gmat;
symbiotic: [adj][生态]共栖的;共生的; [a] /ˌsɪmbaɪˈɑːtɪk/; [or]gmat;
predator: [n]掠夺者,食肉动物; [a] /ˈpredətər/; [or]gmat;
alumna: [n]女毕业生,女校友; [a] /əˈlʌmnə/; [or]gmat;
hamster: [n](动)仓鼠; [a] /ˈhæmstər/; [or]gmat;
vinyl: [n]［化］乙烯基,塑料; [a] /ˈvaɪnl/; [or]gmat;
aerobic: [adj]需氧的;有氧健身法的; [a] /eˈroʊbɪk/; [or]gmat;
ethnicity: [n]种族,种族地位,种族特点; [a] /eθˈnɪsəti/; [or]gmat;
macaque: [n]猕猴,恒河猴,短尾猴; [a] /məˈkæk/; [or]gmat;
horrendous: [adj]可怕的,令人惊惧的; [a] /həˈrendəs/; [or]gmat;
pesticide: [n]杀虫剂;农药; [a] /ˈpestɪsaɪd/; [or]gmat;
provision: [n](法律等)条款;供应;预备,存粮;必需品; [v]为..提供必需品; [a] /prəˈvɪʒn/; [or]gmat;
ambivalence: [n]矛盾心理; [a] /æmˈbɪvələns/; [or]gmat;
burglarize: [v]进行夜盗; [a] /'bɜːɡləraɪz/; [or]gmat;
cholesterol: [n]胆固醇; [a] /kəˈlestərɔːl/; [or]gmat;
hypothesize: [v]假设,假定; [a] /haɪˈpɑːθəsaɪz/; [or]gmat;
bylaw: [n]地方法规; [a] /'baɪˌlɔː/; [or]gmat;
insulin: [n]胰岛素; [a] /ˈɪnsəlɪn/; [or]gmat;
neutron: [n]中子; [a] /ˈnuːtrɑːn/; [or]gmat;
allergy: [n]过敏症,厌恶; [a] /ˈælərdʒi/; [or]gmat;
customize: [v]定制,定做;按规格改制;定制,定做;依照指定的规格制造; [a] /ˈkʌstəmaɪz/; [or]gmat;
dehydrate: [v]除去水份,脱水; [a] /diːˈhaɪdreɪt/; [or]gmat;
transistor: [n]晶体管;半导体收音机; [a] /trænˈzɪstər/; [or]gmat;
replicate: [v]复制;重复,反复; [a] /ˈreplɪkeɪt/; [or]gmat;
dopamine: [n]［生化］多巴胺; [a] /ˈdoʊpəmiːn/; [or]gmat;
juxtapose: [v]使并排;使并置;使并列; [a] /ˌdʒʌkstəˈpoʊz/; [or]gmat;
upsurge: [n]高潮,高涨; [a] /ˈʌpsɜːrdʒ/; [or]gmat;
apolitical: [adj]不问政治的; [a] /ˌeɪpəˈlɪtɪkl/; [or]gmat;
bicentenary: [adj]二百年的; [n]二百周年纪念; [a] /ˌbaɪsenˈtenəri/; [or]gmat;
isotope: [n]同位素; [a] /ˈaɪsətoʊp/; [or]gmat;
sibling: [n]兄弟姊妹;同胞;(生物)同科,同属; [a] /ˈsɪblɪŋ/; [or]gmat;
polygraph: [n]复写仪,测谎器,多产作家; [vi]用测谎仪测出结果; [vt]用测谎仪测试(某人); [a] /ˈpɑːliɡræf/; [or]gmat;
blackout: [n]断电; [adj]防空袭的; [a] /ˈblækaʊt/; [or]gmat;
pollinate: [vt]传花粉给.; [a] /ˈpɑːləneɪt/; [or]gmat;
sinusitis: [n][医]窦炎; [a] /ˌsaɪnəˈsaɪtɪs/; [or]gmat;
antibiotic: [n]抗生素; [adj]抗菌的; [a] /ˌæntibaɪˈɑːtɪk/; [or]gmat;
extraterrestrial: [adj]地球外的,地球大气圈外的; [n]外星人,外星生物,宇航员; [a] /ˌekstrətəˈrestriəl/; [or]gmat;
intracellular: [adj]细胞内部的; [a] /ˌɪntrə'seljələ/; [or]gmat;
gimmick: [n]吸引人的花招,噱头; [vt]用暗机关改变或影响; [a] /ˈɡɪmɪk/; [or]gmat;
radon: [n]［化］氡; [a] /ˈreɪdɑːn/; [or]gmat;
choreography: [n]编舞艺术;舞蹈编排;舞蹈编排; [a] /ˌkɔːriˈɑːɡrəfi/; [or]gmat;
portage: [n]搬运,运输线路; [v]转到陆上运输,运输; [a] /ˈpɔːrtɪdʒ/; [or]gmat;
odd number: [phr]奇数; [a] /ɑd ˈnʌmbər/; [or]gmat;
off-the-shelf: [adj](货品)现成常备的,非定制的; [adv]现成地,无需作重大修改地; [a] /ˌɔːf ðə ˈʃelf/; [or]gmat;
enthusiastically: [adv]热心地;满腔热情地; [a] /ɪnˌθuːziˈæstɪkli/; [or]gmat;
organelle: [n]［生］细胞器; [a] /ˌɔːgə'nel/; [or]gmat;
correlate: [v](使)相关联; [n]相关物; [a] /ˈkɔːrələt/; [or]gmat;
hieroglyphic: [adj]象形文字的; [n]象形文字,象形文字写成的文章; [a] /ˌhaɪərəˈɡlɪfɪk/; [or]gmat;
amino acid: [n]［生］氨基酸; [a] /əˌmiːnoʊ ˈæsɪd/; [or]gmat;
neologism: [n]新生词; [a] /niˈɑːlədʒɪzəm/; [or]gmat;
neonate: [n]初生婴儿; [a] /ˈniːoʊneɪt/; [or]gmat;
inextricably: [adv]无法摆脱地; [a] /ˌɪnɪkˈstrɪkəbli/; [or]gmat;
extradite: [v]引渡,获取.的引渡; [a] /ˈekstrədaɪt/; [or]gmat;
equilateral triangle: [phr]等边三角形; [a] /ˌiːkwɪˌlætərəl ˈtraɪæŋɡl/; [or]gmat;
anopheles: [n](动)疟蚊属; [a] /ə'nɒfəˌlɪz/; [or]gmat;
infirmary: [n]医院,医务室(尤指学校等附设的病房或配药处); [a] /ɪnˈfɜːrməri/; [or]gmat;
transfer: [v]转移;调任;换乘;转变;改编; [n]转让;转移;调任;汇兑; [a] /trænsˈfɜːr/; [or]gmat;
defrost: [v]除霜,解冻; [a] /ˌdiːˈfrɔːst/; [or]gmat;
compensatory: [adj]补偿的,赔偿的; [a] /kəmˈpensətɔːri/; [or]gmat;
hominid: [n]原始人类;人科动物; [a] /ˈhɑːmɪnɪd/; [or]gmat;
misrepresent: [vi]作虚假陈述; [vt]歪曲;误传; [a] /ˌmɪsˌreprɪˈzent/; [or]gmat;
unison: [n]一致,(音)齐唱; [adj]同音的; [a] /ˈjuːnɪsn/; [or]gmat;
real estate: [n]不动产,房地产; [a] /ˈriːəl əsteɪt/; [or]gmat;
roller coaster: [n]过山车; [a] /ˈroʊlər koʊstər/; [or]gmat;
overuse: [n]过度的使用; [vt]使用.过度;使用.过多; [a] /ˌoʊvərˈjuːs/; [or]gmat;
antifreeze: [n]抗冻剂; [a] /ˈæntifriːz/; [or]gmat;
antipode: [n]恰恰相反的事物(of,to),相对极,对极; [a] /'æntɪˌpoʊd/; [or]gmat;
palatability: [n]可口性,风味; [a] /'pælətəbəlɪtɪ/; [or]gmat;
eventual: [adj]最后的,终于的; [a] /ɪˈventʃuəl/; [or]gmat;
antipsychotic: [adj]抑制精神的; [n]安定药; [a] /ˌæntɪsaɪˈkɒtɪk/; [or]gmat;
antitrust law: [phr]反托拉斯法; [a] /ˌæntiˈtrʌst lɔ/; [or]gmat;
aperiodic: [adj]非周期的; [a] /ˌeɪpɪrɪ'ɒdɪk/; [or]gmat;
divergence: [n]分歧;背离; [a] /daɪˈvɜːrdʒəns/; [or]gmat;
paranormal: [adj]超自然的,异常的; [n]超常事件(或话题); [a] /ˌpærəˈnɔːrml/; [or]gmat;
excavate: [v]挖掘,挖出;挖(空),挖(洞); [a] /ˈekskəveɪt/; [or]gmat;
imposition: [n]征收;强加;欺骗;不公平的负担; [a] /ˌɪmpəˈzɪʃn/; [or]gmat;
parapsychology: [n]灵学;超心理学; [a] /ˌpærəsaɪˈkɑːlədʒi/; [or]gmat;
spherule: [n]小球(体); [a] /'sfeəuːl/; [or]gmat;
slowdown: [n]减速,减退;怠工; [a] /ˈsloʊdaʊn/; [or]gmat;
decay: [v]腐烂;衰退;腐朽; [n]腐烂;衰退;腐败; [a] /dɪˈkeɪ/; [or]gmat;
at stake: [phr]存亡攸关,处于危险中; [a] /ət steɪk/; [or]gmat;
centrifugal: [adj]离心的;远中的; [n]离心机; [a] /ˌsentrɪˈfjuːɡl/; [or]gmat;
per capita: [phr]人均; [a] /pər ˈkæpɪtə/; [or]gmat;
categorical: [adj]绝对的;直接了当的;无条件的;属于某一范畴的; [a] /ˌkætəˈɡɔːrɪkl/; [or]gmat;
interdependence: [n]互相依赖; [a] /ˌɪntərdɪˈpendəns/; [or]gmat;
quarantine: [v]检疫;隔离;使隔离; [n]检疫;隔离;检疫期;封锁; [a] /ˈkwɔːrəntiːn/; [or]gmat;
causative: [adj]成为原因的,引起.的; [n]使役动词; [a] /ˈkɔːzətɪv/; [or]gmat;
laxity: [n]松弛,放纵; [a] /ˈlæksəti/; [or]gmat;
better off: [adj]境况(尤指经济境况)较好; [a] /ˈbetər ɑf/; [or]gmat;
rationality: [n]合理性,合理的行动; [a] /ˌræʃəˈnæləti/; [or]gmat;
psychopath: [n]精神变态者; [a] /ˈsaɪkəpæθ/; [or]gmat;
prospectus: [n]章程,内容简介;样张;创办计划书; [a] /prəˈspektəs/; [or]gmat;
biota: [n]生物区系; [a] /baɪ'oʊtə/; [or]gmat;
ostentation: [n]卖弄,炫耀; [a] /ˌɑːstenˈteɪʃn/; [or]gmat;
bipedalism: [n]二足类; [a] /'baɪpedlɪzəm/; [or]gmat;
reconvene: [v]重新集合,重新召集; [a] /ˌriːkənˈviːn/; [or]gmat;
inverted: [adj]反向的,倒转的,倒置,颠倒; [a] /ɪnˈvɜːrtɪd/; [or]gmat;
blind spot: [n]［物］盲点,［无］静区,(驾驶车辆等视力以外的)盲区; [a] /ˈblaɪnd spɑːt/; [or]gmat;
bona fides: [n]［拉］诚意,善意; [a] /ˌboʊnə ˈfaɪdiːz/; [or]gmat;
cramped: [adj]狭窄的,挤在一起的; [a] /kræmpt/; [or]gmat;
unparalleled: [adj]无比的,无双的,空前的; [a] /ʌnˈpærəleld/; [or]gmat;
meteorologist: [n]气象学者; [a] /ˌmiːtiəˈrɑːlədʒɪst/; [or]gmat;
prior to: [phr]在..之前; [a] /ˈpraɪr tu/; [or]gmat;
buttress: [n]扶墙,拱壁; [v]支持; [a] /ˈbʌtrəs/; [or]gmat;
prone to: [phr]易于..的; [a] /proʊn tu/; [or]gmat;
side effect: [phr]副作用; [a] /ˈsaɪd ɪfekt/; [or]gmat;
novocaine: [n]奴佛卜因(一种麻醉药); [a] /ˈnoʊvəkeɪn/; [or]gmat;
far-reaching: [adj]深远的;广泛的;伸至远处的; [a] /ˌfɑːr ˈriːtʃɪŋ/; [or]gmat;
rule of thumb: [n]单凭经验的做法;经验法则; [a] /rul ɑv θʌm/; [or]gmat;
unsubstantiated: [adj]未经证实的,无事实根据的; [a] /ˌʌnsəbˈstænʃieɪtɪd/; [or]gmat;
peninsula: [n]半岛; [a] /pəˈnɪnsələ/; [or]gmat;
embroider: [v]刺绣,绣花;润色,渲染; [a] /ɪmˈbrɔɪdər/; [or]gmat;
psychoactive: [adj](药剂)对神经起显著(或特殊)作用的; [a] /ˌsaɪkoʊˈæktɪv/; [or]gmat;
prejudicial: [adj]有害的,引起偏见的; [a] /ˌpredʒuˈdɪʃl/; [or]gmat;
caries: [n]［拉］［医］龋,骨疡; [a] /ˈkeriːz/; [or]gmat;
resurgence: [n]复活;再现;再起; [a] /rɪˈsɜːrdʒəns/; [or]gmat;
dispassionate: [adj]平心静气的,不带感情的; [a] /dɪsˈpæʃənət/; [or]gmat;
pupation: [n]［动］化蛹; [a] /pjʊ'peɪʃn/; [or]gmat;
photosynthesis: [n]光合作用; [a] /ˌfoʊtoʊˈsɪnθəsɪs/; [or]gmat;
herbicide: [n][农药]除草剂; [a] /ˈɜːrbɪsaɪd/; [or]gmat;
landfill: [n]垃圾堆; [vt]在垃圾填埋地上处理; [a] /ˈlændfɪl/; [or]gmat;
hedge: [v]防范,规避;避免直接答复,避免直接回答;围住;用树篱围起; [n]篱笆,树篱;保障; [a] /hedʒ/; [or]gmat;
quasar: [n](天)类星体; [a] /ˈkweɪzɑːr/; [or]gmat;
substantiate: [v]证实;使实体化; [a] /səbˈstænʃieɪt/; [or]gmat;
chordate: [n]脊索动; [adj][动]脊索动物的; [a] /'kɔːˌdeɪt/; [or]gmat;
subsidy: [n]补助金,津贴; [a] /ˈsʌbsədi/; [or]gmat;
urbanize: [v]使都市化;使文雅; [a] /'ɜːbənˌaɪz/; [or]gmat;
circadian: [adj]［生］生理节奏的;以24小时为周期的; [a] /sɜːrˈkeɪdiən/; [or]gmat;
lipid: [n]脂质,油脂; [a] /ˈlɪpɪd/; [or]gmat;
climatologist: [n]气候学家; [a] /ˌklaɪməˈtɑːlədʒist/; [or]gmat;
tartan: [n]单桅三角帆船,格子花,格子织物; [adj]格子花呢的; [a] /ˈtɑːrtn/; [or]gmat;
closed-circuit television: [n]闭路电视; [a] /ˌkloʊzd ˌsɜːrkɪt ˈtelɪvɪʒn/; [or]gmat;
counterclockwise: [adv]逆时针方向; [adj]逆时针方向的,自右向左的; [a] /ˌkaʊntərˈklɑːkwaɪz/; [or]gmat;
coleslaw: [n]凉拌卷心菜丝; [a] /ˈkoʊlslɔː/; [or]gmat;
contaminant: [n]污染物,致污物; [a] /kənˈtæmɪnənt/; [or]gmat;
resuscitation: [n]复活,苏醒; [a] /rɪˌsʌsɪˈteɪʃn/; [or]gmat;
surcharge: [n]额外费用,过高的要价; [v]追加罚款;使.装载过多;使.负担过重; [a] /ˈsɜːrtʃɑːrdʒ/; [or]gmat;
eusocial: [adj](昆虫)完全社会性的,完全群居的; [a] /juː'soʊʃəl/; [or]gmat;
composite number: [phr]合成数,合数; [a] /kəmˈpɑːzət ˈnʌmbər/; [or]gmat;
put away: [phr]放好;把.收起来;储存; [a] /pʊt əˈweɪ/; [or]gmat;
invalidate: [v]使无效;使无价值; [a] /ɪnˈvælɪdeɪt/; [or]gmat;
compound interest: [phr]复利; [a] /ˌkɑːmpaʊnd ˈɪntrəst/; [or]gmat;
concentric circle: [phr]同心圆; [a] /kənˈsentrɪk ˈsɜːrkl/; [or]gmat;
rheumatoid: [adj]风湿病的,类风湿病的; [a] /'ruːməˌtɔɪd/; [or]gmat;
right angle: [phr]直角; [a] /ˈraɪt æŋɡl/; [or]gmat;
rhinovirus: [n]鼻病毒; [a] /ˌraɪnoʊ'vaɪrəs/; [or]gmat;
authentic: [adj]真实的;真正的;可靠的; [a] /ɔːˈθentɪk/; [or]gmat;
indulge: [v]沉迷于;放纵;满足; [a] /ɪnˈdʌldʒ/; [or]gmat;
speak out: [phr]大胆地说,清楚和响亮地说; [a] /spik aʊt/; [or]gmat;
denominator: [n][数]分母; [a] /dɪˈnɑːmɪneɪtər/; [or]gmat;
rough-hewn: [adj]粗凿成的,粗削的(石头,木材),毛坯的,草拟的; [a] /ˌrʌf ˈhjuːn/; [or]gmat;
automation: [n]自动化; [a] /ˌɔːtəˈmeɪʃn/; [or]gmat;
preferential: [adj]优先的;选择的;特惠的; [a] /ˌprefəˈrenʃl/; [or]gmat;
epicenter: [n]震中,中心,集中点; [a] /'epɪˌsentə/; [or]gmat;
cornstalk: [n]玉米秆; [a] /'kɔːnˌstɔːk/; [or]gmat;
sale price: [n]特价,廉价; [a] /seɪl praɪs/; [or]gmat;
antibiotics: [n]抗生素; [a] /ˌæntɪbaɪ'ɒtɪks/; [or]gmat;
assembly line: [n]装配线(生产上一环接一环的),流水线; [a] /əˈsembli laɪn/; [or]gmat;
fretful: [adj]烦躁的,焦躁的,(水面)起波纹的; [a] /ˈfretfl/; [or]gmat;
critique: [n]批评;评论文章; [v]批判,评论;评论; [a] /krɪˈtiːk/; [or]gmat;
overtone: [n][声]泛音,暗示,弦外之音; [v][摄]使曝光过度; [a] /ˈoʊvərtoʊn/; [or]gmat;
sermonize: [v]说教,讲道; [a] /ˈsɜːrmənaɪz/; [or]gmat;
antibody: [n][免疫]抗体; [a] /ˈæntibɑːdi/; [or]gmat;
daylight saving time: [phr]夏时制; [a] /ˌdeɪlaɪt ˈseɪvɪŋ taɪm/; [or]gmat;
shoplifting: [n]冒充顾客进商店行窃; [a] /ˈʃɑːplɪftɪŋ/; [or]gmat;
bombardment: [n]炮轰; [a] /bɑːmˈbɑːrdmənt/; [or]gmat;
impressionable: [adj]敏感的;易受影响的; [a] /ɪmˈpreʃənəbl/; [or]gmat;
shortfall: [n]不足,亏空; [a] /ˈʃɔːrtfɔːl/; [or]gmat;
exhaustive: [adj]详尽的;彻底的;消耗的; [a] /ɪɡˈzɔːstɪv/; [or]gmat;
shut off: [phr]关掉(煤气等),切断,使隔绝,脱离; [a] /ʃʌt ɑf/; [or]gmat;
simple interest: [phr]单利; [a] /ˌsɪmpl ˈɪntrəst/; [or]gmat;
desegregation: [n]取消种族隔离; [a] /ˌdiːˌseɡrɪˈɡeɪʃn/; [or]gmat;
authenticate: [v]鉴定;证明.是真实的; [a] /ɔːˈθentɪkeɪt/; [or]gmat;
sporadically: [adv]偶尔; [a] /spəˈrædɪkli/; [or]gmat;
die out: [phr]灭绝,绝种; [a] /daɪ aʊt/; [or]gmat;
spillover: [n]溢出(量);外流人口(大城市容纳不下的); [a] /ˈspɪloʊvər/; [or]gmat;
predominate: [v]居支配地位;主宰;在.中占优势; [a] /prɪˈdɑːmɪneɪt/; [or]gmat;
statutory: [adj]法定的;法令的;可依法惩处的; [a] /ˈstætʃətɔːri/; [or]gmat;
bring about: [phr]导致,引起; [a] /brɪŋ əˈbaʊt/; [or]gmat;
proportion: [n]比例;部分;相称; [v]使成比例;分配; [a] /prəˈpɔːrʃn/; [or]gmat;
status quo: [n]［拉］现状; [a] /ˌsteɪtəs ˈkwoʊ/; [or]gmat;
preponderance: [n]优势;多数;占优势; [a] /prɪˈpɑːndərəns/; [or]gmat;
streptomycin: [n]［药］链霉素; [a] /ˌstreptə'maɪsɪn/; [or]gmat;
dogwood: [n]木属植物,山茱萸; [adj]山茱萸科植物的,淡黄褐色的; [a] /ˈdɔːɡwʊd/; [or]gmat;
stamina: [n]耐力,持久力; [a] /ˈstæmɪnə/; [or]gmat;
wedge-shaped: [adj]楔形的;v字形的; [a] /'wedʒˌʃeɪpt/; [or]gmat;
prudery: [n]过分拘谨,假正经; [a] /ˈpruːdəri/; [or]gmat;
technocrat: [n]技术人员,技术统治; [a] /ˈteknəkræt/; [or]gmat;
strep throat: [n]［医］脓毒性咽喉炎; [a] /ˌstrep ˈθroʊt/; [or]gmat;
stumbling block: [n]障碍物,绊脚石; [a] /ˈstʌmblɪŋ blɑːk/; [or]gmat;
fanatic: [n]狂热者,盲信者; [adj]狂热的,入迷的,盲信的; [a] /fəˈnætɪk/; [or]gmat;
credo: [n]信条,教义; [a] /ˈkriːdoʊ/; [or]gmat;
subcontract: [n]转包合同,分包合同; [v]承作,转包; [a] /ˌsʌbˈkɑːntrækt/; [or]gmat;
cash in on: [v]以.获利,营利; [a] /kæʃ ɪn ɔn/; [or]gmat;
analytic(al): [adj]分析的;分解的; [a] /ˌænə'lɪtɪkl/; [or]gmat;
wingspan: [n]翼展(相当wingspread); [a] /ˈwɪŋspæn/; [or]gmat;
suppressant: [n]抑制药; [adj]制止的,抑制性的,遏抑的; [a] /səˈpresnt/; [or]gmat;
stake: [n]木桩;赌注;利害关系;股份,股本;(赛马)奖金; [v]下注,以桩来支撑; [a] /steɪk/; [or]gmat;
deploy: [v]部署,设置;展开,散开; [a] /dɪˈplɔɪ/; [or]gmat;
extracurricular: [adj]课外的,业余的,婚外的; [a] /ˌekstrəkə'rɪkjələ/; [or]gmat;
progression: [n]前进;连续; [a] /prəˈɡreʃn/; [or]gmat;
entrant: [n]进入者,新成员,参加竞赛者; [a] /ˈentrənt/; [or]gmat;
take issue: [v]就某事与某人争论; [a] /teɪk ˈɪʃu/; [or]gmat;
acreage: [n]面积,英亩数; [a] /ˈeɪkərɪdʒ/; [or]gmat;
take issue with: quant. 与...争论;对...提出异议; [a] /teɪk ˈɪʃu wɪθ/; [or]gmat;
take over: [phr]接收,接管,接任,夺取; [a] /teɪk ˈoʊvər/; [or]gmat;
take precedence over: [phr]优先于..,地位在..之上; [a] /teɪk ˈpresɪdəns ˈoʊvər/; [or]gmat;
automate: [v]使自动化,自动操作; [a] /ˈɔːtəmeɪt/; [or]gmat;
inventory: [n]详细目录;存货清单; [a] /ˈɪnvəntɔːri/; [or]gmat;
intestinal: [adj]肠的; [a] /ɪnˈtestɪnl/; [or]gmat;
canvas: [n]帆布,(帆布)油画; [a] /ˈkænvəs/; [or]gmat;
euphoria: [n]幸福愉快感; [a] /juːˈfɔːriə/; [or]gmat;
passbook: [n]存折; [a] /ˈpæsbʊk/; [or]gmat;
tortillas: [n](墨西哥人用以代替面包的)未经发酵的玉米饼; [a] /tɔ'tijəz/; [or]gmat;
trade off: [v]交替换位,通过交换抛掉,权衡; [a] /treɪd ɑf/; [or]gmat;
ration: [n]定量配给; [v]配给;定量供应; [a] /ˈræʃn/; [or]gmat;
fava: [n]蚕豆; [a] /'fɑːvə/; [or]gmat;
traitorous: [adj]叛徒的,不忠的,卖国贼的,奸诈的; [a] /ˈtreɪtərəs/; [or]gmat;
ironically: [adv]讽刺地;出乎意料地; [a] /aɪˈrɑːnɪkli/; [or]gmat;
storefront: [n]店面; [adj]临街的; [a] /ˈstɔːrfrʌnt/; [or]gmat;
deterrent: [n]威慑物; [v]威慑的; [a] /dɪˈtɜːrənt/; [or]gmat;
give way to: [phr]让位于..;让路; [a] /ɡɪv weɪ tu/; [or]gmat;
encapsulate: [v]装入胶囊,压缩;概述; [a] /ɪnˈkæpsjuleɪt/; [or]gmat;
ethnocentric: [adj]种族中心主义的,种族(或民族)优越感的; [a] /ˌeθnoʊˈsentrɪk/; [or]gmat;
turn down: [phr]拒绝;调低;关小; [a] /tɜrn daʊn/; [or]gmat;
malady: [n]疾病,弊病; [a] /ˈmælədi/; [or]gmat;
devoid: [adj]全无的,缺乏的; [a] /dɪˈvɔɪd/; [or]gmat;
updrafts: [n]向上排气,通风; [a] /ˈəpˌdræfts/; [or]gmat;
predation: [n]捕食;掠夺,抢夺;捕食动物的方法; [a] /prɪˈdeɪʃn/; [or]gmat;
free market: [n]［经］自由竞争的市场; [a] /ˌfriː ˈmɑːrkɪt/; [or]gmat;
valance: [n]窗帘上部的框架,帷幔,挂布; [a] /ˈvæləns/; [or]gmat;
freestanding: [adj]［建］独立式的; [a] /'friː'stændɪŋ/; [or]gmat;
disorient: [v]使迷失方位,使迷惑; [a] /dɪs'ɔːrient/; [or]gmat;
boardinghouse: [n]公寓;供膳食的寄宿处; [a] /'boʊrdɪŋˌhaʊs/; [or]gmat;
school: [n]学校;学院;流派;(鱼,海豚的)一群; [v]教育; [a] /skuːl/; [or]gmat;
gingivitis: [n]［医］(齿)龈炎; [a] /ˌdʒɪndʒɪˈvaɪtəs/; [or]gmat;
give rise to: [phr]引起,发生; [a] /ɡɪv raɪz tu/; [or]gmat;
Wall Street: [n]华尔街(美金融业集中之地); [a] /ˈwɔːl striːt/; [or]gmat;
dilution: [n]稀释;冲淡;稀释法; [a] /daɪˈluːʃn/; [or]gmat;
rancher: [n]牧场经营者; [a] /ˈræntʃər/; [or]gmat;
graveside: [n]坟墓边; [adj]在墓旁的;在墓旁发生的; [a] /'greɪvˌsaɪd/; [or]gmat;
whole number: [phr]整数; [a] /ˌhoʊl ˈnʌmbər/; [or]gmat;
hadron: [n]［物］强子(一种基本粒子); [a] /'hædrən/; [or]gmat;
willy-nilly: [adj]犹豫不决的,不容分辨的,随意的; [adv]乱七八糟地,不管愿不愿意地; [a] /ˌwɪli ˈnɪli/; [or]gmat;
aerosol: [n]烟雾,［化］气溶,烟雾剂; [adj]喷雾的,喷雾器的; [a] /ˈerəsɔːl/; [or]gmat;
wristband: [n](衬衫等的)袖口,腕套,手表带; [a] /ˈrɪstbænd/; [or]gmat;
radius: [n]半径;范围; [a] /ˈreɪdiəs/; [or]gmat;
hatchback: [n]［美］有可向上开启天窗的汽车背部; [a] /ˈhætʃbæk/; [or]gmat;
unwarranted: [adj]未经保证的,无根据的,不合适的; [a] /ʌnˈwɔːrəntɪd/; [or]gmat;
get by: [v]侥幸躲过,勉强生活; [a] /ɡet baɪ/; [or]gmat;
liquidation: [n](公司等的)清理,清算,(债务的)清偿,了结; [v]破坏,毁灭,杀掉; [a] /ˌlɪkwɪˈdeɪʃn/; [or]gmat;
assemble: [v]装配(机器等);集合;召集; [a] /əˈsembl/; [or]gmat;
depletion: [n]消耗,损耗,放血; [a] /dɪˈpliːʃn/; [or]gmat;
briny: [n]海洋; [adj]很咸的,海水的; [a] /ˈbraɪni/; [or]gmat;
predisposition: [n]倾向;素质;易染病体质; [a] /ˌpriːdɪspəˈzɪʃn/; [or]gmat;
basketry: [n](篮,篓,筐等的)编织术,(总称)(篮子等)编织物; [a] /'bɑskɪtrɪ/; [or]gmat;
reminiscence: [n]回忆,怀旧,引起联想的相似事物; [a] /ˌremɪˈnɪsns/; [or]gmat;
dysfunction: [n]功能紊乱,机能障碍,官能不良; [v]功能失调,出现机能障碍,垮掉; [a] /dɪsˈfʌŋkʃn/; [or]gmat;
dentition: [n]长牙齿,牙列; [a] /denˈtɪʃn/; [or]gmat;
ibuprofen: [n]布洛芬(镇痛药); [a] /ˌaɪbjuːˈproʊfen/; [or]gmat;
idioglossia: [n]自解语症(只有自己懂的语言),自语症; [a] /ɪdɪə'glɔːsɪə/; [or]gmat;
delusion: [n]错觉; [a] /dɪˈluːʒn/; [or]gmat;
receptive: [adj]善于接受的;能容纳的; [a] /rɪˈseptɪv/; [or]gmat;
receptor: [n]感觉器官;感受器;受体;接受器;受体;接受器; [a] /rɪˈseptər/; [or]gmat;
immunological: [adj]［医］免疫学的; [a] /ˌɪmjunəˈlɑːdʒɪkl/; [or]gmat;
in full bloom: [phr]全盛时期; [a] /ɪn fʊl blum/; [or]gmat;
get through: [v]完成;穿过;(成功)渡过(困难时期);打通(电话); [a] /ɡet θru/; [or]gmat;
turbine: [n]汽轮机,叶轮机; [a] /ˈtɜːrbaɪn/; [or]gmat;
cardiovascular: [adj]［医］心血管的; [a] /ˌkɑːrdioʊˈvæskjələr/; [or]gmat;
semiarid: [adj]半干旱的; [a] /ˌsemɪ'ærɪd/; [or]gmat;
catalog: [n]目录,目录册,商品目录; [v]为..编目录,登记; [a] /ˈkætəlɔːɡ/; [or]gmat;
encephalitis: [n][内科]脑炎; [a] /enˌsefəˈlaɪtəs/; [or]gmat;
inpatient: [n]住院病人; [a] /ˈɪnpeɪʃnt/; [or]gmat;
susceptibility: [n]易感性的,敏感性,感情; [a] /səˌseptəˈbɪləti/; [or]gmat;
utensil: [n]工具,(厨房)用具; [a] /juːˈtensl/; [or]gmat;
seniority: [n]年长,资历深,职位高; [a] /ˌsiːniˈɔːrəti/; [or]gmat;
interdependency: [n]相互依赖,相关性; [a] /ɪn'tədɪpendənsɪ/; [or]gmat;
interest rate: [phr]利率; [a] /ˈɪntrəst reɪt/; [or]gmat;
exterior: [n]外表;外貌,外观; [adj]外部的;外界的;位于外边的;外交上的; [a] /ɪkˈstɪriər/; [or]gmat;
rehabilitate: [v]使康复,使恢复名誉,使恢复原状; [a] /ˌriːəˈbɪlɪteɪt/; [or]gmat;
countervail: [v]抵销,对抗,补偿; [adj]抗衡的;抵消的; [a] /'kaʊntəˌveɪl/; [or]gmat;
cytology: [n]细胞学; [a] /saɪˈtɑːlədʒi/; [or]gmat;
protagonist: [n]主角,领导者,积极参加者; [a] /prəˈtæɡənɪst/; [or]gmat;
lay sb. off: [v]解雇;关闭;停止活动; [n](临时)解雇期; [a] /leɪ ˈsʌmbədi ɑf/; [or]gmat;
congested: [adj]拥挤的,密集的; [a] /kənˈdʒestɪd/; [or]gmat;
prognosis: [n][医]预后;预知; [a] /prɑːɡˈnoʊsɪs/; [or]gmat;
pull away: [phr]脱身,离开,脱出; [a] /pʊl əˈweɪ/; [or]gmat;
resplendent: [adj]华丽的,辉煌的; [a] /rɪˈsplendənt/; [or]gmat;
letup: [n]放松,停顿; [a] /'letˌʌp/; [or]gmat;
prosthetic: [adj][医]修复术的,弥补性的; [a] /prɑːsˈθetɪk/; [or]gmat;
fool around: [v]闲荡,干蠢事(或无用,琐悄的事); [a] /ful əˈraʊnd/; [or]gmat;
delinquency: [n]失职,玩忽职守,拖欠债务,缺点,过错;[法律]少年犯罪,不法行为(青少年),行为不当; [a] /dɪˈlɪŋkwənsi/; [or]gmat;
punitive: [adj]给予惩罚,刑罚的; [a] /ˈpjuːnətɪv/; [or]gmat;
pterosaur: [n]翼龙; [a] /'terəˌsɔː/; [or]gmat;
competence: [n]能力,胜任,称职; [a] /ˈkɑːmpɪtəns/; [or]gmat;
respire: [v]呼吸; [a] /rɪˈspaɪər/; [or]gmat;
liquidator: [n]清算人; [a] /ˈlɪkwɪdeɪtər/; [or]gmat;
list price: [phr]目录价格,标价; [a] /ˈlɪst praɪs/; [or]gmat;
renovation: [n]修理;恢复; [a] /ˌrenəˈveɪʃn/; [or]gmat;
live show: [n]现场表演; [a] /lɪv ʃoʊ/; [or]gmat;
reclamation: [n]开垦,改造,感化,废料回收; [a] /ˌrekləˈmeɪʃn/; [or]gmat;
ductile: [adj](某些金属)有延展性的;可塑的;易受影响的; [a] /ˈdʌktaɪl/; [or]gmat;
logotype: [n]［印］连合活字,广告等用的标识; [a] /'lɒgəˌtaɪp/; [or]gmat;
hypothalamus: [n]下丘脑; [a] /ˌhaɪpəˈθæləməs/; [or]gmat;
fluctuate: [v]波动;起伏;涨落; [a] /ˈflʌktʃueɪt/; [or]gmat;
antigen: [n][免疫]抗原; [a] /ˈæntɪdʒən/; [or]gmat;
debunk: [v]揭穿真面目,证明为假; [a] /ˌdiːˈbʌŋk/; [or]gmat;
regressive: [adj]回归的,后退的,退化的; [a] /rɪˈɡresɪv/; [or]gmat;
carcinogen: [n]［医］致癌物,诱癌物; [a] /kɑːrˈsɪnədʒən/; [or]gmat;
maladaptive: [adj]不适应的; [a] /ˌmælə'dæptɪv/; [or]gmat;
nutritious: [adj]有营养的,滋养的; [a] /nuˈtrɪʃəs/; [or]gmat;
mark up: [phr]标记;加价;提高分数; [a] /mɑːrk ʌp/; [or]gmat;
mark down: [v]降价; [n]降价; [a] /mɑrk daʊn/; [or]gmat;
phony: [adj]假的,伪造的; [n]假冒者; suf. 表声音; [a] /ˈfoʊni/; [or]gmat;
retentive: [adj]保持的;吸(水)的; [adv]有记性地,记性强地; [n]保持力;〈物〉顽磁性; [a] /rɪˈtentɪv/; [or]gmat;
compactness: [n]紧密;小巧;紧凑; [a] /kəmˈpæktnəs/; [or]gmat;
megalithic: [adj]巨石制的,有巨石物征的; [a] /ˌmeɡəˈlɪθɪk/; [or]gmat;
choreographer: [n]舞蹈编导; [a] /ˌkɔːriˈɑːɡrəfər/; [or]gmat;
critic: [n]评论家,批判者;挑剔的人; [a] /ˈkrɪtɪk/; [or]gmat;
topographical: [adj]地形的,地形学的,地形测量的; [a] /ˌtɑːpəˈɡræfɪkl/; [or]gmat;
seesaw: [n]跷跷板;拉锯局面,不断起伏的状态; [adj]来回往复的;拉锯式的; [v]摇摆不定,时起时伏; [adv]上下动地[的], 前后动地[的],交互地[的],拉锯性地[的]; [a] /ˈsiː sɔː/; [or]gmat;
topsoil: [n]表层土;上层土; [v]去掉表土; [a] /ˈtɑːpsɔɪl/; [or]gmat;
soprano: [n]女高音,女高音歌手,女高音声部; [adj]女高音的,童声高音的,女高音声部的; [a] /səˈprɑːnoʊ/; [or]gmat;
optometrist: [n]配镜师,验光师; [a] /ɑːpˈtɑːmətrɪst/; [or]gmat;
natural number: [phr]自然数; [a] /ˌnætʃrəl ˈnʌmbər/; [or]gmat;
pharmacologist: [n]药理学家,药物学家; [a] /ˌfɑːrməˈkɑːlədʒɪst/; [or]gmat;
rhythmical: [adj]有节奏的,有韵律的; [a] /ˈrɪðmɪk(ə)l/; [or]gmat;
neuroleptic: [adj]抑制精神的,安定的; [n]安定药,精神抑制药; [a] /ˌnjʊəˌnʊrə'leptɪk/; [or]gmat;
neutrino: [n]中微子; [a] /nuːˈtriːnoʊ/; [or]gmat;
contend: [v]争辩;坚决主张;搏斗; [a] /kənˈtend/; [or]gmat;
incriminate: [v]控告,暗示..有罪; [a] /ɪnˈkrɪmɪneɪt/; [or]gmat;
preeminence: [n]杰出; [a] /priː'emɪnəns/; [or]gmat;
polarity: [n](分)极性;相对的观点; [a] /pəˈlærəti/; [or]gmat;
outgrowth: [n]结果;副产物;自然的发展;分枝; [a] /ˈaʊtɡroʊθ/; [or]gmat;
adversarial: [adj]敌人的,对手的,对抗的; [a] /ˌædvərˈseriəl/; [or]gmat;
account for: [phr]解释,说明;(在数量方面)占;对.负责;导致,引起; [a] /əˈkaʊnt fɔr/; [or]gmat;
sugarcane: [n]甘蔗; [a] /'ʃʊgəˌkeɪn/; [or]gmat;
ocher: [n]［矿］赭石,(黄)褐色; [a] /'oʊkə/; [or]gmat;
raffle: [n]废物;抽彩票; [v]抽彩票; [a] /ˈræfl/; [or]gmat;
framework: [n]构架,框架,结构;体制,体系; [a] /ˈfreɪmwɜːrk/; [or]gmat;
retention: [n]保留,保持; [a] /rɪˈtenʃn/; [or]gmat;
pall: [n]幕;棺罩;遮盖物; [v]覆盖;使乏味;走味; [a] /pɔːl/; [or]gmat;
philanthropic: [adj]博爱的,为他人着想的; [a] /ˌfɪlənˈθrɑːpɪk/; [or]gmat;
velvet: [n]天鹅绒;鹿茸的嫩皮; [adj]天鹅绒的; [a] /ˈvelvɪt/; [or]gmat;
prose: [n]散文; [vt]用散文写,把.改写成散文;平淡无趣地写;啰啰唆唆地讲; [a] /proʊz/; [or]gmat;
impulse: [n]冲动,脉冲,驱使; [a] /ˈɪmpʌls/; [or]gmat;
novelty: [n]新奇;新奇的事物;新颖小巧而廉价的小物品; [adj]新奇的;风格独特的; [a] /ˈnɑːvlti/; [or]gmat;
bounty: [n]慷慨;赠物;奖金; [vt]发给.奖金; [a] /ˈbaʊnti/; [or]gmat;
prominent: [adj]突起的,显眼的;突出的,杰出的; [a] /ˈprɑːmɪnənt/; [or]gmat;
readily: [adv]容易地;乐意地;欣然地; [a] /ˈredɪli/; [or]gmat;
fusion: [n]融合,合并,核聚变; [a] /ˈfjuːʒn/; [or]gmat;
peel: [v]剥皮,削皮,去壳; [n]果皮,外皮; [a] /piːl/; [or]gmat;
proclaim: [v]声明,声称;宣告;表明; [a] /prəˈkleɪm/; [or]gmat;
headquarters: [n]司令部,指挥部;总部,总局; [a] /ˈhedkwɔːrtərz/; [or]gmat;
diverge: [v]分歧,分开; [a] /daɪˈvɜːrdʒ/; [or]gmat;
senate: [n]参议院,上院; [a] /ˈsenət/; [or]gmat;
promising: [adj]有前途的,有希望的;(前景)光明的; [a] /ˈprɑːmɪsɪŋ/; [or]gmat;
supplement: [n]增补,补充物,保健品;附录; [v]补充; [a] /ˈsʌplɪmənt/; [or]gmat;
gauge: [n]测量仪;尺度,标准; [v]估计,判断;计量; [a] /ɡeɪdʒ/; [or]gmat;
fluid: [n]流体,液体; [adj]流动的;易变的;流畅的; [a] /ˈfluːɪd/; [or]gmat;
shave: [v]剃,刮; [n]剃须,修面,剃刀; [a] /ʃeɪv/; [or]gmat;
insight: [n]深刻的理解,洞察力,见识; [a] /ˈɪnsaɪt/; [or]gmat;
rug: [n](小)地毯;围毯;男子假发; [a] /rʌɡ/; [or]gmat;
undermine: [v]暗中破坏;逐渐削弱;侵蚀.的基础;在...下挖坑道,从根基处损害; [a] /ˌʌndərˈmaɪn/; [or]gmat;
trim: [n]修剪;整齐;装饰; [v]修剪;整理;装饰; [adj](人)苗条的;整洁的; [adv]整齐[整洁]地; [a] /trɪm/; [or]gmat;
diplomatic: [adj]外交的,从事外交的;老练的,圆滑的; [a] /ˌdɪpləˈmætɪk/; [or]gmat;
humanitarian: [n]慈善家;人道主义者;博爱主义者; [adj]人道主义者的;慈善的;博爱的; [a] /hjuːˌmænɪˈteriən/; [or]gmat;
discourse: [n]交谈,演讲,论述,讲道; [v]演讲,谈论; [a] /ˈdɪskɔːrs/; [or]gmat;
progressive: [adj]进步的;逐步的,渐进的; [n]进步人士; [a] /prəˈɡresɪv/; [or]gmat;
yeast: [n]酵母,发酵物;兴奋; [a] /jiːst/; [or]gmat;
upgrade: [v]升级;提高; [n]改善,提高;升级;升舱; [a] /ˈʌpɡreɪd/; [or]gmat;
string: [n]弦,线,细绳,一系列;一行; [v]串起;悬挂;使紧张; [adj]线的,线织的;由弦乐器组成的; [a] /strɪŋ/; [or]gmat;
multitude: [n]大量;众多;大批;群众; [a] /ˈmʌltɪtuːd/; [or]gmat;
medium: [adj]中等的;适中的; [n]手段;媒介;材料; [a] /ˈmiːdiəm/; [or]gmat;
signify: [vi]具有重要性; [vt]表示; [a] /ˈsɪɡnɪfaɪ/; [or]gmat;
rating: [n]评价;等级;等级评定;额定功率;评分,收视率; [a] /ˈreɪtɪŋ/; [or]gmat;
implement: [n]工具;器具; [v]实施,执行;执行; [a] /ˈɪmplɪment/; [or]gmat;
optimism: [n]乐观,乐观主义; [a] /ˈɑːptɪmɪzəm/; [or]gmat;
separate: [adj]独立的;分开的;单独的; [v]使分开,分离,分割,划分; [a] /ˈsepəreɪt/; [or]gmat;
petroleum: [n]石油; [a] /pəˈtroʊliəm/; [or]gmat;
regiment: [n](军队)团; [v]组编成团;严格控制; [a] /ˈredʒɪmənt/; [or]gmat;
embrace: [v]拥抱;包含;欣然接受,乐意采纳; [n]拥抱;接受;领会; [a] /ɪmˈbreɪs/; [or]gmat;
household: [n]同住在一家的人;家务;家常普通的; [adj]家庭的,家内的,一家的;家喻户晓的; [a] /ˈhaʊshoʊld/; [or]gmat;
dose: [n](药)剂量,用量,一剂; [vt]给..服药; [a] /doʊs/; [or]gmat;
implicit: [adj]隐含的;盲目的;完全的,绝对的;成为一部分的; [a] /ɪmˈplɪsɪt/; [or]gmat;
prey: [n]被掠食者,猎物;牺牲者; [v]使..苦恼; [vi]捕食;受..控制; [a] /preɪ/; [or]gmat;
discrete: [adj]分开的;不连续的; [a] /dɪˈskriːt/; [or]gmat;
hide: [vt]躲藏,把.藏起来;隐瞒; [n]藏身处;隐密场所,隐蔽处;(尤指买卖或用作皮革的)皮;兽皮;人身安全; [a] /haɪd/; [or]gmat;
swiftly: [adv]迅速地,敏捷地; [a] /ˈswɪftli/; [or]gmat;
lot: pro[n]大量,许多;场地;一批;某一类人; [adv](与形容词和副词连用)很;非常;(与动词连用)非常; [v]分组;把.划分(常与out连用);把(土地)划分成块;抽签;拈阄; [a] /lɑːt/; [or]gmat;
spiced: [adj]五香的,调过味的,含香料的; [a] /spaɪst/; [or]gmat;
[kk9: GMAT/3000]