bounce: [vi]弹起,蹦跳;  [vt]使弹起;  [v]拒付 (支票);  [n]弹跳,弹力,活力; [a]/baʊns/; [or]6j;
domestic: [adj]国产的;国内的;家庭的;驯养的;  [n]家仆;家庭纷争; [a]/dəˈmestɪk/; [or]6j;
guarantee: [v]保证;担保;提供保修;  [n]保证;担保;保修单;保证金; [a]/ˌɡærənˈtiː/; [or]6j;
mental: [adj]精神的;心理的; [a]/ˈmentl/; [or]6j;
suicide: [n]自杀;自毁; [a]/ˈsuːɪsaɪd/; [or]6j;
despise: [vt]轻视,蔑视,看不起; [a]/dɪˈspaɪz/; [or]6j;
magnet: [n]磁体,磁铁; [a]/ˈmæɡnət/; [or]6j;
sufficient: [adj]足够的;充分的; [a]/səˈfɪʃnt/; [or]6j;
vacant: [adj]空的,未被占用的;闲置的;空缺的;茫然的; [a]/ˈveɪkənt/; [or]6j;
layman: [n]门外汉;俗人;外行; [a]/ˈleɪmən/; [or]6j;
impatient: [adj]不耐烦的,没有耐心的;急躁的; [a]/ɪmˈpeɪʃnt/; [or]6j;
urge: [v]力劝,敦促;驱策;力荐;  [vi]驱策;  [n]冲动,欲望; [a]/ɜːrdʒ/; [or]6j;
brand: [n]商标,品牌;烙印;  [v]给..打上烙印;归为 (不好的事物); [a]/brænd/; [or]6j;
specialist: [n]专家;专科医生;  [adj]专家的;专业的; [a]/ˈspeʃəlɪst/; [or]6j;
propaganda: [n]宣传;宣传方法; [a]/ˌprɑːpəˈɡændə/; [or]6j;
summit: [n]山顶,顶点;(政府间的)峰会; [a]/ˈsʌmɪt/; [or]6j;
chase: [v]追赶;驱逐;追求;  [n]追逐;追求; [a]/tʃeɪs/; [or]6j;
endure: [v]忍受;持久;持续;容忍; [a]/ɪnˈdʊr/; [or]6j;
sheer: [adj]陡峭的;纯粹的;  [v](off)急转向,偏离;  [n]透明薄纱,透明布料的衣服;  [adv]完全地,全然;垂直地,陡峭地; [a]/ʃɪr/; [or]6j;
extravagant: [adj]奢侈的,无节制的; [a]/ɪkˈstrævəɡənt/; [or]6j;
probability: [n]可能性;几率,概率; [a]/ˌprɑːbəˈbɪləti/; [or]6j;
diet: [n]日常饮食;(病人或减肥者的)特种饮食;大量;  [v]节食; [a]/ˈdaɪət/; [or]6j;
poisonous: [adj]有毒的; [a]/ˈpɔɪzənəs/; [or]6j;
engine: [n]引擎;发动机;  [v]给..装引擎; [a]/ˈendʒɪn/; [or]6j;
monarch: [n]君主;帝王;统治者; [a]/ˈmɑːnərk/; [or]6j;
bulletin: [n]公告;公报;公告牌; [a]/ˈbʊlətɪn/; [or]6j;
prevailing: [adj]流行的;盛行的;普遍的; [a]/prɪˈveɪlɪŋ/; [or]6j;
purchase: [v]购买;  [n]购买;所购之物; [a]/ˈpɜːrtʃəs/; [or]6j;
sturdy: [adj]结实的;坚固的;强壮的;健壮的;  [n](羊的)晕倒病; [a]/ˈstɜːrdi/; [or]6j;
voluntary: [adj]自愿的;无偿的;志愿的;  [n]即兴曲; [a]/ˈvɑːlənteri/; [or]6j;
response: [n]回应;作答;响应,回答; [a]/rɪˈspɑːns/; [or]6j;
fastener: [n]纽扣;使系牢之物; [a]/ˈfæsnər/; [or]6j;
uproar: [n]骚动;喧嚣; [a]/ˈʌprɔːr/; [or]6j;
stark: [adj]完全的,明显的,荒凉的;  [adv]完全,明显地; [a]/stɑːrk/; [or]6j;
suburb: [n]郊区; [a]/ˈsʌbɜːrb/; [or]6j;
butt: [n]底部,屁股;  [v](人)用头顶撞;(动物)用头(或角)顶;  [adv]猛撞;用头撞; [a]/bʌt/; [or]6j;
merciful: [adj]慈善的,仁慈的,宽大的; [a]/ˈmɜːrsɪfl/; [or]6j;
chorus: [n]副歌部分;合唱团;合唱曲,合唱句;  [v]合唱,齐声说;齐声说; [a]/ˈkɔːrəs/; [or]6j;
glossary: [n]词汇表,术语汇编; [a]/ˈɡlɑːsəri/; [or]6j;
deduce: [v]演绎;推论,推断; [a]/dɪˈduːs/; [or]6j;
concession: [n]让步;特许,特许权;承认; [a]/kənˈseʃn/; [or]6j;
procedure: [n]步骤,过程;程序;手续; [a]/prəˈsiːdʒər/; [or]6j;
reactor: [n]［原］反应堆; [a]/riˈæktər/; [or]6j;
specialty: [n]特色菜;专业,专长,特点; [a]/ˈspeʃəlti/; [or]6j;
brutal: [adj]残忍的,粗鲁的;严酷的,难以忍受的;严峻的; [a]/ˈbruːtl/; [or]6j;
reproach: [v]责备,指责;  [n]指责; [a]/rɪˈproʊtʃ/; [or]6j;
spherical: [adj]球形的; [a]/ˈsferɪkl/; [or]6j;
solemn: [adj]严肃的;庄严的,隆重的;神圣的; [a]/ˈsɑːləm/; [or]6j;
provoke: [v]激怒;对.挑衅;引起; [a]/prəˈvoʊk/; [or]6j;
realization: [n]认识,领会,领悟,实现; [a]/ˌriːələˈzeɪʃn/; [or]6j;
melancholy: [n]忧郁,悲哀;  [adj]忧郁的,令人伤感的; [a]/ˈmelənkɑːli/; [or]6j;
yolk: [n]蛋黄; [a]/joʊk/; [or]6j;
offset: [v]抵消;  [adj]胶印的,透印版印刷的;  [n]分支;抵销; [a]/ˈɔːfset/; [or]6j;
strain: [n]负担;紧张;拉力;(生物体)品种,种类;  [v]拉紧;劳累;过分使用; [a]/streɪn/; [or]6j;
bourgeois: [n]中产阶级;资产阶级;  [adj]中产阶级的; [a]/ˌbʊrˈʒwɑː/; [or]6j;
conference: [n]会议;讨论会; [a]/ˈkɑːnfərəns/; [or]6j;
drain: [vi]排出,排水;  [v]流干,沥干;喝光,耗尽,减少,消逝;  [vt]使流出,排掉水;  [n]下水道,排水管;消耗,排水; [a]/dreɪn/; [or]6j;
passive: [adj]被动的;消极的;  [n]被动语态; [a]/ˈpæsɪv/; [or]6j;
achievement: [n]成绩,成就;实现,完成; [a]/əˈtʃiːvmənt/; [or]6j;
thrill: [n]兴奋,激动,引起激动的事物;  [v](使)非常兴奋,(使)非常激动; [a]/θrɪl/; [or]6j;
pave: [v]铺(路),铺筑; [a]/peɪv/; [or]6j;
cyber-: pref. 电脑(网络)的;电脑的;网络的; [a]/'saɪbə/; [or]6j;
annual: [adj]一年一次的,年度的;  [n]年鉴,一年生植物,一年一度的事件; [a]/ˈænjuəl/; [or]6j;
scarlet: [n]鲜红色;鲜红色布匹;  [adj]鲜红色的;罪不可赦的; [a]/ˈskɑːrlət/; [or]6j;
cumulative: [adj]渐增的;累积的; [a]/ˈkjuːmjəleɪtɪv/; [or]6j;
reconciliation: [n]和解,修好,和好,调停,调解; [a]/ˌrekənsɪliˈeɪʃn/; [or]6j;
cocaine: [n]可卡因,古柯碱; [a]/koʊˈkeɪn/; [or]6j;
fraud: [n]欺诈,诈骗;骗子; [a]/frɔːd/; [or]6j;
complement: [v]补充;与.相配;  [n]补充;互为补充的东西;补语; [a]/ˈkɑːmplɪment/; [or]6j;
outrage: [n]残暴;暴行,愤怒;  [v]使震怒,使愤慨; [a]/ˈaʊtreɪdʒ/; [or]6j;
bang: [n]巨响;重击;刘海;  [adv]准确地,完全地;  [v]发出砰的一声;重击;猛敲;砰地关上; [a]/bæŋ/; [or]6j;
tar: [n]柏油;焦油;  [v]涂柏油; [a]/tɑːr/; [or]6j;
cane: [n]手杖;茎;藤条;甘蔗; [a]/keɪn/; [or]6j;
inevitable: [adj]不可避免的,必然的;  [n]必然发生的事; [a]/ɪnˈevɪtəbl/; [or]6j;
attendance: [n]出席人数;出席;出席者;随员; [a]/əˈtendəns/; [or]6j;
innovation: [n]创新,革新,新设施,新发明; [a]/ˌɪnəˈveɪʃn/; [or]6j;
sensor: [n]传感器,灵敏元件; [a]/ˈsensər/; [or]6j;
entitle: [v]给(书)题名;给予.权利; [a]/ɪnˈtaɪtl/; [or]6j;
adjoin: [v]与.毗连;贴近; [a]/əˈdʒɔɪn/; [or]6j;
junk: [n]废旧物品,垃圾,假货;  [v]把.(当废物)丢弃; [a]/dʒʌŋk/; [or]6j;
cite: [v]引用,引证;传唤,传讯;表彰,嘉奖; [a]/saɪt/; [or]6j;
clerk: [n]店员;职员;办事员;  [vi]当职员; [a]/klɜːrk/; [or]6j;
decisive: [adj]决定性的; [a]/dɪˈsaɪsɪv/; [or]6j;
indignant: [adj]愤慨的,愤愤不平的; [a]/ɪnˈdɪɡnənt/; [or]6j;
haul: [n]一次获得;拖运路程;  [v]硬拖,硬拉,用力拖;拖,拉,拽;强迫(某人)去某处; [a]/hɔːl/; [or]6j;
cannon: [n]大炮;机关炮;  [v]相撞;开炮; [a]/ˈkænən/; [or]6j;
crime: [n]罪行;犯罪;违反道德的行为;  [v]判定犯罪;处罚军事犯; [a]/kraɪm/; [or]6j;
adjustable: [adj]可调整的; [a]/əˈdʒʌstəbl/; [or]6j;
mast: [n]桅,桅杆,柱;旗杆;天线竿;  [v]装桅杆于; [a]/mæst/; [or]6j;
religion: [n]宗教;宗教信仰;宗教生活;虔诚的追求; [a]/rɪˈlɪdʒən/; [or]6j;
accustomed: [adj]通常的,惯常的;独特的;习惯的,适应了的(to); [a]/əˈkʌstəmd/; [or]6j;
flare: [v]燃烧(摇曳着);突然发怒;  [n]照明弹;摇曳的火焰;闪光信号; [a]/fler/; [or]6j;
instrumental: [adj]乐器的;重要的;有帮助的;仪器的;  [n]工具词;器乐曲;工具格; [a]/ˌɪnstrəˈmentl/; [or]6j;
fluctuate: [v]波动;起伏;涨落; [a]/ˈflʌktʃueɪt/; [or]6j;
detection: [n]察觉;侦察;检测,检验; [a]/dɪˈtekʃn/; [or]6j;
commitment: [n]承诺;许诺;委任;承担的义务;献身;赞助;委托;犯罪;罪行;信奉; [a]/kəˈmɪtmənt/; [or]6j;
purity: [n]纯洁;纯净;纯正;纯粹; [a]/ˈpjʊrəti/; [or]6j;
tenant: [n]承租人,租客,佃户; [a]/ˈtenənt/; [or]6j;
initiate: [v]开始,发动;  [n]新加入组织的人; [a]/ɪˈnɪʃieɪt/; [or]6j;
reward: [n]奖品,报酬,回报;悬赏;  [v]报答,酬谢; [a]/rɪˈwɔːrd/; [or]6j;
underwear: [n]内衣裤; [a]/ˈʌndərwer/; [or]6j;
proof: [n]证据,证明,校样;  [v]校对;试验;  [adj]防.的;能抵御;能防范; [a]/pruːf/; [or]6j;
spectacle: [n]场面;景象,奇观;眼镜; [a]/ˈspektəkl/; [or]6j;
alternative: [adj]可供选择的;替代的;不寻常的;  [n]可供选择的事物; [a]/ɔːlˈtɜːrnətɪv/; [or]6j;
linear: [adj]线的,线性的;直线的;长度的; [a]/ˈlɪniər/; [or]6j;
bias: [n]倾斜;偏心;偏见;  [v]使有偏见; [a]/ˈbaɪəs/; [or]6j;
abundance: [n]丰富;大量; [a]/əˈbʌndəns/; [or]6j;
banquet: [n](正式的)宴会;盛宴;  [adj]宴会的; [a]/ˈbæŋkwɪt/; [or]6j;
devise: [v]设计,想出;密谋;遗赠(不动产);  [n]设计,发明,遗赠; [a]/dɪˈvaɪz/; [or]6j;
compute: [v]计算,估计; [a]/kəmˈpjuːt/; [or]6j;
accommodation: [n]住宿,食宿;调解;住处; [a]/əˌkɑːməˈdeɪʃn/; [or]6j;
gossip: [n]流言蜚语,爱传流言的人;  [v]闲聊,传播流言蜚语; [a]/ˈɡɑːsɪp/; [or]6j;
advocate: [v]提倡;主张;为.辩护;  [n]辩护者;提倡者;律师; [a]/ˈædvəkeɪt/; [or]6j;
peculiar: [adj]奇怪的,古怪的;特有的,特别的; [a]/pɪˈkjuːliər/; [or]6j;
feasible: [adj]可行的,行得通的; [a]/ˈfiːzəbl/; [or]6j;
republican: [n]共和主义者;共和党员;  [adj]共和国的,共和政体的;共和党的; [a]/rɪˈpʌblɪkən/; [or]6j;
composite: [adj]合成的,复合的;  [n]合成物,复合材料;  [v]使合成,使混合; [a]/kəmˈpɑːzət/; [or]6j;
rivalry: [n]竞争,敌对; [a]/ˈraɪvlri/; [or]6j;
pertinent: [adj]有关的;适当的;中肯的;  [n]附属物;参考; [a]/ˈpɜːrtnənt/; [or]6j;
iceberg: [n]冰山; [a]/ˈaɪsbɜːrɡ/; [or]6j;
shady: [adj]成荫的,多荫的;可疑的,靠不住的; [a]/ˈʃeɪdi/; [or]6j;
cathedral: [n]大教堂;  [adj]有权威的;大教堂的; [a]/kəˈθiːdrəl/; [or]6j;
hound: [n]猎犬;  [v]追逼;烦扰;纠缠; [a]/haʊnd/; [or]6j;
awkward: [adj]尴尬的;笨拙的;棘手的;不雅观的;不方便的;困难的,危险的; [a]/ˈɔːkwərd/; [or]6j;
audit: [v]审计,查账;旁听;  [n]审计;查帐; [a]/ˈɔːdɪt/; [or]6j;
counter: [n]柜台;回击,反击;  [v]抵消,抗衡;  [adv]相反地; [a]/ˈkaʊntər/; [or]6j;
specific: [adj]具体的,明确的;特定的;特殊的;针对..的;  [n]详情;特性; [a]/spəˈsɪfɪk/; [or]6j;
pamphlet: [n]小册子; [a]/ˈpæmflət/; [or]6j;
brief: [adj]简短的,扼要的,短暂的,短时间的;  [n]摘要,概要,简短声明,诉讼要点;职责;  [v]作.的摘要,向.通报情况; [a]/briːf/; [or]6j;
seminar: [n]研究班;研讨会; [a]/ˈsemɪnɑːr/; [or]6j;
ornamental: [adj]装饰性的;  [n]观赏植物;装饰物; [a]/ˌɔːrnəˈmentl/; [or]6j;
sift: [vt]筛;  [v]筛分;精选;细查; [a]/sɪft/; [or]6j;
permanence: [n]持久;永久; [a]/ˈpɜːrmənəns/; [or]6j;
strife: [n]纷争,倾轧; [a]/straɪf/; [or]6j;
prediction: [n]预言,预测; [a]/prɪˈdɪkʃn/; [or]6j;
clasp: [v]握紧;扣紧;扣住;抱紧;  [n]扣子;钩子;紧抱;紧握; [a]/klæsp/; [or]6j;
persecute: [v](尤指因宗教或政治信仰不同)迫害;烦扰,纠缠; [a]/ˈpɜːrsɪkjuːt/; [or]6j;
underlying: [adj]基本的;潜在的;在下面的; [a]/ˌʌndərˈlaɪɪŋ/; [or]6j;
standardize: [v]立下标准;制定标准;使合乎标准;使标准化; [a]/ˈstændərdaɪz/; [or]6j;
angel: [n]天使;可爱的人;善人,好人(感激某人时所说); [a]/ˈeɪndʒl/; [or]6j;
combination: [n]结合,联合,组合;(保险锁等的)暗码; [a]/ˌkɑːmbɪˈneɪʃn/; [or]6j;
alleviate: [v]减轻;缓解;缓和; [a]/əˈliːvieɪt/; [or]6j;
untie: [v]解开,解放; [a]/ʌnˈtaɪ/; [or]6j;
diverse: [adj]不同的,差异的,多种多样的; [a]/daɪˈvɜːrs/; [or]6j;
vow: [n]誓约;  [v]宣誓;立誓;发誓; [a]/vaʊ/; [or]6j;
tract: [n]器官系统;一大片地;短文,小册子; [a]/trækt/; [or]6j;
bewilder: [v]使不知所措;使迷惑;使变糊涂,弄糊涂; [a]/bɪˈwɪldər/; [or]6j;
experimentally: [adv]实验上地;用实验方法; [a]/ɪkˌsperɪˈmentəli/; [or]6j;
perspective: [n]角度,视角,观点,想法;(对事物的)合理判断,正确认识;远景;透视图,透视法,透视效果;  [adj]透视的; [a]/pərˈspektɪv/; [or]6j;
synthesis: [n]合成; [a]/ˈsɪnθəsɪs/; [or]6j;
prospect: [n]前景,展望;视野;景象;  [v]勘察;有前途;勘探;对..进行仔细调查; [a]/ˈprɑːspekt/; [or]6j;
loom: [n]织布机;  [v]阴森地逼近;隐现;即将来临; [a]/luːm/; [or]6j;
pastime: [n]消遣,娱乐; [a]/ˈpæstaɪm/; [or]6j;
manure: [n]肥料;  [v]施肥于;耕种; [a]/məˈnʊr/; [or]6j;
advent: [n]来临;到来;出现; [a]/ˈædvent/; [or]6j;
probe: [v]探测,探索;  [n]探索,调查;探针,探测器; [a]/proʊb/; [or]6j;
solidify: [v](使)凝固,(使)团结,巩固; [a]/səˈlɪdɪfaɪ/; [or]6j;
refuge: [n]避难,庇护;避难所,收容所;隐蔽处;保护区;  [vi]避难,寻求庇护;  [vt]给以庇护,提供庇护; [a]/ˈrefjuːdʒ/; [or]6j;
hybrid: [n]杂种,混血儿,混合物;  [adj]混合的;杂种的; [a]/ˈhaɪbrɪd/; [or]6j;
decline: [n]下降;衰退;  [v][语]使发生词尾变化,使变格;下降;拒绝; [a]/dɪˈklaɪn/; [or]6j;
commute: [n]在两地之间乘车往返;  [v]经常乘车往返于两地之间;  [vt]减免; [a]/kəˈmjuːt/; [or]6j;
shrink: [v]收缩;缩小;退缩;  [n](非正式用法)心理医生,精神病医生; [a]/ʃrɪŋk/; [or]6j;
denial: [n]拒绝;否认;拒绝给予; [a]/dɪˈnaɪəl/; [or]6j;
timely: [adj]适时的,及时的;  [adv]及时地; [a]/ˈtaɪmli/; [or]6j;
consumption: [n]消耗,消费,耗尽;肺痨; [a]/kənˈsʌmpʃn/; [or]6j;
prototype: [n]原型,典型,样本; [a]/ˈproʊtətaɪp/; [or]6j;
approach: [v]接近;靠近;着手处理;  [n]接近;途径;方法; [a]/əˈproʊtʃ/; [or]6j;
oyster: [n]牡蛎;从中可得到好处的东西;[口语]沉默寡言;  [v]采牡蛎; [a]/ˈɔɪstər/; [or]6j;
legitimate: [adj]合法的;合理的;  [vt]使合法;授权;宣布..为合法; [a]/lɪˈdʒɪtɪmət/; [or]6j;
conscious: [adj]神志清醒的;自觉的;意识到的;有意的;  [n]意识; [a]/ˈkɑːnʃəs/; [or]6j;
fist: [n]拳头;笔迹;  [vt]用拳头打;握成拳;紧握; [a]/fɪst/; [or]6j;
participant: [n]参加者,参与者;  [adj]参加的;有关系的; [a]/pɑːrˈtɪsɪpənt/; [or]6j;
scratch: [n]抓痕,擦伤;  [v]划破,擦伤,挠; [a]/skrætʃ/; [or]6j;
spy: [n]间谍,密探;  [v]当间谍,暗中监视(或侦察); [a]/spaɪ/; [or]6j;
haughty: [adj]傲慢的; [a]/ˈhɔːti/; [or]6j;
plea: [n](法律)抗辩;恳求;请求,托词,口实; [a]/pliː/; [or]6j;
recur: [v]重新出现;再次发生;重新提起;诉诸;反复; [a]/rɪˈkɜːr/; [or]6j;
coarse: [adj]粗糙的;粗俗的;粗鲁的; [a]/kɔːrs/; [or]6j;
stun: [v]使昏迷,使发愣; [a]/stʌn/; [or]6j;
growl: [v](动物)咆哮,吼叫;  [n]咆哮声,怨言,打嗝声; [a]/ɡraʊl/; [or]6j;
recipient: [n]接受者;容器;间接宾语;  [adj]接受的;善于接受的;接受能力强的; [a]/rɪˈsɪpiənt/; [or]6j;
appeal: [vi]呼吁,请求;申诉;有吸引力;  [n]呼吁;恳求;(为慈善或好的事业所做的) 筹款努力;(人或物的)吸引力; [a]/əˈpiːl/; [or]6j;
gradient: [n]斜坡;倾斜度;坡度;渐变;  [adj]倾斜的;渐倾的; [a]/ˈɡreɪdiənt/; [or]6j;
myth: [n]神话;虚构的信念(或观念,理论);杜撰出来的人(或事物); [a]/mɪθ/; [or]6j;
charter: [n]宪章;特权,豁免权;契约,证书;租赁;  [v]包,租(飞机,汽车等);  [adj]包租的,租用的; [a]/ˈtʃɑːrtər/; [or]6j;
ozone: [n]臭氧;(口语)新鲜空气;能使人兴奋的力量; [a]/ˈoʊzoʊn/; [or]6j;
treaty: [n]条约;协议;协定; [a]/ˈtriːti/; [or]6j;
pinpoint: [v]准确地解释或说明;  [adj]精确的;  [n]针尖,极小之物,极不重要的事物; [a]/ˈpɪnpɔɪnt/; [or]6j;
retort: [v]反驳;  [n]反驳,反击,回嘴; [a]/rɪˈtɔːrt/; [or]6j;
gloomy: [adj]愁容满面的,阴暗的,没有希望的; [a]/ˈɡluːmi/; [or]6j;
lane: [n]小径,巷,行车道; [a]/leɪn/; [or]6j;
scale: [n]天平,磅秤;刻度,尺度,标度;等级,级别, 等级体系;鳞片,鳞状物;规模;水垢,牙垢;  [v]攀登;按比例决定;称重;刮鳞,剥落; [a]/skeɪl/; [or]6j;
charity: [n]慈善团体;慈善;仁慈;施舍; [a]/ˈtʃærəti/; [or]6j;
prose: [n]散文;  [vt]用散文写,把.改写成散文;平淡无趣地写;啰啰唆唆地讲; [a]/proʊz/; [or]6j;
appliance: [n]家用器具;家用电器;装置;应用; [a]/əˈplaɪəns/; [or]6j;
resignation: [n]辞职;辞职书;无奈;顺从; [a]/ˌrezɪɡˈneɪʃn/; [or]6j;
retain: [v]保持,保留,保存;聘请; [a]/rɪˈteɪn/; [or]6j;
stability: [n]稳定,稳定性; [a]/stəˈbɪləti/; [or]6j;
geometrical: [adj]几何学的;几何的; [a]/ˌdʒiəˈmetrɪk(ə)l/; [or]6j;
notation: [n]记号;标记法;记录; [a]/noʊˈteɪʃn/; [or]6j;
coherent: [adj]协调一致的;条理清楚的,有条理的;连贯的;有黏性的,黏合在一起的,粘着的; [a]/koʊˈhɪrənt/; [or]6j;
ban: [vt]禁止;查禁;  [n]禁止,禁令; [a]/bæn/; [or]6j;
bribe: [v]向.行贿;买通;  [n]贿赂;行贿物; [a]/braɪb/; [or]6j;
physiological: [adj]生理的,生理学的; [a]/ˌfɪziəˈlɑːdʒɪkl/; [or]6j;
naive: [adj]天真的;  [n]天真的人; [a]/naɪˈiːv/; [or]6j;
rank: [v]排名;把.分等级;列队;  [n]等级;军队中的官阶;  [adj]繁茂的,讨厌的,难闻的; [a]/ræŋk/; [or]6j;
masculine: [adj]男性的;男子气概的; [a]/ˈmæskjəlɪn/; [or]6j;
immigrant: [n]移民;  [adj]移民的;迁入的; [a]/ˈɪmɪɡrənt/; [or]6j;
external: [adj]外面的,外部的;外国的; [a]/ɪkˈstɜːrnl/; [or]6j;
analytic(al): [adj]分析的;分解的; [a]/ˌænə'lɪtɪkl/; [or]6j;
disposal: [n]销毁,丢掉,处理;  [adj]处理(或置放)废品的; [a]/dɪˈspoʊzl/; [or]6j;
float: [vi]漂浮,飘浮,浮现;散布;漂泊;  [vt]使漂浮;散布;  [n]浮标,漂浮物,漂浮; [a]/floʊt/; [or]6j;
grove: [n]小树林;果园; [a]/ɡroʊv/; [or]6j;
occupation: [n]占领,占据;占用,居住;职业,工作;消遣; [a]/ˌɑːkjuˈpeɪʃn/; [or]6j;
Thanksgiving: [n]感恩节; [a]/ˌθæŋksˈɡɪvɪŋ/; [or]6j;
impurity: [n]不洁;杂质;不道德; [a]/ɪmˈpjʊrəti/; [or]6j;
ruin: [v]毁灭,毁坏;(使)破产;(使)堕落;  [n]毁灭;废墟; [a]/ˈruːɪn/; [or]6j;
regenerative: [adj]再生的;更新的; [a]/rɪˈdʒenərətɪv/; [or]6j;
extinguish: [v]熄灭,扑灭;根除,消灭; [a]/ɪkˈstɪŋɡwɪʃ/; [or]6j;
web: [n]网;蜘蛛网; [a]/web/; [or]6j;
exert: [v]尽(力),运用,发挥; [a]/ɪɡˈzɜːrt/; [or]6j;
successive: [adj]连续的;接连的; [a]/səkˈsesɪv/; [or]6j;
extraordinarily: [adv]格外地;非常好地; [a]/ɪkˌstrɔːrdəˈnerəli/; [or]6j;
marvel: [n]奇迹,奇景;奇才;  [v]惊叹,吃惊,诧异; [a]/ˈmɑːrvl/; [or]6j;
extensive: [adj]广阔的;广泛的; [a]/ɪkˈstensɪv/; [or]6j;
cancel: [v]取消;撤消;删去; [a]/ˈkænsl/; [or]6j;
rapidity: [n]速度;陡峭; [a]/rəˈpɪdəti/; [or]6j;
poetry: [n]诗,诗歌,诗作;诗意; [a]/ˈpoʊətri/; [or]6j;
fracture: [n]骨折;折断;裂口;  [v]使折断;使骨折; [a]/ˈfræktʃər/; [or]6j;
forum: [n]论坛;讨论会; [a]/ˈfɔːrəm/; [or]6j;
multiply: [v]乘;繁殖;增加; [a]/ˈmʌltɪplaɪ/; [or]6j;
batch: [n]一批(人或物);一批生产量; [a]/bætʃ/; [or]6j;
precedent: [n]先例,范例;惯例;  [adj]在前的,前面的; [a]/ˈpresɪdənt/; [or]6j;
stylish: [adj]时髦的,漂亮的,流行的; [a]/ˈstaɪlɪʃ/; [or]6j;
deceptive: [adj]欺骗性的,骗人的; [a]/dɪˈseptɪv/; [or]6j;
outward: [adj]外面的;向外的;  [adv]外面地,向外地;  [n]外表;外在事务;周围世界;〈罕〉外部; [a]/ˈaʊtwərd/; [or]6j;
segment: [n]部分;片段;(橘子等的)瓣;  [v]分割; [a]/ˈseɡmənt/; [or]6j;
condemn: [v]谴责,责备;判(某人某罪); [a]/kənˈdem/; [or]6j;
reunion: [n]团聚;再联合;再结合;(亲友等的)重聚; [a]/ˌriːˈjuːniən/; [or]6j;
tradesman: [n]零售商;工匠; [a]/ˈtreɪdzmən/; [or]6j;
afflict: [v]使痛苦;使苦恼; [a]/əˈflɪkt/; [or]6j;
overwhelming: [adj]巨大的,势不可挡的,压倒性的;制服的,无法抗拒的; [a]/ˌoʊvərˈwelmɪŋ/; [or]6j;
knob: [n]圆形把手,旋钮,圆形突出物;  [v]突出;使有球形突出物;在.上生疖(长瘤);给(门等)装球形捏手; [a]/nɑːb/; [or]6j;
negotiate: [v]谈判,交涉,商议;成功越过,渡过; [a]/nɪˈɡoʊʃieɪt/; [or]6j;
revolve: [v](使)旋转;(使)绕转; [a]/rɪˈvɑːlv/; [or]6j;
weird: [adj]古怪的;荒唐的; [a]/wɪrd/; [or]6j;
aroma: [n]芳香,香气; [a]/əˈroʊmə/; [or]6j;
proceeding: [n]诉讼;(会议等的)项目;行动;会议记录,会刊;  [v]继续进行; [a]/prəˈsiːdɪŋ/; [or]6j;
cereal: [n]谷物;谷类食物;谷类食品;  [adj]谷类的;谷类制成的; [a]/ˈsɪriəl/; [or]6j;
gloom: [n]昏暗,阴暗;忧郁,沮丧;  [v]变忧郁,变忧愁; [a]/ɡluːm/; [or]6j;
senseless: [adj]不省人事的;无知的;愚蠢的;无意义的;不理解的; [a]/ˈsensləs/; [or]6j;
discourse: [n]交谈,演讲,论述,讲道;  [v]演讲,谈论; [a]/ˈdɪskɔːrs/; [or]6j;
retail: [adj]零售的;  [n]零售;  [v]零售,零售价是;  [adv]以零售方式,以零售形式; [a]/ˈriːteɪl/; [or]6j;
slum: [n]贫民窟,贫民区,陋巷;  [v]去贫民窟,到贫民区去(参观,游玩等); [a]/slʌm/; [or]6j;
kit: [n]成套工具;工具箱;装备;  [vt]装备; [a]/kɪt/; [or]6j;
plateau: [n]高原;  [vi]到达平稳阶段; [a]/plæˈtoʊ/; [or]6j;
considerate: [adj]考虑周到的;体贴的; [a]/kənˈsɪdərət/; [or]6j;
acquisition: [n]并购;获得;掌握;获得物;取得物; [a]/ˌækwɪˈzɪʃn/; [or]6j;
vaccinate: [v]进行预防接种;  [n]被接种牛痘者; [a]/ˈvæksɪneɪt/; [or]6j;
addition: [n]加法;添加;附加物; [a]/əˈdɪʃn/; [or]6j;
regime: [n]政权;政治制度;养生法,生活规则; [a]/reɪˈʒiːm/; [or]6j;
erupt: [v]爆发;(火山,喷泉,蒸汽等)喷发;使迸发;喷射出; [a]/ɪˈrʌpt/; [or]6j;
obsolete: [adj]已过时的;已废弃的;  [v]使过时;使作废;  [n]废词;被废弃的事物; [a]/ˌɑːbsəˈliːt/; [or]6j;
shrub: [n]灌木; [a]/ʃrʌb/; [or]6j;
ventilate: [v]使.通风,透风;公开讨论; [a]/ˈventɪleɪt/; [or]6j;
discard: [v]丢弃;抛弃;遗弃; [a]/dɪsˈkɑːrd/; [or]6j;
remainder: [n]剩下的人;剩余物,残留部分;  [v]减价出售,削价处理;  [adj]剩余的;留存下的; [a]/rɪˈmeɪndər/; [or]6j;
analytic: [adj]分析的;分析法的; [a]/ˌænəˈlɪtɪk/; [or]6j;
underprivileged: [adj]贫困的;被剥夺基本权力的;社会地位低下的;  [n]弱势群体;贫困阶层; [a]/ˌʌndərˈprɪvəlɪdʒd/; [or]6j;
crank: [n]曲柄;有怪癖的人;脾气坏的人;  [v]装曲柄;转动曲柄;  [adj]脾气暴躁的,易怒的; [a]/kræŋk/; [or]6j;
aesthetic: [n]美感;审美观;  [adj]美学的;审美的;悦目的;雅致的; [a]/esˈθetɪk/; [or]6j;
soluble: [adj]可溶解的;可解决的; [a]/ˈsɑːljəbl/; [or]6j;
electronic: [adj]电子的;电子学的;电子操控的;电子设备的; [a]/ɪˌlekˈtrɑːnɪk/; [or]6j;
unpaid: [adj]未付款的;不受报酬的; [a]/ˌʌnˈpeɪd/; [or]6j;
continental: [adj]大陆的,大陆性的;  [n]欧洲人; [a]/ˌkɑːntɪˈnentl/; [or]6j;
cycle: [n]自行车;周期,循环;  [v](英)骑自行车;循环; [a]/ˈsaɪkl/; [or]6j;
precipitate: [v]促成,使..沉淀,猛摔;[气象]凝结;  [n]沉淀物,冷凝物;  [adj]突如其来的,仓促的,迅猛的;感情用事的; [a]/prɪˈsɪpɪteɪt/; [or]6j;
stew: [v]炖,焖,受闷热;使焦虑不安;  [n]炖肉(或菜);鱼塘; [a]/stuː/; [or]6j;
classic: [adj]经典的;古典的;高雅的;一流的;  [n]经典著作;文豪;优秀典范; [a]/ˈklæsɪk/; [or]6j;
muddy: [adj]泥泞的;暗淡的;浑浊的;  [v]使粘上烂泥;显得扑朔迷离; [a]/ˈmʌdi/; [or]6j;
experimentation: [n]实验;试验;实验法; [a]/ɪkˌsperɪmenˈteɪʃn/; [or]6j;
leisure: [n]闲暇,空暇,休闲时间;  [adj]空闲的; [a]/ˈliːʒər/; [or]6j;
faction: [n]派别,小集团,小派系;派系斗争,内讧; [a]/ˈfækʃn/; [or]6j;
pier: [n]码头;桥墩; [a]/pɪr/; [or]6j;
intellectual: [n]知识分子;  [adj]智力的;理智的;需用智力的;聪明的; [a]/ˌɪntəˈlektʃuəl/; [or]6j;
curb: [v]勒住;抑制;控制;约束;  [n]路缘;控制;约束; [a]/kɜːrb/; [or]6j;
suspicious: [adj]可疑的,引起怀疑的;怀疑的,猜疑的; [a]/səˈspɪʃəs/; [or]6j;
instruct: [v]指导;教;指示;通知; [a]/ɪnˈstrʌkt/; [or]6j;
cling: [v]紧紧抓住;黏着,挨近;依恋,依附;坚持,墨守,忠实于; [a]/klɪŋ/; [or]6j;
exotic: [adj]奇异的,珍奇的,来自异国的; [a]/ɪɡˈzɑːtɪk/; [or]6j;
cabinet: [n]橱;柜;内阁; [a]/ˈkæbɪnət/; [or]6j;
oath: [n]誓言;誓约;咒骂;咒语; [a]/oʊθ/; [or]6j;
collapse: [v](使)倒塌,(使)崩溃,(使)瓦解;  [n]倒塌,崩溃,暴跌; [a]/kəˈlæps/; [or]6j;
overflow: [v]满得外溢,外流,泛滥;充满,洋溢;  [n]溢流口,溢流管;容纳不下的物(或人);溢出,满出;超出额;  [adj]充满的; [a]/ˌoʊvərˈfloʊ/; [or]6j;
enormous: [adj]极大的,极大量的;巨大的;庞大的; [a]/ɪˈnɔːrməs/; [or]6j;
commentary: [n]评述;评论,评论文章;(广播员对球赛等的)实况报道,(电影的)解说词; [a]/ˈkɑːmənteri/; [or]6j;
diplomatic: [adj]外交的,从事外交的;老练的,圆滑的; [a]/ˌdɪpləˈmætɪk/; [or]6j;
formulation: [n]表述方式;构想,规划;公式化; [a]/ˌfɔːrmjuˈleɪʃn/; [or]6j;
faith: [n]信任;信心;信仰;  int. 实在,确实; [a]/feɪθ/; [or]6j;
ultraviolet: [adj]紫外线;紫外线的; [a]/ˌʌltrəˈvaɪələt/; [or]6j;
knight: [n]骑士;  [v]授以爵位; [a]/naɪt/; [or]6j;
caption: [n](报刊的)标题;(插图,照片等的)说明文字;  [v]给(图片,照片等)加说明文字; [a]/ˈkæpʃn/; [or]6j;
prevail: [v]流行,盛行;战胜,压倒; [a]/prɪˈveɪl/; [or]6j;
walnut: [n]核桃,胡桃;核桃树;胡桃木; [a]/ˈwɔːlnʌt/; [or]6j;
investigate: [v]调查,研究; [a]/ɪnˈvestɪɡeɪt/; [or]6j;
frightful: [adj]可怕的;惊人的;使惊恐的;讨厌的;非常的; [a]/ˈfraɪtfl/; [or]6j;
scrap: [n]碎片;口角,吵架;小块,小片;废金属;残羹冷炙;  [v]报废;舍弃;打架; [a]/skræp/; [or]6j;
continual: [adj]不断的;连续的;频繁的; [a]/kənˈtɪnjuəl/; [or]6j;
tick: [n]勾号,(钟表)滴答声,一刹那;  [v]用勾作为记号,发出滴答声; [a]/tɪk/; [or]6j;
degrade: [v]贬低;降低品格(身价,价值等);分解;降低; [a]/dɪˈɡreɪd/; [or]6j;
characteristic: [n]特点;特性;特色;  [adj]典型的;特有的;独特的; [a]/ˌkærəktəˈrɪstɪk/; [or]6j;
momentary: [adj]短暂的,瞬间的; [a]/ˈmoʊmənteri/; [or]6j;
savage: [n]野蛮人,粗鲁的人;  [adj]凶猛的,猛烈的;野蛮的;未驯化的;  [v](狗等)乱咬;激烈抨击; [a]/ˈsævɪdʒ/; [or]6j;
intrigue: [n]阴谋;诡计;  [v]密谋;欺骗;引起极大兴趣; [a]/ɪnˈtriːɡ/; [or]6j;
helmet: [n]钢盔;头盔;盔形物;  [vt]给.戴头盔; [a]/ˈhelmɪt/; [or]6j;
wring: [v]扭,榨取,强求;绞,拧,扭(尤指脖子);  [n]扭,榨取,强求;折磨; [a]/rɪŋ/; [or]6j;
snack: [n]零食,小吃,快餐; [a]/snæk/; [or]6j;
courtesy: [n]礼貌; [a]/ˈkɜːrtəsi/; [or]6j;
neighbouring: [adj]附近的,毗邻的; [a]/ˈneɪbərɪŋ/; [or]6j;
ethnic: [adj]种族的,少数民族的;  [n]少数民族成员;人种学; [a]/ˈeθnɪk/; [or]6j;
verbal: [adj]言语的,口头的,动词的; [a]/ˈvɜːrbl/; [or]6j;
fabulous: [adj]极好的;极妙的;极为巨大的;寓言中的;传说中的; [a]/ˈfæbjələs/; [or]6j;
puff: [v]喷出;膨胀,肿胀;吹捧;一口口抽烟;  [n]一口(气味,烟雾);一阵,一股;喷出;粉扑;呼吸;  [adj]吹嘘的; [a]/pʌf/; [or]6j;
diplomat: [n]外交官,外交家;有交际手腕的人,圆滑的人; [a]/ˈdɪpləmæt/; [or]6j;
evident: [adj]显然的,明显的,明白的; [a]/ˈevɪdənt/; [or]6j;
conventional: [adj]普通的,常规的;依照惯例的,依照传统的; [a]/kənˈvenʃənl/; [or]6j;
pore: [n]毛孔,细孔;  [v]深思熟虑,仔细阅读,审视; [a]/pɔːr/; [or]6j;
factor: [n]因素;[数]因子,商; [a]/ˈfæktər/; [or]6j;
consensus: [n]一致同意,合意; [a]/kənˈsensəs/; [or]6j;
literate: [adj]受过教育的;精通文学的;  [n]学者; [a]/ˈlɪtərət/; [or]6j;
autonomous: [adj]自动驾驶的;自治的,独立自主的;自主的; [a]/ɔːˈtɑːnəməs/; [or]6j;
upgrade: [v]升级;提高;  [n]改善,提高;升级;升舱; [a]/ˈʌpɡreɪd/; [or]6j;
bruise: [n](人体组织或表皮等跌,碰撞后产生的)青肿,挫伤;碰伤;  [v]撞伤,碰伤,(使)挫伤,擦伤(表皮,表面);打击;擦伤; [a]/bruːz/; [or]6j;
betrayal: [n]背叛;辜负;暴露; [a]/bɪˈtreɪəl/; [or]6j;
startle: [v]吃惊;惊吓; [a]/ˈstɑːrtl/; [or]6j;
exquisite: [adj]精致的,精选的;细腻的;强烈的;  [n]过分讲究穿戴的人; [a]/ɪkˈskwɪzɪt/; [or]6j;
supervise: [v]监督;指导;管理; [a]/ˈsuːpərvaɪz/; [or]6j;
patriot: [n]爱国者; [a]/ˈpeɪtriət/; [or]6j;
thoughtless: [adj]欠考虑的,轻率的;不体贴人的; [a]/ˈθɔːtləs/; [or]6j;
membership: [n]会员资格;成员资格; [a]/ˈmembərʃɪp/; [or]6j;
criterion: [n]标准,准则; [a]/kraɪˈtɪriən/; [or]6j;
subtract: [v]减少;减去;扣除;  [vt]减去; [a]/səbˈtrækt/; [or]6j;
tentative: [adj]试探性的;不确定的;暂时的;犹豫不决的; [a]/ˈtentətɪv/; [or]6j;
calibration: [n]校准刻度;校正;口径测定; [a]/ˌkælɪˈbreɪʃn/; [or]6j;
chord: [n]和弦;和音;心弦;(数学)弦; [a]/kɔːrd/; [or]6j;
cliff: [n]悬崖;峭壁; [a]/klɪf/; [or]6j;
commonwealth: [n]联邦; [a]/ˈkɑːmənwelθ/; [or]6j;
equip: [v]装备;具备; [a]/ɪˈkwɪp/; [or]6j;
transaction: [n]交易;办理;事务;学报; [a]/trænˈzækʃn/; [or]6j;
straighten: [v](使)弄直,伸直; [a]/ˈstreɪtn/; [or]6j;
encouragement: [n]鼓励;激励; [a]/ɪnˈkɜːrɪdʒmənt/; [or]6j;
character: [n]人物,角色;性格;(书写或印刷)符号,(汉)字;特点;人格,品性; [a]/ˈkærəktər/; [or]6j;
tunnel: [n]隧道;  [v]挖地道; [a]/ˈtʌnl/; [or]6j;
inherit: [v]经遗传而得(特性等);接受遗产;沿袭;继任; [a]/ɪnˈherɪt/; [or]6j;
taper: [v]逐渐变细;  [n]锥形;渐弱;蜡芯,小蜡烛;  [vi]变尖;逐渐减弱;  [vt]变尖;逐渐减弱;  [adj]渐细的;斜的;依次递减的; [a]/ˈteɪpər/; [or]6j;
basis: [n]基础,根据;原因,缘由;基准; [a]/ˈbeɪsɪs/; [or]6j;
keen: [adj]敏锐的;热衷的,热心的;强烈的,渴望的;  [v]恸哭;  [n]〈英〉号哭,恸哭;  [adv]如饥似渴地; [a]/kiːn/; [or]6j;
esthetic: [adj]美学的;悦目的;美的;  [n]审美观,美学;审美家; [a]/esˈθetɪk/; [or]6j;
prophecy: [n]预言书;预言,预言能力; [a]/ˈprɑːfəsi/; [or]6j;
tendency: [n]趋向,趋势,倾向;癖好,意向;派别; [a]/ˈtendənsi/; [or]6j;
hug: [v]紧抱;拥抱;  [n]拥抱; [a]/hʌɡ/; [or]6j;
methodology: [n]方法论,方法学;(某一学科的)一套方法; [a]/ˌmeθəˈdɑːlədʒi/; [or]6j;
despatch: [v]发送;派遣;打败;  [n](公文)急件;(记者发回的)新闻报道;派遣; [a]/dɪˈspætʃ/; [or]6j;
collaboration: [n]合作,协作;勾结; [a]/kəˌlæbəˈreɪʃn/; [or]6j;
disgrace: [n]耻辱;不光彩;失宠;  [v]使丢脸,给.带来耻辱;使失宠; [a]/dɪsˈɡreɪs/; [or]6j;
narrative: [n]叙述;  [adj]叙述的; [a]/ˈnærətɪv/; [or]6j;
stumble: [v]绊跌,绊倒;结结巴巴说话;  [n]绊倒;失足;失误;失败; [a]/ˈstʌmbl/; [or]6j;
criminal: [n]罪犯;  [adj]犯罪的,违法的,刑法的;可耻的; [a]/ˈkrɪmɪnl/; [or]6j;
grief: [n](因不幸,丧失等而)悲伤,悲痛;悲痛的缘由,伤心事;担心,忧虑; [a]/ɡriːf/; [or]6j;
roam: [v]闲逛,漫步,徘徊;眼睛或手(缓慢地)扫遍;  [n]漫步,漫游; [a]/roʊm/; [or]6j;
whitewash: [v]用石灰水把..刷白;  [n]石灰水,白色涂料,白粉胶泥水,涂脂抹粉; [a]/ˈwaɪtwɑːʃ/; [or]6j;
cafeteria: [n]自助食堂;自助餐馆; [a]/ˌkæfəˈtɪriə/; [or]6j;
scheme: [n]方案,计划;阴谋,诡计;  [v]图谋,密谋;  [adj]计划的; [a]/skiːm/; [or]6j;
gramophone: [n]留声机; [a]/ˈɡræməfoʊn/; [or]6j;
luminous: [adj]发光的;鲜艳的;明亮的;夜光的; [a]/ˈluːmɪnəs/; [or]6j;
dismiss: [v]开除;解散;摒除,不再考虑; [a]/dɪsˈmɪs/; [or]6j;
composer: [n]作曲家,设计者,著作者; [a]/kəmˈpoʊzər/; [or]6j;
inhibit: [v]阻碍;阻止,防止;抑制,约束; [a]/ɪnˈhɪbɪt/; [or]6j;
revive: [v](使)苏醒;(使)复苏;再兴起;重做; [a]/rɪˈvaɪv/; [or]6j;
pant: [v]喘息;气喘吁吁地说;喘气;  [n]喘气; [a]/pænt/; [or]6j;
blossom: [v]开花,兴旺,长成;  [n](果树的)花; [a]/ˈblɑːsəm/; [or]6j;
shrill: [adj]尖声的,刺耳的;  [vi]尖叫;  [vt]尖叫着说;  [n]尖叫声;  [adv]尖声地,无节制地; [a]/ʃrɪl/; [or]6j;
veto: [v]否决;投反对票;  [n]否决;否决权;禁止; [a]/ˈviːtoʊ/; [or]6j;
academy: [n]学院; [a]/əˈkædəmi/; [or]6j;
administer: [v]管理;执行;实施;给予;用(药); [a]/ədˈmɪnɪstər/; [or]6j;
dizzy: [adj]眩晕的,头晕目眩的,头昏眼花的;  [vt]使头晕目眩;使困惑; [a]/ˈdɪzi/; [or]6j;
format: [n]版式;设计;格式;  [v]设计一个版式;使格式化;设计.的版面; [a]/ˈfɔːrmæt/; [or]6j;
cellar: [n]地窖;地下室;酒窖; [a]/ˈselər/; [or]6j;
inferior: [adj](等级,地位等)下等的,低等的;低劣的;  [n]部下,地位低的人;次品; [a]/ɪnˈfɪriər/; [or]6j;
legal: [adj]合法的,法定的;法律的; [a]/ˈliːɡl/; [or]6j;
spectacular: [adj]壮观的,引人入胜的;  [n]壮观的场面,精彩的表演; [a]/spekˈtækjələr/; [or]6j;
fore: [adj]在前部的,以前的;  [adv]在前面,在船头;  [n]前部,船头;  prep. 在前; [a]/fɔːr/; [or]6j;
invalid: [adj]不能识别的;无效的;作废的,不能成立的;  [n]病人,残疾人; [a]/ɪnˈvælɪd/; [or]6j;
cosmopolitan: [n]游历四方的人;  [adj]见多识广的;多元的;广泛分布的; [a]/ˌkɑːzməˈpɑːlɪtən/; [or]6j;
intimidate: [v]恫吓,威胁; [a]/ɪnˈtɪmɪdeɪt/; [or]6j;
scrutiny: [n]监视,细看,详细检查,仔细观察; [a]/ˈskruːtəni/; [or]6j;
hatch: [n]船舱盖;  [v]孵出,孵;策划; [a]/hætʃ/; [or]6j;
grim: [adj]严酷的,无情的;令人沮丧的,令人失望的;讨厌的,糟糕的; [a]/ɡrɪm/; [or]6j;
cleanliness: [n]清洁;洁癖; [a]/ˈklenlinəs/; [or]6j;
hydraulic: [adj]水力的,水压的; [a]/haɪˈdrɔːlɪk/; [or]6j;
reproduction: [n]复制;繁殖;复制品;再现; [a]/ˌriːprəˈdʌkʃn/; [or]6j;
protein: [n]蛋白质;  [adj]蛋白质的; [a]/ˈproʊtiːn/; [or]6j;
restrict: [v]限制;约束; [a]/rɪˈstrɪkt/; [or]6j;
pledge: [v]发誓,保证,以.抵押,向.祝酒;  [n]保证,誓言; [a]/pledʒ/; [or]6j;
dilute: [v]使变淡,稀释;使病弱; [a]/daɪˈluːt/; [or]6j;
plague: [n]瘟疫;灾难;麻烦;  [v]折磨;烦扰;造成麻烦; [a]/pleɪɡ/; [or]6j;
competence: [n]能力,胜任,称职; [a]/ˈkɑːmpɪtəns/; [or]6j;
author: [n]作者;发起人;  [v]成为作家; [a]/ˈɔːθər/; [or]6j;
tow: [v]拖,牵引;拉; [a]/toʊ/; [or]6j;
excel: [vi]胜出;  [vt]优于; [a]/ɪkˈsel/; [or]6j;
leather: [n]皮革;皮制品;  [vt]用皮鞭抽打;用皮革覆盖; [a]/ˈleðər/; [or]6j;
auditory: [adj]听觉的; [a]/ˈɔːdətɔːri/; [or]6j;
skip: [v]跳过;略过;遗漏;  [n]跳跃;跳读;省略; [a]/skɪp/; [or]6j;
Egyptian: [n]埃及人; [a]/iˈdʒɪpʃn/; [or]6j;
ethics: [n]行为准则;道德规范; [a]/'eθɪks/; [or]6j;
waxy: [adj]蜡制的;蜡质的;似蜡的; [a]/ˈwæksi/; [or]6j;
dynamo: [n]发电机;精力充沛的人; [a]/ˈdaɪnəmoʊ/; [or]6j;
enrich: [v]使丰富;使富裕; [a]/ɪnˈrɪtʃ/; [or]6j;
elegant: [adj]优美的,文雅的,漂亮雅致的,陈设讲究的; [a]/ˈelɪɡənt/; [or]6j;
revenue: [n]收入;财政收入;国家的税收; [a]/ˈrevənuː/; [or]6j;
passion: [n]激情; [a]/ˈpæʃn/; [or]6j;
jewelry: [n]珠宝; [a]/ˈdʒuːəlri/; [or]6j;
cancer: [n]癌,癌症;迅速蔓延的恶劣的或危险的事物; [a]/ˈkænsər/; [or]6j;
terrorist: [n]恐怖主义者; [a]/ˈterərɪst/; [or]6j;
drainage: [n]排水;排水系统;污水;下水道; [a]/ˈdreɪnɪdʒ/; [or]6j;
lounge: [n]候机室,休息室,酒吧间;沙发,躺椅;懒散的步子;  [v](懒散地)倚,躺;闲逛; [a]/laʊndʒ/; [or]6j;
definitely: [adv]一定地,明确地;当然; [a]/ˈdefɪnətli/; [or]6j;
inclination: [n]点头;做.的倾向;意愿;倾斜; [a]/ˌɪnklɪˈneɪʃn/; [or]6j;
administration: [n]管理;管理层,管理部门;政府;(药的)配给; [a]/ədˌmɪnɪˈstreɪʃn/; [or]6j;
mentality: [n]脑力;思想;心理; [a]/menˈtæləti/; [or]6j;
subscription: [n]订阅;捐款;签署;同意;会费;  [adj]收费的; [a]/səbˈskrɪpʃn/; [or]6j;
menace: [v]威胁,威吓;  [n]威胁;具有危险性的人(或物); [a]/ˈmenəs/; [or]6j;
groove: [n][建]凹槽;最佳状态;槽;惯例;  [v]开槽于;形成沟槽; [a]/ɡruːv/; [or]6j;
studio: [n]摄影棚;工作室;录音室;单间公寓(studio flat);制片公司; [a]/ˈstuːdioʊ/; [or]6j;
novelty: [n]新奇;新奇的事物;新颖小巧而廉价的小物品;  [adj]新奇的;风格独特的; [a]/ˈnɑːvlti/; [or]6j;
illiterate: [n]文盲,目不识丁者;  [adj]不识字的;缺乏(某方面)知识的;语法错误的; [a]/ɪˈlɪtərət/; [or]6j;
theme: [n]主题;主旨;主旋律;  [adj]主题的;  [v]赋予.某种主题; [a]/θiːm/; [or]6j;
preach: [v]传教,布道;说教;宣扬; [a]/priːtʃ/; [or]6j;
token: [n]象征;礼券,代金券;筹码,代币;  [adj]象征性的; [a]/ˈtoʊkən/; [or]6j;
cutter: [n]刀具,切割机;小汽艇;独桅纵帆船; [a]/ˈkʌtər/; [or]6j;
resolute: [adj]坚决的;果断的; [a]/ˈrezəluːt/; [or]6j;
expertise: [n]专长,专门的知识或技能; [a]/ˌekspɜːrˈtiːz/; [or]6j;
poll: [n]投票,投票数;投票站;民意测验;  [v]获得(票数);  [adj][法]当事人一方作成的; [a]/poʊl/; [or]6j;
wield: [v]运用,行使;挥;  [vt]使用; [a]/wiːld/; [or]6j;
device: [n]器械,装置,设备;手段,策略; [a]/dɪˈvaɪs/; [or]6j;
occupy: [v]占领,占据,侵占;住在,居住,住进;担任(职务),任职;占用(时间,空间等),占有;使用(房屋,建筑); [a]/ˈɑːkjupaɪ/; [or]6j;
disaster: [n]灾难,天灾; [a]/dɪˈzæstər/; [or]6j;
hinder: [v]阻碍,妨碍;  [adj]后面的,后方的; [a]/ˈhɪndər/; [or]6j;
donate: [v]捐献;捐赠;  [vi]捐献;捐赠; [a]/ˈdoʊneɪt/; [or]6j;
engagement: [n]交战,战斗;约会,约定;婚约,订婚; [a]/ɪnˈɡeɪdʒmənt/; [or]6j;
conduct: [v]指挥;进行;实施;处理;传导(电,热等);护送;  [n]行为,举止;指挥,带领; [a]/kənˈdʌkt/; [or]6j;
cosmic: [adj]宇宙的;广大无边的; [a]/ˈkɑːzmɪk/; [or]6j;
confusion: [n]困惑;混淆;混乱;窘迫; [a]/kənˈfjuːʒn/; [or]6j;
grill: [n]烤架;  [v]烤;拷问; [a]/ɡrɪl/; [or]6j;
avert: [v]转移(目光,注意力等);防止;避开; [a]/əˈvɜːrt/; [or]6j;
exposition: [n]讲解;阐述;展览会,博览会; [a]/ˌekspəˈzɪʃn/; [or]6j;
obscene: [adj]下流的,淫秽的; [a]/əbˈsiːn/; [or]6j;
dictate: [v]规定;命令;口授;听写;  [n]命令;指令; [a]/ˈdɪkteɪt/; [or]6j;
tackle: [v]对付,处理;(足球等比赛中)阻截;  [n]阻截;钓具;滑轮(组); [a]/ˈtækl/; [or]6j;
drag: [v]拉,拽,拖着(沉重的步伐或疲惫的身躯);拖动,拖沓;  [n]拖,拖累物;  [adj]女穿男服的;男穿女服的;  [adv]带有女伴; [a]/dræɡ/; [or]6j;
dwarf: [n]侏儒;  [v]变矮;发育不全;  [adj]矮生动物或植物的;矮小的;发育不全的;  [vt]使矮小;阻碍.的发育; [a]/dwɔːrf/; [or]6j;
pilgrim: [n]朝圣客;香客; [a]/ˈpɪlɡrɪm/; [or]6j;
conserve: [v]保藏,保存;节约;  [n]蜜饯,果酱; [a]/kənˈsɜːrv/; [or]6j;
inscribe: [v]刻; [a]/ɪnˈskraɪb/; [or]6j;
ego: [n]自我;自负;自尊心; [a]/ˈiːɡoʊ/; [or]6j;
peel: [v]剥皮,削皮,去壳;  [n]果皮,外皮; [a]/piːl/; [or]6j;
photoelectric: [adj]光电的; [a]/ˌfoʊtoʊɪˈlektrɪk/; [or]6j;
subdue: [v]征服,压制,减轻; [a]/səbˈduː/; [or]6j;
conqueror: [n]征服者,胜利者; [a]/ˈkɑːŋkərər/; [or]6j;
exhibit: [n]展览会,陈列品;  [v]展览,陈列; [a]/ɪɡˈzɪbɪt/; [or]6j;
heighten: [v]加强,增加,提高; [a]/ˈhaɪtn/; [or]6j;
assemble: [v]装配(机器等);集合;召集; [a]/əˈsembl/; [or]6j;
surge: [n]波涛汹涌;波动;激增;  [v]波浪般汹涌奔腾;激增; [a]/sɜːrdʒ/; [or]6j;
militant: [adj]好战的,好暴力的;  [n]激进分子,斗士; [a]/ˈmɪlɪtənt/; [or]6j;
conservative: [adj]保守的;保守估计的;保守党的;  [n]保守主义者;保守党党员; [a]/kənˈsɜːrvətɪv/; [or]6j;
jury: [n]陪审团;全体评审员,评判委员会; [a]/ˈdʒʊri/; [or]6j;
amateur: [n]业余爱好者;外行;  [adj]外行的;业余爱好的,业余(身份)的; [a]/ˈæmətʃər/; [or]6j;
clash: [vi]发生冲突;发出撞击声;不合,不一致,不调和;  [n]冲突;抵触;撞击声; [a]/klæʃ/; [or]6j;
severe: [adj]严重的;严厉的;严酷的;剧烈的; [a]/sɪˈvɪr/; [or]6j;
fabrication: [n]制作;构成;捏造;伪造物;装配工; [a]/ˌfæbrɪˈkeɪʃn/; [or]6j;
turnover: [n]成交量;营业收入;人员更替率;半圆卷饼; [a]/ˈtɜːrnoʊvər/; [or]6j;
bridle: [n]马笼头,缰绳;  [v]上笼头;昂首(表傲慢,愤怒等);抑制,控制; [a]/ˈbraɪdl/; [or]6j;
xerox: [v]复印; [a]/ˈzɪrɑːks/; [or]6j;
aggregate: [n]合计;总数;混凝料;总计;  [v]集合;聚集;合计;  [adj]总的,总数的;集合的; [a]/ˈæɡrɪɡət/; [or]6j;
overt: [adj]明显的;公开的;公然的; [a]/oʊˈvɜːrt/; [or]6j;
tulip: [n][植]郁金香; [a]/ˈtuːlɪp/; [or]6j;
attempt: [n]尝试;企图;  [vt]努力去做;试图,尝试; [a]/əˈtempt/; [or]6j;
prune: [n]梅干;  [v]修剪;削减; [a]/pruːn/; [or]6j;
premise: [n]前提;房屋地基;  [v]假定; [a]/ˈpremɪs/; [or]6j;
sensitivity: [n]灵敏性;敏感; [a]/ˌsensəˈtɪvəti/; [or]6j;
goddess: [n]女神;绝代佳人; [a]/ˈɡɑːdəs/; [or]6j;
existence: [n]存在;生活方式; [a]/ɪɡˈzɪstəns/; [or]6j;
majority: [n]多数,大多数,多数票;法定成年年龄; [a]/məˈdʒɔːrəti/; [or]6j;
score: [n]得分;刻痕;二十;配乐;  [vi]刻痕;  [v]得分;  [vt]在.上刻痕; [a]/skɔːr/; [or]6j;
axis: [n]轴;中心线;坐标轴;基准线; [a]/ˈæksɪs/; [or]6j;
hull: [n](果实等的)外壳,船体;  [v]剥壳; [a]/hʌl/; [or]6j;
progressive: [adj]进步的;逐步的,渐进的;  [n]进步人士; [a]/prəˈɡresɪv/; [or]6j;
faculty: [n]教职工,全体教员;系;科;能力; [a]/ˈfæklti/; [or]6j;
enchant: [v]施魔法于;吸引; [a]/ɪnˈtʃænt/; [or]6j;
thorn: [n]刺;荆棘;带刺小灌木; [a]/θɔːrn/; [or]6j;
pitch: [v]投掷;用沥青覆盖;[音]为...定音高;扎营;搭帐篷;  [n]投掷;球场;沥青;音高; [a]/pɪtʃ/; [or]6j;
bless: [v]保佑,祝福,赐福,有幸具有; [a]/bles/; [or]6j;
jerk: [v]猛拉;使猝然一动;  [n]急推;急拉;蠢货;古怪的人;腌制品;  [adj]颠簸不稳的; [a]/dʒɜːrk/; [or]6j;
reverse: [n]失败,挫折,倒退;相反,背面;  [v]颠倒,翻转;  [adj]相反的,反面的,颠倒的; [a]/rɪˈvɜːrs/; [or]6j;
booklet: [n]小册子; [a]/ˈbʊklət/; [or]6j;
assessment: [n]评估;评价;估价; [a]/əˈsesmənt/; [or]6j;
territory: [n]地区,领土;版图;领域;范围;属地; [a]/ˈterətɔːri/; [or]6j;
fling: [v]掷,抛;猛烈地移动;投入;  [n]尽情欢乐的一阵,一时的放纵; [a]/flɪŋ/; [or]6j;
overload: [n]过载;过重负担;过度刺激;  [v]使超载,使过载;使负担(或负荷)过重; [a]/ˌoʊvərˈloʊd/; [or]6j;
aggressive: [adj]好斗的,挑衅性的;有闯劲的,积极进取的; [a]/əˈɡresɪv/; [or]6j;
maintain: [v]维持,保持;断言,宣称;供养,赡养; [a]/meɪnˈteɪn/; [or]6j;
infant: [n]幼儿,婴儿;  [adj]婴儿的;初期的,初创的; [a]/ˈɪnfənt/; [or]6j;
ambitious: [adj]有抱负的;雄心勃勃的;(计划,想法等)宏大的,艰巨的; [a]/æmˈbɪʃəs/; [or]6j;
roundabout: [n]环形路;旋转木马;  [adj]绕远道的;迂回的;转弯抹角的; [a]/ˈraʊndəbaʊt/; [or]6j;
frock: [n]僧袍;(妇女,小儿的连衣裙式)长衣; [a]/frɑːk/; [or]6j;
cluster: [n]一串;一簇;  [v]群集;丛生; [a]/ˈklʌstər/; [or]6j;
juvenile: [n]青少年;雏鸟;  [adj]青少年的;幼稚的; [a]/ˈdʒuːvənl/; [or]6j;
monster: [n]怪物,怪兽,妖怪;巨兽,巨大的东西,庞然大物;极其残酷的人,恶人,恶魔;小恶棍,捣蛋鬼〔幽默用法〕;  [adj]巨大的;庞大的; [a]/ˈmɑːnstər/; [or]6j;
majesty: [n]最高权威;雄伟;壮丽;帝王; [a]/ˈmædʒəsti/; [or]6j;
multitude: [n]大量;众多;大批;群众; [a]/ˈmʌltɪtuːd/; [or]6j;
monetary: [adj]货币的,金融的;金钱的; [a]/ˈmɑːnɪteri/; [or]6j;
inhabitant: [n]居民,住户; [a]/ɪnˈhæbɪtənt/; [or]6j;
velocity: [n]速度;迅速,快速; [a]/vəˈlɑːsəti/; [or]6j;
comprehend: [v]由.组成;了解;领会;包含; [a]/ˌkɑːmprɪˈhend/; [or]6j;
devastating: [adj]毁灭性的;惊人的;令人难受的; [a]/ˈdevəsteɪtɪŋ/; [or]6j;
disappearance: [n]失踪,消失;绝迹; [a]/ˌdɪsəˈpɪrəns/; [or]6j;
compatible: [adj]可和谐共存的;兼容的; [a]/kəmˈpætəbl/; [or]6j;
inspection: [n]检查,细看; [a]/ɪnˈspekʃn/; [or]6j;
profess: [v]表示,承认;宣称; [a]/prəˈfes/; [or]6j;
panther: [n]豹;黑豹; [a]/ˈpænθər/; [or]6j;
compile: [v]收集,汇编; [a]/kəmˈpaɪl/; [or]6j;
recognition: [n]承认,认可;认出;认识; [a]/ˌrekəɡˈnɪʃn/; [or]6j;
jail: [n]监狱;看守所;  [v]监禁;拘留; [a]/dʒeɪl/; [or]6j;
planet: [n]行星; [a]/ˈplænɪt/; [or]6j;
constraint: [n]限制;强迫,拘束;强制; [a]/kənˈstreɪnt/; [or]6j;
sneeze: [n]喷嚏;  [v]打喷嚏; [a]/sniːz/; [or]6j;
expanding: [adj]扩展的;详述的;  [v]扩大;扩展; [a]/ɪkˈspændɪŋ/; [or]6j;
annually: [adv]一年一次;每年; [a]/ˈænjuəli/; [or]6j;
riot: [v]闹事;  [n]骚乱;暴乱;骚动;放纵; [a]/ˈraɪət/; [or]6j;
rash: [adj]轻率的,鲁莽的;  [n]疹,皮疹;(短时期内)爆发的一连串; [a]/ræʃ/; [or]6j;
absurd: [adj]荒唐的;可笑的;不合理的;  [n]荒唐; [a]/əbˈsɜːrd/; [or]6j;
wrinkle: [n]皱纹,褶皱;窍门;转折,改变;  [v](使)起褶皱; [a]/ˈrɪŋkl/; [or]6j;
ally: [n]盟友;同盟国;(二战时的) 同盟国;  [v]结盟; [a]/ˈælaɪ/; [or]6j;
dock: [n]码头;船埠;被告席;  [v](船)进港;扣工资;剪短(动物的尾巴); [a]/dɑːk/; [or]6j;
explicit: [adj]充分表达清楚的,明确的;直率的,直截了当的;〔描绘性或暴力的语言或画面〕清晰露骨的; [a]/ɪkˈsplɪsɪt/; [or]6j;
microscopic: [adj]极小的;用显微镜可见的; [a]/ˌmaɪkrəˈskɑːpɪk/; [or]6j;
variation: [n]变异,变化,变奏曲;[生物] 变异,变种;差异; [a]/ˌveriˈeɪʃn/; [or]6j;
coincidence: [n]一致;巧合,巧事;同时发生; [a]/koʊˈɪnsɪdəns/; [or]6j;
migration: [n]迁移;移民;移动; [a]/maɪˈɡreɪʃn/; [or]6j;
database: [n]数据库; [a]/ˈdeɪtəbeɪs/; [or]6j;
access: [n]进入;使用权;通道;  [v]进入;访问; [a]/ˈækses/; [or]6j;
grease: [n]油脂;动物脂;润滑脂;  [v]抹油;使润滑; [a]/ɡriːs/; [or]6j;
testify: [vt]作证;  [vi]证明;  [v]声明;见证(上帝的存在);证实; [a]/ˈtestɪfaɪ/; [or]6j;
hostess: [n]女主人,女主持人,女服务员(乘务员); [a]/ˈhoʊstəs/; [or]6j;
pharmacy: [n]药房,药剂学,配药业,制药业,一批备用药品; [a]/ˈfɑːrməsi/; [or]6j;
invoice: [n]发票;  [v]开发票;记清单; [a]/ˈɪnvɔɪs/; [or]6j;
skeleton: [n]骨骼,梗概;骨瘦如柴的人或动物; [a]/ˈskelɪtn/; [or]6j;
vice: [n]缺点;恶习;邪恶;罪行;生理缺陷;  [adj]副的;代理的;  pref. 代理的;  [vt]用老虎钳夹紧;钳制; [a]/vaɪs/; [or]6j;
maximum: [n]最大值;最大限度;  [adj]最大的; [a]/ˈmæksɪməm/; [or]6j;
spice: [n]香料,调味品;额外的趣味;  [v]使增添趣味;加香料于; [a]/spaɪs/; [or]6j;
economy: [n]经济,经济制度;节约; [a]/ɪˈkɑːnəmi/; [or]6j;
update: [v]更新;为..提供最新信息;  [n]更新;最新的情况; [a]/ˌʌpˈdeɪt/; [or]6j;
embryo: [n][动物学]胚胎; [a]/ˈembrioʊ/; [or]6j;
property: [n]房产;财产;特性;性能; [a]/ˈprɑːpərti/; [or]6j;
violent: [adj]强烈的,猛烈的;暴力的,粗暴的; [a]/ˈvaɪələnt/; [or]6j;
defendant: [n]被告; [a]/dɪˈfendənt/; [or]6j;
innumerable: [adj]数不清的;无数的; [a]/ɪˈnuːmərəbl/; [or]6j;
sensitive: [adj]敏感的,过敏的;灵敏的;善解人意的,体恤的; [a]/ˈsensətɪv/; [or]6j;
convince: [v]使确信;使信服; [a]/kənˈvɪns/; [or]6j;
tolerant: [adj]容忍的,宽容的; [a]/ˈtɑːlərənt/; [or]6j;
version: [n]版本;译文;(某人对于某件事不同于其他人的)描述,说法; [a]/ˈvɜːrʒn/; [or]6j;
emotion: [n]感情;情绪;强烈的感情;激动; [a]/ɪˈmoʊʃn/; [or]6j;
jack: [n]千斤顶;[牌戏]J牌;插座,插口;  [adj]对..感到厌烦的;  [v]偷窃(特别是价值低的物品); [a]/dʒæk/; [or]6j;
longevity: [n]长寿,长命;寿命; [a]/lɔːnˈdʒevəti/; [or]6j;
triumph: [n]喜悦,狂喜;凯旋,胜利;  [v]成功,获胜; [a]/ˈtraɪʌmf/; [or]6j;
napkin: [n]纸巾,餐巾,(小孩用的)尿布; [a]/ˈnæpkɪn/; [or]6j;
constitution: [n]宪法,章程;组成,结构;体质,体格; [a]/ˌkɑːnstəˈtuːʃn/; [or]6j;
baron: [n]男爵(英国世袭的最低级的贵族爵位),大财主; [a]/ˈbærən/; [or]6j;
prejudice: [n]偏见;成见;损害;侵害;  [vt]使抱偏见; [a]/ˈpredʒudɪs/; [or]6j;
imaginative: [adj]想象的;富于想象力的;虚构的; [a]/ɪˈmædʒɪnətɪv/; [or]6j;
glare: [v]怒目而视;发出强光;  [n]眩目的光;瞪眼; [a]/ɡler/; [or]6j;
mob: [n]乌合之众,(尤指)暴民;  [v](指民众)包围(为攻击或赞赏); [a]/mɑːb/; [or]6j;
declaration: [n]宣言,声明书;宣布,宣告;申报; [a]/ˌdekləˈreɪʃn/; [or]6j;
wasp: [n]黄蜂; [a]/wɑːsp/; [or]6j;
diligent: [adj]勤奋的;用功的; [a]/ˈdɪlɪdʒənt/; [or]6j;
decay: [v]腐烂;衰退;腐朽;  [n]腐烂;衰退;腐败; [a]/dɪˈkeɪ/; [or]6j;
qualitative: [adj](性)质的,定性的; [a]/ˈkwɑːləteɪtɪv/; [or]6j;
vast: [adj]辽阔的;巨大的; [a]/væst/; [or]6j;
crisp: [adj]脆的,易碎的,霜冻的,干脆的;  [n]油炸马铃薯片;  [v](使)发脆; [a]/krɪsp/; [or]6j;
superintendent: [n]主管人,负责人;警长;监督人; [a]/ˌsuːpərɪnˈtendənt/; [or]6j;
prism: [n]棱镜;棱柱; [a]/ˈprɪzəm/; [or]6j;
solo: [n]独唱;  [adj]独奏的;单独的;  [adv]独奏地;单独地;  [v]放单飞; [a]/ˈsoʊloʊ/; [or]6j;
burden: [n]负担,重担;  [v]使负重,装载;烦扰; [a]/ˈbɜːrdn/; [or]6j;
depress: [vt]使沮丧;使萧条;压下,压低; [a]/dɪˈpres/; [or]6j;
herb: [n]草本植物;药草; [a]/ɜːrb/; [or]6j;
alloy: [n]合金;  [v]使成合金; [a]/ˈælɔɪ/; [or]6j;
conviction: [n]定罪;信服;坚强信念; [a]/kənˈvɪkʃn/; [or]6j;
intelligent: [adj]聪明的;智能的; [a]/ɪnˈtelɪdʒənt/; [or]6j;
allocate: [v]分配,配给; [a]/ˈæləkeɪt/; [or]6j;
exemplify: [v]举例说明;例示,是..的典范; [a]/ɪɡˈzemplɪfaɪ/; [or]6j;
blaze: [vi]熊熊燃烧;闪耀;怒视;连续射击;  [vt]大肆宣扬;  [n]火焰; [a]/bleɪz/; [or]6j;
fulfill: [v]履行,实现,完成;满足(愿望,要求等),使满意; [a]/fʊl'fɪl/; [or]6j;
distort: [v]扭曲,使变形;歪曲,曲解; [a]/dɪˈstɔːrt/; [or]6j;
transit: [n]运输;运送;  [v]运送;通过; [a]/ˈtrænzɪt/; [or]6j;
reservation: [n](住处,席位的)预订;保留态度,保留意见;(美国印第安部落的)居留地; [a]/ˌrezərˈveɪʃn/; [or]6j;
humanitarian: [n]慈善家;人道主义者;博爱主义者;  [adj]人道主义者的;慈善的;博爱的; [a]/hjuːˌmænɪˈteriən/; [or]6j;
manifestation: [n]表现,表示;显灵;示威运动; [a]/ˌmænɪfeˈsteɪʃn/; [or]6j;
stab: [v]刺伤;戳;  [n]刺痛;尝试,努力;一种突然强烈的感觉; [a]/stæb/; [or]6j;
pressure: [n]压力;压迫,[物] 压强;迫使;  [v]对..施加压力;密封; [a]/ˈpreʃər/; [or]6j;
appraisal: [n]评估;估价;评价; [a]/əˈpreɪzl/; [or]6j;
contempt: [n]轻视,鄙视; [a]/kənˈtempt/; [or]6j;
audible: [adj]听得见的; [a]/ˈɔːdəbl/; [or]6j;
tug: [v]用力拖(或拉);  [n]猛拉;牵引; [a]/tʌɡ/; [or]6j;
expenditure: [n](时间,金钱等的)花费,支出,消耗; [a]/ɪkˈspendɪtʃər/; [or]6j;
correctly: [adv]恰当地,正确地; [a]/kəˈrektli/; [or]6j;
hearing: [n]听觉;听距;听证会;申辩的机会;  [v]听到; [a]/ˈhɪrɪŋ/; [or]6j;
tangle: [v](使)缠结;(使)乱作一团;  [n]纠缠;纠结;复杂的问题;困惑; [a]/ˈtæŋɡl/; [or]6j;
misfortune: [n]不幸,灾祸; [a]/ˌmɪsˈfɔːrtʃuːn/; [or]6j;
versatile: [adj]万能的,综合的,多才多艺的; [a]/ˈvɜːrsətl/; [or]6j;
gathering: [n]聚会,集会; [a]/ˈɡæðərɪŋ/; [or]6j;
infinitely: [adv]无限地,无穷地; [a]/ˈɪnfɪnətli/; [or]6j;
valid: [adj]有效的,正式认可的;合理的,有根据的; [a]/ˈvælɪd/; [or]6j;
warning: [n]警告;预告;通知;预兆;  [adj]警告的;告诫的;引以为戒的;  [v]warn的现在进行时; [a]/ˈwɔːrnɪŋ/; [or]6j;
literacy: [n]读写能力;识字;有文化;教养; [a]/ˈlɪtərəsi/; [or]6j;
isle: [n]岛,小岛; [a]/aɪl/; [or]6j;
sniff: [n]嗅,吸气(声);  [v]嗅,吸气; [a]/snɪf/; [or]6j;
numerical: [adj]数字的,用数字表示的; [a]/nuːˈmerɪkl/; [or]6j;
compression: [n]浓缩;压缩,压紧;[机](内燃机的)压缩冲程; [a]/kəmˈpreʃn/; [or]6j;
transverse: [adj]横向的;横断的; [a]/ˈtrænzvɜːrs/; [or]6j;
counterpart: [n]对应的人(物);副本;对手; [a]/ˈkaʊntərpɑːrt/; [or]6j;
enlighten: [v]启发,开导; [a]/ɪnˈlaɪtn/; [or]6j;
overwhelm: [v]压垮;不知所措;淹没;打败,压倒; [a]/ˌoʊvərˈwelm/; [or]6j;
accessory: [n](妇女的)装饰品;附件;附属物;同谋;  [adj]附属的;辅助的;同谋的; [a]/əkˈsesəri/; [or]6j;
cult: [n]异教;风尚,热潮;信徒;  [adj]流行的;风靡一时的; [a]/kʌlt/; [or]6j;
boring: [adj]令人厌烦的;单调的;无聊的,乏味的; [a]/ˈbɔːrɪŋ/; [or]6j;
betray: [v]背叛;失信于;泄露(秘密等);(非故意地)暴露; [a]/bɪˈtreɪ/; [or]6j;
gorgeous: [adj]绚丽的;极好的;令人愉快的; [a]/ˈɡɔːrdʒəs/; [or]6j;
sediment: [n]沉渣,沉淀物,沉淀; [a]/ˈsedɪmənt/; [or]6j;
assimilate: [v]使同化;吸收;消化; [a]/əˈsɪməleɪt/; [or]6j;
moan: [n]呻吟声;呜咽声;怨声;牢骚;  [v]呻吟;呜咽;抱怨;发牢骚; [a]/moʊn/; [or]6j;
nightmare: [n]噩梦;可怕的情景;  [adj]可怕的,噩梦似的; [a]/ˈnaɪtmer/; [or]6j;
target: [n]目标;靶子;  [v]瞄准; [a]/ˈtɑːrɡɪt/; [or]6j;
afford: [v]买得起;抽得出时间;担负得起;提供;产生;赐予;  [vi]担负得起;买得起; [a]/əˈfɔːrd/; [or]6j;
complexity: [n]复杂,复杂的事物,复杂性; [a]/kəmˈpleksəti/; [or]6j;
soar: [v]高飞,翱翔;飞腾;猛增;高飞越过;  [n]高飞;高涨; [a]/sɔːr/; [or]6j;
stride: [v]大步走;越过;跨越;  [vt]大步走过;跨骑在.上;  [n]大步;阔步行走的姿势;一大步;跨越;正常的进展; [a]/straɪd/; [or]6j;
criticism: [n]批评;批判;评论; [a]/ˈkrɪtɪsɪzəm/; [or]6j;
champion: [n]冠军;拥护者,战士;  [v]拥护;保卫;为..而斗争;  [adj]夺得第一名的;优胜的; [a]/ˈtʃæmpiən/; [or]6j;
vicinity: [n]附近地区;近邻;附近; [a]/vəˈsɪnəti/; [or]6j;
rap: [n]饶舌歌;  [v]轻敲;表演说唱;严厉批评; [a]/ræp/; [or]6j;
suspension: [n]悬浮;暂停;停职; [a]/səˈspenʃn/; [or]6j;
propagate: [v]繁殖,增殖;  [vt]传播,宣传; [a]/ˈprɑːpəɡeɪt/; [or]6j;
divert: [v]使转向,使改道(或绕道);转移,转移.的注意力;使娱乐,使消遣; [a]/daɪˈvɜːrt/; [or]6j;
ethical: [adj]伦理的;道德的;凭处方出售的;  [n]处方药; [a]/ˈeθɪkl/; [or]6j;
notorious: [adj]臭名昭著的,声名狼藉的; [a]/noʊˈtɔːriəs/; [or]6j;
orbit: [v]环绕..的轨道运行;  [n]轨道;  [vi]环绕..的轨道运行; [a]/ˈɔːrbɪt/; [or]6j;
derive: [v]获取;得自;起源; [a]/dɪˈraɪv/; [or]6j;
positive: [adj]积极的;肯定的,明确的;正面的;阳性的;  [n]正面;肯定;优点;正数; [a]/ˈpɑːzətɪv/; [or]6j;
shrine: [n]神殿,神祠,圣地; [a]/ʃraɪn/; [or]6j;
wardrobe: [n]衣橱;全部服装;剧服; [a]/ˈwɔːrdroʊb/; [or]6j;
critic: [n]评论家,批判者;挑剔的人; [a]/ˈkrɪtɪk/; [or]6j;
significant: [adj]重大的,有意义的;意味深长的;数量相当大的;  [n]象征,标志; [a]/sɪɡˈnɪfɪkənt/; [or]6j;
molecule: [n]分子,微粒; [a]/ˈmɑːlɪkjuːl/; [or]6j;
reed: [n]芦苇;苇丛;芦笛;牧笛; [a]/riːd/; [or]6j;
prominent: [adj]突起的,显眼的;突出的,杰出的; [a]/ˈprɑːmɪnənt/; [or]6j;
differentiate: [v]使有差异;区别; [a]/ˌdɪfəˈrenʃieɪt/; [or]6j;
retard: [v]延迟,使减速;  [n]妨碍,阻碍; [a]/rɪˈtɑːrd/; [or]6j;
porch: [n]门廊;走廊; [a]/pɔːrtʃ/; [or]6j;
excerpt: [n]摘录,节选;  [v]摘,选;引用; [a]/ˈeksɜːrpt/; [or]6j;
stroll: [n]漫步;散步;闲荡;溜达;  [vi]散步;  [vt]溜达;游荡;在.散步;在.漫步; [a]/stroʊl/; [or]6j;
snob: [n]势利小人;假行家; [a]/snɑːb/; [or]6j;
psychological: [adj]心理的,心理学的; [a]/ˌsaɪkəˈlɑːdʒɪkl/; [or]6j;
compromise: [n]妥协;折中;  [v]妥协;使遭受危害; [a]/ˈkɑːmprəmaɪz/; [or]6j;
modification: [n]修改,改进,改造; [a]/ˌmɑːdɪfɪˈkeɪʃn/; [or]6j;
demonstrate: [vt](用实例,实验)论证;演示,展示;示范;  [vi]示威; [a]/ˈdemənstreɪt/; [or]6j;
expedition: [n]远征队;探险;短途旅行;迅速; [a]/ˌekspəˈdɪʃn/; [or]6j;
expose: [v]暴露;揭露;使遭受; [a]/ɪkˈspoʊz/; [or]6j;
potential: [n]潜力,潜能;  [adj]潜在的,可能的; [a]/pəˈtenʃl/; [or]6j;
wealth: [n]财富;财产;大量; [a]/welθ/; [or]6j;
elemental: [adj]基本的;自然力的; [a]/ˌelɪˈmentl/; [or]6j;
charm: [n]魅力,吸引力,符咒;  [v](使)着迷,施魔法; [a]/tʃɑːrm/; [or]6j;
undesirable: [adj]令人不悦的;讨厌的;  [n]不受欢迎的人;不良分子; [a]/ˌʌndɪˈzaɪərəbl/; [or]6j;
pesticide: [n]杀虫剂;农药; [a]/ˈpestɪsaɪd/; [or]6j;
eagle: [n]鹰,老鹰;鹰状标志;(高尔夫球赛中)少击两棒入穴的成绩;  [vt](高尔夫球赛中)比标准杆数少击两杆入; [a]/ˈiːɡl/; [or]6j;
thrifty: [adj]节省的,节俭的; [a]/ˈθrɪfti/; [or]6j;
gamble: [v]赌博;投机;打赌;  [n]赌博;冒险;  [vt]赌输; [a]/ˈɡæmbl/; [or]6j;
mobile: [n]风铃,悬挂饰物;手机,移动电话;  [adj]可移动的;行动方便的; [a]/ˈmoʊbl/; [or]6j;
various: [adj]各种各样的;不同的; [a]/ˈveriəs/; [or]6j;
bleed: [vi]流血;散开;  [vt]榨取,敲诈;使流血;使..排出液体;  [n]出血;  [adj][印]出血版的; [a]/bliːd/; [or]6j;
terrific: [adj]极好的;可怕的;(尺寸或程度)极其巨大的,大的惊人的; [a]/təˈrɪfɪk/; [or]6j;
granite: [n]花岗岩; [a]/ˈɡrænɪt/; [or]6j;
bugle: [n]军号,喇叭;  [vi]吹号;  [vt]吹冲锋号; [a]/ˈbjuːɡl/; [or]6j;
shaft: [n]柄;轴;杆状物;  [v]苛刻地对待;  [vt]给.装杆; [a]/ʃæft/; [or]6j;
statistics: [n]统计;统计数字,数据;统计学; [a]/stəˈtɪstɪks/; [or]6j;
heir: [n]继承人;后继者; [a]/er/; [or]6j;
fret: [v]使烦恼,使焦急;使腐蚀;使磨损;  [n](斑卓琴,吉他,曼陀林琴等弦乐器指板上定音的)档;侵蚀; [a]/fret/; [or]6j;
notion: [n]概念,观念;观点,看法;突然的念头;意图; [a]/ˈnoʊʃn/; [or]6j;
abuse: [v]虐待;辱骂;(对麻醉毒品,兴奋剂等的)非法服用;滥用;  [n]滥用;虐待;辱骂; [a]/əˈbjuːs/; [or]6j;
radioactive: [adj]放射性的; [a]/ˌreɪdioʊˈæktɪv/; [or]6j;
inflict: [v]使遭受(损伤,痛苦等);使承担(负担等); [a]/ɪnˈflɪkt/; [or]6j;
performance: [n]表演,演出;表现;执行;性能; [a]/pərˈfɔːrməns/; [or]6j;
upright: [adj]垂直的;正直的;  [adv]直立地;  [n]立柱; [a]/ˈʌpraɪt/; [or]6j;
incur: [v]遭受;招致;引起; [a]/ɪnˈkɜːr/; [or]6j;
visa: [n]签证; [a]/ˈviːzə/; [or]6j;
decade: [n]十年,十年间; [a]/ˈdekeɪd/; [or]6j;
intonation: [n]声调;语调; [a]/ˌɪntəˈneɪʃn/; [or]6j;
pneumatic: [adj]装满空气的;风力的; [a]/nuːˈmætɪk/; [or]6j;
anniversary: [n]周年纪念日;  [adj]周年的,(有关)周年纪念的; [a]/ˌænɪˈvɜːrsəri/; [or]6j;
agent: [n]政府特工;代理商,代理人; [a]/ˈeɪdʒənt/; [or]6j;
paralysis: [n]瘫痪(症),麻痹(症); [a]/pəˈræləsɪs/; [or]6j;
marsh: [n]湿地;沼泽; [a]/mɑːrʃ/; [or]6j;
undermine: [v]暗中破坏;逐渐削弱;侵蚀.的基础;在...下挖坑道,从根基处损害; [a]/ˌʌndərˈmaɪn/; [or]6j;
communication: [n]沟通方式;交流,通讯;信息; [a]/kəˌmjuːnɪˈkeɪʃn/; [or]6j;
enclosure: [n]四周有篱笆(或围墙等)的场所,围场;(信中的)附件; [a]/ɪnˈkloʊʒər/; [or]6j;
fantasy: [n]幻想,想象;幻想作品;  [vi]奏幻想曲;  [vt]想像;幻想;  [adj]虚幻的; [a]/ˈfæntəsi/; [or]6j;
inaugurate: [v]为..揭幕;为.举行就职典礼;开展; [a]/ɪˈnɔːɡjəreɪt/; [or]6j;
blunder: [n]愚蠢之举;大错;  [vi]犯大错;  [v]失策;绊倒; [a]/ˈblʌndər/; [or]6j;
groan: [v]呻吟;抱怨;  [n]呻吟; [a]/ɡroʊn/; [or]6j;
transistor: [n]晶体管;半导体收音机; [a]/trænˈzɪstər/; [or]6j;
respond: [vi]作答;对..有效果;做出反应;  [v]回应; [a]/rɪˈspɑːnd/; [or]6j;
snobbish: [adj]自命不凡的,势利的; [a]/ˈsnɑːbɪʃ/; [or]6j;
inject: [v]给.注射;注入;引入;射入轨道; [a]/ɪnˈdʒekt/; [or]6j;
lattice: [n]格子架; [a]/ˈlætɪs/; [or]6j;
liner: [n]眼线笔;班轮;班机;内衬; [a]/ˈlaɪnər/; [or]6j;
revision: [n]修订;修改;修订本;复习; [a]/rɪˈvɪʒn/; [or]6j;
devour: [v]狼吞虎咽;毁灭;贪婪地看,贪婪地阅读; [a]/dɪˈvaʊər/; [or]6j;
undue: [adj]过分的,不适当的;过度的;尚未到期的; [a]/ˌʌnˈduː/; [or]6j;
watchful: [adj]注意的,警惕的; [a]/ˈwɑːtʃfl/; [or]6j;
objective: [n]目标;目的;  [adj]客观的; [a]/əbˈdʒektɪv/; [or]6j;
nun: [n]修女,尼姑; [a]/nʌn/; [or]6j;
layer: [n]层;层次;阶层;  [v]把.分层堆放;借助压条法;将(头发)剪成不同层次; [a]/ler/; [or]6j;
exceed: [v]超过;胜过;超出; [a]/ɪkˈsiːd/; [or]6j;
trot: [v](使)小跑,(使)快步走,骑马小跑,疾走;  [n]小跑,骑马,疾走;忙碌; [a]/trɑːt/; [or]6j;
authentic: [adj]真实的;真正的;可靠的; [a]/ɔːˈθentɪk/; [or]6j;
ridicule: [v]嘲笑,愚弄;  [n]嘲笑,愚弄; [a]/ˈrɪdɪkjuːl/; [or]6j;
enthusiastic: [adj]狂热的,极感兴趣的,热情的; [a]/ɪnˌθuːziˈæstɪk/; [or]6j;
construct: [v]建造;作(图);构筑;  [n]概念;构筑物;结构体;建造物; [a]/kənˈstrʌkt/; [or]6j;
quantitative: [adj]定量的; [a]/ˈkwɑːntəteɪtɪv/; [or]6j;
court: [n]法院,法庭;庭院;球场;宫廷;  [v]讨好,取悦;招致危险;追求; [a]/kɔːrt/; [or]6j;
liability: [n]责任;债务;倾向;可能性;不利因素;惹麻烦的人(或事); [a]/ˌlaɪəˈbɪləti/; [or]6j;
impair: [v]损害;削弱; [a]/ɪmˈper/; [or]6j;
supplement: [n]增补,补充物,保健品;附录;  [v]补充; [a]/ˈsʌplɪmənt/; [or]6j;
trial: [n]审判,审理;试验;试用;磨炼,苦难;  [adj]试验的,试验性的;考验的;审判的;  [v]测试; [a]/ˈtraɪəl/; [or]6j;
acknowledge: [v]告知收到;对(人)打招呼,招呼(某人)以示相识,致意;就..表示谢忱,鸣谢,感谢,感激,答谢,对..表示感谢;承认(属实),承认(权威,地位); [a]/əkˈnɑːlɪdʒ/; [or]6j;
utensil: [n]工具,(厨房)用具; [a]/juːˈtensl/; [or]6j;
divorce: [n]离婚,离异;  [v]离婚; [a]/dɪˈvɔːrs/; [or]6j;
partition: [n]划分;隔开物,隔墙,隔板;  [v]隔开;  [vt]瓜分;分割; [a]/pɑːrˈtɪʃn/; [or]6j;
avoid: [v]躲开,避开;避免,防止; [a]/əˈvɔɪd/; [or]6j;
transfer: [v]转移;调任;换乘;转变;改编;  [n]转让;转移;调任;汇兑; [a]/trænsˈfɜːr/; [or]6j;
destine: [v]注定;预定; [a]/'destɪn/; [or]6j;
invest: [v]投资,投入;赋予,给予; [a]/ɪnˈvest/; [or]6j;
lighter: [n]打火机; [a]/ˈlaɪtər/; [or]6j;
function: [n]功能,作用;函数;应变量;盛大聚会;职务,职责;  [v]起作用;正常运转; [a]/ˈfʌŋkʃn/; [or]6j;
certainty: [n]必然;确信;必然的事; [a]/ˈsɜːrtnti/; [or]6j;
machinery: [n]机器,机关;机构,机制; [a]/məˈʃiːnəri/; [or]6j;
grope: [v]摸索,探索,动手动脚; [a]/ɡroʊp/; [or]6j;
unfit: [adj]不适宜的,不合适的;不适当的;不健康的;  [v]不适合; [a]/ʌnˈfɪt/; [or]6j;
adequate: [adj]充足的,充分的,足够的;尚可的,过得去的; [a]/ˈædɪkwət/; [or]6j;
slim: [adj]细长的;苗条的;  [v](用运动,节食等)减轻体重,变苗条; [a]/slɪm/; [or]6j;
clarity: [n]清楚;清澈; [a]/ˈklærəti/; [or]6j;
hesitate: [v]犹豫,踌躇;含糊,支吾,有顾虑; [a]/ˈhezɪteɪt/; [or]6j;
monologue: [n]独白,个人长篇演说; [a]/ˈmɑːnəlɔːɡ/; [or]6j;
gown: [n]女礼服;女裙服;长袍; [a]/ɡaʊn/; [or]6j;
commodity: [n]商品,货物; [a]/kəˈmɑːdəti/; [or]6j;
opponent: [n]对手,敌手,对抗者;  [adj]对立的;敌对的; [a]/əˈpoʊnənt/; [or]6j;
immerse: [v]沉浸,沉浸于;使陷入; [a]/ɪˈmɜːrs/; [or]6j;
capability: [n](实际)能力,性能,容量,接受力; [a]/ˌkeɪpəˈbɪləti/; [or]6j;
electrician: [n]电工;电气技师; [a]/ɪˌlekˈtrɪʃn/; [or]6j;
resolve: [n]决心;  [v]解决,决定,表决; [a]/rɪˈzɑːlv/; [or]6j;
vital: [adj]生命所必需的;必不可少的;至关重要的;有活力的;生命攸关的;  [n]要害;重要部分; [a]/ˈvaɪtl/; [or]6j;
sculpture: [n]雕刻艺术;雕刻,雕塑; [a]/ˈskʌlptʃər/; [or]6j;
abnormal: [adj]反常的;畸形的; [a]/æbˈnɔːrml/; [or]6j;
confinement: [n]限制;监禁;分娩; [a]/kənˈfaɪnmənt/; [or]6j;
installment: [n]分期付款;部分;安装,安置; [a]/ɪnˈstɔlmənt/; [or]6j;
issue: [n]问题;议题;发行物;子女;  [v]发行;发布;分配,分发,给; [a]/ˈɪʃuː/; [or]6j;
describe: [v]描述;形容; [a]/dɪˈskraɪb/; [or]6j;
elementary: [adj]基本的;初级的;非常简单的; [a]/ˌelɪˈmentri/; [or]6j;
atlas: [n]地图集; [a]/ˈætləs/; [or]6j;
finely: [adv]细小地;美好地; [a]/ˈfaɪnli/; [or]6j;
mutter: [n]低语;小声抱怨;  [v]低声说;小声抱怨;  [vt]低声说;抱怨地说; [a]/ˈmʌtər/; [or]6j;
eligible: [adj]适合被选的,符合条件的;(尤指婚姻等)合适的,合意的; [a]/ˈelɪdʒəbl/; [or]6j;
blacksmith: [n]锻工;铁匠; [a]/ˈblæksmɪθ/; [or]6j;
anode: [n](电)阳极,负极; [a]/ˈænoʊd/; [or]6j;
interpret: [v]口译;解释;把..理解为; [a]/ɪnˈtɜːrprɪt/; [or]6j;
disconnect: [v]断开,拆开,使分离; [a]/ˌdɪskəˈnekt/; [or]6j;
adverse: [adj]不利的;(方向上)逆的;在相反的方向上移动(或运转);相反的; [a]/ˈædvɜːrs/; [or]6j;
authoritative: [adj]权威性的;可信的;命令式的,专断的; [a]/əˈθɔːrəteɪtɪv/; [or]6j;
desolate: [adj]荒凉的;孤单寂寞的; [a]/ˈdesələt/; [or]6j;
offense: [n]犯罪,冒犯,过错,触怒,犯规,进攻; [a]/əˈfens/; [or]6j;
priority: [n]优先;优先权;优先考虑的事;重要事项; [a]/praɪˈɔːrəti/; [or]6j;
overhear: [v]无意中听到,偷听到; [a]/ˌoʊvərˈhɪr/; [or]6j;
evaluate: [v]评价;评估; [a]/ɪˈvæljueɪt/; [or]6j;
acquaint: [v]使熟悉;使认识;介绍; [a]/əˈkweɪnt/; [or]6j;
behave: [v]举动;举止端正(或良好,适当); [a]/bɪˈheɪv/; [or]6j;
datum: [n]数据,资料; [a]/ˈdeɪtəm/; [or]6j;
buck: [n]雄鹿;年轻男士;美元;  [v]反对;马弓背踢后腿挑起; [a]/bʌk/; [or]6j;
represent: [v]代表;象征;表示;描述;阐明;说明;演绎; [a]/ˌreprɪˈzent/; [or]6j;
junction: [n]连接,接合;接合处;路口; [a]/ˈdʒʌŋkʃn/; [or]6j;
anxiety: [n]焦虑;忧虑;担心; [a]/æŋˈzaɪəti/; [or]6j;
insist: [v]坚持;坚持要求;坚持认为; [a]/ɪnˈsɪst/; [or]6j;
discrepancy: [n]不一致,差异,不符; [a]/dɪsˈkrepənsi/; [or]6j;
reject: [v]拒绝;抵制;  [n]废品;次品;不合格者;被剔除者; [a]/rɪˈdʒekt/; [or]6j;
imaginary: [adj]想象的,虚构的,假想的; [a]/ɪˈmædʒɪneri/; [or]6j;
obscure: [v]隐藏,使.模糊;使变暗;遮掩;  [adj]不清楚的;难以理解的;  [n]某种模糊的或不清楚的东西; [a]/əbˈskjʊr/; [or]6j;
cast: [v]投;抛下,投射(光线和阴影);瞥,飞快看(一眼),扫视;掷;放钓;投票;选定演员;  [n]投掷物;铸件;演员表,演员阵容; [a]/kæst/; [or]6j;
ordinarily: [adv]普通;通常; [a]/ˌɔːrdnˈerəli/; [or]6j;
ascertain: [v]探知,弄清,查明(真相等); [a]/ˌæsərˈteɪn/; [or]6j;
define: [v]给(词,短语等)下定义;使明确;规定;下定义,构成释义; [a]/dɪˈfaɪn/; [or]6j;
incredible: [adj]不可相信的;惊人的,不可思议的; [a]/ɪnˈkredəbl/; [or]6j;
sponge: [n]海绵,多孔布丁,松蛋糕;  [v]用湿海绵(或布)擦,揩; [a]/spʌndʒ/; [or]6j;
destiny: [n]命运,天数,天命; [a]/ˈdestəni/; [or]6j;
appearance: [n]外貌,外表;到达,抵达;公开露面;出版,发表,刊登; [a]/əˈpɪrəns/; [or]6j;
shipment: [n]装载的货物;装船;装运;装货量; [a]/ˈʃɪpmənt/; [or]6j;
compete: [v]参加比赛;竞争,对抗; [a]/kəmˈpiːt/; [or]6j;
destruction: [n]破坏,毁灭,灭亡; [a]/dɪˈstrʌkʃn/; [or]6j;
principle: [n]原则,原理;理由,信条; [a]/ˈprɪnsəpl/; [or]6j;
speculate: [vi]推测,猜测;投机,做投机买卖;  [vt]推测; [a]/ˈspekjuleɪt/; [or]6j;
settlement: [n]解决;结算;协议;定居; [a]/ˈsetlmənt/; [or]6j;
postulate: [v]假定.是真的;  [n]假定; [a]/ˈpɑːstʃəleɪt/; [or]6j;
questionable: [adj]可疑的,不可靠的; [a]/ˈkwestʃənəbl/; [or]6j;
Saturn: [n][天]土星; [a]/ˈsætɜːrn/; [or]6j;
streak: [n]条纹,条痕,色线;  [v]裸奔;成条纹; [a]/striːk/; [or]6j;
exclusively: [adv]专门地;特定地;排外地;仅仅; [a]/ɪkˈskluːsɪvli/; [or]6j;
petty: [adj]价值不大的;小的;器量小的;琐碎的; [a]/ˈpeti/; [or]6j;
entrepreneur: [n]企业家,演出承包人; [a]/ˌɑːntrəprəˈnɜːr/; [or]6j;
rectangle: [n]长方形,矩形; [a]/ˈrektæŋɡl/; [or]6j;
interface: [n]界面;[地质]分界面,接触面;  [v]相互作用(或影响);交流,交谈; [a]/ˈɪntərfeɪs/; [or]6j;
purify: [v]净化;提纯; [a]/ˈpjʊrɪfaɪ/; [or]6j;
possess: [v]拥有,占有;缠住,迷住;支配; [a]/pəˈzes/; [or]6j;
ripple: [n]涟漪,波纹;  [v](使)泛起层层细浪; [a]/ˈrɪpl/; [or]6j;
decimal: [n]小数;  [adj]小数的;十进制的; [a]/ˈdesɪml/; [or]6j;
ingredient: [n](烹调的)原料;(构成的)要素,因素; [a]/ɪnˈɡriːdiənt/; [or]6j;
amends: [n]赔偿;赔罪; [a]/əˈmendz/; [or]6j;
fund: [n]资金,基金;存款;  [v]拨款,提供基金; [a]/fʌnd/; [or]6j;
morality: [n]道德,道德观;道德规范,伦理体系; [a]/məˈræləti/; [or]6j;
comedy: [n]喜剧,有趣的事情; [a]/ˈkɑːmədi/; [or]6j;
blank: [adj](纸等)空白的,茫然的;  [n]空白,空白处;  [v]忽视; [a]/blæŋk/; [or]6j;
consume: [v]消耗,耗尽;  [vt]吃光,喝光;毁灭; [a]/kənˈsuːm/; [or]6j;
suppress: [v]镇压;禁止发表;抑制(感情等);阻止.的生长; [a]/səˈpres/; [or]6j;
sympathetic: [adj]有同情心的,同情的;支持的;称心的; [a]/ˌsɪmpəˈθetɪk/; [or]6j;
tenure: [n]任期;终身职位; [a]/ˈtenjər/; [or]6j;
damn: excl. 该死,讨厌;  [v]诅咒;  [n]诅咒;  [adj]该死的;完全的;  [adv](表示厌烦)该死;非常; [a]/dæm/; [or]6j;
symmetry: [n]对称;均衡; [a]/ˈsɪmətri/; [or]6j;
invert: [v]倒置;倒转;颠倒; [a]/ɪnˈvɜːrt/; [or]6j;
compact: [adj]小巧的,小型的,袖珍的,体积小的;紧密的,紧凑的,密集的;  [v]把..压紧;变得坚实;  [n]带镜小粉盒;合约,条约; [a]/ˈkɑːmpækt/; [or]6j;
demand: [n]要求(坚决的),需求;  [v]强烈要求,需要; [a]/dɪˈmænd/; [or]6j;
feminine: [adj]女性的,娇柔的;  [n]女性;温柔的女性;[语]阴性,阴性词; [a]/ˈfemənɪn/; [or]6j;
reap: [v]收割;获得;收获; [a]/riːp/; [or]6j;
solitary: [adj]孤独的,单独的,隐居的;  [n]独居者,隐士;单独禁闭; [a]/ˈsɑːləteri/; [or]6j;
magnify: [v]放大,扩大;夸大,夸张; [a]/ˈmæɡnɪfaɪ/; [or]6j;
surplus: [adj]过剩的,多余的;  [n]过剩,盈余;顺差; [a]/ˈsɜːrplʌs/; [or]6j;
instructive: [adj]有教育意义的; [a]/ɪnˈstrʌktɪv/; [or]6j;
distract: [v]使分心,转移(注意力),分散(思想); [a]/dɪˈstrækt/; [or]6j;
compel: [v]强迫;迫使屈服;(使)不得已; [a]/kəmˈpel/; [or]6j;
cord: [n]细绳,索,(电工学)电绳;索,(电工学)电绳; [a]/kɔːrd/; [or]6j;
strategic: [adj]战略(上)的,对全局有重要意义的,关键的; [a]/strəˈtiːdʒɪk/; [or]6j;
flutter: [n]激动不安,紧张;  [v]飘动,飘扬;(鸟等)振翼,拍翅而飞;  [vi](心脏等)快速跳动; [a]/ˈflʌtər/; [or]6j;
slope: [n]山坡,斜坡,倾斜;  [v]倾斜; [a]/sloʊp/; [or]6j;
phenomenon: [n]现象;奇迹,奇事,奇才; [a]/fəˈnɑːmɪnən/; [or]6j;
dominant: [adj]主要的,占优势的,支配的,统治的;显性基因的; [a]/ˈdɑːmɪnənt/; [or]6j;
glide: [v]滑翔;滑动;  [n]滑音,延音;滑行; [a]/ɡlaɪd/; [or]6j;
deficient: [adj]有缺陷的;不足的,不充足的;  [n]有缺陷的人[东西]; [a]/dɪˈfɪʃnt/; [or]6j;
sheriff: [n]警长,郡治安官,州长; [a]/ˈʃerɪf/; [or]6j;
sovereign: [adj]至高无上的,具有独立主权的,有最高统治权的;  [n]最高统治者,君主,元首; [a]/ˈsɑːvrən/; [or]6j;
medieval: [adj]中世纪的,中古(时代)的; [a]/ˌmediˈiːvl/; [or]6j;
conceit: [n]自负;狂妄;想法,观点;构想,幻想; [a]/kənˈsiːt/; [or]6j;
bull: [n]公牛,雄性的鲸,象等大动物; [a]/bʊl/; [or]6j;
harassment: [n]骚扰;扰乱;烦恼事; [a]/həˈræsmənt/; [or]6j;
trifle: [n]蛋糕;琐事,小事,无价值的东西;  [v]嘲笑,轻视; [a]/ˈtraɪfl/; [or]6j;
lick: [v]舔;卷烧;战胜;使无法理解;轻轻拍打;  [vi]舔;  [n]舔;舌头一次舔的量;狠揍; [a]/lɪk/; [or]6j;
formula: [n]公式,方程式;配方;方案;方法;配方奶; [a]/ˈfɔːrmjələ/; [or]6j;
negative: [adj]消极的,负面的;否定的;  [n]否定,否定词;底片; [a]/ˈneɡətɪv/; [or]6j;
frustrate: [v]使灰心;挫败;阻挠; [a]/ˈfrʌstreɪt/; [or]6j;
reign: [v]占主导地位,统治,当政;  [n](君主)统治时期; [a]/reɪn/; [or]6j;
watt: [n]瓦,瓦特; [a]/wɑːt/; [or]6j;
minibus: [n]小型公共汽车,小型巴士; [a]/ˈmɪnibʌs/; [or]6j;
electric: [adj]电的,电动的,带电的;刺激的;  [n]供电; [a]/ɪˈlektrɪk/; [or]6j;
plunder: [v]抢劫,掠夺;  [n]抢劫,战利品; [a]/ˈplʌndər/; [or]6j;
recite: [vi]背诵;朗诵;  [vt]背诵;朗诵;叙述;列举; [a]/rɪˈsaɪt/; [or]6j;
infectious: [adj]传染的;感染性的;易传播的; [a]/ɪnˈfekʃəs/; [or]6j;
interaction: [n]互动;相互作用,相互影响; [a]/ˌɪntərˈækʃn/; [or]6j;
posture: [n]姿势;看法;态度;  [v]装模作样; [a]/ˈpɑːstʃər/; [or]6j;
discrete: [adj]分开的;不连续的; [a]/dɪˈskriːt/; [or]6j;
institution: [n]机构;制度;惯例;习俗;建立,设立,制定; [a]/ˌɪnstɪˈtuːʃn/; [or]6j;
solidarity: [n]团结一致; [a]/ˌsɑːlɪˈdærəti/; [or]6j;
gravitation: [n]重力;万有引力;地心吸力; [a]/ˌɡrævɪˈteɪʃn/; [or]6j;
journalist: [n]记者,新闻工作者; [a]/ˈdʒɜːrnəlɪst/; [or]6j;
boost: [v]增加;偷盗;  [n]提高;激励;后推;助推发动机; [a]/buːst/; [or]6j;
clatter: [n]咔嗒;哗啦声;嘈杂的谈笑声;  [v]发出哗啦声;喧闹的谈笑; [a]/ˈklætər/; [or]6j;
budget: [n]预算;  [v]预算,安排;  [adj]廉价的; [a]/ˈbʌdʒɪt/; [or]6j;
scared: [adj]害怕的,恐惧的; [a]/skerd/; [or]6j;
underestimate: [v]低估;对.估计不足; [a]/ˌʌndərˈestɪmeɪt/; [or]6j;
constant: [adj]不变的,始终如一的;持续不断的;  [n]常数,恒量; [a]/ˈkɑːnstənt/; [or]6j;
complain: [v]抱怨;诉苦;申诉;控诉;诉说;控告;  [vt]申诉;  [n]抱怨,诉苦; [a]/kəmˈpleɪn/; [or]6j;
economical: [adj]节约的;经济的;合算的; [a]/ˌekəˈnɑːmɪkl/; [or]6j;
alarm: [n]警报器,警报;闹钟;惊恐,忧虑;  [v]使惊恐,使忧虑; [a]/əˈlɑːrm/; [or]6j;
reconcile: [v]和解;调解;调和; [a]/ˈrekənsaɪl/; [or]6j;
millionaire: [n]百万富翁,大富翁; [a]/ˌmɪljəˈner/; [or]6j;
bearing: [n]方向;举止;轴承; [a]/ˈberɪŋ/; [or]6j;
recession: [n](经济)衰退,不景气;后退,撤回;凹处; [a]/rɪˈseʃn/; [or]6j;
watertight: [adj]不透水的;无懈可击的; [a]/ˈwɔːtərtaɪt/; [or]6j;
enforce: [v]实施;执行;强制; [a]/ɪnˈfɔːrs/; [or]6j;
torpedo: [n]鱼雷;油井爆破筒;  [v]用鱼雷进攻,破坏; [a]/tɔːrˈpiːdoʊ/; [or]6j;
fluctuation: [n]波动;起伏; [a]/ˌflʌktʃuˈeɪʃn/; [or]6j;
recruit: [v]招募(新兵),招收(新成员);  [n]新兵,新成员; [a]/rɪˈkruːt/; [or]6j;
depression: [n]抑郁,沮丧;不景气,萧条(期);洼地,凹陷; [a]/dɪˈpreʃn/; [or]6j;
mediterranean: [adj]地中海的;地中海地区的; [a]/ˌmedɪtə'reɪniən/; [or]6j;
fraction: [n]部分,片断,碎片;分数; [a]/ˈfrækʃn/; [or]6j;
descent: [n]下降,下倾;血统,世系;斜坡,坡道; [a]/dɪˈsent/; [or]6j;
correlation: [n]相互关系,相关(性); [a]/ˌkɔːrəˈleɪʃn/; [or]6j;
slide: [n]滑行;下落;滑面;幻灯片;  [v]使滑动;使滑入;滑动;滑倒;滑落;下跌; [a]/slaɪd/; [or]6j;
coalition: [n]结合;联盟;联合; [a]/ˌkoʊəˈlɪʃn/; [or]6j;
violate: [v]违反,违背;侵犯,妨碍;亵渎; [a]/ˈvaɪəleɪt/; [or]6j;
humidity: [n]潮湿;湿气;湿度; [a]/hjuːˈmɪdəti/; [or]6j;
intercourse: [n]交流;性交; [a]/ˈɪntərkɔːrs/; [or]6j;
spectator: [n]旁观者;观众;目击者; [a]/ˈspekteɪtər/; [or]6j;
locust: [n]蝗虫; [a]/ˈloʊkəst/; [or]6j;
spontaneous: [adj]自发的,无意识的;自然的,天真率直的; [a]/spɑːnˈteɪniəs/; [or]6j;
cartoon: [n]卡通(片),动画片;(尤指报刊上讽刺政客或时事的)漫画,幽默画; [a]/kɑːrˈtuːn/; [or]6j;
symmetrical: [adj]对称的; [a]/sɪˈmetrɪkl/; [or]6j;
doctrine: [n]教条,学说,信条,原则; [a]/ˈdɑːktrɪn/; [or]6j;
terrace: [n]阳台;梯田;走廊;  [vi]成阶地;  [adj]梯形的;  [vt]使成梯田; [a]/ˈterəs/; [or]6j;
persevere: [v]坚持,不屈不挠; [a]/ˌpɜːrsəˈvɪr/; [or]6j;
periodical: [n]期刊;杂志; [a]/ˌpɪriˈɑːdɪkl/; [or]6j;
spokesman: [n]发言人; [a]/ˈspoʊksmən/; [or]6j;
configuration: [n]配置,布局,构造; [a]/kənˌfɪɡjəˈreɪʃn/; [or]6j;
transient: [adj]短暂的,路过的;转瞬即逝的;  [n]过客; [a]/ˈtrænʃnt/; [or]6j;
outfit: [n]装备,全部用品,(协同工作)的一组人;  [v]提供装备; [a]/ˈaʊtfɪt/; [or]6j;
artillery: [n]大炮,炮兵; [a]/ɑːrˈtɪləri/; [or]6j;
consul: [n]领事; [a]/ˈkɑːnsl/; [or]6j;
smuggle: [v]非法偷运;走私; [a]/ˈsmʌɡl/; [or]6j;
continuity: [n]连续性;(电影或电视节目中)镜头的连接,衔接; [a]/ˌkɑːntəˈnuːəti/; [or]6j;
eternal: [adj]永恒的,永不改变的; [a]/ɪˈtɜːrnl/; [or]6j;
linger: [v]逗留,留恋; [a]/ˈlɪŋɡər/; [or]6j;
paperback: [n]平装书,平装本,简装本;  [adj]纸面装订的,平装本的;  [v]以平装本(或纸面本)出版; [a]/ˈpeɪpərbæk/; [or]6j;
scrape: [n]擦伤;刮,擦;  [v]刮,擦; [a]/skreɪp/; [or]6j;
consolidate: [v]巩固,加强;把.合为一体; [a]/kənˈsɑːlɪdeɪt/; [or]6j;
bandit: [n]强盗,土匪; [a]/ˈbændɪt/; [or]6j;
sneer: [v]冷笑;嘲笑;  [n]嘲笑; [a]/snɪr/; [or]6j;
intimate: [adj]亲密的,密切的;详细的;  [v]暗示;宣布,通知;  [n]密友,知己; [a]/ˈɪntɪmət/; [or]6j;
obstinate: [adj]顽固的;较难治愈的; [a]/ˈɑːbstɪnət/; [or]6j;
encourage: [v]鼓励,支持;促使;怂恿; [a]/ɪnˈkɜːrɪdʒ/; [or]6j;
giggle: [v]咯咯地笑,傻笑;  [n]咯咯地笑,傻笑; [a]/ˈɡɪɡl/; [or]6j;
corresponding: [adj]相应的;符合的,一致的;通信的; [a]/ˌkɔːrəˈspɑːndɪŋ/; [or]6j;
abbreviation: [n]缩短;缩写词;省略号; [a]/əˌbriːviˈeɪʃn/; [or]6j;
confidential: [adj]机密的;表示信任的;悄悄的; [a]/ˌkɑːnfɪˈdenʃl/; [or]6j;
mediate: [v]调解,调停,斡旋; [a]/ˈmiːdieɪt/; [or]6j;
availability: [n]可得到的人(或物);可用性; [a]/əˌveɪləˈbɪləti/; [or]6j;
weary: [adj]疲倦的,困乏的,令人厌倦的;  [v]使疲倦;使厌倦; [a]/ˈwɪri/; [or]6j;
pudding: [n]布丁,一种甜点心; [a]/ˈpʊdɪŋ/; [or]6j;
reptile: [n]爬行动物,爬虫;  [adj]爬行的,爬虫类的; [a]/ˈreptaɪl/; [or]6j;
charcoal: [n]木炭; [a]/ˈtʃɑːrkoʊl/; [or]6j;
embassy: [n]大使馆;大使馆全体人员; [a]/ˈembəsi/; [or]6j;
bishop: [n]主教; [a]/ˈbɪʃəp/; [or]6j;
hymn: [n]赞美诗,圣歌;歌颂某事物的电影; [a]/hɪm/; [or]6j;
grip: [v]握紧,抓牢;  [n]紧握,握力; [a]/ɡrɪp/; [or]6j;
proton: [n]质子; [a]/ˈproʊtɑːn/; [or]6j;
colonial: [adj]殖民地的,关于殖民的;  [n]殖民地居民; [a]/kəˈloʊniəl/; [or]6j;
vain: [adj]爱虚荣的;徒劳的;没有真正意义的,没有真正价值的,无关紧要的;自负的,自高自大的;无益的; [a]/veɪn/; [or]6j;
alert: [adj]警惕的;充分意识到的;  [n]警觉(状态),戒备(状态);警报;  [v]向.报警,使警惕;使意识到; [a]/əˈlɜːrt/; [or]6j;
radical: [n]激进分子;基础;原子团;根数,根式;  [adj]重大的,彻底的;激进的; [a]/ˈrædɪkl/; [or]6j;
paradox: [n]矛盾;似矛盾而正确的说法; [a]/ˈpærədɑːks/; [or]6j;
practicable: [adj]能实行的,行得通的;适用的,能用的;可通行的; [a]/ˈpræktɪkəbl/; [or]6j;
hoist: [v]升起,吊起;向上推;  [n]起重机;举起; [a]/hɔɪst/; [or]6j;
suitcase: [n]小提箱,手提箱; [a]/ˈsuːtkeɪs/; [or]6j;
expend: [v]消费,用尽; [a]/ɪkˈspend/; [or]6j;
meteorite: [n]流星;陨星; [a]/ˈmiːtiəraɪt/; [or]6j;
wink: [vi]闪烁;眨眼示意;  [n]眨眼; [a]/wɪŋk/; [or]6j;
vowel: [n]元音;元音字母; [a]/ˈvaʊəl/; [or]6j;
pursuit: [n]追求,寻找;追赶,跟踪;事业,消遣;  [v]追踪,追击; [a]/pərˈsuːt/; [or]6j;
summon: [v]召唤;召集;聚集; [a]/ˈsʌmən/; [or]6j;
fatigue: [n]疲乏,劳累; [a]/fəˈtiːɡ/; [or]6j;
chunk: [n]大块;矮而厚的木块;大量; [a]/tʃʌŋk/; [or]6j;
disillusion: [n]幻灭;  [v]给.泼冷水; [a]/ˌdɪsɪˈluːʒn/; [or]6j;
disguise: [v]伪装;掩饰;  [n]伪装物;伪装; [a]/dɪsˈɡaɪz/; [or]6j;
induce: [v]引导,劝诱,诱导; [a]/ɪnˈduːs/; [or]6j;
facet: [n](多面体的)面,小平面;琢面,侧面;  [vt]在.上琢面; [a]/ˈfæsɪt/; [or]6j;
autonomy: [n]人身自由;自治;自治权; [a]/ɔːˈtɑːnəmi/; [or]6j;
conclude: [v]使结束;推断出;缔结;结束,总结,作决定,作协议; [a]/kənˈkluːd/; [or]6j;
crush: [vt]压坏;压扁;弄皱;弄碎,压碎;榨出;紧抱;挤入;镇压;欺压;  [n]压扁;极度拥挤;  [vi]被压坏;被揉皱;蜂拥而来; [a]/krʌʃ/; [or]6j;
rotary: [adj]旋转的;  [n]旋转运行的机器; [a]/ˈroʊtəri/; [or]6j;
monopoly: [n]垄断;专卖;垄断商品;专卖商品; [a]/məˈnɑːpəli/; [or]6j;
capacity: [n]产能;容量;本领;才能;负载量;职位; [a]/kəˈpæsəti/; [or]6j;
output: [n]产量,输出;  [vt]生产,出产,制造;输出;  [vi]生产,出产,制造;输出; [a]/ˈaʊtpʊt/; [or]6j;
skyscraper: [n]摩天大楼; [a]/ˈskaɪskreɪpər/; [or]6j;
shrug: [n]耸肩;  [v](为表示厌恶,轻漠,冷淡,怀疑等)耸肩;以耸肩表示(厌恶,轻蔑,冷淡,怀疑等); [a]/ʃrʌɡ/; [or]6j;
tact: [n]机智,得体,老练,圆滑; [a]/tækt/; [or]6j;
estate: [n]地产,(上有大片建筑物的)土地,住宅,财产,遗产; [a]/ɪˈsteɪt/; [or]6j;
rupture: [n]破裂;割裂;  [v]使破裂;断绝(关系); [a]/ˈrʌptʃər/; [or]6j;
abolish: [v]废除,废止;取消,革除; [a]/əˈbɑːlɪʃ/; [or]6j;
provision: [n](法律等)条款;供应;预备,存粮;必需品;  [v]为..提供必需品; [a]/prəˈvɪʒn/; [or]6j;
glance: [v]看一下;  [n]一瞥,扫视; [a]/ɡlæns/; [or]6j;
warehouse: [n]仓库; [a]/ˈwerhaʊs/; [or]6j;
adolescent: [adj]青春期的;青少年的;  [n]青少年; [a]/ˌædəˈlesnt/; [or]6j;
salmon: [n]鲑鱼; [a]/ˈsæmən/; [or]6j;
mighty: [adj]强大的,强有力的,有势力的;  [adv]很,非常; [a]/ˈmaɪti/; [or]6j;
guardian: [n]保护人;监护人; [a]/ˈɡɑːrdiən/; [or]6j;
yacht: [n]游艇;帆船; [a]/jɑːt/; [or]6j;
equator: [n]赤道; [a]/ɪˈkweɪtər/; [or]6j;
revenge: [n]报仇;报复;  [v]为.报仇,报.之仇; [a]/rɪˈvendʒ/; [or]6j;
throne: [n]王座;君主; [a]/θroʊn/; [or]6j;
restore: [v]恢复;修补;归还; [a]/rɪˈstɔːr/; [or]6j;
monk: [n]和尚,修道士,僧侣; [a]/mʌŋk/; [or]6j;
sorrowful: [adj]充满悲伤的,悲哀的,伤心的; [a]/ˈsɑːroʊfl/; [or]6j;
dilemma: [n]进退两难的窘境; [a]/dɪˈlemə/; [or]6j;
tuck: [v]把(衬衫,餐巾等的)边塞到里面;把.夹入,把.藏入;  [n](衣服等的)褶,裥; [a]/tʌk/; [or]6j;
ridiculous: [adj]可笑的,荒谬的; [a]/rɪˈdɪkjələs/; [or]6j;
slate: [n]黑板,石板,候选人名单;  [v]提名; [a]/sleɪt/; [or]6j;
soy: [n]大豆;酱油; [a]/sɔɪ/; [or]6j;
insignificant: [adj]无关紧要的,可忽略的,无意义的; [a]/ˌɪnsɪɡˈnɪfɪkənt/; [or]6j;
fission: [n][原子能]裂变,裂开,[生物学]分裂生殖; [a]/ˈfɪʃn/; [or]6j;
virus: [n]病毒;(计算机) 病毒;病毒性疾病; [a]/ˈvaɪrəs/; [or]6j;
ingenuity: [n]机灵,心灵手巧,富于创造天赋; [a]/ˌɪndʒəˈnuːəti/; [or]6j;
foster: [adj]收养的;  [vt]养育;培养,促进; [a]/ˈfɔːstər/; [or]6j;
dioxide: [n]二氧化物; [a]/daɪˈɑːksaɪd/; [or]6j;
vicious: [adj]罪恶的;恶意的;凶猛的,残忍的; [a]/ˈvɪʃəs/; [or]6j;
patriotic: [adj]爱国的,有爱国心的,显示爱国精神的; [a]/ˌpeɪtriˈɑːtɪk/; [or]6j;
rot: [v](使)腐烂;  [n]胡话;腐烂;腐朽,腐败; [a]/rɑːt/; [or]6j;
tack: [n]平头钉;行动步骤;  [v]钉住;使(船)抢风转变航向; [a]/tæk/; [or]6j;
poke: [v]刺,戳;拨开,拨(弄);探(出),露出;  [n]戳,捅; [a]/poʊk/; [or]6j;
supersonic: [adj]超音速的; [a]/ˌsuːpərˈsɑːnɪk/; [or]6j;
challenge: [n]挑战;质疑;  [v]挑战;质疑; [a]/ˈtʃælɪndʒ/; [or]6j;
expense: [n]开销,开支;花费,费用;代价; [a]/ɪkˈspens/; [or]6j;
apt: [adj]恰当的;有(做某事的)倾向; [a]/æpt/; [or]6j;
deserve: [v]值得,应得;应受; [a]/dɪˈzɜːrv/; [or]6j;
fright: [n]恐怖,惊吓; [a]/fraɪt/; [or]6j;
spear: [n]矛;标枪;嫩叶;  [v]刺戳; [a]/spɪr/; [or]6j;
waitress: [n]女侍者;女服务员; [a]/ˈweɪtrəs/; [or]6j;
trench: [n]沟;壕沟,战壕;海沟; [a]/trentʃ/; [or]6j;
hoarse: [adj]沙哑的; [a]/hɔːrs/; [or]6j;
heritage: [n]遗产;继承物;传统;文化遗产; [a]/ˈherɪtɪdʒ/; [or]6j;
magician: [n]善于变戏法的人,魔术师,术士; [a]/məˈdʒɪʃn/; [or]6j;
surpass: [v]胜过;超出; [a]/sərˈpæs/; [or]6j;
compliment: [n]恭维,问候;  [v]赞美,祝贺; [a]/ˈkɑːmplɪmənt/; [or]6j;
bleak: [adj]凄凉的;萧瑟的;阴郁的;无希望的; [a]/bliːk/; [or]6j;
vehicle: [n]交通工具,机动车;传播媒介;工具,手段; [a]/ˈviːəkl/; [or]6j;
occur: [vi]发生;出现,存在; [a]/əˈkɜːr/; [or]6j;
prohibit: [v]禁止; [a]/prəˈhɪbɪt/; [or]6j;
concede: [v]承认;承认失败;让给,让与;让步; [a]/kənˈsiːd/; [or]6j;
lengthen: [v]变长;延长; [a]/ˈleŋθən/; [or]6j;
negligence: [n]疏忽; [a]/ˈneɡlɪdʒəns/; [or]6j;
resent: [v]愤恨; [a]/rɪˈzent/; [or]6j;
inspiring: [adj]鼓舞人心的,激励人的;启发灵感的; [a]/ɪnˈspaɪərɪŋ/; [or]6j;
beam: [n]光线;(房屋等)大梁;(横)梁;  [v]发光;照射;发射,播送;微笑;用梁支撑; [a]/biːm/; [or]6j;
bazaar: [n]集市,商店集中区; [a]/bəˈzɑːr/; [or]6j;
bamboo: [n]竹,竹子; [a]/ˌbæmˈbuː/; [or]6j;
sympathy: [n]同情;同感; [a]/ˈsɪmpəθi/; [or]6j;
spiral: [n]螺旋,螺线;  [v]不断急剧地上升(或下降),螺旋形行进;  [adj]螺旋的; [a]/ˈspaɪrəl/; [or]6j;
portray: [v]描绘;描述; [a]/pɔːrˈtreɪ/; [or]6j;
repel: [v]击退,驱逐;排斥,抵制;使厌恶,使反感;使恐惧; [a]/rɪˈpel/; [or]6j;
blur: [n]污点,模糊;  [v]使.模糊;弄脏;变模糊; [a]/blɜːr/; [or]6j;
slap: [v]掌掴,拍打,侮辱;  [n]侮辱,掴,拍击声;  [adv]猛然;径直;恰好;正好; [a]/slæp/; [or]6j;
decent: [adj]体面的;像样的;合宜的;正直的; [a]/ˈdiːsnt/; [or]6j;
permissible: [adj]容许的;许可的; [a]/pərˈmɪsəbl/; [or]6j;
diminish: [v]减少;失势,削弱.的权势, 减弱.的权势; [a]/dɪˈmɪnɪʃ/; [or]6j;
harp: [n]竖琴;  [v]不停地说,喋喋不休; [a]/hɑːrp/; [or]6j;
prayer: [n]祈祷,祷告;祷文; [a]/prer/; [or]6j;
inland: [adv]在内陆地;  [adj]内陆的,国内的;  [n]内陆; [a]/ˈɪnlænd/; [or]6j;
gleam: [vi]闪烁;使发出微光;  [n]闪光;微光;闪现; [a]/ɡliːm/; [or]6j;
margin: [n]页边的空白,边缘;优势;利润; [a]/ˈmɑːrdʒən/; [or]6j;
jingle: [n](硬币,铃铛等发出的)叮当声;含有轻松而有节奏的韵律的诗篇;  [v]发出叮当声; [a]/ˈdʒɪŋɡl/; [or]6j;
buzz: [v]发出嗡嗡声;  [n]嗡嗡声;低沉嘈杂的谈话声; [a]/bʌz/; [or]6j;
shorten: [v]缩短,(使)变短; [a]/ˈʃɔːrtn/; [or]6j;
meditate: [v]考虑,沉思,冥想; [a]/ˈmedɪteɪt/; [or]6j;
priest: [n]教士,神父; [a]/priːst/; [or]6j;
wax: [n]蜡;蜡状物;  [v]给.上蜡;给.打蜡,给.上蜡;渐渐变大;变为;(月亮)渐圆,渐盈;  [adj]蜡制的; [a]/wæks/; [or]6j;
notable: [n]著名人士;  [adj]值得注意的,显著的,显要的; [a]/ˈnoʊtəbl/; [or]6j;
apprehension: [n]忧虑,担心,疑惧;逮捕;理解; [a]/ˌæprɪˈhenʃn/; [or]6j;
crew: [n](飞机,轮船等的)全体工作人员;一群人; [a]/kruː/; [or]6j;
elderly: [adj]年老的,年长的;上年纪的人; [a]/ˈeldərli/; [or]6j;
marginal: [adj]微小的,不重要的;仅以微弱多数票获胜的;  [n](议会或地方委员会的)边缘席位; [a]/ˈmɑːrdʒɪnl/; [or]6j;
disorder: [n]混乱;紊乱;动乱;  [vt]使混乱;使紊乱; [a]/dɪsˈɔːrdər/; [or]6j;
cylinder: [n]圆柱体,圆筒;汽缸,泵(或桶)体; [a]/ˈsɪlɪndər/; [or]6j;
client: [n]委托人,当事人,主顾,客户;客户端; [a]/ˈklaɪənt/; [or]6j;
abrupt: [adj]突然的;唐突的;鲁莽的; [a]/əˈbrʌpt/; [or]6j;
successor: [n]继承者;继任者; [a]/səkˈsesər/; [or]6j;
sample: [n]样品,样本;(用于检验,分析的) 试样;  [adj]样品的,作为例子的;  [vi]抽样检查;  [vt]抽取.的试样;  [v]品尝;体验,尝试; [a]/ˈsæmpl/; [or]6j;
current: [adj]当前的,现在的;流动的;  [n](电,水,气)流; [a]/ˈkɜːrənt/; [or]6j;
cemetery: [n]公墓;墓地; [a]/ˈseməteri/; [or]6j;
belly: [n]圆形或凸起部分;肚子; [a]/ˈbeli/; [or]6j;
hysterical: [adj]歇斯底里的,情绪激动的; [a]/hɪˈsterɪkl/; [or]6j;
lofty: [adj]极高的,巍峨的;崇高的;高傲的; [a]/ˈlɔːfti/; [or]6j;
bid: [n]出价;投标;努力争取;  [v]出价;投标;问候;道别;吩咐; [a]/bɪd/; [or]6j;
reception: [n]前台,接待处,接收,欢迎,招待会; [a]/rɪˈsepʃn/; [or]6j;
tremendous: [adj]巨大的;极大的;惊人的; [a]/trəˈmendəs/; [or]6j;
stall: [n]分隔栏;售货摊;厩;  [v]停止(因故障); [a]/stɔːl/; [or]6j;
impose: [v]把.强加;强制实行,强迫接受; [a]/ɪmˈpoʊz/; [or]6j;
coverage: [n]新闻报道;可达范围;覆盖范围; [a]/ˈkʌvərɪdʒ/; [or]6j;
nasty: [adj]令人讨厌的;严重的;恶劣的;下流的;  [n](复数形式)令人不愉快或对人有害的事物; [a]/ˈnæsti/; [or]6j;
highlight: [vt]使突出,强调,高亮;  [n]最精彩的部分,最重要的事件; [a]/ˈhaɪlaɪt/; [or]6j;
minority: [n]少数;少数民族;未成年;  [adj]构成少数的; [a]/maɪˈnɔːrəti/; [or]6j;
fatal: [adj]致命的;毁灭性的;决定性的; [a]/ˈfeɪtl/; [or]6j;
temperament: [n]气质,性格,喜怒无常; [a]/ˈtemprəmənt/; [or]6j;
seemingly: [adv]表面上;看上去;似乎; [a]/ˈsiːmɪŋli/; [or]6j;
refresh: [v](使)恢复精神,提神;刷新; [a]/rɪˈfreʃ/; [or]6j;
infinity: [n]无限的时间;大宗,大量;无穷; [a]/ɪnˈfɪnəti/; [or]6j;
interconnect: [v]互相连接; [a]/ˌɪntərkəˈnekt/; [or]6j;
cucumber: [n]黄瓜; [a]/ˈkjuːkʌmbər/; [or]6j;
discharge: [n]发射;释放;解雇;放电;  [v]卸掉负担;发射;放电;卸(货);使爆炸;履行;解雇;允许.离开;排出,放出;清偿(债务); [a]/dɪsˈtʃɑːrdʒ/; [or]6j;
superiority: [n]优越(性),优等; [a]/suːˌpɪriˈɔːrəti/; [or]6j;
residual: [adj]残余的,剩余的; [a]/rɪˈzɪdʒuəl/; [or]6j;
messenger: [n]送信者; [a]/ˈmesɪndʒər/; [or]6j;
improper: [adj]不成体统的,不合礼仪的;不正确的;不道德的; [a]/ɪmˈprɑːpər/; [or]6j;
brew: [v]调制;酿造;冲泡 (茶,咖啡等);酝酿;筹划;  [n]酝酿的饮料;啤酒; [a]/bruː/; [or]6j;
virgin: [n]处女;处男;贞女;  [adj]处女的; [a]/ˈvɜːrdʒɪn/; [or]6j;
pearl: [n]珍珠;珠状物; [a]/pɜːrl/; [or]6j;
augment: [v]增加;助长; [a]/ɔːɡˈment/; [or]6j;
historic: [adj]历史上著名的,有历史意义的;历史性的; [a]/hɪˈstɔːrɪk/; [or]6j;
simultaneous: [adj]同时发生的; [a]/ˌsaɪmlˈteɪniəs/; [or]6j;
evenly: [adv]均匀地,平坦地;不偏不倚地; [a]/ˈiːvnli/; [or]6j;
historian: [n]历史学家,史学工作者; [a]/hɪˈstɔːriən/; [or]6j;
fragile: [adj]易碎的;易损坏的;虚弱的;脆弱的; [a]/ˈfrædʒl/; [or]6j;
contend: [v]争辩;坚决主张;搏斗; [a]/kənˈtend/; [or]6j;
software: [n]软件; [a]/ˈsɔːftwer/; [or]6j;
disclose: [v]公开,揭露,泄露; [a]/dɪsˈkloʊz/; [or]6j;
scripture: [n]经文;圣经; [a]/ˈskrɪptʃər/; [or]6j;
stitch: [v]缝,绣;  [n]一针,线迹;缝法,编结法;(肋部的)突然剧痛;缝合(伤口); [a]/stɪtʃ/; [or]6j;
scorn: [n]鄙视;  [v]轻蔑;对.不屑一顾; [a]/skɔːrn/; [or]6j;
elastic: [adj]有弹性的;可伸缩的,(系统或计划)灵活的;弹力材料制成的;  [n]松紧带,橡皮圈; [a]/ɪˈlæstɪk/; [or]6j;
detector: [n]探测器; [a]/dɪˈtektər/; [or]6j;
indicative: [adj]指示的;暗示的;陈述的;  [n]陈述语气; [a]/ɪnˈdɪkətɪv/; [or]6j;
electrical: [adj]有关电的;电气科学的; [a]/ɪˈlektrɪkl/; [or]6j;
dignity: [n]威严,威风;端庄;尊严,高贵; [a]/ˈdɪɡnəti/; [or]6j;
casual: [adj]偶然的;临时的;随便的;  [n]临时工;便服; [a]/ˈkæʒuəl/; [or]6j;
sentiment: [n]感情;情绪; [a]/ˈsentɪmənt/; [or]6j;
projector: [n]放映机;投影仪; [a]/prəˈdʒektər/; [or]6j;
transition: [n]转变,过渡时期;  [v](从某一状态或活动)转变,过渡(到另一状态或活动); [a]/trænˈzɪʃn/; [or]6j;
vector: [n][数]向量;矢量;带菌者; [a]/ˈvektər/; [or]6j;
uniformly: [adv]一致地; [a]/ˈjuːnɪfɔːrmli/; [or]6j;
jog: [v]慢跑;轻碰;  [n]轻推,慢跑,漫步; [a]/dʒɑːɡ/; [or]6j;
winding: [adj]蜿蜒的,弯曲的; [a]/ˈwaɪndɪŋ/; [or]6j;
flatten: [v]把..弄平; [a]/ˈflætn/; [or]6j;
generate: [v]产生(热,电等能量),创造; [a]/ˈdʒenəreɪt/; [or]6j;
ample: [adj]富足的,丰满的,宽敞的; [a]/ˈæmpl/; [or]6j;
attendant: [n]服务员,侍者,随从;  [adj]伴随的,随之而产生的; [a]/əˈtendənt/; [or]6j;
contamination: [n]污染;侵蚀,玷污; [a]/kənˌtæmɪˈneɪʃn/; [or]6j;
nil: [n]零;无; [a]/nɪl/; [or]6j;
stalk: [n]茎,梗;  [v]隐伏跟踪,(为搜索而)走遍;高视阔步,蔓延; [a]/stɔːk/; [or]6j;
commend: [v]称赞;推荐;委托保管; [a]/kəˈmend/; [or]6j;
everlasting: [adj]永恒的,持久的;无止境的;耐用的; [a]/ˌevərˈlæstɪŋ/; [or]6j;
crumble: [v]弄碎;使破碎;崩溃;破灭;  [n]碎屑;面包屑; [a]/ˈkrʌmbl/; [or]6j;
bachelor: [n]单身汉;学士学位; [a]/ˈbætʃələr/; [or]6j;
culminate: [v]使达高潮,使结束; [a]/ˈkʌlmɪneɪt/; [or]6j;
concept: [n]设想;想法;概念;观念; [a]/ˈkɑːnsept/; [or]6j;
allege: [v]断言;硬说; [a]/əˈledʒ/; [or]6j;
affluent: [adj]富裕的,丰富的; [a]/ˈæfluənt/; [or]6j;
friction: [n]摩擦,摩擦力;争执,冲突; [a]/ˈfrɪkʃn/; [or]6j;
imply: [vt]暗示;暗指;意味着; [a]/ɪmˈplaɪ/; [or]6j;
compulsory: [adj]强制的,必修的; [a]/kəmˈpʌlsəri/; [or]6j;
volunteer: [n]志愿者;志愿兵;志愿者,义务工作者;  [v]自愿做;自愿加入;主动要求;主动提供 (信息); [a]/ˌvɑːlənˈtɪr/; [or]6j;
haven: [n]港湾;避难所;  [vt]为.提供庇护所; [a]/ˈheɪvn/; [or]6j;
converse: [v]交谈;  [adj]相反的,颠倒的;  [n]相反的事物; [a]/kənˈvɜːrs/; [or]6j;
endeavour: [n]尝试;  [v]努力; [a]/ɪnˈdevər/; [or]6j;
siege: [n]围困;包围; [a]/siːdʒ/; [or]6j;
fundamental: [adj]基本的,根本的;重要的;基础的;  [n]基本原理;基本原则; [a]/ˌfʌndəˈmentl/; [or]6j;
scandal: [n]丑闻;丢脸;流言蜚语;反感;愤慨;  [v]诋毁; [a]/ˈskændl/; [or]6j;
vocational: [adj]职业的;业务的; [a]/voʊˈkeɪʃənl/; [or]6j;
implement: [n]工具;器具;  [v]实施,执行;执行; [a]/ˈɪmplɪment/; [or]6j;
charge: [v]充电,充值;索价;控告;向.冲去;  [n]费用;主管;控告; [a]/tʃɑːrdʒ/; [or]6j;
foremost: [adj](位置或时间),最先的;首要的;  [adv]首先,第一; [a]/ˈfɔːrmoʊst/; [or]6j;
crooked: [adj]弯曲的;歪的;不正当的;不正直的; [a]/ˈkrʊkɪd/; [or]6j;
derivation: [n]出处;词源;派生; [a]/ˌderɪˈveɪʃn/; [or]6j;
linen: [n]亚麻桌布;亚麻布; [a]/ˈlɪnɪn/; [or]6j;
flush: [v]脸红;清除;赶出;冲掉;  [n]发红;冲掉;脸红;  [adj]挥霍的,浪费的;富有的;完全齐平的; [a]/flʌʃ/; [or]6j;
validity: [n]正确(性);有效(性),效力; [a]/vəˈlɪdəti/; [or]6j;
finance: [v]资金供给,筹措资金;  [n]金融,财政,资金; [a]/ˈfaɪnæns/; [or]6j;
slumber: [n]睡眠;睡觉;  [v]浅睡;打盹儿; [a]/ˈslʌmbər/; [or]6j;
excessive: [adj]过多的; [a]/ɪkˈsesɪv/; [or]6j;
recognize: [v]辨别,认出;赏识,表彰;承认;赞成; [a]/ˈrekəɡnaɪz/; [or]6j;
premier: [n]总理,首相;  [adj]第一的,首位的; [a]/prɪˈmɪr/; [or]6j;
professional: [adj]职业的;专业的;  [n]专业人员; [a]/prəˈfeʃənl/; [or]6j;
probation: [n]试用;缓刑;察看; [a]/proʊˈbeɪʃn/; [or]6j;
intercity: [adj]城市间的,交际的,来往于城市间的; [a]/ˌɪntərˈsɪti/; [or]6j;
overturn: [v]打翻;  [vt]推翻; [a]/ˌoʊvərˈtɜːrn/; [or]6j;
rig: [n]钻井架;装备;帆具;成套器械;  [v]操纵;装配;欺骗; [a]/rɪɡ/; [or]6j;
lace: [n]鞋带;花边;  [v]加以修饰;结带子; [a]/leɪs/; [or]6j;
overlap: [n]重叠,重复;  [v](部分地)重叠; [a]/ˌoʊvərˈlæp/; [or]6j;
radius: [n]半径;范围; [a]/ˈreɪdiəs/; [or]6j;
displacement: [n]替代;移位,位移,排水量; [a]/dɪsˈpleɪsmənt/; [or]6j;
conspicuous: [adj]显眼的;显著的;显而易见的; [a]/kənˈspɪkjuəs/; [or]6j;
shorthand: [n]速记;缩写; [a]/ˈʃɔːrthænd/; [or]6j;
fellowship: [n]友谊;伙伴关系;交情;团体;奖学金; [a]/ˈfeloʊʃɪp/; [or]6j;
intersection: [n]交点,十字路口; [a]/ˌɪntərˈsekʃn/; [or]6j;
wade: [v]涉水而行,淌水;跋涉; [a]/weɪd/; [or]6j;
pattern: [n]模型,模式;典型;图案;版式;样品;  [vi]形成图案;  [vt]用图案装饰; [a]/ˈpætərn/; [or]6j;
reside: [v]居住; [a]/rɪˈzaɪd/; [or]6j;
clockwise: [adj]顺时针方向的;  [adv]顺时针方向地; [a]/ˈklɑːkwaɪz/; [or]6j;
prosecute: [v]起诉;做检察官;从事; [a]/ˈprɑːsɪkjuːt/; [or]6j;
fiber: [n]纤维(物质);纤维组织;(植物) 纤维; [a]/ˈfaɪbər/; [or]6j;
apply: [v]涂,敷;应用;申请; [a]/əˈplaɪ/; [or]6j;
ignorance: [n]不知,不懂;愚昧,无知; [a]/ˈɪɡnərəns/; [or]6j;
heal: [v]治愈,治疗;痊愈;恢复; [a]/hiːl/; [or]6j;
shatter: [v]使粉碎;砸碎;打碎;粉碎; [a]/ˈʃætər/; [or]6j;
bitterness: [n]苦味;辛酸;苦难; [a]/ˈbɪtərnəs/; [or]6j;
comparable: [adj]类似的,比得上的,可比较的; [a]/ˈkɑːmpərəbl/; [or]6j;
dual: [adj]双的;双重的; [a]/ˈduːəl/; [or]6j;
sexual: [adj]性别的;性的;性感的; [a]/ˈsekʃuəl/; [or]6j;
antenna: [n]天线,触角; [a]/ænˈtenə/; [or]6j;
fuse: [n]导火线,引信,保险丝;  [v](使)因保险丝熔断而中断工作,熔合,合并; [a]/fjuːz/; [or]6j;
intake: [n]吸入,收纳;纳入(数量); [a]/ˈɪnteɪk/; [or]6j;
intensify: [v]增强;加剧; [a]/ɪnˈtensɪfaɪ/; [or]6j;
cabin: [n](简陋的)小屋;船舱;客舱,机舱;  [v]住在小屋里; [a]/ˈkæbɪn/; [or]6j;
equivalent: [adj]相等的;等值的;  [n]同义词;等价物; [a]/ɪˈkwɪvələnt/; [or]6j;
circulation: [n]流传,传播;发行,发行量;(体液的)循环;(水,空气等的)流通;(货币等的)流通; [a]/ˌsɜːrkjəˈleɪʃn/; [or]6j;
relay: [n]替班;转播;接力赛跑;  [v]转播;传递; [a]/ˈriːleɪ/; [or]6j;
mortal: [adj]必有一死的;致命的;极端的;  [n]人类; [a]/ˈmɔːrtl/; [or]6j;
contribute: [v]增进,起促成作用;捐献,捐助;..的原因之一;投稿; [a]/kənˈtrɪbjuːt/; [or]6j;
ideology: [n]意识形态,思想(体系); [a]/ˌaɪdiˈɑːlədʒi/; [or]6j;
kilowatt: [n][物]千瓦(功率单位); [a]/ˈkɪləwɑːt/; [or]6j;
reclaim: [v]开拓,开垦;感化;取回;改造;废物回收利用; [a]/rɪˈkleɪm/; [or]6j;
redundant: [adj]多余的,过剩的;被下岗的; [a]/rɪˈdʌndənt/; [or]6j;
statement: [n]声明;结算单,报表;陈述; [a]/ˈsteɪtmənt/; [or]6j;
precise: [adj]精确的;恰好的; [a]/prɪˈsaɪs/; [or]6j;
hemisphere: [n](地球的)半球;大脑半球; [a]/ˈhemɪsfɪr/; [or]6j;
reveal: [v]揭示;透露;显示; [a]/rɪˈviːl/; [or]6j;
triple: [v]使成三倍,三倍于;  [adj]三倍的; [a]/ˈtrɪpl/; [or]6j;
inventory: [n]详细目录;存货清单; [a]/ˈɪnvəntɔːri/; [or]6j;
nought: [n]无;零; [a]/nɔːt/; [or]6j;
fuel: [v]给.加燃料;  [n]燃料;刺激因素; [a]/ˈfjuːəl/; [or]6j;
withdraw: [v]取款;撤退,收回,撤离; [a]/wɪðˈdrɔː/; [or]6j;
cruelty: [n]残忍,残酷(行为); [a]/ˈkruːəlti/; [or]6j;
dissipate: [v]消散,消失;浪费; [a]/ˈdɪsɪpeɪt/; [or]6j;
minimize: [v]使缩到最小;达到最低值; [a]/ˈmɪnɪmaɪz/; [or]6j;
depressed: [adj]沮丧的;萧条的;低迷的; [a]/dɪˈprest/; [or]6j;
asset: [n]财产,资产,有价值的东西或人; [a]/ˈæset/; [or]6j;
shield: [n]盾牌;防护物;  [v]保护; [a]/ʃiːld/; [or]6j;
adjust: [v]调整,调节;校正;改变.以适应; [a]/əˈdʒʌst/; [or]6j;
draft: [n]气流;通风,通风装置;草稿;汇票;征兵;  [v]起草;征兵; [a]/dræft/; [or]6j;
insulate: [v]隔离,使隔绝(以免受到影响);使隔热; [a]/ˈɪnsəleɪt/; [or]6j;
icy: [adj]多冰的; [a]/ˈaɪsi/; [or]6j;
suspicion: [n]怀疑,猜疑,疑心;少许; [a]/səˈspɪʃn/; [or]6j;
indignation: [n]愤慨; [a]/ˌɪndɪɡˈneɪʃn/; [or]6j;
Mars: [n]火星; [a]/mɑːrz/; [or]6j;
decorative: [adj]装饰的; [a]/ˈdekəreɪtɪv/; [or]6j;
preview: [n](电影,戏剧等的)预映;(电影等的)预告(片);  [v]预观;预习; [a]/ˈpriːvjuː/; [or]6j;
woodpecker: [n]啄木鸟; [a]/ˈwʊdpekər/; [or]6j;
precious: [n]<口>宝贝,心爱的人;  [adv]强调极少或太少;  [adj]珍贵的,宝贵的; [a]/ˈpreʃəs/; [or]6j;
hawk: [n]鹰;鹰派成员(以强硬态度或手段维护国家民族利益的个人,团体或势力);  [v]叫卖,兜售;散播; [a]/hɔːk/; [or]6j;
sprinkle: [v]撒,洒;下稀疏的雨;  [n]小雨;少量; [a]/ˈsprɪŋkl/; [or]6j;
brittle: [adj]易碎的;脆弱的;靠不住的;  [n]薄片脆糖; [a]/ˈbrɪtl/; [or]6j;
subsidy: [n]补助金,津贴; [a]/ˈsʌbsədi/; [or]6j;
command: [n]命令,指挥;  [v]发布命令,指挥;掌管,控制;指挥,命令;控制,管理; [a]/kəˈmænd/; [or]6j;
inclusive: [adj]包含..在内的,包罗广泛的; [a]/ɪnˈkluːsɪv/; [or]6j;
unreasonable: [adj]不合理的;过度的; [a]/ʌnˈriːznəbl/; [or]6j;
twist: [v]捻,搓;扭;歪曲;  [n]搓,扭拧;意外进展;弯曲处; [a]/twɪst/; [or]6j;
neutron: [n]中子; [a]/ˈnuːtrɑːn/; [or]6j;
array: [n]一系列;陈列;编队;  [v]排列;部署; [a]/əˈreɪ/; [or]6j;
stump: [n]树桩,残肢,残余的部分;  [v]把..难住,到处做演讲,沉重或笨重地移动; [a]/stʌmp/; [or]6j;
preservation: [n]保存,保护; [a]/ˌprezərˈveɪʃn/; [or]6j;
urine: [n]尿; [a]/ˈjʊrən/; [or]6j;
flaw: [n]瑕疵;缺点;  [v]使有缺陷;使不完美;有瑕疵; [a]/flɔː/; [or]6j;
consultant: [n]会诊医师,顾问医生;顾问; [a]/kənˈsʌltənt/; [or]6j;
popularity: [n]受大众欢迎; [a]/ˌpɑːpjuˈlærəti/; [or]6j;
pedestrian: [n]步行者,行人;  [adj]步行的;平庸无奇的,无聊的; [a]/pəˈdestriən/; [or]6j;
smash: [v]粉碎,猛冲,击溃;  [n]破碎(声),猛撞,巨大的成功;  [adj]极为成功的; [a]/smæʃ/; [or]6j;
metropolitan: [adj]大城市的,大都会的;大主教区的; [a]/ˌmetrəˈpɑːlɪtən/; [or]6j;
perplex: [v]使困惑; [a]/pərˈpleks/; [or]6j;
Pope: [n]教皇; [a]/poʊp/; [or]6j;
suite: [n](旅馆的)套间;一套家具;一组程序;组曲; [a]/swiːt/; [or]6j;
wholesome: [adj]有益于健康的;有益的; [a]/ˈhoʊlsəm/; [or]6j;
chapel: [n]小教堂;私人祈祷室; [a]/ˈtʃæpl/; [or]6j;
whirl: [v]回旋;使旋转;  [n]回旋;一个接一个的活动; [a]/wɜːrl/; [or]6j;
spotlight: [n]聚光灯;  [v]聚光照明,使显著; [a]/ˈspɑːtlaɪt/; [or]6j;
advertise: [v]为..做广告;公告;公布; [a]/ˈædvərtaɪz/; [or]6j;
armor: [n]盔甲;装甲; [a]/ˈɑrmər/; [or]6j;
expire: [v]期满,(期限)终止;断气,死亡; [a]/ɪkˈspaɪər/; [or]6j;
fertilizer: [n]肥料,化肥; [a]/ˈfɜːrtəlaɪzər/; [or]6j;
impulse: [n]冲动,脉冲,驱使; [a]/ˈɪmpʌls/; [or]6j;
erect: [v]搭建,竖起;建造,建立;  [adj]直立的,垂直的; [a]/ɪˈrekt/; [or]6j;
expert: [n]专家;  [adj]熟练的,专业的; [a]/ˈekspɜːrt/; [or]6j;
radiate: [v]辐射,发出(光或热);流露,显示;(使)从中心发散; [a]/ˈreɪdieɪt/; [or]6j;
detach: [v]使分开,拆卸;派遣; [a]/dɪˈtætʃ/; [or]6j;
essence: [n]本质,实质;精髓,精华; [a]/ˈesns/; [or]6j;
exchange: [v]交换,互换;交流;进行易货贸易;  [n]交换;交易所;(货币的)兑换; [a]/ɪksˈtʃeɪndʒ/; [or]6j;
chuck: [v]轻轻地扔;抛;丢弃; [a]/tʃʌk/; [or]6j;
excessively: [adv]过分地,非常地; [a]/ɪkˈsesɪvli/; [or]6j;
appreciation: [n]感激;欣赏,鉴识,评价;增值;理解,了解; [a]/əˌpriːʃiˈeɪʃn/; [or]6j;
embarrass: [vt]使窘迫,使尴尬(尤指在社交场合);困窘,困扰; [a]/ɪmˈbærəs/; [or]6j;
tribe: [n]部落; [a]/traɪb/; [or]6j;
notify: [v]通知,告知;报告; [a]/ˈnoʊtɪfaɪ/; [or]6j;
reassure: [v]使放心,使消除疑虑; [a]/ˌriːəˈʃʊr/; [or]6j;
transformation: [n]变化,改造,转变; [a]/ˌtrænsfərˈmeɪʃn/; [or]6j;
fabric: [n]布料,织物;质地,结构; [a]/ˈfæbrɪk/; [or]6j;
galaxy: [n]星系; [a]/ˈɡæləksi/; [or]6j;
species: [n](单复同)物种;种类;人类;  [adj]物种上的; [a]/ˈspiːʃiːz/; [or]6j;
rage: [n]极怒;盛怒;  [v]迅速蔓延,快速扩散;(战争等)激烈地进行; [a]/reɪdʒ/; [or]6j;
disproportionate: [adj]不成比例的; [a]/ˌdɪsprəˈpɔːrʃənət/; [or]6j;
immune: [adj]免疫的,有免疫力的;不受影响的;免除的; [a]/ɪˈmjuːn/; [or]6j;
wretched: [adj]可怜的;恶劣的;身心疲惫的; [a]/ˈretʃɪd/; [or]6j;
oval: [adj]椭圆形的;  [n]椭圆形; [a]/ˈoʊvl/; [or]6j;
senator: [n]参议员; [a]/ˈsenətər/; [or]6j;
illustrate: [v]举例说明,阐明;图解,加插图; [a]/ˈɪləstreɪt/; [or]6j;
rejoice: [v]欣喜,高兴; [a]/rɪˈdʒɔɪs/; [or]6j;
doubtless: [adv]无疑地;肯定地;  [adj]无疑的;肯定的; [a]/ˈdaʊtləs/; [or]6j;
Easter: [n]复活节; [a]/ˈiːstər/; [or]6j;
shadowy: [adj]朦胧的;模糊的;多荫的,阴凉的; [a]/ˈʃædoʊi/; [or]6j;
confer: [v]授予(奖项,学位,荣誉或权利);商讨,协商; [a]/kənˈfɜːr/; [or]6j;
process: [v]加工;处理;  [n]过程,进程;工序,程序;传票; [a]/ˈprɑːses/; [or]6j;
attractive: [adj]有魅力的;吸引人的;引起兴趣的; [a]/əˈtræktɪv/; [or]6j;
legend: [n]传说,传奇人物;(奖章纪念牌等的)铭文;地图的图例,插图的说明; [a]/ˈledʒənd/; [or]6j;
reserve: [n]储备;保留;保护区;  [v]保留;预定;储备; [a]/rɪˈzɜːrv/; [or]6j;
robust: [adj]健壮的,强壮的;精力充沛的;坚固的;粗鲁的; [a]/roʊˈbʌst/; [or]6j;
compound: [n]复合物;[化学]化合物;  [adj]合成的;复合的;多功能的;  [vi]妥协;和解;  [vt]混合;调和;调停;使恶化; [a]/ˈkɑːmpaʊnd/; [or]6j;
stream: [n]小河,溪流;流,一股,一串;  [v]流(出),涌(出);按能力分班(或分组); [a]/striːm/; [or]6j;
stimulus: [n]刺激物;鼓励;促进因素; [a]/ˈstɪmjələs/; [or]6j;
descend: [vi]走下;降临;  [v]下降,下来;突然访问;下移,下降; [a]/dɪˈsend/; [or]6j;
fitness: [n]适当,恰当,健康; [a]/ˈfɪtnəs/; [or]6j;
sulfur: [n]硫磺; [a]/ˈsʌlfər/; [or]6j;
psychiatrist: [n]精神病医生;精神病学家; [a]/saɪˈkaɪətrɪst/; [or]6j;
flank: [v]位于.的侧面;  [n]肋,肋腹,侧翼; [a]/flæŋk/; [or]6j;
correspondent: [n]通讯员,记者;通信者; [a]/ˌkɔːrəˈspɑːndənt/; [or]6j;
gauge: [n]测量仪;尺度,标准;  [v]估计,判断;计量; [a]/ɡeɪdʒ/; [or]6j;
quart: [n]夸脱; [a]/kwɔːrt/; [or]6j;
detail: [n]细节;详情;特遣队;  [vt]详述;派遣; [a]/ˈdiːteɪl/; [or]6j;
indispensable: [adj]必不可少的;必需的; [a]/ˌɪndɪˈspensəbl/; [or]6j;
utmost: [adj]最大的;极度的;最远的;  [n]极限; [a]/ˈʌtmoʊst/; [or]6j;
integrity: [n]正直,真诚;完整; [a]/ɪnˈteɡrəti/; [or]6j;
antique: [n]古董;古玩;古物;  [adj]古代的;古董的; [a]/ænˈtiːk/; [or]6j;
mammal: [n]哺乳动物; [a]/ˈmæml/; [or]6j;
grasshopper: [n]蚱蜢; [a]/ˈɡræshɑːpər/; [or]6j;
cripple: [n]跛子,伤残人(或动物);  [v]使跛;使受伤致残;严重削弱; [a]/ˈkrɪpl/; [or]6j;
quest: [n]探索,寻求;  [v]寻找,搜索; [a]/kwest/; [or]6j;
authorize: [v]批准;授权; [a]/ˈɔːθəraɪz/; [or]6j;
elliptical: [adj]椭圆的;省略的; [a]/ɪˈlɪptɪkl/; [or]6j;
burglar: [n]窃贼; [a]/ˈbɜːrɡlər/; [or]6j;
imperative: [adj]必要的;祈使的;急需的;  [n]命令;必要的事;义务;驱使; [a]/ɪmˈperətɪv/; [or]6j;
emission: [n]排放物;放射物; [a]/iˈmɪʃn/; [or]6j;
intervention: [n]介入;调停;干涉,干预; [a]/ˌɪntərˈvenʃn/; [or]6j;
dependant: [n](子女等)受抚养者; [a]/dɪˈpendənt/; [or]6j;
cholesterol: [n]胆固醇; [a]/kəˈlestərɔːl/; [or]6j;
artificial: [adj]人造的,人工的,假的;假装的,虚伪的;  [n]人造肥料;<美>假花; [a]/ˌɑːrtɪˈfɪʃl/; [or]6j;
disease: [n]疾病; [a]/dɪˈziːz/; [or]6j;
rebuke: [v]指责;  [n]谴责; [a]/rɪˈbjuːk/; [or]6j;
breed: [n]血统;种类;  [v]产仔;繁殖;使繁殖; [a]/briːd/; [or]6j;
threshold: [n]门槛;开端; [a]/ˈθreʃhoʊld/; [or]6j;
interrupt: [v]打扰;打断,中断;插嘴;妨碍; [a]/ˌɪntəˈrʌpt/; [or]6j;
assess: [v]评估;估值; [a]/əˈses/; [or]6j;
category: [n]类别;范畴; [a]/ˈkætəɡɔːri/; [or]6j;
superstition: [n]迷信,盲目恐惧; [a]/ˌsuːpərˈstɪʃn/; [or]6j;
element: [n]元素;成分;要素;电炉,热水器等的电热元件,电热丝; [a]/ˈelɪmənt/; [or]6j;
overcome: [v]战胜;克服;压倒;得胜,征服; [a]/ˌoʊvərˈkʌm/; [or]6j;
outermost: [adj]最外面的;最远的; [a]/ˈaʊtərmoʊst/; [or]6j;
quantify: [v]确定数量; [a]/ˈkwɑːntɪfaɪ/; [or]6j;
perfume: [n]香水;香气;  [v]使充满芳香;洒香水于; [a]/pərˈfjuːm/; [or]6j;
Jesus: [n]耶稣;  excl. 天哪;岂有此理; [a]/ˈdʒiːzəs/; [or]6j;
invariably: [adv]总是;不变地,永恒地; [a]/ɪnˈveriəbli/; [or]6j;
stroke: [n]击打;一击,一次,一举;中风;抚摸;笔画;  [v]拭去;轻抚; [a]/stroʊk/; [or]6j;
vulnerable: [adj]易受伤的;脆弱的;易受攻击的; [a]/ˈvʌlnərəbl/; [or]6j;
retention: [n]保留,保持; [a]/rɪˈtenʃn/; [or]6j;
commercial: [adj]商业性的,贸易的;  [n]商业广告; [a]/kəˈmɜːrʃl/; [or]6j;
solution: [n]解决办法;解答;溶液;溶解; [a]/səˈluːʃn/; [or]6j;
formulate: [v]构想出(计划,方法等);系统地阐述; [a]/ˈfɔːrmjuleɪt/; [or]6j;
rational: [adj]理性的;理智的;合理的; [a]/ˈræʃnəl/; [or]6j;
flexible: [adj]易曲的,柔软的,灵活的; [a]/ˈfleksəbl/; [or]6j;
completion: [n]完成,完满; [a]/kəmˈpliːʃn/; [or]6j;
mar: [v]毁坏,弄糟,玷污; [a]/mɑːr/; [or]6j;
lieutenant: [n]陆军中尉,海军上尉,空军中尉;副队长;助理官员;警督; [a]/luːˈtenənt/; [or]6j;
dominate: [v]在.中占首要地位;支配,统治,控制;耸立于,俯视;处于支配地位,拥有优势; [a]/ˈdɑːmɪneɪt/; [or]6j;
muscular: [adj]肌肉的;肌肉发达的;强有力的; [a]/ˈmʌskjələr/; [or]6j;
optimist: [n]乐天派,乐观者; [a]/ˈɑːptɪmɪst/; [or]6j;
literal: [adj]字面上的;照字面的;缺乏想像力的; [a]/ˈlɪtərəl/; [or]6j;
shepherd: [n]牧羊人;  [v]带领; [a]/ˈʃepərd/; [or]6j;
preside: [v]主持; [a]/prɪˈzaɪd/; [or]6j;
rely: [v]依赖,依靠;信赖; [a]/rɪˈlaɪ/; [or]6j;
bald: [adj]秃头的; [a]/bɔːld/; [or]6j;
hush: [vi]安静下来;嘘!别做声!别吵!;  [vt]使安静;  [n]安静; [a]/hʌʃ/; [or]6j;
hierarchy: [n]阶层,等级制度; [a]/ˈhaɪərɑːrki/; [or]6j;
recover: [v]恢复;痊愈,恢复健康;收回;换回;重新获得;重新找到; [a]/rɪˈkʌvər/; [or]6j;
gene: [n]基因; [a]/dʒiːn/; [or]6j;
relative: [n]亲戚,家人,亲属;相关物,关系词,同类事物;  [adj]相对的;有关系的,(语)关系的; [a]/ˈrelətɪv/; [or]6j;
strive: [v]斗争;努力,奋斗; [a]/straɪv/; [or]6j;
mustard: [n]芥菜;芥末;芥末色;  [adj]芥末色的; [a]/ˈmʌstərd/; [or]6j;
defective: [adj]有缺陷的; [a]/dɪˈfektɪv/; [or]6j;
magistrate: [n]法官; [a]/ˈmædʒɪstreɪt/; [or]6j;
supreme: [adj]至高的;最重要的;极度的; [a]/suːˈpriːm/; [or]6j;
rein: [n]缰绳;  [v]控制; [a]/reɪn/; [or]6j;
inference: [n]推断,推断的结果; [a]/ˈɪnfərəns/; [or]6j;
immigrate: [v]移居入境; [a]/ˈɪmɪɡreɪt/; [or]6j;
cozy: [adj]温暖舒适的,安逸的;  [v]取悦; [a]/ˈkoʊzi/; [or]6j;
bleach: [v]漂白;  [n]漂白剂; [a]/bliːtʃ/; [or]6j;
greed: [n]贪欲,贪婪;贪吃; [a]/ɡriːd/; [or]6j;
orchestra: [n]管弦乐队;  [adj]管弦乐队的; [a]/ˈɔːrkɪstrə/; [or]6j;
motivate: [vt]激励;使有动机;促进;促动;激发..的积极性; [a]/ˈmoʊtɪveɪt/; [or]6j;
interfere: [v]干涉,妨碍;妨碍;干涉;  [vi]妨碍; [a]/ˌɪntərˈfɪr/; [or]6j;
attach: [v]系;贴;附上;附加;缚; [a]/əˈtætʃ/; [or]6j;
rectify: [v]纠正;修复; [a]/ˈrektɪfaɪ/; [or]6j;
harmony: [n]和谐;和声;和睦;协调; [a]/ˈhɑːrməni/; [or]6j;
modest: [adj]谦虚的,谦逊的;端庄的,羞怯的;不太大(或太贵,太重要)的,适度的; [a]/ˈmɑːdɪst/; [or]6j;
flatter: [v]阿谀,使高兴;(肖像等)胜过(真人真物);自鸣得意,自以为是; [a]/ˈflætər/; [or]6j;
argue: [v]争吵;主张,认为;提供.证据,提出证明;表明(原因等); [a]/ˈɑːrɡjuː/; [or]6j;
complaint: [n]抱怨,怨言;不满的缘由,痛苦根源;控诉;投诉; [a]/kəmˈpleɪnt/; [or]6j;
migrate: [vi]迁徙;迁移,移往;迁移; [a]/ˈmaɪɡreɪt/; [or]6j;
annoy: [v]使烦恼,使生气;  [n]烦恼(等于annoyance); [a]/əˈnɔɪ/; [or]6j;
customary: [adj]合乎习俗的;惯常的; [a]/ˈkʌstəmeri/; [or]6j;
calculus: [n](数)微积分学; [a]/ˈkælkjələs/; [or]6j;
pineapple: [n]凤梨,菠萝; [a]/ˈpaɪnæpl/; [or]6j;
disposition: [n]性情,性格;意向,倾向;排列,部署; [a]/ˌdɪspəˈzɪʃn/; [or]6j;
indifferent: [adj]不感兴趣的,不关心的;平庸的;冷漠的; [a]/ɪnˈdɪfrənt/; [or]6j;
individual: [adj]个别的,独特的;单独的;  [n]独立的个体; [a]/ˌɪndɪˈvɪdʒuəl/; [or]6j;
disagreement: [n]分歧,不和;不一致; [a]/ˌdɪsəˈɡriːmənt/; [or]6j;
span: [n]跨度;时间段;范围;持续时间;  [v]持续;横跨;包括; [a]/spæn/; [or]6j;
sacrifice: [vt]牺牲;祭献;  [vi]奉献;做出牺牲;  [n]祭品;牺牲; [a]/ˈsækrɪfaɪs/; [or]6j;
kidney: [n]肾,腰子; [a]/ˈkɪdni/; [or]6j;
racial: [adj]种族的;人种的; [a]/ˈreɪʃl/; [or]6j;
juggle: [v]玩杂耍;同时做;对.巧妙应付; [a]/ˈdʒʌɡl/; [or]6j;
minimum: [adj]最少的,最低程度的;  [n]最低限度,最小量; [a]/ˈmɪnɪməm/; [or]6j;
install: [v]安装,安置,使就职; [a]/ɪnˈstɔːl/; [or]6j;
paradise: [n]天国;天堂;极乐世界; [a]/ˈpærədaɪs/; [or]6j;
cork: [n]软木;  [v]塞住,抑制; [a]/kɔːrk/; [or]6j;
scar: [n]伤疤,伤痕;内心创伤;  [v](给.)留下伤痕; [a]/skɑːr/; [or]6j;
pathetic: [adj]可怜的;不足的; [a]/pəˈθetɪk/; [or]6j;
wag: [n]摇摆;爱说笑的人;  [v]摇动; [a]/wæɡ/; [or]6j;
multiplication: [n]乘法; [a]/ˌmʌltɪplɪˈkeɪʃn/; [or]6j;
committee: [n]委员会;全体委员; [a]/kəˈmɪti/; [or]6j;
tensile: [adj]可拉长的,可伸长的,[物]张力的,拉力的; [a]/ˈtensl/; [or]6j;
previous: [adj]以前的;早先的;过早的; [a]/ˈpriːviəs/; [or]6j;
latent: [adj]潜在的,隐伏的,不易察觉的; [a]/ˈleɪtnt/; [or]6j;
molecular: [adj]分子的; [a]/məˈlekjələr/; [or]6j;
eject: [v](使)弹出;喷射;放逐; [a]/iˈdʒekt/; [or]6j;
fax: [n]传真(机);传真件;  [v]用传真传输; [a]/fæks/; [or]6j;
fighter: [n]战士;战斗机,歼击机; [a]/ˈfaɪtər/; [or]6j;
principally: [adv]主要地; [a]/ˈprɪnsəpli/; [or]6j;
perimeter: [n]周长;周界; [a]/pəˈrɪmɪtər/; [or]6j;
elicit: [v]引出;诱出;探出; [a]/iˈlɪsɪt/; [or]6j;
beware: [v]当心,谨防; [a]/bɪˈwer/; [or]6j;
scope: [n]瞄准镜;范围;余地; [a]/skoʊp/; [or]6j;
destructive: [adj]破坏(性)的,毁灭(性)的; [a]/dɪˈstrʌktɪv/; [or]6j;
timber: [n]木料;树木;性格,素质;  excl. 树要倒啦!;  [adj]木材的,木制的;  [v]用木材作骨架;以林木覆盖; [a]/ˈtɪmbər/; [or]6j;
stereotype: [n]老套的模式,陈规,成见;  [v]对..产生成见; [a]/ˈsteriətaɪp/; [or]6j;
bonus: [n]奖金,额外津贴; [a]/ˈboʊnəs/; [or]6j;
limp: [n]跛行;  [vi]一瘸一拐地走,跛行;慢腾腾地进行;  [adj]无力的,无生气的;柔软的,软弱的; [a]/lɪmp/; [or]6j;
agitation: [n]摇动;焦虑,忧虑;煽动; [a]/ˌædʒɪˈteɪʃn/; [or]6j;
prudent: [adj]谨慎的,精明的; [a]/ˈpruːdnt/; [or]6j;
symposium: [n]专题报告会; [a]/sɪmˈpoʊziəm/; [or]6j;
clinical: [adj]临床的;冷静的; [a]/ˈklɪnɪkl/; [or]6j;
episode: [n]插曲,片断;连续剧的一集;一段经历; [a]/ˈepɪsoʊd/; [or]6j;
tempt: [v]诱惑;吸引;冒..的风险,不顾; [a]/tempt/; [or]6j;
kin: [n]亲属; [a]/kɪn/; [or]6j;
compassion: [n]同情;怜悯; [a]/kəmˈpæʃn/; [or]6j;
corps: [n](由两个或以上师组成的)军,兵团;一群人;特别小组; [a]/kɔːr/; [or]6j;
exploit: [v]剥削,利用;开发,开拓;  [n]辉煌功绩; [a]/ɪkˈsplɔɪt/; [or]6j;
realistic: [adj]现实(主义)的;现实可行的;逼真的,栩栩如生的; [a]/ˌriːəˈlɪstɪk/; [or]6j;
Antarctic: [adj]南极的;  [n]南极区; [a]/ænˈtɑːrktɪk/; [or]6j;
memorize: [v]熟记; [a]/ˈmeməraɪz/; [or]6j;
rating: [n]评价;等级;等级评定;额定功率;评分,收视率; [a]/ˈreɪtɪŋ/; [or]6j;
curly: [adj]卷曲的,卷毛的,弯曲的; [a]/ˈkɜːrli/; [or]6j;
saturate: [v]使充满,使饱和,使湿透; [a]/ˈsætʃəreɪt/; [or]6j;
accord: [n]协议;  [v]授予; [a]/əˈkɔːrd/; [or]6j;
behavior: [n]行为;举止;态度; [a]/bɪ'heɪvjə/; [or]6j;
evolution: [n]进化,演变;发展; [a]/ˌevəˈluːʃn/; [or]6j;
deed: [n]行为;契约; [a]/diːd/; [or]6j;
handicap: [n]障碍,阻碍,不利条件,不利因素;残疾,缺陷,生理缺陷;[高尔夫]给弱者增加的杆数(按击球次数计数,并随参赛者的进步而减少);  [v]使不利,妨碍; [a]/ˈhændikæp/; [or]6j;
pose: [n]姿势;装腔作势,伪装;  [vi]摆造型;  [vt]主张,提出;引起,导致; [a]/poʊz/; [or]6j;
coincide: [v]巧合,一致,相符; [a]/ˌkoʊɪnˈsaɪd/; [or]6j;
infusion: [n]灌输;注入物;输入; [a]/ɪnˈfjuːʒn/; [or]6j;
chronic: [adj](疾病)慢性的;长期的;(人)久病的;积习难改的;严重的; [a]/ˈkrɑːnɪk/; [or]6j;
nominal: [adj]名义上的;象征性的,很少的;名词性的; [a]/ˈnɑːmɪnl/; [or]6j;
slang: [n]俚语,行话; [a]/slæŋ/; [or]6j;
microprocessor: [n]微处理器; [a]/ˌmaɪkroʊˈproʊsesər/; [or]6j;
hum: [v]发出嗡嗡声,哼(歌曲);  [n]轰鸣声,嗡嗡营营声; [a]/hʌm/; [or]6j;
ingenious: [adj]聪明的;有发明天才的;有独创性的,别出心裁的; [a]/ɪnˈdʒiːniəs/; [or]6j;
cute: [adj]可爱的;讨人喜爱的;聪明的; [a]/kjuːt/; [or]6j;
tactics: [n]战术,策略; [a]/'tæktɪks/; [or]6j;
compactness: [n]紧密;小巧;紧凑; [a]/kəmˈpæktnəs/; [or]6j;
bibliography: [n]参考书目;文献学; [a]/ˌbɪbliˈɑːɡrəfi/; [or]6j;
sergeant: [n]士官,中士,警官; [a]/ˈsɑːrdʒənt/; [or]6j;
spoil: [v]溺爱;娇惯;(食物)变质;毁坏;  [n]溺爱;战利品;犒劳;成功所带来的好处; [a]/spɔɪl/; [or]6j;
batter: [n](用鸡蛋,牛奶等调制的)面糊;  [v]连续猛击; [a]/ˈbætər/; [or]6j;
proficiency: [n]熟练;精通; [a]/prəˈfɪʃnsi/; [or]6j;
extent: [n]范围;程度;宽度;长度; [a]/ɪkˈstent/; [or]6j;
deliberately: [adv]故意地;慢条斯理地; [a]/dɪˈlɪbərətli/; [or]6j;
climax: [n]高潮,最令人兴奋(或感兴趣)的部分;  [v](使)达到顶点,(使)达到高潮; [a]/ˈklaɪmæks/; [or]6j;
skeptical: [adj]表示怀疑的; [a]/ˈskeptɪkl/; [or]6j;
stern: [adj]严厉的;严峻的;苛刻的;坚决的;  [n]船尾; [a]/stɜːrn/; [or]6j;
context: [n]上下文,语境;背景; [a]/ˈkɑːntekst/; [or]6j;
monitor: [n]显示器;监视器;班长;  [v]监视;监督;监测; [a]/ˈmɑːnɪtər/; [or]6j;
incident: [n]事件;事变,军事冲突,冲突;事故;  [adj][法]附带的;[光]入射的;易发生的,伴随而来的; [a]/ˈɪnsɪdənt/; [or]6j;
handout: [n]宣传单;施舍物;印刷品;讲义;小册子; [a]/ˈhændaʊt/; [or]6j;
capacitor: [n]电容器; [a]/kəˈpæsɪtər/; [or]6j;
conversion: [n]转变,转换;宗教,信仰上的转变;[经济学]兑换; [a]/kənˈvɜːrʒn/; [or]6j;
segregate: [v]分开,隔离,进行种族隔离; [a]/ˈseɡrɪɡeɪt/; [or]6j;
maple: [n]枫树;枫木; [a]/ˈmeɪpl/; [or]6j;
lathe: [n]车床; [a]/leɪð/; [or]6j;
ultimate: [adj]根本的;最后的,最终的; [a]/ˈʌltɪmət/; [or]6j;
hindrance: [n]妨碍;障碍物; [a]/ˈhɪndrəns/; [or]6j;
trader: [n]商人; [a]/ˈtreɪdər/; [or]6j;
producer: [n]电影制片人;电视制作人,制作公司;出产地; [a]/prəˈduːsər/; [or]6j;
thrive: [v]茁壮成长;繁荣,兴旺; [a]/θraɪv/; [or]6j;
romance: [n]浪漫;  [v]向..求爱; [a]/ˈroʊmæns/; [or]6j;
earthenware: [n][总称]陶器;  [adj]陶制的; [a]/ˈɜːrθnwer/; [or]6j;
commence: [v]开始; [a]/kəˈmens/; [or]6j;
oar: [n]桨,橹; [a]/ɔːr/; [or]6j;
bead: [n]珠子;水珠; [a]/biːd/; [or]6j;
fake: [adj]假的,伪造的;  [n]骗子;假货,赝品;  [v]假造,杜撰;伪造;冒充,假装;假装; [a]/feɪk/; [or]6j;
rapture: [n]狂喜; [a]/ˈræptʃər/; [or]6j;
permeate: [v]弥漫;普及;渗透; [a]/ˈpɜːrmieɪt/; [or]6j;
mint: [n]薄荷,薄荷糖,造币厂;  [v]铸造(硬币); [a]/mɪnt/; [or]6j;
vegetation: [n]植被; [a]/ˌvedʒəˈteɪʃn/; [or]6j;
dub: [v]授予(称号);为(电影)配音;混录录制(音乐);  [n](西印度群岛的)强节奏音乐; [a]/dʌb/; [or]6j;
heater: [n]加热器;发热器; [a]/ˈhiːtər/; [or]6j;
fiction: [n]虚构;想象;小说; [a]/ˈfɪkʃn/; [or]6j;
virtual: [adj](计算机)虚拟的;十分接近的;实质上的; [a]/ˈvɜːrtʃuəl/; [or]6j;
diagnose: [v]诊断(疾病),对(病人)下诊断结论; [a]/ˌdaɪəɡˈnoʊs/; [or]6j;
dodge: [n]托词;躲闪,躲避;  [v]回避,规避;躲避,避开; [a]/dɑːdʒ/; [or]6j;
deformation: [n]变形;畸形; [a]/ˌdiːfɔːrˈmeɪʃn/; [or]6j;
toss: [v]扔,抛,掷;  [n]掷,掷钱币来决定,猛抬头; [a]/tɔːs/; [or]6j;
recall: [v]回想起,记起,回忆;召回;  [n]召回(有问题的产品); [a]/rɪˈkɔːl/; [or]6j;
identical: [adj]相同的,同样的,一模一样的;相似的;  [n]完全相同的事物; [a]/aɪˈdentɪkl/; [or]6j;
kidnap: [v]诱拐;绑架; [a]/ˈkɪdnæp/; [or]6j;
nourish: [v]养育;培育(希望);增强(希望); [a]/ˈnɜːrɪʃ/; [or]6j;
arrest: [v]逮捕,拘留;吸引;  [n]逮捕,拘留; [a]/əˈrest/; [or]6j;
deny: [v]否认,拒绝承认,拒绝给予,自制; [a]/dɪˈnaɪ/; [or]6j;
submarine: [n]潜水艇;  [adj]水底的,海底的; [a]/ˈsʌbməriːn/; [or]6j;
prevalent: [adj]普遍的,流行的; [a]/ˈprevələnt/; [or]6j;
slack: [adj]松弛的;懈怠的;萧条的;  [n]松弛的部分,松散;  [v]变松弛,逃避工作; [a]/slæk/; [or]6j;
contest: [n]比赛,竞争;  [v]争夺,争论; [a]/ˈkɑːntest/; [or]6j;
release: [v]释放;解放;发行;  [n]解除;免除;发表; [a]/rɪˈliːs/; [or]6j;
odor: [n]气味; [a]/ˈoʊdər/; [or]6j;
incapable: [adj]无能力的,不能的; [a]/ɪnˈkeɪpəbl/; [or]6j;
accident: [n]事故;意外;偶然; [a]/ˈæksɪdənt/; [or]6j;
stereo: [n]立体声(装置);  [adj]立体声的; [a]/ˈsterioʊ/; [or]6j;
rigorous: [adj]严厉的,严格的; [a]/ˈrɪɡərəs/; [or]6j;
mock: [v]嘲笑;轻蔑,蔑视;  [adj]不真诚的;伪造的;  [n]模拟考; [a]/mɑːk/; [or]6j;
complexion: [n]肤色;特性; [a]/kəmˈplekʃn/; [or]6j;
worthy: [adj](of)值得..的,配得上..的,可尊敬的,有价值的;  [n]知名人士;杰出人物; [a]/ˈwɜːrði/; [or]6j;
slot: [n]狭缝,狭槽,(机构的)职位;  [v]把.放入狭长开口中,把.纳入; [a]/slɑːt/; [or]6j;
constituent: [adj]组成的;有选举权的;  [n]选民;成分; [a]/kənˈstɪtʃuənt/; [or]6j;
alternate: [adj]交替的,轮流的,间隔的;  [v](使)交替,(使)轮流;  [n]代替者; [a]/ˈɔːltərnət/; [or]6j;
intensive: [adj]加强的,强调的;精耕细作的;密集的;  [n]加强器;[语]强义词,强调成份; [a]/ɪnˈtensɪv/; [or]6j;
symphony: [n]交响乐; [a]/ˈsɪmfəni/; [or]6j;
seam: [n]缝;接缝;地层; [a]/siːm/; [or]6j;
approve: [v]称许,赞成,批准; [a]/əˈpruːv/; [or]6j;
similar: [adj]相似的;类似的;  [n]类似物;相像的人;相似物; [a]/ˈsɪmələr/; [or]6j;
hail: [n]冰雹;一阵;  [v]下冰雹;歌颂; [a]/heɪl/; [or]6j;
leopard: [n]豹;美洲豹;美洲虎; [a]/ˈlepərd/; [or]6j;
contribution: [n]贡献,投稿稿件,捐献物; [a]/ˌkɑːntrɪˈbjuːʃn/; [or]6j;
obtain: [v]获得,赢得,取得;存在,流行,适用; [a]/əbˈteɪn/; [or]6j;
threaten: [vt]威胁;危及;恐吓;预示..的恶兆;  [v]恐吓; [a]/ˈθretn/; [or]6j;
apparatus: [n]装置,仪器;设备;组织,机构; [a]/ˌæpəˈrætəs/; [or]6j;
strait: [n]海峡;窘迫; [a]/streɪt/; [or]6j;
decrease: [v]减少;减;  [n]减;减少; [a]/dɪˈkriːs/; [or]6j;
pristine: [adj]原始的;古时的;纯朴的;崭新的; [a]/ˈprɪstiːn/; [or]6j;
primary: [adj]初等教育的;初级的;基本的;首要的;主要的;  [n]首选;(美)初选; [a]/ˈpraɪmeri/; [or]6j;
curt: [adj]简略的; [a]/kɜːrt/; [or]6j;
account: [n]账户;原因,理由;叙述;  [v]报账,做出说明(或解释),为.负责,受罚;认为,考虑; [a]/əˈkaʊnt/; [or]6j;
relevant: [adj]有关的;恰当的;贴切的; [a]/ˈreləvənt/; [or]6j;
advantageous: [adj]有利的; [a]/ˌædvənˈteɪdʒəs/; [or]6j;
assert: [v]断言;肯定地说;坚持;维护; [a]/əˈsɜːrt/; [or]6j;
absorb: [vt]吸收;汲取;吸引..的注意;理解,掌握;承受; [a]/əbˈzɔːrb/; [or]6j;
thermal: [adj]保暖的;温泉的;热的;  [n]保暖内衣裤; [a]/ˈθɜːrml/; [or]6j;
ward: [n]病房;行政区;受监护人;  [v]守护,躲开; [a]/wɔːrd/; [or]6j;
tile: [n]瓦;瓷砖;  [v]贴砖于;用瓦盖; [a]/taɪl/; [or]6j;
preclude: [v]阻止;排除; [a]/prɪˈkluːd/; [or]6j;
authority: [n]权威;威信;当局,官方;权力,职权; [a]/əˈθɔːrəti/; [or]6j;
hasty: [adj]匆忙的;仓促完成的;草率的; [a]/ˈheɪsti/; [or]6j;
facilitate: [v]为他人提供方便;使便利;  [vt]促进; [a]/fəˈsɪlɪteɪt/; [or]6j;
shrimp: [n](小)虾; [a]/ʃrɪmp/; [or]6j;
remain: [v]剩余;逗留;保持不变;依然,继续;  [n]剩余物;遗迹;残骸; [a]/rɪˈmeɪn/; [or]6j;
publicity: [n]公开(性),公众的关注;宣传;名声; [a]/pʌbˈlɪsəti/; [or]6j;
strand: [n](线等的)股,缕;一个组成部分;海滨,河岸,海滩,湖滨;  [v]使陷入困境;使滞留,使搁浅; [a]/strænd/; [or]6j;
valve: [n]阀门,活门; [a]/vælv/; [or]6j;
assume: [v]猜想;以为,假设;呈现;就职;(想当然地)认为;承担(责任); [a]/əˈsuːm/; [or]6j;
insight: [n]深刻的理解,洞察力,见识; [a]/ˈɪnsaɪt/; [or]6j;
witness: [n]目击者,证人;  [v]目击,亲眼看见;为..作证; [a]/ˈwɪtnəs/; [or]6j;
proposition: [n]提议,计划,命题;  [v]向.求欢; [a]/ˌprɑːpəˈzɪʃn/; [or]6j;
bowel: [n]肠;内部; [a]/ˈbaʊəl/; [or]6j;
motto: [n]座右铭;格言;箴言;口号; [a]/ˈmɑːtoʊ/; [or]6j;
distinguish: [v]区别,识别,辨别,使显著; [a]/dɪˈstɪŋɡwɪʃ/; [or]6j;
objection: [n]反对,异议; [a]/əbˈdʒekʃn/; [or]6j;
emergency: [n]紧急情况;突发事件; [a]/iˈmɜːrdʒənsi/; [or]6j;
barge: [n]平底货船,驳船;  [v]猛撞; [a]/bɑːrdʒ/; [or]6j;
cautious: [adj]小心的,谨慎的; [a]/ˈkɔːʃəs/; [or]6j;
drastic: [adj]极端的;猛烈的;激烈的; [a]/ˈdræstɪk/; [or]6j;
absorption: [n]吸收;全神贯注;合并; [a]/əbˈsɔːrpʃn/; [or]6j;
privacy: [n]隐私;秘密;私生活; [a]/ˈpraɪvəsi/; [or]6j;
primitive: [adj]原始的;简陋的;  [n]原始人; [a]/ˈprɪmətɪv/; [or]6j;
inspector: [n]检查员,督察员;视察者,检阅者;(英)查票员; [a]/ɪnˈspektər/; [or]6j;
exceptional: [adj]优越的,杰出的;异常的; [a]/ɪkˈsepʃənl/; [or]6j;
merchandise: [n]商品,货品;  [v]推销,经营; [a]/ˈmɜːrtʃəndaɪs/; [or]6j;
polymer: [n]聚合体; [a]/ˈpɑːlɪmər/; [or]6j;
sophisticated: [adj](仪器)精密的,复杂的;老于世故的,老练的,富有经验的;高雅的,精致的; [a]/səˈfɪstɪkeɪtɪd/; [or]6j;
astronomer: [n]天文学家; [a]/əˈstrɑːnəmər/; [or]6j;
moor: [v]停泊;系住;  [n]旷野地;荒野; [a]/mʊr/; [or]6j;
furnish: [v](用家具等)布置(房间,公寓等);供应,提供; [a]/ˈfɜːrnɪʃ/; [or]6j;
disastrous: [adj]灾难性的; [a]/dɪˈzæstrəs/; [or]6j;
squat: [adj]蹲着的;  [v]蹲坐,蹲伏;  [n]蹲坐; [a]/skwɑːt/; [or]6j;
blink: [v]眨眼睛;闪亮;闪烁;  [n]眨眼睛; [a]/blɪŋk/; [or]6j;
ascend: [v]沿着.上升,攀登; [a]/əˈsend/; [or]6j;
force: [v]强迫;推动;凭借武力前进;  [n]力量;武力;势力; [a]/fɔːrs/; [or]6j;
commit: [v]犯(罪);进行 (自杀);调拨 (钱,资源);监禁;送交 (到精神病院,监狱等);承诺,保证; [a]/kəˈmɪt/; [or]6j;
athlete: [n]运动员,体育家,强壮的人; [a]/ˈæθliːt/; [or]6j;
perish: [vi]死去;毁灭,灭亡;  [v]脆裂,老化,腐烂; [a]/ˈperɪʃ/; [or]6j;
discriminate: [v]区别,辨别;歧视; [a]/dɪˈskrɪmɪneɪt/; [or]6j;
filth: [n]污秽图片;污物;对警察的冒犯言辞; [a]/fɪlθ/; [or]6j;
creation: [n]创造,创作;创造物,作品; [a]/kriˈeɪʃn/; [or]6j;
cavity: [n]洞;龋洞; [a]/ˈkævəti/; [or]6j;
bug: [n][计算机](制作软件程序所产生的意料不到的)错误,故障;窃听器;热衷于(某事)者;臭虫,小虫子;  [v]使厌烦,打扰;窃听;  [vt]使烦恼,纠缠; [a]/bʌɡ/; [or]6j;
cynical: [adj]愤世嫉俗的;恶意的;悲观的; [a]/ˈsɪnɪkl/; [or]6j;
currency: [n]货币;流通;流行; [a]/ˈkɜːrənsi/; [or]6j;
bound: [adj]受约束的;有义务的;一定的;  [v]束缚;跳跃着前行;  [n]跳跃;范围;界限; [a]/baʊnd/; [or]6j;
complicated: [adj]复杂的;难解的;  [v]使复杂; [a]/ˈkɑːmplɪkeɪtɪd/; [or]6j;
salute: [n]致意;致敬,欢迎;  [v]向..行举手礼;敬礼; [a]/səˈluːt/; [or]6j;
pasture: [n]牧场,草地;生活状况;  [v]放牧; [a]/ˈpæstʃər/; [or]6j;
maiden: [n](文学)少女,未嫁女子;  [adj]未婚的,处女的,初次的; [a]/ˈmeɪdn/; [or]6j;
swap: [v]交换;替换;对调;  [n]交换;交换物; [a]/swɑːp/; [or]6j;
band: [n]乐队;帮伙;带;  [v]用带捆扎;联合; [a]/bænd/; [or]6j;
graduate: [v]毕业;渐变;渐渐变为;取得资格;授予.学位;  [n]大学毕业生;学位获得者;  [adj]毕业的;研究生的; [a]/ˈɡrædʒuət/; [or]6j;
endurance: [n]忍耐力,耐性,耐用度; [a]/ɪnˈdʊrəns/; [or]6j;
visualize: [v]使形象化;想象; [a]/ˈvɪʒuəlaɪz/; [or]6j;
oxidize: [v]生锈;氧化; [a]/ˈɑːksɪdaɪz/; [or]6j;
salvation: [n]拯救,救赎;救助;救世; [a]/sælˈveɪʃn/; [or]6j;
flask: [n]烧瓶;长颈瓶;扁瓶; [a]/flæsk/; [or]6j;
promote: [v]提升;促进;发扬;促销; [a]/prəˈmoʊt/; [or]6j;
background: [n]图片背景,底色;出身;背景;时代背景; [a]/ˈbækɡraʊnd/; [or]6j;
extract: [v]取出;提取;摘录;设法得到;索取;  [n]摘录;提出物; [a]/ɪkˈstrækt/; [or]6j;
fortress: [n]堡垒;要塞; [a]/ˈfɔːrtrəs/; [or]6j;
terrify: [v]使害怕;使惊恐; [a]/ˈterɪfaɪ/; [or]6j;
vary: [v]相异;改变,变化;使多样化; [a]/ˈveri/; [or]6j;
diversion: [n]绕行路;转移,改变方向;分心,消遣;分水渠; [a]/daɪˈvɜːrʒn/; [or]6j;
deliberate: [adj]故意的;深思熟虑的;从容不迫的;  [v]仔细考虑;研讨; [a]/dɪˈlɪbərət/; [or]6j;
dazzle: [n]光辉;令人赞叹的东西;  [v]使眼花;使赞叹不已; [a]/ˈdæzl/; [or]6j;
evoke: [v]唤起;引起;使人想起; [a]/ɪˈvoʊk/; [or]6j;
twinkle: [vi]闪烁;闪闪发光; [a]/ˈtwɪŋkl/; [or]6j;
overlook: [v]忽视,未注意到;眺望,俯视;  [n]忽视,远眺; [a]/ˌoʊvərˈlʊk/; [or]6j;
pantry: [n]食品室;餐具室; [a]/ˈpæntri/; [or]6j;
shrewd: [adj]精明的;机灵的;  [n]精明;精明者; [a]/ʃruːd/; [or]6j;
deflect: [v](使)偏斜,(使)偏转; [a]/dɪˈflekt/; [or]6j;
cradle: [n]摇篮;策源地,发源地;  [v]轻轻地抱,捧; [a]/ˈkreɪdl/; [or]6j;
originality: [n]创造性;独创性; [a]/əˌrɪdʒəˈnæləti/; [or]6j;
ivory: [n]象牙,象牙制品;乳白色; [a]/ˈaɪvəri/; [or]6j;
malice: [n]恶意,怨恨; [a]/ˈmælɪs/; [or]6j;
blond: [adj]金色的,亚麻色的(头发);白皙的,金发碧眼的(人); [a]/blɑnd/; [or]6j;
diesel: [n]内燃机,柴油机; [a]/ˈdiːzl/; [or]6j;
destination: [n]目的地,终点;  [adj]目的地的; [a]/ˌdestɪˈneɪʃn/; [or]6j;
hoe: [n]锄头;  [v]用锄耕地; [a]/hoʊ/; [or]6j;
blush: [v]脸红;害臊;  [n]脸红; [a]/blʌʃ/; [or]6j;
hazard: [n]公害;危险;危险的事物;机会;  [v]使冒危险;冒险做; [a]/ˈhæzərd/; [or]6j;
litter: [n]垃圾;杂乱;  [v]乱丢; [a]/ˈlɪtər/; [or]6j;
heave: [v]用力举起;掷扔;发出叹息;恶心;  [n]举起,升降; [a]/hiːv/; [or]6j;
bridegroom: [n]新郎; [a]/ˈbraɪdɡruːm/; [or]6j;
environmental: [adj]周围的;环境的; [a]/ɪnˌvaɪrənˈmentl/; [or]6j;
compensate: [v]补偿,赔偿,给..报酬; [a]/ˈkɑːmpenseɪt/; [or]6j;
coup: [n]政变;出乎意料的行动或胜利; [a]/kuː/; [or]6j;
input: [n]投入;[电学,计算机]输入;  [vt]输入; [a]/ˈɪnpʊt/; [or]6j;
reinforce: [v]加固;加强;增援;支持; [a]/ˌriːɪnˈfɔːrs/; [or]6j;
postal: [adj]邮政的,邮局的;邮件的; [a]/ˈpoʊstl/; [or]6j;
announcement: [n]宣告,发表,一项公告; [a]/əˈnaʊnsmənt/; [or]6j;
patron: [n]老主顾;赞助人;支持者; [a]/ˈpeɪtrən/; [or]6j;
spacious: [adj]宽敞的,广阔的; [a]/ˈspeɪʃəs/; [or]6j;
mortgage: [n]按揭贷款,抵押贷款;  [v]抵押; [a]/ˈmɔːrɡɪdʒ/; [or]6j;
murmur: [v]低声说,低语;低声抱怨;  [n]低语;喃喃说话声; [a]/ˈmɜːrmər/; [or]6j;
manuscript: [n]手稿;底稿;手抄本; [a]/ˈmænjuskrɪpt/; [or]6j;
poster: [n]海报,张贴的大幅广告;贴标语的人; [a]/ˈpoʊstər/; [or]6j;
bushel: [n](pl.)大量;蒲式耳(容量等于八加仑); [a]/ˈbʊʃl/; [or]6j;
alien: [n]外国人;外星人;  [adj]陌生的;外国的,外星(人)的;异己的,不相容的; [a]/ˈeɪliən/; [or]6j;
guilt: [n]内疚;罪行;罪恶感; [a]/ɡɪlt/; [or]6j;
hurricane: [n]飓风; [a]/ˈhɜːrəkeɪn/; [or]6j;
deadly: [adj]致命的,致死的,十足的;  [adv]死一般地;非常; [a]/ˈdedli/; [or]6j;
convict: [n]犯人;  [v](经审讯)证明..有罪,使..知罪; [a]/ˈkɑːnvɪkt/; [or]6j;
catastrophe: [n]大灾难; [a]/kəˈtæstrəfi/; [or]6j;
elevate: [v]上升;提高;举起;提拔; [a]/ˈelɪveɪt/; [or]6j;
idleness: [n]闲散;赋闲无事; [a]/ˈaɪdlnəs/; [or]6j;
cooperative: [adj]合作的;协作的;  [n]合作社; [a]/koʊˈɑːpərətɪv/; [or]6j;
testimony: [n]证据,证词;表明,说明;见证,证明; [a]/ˈtestɪmoʊni/; [or]6j;
incomplete: [adj]不完全的;未完成的,未结束的;  [n]未完成,未修毕; [a]/ˌɪnkəmˈpliːt/; [or]6j;
impetus: [n]推动力;促进; [a]/ˈɪmpɪtəs/; [or]6j;
extraordinary: [adj]非同寻常的;特别的; [a]/ɪkˈstrɔːrdəneri/; [or]6j;
random: [adj]随机的;任意的;胡乱的; [a]/ˈrændəm/; [or]6j;
fearless: [adj]大胆的,勇敢的,无畏的; [a]/ˈfɪrləs/; [or]6j;
confidence: [n]自信,信心;信任;有把握; [a]/ˈkɑːnfɪdəns/; [or]6j;
integral: [adj](用于构成整体)必需的,不可缺少的,必不可少的;基本的,作为组成部分的,内置的;整体的,完整的; [a]/ˈɪntɪɡrəl/; [or]6j;
impart: [v]传授,给予,将(某性质)给予或赋予某事物; [a]/ɪmˈpɑːrt/; [or]6j;
levy: [v]征收(税等);  [n]征税;税款; [a]/ˈlevi/; [or]6j;
relish: [v]享受;享受.的味道;品味;  [n]乐趣;调味品; [a]/ˈrelɪʃ/; [or]6j;
revel: [n]狂欢;  [v]狂欢; [a]/ˈrevl/; [or]6j;
rival: [n]竞争者,对手;  [v]与.竞争,与.匹敌;  [adj]竞争的,敌对的; [a]/ˈraɪvl/; [or]6j;
elite: [n]精英;  [adj]高级的; [a]/ɪˈliːt/; [or]6j;
alliance: [n]联盟,同盟;盟约;盟国,同盟者;类同; [a]/əˈlaɪəns/; [or]6j;
region: [n]地区,区域;范围;行政区;身体部位; [a]/ˈriːdʒən/; [or]6j;
equilibrium: [n](心态情感等)平静;平衡; [a]/ˌiːkwɪˈlɪbriəm/; [or]6j;
pregnant: [adj]怀孕的;充满的,意味深长的; [a]/ˈpreɡnənt/; [or]6j;
propulsion: [n]推进力; [a]/prəˈpʌlʃn/; [or]6j;
prime: [adj]首要的,主要的;最好的,第一流的;  [n]青春,全盛期,青壮年时期;  [v]使准备好; [a]/praɪm/; [or]6j;
ascribe: [v]把.归因于;把.归属于; [a]/əˈskraɪb/; [or]6j;
beyond: [adv]更远处,更多,以后;  prep. 超过;在能力,理解力之外;除..之外; [a]/bɪˈjɑːnd/; [or]6j;
abide: [v]遵守;忍受;居住; [a]/əˈbaɪd/; [or]6j;
bud: [n]蓓蕾,芽;  [v]使发芽; [a]/bʌd/; [or]6j;
pirate: [n]海盗;剽窃者;  [v]剽窃; [a]/ˈpaɪrət/; [or]6j;
diffuse: [v]传播;扩散,弥漫;漫射;  [adj]四散的,散开的;不清楚的; [a]/dɪˈfjuːz/; [or]6j;
proximity: [n]接近;邻近; [a]/prɑːkˈsɪməti/; [or]6j;
manual: [n]手册;指南;  [adj]手的;手制的;手工的;体力的; [a]/ˈmænjuəl/; [or]6j;
gutter: [n]水槽,檐槽,排水沟;贫民区;  [v](蜡烛)忽明忽暗; [a]/ˈɡʌtər/; [or]6j;
factual: [adj]事实的;真实的; [a]/ˈfæktʃuəl/; [or]6j;
identity: [n]身份;特性;一致; [a]/aɪˈdentəti/; [or]6j;
bacterium: [n]细菌; [a]/bæk'tɪriəm/; [or]6j;
alienate: [v]疏远;挑拨; [a]/ˈeɪliəneɪt/; [or]6j;
academic: [adj]学术的;学院的,大学的;理论的;  [n]学者; [a]/ˌækəˈdemɪk/; [or]6j;
orthodox: [adj]正统的;传统的;(Orthodox)东正教的; [a]/ˈɔːrθədɑːks/; [or]6j;
resign: [v]辞职; [a]/rɪˈzaɪn/; [or]6j;
retirement: [n]退休,退休生活;退役; [a]/rɪˈtaɪərmənt/; [or]6j;
diploma: [n]毕业文凭,毕业证书;文凭课程; [a]/dɪˈploʊmə/; [or]6j;
implication: [n]暗示;含意;牵连;卷入;可能的后果; [a]/ˌɪmplɪˈkeɪʃn/; [or]6j;
fascinate: [v]使着迷;使神魂颠倒;吸引注意; [a]/ˈfæsɪneɪt/; [or]6j;
shovel: [n]铁锨,铲;  [v]铲起; [a]/ˈʃʌvl/; [or]6j;
psychology: [n]心理学;心理状态;心理; [a]/saɪˈkɑːlədʒi/; [or]6j;
household: [n]同住在一家的人;家务;家常普通的;  [adj]家庭的,家内的,一家的;家喻户晓的; [a]/ˈhaʊshoʊld/; [or]6j;
appease: [v]抚慰;平息; [a]/əˈpiːz/; [or]6j;
obedient: [adj]服从的,顺从的;孝顺的; [a]/oʊˈbiːdiənt/; [or]6j;
slash: [n]砍痕;砍;  [v]砍,大幅度削减; [a]/slæʃ/; [or]6j;
cocktail: [n]鸡尾酒;餐前开胃小吃;混合物; [a]/ˈkɑːkteɪl/; [or]6j;
intuition: [n]直觉;感觉; [a]/ˌɪntuˈɪʃn/; [or]6j;
consist: [v]由..组成;在于; [a]/kənˈsɪst/; [or]6j;
terminology: [n]术语,术语学; [a]/ˌtɜːrməˈnɑːlədʒi/; [or]6j;
regulation: [n]法规,条例,规章;管理; [a]/ˌreɡjuˈleɪʃn/; [or]6j;
pluck: [v]拔去(毛发等);拽开;选;  [n]勇气; [a]/plʌk/; [or]6j;
gross: [adj]总的,毛重的;恶心的;粗鲁的;  [n]总量,总额;  [adv]总共地;  [vt]总共赚得; [a]/ɡroʊs/; [or]6j;
contract: [n]合同,契约;  [v]感染(疾病);招致;订合同;订立(婚约);缩减; [a]/ˈkɑːntrækt/; [or]6j;
absence: [n]缺席;缺勤;缺乏;缺席,心不在焉; [a]/ˈæbsəns/; [or]6j;
embed: [v]把.嵌入;使嵌入; [a]/ɪmˈbed/; [or]6j;
degradation: [n]降级,降格;退化;恶化; [a]/ˌdeɡrəˈdeɪʃn/; [or]6j;
rattle: [n]格格声,发出嘎嘎声的儿童玩具,(响尾蛇)音响器官;  [v](使)发出格格声,(人或车)疾驰,使烦扰; [a]/ˈrætl/; [or]6j;
tablet: [n]药片;便笺簿;碑,匾; [a]/ˈtæblət/; [or]6j;
conception: [n]怀孕,构想,设想,思想,观念; [a]/kənˈsepʃn/; [or]6j;
dwell: [v](尤指作为常住居民)居住; [a]/dwel/; [or]6j;
famine: [n]饥荒;严重的缺乏; [a]/ˈfæmɪn/; [or]6j;
trend: [n]趋势;倾向;时尚;  [v]倾向;走向;转向;使趋向; [a]/trend/; [or]6j;
sector: [n](经济等)部门,部分;战区,防区;扇形,扇区; [a]/ˈsektər/; [or]6j;
stuffy: [adj]闷热的;古板的;鼻子不通气的; [a]/ˈstʌfi/; [or]6j;
brightness: [n]明亮;聪明,智慧;[光]亮度; [a]/ˈbraɪtnəs/; [or]6j;
gallery: [n]美术馆,画廊;(大厅的)旁听席,边座; [a]/ˈɡæləri/; [or]6j;
eruption: [n]喷发;(情绪)爆发;出疹; [a]/ɪˈrʌpʃn/; [or]6j;
convene: [v]集合,召集,召唤; [a]/kənˈviːn/; [or]6j;
item: [n]物品;条,条款,项目; [a]/ˈaɪtəm/; [or]6j;
constrain: [v]约束;限制;强迫; [a]/kənˈstreɪn/; [or]6j;
ranch: [n]大农场; [a]/ræntʃ/; [or]6j;
contact: [v]接触;联系;  [n]接触;联系;  [adj]保持接触的;由接触引起的;[航]可看见地面景物的;  [adv][航]以目力观察(飞行);  int. 开动; [a]/ˈkɑːntækt/; [or]6j;
repay: [v]偿还(钱款或债务);报答;回报; [a]/rɪˈpeɪ/; [or]6j;
negligible: [adj]微不足道的,可忽略不计的; [a]/ˈneɡlɪdʒəbl/; [or]6j;
executive: [n]执行者;经理;行政人员;  [adj]执行的; [a]/ɪɡˈzekjətɪv/; [or]6j;
hostile: [adj]敌对的,敌方的;怀敌意的; [a]/ˈhɑːstl/; [or]6j;
lash: [v]鞭打;猛烈抨击;捆绑;摆动;猛击;  [n]鞭梢;鞭打; [a]/læʃ/; [or]6j;
navigation: [n]导航,航行,航海; [a]/ˌnævɪˈɡeɪʃn/; [or]6j;
idiot: [n]愚蠢的人,白痴; [a]/ˈɪdiət/; [or]6j;
humble: [adj]卑微的;(级别或地位)低下的,简陋的;谦逊的;  [v]使⋯谦逊,使⋯卑下;轻松打败(尤指强大的对手); [a]/ˈhʌmbl/; [or]6j;
beetle: [n]甲虫;  [v]快速移动; [a]/ˈbiːtl/; [or]6j;
residential: [adj]居住的,住宅的;寄宿的; [a]/ˌrezɪˈdenʃl/; [or]6j;
admiration: [n]钦佩;仰慕; [a]/ˌædməˈreɪʃn/; [or]6j;
climate: [n]气候;(社会思想等)趋势; [a]/ˈklaɪmət/; [or]6j;
turtle: [n]海龟; [a]/ˈtɜːrtl/; [or]6j;
thrash: [v]打(谷),(用棍,鞭等)痛打,打败,使逆行,胜过;  [n]敲击摇滚乐; [a]/θræʃ/; [or]6j;
offensive: [adj]冒犯的,进攻的,无礼的,令人不快的,得罪人的;  [n]进攻; [a]/əˈfensɪv/; [or]6j;
panic: [n]恐慌;惊慌;慌乱;  [v](使)恐慌;使..惊慌失措;  [adj]恐慌的,惊慌的; [a]/ˈpænɪk/; [or]6j;
coffin: [n]棺材; [a]/ˈkɔːfɪn/; [or]6j;
wealthy: [n]富人;  [adj]富有的;充分的; [a]/ˈwelθi/; [or]6j;
recreation: [n]娱乐活动,消遣; [a]/ˌrekriˈeɪʃn/; [or]6j;
captive: [adj]被捕获的;被俘虏的;  [n]俘虏; [a]/ˈkæptɪv/; [or]6j;
narration: [n]叙述;解说;配音; [a]/nəˈreɪʃn/; [or]6j;
parallel: [adj]平行的;相似的;  [n]相似物;平行线;  [v]与..相似;与..匹配;  [adv]并行地,平行地; [a]/ˈpærəlel/; [or]6j;
windmill: [n]风车;风车房; [a]/ˈwɪndmɪl/; [or]6j;
transcend: [v]超越(经验,理性,信念等)的范围,超过; [a]/trænˈsend/; [or]6j;
syndrome: [n]［医］综合征;一系列表现; [a]/ˈsɪndroʊm/; [or]6j;
canvas: [n]帆布,(帆布)油画; [a]/ˈkænvəs/; [or]6j;
gaze: [v]凝视,注视;  [n]凝视,注视; [a]/ɡeɪz/; [or]6j;
transmission: [n]发射,转播,传播,变速器; [a]/trænsˈmɪʃn/; [or]6j;
stationery: [n]文具;(有配套信封的)信纸; [a]/ˈsteɪʃəneri/; [or]6j;
sociable: [adj]好交际的; [a]/ˈsoʊʃəbl/; [or]6j;
verdict: [n](陪审团)裁决;定论;意见; [a]/ˈvɜːrdɪkt/; [or]6j;
penalty: [n]惩罚,处罚,不利,罚球;  [adj]处罚的; [a]/ˈpenəlti/; [or]6j;
intelligible: [adj]可理解的,明白易懂的; [a]/ɪnˈtelɪdʒəbl/; [or]6j;
shipwreck: [n]遇难船;船只失事;  [v]使遭遇海难; [a]/ˈʃɪprek/; [or]6j;
federation: [n]同盟,联盟,联邦; [a]/ˌfedəˈreɪʃn/; [or]6j;
perception: [n]洞察力,理解力;洞察力,理解力,认识,观念,看法; [a]/pərˈsepʃn/; [or]6j;
literary: [adj]文学的,文学上的;精通文学的;以写作为职业的;书本上的;书面的;书面语的; [a]/ˈlɪtəreri/; [or]6j;
aware: [adj]意识到的,知道的; [a]/əˈwer/; [or]6j;
anonymous: [adj]匿名的;无名的;不具名的;无特色的;无个性特征; [a]/əˈnɑːnɪməs/; [or]6j;
straightforward: [adj]坦率的,笔直的,正直的,直接的; [a]/ˌstreɪtˈfɔːrwərd/; [or]6j;
gnaw: [v]啃,咬,消耗,侵蚀; [a]/nɔː/; [or]6j;
embark: [v]上船或飞机;开始,着手,从事; [a]/ɪmˈbɑːrk/; [or]6j;
prophet: [n]先知,预言者; [a]/ˈprɑːfɪt/; [or]6j;
defeat: [n]挫败;击败,战胜;  [v]打败;战胜; [a]/dɪˈfiːt/; [or]6j;
gigantic: [adj]巨大的; [a]/dʒaɪˈɡæntɪk/; [or]6j;
efficient: [adj]效率高的;有能力的;能胜任的; [a]/ɪˈfɪʃnt/; [or]6j;
owl: [n]猫头鹰; [a]/aʊl/; [or]6j;
utilization: [n]利用; [a]/ˌjuːtələˈzeɪʃn/; [or]6j;
earnings: [n]工资;收入;收益; [a]/ˈɜːrnɪŋz/; [or]6j;
concentration: [n]集中;专注;浓缩; [a]/ˌkɑːnsnˈtreɪʃn/; [or]6j;
rascal: [n]不诚实的人;坏蛋,淘气鬼; [a]/ˈræskl/; [or]6j;
toward: prep. 向;朝;对于; [a]/tɔːrd/; [or]6j;
hostility: [n]虐待,敌意;不友善;敌对; [a]/hɑːˈstɪləti/; [or]6j;
lure: [v]引诱;以诱饵吸引;  [n]诱惑力;诱惑物;鱼饵; [a]/lʊr/; [or]6j;
glamour: [n]魅力;诱惑力; [a]/ˈɡlæmər/; [or]6j;
skull: [n]颅骨;脑壳; [a]/skʌl/; [or]6j;
symbol: [n]象征;符号,图标;记号;标志; [a]/ˈsɪmbl/; [or]6j;
calcium: [n]钙; [a]/ˈkælsiəm/; [or]6j;
reputation: [n]名声;声誉; [a]/ˌrepjuˈteɪʃn/; [or]6j;
pajamas: [n](=pyjamas)睡衣,宽长裤; [a]/pəˈdʒæməz/; [or]6j;
sensation: [n]感觉;知觉;轰动; [a]/senˈseɪʃn/; [or]6j;
urban: [adj]城市的,城镇的,都市的; [a]/ˈɜːrbən/; [or]6j;
peripheral: [adj]外围的;  [n]外围设备; [a]/pəˈrɪfərəl/; [or]6j;
offspring: [n]后代; [a]/ˈɔːfsprɪŋ/; [or]6j;
mobilize: [v]动员起来;动员;鼓动起; [a]/ˈmoʊbəlaɪz/; [or]6j;
signify: [vi]具有重要性;  [vt]表示; [a]/ˈsɪɡnɪfaɪ/; [or]6j;
capsule: [n]胶囊;航天舱,密封舱; [a]/ˈkæpsl/; [or]6j;
auditorium: [n]〈美〉讲堂;听众席; [a]/ˌɔːdɪˈtɔːriəm/; [or]6j;
productive: [adj]多产的;产生..的;富有成效的; [a]/prəˈdʌktɪv/; [or]6j;
console: [v]安慰,慰问;  [n]控制台,仪表板;落地柜; [a]/kənˈsoʊl/; [or]6j;
audience: [n](演讲,音乐会等的)听众,观众;正式会见;拥护者; [a]/ˈɔːdiəns/; [or]6j;
disapprove: [v]不同意; [a]/ˌdɪsəˈpruːv/; [or]6j;
obligation: [n]义务,责任; [a]/ˌɑːblɪˈɡeɪʃn/; [or]6j;
reef: [n]礁;  [v]收帆,缩帆; [a]/riːf/; [or]6j;
vent: [n]发泄;通风口,排气口;(上衣背部或两侧的)开衩;(小型动物的)排泄口;  [v]发泄(情绪),开孔,泄露; [a]/vent/; [or]6j;
attitude: [n]态度;看法;姿势; [a]/ˈætɪtuːd/; [or]6j;
linguistic: [adj]语言的,语言上的; [a]/lɪŋˈɡwɪstɪk/; [or]6j;
status: [n]地位;状态;身份; [a]/ˈsteɪtəs/; [or]6j;
cruise: [n]巡航;漫游;旅行;  [v]航游;巡航;(出租车,船等)缓慢巡行; [a]/kruːz/; [or]6j;
tame: [adj]驯服的,温顺的;顺从的;枯燥的;  [v]驯服; [a]/teɪm/; [or]6j;
barrier: [n]障碍;屏障;隔阂;壁垒;  [v]用栅栏围住; [a]/ˈbæriər/; [or]6j;
tuberculosis: [n]肺结核; [a]/tuːˌbɜːrkjəˈloʊsɪs/; [or]6j;
missionary: [n]传教士; [a]/ˈmɪʃəneri/; [or]6j;
gracious: [adj]和善的;亲切的;优美的;奢华的; [a]/ˈɡreɪʃəs/; [or]6j;
appendix: [n]附录;阑尾;附属物; [a]/əˈpendɪks/; [or]6j;
drawback: [n]缺点;障碍,不利条件; [a]/ˈdrɔːbæk/; [or]6j;
apartment: [n](美)公寓,一套房间; [a]/əˈpɑːrtmənt/; [or]6j;
ancient: [adj]远古的,古代的,古老的;  [n]古代人;古文明国的国民; [a]/ˈeɪnʃənt/; [or]6j;
proficient: [adj]精通的,熟练的; [a]/prəˈfɪʃnt/; [or]6j;
slippery: [adj]滑的;易滑脱的;不老实的;不稳定的; [a]/ˈslɪpəri/; [or]6j;
adapt: [vi]适应不同情况;  [vt]使适合;改编; [a]/əˈdæpt/; [or]6j;
intestine: [n]肠; [a]/ɪnˈtestɪn/; [or]6j;
radiant: [adj]光芒四射的,绚丽的;喜悦的; [a]/ˈreɪdiənt/; [or]6j;
wharf: [n]码头; [a]/wɔːrf/; [or]6j;
stairway: [n]楼梯; [a]/ˈsterweɪ/; [or]6j;
ore: [n]矿石;矿砂;矿,矿石; [a]/ɔːr/; [or]6j;
epilogue: [n]收场白;尾声; [a]/ˈepɪlɔːɡ/; [or]6j;
coke: [n]可乐;焦炭; [a]/koʊk/; [or]6j;
bureaucracy: [n]官僚主义;政府机构; [a]/bjʊˈrɑːkrəsi/; [or]6j;
component: [n]零件;  [adj]组成的; [a]/kəmˈpoʊnənt/; [or]6j;
quota: [n]配额;限额;定额; [a]/ˈkwoʊtə/; [or]6j;
rip: [n]裂缝,裂口;  [v]撕开,扯破,裂开,敲诈; [a]/rɪp/; [or]6j;
aviation: [n]航空,航空学;飞机制造业; [a]/ˌeɪviˈeɪʃn/; [or]6j;
module: [n]组件,模件,(航天器的)舱;(组成一门课程的)独立单元; [a]/ˈmɑːdʒuːl/; [or]6j;
nourishment: [n]食物,营养品; [a]/ˈnɜːrɪʃmənt/; [or]6j;
vigorous: [adj]精力充沛的;强有力的,有活力的;强健的; [a]/ˈvɪɡərəs/; [or]6j;
original: [adj]有独创性的,原始的,最初的,新颖的;  [n]原件;怪人; [a]/əˈrɪdʒənl/; [or]6j;
noted: [adj]著名的; [a]/ˈnoʊtɪd/; [or]6j;
brilliant: [adj]聪颖的;卓越的,有才气的;明亮的; [a]/ˈbrɪliənt/; [or]6j;
pumpkin: [n]南瓜,倭瓜; [a]/ˈpʌmpkɪn/; [or]6j;
respective: [adj]各自的; [a]/rɪˈspektɪv/; [or]6j;
sieve: [n]筛子,粗篮;  [v]筛,滤; [a]/sɪv/; [or]6j;
erase: [v](计算机)擦除;抹去;擦掉; [a]/ɪˈreɪs/; [or]6j;
formidable: [adj]令人畏惧的;可怕的;难以克服的;难应付的; [a]/ˈfɔːrmɪdəbl/; [or]6j;
glitter: [v]闪闪发光,闪耀;  [n]灿烂的光辉,闪光; [a]/ˈɡlɪtər/; [or]6j;
dedicate: [v]献给,致力于; [a]/ˈdedɪkeɪt/; [or]6j;
adore: [v]很喜欢,极喜爱;崇拜;爱慕; [a]/əˈdɔːr/; [or]6j;
repeal: [n]撤销;  [v]废除;废止; [a]/rɪˈpiːl/; [or]6j;
couch: [n]长沙发;长椅;长榻;  [v]表达; [a]/kaʊtʃ/; [or]6j;
provided: [conj]假如,如果,以..为条件;  [adj]预备好的,提供的; [a]/prəˈvaɪdɪd/; [or]6j;
activate: [v]使活动起来;使开始起作用; [a]/ˈæktɪveɪt/; [or]6j;
repression: [n]压抑,压制,镇压; [a]/rɪˈpreʃn/; [or]6j;
depict: [v]描绘,描写; [a]/dɪˈpɪkt/; [or]6j;
ruthless: [adj]无情的;残忍的; [a]/ˈruːθləs/; [or]6j;
peg: [n]小钉,栓,挂物钉;晾衣夹;  [v]用钉子钉,用钉(或桩等)固定;限定(价格,工资等);将.看成,将.归入; [a]/peɡ/; [or]6j;
affection: [n]关爱,爱慕;感情;作用,影响;疾病; [a]/əˈfekʃn/; [or]6j;
tiresome: [adj]使人疲倦的;烦人的,讨厌的;无聊的; [a]/ˈtaɪərsəm/; [or]6j;
forge: [n]熔炉;锻工车间;铁匠店;  [v]锻造;经锻炼而形成;伪造;推进,加强; [a]/fɔːrdʒ/; [or]6j;
economic: [adj]经济上的,经济学的;合算的;有利可图的; [a]/ˌekəˈnɑːmɪk/; [or]6j;
assassination: [n]暗杀; [a]/əˌsæsəˈneɪʃn/; [or]6j;
refinery: [n]精炼厂; [a]/rɪˈfaɪnəri/; [or]6j;
prosperous: [adj]富裕的;繁荣的;茂盛的;茁壮生长的; [a]/ˈprɑːspərəs/; [or]6j;
fixture: [n]固定装置;体育项目; [a]/ˈfɪkstʃər/; [or]6j;
acquire: [v](尤指靠自己的努力或行动或经过一个过程)获得;学到;取得; [a]/əˈkwaɪər/; [or]6j;
sneak: [vi]鬼鬼祟祟地走;打小报告;  [vt]潜行;偷窃;  [adj]偷偷的;  [n]行为鬼祟的人; [a]/sniːk/; [or]6j;
fury: [n]狂怒,暴怒; [a]/ˈfjʊri/; [or]6j;
plaster: [n]灰泥,石膏;  [v]抹泥; [a]/ˈplæstər/; [or]6j;
dismay: [n]失望;沮丧;惊愕;  [v]使惊恐; [a]/dɪsˈmeɪ/; [or]6j;
inorganic: [adj]无机的; [a]/ˌɪnɔːrˈɡænɪk/; [or]6j;
complication: [n](新出现的)困难,难题;并发症; [a]/ˌkɑːmplɪˈkeɪʃn/; [or]6j;
grin: [v]露齿而笑,咧嘴一笑;  [n]龇牙笑; [a]/ɡrɪn/; [or]6j;
dim: [adj]暗淡的;模糊的;朦胧的;  [v]变暗淡; [a]/dɪm/; [or]6j;
leakage: [n]泄漏; [a]/ˈliːkɪdʒ/; [or]6j;
dread: [v]惧怕,害怕;  [n]畏惧,恐惧;  [adj]恐怖的,使人敬畏的; [a]/dred/; [or]6j;
vigour: [n]活力; [a]/ˈvɪɡər/; [or]6j;
confirmation: [n]证实,确认,批准; [a]/ˌkɑːnfərˈmeɪʃn/; [or]6j;
knit: [v]编结,针织;  [n]编织的衣服;针织衫; [a]/nɪt/; [or]6j;
confirm: [v]确认;证实;批准; [a]/kənˈfɜːrm/; [or]6j;
guideline: [n]指导路线,准则; [a]/ˈɡaɪdlaɪn/; [or]6j;
sham: [n]假货;虚假;欺诈;  [v]假装;  [adj]虚假的,假装的; [a]/ʃæm/; [or]6j;
readily: [adv]容易地;乐意地;欣然地; [a]/ˈredɪli/; [or]6j;
subsequent: [adj]随后的; [a]/ˈsʌbsɪkwənt/; [or]6j;
chestnut: [n]栗子,栗树;  [adj]栗色的; [a]/ˈtʃesnʌt/; [or]6j;
shark: [n]鲨鱼;骗子; [a]/ʃɑːrk/; [or]6j;
scrub: [v]用力擦洗;宣布中止;  [n]灌木丛;擦洗; [a]/skrʌb/; [or]6j;
escort: [n]护送者;  [v]护送; [a]/ˈeskɔːrt/; [or]6j;
adhere: [v]遵守;坚持;粘附;附着,粘在..上; [a]/ədˈhɪr/; [or]6j;
molten: [adj]熔化的; [a]/ˈmoʊltən/; [or]6j;
temper: [n]脾气,性情;调和剂;  [v]锻炼,缓和; [a]/ˈtempər/; [or]6j;
instinct: [n]天性;本能;直觉;  [adj]充满的; [a]/ˈɪnstɪŋkt/; [or]6j;
ignite: [v]点燃,发光,燃烧; [a]/ɪɡˈnaɪt/; [or]6j;
federal: [adj]联邦制的;联邦政府的; [a]/ˈfedərəl/; [or]6j;
shutter: [n]百叶窗;照相机快门; [a]/ˈʃʌtər/; [or]6j;
resemblance: [n]相似,形似; [a]/rɪˈzembləns/; [or]6j;
unanimous: [adj]全体一致的;一致同意的; [a]/juˈnænɪməs/; [or]6j;
confession: [n]忏悔;坦白,供认;教派; [a]/kənˈfeʃn/; [or]6j;
toad: [n][动]蟾蜍,癞蛤蟆,讨厌的家伙; [a]/toʊd/; [or]6j;
recipe: [n]方法;食谱; [a]/ˈresəpi/; [or]6j;
tickle: [v]呵.痒,使发痒;使高兴;  [n]痒; [a]/ˈtɪkl/; [or]6j;
pastry: [n]糕点,点心; [a]/ˈpeɪstri/; [or]6j;
eclipse: [n](日,月)食;黯然失色;  [v]掩盖..的重要性;使暗淡; [a]/ɪˈklɪps/; [or]6j;
luxurious: [adj]奢侈的,豪华的; [a]/lʌɡˈʒʊriəs/; [or]6j;
screw: [n]螺旋;螺丝;  [v]拧紧;  [vi]敲诈勒索;  [vt]用螺钉固定;把.拧紧; [a]/skruː/; [or]6j;
deprive: [v]使丧失;剥夺;免去.的职务; [a]/dɪˈpraɪv/; [or]6j;
recede: [vi]退去;渐渐远去;(尤指问题,感情或品质)逐渐减弱;(头发)从前向后减少;向后倾斜; [a]/rɪˈsiːd/; [or]6j;
hypothesis: [n]假说;假设; [a]/haɪˈpɑːθəsɪs/; [or]6j;
legacy: [n]遗赠(物);遗产; [a]/ˈleɡəsi/; [or]6j;
aspiration: [n]抱负,志向;发 h 音; [a]/ˌæspəˈreɪʃn/; [or]6j;
gear: [n]档位;齿轮;装备;衣物;  [v]使适合; [a]/ɡɪr/; [or]6j;
sardine: [n][鱼]沙丁鱼; [a]/ˌsɑːrˈdiːn/; [or]6j;
blunt: [adj]钝的;直率的;  [v]使情感,感觉,需求减弱;变钝; [a]/blʌnt/; [or]6j;
peak: [n]顶峰;山顶;尖端;  [v]达到最高点;  [adj]最高度的;高峰时期的;巅峰状态的; [a]/piːk/; [or]6j;
religious: [adj]宗教的;虔诚的; [a]/rɪˈlɪdʒəs/; [or]6j;
considerable: [adj]相当大的;重要的;可观的; [a]/kənˈsɪdərəbl/; [or]6j;
sparkle: [vi]闪耀;焕发,活跃,才华横溢;  [n]光亮;活力; [a]/ˈspɑːrkl/; [or]6j;
curse: [n]诅咒;咒骂;祸因;  [v]诅咒;咒骂;使受罪; [a]/kɜːrs/; [or]6j;
option: [n]选择;选择权;选修课;  [v]得到或获准进行选择;调动球员; [a]/ˈɑːpʃn/; [or]6j;
occasional: [adj]偶尔的;临时的;偶然的; [a]/əˈkeɪʒənl/; [or]6j;
scorch: [v]烧焦;枯萎;  [vi]高速行驶,疾驰,飞驰; [a]/skɔːrtʃ/; [or]6j;
replacement: [n]代替物;接替者;更换; [a]/rɪˈpleɪsmənt/; [or]6j;
cuckoo: [n]杜鹃鸟;布谷鸟;  [adj]疯狂的; [a]/ˈkʊkuː/; [or]6j;
identify: [v]认出,联系;识别;确定,鉴定,发现;认为.等同,认为.关系紧密;表明.的身份;认同,有共鸣,有同感; [a]/aɪˈdentɪfaɪ/; [or]6j;
combine: [v]使混合(结合,组合,联合);结合;联合;组合;  [n]联合体,联合企业;联合收割机; [a]/kəmˈbaɪn/; [or]6j;
environment: [n]环境;外界;工作平台; [a]/ɪnˈvaɪrənmənt/; [or]6j;
discern: [v]辨别;识别;看出; [a]/dɪˈsɜːrn/; [or]6j;
traverse: [v]横越;穿过;  [n]横越; [a]/trəˈvɜːrs/; [or]6j;
deem: [v]认为,视为;知道,相信; [a]/diːm/; [or]6j;
handbook: [n]手册;指南; [a]/ˈhændbʊk/; [or]6j;
corrupt: [v]变腐败,堕落;贿赂,使腐败;  [adj]腐败的;堕落的; [a]/kəˈrʌpt/; [or]6j;
lily: [n]百合; [a]/ˈlɪli/; [or]6j;
tutor: [n]家庭教师,指导教师;  [v]个别指导;当.家庭教师; [a]/ˈtuːtər/; [or]6j;
fabricate: [v]建造,制造,伪造(文件等),捏造,编造(谎言,借口等); [a]/ˈfæbrɪkeɪt/; [or]6j;
makeup: [n]化妆品; [a]/'meɪkˌʌp/; [or]6j;
clue: [n]线索;提示;暗示;  [vt]为..提供线索; [a]/kluː/; [or]6j;
polar: [adj]极地的;南北两极的;截然对立的,正好相反的; [a]/ˈpoʊlər/; [or]6j;
elbow: [n]手肘;衣服肘部;  [v]用肘推,挤; [a]/ˈelboʊ/; [or]6j;
confident: [adj]自信的;确信的,深信的; [a]/ˈkɑːnfɪdənt/; [or]6j;
survival: [n]存活;生存; [a]/sərˈvaɪvl/; [or]6j;
groom: [n]新郎;马夫;  [v]修整;装扮;照料; [a]/ɡruːm/; [or]6j;
mosque: [n]伊斯兰教寺院;清真寺; [a]/mɑːsk/; [or]6j;
neutral: [adj]中立的;中性的;  [n]中立国;中性色; [a]/ˈnuːtrəl/; [or]6j;
attorney: [n](辩护)律师; [a]/əˈtɜːrni/; [or]6j;
metallic: [adj]金属的;金属般的; [a]/məˈtælɪk/; [or]6j;
manufacture: [v]生产;制造;  [n]制造,生产;制造业;(复)产品; [a]/ˌmænjuˈfæktʃər/; [or]6j;
civilian: [n]平民,百姓;  [adj]平民的,百姓的,民用的; [a]/səˈvɪliən/; [or]6j;
tub: [n]洗澡盆,浴缸,桶,盆,杯,一桶的(分量); [a]/tʌb/; [or]6j;
royalty: [n]皇家,王族,皇族;版税;专利费; [a]/ˈrɔɪəlti/; [or]6j;
barely: [adv]几乎不;仅仅;只不过; [a]/ˈberli/; [or]6j;
stillness: [n]沉静;宁静,静止; [a]/ˈstɪlnəs/; [or]6j;
follower: [n]追随者;信徒; [a]/ˈfɑːloʊər/; [or]6j;
beneficial: [adj]有益的,有利的; [a]/ˌbenɪˈfɪʃl/; [or]6j;
electricity: [n]电,电力;电流;电学; [a]/ɪˌlekˈtrɪsəti/; [or]6j;
melody: [n]旋律,曲调,悦耳的音乐; [a]/ˈmelədi/; [or]6j;
comparison: [n]比较;对照;比较等级;比喻; [a]/kəmˈpærɪsn/; [or]6j;
applaud: [v]鼓掌;  [vi]喝彩;  [vt]向.鼓掌表示赞赏;给.捧场; [a]/əˈplɔːd/; [or]6j;
confront: [v]与某人对峙;与..对抗;正视; [a]/kənˈfrʌnt/; [or]6j;
worthwhile: [adj]值得(花时间,精力)的,有意义的; [a]/ˌwɜːrθˈwaɪl/; [or]6j;
label: [n]标签;称号;唱片公司;  [v]把..称为,贴标签于..; [a]/ˈleɪbl/; [or]6j;
torque: [n]转矩; [a]/tɔːrk/; [or]6j;
expel: [v]罚出,开除;排出;开除;驱逐; [a]/ɪkˈspel/; [or]6j;
responsible: [adj]有责任,负责的; [a]/rɪˈspɑːnsəbl/; [or]6j;
definition: [n](轮廓等)清晰;定义,释义; [a]/ˌdefɪˈnɪʃn/; [or]6j;
peninsula: [n]半岛; [a]/pəˈnɪnsələ/; [or]6j;
scarcity: [n]缺乏,不足; [a]/ˈskersəti/; [or]6j;
irrespective: [adj]不考虑的,不顾的; [a]/ˌɪrɪˈspektɪv/; [or]6j;
concentrate: [v]全神贯注于,集中于;浓缩;  [n]浓缩物; [a]/ˈkɑːnsntreɪt/; [or]6j;
contradict: [v]与..发生矛盾,与..抵触,与..对立; [a]/ˌkɑːntrəˈdɪkt/; [or]6j;
disperse: [v]使散开;分散,散开; [a]/dɪˈspɜːrs/; [or]6j;
excess: [adj]额外的,过量的,过度的,附加的;  [n]超越,超过,过度; [a]/ɪkˈses/; [or]6j;
crab: [n]螃蟹;蟹肉; [a]/kræb/; [or]6j;
electron: [n]电子; [a]/ɪˈlektrɑːn/; [or]6j;
propel: [v]推进,推动,激励; [a]/prəˈpel/; [or]6j;
mash: [v]捣碎;  [n]糊状物; [a]/mæʃ/; [or]6j;
convention: [n]会议;习俗;惯例; [a]/kənˈvenʃn/; [or]6j;
community: [n]社区;团体;(生)群落;人群,很多个体的集合体; [a]/kəˈmjuːnəti/; [or]6j;
arbitrary: [adj]随意的,任性的,随心所欲的;霸道的,专制的,专横的;主观的,武断的; [a]/ˈɑːrbətreri/; [or]6j;
weapon: [n]武器;手段;  [v]武装,提供武器; [a]/ˈwepən/; [or]6j;
exception: [n]例外(的人或事),除外; [a]/ɪkˈsepʃn/; [or]6j;
commission: [n]委员会;任务;权限;委任;销售佣金;  [v]委任; [a]/kəˈmɪʃn/; [or]6j;
energize: [v]使活跃;给予精力;使兴奋; [a]/ˈenərdʒaɪz/; [or]6j;
surgeon: [n]外科医生; [a]/ˈsɜːrdʒən/; [or]6j;
setback: [n]挫折;失败; [a]/ˈsetbæk/; [or]6j;
diagnosis: [n]诊断; [a]/ˌdaɪəɡˈnoʊsɪs/; [or]6j;
stiffness: [n]僵硬;不友好,死板;硬度; [a]/ˈstɪfnəs/; [or]6j;
industrial: [adj]工业的;产业的;  [n]产业工人;工业公司;[商]工业股票; [a]/ɪnˈdʌstriəl/; [or]6j;
ironically: [adv]讽刺地;出乎意料地; [a]/aɪˈrɑːnɪkli/; [or]6j;
metallurgy: [n]冶金学,冶金术; [a]/ˈmetlɜːrdʒi/; [or]6j;
queer: [adj]怪异的;〈贬〉同性恋的;  [n]〈贬〉同性恋者;  [v]破坏.的计划; [a]/kwɪr/; [or]6j;
scramble: [v]争夺,攀登; [a]/ˈskræmbl/; [or]6j;
register: [v]登记,注册;(仪表等)显示;留意;  [n]登记,注册;现金收纳机; [a]/ˈredʒɪstər/; [or]6j;
survive: [vi]活下来,幸存;  [vt]比..活得长;幸存,存活;幸免于难; [a]/sərˈvaɪv/; [or]6j;
paragraph: [n](文章的)段,节; [a]/ˈpærəɡræf/; [or]6j;
mop: [n]拖把(俗称地拖);多而蓬乱的头发;  [v]用拖把拖洗,擦,抹; [a]/mɑːp/; [or]6j;
appropriate: [adj]合适的;适当的;  [v]挪用;拨款;私占; [a]/əˈproʊpriət/; [or]6j;
cape: [n]斗篷;披肩;岬,海岬,海角; [a]/keɪp/; [or]6j;
intricate: [adj]错综复杂的; [a]/ˈɪntrɪkət/; [or]6j;
judicial: [adj]司法的,法庭的,法律的,审判(上)的; [a]/dʒuˈdɪʃl/; [or]6j;
simulate: [v]假装;模仿;模拟; [a]/ˈsɪmjuleɪt/; [or]6j;
primarily: [adv]首先;主要地; [a]/praɪˈmerəli/; [or]6j;
solicit: [v]乞求,恳求给予(帮助,金钱); [a]/səˈlɪsɪt/; [or]6j;
solitude: [n]孤独; [a]/ˈsɑːlətuːd/; [or]6j;
slip: [v]滑倒,跌落,溜走,疏忽;偷偷地给;被遗忘;  [n]溜走;疏忽,错误;纸条;  [adj]打有活结的;可拆卸的;滑动的; [a]/slɪp/; [or]6j;
feeble: [adj]虚弱的; [a]/ˈfiːbl/; [or]6j;
subdivide: [v]再分; [a]/ˈsʌbdɪvaɪd/; [or]6j;
disgust: [v]使作呕,使厌恶;  [n]恶心; [a]/dɪsˈɡʌst/; [or]6j;
substitute: [v]代替;  [n]代替者,代用品,替补队员; [a]/ˈsʌbstɪtuːt/; [or]6j;
agreeable: [adj](欣然)同意的;愉快的;可以接受的; [a]/əˈɡriːəbl/; [or]6j;
multiple: [adj]多重的,复合的,倍数的;  [n]倍数; [a]/ˈmʌltɪpl/; [or]6j;
mechanism: [n]机械装置;机制,机理,原理; [a]/ˈmekənɪzəm/; [or]6j;
pension: [n]养老金,抚恤金;廉租屋;  [v]发给..养老金; [a]/ˈpenʃn/; [or]6j;
effective: [adj]有效的,有影响的;实际的;生效的; [a]/ɪˈfektɪv/; [or]6j;
vine: [n]藤,蔓; [a]/vaɪn/; [or]6j;
bandage: [n]绷带;  [v]用绷带绑扎; [a]/ˈbændɪdʒ/; [or]6j;
routine: [n]常规,例行公事,一套固定舞步(或动作);  [adj]例行的,普通的,惯例的; [a]/ruːˈtiːn/; [or]6j;
raisin: [n]葡萄干; [a]/ˈreɪzn/; [or]6j;
flux: [n]流动,不断的变动; [a]/flʌks/; [or]6j;
magnificent: [adj]华丽的,宏伟的,壮丽的; [a]/mæɡˈnɪfɪsnt/; [or]6j;
spine: [n]脊椎; [a]/spaɪn/; [or]6j;
deviation: [n]偏离,背离; [a]/ˌdiːviˈeɪʃn/; [or]6j;
impartial: [adj]公平的,不偏不倚的; [a]/ɪmˈpɑːrʃl/; [or]6j;
Jupiter: [n]木星; [a]/ˈdʒuːpɪtər/; [or]6j;
midst: [n]中部,中间; [a]/mɪdst/; [or]6j;
retrieve: [v]取回,重新得到,挽回,检索; [a]/rɪˈtriːv/; [or]6j;
flat: [adj]平坦的;浅的;平面的;单调的;  [n]平面;公寓;  [adv]平直地; [a]/flæt/; [or]6j;
outset: [n]开始,开端; [a]/ˈaʊtset/; [or]6j;
polish: [v]磨光,擦亮;润饰,使优美;  [n]擦光剂;优美,完善;  [adj]波兰的;波兰人的;波兰语的; [a]/ˈpɑːlɪʃ/; [or]6j;
withhold: [v]抑制,拒绝给某事物; [a]/wɪðˈhoʊld/; [or]6j;
establish: [v]建立;确立;使安全;使成为; [a]/ɪˈstæblɪʃ/; [or]6j;
bargain: [n]交易,特价商品;便宜货;契约;  [vi]讨价还价,讲价;成交;  [vt]经讨价还价成交;用.交换;  [adj](价格),低廉的; [a]/ˈbɑːrɡən/; [or]6j;
analogy: [n]比拟,比喻;类比;相似;类似; [a]/əˈnælədʒi/; [or]6j;
aggravate: [v]使恶化,加重;使气恼,激怒; [a]/ˈæɡrəveɪt/; [or]6j;
aspect: [n]外表,面貌;(问题等的)方面; [a]/ˈæspekt/; [or]6j;
lever: [n]杠杆;控制杆;施加影响的手段;  [v]用杠杆移动;撬开; [a]/ˈlevər/; [or]6j;
adopt: [v]收养;采纳,采用; [a]/əˈdɑːpt/; [or]6j;
epoch: [n]时期;新时代; [a]/ˈepək/; [or]6j;
veil: [v]用面纱掩盖,掩饰;  [n]面纱,遮蔽物; [a]/veɪl/; [or]6j;
degenerate: [v]堕落,衰减;  [adj]腐化的,颓废的,退化的;变质的;  [n]堕落者; [a]/dɪˈdʒenəreɪt/; [or]6j;
inevitably: [adv]必然地;不可避免地; [a]/ɪnˈevɪtəbli/; [or]6j;
protest: [v]抗议;反对;  [n]声明,反对; [a]/ˈproʊtest/; [or]6j;
clown: [n]小丑,粗鲁愚蠢的人; [a]/klaʊn/; [or]6j;
ammunition: [n]弹药;炮弹; [a]/ˌæmjuˈnɪʃn/; [or]6j;
quiver: [n]颤抖;箭袋;  [vi]颤抖; [a]/ˈkwɪvər/; [or]6j;
mingle: [v]使混合,使相混;  [vi]相交往,相往来; [a]/ˈmɪŋɡl/; [or]6j;
motorway: [n]高速公路; [a]/ˈmoʊtərweɪ/; [or]6j;
nutrition: [n]营养,营养学; [a]/nuˈtrɪʃn/; [or]6j;
heap: [n](一)堆;大量;  [v]堆;堆积; [a]/hiːp/; [or]6j;
gasp: [v]喘气;渴望;气喘吁吁地说出;  [n]喘气; [a]/ɡæsp/; [or]6j;
hamper: [v]阻碍,妨碍,牵制;  [n](有盖的)大篮子; [a]/ˈhæmpər/; [or]6j;
sociology: [n]社会学; [a]/ˌsoʊsiˈɑːlədʒi/; [or]6j;
chief: [n]老板,头子;主管;(部落) 首领;酋长;长官;  [adj]主要的;首席的; [a]/tʃiːf/; [or]6j;
ornament: [n]装饰;  [v]装饰; [a]/ˈɔːrnəmənt/; [or]6j;
ritual: [n](宗教等的)仪式,例行公事,老规矩;  [adj]作为仪式一部分的,例行的; [a]/ˈrɪtʃuəl/; [or]6j;
symptom: [n]症状;征兆; [a]/ˈsɪmptəm/; [or]6j;
warrant: [n]逮捕证;正当理由;凭证;  [v]使正当; [a]/ˈwɔːrənt/; [or]6j;
carve: [v]雕刻;(把肉等)切成片;开创,开拓; [a]/kɑːrv/; [or]6j;
abundant: [adj]丰富的;大量的; [a]/əˈbʌndənt/; [or]6j;
sincerity: [n]诚挚; [a]/sɪnˈserəti/; [or]6j;
undergo: [v]经历;遭受; [a]/ˌʌndərˈɡoʊ/; [or]6j;
desirable: [adj]有吸引力的;性感的;令人向往的;令人满意的; [a]/dɪˈzaɪərəbl/; [or]6j;
claim: [v]声称;要求;断言;主张;认领;索赔;  [n]索赔;主张;声称;断言;要求; [a]/kleɪm/; [or]6j;
strategy: [n]谋略,策略,计谋; [a]/ˈstrætədʒi/; [or]6j;
grain: [n]谷物种子,谷物,少量;格令;颗粒;纹理;  [v]使成粒状; [a]/ɡreɪn/; [or]6j;
exertion: [n]用力;运用; [a]/ɪɡˈzɜːrʃn/; [or]6j;
intense: [adj]强烈的,激烈的;紧张的;认真的;热情的; [a]/ɪnˈtens/; [or]6j;
poultry: [n]家禽(肉); [a]/ˈpoʊltri/; [or]6j;
finite: [adj]有限的;限定的; [a]/ˈfaɪnaɪt/; [or]6j;
council: [n]议会;理事会;委员会; [a]/ˈkaʊnsl/; [or]6j;
overpass: [n]天桥; [a]/ˈoʊvərpæs/; [or]6j;
grieve: [v]伤心,悲痛;  [vi]使悲伤,使伤心; [a]/ɡriːv/; [or]6j;
controversy: [n]争论,辩论; [a]/ˈkɑːntrəvɜːrsi/; [or]6j;
adoption: [n]收养,采用,采纳; [a]/əˈdɑːpʃn/; [or]6j;
catalyst: [n]催化剂;造成变化的人或事; [a]/ˈkætəlɪst/; [or]6j;
slick: [adj]光滑的;圆滑的;顺利的;不费力的;  [n]海面浮油;小块湿润的区域;  [v]使平滑; [a]/slɪk/; [or]6j;
stagger: [v]蹒跚;(使)错开(时间),交错安排;使吃惊;  [n]蹒跚; [a]/ˈstæɡər/; [or]6j;
yield: [v]出产;屈服;弯曲;让行;  [n]收益; [a]/jiːld/; [or]6j;
analytical: [adj]分析的;分析法的; [a]/ˌænəˈlɪtɪkl/; [or]6j;
figure: [n]体型;人物,人影;形状;数字;  [v]想出,估计,计算出; [a]/ˈfɪɡjər/; [or]6j;
ion: [n]［物］离子; [a]/ˈaɪən/; [or]6j;
inspiration: [n]灵感;鼓舞人心的人(或事物);妙计,好办法; [a]/ˌɪnspəˈreɪʃn/; [or]6j;
terrain: [n]地面,地形; [a]/təˈreɪn/; [or]6j;
controversial: [adj]引起争论的,有争议的; [a]/ˌkɑːntrəˈvɜːrʃl/; [or]6j;
optimism: [n]乐观,乐观主义; [a]/ˈɑːptɪmɪzəm/; [or]6j;
footpath: [n]小路,人行道; [a]/ˈfʊtpæθ/; [or]6j;
mechanize: [v]使机械化; [a]/ˈmekənaɪz/; [or]6j;
solicitor: [n](英)初级律师; [a]/səˈlɪsɪtər/; [or]6j;
drastically: [adv]大大地;彻底地; [a]/ˈdræstɪkli/; [or]6j;
patrol: [n]巡逻兵;巡逻;  [v]巡逻;巡查,巡游; [a]/pəˈtroʊl/; [or]6j;
graphic: [adj]形象的;图表的;  [n]图,图表; [a]/ˈɡræfɪk/; [or]6j;
erosion: [n]侵蚀;腐蚀;磨损;削弱;减少; [a]/ɪˈroʊʒn/; [or]6j;
discrimination: [n]歧视,偏见; [a]/dɪˌskrɪmɪˈneɪʃn/; [or]6j;
costume: [n]服装,剧装;  [vt]提供服装;为 ... 设计服装;  [adj]服装打扮的; [a]/ˈkɑːstuːm/; [or]6j;
fin: [n]鳍; [a]/fɪn/; [or]6j;
brisk: [adj]轻快的;活跃的;寒冷而清新的; [a]/brɪsk/; [or]6j;
origin: [n]起源;由来,来源;出身; [a]/ˈɔːrɪdʒɪn/; [or]6j;
sensible: [adj]明智的,理智的;可觉察的;实用耐穿的; [a]/ˈsensəbl/; [or]6j;
inadequate: [adj]不足够的,不充分的,不适当的; [a]/ɪnˈædɪkwət/; [or]6j;
contaminate: [v]弄脏,污染; [a]/kənˈtæmɪneɪt/; [or]6j;
invisible: [adj]看不见的,无形的; [a]/ɪnˈvɪzəbl/; [or]6j;
van: [n]厢式货车;面包车;(火车的)货车车厢;先锋; [a]/væn/; [or]6j;
obstacle: [n]障碍;障碍物;妨碍; [a]/ˈɑːbstəkl/; [or]6j;
feat: [n]绝技,功绩,武艺; [a]/fiːt/; [or]6j;
tighten: [v]拉紧;使..更严格; [a]/ˈtaɪtn/; [or]6j;
irritate: [v]使烦躁;激怒;使难受; [a]/ˈɪrɪteɪt/; [or]6j;
ponder: [v]仔细考虑,沉思; [a]/ˈpɑːndər/; [or]6j;
rinse: [v](用清水)刷,冲洗掉,漂净,漱口;  [n]嗽洗,漂洗,漂清,冲洗; [a]/rɪns/; [or]6j;
predict: [v]预言,预告,预测; [a]/prɪˈdɪkt/; [or]6j;
modify: [v]改装,修改,更改;修饰,限定; [a]/ˈmɑːdɪfaɪ/; [or]6j;
locality: [n]地区;地点;位置;方位; [a]/loʊˈkæləti/; [or]6j;
mute: [n]弱音器;  [adj]缄默的;哑的;  [vt]减弱.的声音; [a]/mjuːt/; [or]6j;
resort: [vi]采取;求助;  [n]求助;凭借;诉诸,采取;度假胜地; [a]/rɪˈzɔːrt/; [or]6j;
articulate: [adj]善于表达的;发音清晰的;  [v]清晰地发音;清楚地讲话;连接,接合;与.合成整体 ,使相互连贯; [a]/ɑːrˈtɪkjuleɪt/; [or]6j;
youngster: [n]年轻人,少年; [a]/ˈjʌŋstər/; [or]6j;
verse: [n]诗句,诗节,诗; [a]/vɜːrs/; [or]6j;
jean: [n]牛仔裤; [a]/dʒɪn/; [or]6j;
adjacent: [adj]邻接的,毗连的;邻近的; [a]/əˈdʒeɪsnt/; [or]6j;
standpoint: [n]立场,观点; [a]/ˈstændpɔɪnt/; [or]6j;
predominant: [adj]占主导地位的;显著的; [a]/prɪˈdɑːmɪnənt/; [or]6j;
innovative: [adj]创新的,革新的; [a]/ˈɪnəveɪtɪv/; [or]6j;
tan: [n]棕褐色,棕黄色;晒成棕褐色,晒黑;  [v]使晒成棕褐色;硝制(皮革); [a]/tæn/; [or]6j;
universe: [n]宇宙,万物,世界,领域,范围; [a]/ˈjuːnɪvɜːrs/; [or]6j;
halve: [v]二等分;平分; [a]/hæv/; [or]6j;
lunar: [adj]月亮的; [a]/ˈluːnər/; [or]6j;
identification: [n]识别;鉴定;验明;身份证明; [a]/aɪˌdentɪfɪˈkeɪʃn/; [or]6j;
conform: [vi]一致;遵照,顺从;符合;  [vt]使一致;使遵照;  [adj]一致的; [a]/kənˈfɔːrm/; [or]6j;
assault: [n]攻击,袭击;  [v]攻击,袭击,殴打; [a]/əˈsɔːlt/; [or]6j;
petition: [n]请愿;请愿书;祈求;  [v]请愿; [a]/pəˈtɪʃn/; [or]6j;
caution: [n]小心;警告;告诫;  [v]劝.谨慎小心;警告; [a]/ˈkɔːʃn/; [or]6j;
predecessor: [n]前辈;(被取代的)原有事物; [a]/ˈpredəsesər/; [or]6j;
cartridge: [n]墨盒;弹药筒,弹药;墨水,笔芯; [a]/ˈkɑːrtrɪdʒ/; [or]6j;
assurance: [n]信心,自信;保证;保险; [a]/əˈʃʊrəns/; [or]6j;
glider: [n]滑翔机;滑翔伞; [a]/ˈɡlaɪdər/; [or]6j;
abut: [v]紧靠; [a]/əˈbʌt/; [or]6j;
unlock: [v]开启;解开; [a]/ˌʌnˈlɑːk/; [or]6j;
dolphin: [n]海豚; [a]/ˈdɑːlfɪn/; [or]6j;
glorify: [v]赞美,赞扬,崇拜(神);美化; [a]/ˈɡlɔːrɪfaɪ/; [or]6j;
remote: [n]遥控器;  [adj]遥远的;偏僻的;关系远的; [a]/rɪˈmoʊt/; [or]6j;
presentation: [n]演讲;报告;介绍;颁奖仪式; [a]/ˌpriːzenˈteɪʃn/; [or]6j;
hospitality: [n]好客;款待; [a]/ˌhɑːspɪˈtæləti/; [or]6j;
turbulent: [adj]湍急的;混乱的,动荡的;骚动的; [a]/ˈtɜːrbjələnt/; [or]6j;
fringe: [n]刘海;一排;边缘;穗,流苏;  [v]形成.的边缘; [a]/frɪndʒ/; [or]6j;
modernize: [v](使)现代化; [a]/ˈmɑːdərnaɪz/; [or]6j;
ohm: [n]欧姆; [a]/oʊm/; [or]6j;
conscientious: [adj]勤勤恳恳的;认真的; [a]/ˌkɑːnʃiˈenʃəs/; [or]6j;
privilege: [n]特权,优待;荣幸;  [v]给..特权; [a]/ˈprɪvəlɪdʒ/; [or]6j;
transport: [v]运输;使狂喜;流放;  [n]运输;运输工具;流放犯; [a]/ˈtrænspɔːrt/; [or]6j;
architect: [n]设计师;建筑师; [a]/ˈɑːrkɪtekt/; [or]6j;
engage: [vt]吸引住(注意力,兴趣);雇,聘;  [vi]使加入,使融入;订婚;  [v](军队)交战;啮合; [a]/ɪnˈɡeɪdʒ/; [or]6j;
auction: [n]拍卖;  [v]拍卖; [a]/ˈɔːkʃn/; [or]6j;
locomotive: [n]机车,火车头;  [adj]运动的; [a]/ˌloʊkəˈmoʊtɪv/; [or]6j;
snore: [vi]打鼾;  [n]鼾声; [a]/snɔːr/; [or]6j;
grave: [adj]严重的;严肃的,庄重的;  [n]墓;  [adv]沉重地,庄重地;极慢地;  [vt]雕刻;铭记; [a]/ɡreɪv/; [or]6j;
attack: [n](病)发作,攻击;  [v]攻击,进攻,抨击;毁坏; [a]/əˈtæk/; [or]6j;
wedge: [v]楔入;  [n]楔子; [a]/wedʒ/; [or]6j;
fowl: [n]家禽;鸟类; [a]/faʊl/; [or]6j;
bully: [n]恃强欺弱者;  [v]欺负; [a]/ˈbʊli/; [or]6j;
dividend: [n](股份的)红利,回报,效益,被除数; [a]/ˈdɪvɪdend/; [or]6j;
critical: [adj]批评的;文艺评论的;爱挑剔的;危急的;关键的,重要的; [a]/ˈkrɪtɪkl/; [or]6j;
saint: [n]圣人; [a]/seɪnt/; [or]6j;
rectangular: [adj]长方形的; [a]/rekˈtæŋɡjələr/; [or]6j;
renaissance: [n]新生,复兴;文艺复兴; [a]/ˈrenəsɑːns/; [or]6j;
application: [n]运用;申请(书);应用程序; [a]/ˌæplɪˈkeɪʃn/; [or]6j;
conceive: [v]怀孕;设想,想出; [a]/kənˈsiːv/; [or]6j;
hydrocarbon: [n]碳氢化合物,烃; [a]/ˌhaɪdrəˈkɑːrbən/; [or]6j;
corporate: [adj]公司的;全体的;共同的;(法人)团体的; [a]/ˈkɔːrpərət/; [or]6j;
stationary: [adj]静止的;固定的;  [n]定居者,驻军; [a]/ˈsteɪʃəneri/; [or]6j;
endanger: [v]危及,危害; [a]/ɪnˈdeɪndʒər/; [or]6j;
tissue: [n]面巾纸,(动植物的)组织,纱布; [a]/ˈtɪʃuː/; [or]6j;
manipulate: [v]操纵,影响;正骨; [a]/məˈnɪpjuleɪt/; [or]6j;
subordinate: [n]部下;下属;  [adj]次要的;从属的;下级的;  [v]使从属于;使处于次要地位; [a]/səˈbɔːrdɪnət/; [or]6j;
ginger: [n]生姜;姜黄色;  [v]使有活力,使兴奋;  [adj]姜黄色的; [a]/ˈdʒɪndʒər/; [or]6j;
chaos: [n]混沌;混乱,纷乱; [a]/ˈkeɪɑːs/; [or]6j;
jug: [n](有把手,小口的)大壶;一壶,一罐(的量); [a]/dʒʌɡ/; [or]6j;
rarely: [adv]很少,难得; [a]/ˈrerli/; [or]6j;
sullen: [adj]沮丧的,闷闷不乐的;阴沉的; [a]/ˈsʌlən/; [or]6j;
enthusiasm: [n]热情,热心,热忱;热衷的活动,热爱的事物; [a]/ɪnˈθuːziæzəm/; [or]6j;
owe: [v]感谢;欠;把.归于;占有;欠钱; [a]/oʊ/; [or]6j;
complex: [adj]复杂的,难解的;复合的;  [n]情结;建筑群;综合体,集合体; [a]/ˈkɑːmpleks/; [or]6j;
alter: [v]改变;改动,使变样;改做; [a]/ˈɔːltər/; [or]6j;
Venus: [n]金星; [a]/ˈviːnəs/; [or]6j;
reflect: [v]倒映;反映,反射;仔细思考;反省; [a]/rɪˈflekt/; [or]6j;
kerosene: [n]煤油; [a]/ˈkerəsiːn/; [or]6j;
pest: [n]讨厌的人(或东西);害虫; [a]/pest/; [or]6j;
logical: [adj]有逻辑的;合情合理的;推理正确的; [a]/ˈlɑːdʒɪkl/; [or]6j;
mixer: [n]搅拌机;调酒用的饮料;混频器; [a]/ˈmɪksər/; [or]6j;
delicate: [adj]易碎的,易坏的,脆弱的;(人)娇弱的,体弱多病的;精美的,精致的,精巧的;微妙的,需要谨慎处理的;优美的,优雅的;柔和的,清淡的,淡雅的; [a]/ˈdelɪkət/; [or]6j;
opium: [n]鸦片; [a]/ˈoʊpiəm/; [or]6j;
normalization: [n]正常化; [a]/ˌnɔːrmələˈzeɪʃn/; [or]6j;
scrutinize: [v]仔细检查,细看; [a]/ˈskruːtənaɪz/; [or]6j;
assign: [v]布置;分配;指定;指派;归因;确定; [a]/əˈsaɪn/; [or]6j;
grant: [v]给予,许可,授予;承认;  [n]许可;拨款,补助金; [a]/ɡrænt/; [or]6j;
shove: [v]推;猛推;  [n]推搡; [a]/ʃʌv/; [or]6j;
relief: [n]安慰;解脱;减轻;浮雕;凸显,起伏;救济金;救济物资;换班人;接替人; [a]/rɪˈliːf/; [or]6j;
reliable: [adj]可靠的;可信赖的;确实的; [a]/rɪˈlaɪəbl/; [or]6j;
dealer: [n]经销商,商人,(俚)毒贩; [a]/ˈdiːlər/; [or]6j;
toll: [n]伤亡人数;(道路等的)通行费;钟声;  [v]敲钟; [a]/toʊl/; [or]6j;
calorie: [n]卡(热量单位); [a]/ˈkæləri/; [or]6j;
crucial: [adj]关键的;决定性的; [a]/ˈkruːʃl/; [or]6j;
simultaneously: [adv]同时地; [a]/ˌsaɪmlˈteɪniəsli/; [or]6j;
military: [n]军队;  [adj]军事的; [a]/ˈmɪləteri/; [or]6j;
deficiency: [n]缺乏,不足;缺陷; [a]/dɪˈfɪʃnsi/; [or]6j;
pickle: [n]盐汁;泡菜;  [v]腌; [a]/ˈpɪkl/; [or]6j;
script: [n]剧本,脚本,手稿;文字系统;  [v]为电影(或戏剧等)写剧本; [a]/skrɪpt/; [or]6j;
expansion: [n]扩大,扩充,扩张,膨胀; [a]/ɪkˈspænʃn/; [or]6j;
gust: [n]阵风,(感情的)迸发,汹涌;  [v]猛吹; [a]/ɡʌst/; [or]6j;
inlet: [n]水湾,小湾;进口,入口; [a]/ˈɪnlet/; [or]6j;
emphasis: [n]强调;重点;重要性; [a]/ˈemfəsɪs/; [or]6j;
consent: [n]同意,准许;赞成;  [v]同意; [a]/kənˈsent/; [or]6j;
candidate: [n](官职,获奖资格等的)候选人;投考人;申请求职者; [a]/ˈkændɪdət/; [or]6j;
accordance: [n]符合;一致;授予; [a]/əˈkɔːrdns/; [or]6j;
medium: [adj]中等的;适中的;  [n]手段;媒介;材料; [a]/ˈmiːdiəm/; [or]6j;
mechanical: [adj]机械的,机械学的,机械性的; [a]/məˈkænɪkl/; [or]6j;
moreover: [adv]此外,而且; [a]/mɔːrˈoʊvər/; [or]6j;
permanent: [adj]永久的,持久的;  [n]电烫发; [a]/ˈpɜːrmənənt/; [or]6j;
formal: [adj]正式的;正规的;规范的,合乎规矩的;形式上的;礼节上的;  [n]<美>须穿礼服的社交集会;<口>夜礼服; [a]/ˈfɔːrml/; [or]6j;
similarity: [n]相似,类似; [a]/ˌsɪməˈlærəti/; [or]6j;
touched: [adj]受感动的;精神轻微失常的; [a]/tʌtʃt/; [or]6j;
rhythm: [n]节奏;韵律;格律; [a]/ˈrɪðəm/; [or]6j;
marble: [n]大理石;(游戏用的)玻璃弹子; [a]/ˈmɑːrbl/; [or]6j;
prick: [n]扎,一刺,刺痛,锥,阴茎;  [v]刺,戳,刺痛,竖起; [a]/prɪk/; [or]6j;
counsel: [n]忠告;律师,法律顾问;  [v]劝告,提议; [a]/ˈkaʊnsl/; [or]6j;
dean: [n](大学的)学院院长;系主任;资格最老者,泰斗;牧师; [a]/diːn/; [or]6j;
ford: [v]涉水,渡河;  [n]浅滩; [a]/fɔːrd/; [or]6j;
willingness: [n]自愿; [a]/ˈwɪlɪŋnəs/; [or]6j;
poverty: [n]贫困;贫穷; [a]/ˈpɑːvərti/; [or]6j;
inaccurate: [adj]不准确的; [a]/ɪnˈækjərət/; [or]6j;
demonstration: [n]示范表演,演示;实物说明;游行;表现; [a]/ˌdemənˈstreɪʃn/; [or]6j;
deduct: [v]减去; [a]/dɪˈdʌkt/; [or]6j;
swamp: [n]沼泽;  [v]淹没,浸没;使困惑,压倒; [a]/swɑːmp/; [or]6j;
plight: [n]困境;  [v]宣誓,保证; [a]/plaɪt/; [or]6j;
parasite: [n]寄生虫;靠他人为生的人; [a]/ˈpærəsaɪt/; [or]6j;
arrogant: [adj]傲慢的,妄自尊大的; [a]/ˈærəɡənt/; [or]6j;
martyr: [n]烈士;受难者;乞怜者;  [v]迫害,折磨; [a]/ˈmɑːrtər/; [or]6j;
remnant: [n]遗迹;边角剩料; [a]/ˈremnənt/; [or]6j;
boom: [n]隆隆声;繁荣;景气;激增;  [v]发出低沉有回响的声音;迅速发展,蓬勃发展;以低沉有回响的声音发出; [a]/buːm/; [or]6j;
amusement: [n]娱乐,消遣;乐趣; [a]/əˈmjuːzmənt/; [or]6j;
analog: [adj]有长短针的;模拟的;  [n]类似物;模拟; [a]/ˈænəlɑːɡ/; [or]6j;
mere: [adj]仅仅的;纯粹的;  [n]小湖,池塘;〈英〉边境(线); [a]/mɪr/; [or]6j;
chant: [v]吟唱;诵扬;  [n]圣歌;赞美诗;旋律; [a]/tʃænt/; [or]6j;
pessimistic: [adj]悲观(主义)的; [a]/ˌpesɪˈmɪstɪk/; [or]6j;
requisite: [n]必需品;  [adj]需要的,必不可少的,必备的; [a]/ˈrekwɪzɪt/; [or]6j;
criticize: [v]批评,评论,挑剔,责难; [a]/ˈkrɪtɪsaɪz/; [or]6j;
limitation: [n]限制,局限性; [a]/ˌlɪmɪˈteɪʃn/; [or]6j;
hose: [n]输水软管;  [v]用水管冲洗(汽车等); [a]/hoʊz/; [or]6j;
twilight: [n]黄昏,薄暮,黎明;晚期,没落时期;  [adj]微明的;界限不清的; [a]/ˈtwaɪlaɪt/; [or]6j;
herald: [n]使者;预兆;  [v]预告;为.欢呼; [a]/ˈherəld/; [or]6j;
promotion: [n]晋升;提升;促销;促进; [a]/prəˈmoʊʃn/; [or]6j;
volume: [n]音量;数量;容量;册,卷; [a]/ˈvɑːljuːm/; [or]6j;
breach: [n]破裂;裂痕;冲击;违反;  [v]使有裂口;破坏; [a]/briːtʃ/; [or]6j;
exploration: [n]探索;研究; [a]/ˌekspləˈreɪʃn/; [or]6j;
manufacturer: [n]制造商;制造厂; [a]/ˌmænjuˈfæktʃərər/; [or]6j;
innate: [adj]与生俱来的,天生的; [a]/ɪˈneɪt/; [or]6j;
seaport: [n]海港; [a]/ˈsiːpɔːrt/; [or]6j;
unemployment: [n]失业;失业人数; [a]/ˌʌnɪmˈplɔɪmənt/; [or]6j;
venture: [n]企业;(商业)冒险;投机,风险投资;  [vi]冒险前进;  [vt]冒.的危险;以.做赌注; [a]/ˈventʃər/; [or]6j;
ware: [n]货物;制品;陶器; [a]/wer/; [or]6j;
dome: [n]圆屋顶,穹顶; [a]/doʊm/; [or]6j;
anticipate: [v]预测;期待;提早(做); [a]/ænˈtɪsɪpeɪt/; [or]6j;
sweetness: [n]甜蜜,可爱;甜味; [a]/ˈswiːtnəs/; [or]6j;
bestow: [v]给予; [a]/bɪˈstoʊ/; [or]6j;
ecology: [n]生态,生态学; [a]/iˈkɑːlədʒi/; [or]6j;
victim: [n]牺牲品,受害者,替罪羊; [a]/ˈvɪktɪm/; [or]6j;
invaluable: [adj]非常宝贵的,极为贵重的,无价的; [a]/ɪnˈvæljuəbl/; [or]6j;
extinction: [n]熄灭,灭绝,消失; [a]/ɪkˈstɪŋkʃn/; [or]6j;
resultant: [adj]作为结果的; [a]/rɪˈzʌltənt/; [or]6j;
Catholic: [adj](兴趣等)广泛的,(C大写)天主教的;  [n](C大写)天主教徒; [a]/ˈkæθlɪk/; [or]6j;
tuna: [n]金枪鱼; [a]/ˈtuːnə/; [or]6j;
circumstance: [n]条件;情况;命运;客观环境; [a]/ˈsɜːrkəmstæns/; [or]6j;
breakdown: [n]损坏;故障;分类,明细;倒塌,崩溃;衰退; [a]/ˈbreɪkdaʊn/; [or]6j;
intrinsic: [adj]固有的; [a]/ɪnˈtrɪnsɪk/; [or]6j;
insurance: [n]保险;保险费;保险业;安全保证; [a]/ɪnˈʃʊrəns/; [or]6j;
premature: [adj]早产的,过早的,早熟的;  [n]早产儿; [a]/ˌpriːməˈtʃʊr/; [or]6j;
institute: [n]学会;学院,专科学院,研究院;  [vt]建立,设立,制定; [a]/ˈɪnstɪtuːt/; [or]6j;
wrath: [n]愤怒; [a]/ræθ/; [or]6j;
lease: [v]出租,租得;  [n]租约,租契; [a]/liːs/; [or]6j;
transplant: [n]移种;移植;  [v]移植(器官),使移居,移种(植物等); [a]/trænsˈplænt/; [or]6j;
hostage: [n]人质; [a]/ˈhɑːstɪdʒ/; [or]6j;
likeness: [n]相像,相似;画像,写真; [a]/ˈlaɪknəs/; [or]6j;
ramble: [vi]瞎扯;溜达;漫步于;  [n]漫步; [a]/ˈræmbl/; [or]6j;
vocation: [n]职业;行业;天职;使命; [a]/voʊˈkeɪʃn/; [or]6j;
prosper: [v](生意等)成功;(城市,文化,植物生长等)繁荣; [a]/ˈprɑːspər/; [or]6j;
evil: [adj]邪恶的,罪恶的;  [n]邪恶,罪恶; [a]/ˈiːvl/; [or]6j;
casualty: [n]伤亡人员,死伤者,受害人;急诊室(英); [a]/ˈkæʒuəlti/; [or]6j;
assure: [v]向..保证,使确信;保证,确保; [a]/əˈʃʊr/; [or]6j;
immortal: [adj]不朽的; [a]/ɪˈmɔːrtl/; [or]6j;
perch: [v](使)栖息,就位;  [n]栖木,有利的地位,杆,河鲈; [a]/pɜːrtʃ/; [or]6j;
companion: [n]同伴,志同道合的人;参考书; [a]/kəmˈpæniən/; [or]6j;
lining: [n](衣服等的)衬里;衬料;里子; [a]/ˈlaɪnɪŋ/; [or]6j;
schedule: [n]时间表,日程,计划表;清单,节目表;  [v]预定,安排; [a]/ˈskedʒuːl/; [or]6j;
norm: [n]准则;模范;规范,标准; [a]/nɔːrm/; [or]6j;
directory: [n]人名地址录,(电话)号码簿;目录; [a]/dəˈrektəri/; [or]6j;
spectrum: [n]光谱,范围,系列; [a]/ˈspektrəm/; [or]6j;
forsake: [v]放弃;抛弃,离开; [a]/fərˈseɪk/; [or]6j;
media: [n]媒体;传播媒介; [a]/ˈmiːdiə/; [or]6j;
nickel: [n]镍;美国五分镍币;五分钱; [a]/ˈnɪkl/; [or]6j;
instability: [n]不稳定(性); [a]/ˌɪnstəˈbɪləti/; [or]6j;
detective: [n]侦探,私人侦探;  [adj]侦探的; [a]/dɪˈtektɪv/; [or]6j;
independence: [n](国家的)独立;(人的)自立,独立; [a]/ˌɪndɪˈpendəns/; [or]6j;
courteous: [adj]有礼貌的,谦恭有礼的; [a]/ˈkɜːrtiəs/; [or]6j;
rehearsal: [n]排演;叙述;详述;排练; [a]/rɪˈhɜːrsl/; [or]6j;
chatter: [n]喋喋不休;吱吱声;啁啾声;  [vi]吱吱叫;唠叨;(使)打颤,打战,发颤;喋喋不休地说; [a]/ˈtʃætər/; [or]6j;
ballet: [n]芭蕾舞,芭蕾舞剧;芭蕾舞团; [a]/bæˈleɪ/; [or]6j;
acquaintance: [n]认识;对..有了解,熟知;熟人,相识的人; [a]/əˈkweɪntəns/; [or]6j;
malnutrition: [n]营养不良; [a]/ˌmælnuːˈtrɪʃn/; [or]6j;
vocal: [n]声乐作品;  [adj]畅言无忌的;声音的; [a]/ˈvoʊkl/; [or]6j;
ramp: [n]斜坡,坡道;倾斜装置;  [v]蔓延; [a]/ræmp/; [or]6j;
buffer: [n]缓冲,缓冲区;  [v]缓冲; [a]/ˈbʌfər/; [or]6j;
situated: [adj]坐落在.的;处于某种境地的; [a]/ˈsɪtʃueɪtɪd/; [or]6j;
firmness: [n]坚定;稳固;稳定;坚(硬)度; [a]/ˈfɜːrmnəs/; [or]6j;
versus: prep. 以..为对手;与..相对,与..相比; [a]/ˈvɜːrsəs/; [or]6j;
tilt: [v](使)倾斜;  [n]倾斜,斜坡; [a]/tɪlt/; [or]6j;
financial: [adj]金融的;财政的;财务的; [a]/faɪˈnænʃl/; [or]6j;
vacancy: [n]空,空白,空房;(职位)空缺;空虚; [a]/ˈveɪkənsi/; [or]6j;
prevention: [n]预防,防止; [a]/prɪˈvenʃn/; [or]6j;
subjective: [adj]主观(上)的,个人的; [a]/səbˈdʒektɪv/; [or]6j;
elaborate: [adj]精心设计的,精巧的;复杂的;  [v]详细说明,详尽阐述;  [vt]变得复杂; [a]/ɪˈlæbəreɪt/; [or]6j;
unique: [adj]独特的,独一无二的;(唯一的)特有的;不同寻常的; [a]/juˈniːk/; [or]6j;
closet: [n]橱,壁橱,小储藏室;  [v]把.引进密室会谈;  [adj]私下的,秘密的; [a]/ˈklɑːzət/; [or]6j;
massacre: [n]大屠杀,残杀;惨败;  [v]屠杀;彻底击败; [a]/ˈmæsəkər/; [or]6j;
implore: [v]恳求; [a]/ɪmˈplɔːr/; [or]6j;
hatred: [n]憎恨;怨恨; [a]/ˈheɪtrɪd/; [or]6j;
outlaw: [n]歹徒,逃犯,丧失公权者;  [v]将..放逐,宣布..为不合法; [a]/ˈaʊtlɔː/; [or]6j;
refugee: [n]避难者,难民;  [v]避难;  [adj]避难的; [a]/ˌrefjuˈdʒiː/; [or]6j;
characterize: [v]表示..的特性;描述..特性; [a]/ˈkærəktəraɪz/; [or]6j;
optimum: [adj]最适宜的;最佳的;  [n]最适条件;最适宜; [a]/ˈɑːptɪməm/; [or]6j;
duplicate: [n]复制品;  [v]复制;重复;  [adj]完全一样的; [a]/ˈduːplɪkeɪt/; [or]6j;
corrosion: [n]侵蚀,腐蚀状态; [a]/kəˈroʊʒn/; [or]6j;
dispatch: [v]派遣,调遣;发送(信件,电报等);结束,摆脱掉;匆匆办完;  [vt]处决;  [n]派遣,调遣;发送;快信,急件;迅速,敏捷; [a]/dɪˈspætʃ/; [or]6j;
plausible: [adj]似乎有理的;巧嘴的; [a]/ˈplɔːzəbl/; [or]6j;
boiler: [n]热水器,锅炉; [a]/ˈbɔɪlər/; [or]6j;
dubious: [adj]可疑的;怀疑的;无把握的; [a]/ˈduːbiəs/; [or]6j;
respectful: [adj]有礼貌的;恭敬的; [a]/rɪˈspektfl/; [or]6j;
slice: [v]把..切成片;大幅度削减;切开;  [n]薄片;份额,部分; [a]/slaɪs/; [or]6j;
extraction: [n]抽出,取出;家世,出身;抽出物; [a]/ɪkˈstrækʃn/; [or]6j;
illusion: [n]假象,幻象;幻想;错误观念; [a]/ɪˈluːʒn/; [or]6j;
envisage: [v]想象,设想; [a]/ɪnˈvɪzɪdʒ/; [or]6j;
exclusive: [adj]独有的;奢华的;排外的;  [n]独家新闻; [a]/ɪkˈskluːsɪv/; [or]6j;
incorporate: [v]包含;使并入; [a]/ɪnˈkɔːrpəreɪt/; [or]6j;
cardinal: [adj]主要的;基本的;  [n][天主教]枢机主教,红衣主教;基数; [a]/ˈkɑːrdɪnl/; [or]6j;
benefit: [v]受益,有助于,使受益;  [n]好处,益处;救济金; [a]/ˈbenɪfɪt/; [or]6j;
settle: [v]安顿;定居;解决;调停;(目光)停留;结算,算清;  [n]背长椅,座位;定居,安顿; [a]/ˈsetl/; [or]6j;
virtue: [n]正直,善良;美德,德行;好处,优点; [a]/ˈvɜːrtʃuː/; [or]6j;
consecutive: [adj]连续的,连贯的; [a]/kənˈsekjətɪv/; [or]6j;
editorial: [adj]编辑的,编者的;  [n](报刊的)社论; [a]/ˌedɪˈtɔːriəl/; [or]6j;
condemnation: [n]谴责,定罪; [a]/ˌkɑːndemˈneɪʃn/; [or]6j;
insert: [vt]插入,嵌入;  [n]插入物;插页; [a]/ɪnˈsɜːrt/; [or]6j;
overhang: [n]突出;悬垂;伸出量;  [v]悬于..之上; [a]/ˌoʊvərˈhæŋ/; [or]6j;
incline: [n]倾斜,斜坡,斜面;  [v](使)倾斜,(使)倾向于; [a]/ɪnˈklaɪn/; [or]6j;
inaccessible: [adj]达不到的;难达到的; [a]/ˌɪnækˈsesəbl/; [or]6j;
documentary: [n]纪录片;  [adj]纪实的;文献的; [a]/ˌdɑːkjuˈmentri/; [or]6j;
foil: [n]箔;锡箔纸;衬托;  [v]挫败;使受挫折; [a]/fɔɪl/; [or]6j;
Arctic: [n]北极;  [adj]北极的,极寒的; [a]/ˈɑːrktɪk/; [or]6j;
stubborn: [adj]顽固的;倔强的;难对付的; [a]/ˈstʌbərn/; [or]6j;
opaque: [adj]不透明的;难懂的; [a]/oʊˈpeɪk/; [or]6j;
clone: [n]克隆;无性繁殖系个体;复制品;  [v]复制;克隆; [a]/kloʊn/; [or]6j;
unfold: [v]展开,伸展;表露,显露; [a]/ʌnˈfoʊld/; [or]6j;
pact: [n]合同;协约; [a]/pækt/; [or]6j;
rape: [v]强奸;  [n]强奸;掠夺,强夺;油菜; [a]/reɪp/; [or]6j;
statesman: [n]政治家; [a]/ˈsteɪtsmən/; [or]6j;
cherish: [v]珍爱,珍视;抱有(希望); [a]/ˈtʃerɪʃ/; [or]6j;
weaver: [n]织布者,织工; [a]/ˈwiːvər/; [or]6j;
dentist: [n]牙医; [a]/ˈdentɪst/; [or]6j;
raid: [n]突袭;袭击;  [v]袭击;劫掠;攫取;突然搜捕; [a]/reɪd/; [or]6j;
quench: [v]扑灭(火);止渴; [a]/kwentʃ/; [or]6j;
waver: [vi]犹豫;摇摆;颤抖; [a]/ˈweɪvər/; [or]6j;
supple: [adj]柔软的;柔顺的; [a]/ˈsʌpl/; [or]6j;
vulgar: [adj]粗俗的;下流的;平民的;通俗的;  [n]平民;方言; [a]/ˈvʌlɡər/; [or]6j;
acid: [n][化学]酸;酸性物质;尖酸;  [adj]尖刻的;敏锐的;含酸过多的;酸的;酸味的; [a]/ˈæsɪd/; [or]6j;
susceptible: [adj]易受感染的;易受影响的;多情的; [a]/səˈseptəbl/; [or]6j;
designate: [adj]已受委派而尚未上任的;  [v]标出,说出;委任,任命,提名;指定; [a]/ˈdezɪɡneɪt/; [or]6j;
denote: [v]是.的标志;指出;  [vt]指示;代表(或表示); [a]/dɪˈnoʊt/; [or]6j;
Turkey: [n]土耳其; [a]/ˈtɜːrki/; [or]6j;
preferable: [adj]更可取的,更好的,更合适的(to); [a]/ˈprefrəbl/; [or]6j;
spouse: [n]配偶,夫妇;夫,妻;  [v]和.结婚; [a]/spaʊs/; [or]6j;
proclaim: [v]声明,声称;宣告;表明; [a]/prəˈkleɪm/; [or]6j;
emerge: [v]冲出,冒出;浮现;出现; [a]/iˈmɜːrdʒ/; [or]6j;
project: [n]项目,工程;专题研究;课题方案;  [v]映射,放映;计划,设计,打算,拟订方案;投掷,发射,喷射;表明..的特性,使呈现特性;阐述;突出,伸出;估计,预估; [a]/ˈprɑːdʒekt/; [or]6j;
remedy: [v]治疗;恢复;补救;  [n]治疗;补救;矫正; [a]/ˈremədi/; [or]6j;
commemorate: [v]纪念,庆祝; [a]/kəˈmeməreɪt/; [or]6j;
limb: [n]肢体;臂;枝干;树枝;  [v]肢解; [a]/lɪm/; [or]6j;
guy: [n]男人;家伙; [a]/ɡaɪ/; [or]6j;
clutch: [v]抓住;紧握;  [n]抓住;离合器; [a]/klʌtʃ/; [or]6j;
heel: [n]脚后跟;(鞋)后跟;  [v]给(鞋)钉后掌,倾侧,紧跟; [a]/hiːl/; [or]6j;
conflict: [n]冲突,(意见)分歧,战斗,斗争;  [v]冲突,抵触,争执; [a]/ˈkɑːnflɪkt/; [or]6j;
microwave: [n]微波炉,微波;  [v]用微波炉加热; [a]/ˈmaɪkrəweɪv/; [or]6j;
stabilize: [v]使稳定; [a]/ˈsteɪbəlaɪz/; [or]6j;
crash: [n]碰撞,坠落,轰隆声;  [v]碰撞,坠落,崩溃;  [adj]紧急的; [a]/kræʃ/; [or]6j;
kinetic: [adj]运动的; [a]/kɪˈnetɪk/; [or]6j;
economics: [n]经济学;经济情况;经济; [a]/ˌekəˈnɑːmɪks/; [or]6j;
browse: [v]浏览;随意翻阅;(牛,羊等)吃草; [a]/braʊz/; [or]6j;
electrode: [n]电极; [a]/ɪˈlektroʊd/; [or]6j;
clause: [n]条款;从句; [a]/klɔːz/; [or]6j;
agenda: [n]议事日程; [a]/əˈdʒendə/; [or]6j;
hearty: [adj]衷心的;亲切的;精神饱满的;丰盛的;强烈的; [a]/ˈhɑːrti/; [or]6j;
advantage: [v]使处于有利地位;有利于;有助于;  [n]优势,利益,有利条件; [a]/ədˈvæntɪdʒ/; [or]6j;
compose: [v]创作,作曲,形成,构成; [a]/kəmˈpoʊz/; [or]6j;
consumer: [n]消费者;用户;消耗者; [a]/kənˈsuːmər/; [or]6j;
credit: [n]信用;荣誉;学分;信贷;称赞;债权;  [v]信赖;归因于;记学分; [a]/ˈkredɪt/; [or]6j;
enhance: [v]提高(强度,力量,数量等);增加,加强; [a]/ɪnˈhæns/; [or]6j;
oxygen: [n]氧气; [a]/ˈɑːksɪdʒən/; [or]6j;
incense: [n]焚香时的烟,香味;  [v]激怒; [a]/ˈɪnsens/; [or]6j;
capable: [adj]有本领的,有能力的;有才能的,能干的; [a]/ˈkeɪpəbl/; [or]6j;
foam: [n]泡沫;泡沫体;泡沫塑料;  [vi]吐白沫,起泡沫; [a]/foʊm/; [or]6j;
clip: [n]回形针,夹子;(电影,广播,电视节目的)片段;  [v]夹住;删剪;剪辑; [a]/klɪp/; [or]6j;
object: [n]物体;宾语;目标;  [v]提出..作为反对的理由;反对; [a]/ˈɑːbdʒekt/; [or]6j;
disregard: [v]不理会;漠视;  [n]忽视,漠视; [a]/ˌdɪsrɪˈɡɑːrd/; [or]6j;
mansion: [n]官邸;巨宅;大厦; [a]/ˈmænʃn/; [or]6j;
garbage: [n]垃圾桶;垃圾; [a]/ˈɡɑːrbɪdʒ/; [or]6j;
jealousy: [n]妒忌,猜忌; [a]/ˈdʒeləsi/; [or]6j;
circus: [n]马戏团;杂技团;环形广场;闹剧(表示不满); [a]/ˈsɜːrkəs/; [or]6j;
striking: [adj]容貌出众的,吸引人的;显著的,突出的;  [n]罢工; [a]/ˈstraɪkɪŋ/; [or]6j;
imposing: [adj]壮观的,壮丽的; [a]/ɪmˈpoʊzɪŋ/; [or]6j;
comet: [n]彗星; [a]/ˈkɑːmət/; [or]6j;
accuse: [v]指责;控告;把..归咎于; [a]/əˈkjuːz/; [or]6j;
masterpiece: [n]杰作; [a]/ˈmæstərpiːs/; [or]6j;
mild: [adj]味淡的;温暖的;轻微的;温和的;  [n]淡味啤酒; [a]/maɪld/; [or]6j;
melt: [v]融化;熔化;溶化; [a]/melt/; [or]6j;
merge: [v]合并;融合; [a]/mɜːrdʒ/; [or]6j;
resistant: [adj]有抵抗力的,抗..的;反抗的; [a]/rɪˈzɪstənt/; [or]6j;
theorem: [n][数]定理,法则; [a]/ˈθiːərəm/; [or]6j;
yearn: [v]渴望,向往; [a]/jɜːrn/; [or]6j;
bypass: [v]绕过;回避;  [n]旁路;心脏分流手术; [a]/ˈbaɪpæs/; [or]6j;
consequent: [adj]作为结果(或后果)的,随之发生的;  [n]结果,随后的事; [a]/ˈkɑːnsəkwənt/; [or]6j;
hinge: [n]铰链;  [v]靠铰链转动; [a]/hɪndʒ/; [or]6j;
perfection: [n]完美,完满;完善; [a]/pərˈfekʃn/; [or]6j;
homely: [adj]不好看的,相貌平平的;朴素的;(如在家一般)舒适自在,家庭的;(女士)热情友好的,和蔼的; [a]/ˈhoʊmli/; [or]6j;
defect: [n]缺陷,缺点,不足之处;  [v]背叛,逃跑,开小差; [a]/ˈdiːfekt/; [or]6j;
transform: [v]将..变形,改变,转换; [a]/trænsˈfɔːrm/; [or]6j;
mitten: [n]连指手套; [a]/ˈmɪtn/; [or]6j;
informed: [adj]了解情况的,消息灵通的; [a]/ɪnˈfɔːrmd/; [or]6j;
slogan: [n]标语;口号;广告语; [a]/ˈsloʊɡən/; [or]6j;
flap: [n]慌乱(状态);拍打,挥动;(一端固定,可自由掀动的布或皮的) 垂悬平片;  [v]拍打,挥动; [a]/flæp/; [or]6j;
consequently: [adv]结果;因此;所以; [a]/ˈkɑːnsəkwentli/; [or]6j;
explore: [v]探险,探索,尝试; [a]/ɪkˈsplɔːr/; [or]6j;
delegate: [n]代表;  [v]委派..为代表,授权; [a]/ˈdelɪɡət/; [or]6j;
shuttle: [n]短程穿梭运行的车辆,接驳车;梭子;穿梭;航天飞机;  [v]穿梭移动;穿梭往返;往返于两地之间; [a]/ˈʃʌtl/; [or]6j;
originate: [vi]起源;开始;  [vt]开创; [a]/əˈrɪdʒɪneɪt/; [or]6j;
flake: [n]薄片;  [v]使成薄片;剥落;雪片般落下; [a]/fleɪk/; [or]6j;
propagation: [n]繁殖;传播; [a]/ˌprɑːpəˈɡeɪʃn/; [or]6j;
ancestor: [n]祖宗;祖先;原型; [a]/ˈænsestər/; [or]6j;
theft: [n]偷盗,失窃; [a]/θeft/; [or]6j;
endeavor: [n]尝试,努力,尽力;  [v]努力,尽力; [a]/ɪnˈdevər/; [or]6j;
revelation: [n]揭露;揭示;(出乎意料的)被揭示的真相; [a]/ˌrevəˈleɪʃn/; [or]6j;
northward(s): [adv]向北地; [a]/ˈnɔːrθwərdz/; [or]6j;
curriculum: [n]课程,(学校或专业的)全部课程; [a]/kəˈrɪkjələm/; [or]6j;
global: [adj]全球的;全面的; [a]/ˈɡloʊbl/; [or]6j;
feature: [n]面貌,相貌;特征,特点;特辑;  [vt]使突出,以.为特色;  [vi]起重要作用,作为主要角色; [a]/ˈfiːtʃər/; [or]6j;
outline: [n]外形,轮廓;大纲,概要;  [v]描绘,画出..的轮廓; [a]/ˈaʊtlaɪn/; [or]6j;
dove: [n]鸽子; [a]/dʌv/; [or]6j;
brace: [n][医学]牙齿定位器;  [v]支柱;支撑;加固;使绷紧; [a]/breɪs/; [or]6j;
seaside: [n]海滨,海边;  [adj]海边的,海滨的; [a]/ˈsiːsaɪd/; [or]6j;
commonsense: [adj]常识的;  [n]常识; [a]/ˌkɑːmən ˈsens/; [or]6j;
mall: [n]购物商场; [a]/mɔːl/; [or]6j;
abstract: [adj]抽象的;  [n]摘要,抽象;  [v]提取; [a]/ˈæbstrækt/; [or]6j;
kernel: [n]子粒,谷粒;核心; [a]/ˈkɜːrnl/; [or]6j;
itinerary: [n]旅程,路线;旅行计划; [a]/aɪˈtɪnəreri/; [or]6j;
champagne: [n]香槟酒; [a]/ʃæmˈpeɪn/; [or]6j;
optimistic: [adj]乐观的,乐观主义的; [a]/ˌɑːptɪˈmɪstɪk/; [or]6j;
arson: [n][法律]纵火,纵火罪; [a]/ˈɑːrsn/; [or]6j;
assignment: [n]任务,(课外)作业;分配,委派; [a]/əˈsaɪnmənt/; [or]6j;
entertainment: [n]娱乐;招待,款待; [a]/ˌentərˈteɪnmənt/; [or]6j;
dart: [n]飞镖;猛冲;标枪;  [v]快速投掷;突然移动; [a]/dɑːrt/; [or]6j;
estimate: [v]估价,估计,评价;  [n]估计,评价; [a]/ˈestɪmət/; [or]6j;
dramatically: [adv]显著地,剧烈地,引人注目地;戏剧性地; [a]/drəˈmætɪkli/; [or]6j;
patent: [n]专利;  [adj]显然的,明显的;专利的;独创的;  [v]取得.的专利权; [a]/ˈpætnt/; [or]6j;
benign: [adj]仁慈的;慈祥的;(病)良性的; [a]/bɪˈnaɪn/; [or]6j;
definitive: [adj]可靠的,明确的,权威的;决定性的; [a]/dɪˈfɪnətɪv/; [or]6j;
qualification: [n]资格证明;条件;合格证书;资格;限制性条件; [a]/ˌkwɑːlɪfɪˈkeɪʃn/; [or]6j;
systematically: [adv]有系统地; [a]/ˌsɪstəˈmætɪkli/; [or]6j;
descendant: [n]后代,后裔;派生物; [a]/dɪˈsendənt/; [or]6j;
satisfactorily: [adv]满意地; [a]/ˌsætɪsˈfæktərəli/; [or]6j;
inhabit: [v]居住于; [a]/ɪnˈhæbɪt/; [or]6j;
reel: [n]卷盘;  [v]旋转;感到震惊;眩晕; [a]/riːl/; [or]6j;
consult: [v]请教,咨询;查阅;商量; [a]/kənˈsʌlt/; [or]6j;
infinite: [adj]无限的,无穷的;无数的;  [n]无穷,无限大; [a]/ˈɪnfɪnət/; [or]6j;
courageous: [adj]勇敢的,英勇的,有胆量的; [a]/kəˈreɪdʒəs/; [or]6j;
cater: [v]供应伙食;为(集会,婚礼等)承办酒席; [a]/ˈkeɪtər/; [or]6j;
mess: [n]凌乱状态,混乱状态;肮脏,污秽;困境;食堂;大量某物;  [v]弄脏,弄乱;浪费时间,瞎闹; [a]/mes/; [or]6j;
border: [n]边界;花坛;滚边,边沿,包边;  [v]近似;毗邻;与..接壤;为..镶边; [a]/ˈbɔːrdər/; [or]6j;
alas: excl. 唉;  [adv]不幸地; [a]/əˈlæs/; [or]6j;
minimal: [adj]最低限度的; [a]/ˈmɪnɪməl/; [or]6j;
genetic: [adj]遗传的,起源的; [a]/dʒəˈnetɪk/; [or]6j;
haunt: [v]常去,萦绕于..;(鬼,魂)常出没于;(思想)萦绕;  [n]常去的地方; [a]/hɔːnt/; [or]6j;
ideal: [adj]理想的;完美的;空想的;观念的;  [n]理想;典范;目标; [a]/aɪˈdiːəl/; [or]6j;
edible: [adj]可食的; [a]/ˈedəbl/; [or]6j;
aid: [n]帮助;救护,援助;帮助者,助手;  [v]帮助;援助,帮助,有助于; [a]/eɪd/; [or]6j;
jeopardize: [v]危及,损害(也作jeopardise); [a]/ˈdʒepərdaɪz/; [or]6j;
ambassador: [n](特命全权)大使;代表; [a]/æmˈbæsədər/; [or]6j;
modulate: [v]调整(音调);变调;调节(使平衡); [a]/ˈmɑːdʒəleɪt/; [or]6j;
expression: [n]表情,神情;表达,表述;措辞; [a]/ɪkˈspreʃn/; [or]6j;
feast: [n]盛宴;筵席;节日;  [v]尽情地吃; [a]/fiːst/; [or]6j;
basement: [n][建筑学]地下室;根基; [a]/ˈbeɪsmənt/; [or]6j;
penguin: [n]企鹅; [a]/ˈpeŋɡwɪn/; [or]6j;
erroneous: [adj]错误的; [a]/ɪˈroʊniəs/; [or]6j;
superb: [adj]极好的;壮丽的; [a]/suːˈpɜːrb/; [or]6j;
horrible: [adj]可怕的,恐怖的;讨厌的,糟糕的;粗鲁的,不友好的; [a]/ˈhɔːrəbl/; [or]6j;
arrangement: [n]布置;排列;组合体;整齐;调解;办法;协议;计划; [a]/əˈreɪndʒmənt/; [or]6j;
geology: [n]地质学,(某一地区的)地质; [a]/dʒiˈɑːlədʒi/; [or]6j;
orientation: [n]信仰;倾向;[计]定向;(学生)迎新会;定向,方向;(任职,上学等之前的) 情况介绍;训练; [a]/ˌɔːriənˈteɪʃn/; [or]6j;
render: [v]使成为,致使,使处于(某种状态);提供,给予,以.回报;(以某种方式)表达,表现;翻译;粉刷,往(墙上)抹灰;将(脂肪)熬成油,使熔化;  [n]粉刷,打底,交纳; [a]/ˈrendər/; [or]6j;
comic: [adj]滑稽的,喜剧的,漫画的;  [n]连环漫画杂志;喜剧演员; [a]/ˈkɑːmɪk/; [or]6j;
implicit: [adj]隐含的;盲目的;完全的,绝对的;成为一部分的; [a]/ɪmˈplɪsɪt/; [or]6j;
stable: [n]马厩;  [adj]稳定的;安定的;  [v]使(马)入厩; [a]/ˈsteɪbl/; [or]6j;
revolutionary: [n]革命者;  [adj]革命的;革命性的; [a]/ˌrevəˈluːʃəneri/; [or]6j;
domain: [n]域名;领土;管区,势力圈; [a]/doʊˈmeɪn/; [or]6j;
aerial: [adj]飞机的,航空的,由飞机进行的;空中的,架空的;  [n]天线; [a]/ˈeriəl/; [or]6j;
illegal: [adj]不合法的,非法的;  [n]非法移民,非法劳工;间谍; [a]/ɪˈliːɡl/; [or]6j;
infection: [n]感染;传染病; [a]/ɪnˈfekʃn/; [or]6j;
notwithstanding: prep. 尽管,虽然;  [adv]尽管,虽然;  [conj]尽管,虽然; [a]/ˌnɑːtwɪθˈstændɪŋ/; [or]6j;
oriental: [adj]东方的;  [n]东方人; [a]/ˌɔːriˈentl/; [or]6j;
prospective: [adj]未来的;预期的;  [n]预期; [a]/prəˈspektɪv/; [or]6j;
pursue: [v]进行,从事;追求,追赶; [a]/pərˈsuː/; [or]6j;
exclaim: [v]呼叫,惊叫; [a]/ɪkˈskleɪm/; [or]6j;
stray: [adj]走失的,迷路的;离了群的;  [v]走失;分心,走神;有外遇,在别处拈花惹草;  [n]流浪者;走失,迷路; [a]/streɪ/; [or]6j;
arena: [n]竞技场,角斗场;(活动,斗争或竞争的)场所,战场,(竞争)舞台; [a]/əˈriːnə/; [or]6j;
discipline: [n]纪律;学科;训练;  [v]训练;惩罚;管制; [a]/ˈdɪsəplɪn/; [or]6j;
unity: [n]联合,统一;统一体;团结,一致; [a]/ˈjuːnəti/; [or]6j;
forthcoming: [adj]即将出现的,即将到来的;唾手可得的,可用的;乐于提供信息的; [a]/ˌfɔːrθˈkʌmɪŋ/; [or]6j;
subscribe: [vi]捐款;订阅;认购(股份);  [vt]申请; [a]/səbˈskraɪb/; [or]6j;
ignore: [v]忽视;不理; [a]/ɪɡˈnɔːr/; [or]6j;
triangular: [adj]三角形的;三人间的; [a]/traɪˈæŋɡjələr/; [or]6j;
employment: [n]职业;雇佣;就业;运用; [a]/ɪmˈplɔɪmənt/; [or]6j;
chip: [n]木屑,碎片;缺口;圆形筹码;芯片;炸薯条,炸薯片;  [v]碎裂;削,凿;将.削成,凿成; [a]/tʃɪp/; [or]6j;
generosity: [n]慷慨,大方; [a]/ˌdʒenəˈrɑːsəti/; [or]6j;
tumble: [v]翻滚;不由自主地卷入;(价格等)暴跌;跌倒,摔下,滚下;  [n]跌倒,摔倒; [a]/ˈtʌmbl/; [or]6j;
disrupt: [v]扰乱; [a]/dɪsˈrʌpt/; [or]6j;
decree: [v]命令,判决,颁布;  [n]法令,政令; [a]/dɪˈkriː/; [or]6j;
extreme: [adj]极端的;极远的;极限的;极度的;偏激的;  [n]极端;极度(状态),最大程度; [a]/ɪkˈstriːm/; [or]6j;
magnetism: [n]吸引力;磁性; [a]/ˈmæɡnətɪzəm/; [or]6j;
rebel: [v]造反,反抗,反叛;  [n]造反者;反叛者;叛逆者;  [adj]反抗的;造反的; [a]/ˈrebl/; [or]6j;
embody: [v]包含;体现,象征; [a]/ɪmˈbɑːdi/; [or]6j;
assistance: [n]援助;帮助;补助; [a]/əˈsɪstəns/; [or]6j;
artery: [n]动脉;干线; [a]/ˈɑːrtəri/; [or]6j;
silicon: [n]硅; [a]/ˈsɪlɪkən/; [or]6j;
linguist: [n]语言学家;会多国语言的人; [a]/ˈlɪŋɡwɪst/; [or]6j;
interact: [v]交流,沟通,互动;互相作用,互相影响; [a]/ˌɪntərˈækt/; [or]6j;
reaction: [n]反应能力;反应;生理反应; [a]/riˈækʃn/; [or]6j;
pulley: [n]滑轮; [a]/ˈpʊli/; [or]6j;
ferrous: [adj]含铁的; [a]/ˈferəs/; [or]6j;
polarity: [n](分)极性;相对的观点; [a]/pəˈlærəti/; [or]6j;
universally: [adv]普遍地;到处; [a]/ˌjuːnɪˈvɜːrsəli/; [or]6j;
initial: [adj]第一的;最初的;开始的;  [n]首字母; [a]/ɪˈnɪʃl/; [or]6j;
admit: [v]承认;准许.进入,允许.加入;容许,可容纳; [a]/ədˈmɪt/; [or]6j;
bizarre: [adj]稀奇古怪的; [a]/bɪˈzɑːr/; [or]6j;
persistent: [adj]坚持的;持续的; [a]/pərˈsɪstənt/; [or]6j;
tease: [v]取笑;挑逗;逗弄;使..渴望;逆梳;  [n]爱戏弄别人者; [a]/tiːz/; [or]6j;
dramatic: [adj]戏剧的,戏剧性的;引人注目的;逼真的,刺激的; [a]/drəˈmætɪk/; [or]6j;
compare: [v]比较,比作;  [n]比较;对照; [a]/kəmˈper/; [or]6j;
associate: [v]联想;联合;联系,交往;  [n]伙伴;同事;  [adj]副的; [a]/əˈsoʊʃieɪt/; [or]6j;
sermon: [n]布道;训诫; [a]/ˈsɜːrmən/; [or]6j;
scatter: [v](使)分散,撒开,散播; [a]/ˈskætər/; [or]6j;
accurate: [adj]精确的;正确的;符合标准的; [a]/ˈækjərət/; [or]6j;
involve: [v]牵涉,涉及;卷入,使参与;吸引;包含,需要,影响; [a]/ɪnˈvɑːlv/; [or]6j;
wrench: [n]扳手;痛苦,难受;猛扭,猛拉;  [v]猛拧;挣脱;使扭伤; [a]/rentʃ/; [or]6j;
warfare: [n]战争;斗争,冲突; [a]/ˈwɔːrfer/; [or]6j;
whisker: [n]胡须;腮须; [a]/ˈwɪskər/; [or]6j;
pretext: [n]借口,托词; [a]/ˈpriːtekst/; [or]6j;
cue: [n]提示;暗号;球杆;  [v]给.提示; [a]/kjuː/; [or]6j;
execution: [n]死刑;实行,执行,履行;演奏,表演; [a]/ˌeksɪˈkjuːʃn/; [or]6j;
lubricate: [v]使.润滑;给.加润滑油; [a]/ˈluːbrɪkeɪt/; [or]6j;
package: [n]包裹;一揽子,一整套; [a]/ˈpækɪdʒ/; [or]6j;
scent: [n]气味;香味;迹象;  [v]嗅到;察觉; [a]/sent/; [or]6j;
arch: [n]拱洞;拱门;拱起;  [v]做成拱形;  [adj]调皮的,淘气的; [a]/ɑːrtʃ/; [or]6j;
foresee: [v]预知,预料,预测; [a]/fɔːrˈsiː/; [or]6j;
imitation: [n]模仿;仿制品;赝品;  [adj]伪造的;仿制的; [a]/ˌɪmɪˈteɪʃn/; [or]6j;
flip: [v]把.往上抛;掷;抽打;用指轻弹;空翻;  [adj]轻率的,无礼的; [a]/flɪp/; [or]6j;
stack: [n]堆,一大堆;烟囱;  [v]堆积,堆放; [a]/stæk/; [or]6j;
classification: [n]分类,归类;(动植物等的)分类学; [a]/ˌklæsɪfɪˈkeɪʃn/; [or]6j;
sharply: [adv]锐利地,敏锐地,急剧地,剧烈地; [a]/ˈʃɑːrpli/; [or]6j;
frequent: [adj]时常的,频繁的;  [v]常去,常到; [a]/ˈfriːkwənt/; [or]6j;
pendulum: [n]摆,钟摆;摇摆不定的事态(或局面); [a]/ˈpendʒələm/; [or]6j;
distribution: [n]分布;分配;分发;散布; [a]/ˌdɪstrɪˈbjuːʃn/; [or]6j;
brood: [n]一窝,同窝幼崽;  [vi]冥思苦想;  [vt]孵;默想;  [adj]传种用的;(母鸡等)抱窝的;(昆虫等)产卵的; [a]/bruːd/; [or]6j;
accelerate: [v]加速,增长;使增速,促进; [a]/əkˈseləreɪt/; [or]6j;
supplementary: [adj]补充的;附加的;  [n]补充者; [a]/ˌsʌplɪˈmentri/; [or]6j;
moral: [adj]道德(上)的,道义的;  [n]道德,品行;寓意; [a]/ˈmɔːrəl/; [or]6j;
diverge: [v]分歧,分开; [a]/daɪˈvɜːrdʒ/; [or]6j;
association: [n]结合;伙伴,关系;协会,联盟,社团;联想; [a]/əˌsəʊsiˈeɪʃn/; [or]6j;
stainless: [adj]不生锈的,不锈钢的; [a]/ˌsteɪnləs/; [or]6j;
communicate: [v]沟通,交流;传达,传递;传染;相连,相通;显露; [a]/kəˈmjuːnɪkeɪt/; [or]6j;
benevolent: [adj]慈爱的,仁慈的;乐善好施的;慈善的; [a]/bəˈnevələnt/; [or]6j;
grunt: [v](猪等)作呼噜声,(表示烦恼,反对,疲劳,轻蔑等)发哼声;  [n]呼噜声,咕哝; [a]/ɡrʌnt/; [or]6j;
gravel: [n]沙砾,小石,砾石;  [adj]粗重而沙哑的,刺耳的;  [vt]用砾石铺;使困惑; [a]/ˈɡrævl/; [or]6j;
chat: [v]闲谈,聊天;  [n]闲谈,聊天; [a]/tʃæt/; [or]6j;
accumulate: [vi]聚积,堆积;  [vt]积攒,积累; [a]/əˈkjuːmjəleɪt/; [or]6j;
wallet: [n]皮夹,钱包; [a]/ˈwɑːlɪt/; [or]6j;
clan: [n]家族;氏族;部落;宗派;亲族; [a]/klæn/; [or]6j;
sour: [adj]酸的;(人)尖酸刻薄的,不友好的;  [v](友谊,局势,态度等)变坏;使恶化; [a]/ˈsaʊər/; [or]6j;
inherent: [adj]内在的,固有的;生来就有的; [a]/ɪnˈhɪrənt/; [or]6j;
bankrupt: [adj]破产的;彻底失败的;彻底缺乏的;  [n]破产者;  [v]使破产;使枯竭; [a]/ˈbæŋkrʌpt/; [or]6j;
stout: [adj]矮胖的,结实的;勇敢的;激烈的;  [n]矮胖子;烈性啤酒; [a]/staʊt/; [or]6j;
intent: [adj]全神贯注的;专心致志的;  [n]意图;意向;目的; [a]/ɪnˈtent/; [or]6j;
migrant: [n]候鸟;移民; [a]/ˈmaɪɡrənt/; [or]6j;
lens: [n]镜头;透镜;镜片;晶状体; [a]/lenz/; [or]6j;
motive: [n]动机,目的;  [adj]发动的,运动的,动机的;  [v]引发,促进,激发; [a]/ˈmoʊtɪv/; [or]6j;
vein: [n]静脉;血管;叶脉;纹理;迹象;风格,性情; [a]/veɪn/; [or]6j;
security: [n]安全;防护措施;债券;抵押物; [a]/sɪˈkjʊrəti/; [or]6j;
refrain: [v]抑制,避免;  [n]歌曲的反复句,叠句; [a]/rɪˈfreɪn/; [or]6j;
luggage: [n]行李箱,行李;衣箱;皮箱; [a]/ˈlʌɡɪdʒ/; [or]6j;
hurl: [v]用力投掷;  [n]猛投; [a]/hɜːrl/; [or]6j;
eliminate: [v]消灭,铲除;消除,根除;(在比赛中)淘汰; [a]/ɪˈlɪmɪneɪt/; [or]6j;
premium: [adj]高级的;高价的;(汽油)辛烷值高的;  [n]额外费用,溢价;保险金; [a]/ˈpriːmiəm/; [or]6j;
misery: [n]痛苦,悲惨,不幸; [a]/ˈmɪzəri/; [or]6j;
manifest: [adj]显然的,明白无误的,明了的;  [v]使显现,使显露,表明;  [n]货单,旅客名单; [a]/ˈmænɪfest/; [or]6j;
irreversible: [adj]不能翻转的;不可撤销的;不可逆的; [a]/ˌɪrɪˈvɜːrsəbl/; [or]6j;
illegible: [adj]难读的;难以辨认的; [a]/ɪˈledʒəbl/; [or]6j;
assumption: [n]假定,设想;采取;承担; [a]/əˈsʌmpʃn/; [or]6j;
rally: [n]集会;公路汽车赛;  [v]集合;恢复(健康等),重新振作; [a]/ˈræli/; [or]6j;
scan: [v]细看;浏览;扫描;  [n]扫描;浏览; [a]/skæn/; [or]6j;
fragrance: [n]香水;香味;芳香; [a]/ˈfreɪɡrəns/; [or]6j;
inflation: [n]通货膨胀;(充气后)膨胀;自负; [a]/ɪnˈfleɪʃn/; [or]6j;
algebra: [n]代数; [a]/ˈældʒɪbrə/; [or]6j;
irony: [n]反语;冷嘲;具有讽刺意味的事; [a]/ˈaɪrəni/; [or]6j;
telecommunications: [n]无线电通讯;电信学; [a]/ˌtelikəˌmjuːnɪˈkeɪʃnz/; [or]6j;
fireplace: [n]壁炉; [a]/ˈfaɪərpleɪs/; [or]6j;
furious: [adj]狂怒的;愤怒的;猛烈的; [a]/ˈfjʊriəs/; [or]6j;
barren: [adj]贫瘠的,不孕的;  [n]荒原,不毛之地; [a]/ˈbærən/; [or]6j;
dine: [v]吃饭,用餐;招待..吃饭;用正餐(晚餐); [a]/daɪn/; [or]6j;
trait: [n]特征; [a]/treɪt/; [or]6j;
digest: [v]消化;领会,理解;  [n]摘要; [a]/daɪˈdʒest/; [or]6j;
trolley: [n]电车;有轨电车;无轨电车;触轮;手推车;  [vt]搭乘;  [vi]搭乘; [a]/ˈtrɑːli/; [or]6j;
mesh: [n]网,筛孔;  [v]相啮合; [a]/meʃ/; [or]6j;
atmosphere: [n]大气层;大气;空气;气氛; [a]/ˈætməsfɪr/; [or]6j;
vision: [n]视力;视野;视觉;景象;想象;洞察;  [v]幻想,设想; [a]/ˈvɪʒn/; [or]6j;
drought: [n]干旱,旱灾; [a]/draʊt/; [or]6j;
sin: [n]罪;罪孽;错误;  [v]违犯戒律;犯过失; [a]/sɪn/; [or]6j;
jelly: [n]果冻,肉冻;胶状物;  [vi]成胶状;做胶冻;  [adj]有胶冻的;  [vt]使成胶冻; [a]/ˈdʒeli/; [or]6j;
competitive: [adj]竞争的;好胜的;有竞争力的; [a]/kəmˈpetətɪv/; [or]6j;
debate: [n]辩论;讨论;  [v]辩论;争论;议论; [a]/dɪˈbeɪt/; [or]6j;
contemplate: [v]沉思;对..周密考虑;注视; [a]/ˈkɑːntəmpleɪt/; [or]6j;
puppy: [n]小狗,幼犬; [a]/ˈpʌpi/; [or]6j;
decorate: [v]装饰,布置;把(勋章)授给(某人); [a]/ˈdekəreɪt/; [or]6j;
moss: [n]苔,藓,地衣; [a]/mɔːs/; [or]6j;
initiative: [n]主动权,主动性;首创精神;(重要的)法案,倡议; [a]/ɪˈnɪʃətɪv/; [or]6j;
resident: [n]居民;住客;住院实习医师;  [adj]居住的;住校的;固有的; [a]/ˈrezɪdənt/; [or]6j;
enroll: [v]入学,加入,登记,入伍; [a]/ɪnˈroʊl/; [or]6j;
tramp: [n]流浪汉;无业游民;沉重的脚步声;长途跋涉;  [v]重步行走;踏;践踏; [a]/træmp/; [or]6j;
dissatisfaction: [n]不满,不平;令人不满的事物; [a]/ˌdɪsˌsætɪsˈfækʃn/; [or]6j;
magnitude: [n]巨大;震级;重要性;[数]量值; [a]/ˈmæɡnɪtuːd/; [or]6j;
bulk: [n]大批;容量;体积;大块;  [adj]大量的;散装的;  [v]膨胀;显得重要; [a]/bʌlk/; [or]6j;
ferry: [n]渡船,渡轮;渡口;  [v]运送;渡运(人,车或物等); [a]/ˈferi/; [or]6j;
squash: [v]压扁,压制;  [n]南瓜,易压烂的物品,拥挤的人群,壁球; [a]/skwɑːʃ/; [or]6j;
surgery: [n]外科手术;外科; [a]/ˈsɜːrdʒəri/; [or]6j;
marshal: [v]整理,排列,集结;  [n]元帅;司仪,主持人; [a]/ˈmɑːrʃl/; [or]6j;
contention: [n]争夺;争论,辩论;论点; [a]/kənˈtenʃn/; [or]6j;
tanker: [n]油轮;运油飞机;油槽车;坦克手; [a]/ˈtæŋkər/; [or]6j;
overestimate: [v]过高估计;过高评价;  [n]过高的估计;过高的评价; [a]/ˌoʊvərˈestɪmət/; [or]6j;
quartz: [n]石英; [a]/kwɔːrts/; [or]6j;
regiment: [n](军队)团;  [v]组编成团;严格控制; [a]/ˈredʒɪmənt/; [or]6j;
plump: [adj]颇胖的,丰满的;  [v]拍打使鼓起,突然坐下,倒下,; [a]/plʌmp/; [or]6j;
management: [n]经营,管理,处理;管理者; [a]/ˈmænɪdʒmənt/; [or]6j;
isolate: [v]使隔离;使孤立;  [adj]孤立的;单独的; [a]/ˈaɪsəleɪt/; [or]6j;
divine: [adj]神的,神圣的;极好的;  [v](凭直觉)发现,猜到;  [n]神学家;圣职人员;教士;上帝; [a]/dɪˈvaɪn/; [or]6j;
apology: [n]道歉,(表达)歉意; [a]/əˈpɑːlədʒi/; [or]6j;
verge: [n]边缘;边界;  [v]接近;濒临; [a]/vɜːrdʒ/; [or]6j;
aerospace: [n]宇宙空间;航空航天(业);  [adj]航空与航天的,宇宙空间的; [a]/ˈeroʊspeɪs/; [or]6j;
convey: [v]传送,运送;表达,传达; [a]/kənˈveɪ/; [or]6j;
fort: [n]堡垒,要塞; [a]/fɔːrt/; [or]6j;
infrastructure: [n]基础设施; [a]/ˈɪnfrəstrʌktʃər/; [or]6j;
efficiency: [n]效率;功效;功率;性能; [a]/ɪˈfɪʃnsi/; [or]6j;
available: [adj]可得到的,可利用的,有空的,有效的; [a]/əˈveɪləbl/; [or]6j;
tightly: [adv]紧紧地; [a]/ˈtaɪtli/; [or]6j;
deflection: [n]转向;偏斜;偏折,折射; [a]/dɪˈflekʃn/; [or]6j;
unify: [v]使联合,统一;使相同,使一致; [a]/ˈjuːnɪfaɪ/; [or]6j;
likelihood: [n]可能;可能性; [a]/ˈlaɪklihʊd/; [or]6j;
quaint: [adj]精巧的;古雅的; [a]/kweɪnt/; [or]6j;
principal: [n]校长,负责人;本金,资本;  [adj]主要的,首要的; [a]/ˈprɪnsəpl/; [or]6j;
amplitude: [n]振幅;广阔;幅度; [a]/ˈæmplɪtuːd/; [or]6j;
corrode: [v]受腐蚀;腐蚀,侵蚀; [a]/kəˈroʊd/; [or]6j;
mask: [n]面具;遮蔽物;伪装;  [v]隐藏(感情);掩盖,掩饰,掩护;伪装; [a]/mæsk/; [or]6j;
merit: [n]优点;价值;功绩;  [v]值得;应得; [a]/ˈmerɪt/; [or]6j;
analyze: [v]分析;细察; [a]/ˈænəlaɪz/; [or]6j;
provocative: [adj]挑衅的,煽动的,刺激的;挑逗的; [a]/prəˈvɑːkətɪv/; [or]6j;
shed: [v]流出(眼泪);蜕皮;脱落;使清晰;流下;去除,摆脱;  [n]棚屋; [a]/ʃed/; [or]6j;
restrain: [v]制止(做);抑制(愤怒等),控制;监禁; [a]/rɪˈstreɪn/; [or]6j;
detect: [v]发现,发觉;侦察,探测; [a]/dɪˈtekt/; [or]6j;
consistent: [adj]始终如一的,持续的,一致的; [a]/kənˈsɪstənt/; [or]6j;
envious: [adj]羡慕的,嫉妒的; [a]/ˈenviəs/; [or]6j;
hike: [n]远足,徒步旅行;(数量,价格等)增加,上升;  [v]作长途徒步旅行;使高涨,提高(价格); [a]/haɪk/; [or]6j;
velvet: [n]天鹅绒;鹿茸的嫩皮;  [adj]天鹅绒的; [a]/ˈvelvɪt/; [or]6j;
detain: [v]拘留,使延迟; [a]/dɪˈteɪn/; [or]6j;
astonishment: [n]惊讶; [a]/əˈstɑːnɪʃmənt/; [or]6j;
violation: [n]违反,违背,妨碍;侵害;[体]违例,强奸; [a]/ˌvaɪəˈleɪʃn/; [or]6j;
vault: [n]保险库,金库,拱顶,墓室;  [v]越过,跳过; [a]/vɔːlt/; [or]6j;
collide: [vi]碰撞;互撞;抵触; [a]/kəˈlaɪd/; [or]6j;
lame: [adj]跛的;瘸的;差劲的,乏味的;〔解释或借口〕无说服力的,站不住脚的,蹩脚的;  [v](使)变跛; [a]/leɪm/; [or]6j;
oppose: [v]反对;反抗; [a]/əˈpoʊz/; [or]6j;
contrast: [n]差异,对照,对比;对照;对比;  [v](with)使与..对比; [a]/ˈkɑːntræst/; [or]6j;
persuasion: [n]说服;说服力; [a]/pərˈsweɪʒn/; [or]6j;
radiator: [n]散热器;暖气片; [a]/ˈreɪdieɪtər/; [or]6j;
excursion: [n]远足;短途旅行; [a]/ɪkˈskɜːrʒn/; [or]6j;
affirm: [v]肯定;断定;坚持声称; [a]/əˈfɜːrm/; [or]6j;
aspire: [vi]渴望,有志于(与to,for,after连用或后接不定式); [a]/əˈspaɪər/; [or]6j;
deadline: [n]截止期限,最后期限;  [vt]通过设定一时间期限来统治; [a]/ˈdedlaɪn/; [or]6j;
yell: [v]叫喊;  [n]叫喊;呐喊,欢呼; [a]/jel/; [or]6j;
relieve: [v]消除,减轻;换班; [a]/rɪˈliːv/; [or]6j;
defiance: [n]蔑视;反抗;挑战; [a]/dɪˈfaɪəns/; [or]6j;
humanity: [n]人性;人类;人道;慈爱;(复)人文学科; [a]/hjuːˈmænəti/; [or]6j;
coward: [n]懦夫,胆小鬼;  [adj]懦弱的,胆怯的; [a]/ˈkaʊərd/; [or]6j;
substance: [n]物质;实质,本质;药物; [a]/ˈsʌbstəns/; [or]6j;
industrious: [adj]勤劳的,勤奋的; [a]/ɪnˈdʌstriəs/; [or]6j;
prescription: [n]处方,药方;(医生开)的药;开处方,开药方; [a]/prɪˈskrɪpʃn/; [or]6j;
superior: [n]上级,高手;  [adj]较高级的,上层的,出众的; [a]/suːˈpɪriər/; [or]6j;
furniture: [n]家具;装置;设备; [a]/ˈfɜːrnɪtʃər/; [or]6j;
geographical: [adj]地理的,地理学的; [a]/ˌdʒiːəˈɡræfɪkl/; [or]6j;
mature: [adj]成熟的;到期的;  [vt]使成熟;  [vi]成熟; [a]/məˈtʃʊr/; [or]6j;
distinct: [adj]截然不同的;独特的;明显的;清晰的; [a]/dɪˈstɪŋkt/; [or]6j;
spatial: [adj]空间的,关于空间的; [a]/ˈspeɪʃl/; [or]6j;
barometer: [n]晴雨表;气压表; [a]/bəˈrɑːmɪtər/; [or]6j;
acute: [adj](疼痛,妒忌等)剧烈的,严重的;敏锐的;急性的;尖声的; [a]/əˈkjut/; [or]6j;
plead: [v]恳求,辩护,(不)认罪;提出.为理由; [a]/pliːd/; [or]6j;
willow: [n]柳树;  [v]用打棉机打开和清理;  [adj]柳木制的; [a]/ˈwɪloʊ/; [or]6j;
cognitive: [adj]认识能力的;认知的; [a]/ˈkɑːɡnətɪv/; [or]6j;
alongside: [adv]在旁边,并排地,并肩地;  prep. 在.旁边,和.并排;和.一起; [a]/əˌlɔːŋˈsaɪd/; [or]6j;
barley: [n]大麦; [a]/ˈbɑːrli/; [or]6j;
receipt: [n]收据,收条;收入;收到; [a]/rɪˈsiːt/; [or]6j;
overhead: [adj]在头顶上的,上面的,架空的;  [adv]在上面;在头顶,在上面;  [n]吊顶,天花板,屋顶;企业运营的一般费用(如房租,电费等); [a]/ˌoʊvərˈhed/; [or]6j;
engross: [v]独占;正式誊写;使全神贯注于;用大字体书写; [a]/ɪnˈɡroʊs/; [or]6j;
donation: [n]捐款;捐赠物; [a]/doʊˈneɪʃn/; [or]6j;
neglect: [v]忽视;忽略;疏忽;  [n]疏忽;忽视; [a]/nɪˈɡlekt/; [or]6j;
uncertain: [adj]不确定的;不确知的;不可靠的;易变的; [a]/ʌnˈsɜːrtn/; [or]6j;
irrigation: [n]灌溉; [a]/ˌɪrɪˈɡeɪʃn/; [or]6j;
congress: [n]国会(美);代表大会;议会;立法机关; [a]/ˈkɑːŋɡrəs/; [or]6j;
discreet: [adj]谨慎的;思虑周全的,小心的; [a]/dɪˈskriːt/; [or]6j;
prone: [adj]易于.的;有.倾向的;俯卧的; [a]/proʊn/; [or]6j;
garment: [n]服装;  [vt]给 ... 披上衣服;覆上...; [a]/ˈɡɑːrmənt/; [or]6j;
accessible: [adj]可使用的;可到达的;可进入的;易懂的; [a]/əkˈsesəbl/; [or]6j;
essential: [adj]必不可少的,必要的;本质的;重要的;基本的;  [n]要素;必需品; [a]/ɪˈsenʃl/; [or]6j;
accommodate: [v]向.提供住处(或膳宿);给.提供方便;容纳;使适应,顺应; [a]/əˈkɑːmədeɪt/; [or]6j;
snatch: [v]强夺;攫取;  [n]片断; [a]/snætʃ/; [or]6j;
snap: [v]使喀嚓一声折断,使发出吧嗒一声(关上或打开);  [n]吧嗒声;快照;  [adj]仓促的,突然的; [a]/snæp/; [or]6j;
equality: [n]同等,平等;[数]等式; [a]/iˈkwɑːləti/; [or]6j;
mountainous: [adj]多山的;巨大的; [a]/ˈmaʊntənəs/; [or]6j;
reciprocal: [adj]相互的,互惠的;  [n]倒数;互相关联的事物; [a]/rɪˈsɪprəkl/; [or]6j;
devote: [vt]奉献;献身于,专心致力于; [a]/dɪˈvoʊt/; [or]6j;
convenience: [n]方便;便利设施; [a]/kənˈviːniəns/; [or]6j;
competitor: [n]竞争对手,参赛者; [a]/kəmˈpetɪtər/; [or]6j;
printer: [n]印刷机,印刷工;打印机; [a]/ˈprɪntər/; [or]6j;
booth: [n]小舍;隔开的小间;公用电话亭;有篷的售货摊;窝棚; [a]/buːθ/; [or]6j;
classical: [adj]古典的;传统的;正统的;权威的;  [n]古典音乐; [a]/ˈklæsɪkl/; [or]6j;
collision: [n]碰撞;冲突; [a]/kəˈlɪʒn/; [or]6j;
imitate: [v]模仿; [a]/ˈɪmɪteɪt/; [or]6j;
refusal: [n]拒绝,回绝; [a]/rɪˈfjuːzl/; [or]6j;
genuine: [adj]真正的;真的;真诚的; [a]/ˈdʒenjuɪn/; [or]6j;
exaggerate: [vi]夸张;  [vt]夸大,夸张;使扩大; [a]/ɪɡˈzædʒəreɪt/; [or]6j;
fantastic: [adj]极好的;极大的;不真实的;荒诞离奇的;不可思议的;  [n]〈古〉古怪的人; [a]/fænˈtæstɪk/; [or]6j;
watery: [adj]水的;水分多的;水淋淋的,平淡的,稀薄的,松软的,有雨意的;微弱的,淡薄的; [a]/ˈwɔːtəri/; [or]6j;
instrument: [n]仪器;工具;乐器;手段; [a]/ˈɪnstrəmənt/; [or]6j;
wither: [v]枯萎;凋谢;  [vt]使枯萎,使凋谢,萎缩;使人感觉羞惭或迷惑; [a]/ˈwɪðər/; [or]6j;
ambition: [n]雄心,强烈欲望,抱负;(具体的)追求目标;  [vt]追求;有.野心; [a]/æmˈbɪʃn/; [or]6j;
design: [vt]设计;  [n]设计;图样;  [vi]设计略图;(为工艺品,装潢项目等)设计;当设计师;构思; [a]/dɪˈzaɪn/; [or]6j;
tribute: [n]致敬;悼念;贡品;称赞; [a]/ˈtrɪbjuːt/; [or]6j;
aisle: [n](席位间的)通道,过道; [a]/aɪl/; [or]6j;
ensue: [v]跟着发生,接踵而来;因而产生; [a]/ɪnˈsuː/; [or]6j;
exhausted: [adj]精疲力竭的;耗尽的;用完的; [a]/ɪɡˈzɔːstɪd/; [or]6j;
sacred: [adj]神圣的,宗教(性)的;神圣不可侵犯的; [a]/ˈseɪkrɪd/; [or]6j;
ultrasonic: [adj]超声的; [a]/ˌʌltrəˈsɑːnɪk/; [or]6j;
mission: [n]任务,使命;代表团,使团;  [vi]派遣..执行任务; [a]/ˈmɪʃn/; [or]6j;
perpendicular: [adj]成直角的,垂直的;直立的;  [n]垂直线; [a]/ˌpɜːrpənˈdɪkjələr/; [or]6j;
inspire: [v]使生灵感;启示;激发,激励; [a]/ɪnˈspaɪər/; [or]6j;
proverb: [n]谚语; [a]/ˈprɑːvɜːrb/; [or]6j;
sober: [vi]变得冷静;  [adj]未饮醉的,清醒的;有节制的;严肃的;  [v]使清醒;使冷静; [a]/ˈsoʊbər/; [or]6j;
crowd: [n]人群,一群;民众;朋友;  [v]聚集;涌入(脑海);挤满; [a]/kraʊd/; [or]6j;
persistence: [n]坚持不懈,持续; [a]/pərˈsɪstəns/; [or]6j;
pious: [adj]虔诚的;难以实现的;尽责的; [a]/ˈpaɪəs/; [or]6j;
mourn: [v]哀悼,哀伤; [a]/mɔːrn/; [or]6j;
parachute: [n]降落伞;  [v]跳伞; [a]/ˈpærəʃuːt/; [or]6j;
destined: [adj]命中注定的,预定的;(for)以.为目的地的; [a]/ˈdestɪnd/; [or]6j;
allowance: [v]定量供应(食物,饮料等物品);配给;  [n]零用钱;津贴,补贴;限额;免税额;允许,容忍,让步;考虑; [a]/əˈlaʊəns/; [or]6j;
focus: [n]焦点,聚焦;焦距;关注;  [v]使聚焦,集中注意力; [a]/ˈfoʊkəs/; [or]6j;
baffle: [v]使困惑;难住;阻碍;  [n]挡板; [a]/ˈbæfl/; [or]6j;
album: [n]相册;唱片集,专辑;集邮册; [a]/ˈælbəm/; [or]6j;
consequence: [n]结果,后果;重要性; [a]/ˈkɑːnsɪkwens/; [or]6j;
landscape: [n]风景;风景画;景观;横向打印格式;  [v]美化环境; [a]/ˈlændskeɪp/; [or]6j;
partial: [adj]偏爱的,特别喜欢的;偏袒的,不公平的,有偏见的;部分的;不完全的;  [n][数学]偏微商; [a]/ˈpɑːrʃl/; [or]6j;
deplore: [v]谴责;对...深感遗憾;悲悼;痛惜; [a]/dɪˈplɔːr/; [or]6j;
splash: [v]泼洒,溅,使成斑驳状;将.置于显眼位置;  [n]污点;飞溅的水;卖弄;拍打水的声音; 落入水的声音; [a]/splæʃ/; [or]6j;
vivid: [adj](颜色)鲜艳的,强烈的(颜色,光);生动的,清晰的(记忆,描述); [a]/ˈvɪvɪd/; [or]6j;
miser: [n]守财奴,吝啬鬼,(石油)凿井机; [a]/ˈmaɪzər/; [or]6j;
suffice: [v]足够; [a]/səˈfaɪs/; [or]6j;
tropic: [n]热带,回归线;  [adj]热带的; [a]/ˈtrɑːpɪk/; [or]6j;
olive: [n]橄榄;橄榄树;橄榄色;  [adj]橄榄色的; [a]/ˈɑːlɪv/; [or]6j;
condense: [v]压缩;精炼;冷凝; [a]/kənˈdens/; [or]6j;
intellect: [n]智力,理解力;非凡的才智;才华出众的人; [a]/ˈɪntəlekt/; [or]6j;
additional: [adj]增加的;附加的; [a]/əˈdɪʃənl/; [or]6j;
comprehensive: [adj]综合的;有充分理解力的,悟性好的;全面的,完整的;详尽的;广泛的,无所不包的;广义的;  [n]综合测验;综合学校; [a]/ˌkɑːmprɪˈhensɪv/; [or]6j;
coupon: [n](债券等)息券;赠券;配给券;折扣券; [a]/ˈkuːpɑːn/; [or]6j;
wreck: [n]沉船,失事船;失事;(事故中)遭严重损坏的汽车(飞机等);  [v]破坏,使毁灭; [a]/rek/; [or]6j;
brink: [n](尤指崖边)边缘; [a]/brɪŋk/; [or]6j;
souvenir: [n]纪念物,纪念品;  [vt]把.留作纪念; [a]/ˈsuːvənɪr/; [or]6j;
confine: [v]限制;监禁;  [n]范围,界限,约束,限制; [a]/kənˈfaɪn/; [or]6j;
corpse: [n]尸体,被废弃的东西; [a]/kɔːrps/; [or]6j;
ashore: [adv]在岸上,上岸; [a]/əˈʃɔːr/; [or]6j;
fossil: [n]化石;  [adj]从地下发掘出来的;化石的;属于旧时代的;陈腐的; [a]/ˈfɑːsl/; [or]6j;
devotion: [n]奉献,献身于...;热爱;投入;忠诚; [a]/dɪˈvoʊʃn/; [or]6j;
deviate: [v]偏离;背离;  [adj]脱离常轨的;  [n]脱离常轨的人; [a]/ˈdiːvieɪt/; [or]6j;
bust: [n]半身塑像;胸部;  [v]打碎;搜捕;降级;终止;  [adj]破产的;打碎的; [a]/bʌst/; [or]6j;
desire: [n]渴望;欲望;愿望;要求;  [vi]有希望,期望,愿望;  [vt]希望,渴望;请求,要求; [a]/dɪˈzaɪər/; [or]6j;
saturation: [n]饱和(状态),浸润,浸透; [a]/ˌsætʃəˈreɪʃn/; [or]6j;
depute: [vt]委派.为代表,指派,.为代理人;把(工作,责任等)交托给; [a]/dɪˈpjuːt/; [or]6j;
burial: [n]埋葬,葬礼;掩埋; [a]/ˈberiəl/; [or]6j;
briefcase: [n]公文包; [a]/ˈbriːfkeɪs/; [or]6j;
reluctant: [adj]不情愿的;勉强的; [a]/rɪˈlʌktənt/; [or]6j;
automated: [adj]机械化的;自动化的; [a]/ˈɔtəˌmeɪtəd/; [or]6j;
correspondence: [n]通信,通信联系;信件,函件;符合,一致;相似; [a]/ˌkɔːrəˈspɑːndəns/; [or]6j;
bracket: [n]括号;(年龄,收入等的)等级段,档次;壁架,支架;  [v]把.置于括号内;把.归入同一类; [a]/ˈbrækɪt/; [or]6j;
safeguard: [v]保护,维护;  [n]防卫措施,防范措施; [a]/ˈseɪfɡɑːrd/; [or]6j;
incidence: [n]发生率,入射角度; [a]/ˈɪnsɪdəns/; [or]6j;
thicken: [v](使)变厚,(使)变粗,使)变浓;变复杂,变密集; [a]/ˈθɪkən/; [or]6j;
timid: [adj]胆怯的;腼腆的; [a]/ˈtɪmɪd/; [or]6j;
momentum: [n](物理)动量;势头;动力; [a]/moʊˈmentəm/; [or]6j;
evacuate: [v]撤离,疏散,排清; [a]/ɪˈvækjueɪt/; [or]6j;
peculiarity: [n]怪癖;独特性; [a]/pɪˌkjuːliˈærəti/; [or]6j;
doom: [v]注定;命定;  [n]毁灭;厄运;劫数; [a]/duːm/; [or]6j;
undertaking: [n]事业,企业;承诺,保证;殡仪业;工程; [a]/ˌʌndərˈteɪkɪŋ/; [or]6j;
holder: [n]持有者,占有者,(台,架等)支持物; [a]/ˈhoʊldər/; [or]6j;
generous: [adj]慷慨的;充裕的,宽厚的;肥沃的; [a]/ˈdʒenərəs/; [or]6j;
sue: [v]控告,提起诉讼;控告;起诉;  [n]女子名(Sue); [a]/suː/; [or]6j;
tyrant: [n]暴君; [a]/ˈtaɪrənt/; [or]6j;
trigger: [n](枪等的)扳机,诱因;  [v]触发,引起,激发,扣扳机; [a]/ˈtrɪɡər/; [or]6j;
flannel: [n]法兰绒;绒布;法兰绒衣服;花言巧语;托辞;  [adj]法兰绒制的; [a]/ˈflænl/; [or]6j;
enterprise: [n]企业(或事业)单位,公司;事业;事业心; [a]/ˈentərpraɪz/; [or]6j;
foul: [adj]难闻的,发臭的;糟透了的;污秽的;犯规的;  [n]犯规;  [vi]犯规;  [vt]弄脏,使污秽;使纠缠; [a]/faʊl/; [or]6j;
hitherto: [adv]到目前为止,迄今为止; [a]/ˌhɪðərˈtuː/; [or]6j;
indefinite: [adj]模糊的;不确定的;无限的; [a]/ɪnˈdefɪnət/; [or]6j;
peer: [n]同龄人,同等地位的人;贵族;  [v]仔细看,费力地看; [a]/pɪr/; [or]6j;
mass: [n]众多;大多数;[物]质量;群众;  [adj]大量的,大规模的;  [v]聚集; [a]/mæs/; [or]6j;
toxic: [n]毒物;  [adj]有毒的;中毒的; [a]/ˈtɑːksɪk/; [or]6j;
verify: [v]查证,证明,证实; [a]/ˈverɪfaɪ/; [or]6j;
bump: [n]隆起物;撞击;(碰撞造成的)肿块;  [v]撞击;颠簸地行驶;凹凸不平;除名,撵走; [a]/bʌmp/; [or]6j;
discount: [n](价格,债款等)折扣;  [v]打折扣,不全信,怀疑地看待; [a]/ˈdɪskaʊnt/; [or]6j;
emphasize: [v]强调;着重;使突出; [a]/ˈemfəsaɪz/; [or]6j;
reliance: [n]信任,信心;信赖,依靠;信赖的人,(或物); [a]/rɪˈlaɪəns/; [or]6j;
kindle: [v]点燃,激起;着火;照亮;煽动; [a]/ˈkɪndl/; [or]6j;
fuss: [n]大惊小怪,小题大做;  [v](为小事)烦恼,过于忧虑; [a]/fʌs/; [or]6j;
converge: [v](向某一点)相交,会合;汇集,聚集,集中; [a]/kənˈvɜːrdʒ/; [or]6j;
preliminary: [adj]初步的,预备的;  [n]预赛;预考,初试;初步措施; [a]/prɪˈlɪmɪneri/; [or]6j;
shabby: [adj]破烂的,卑鄙的,衣衫褴褛的; [a]/ˈʃæbi/; [or]6j;
Buddhism: [n]佛教; [a]/ˈbʊdɪzəm/; [or]6j;
comprehension: [n]测试;理解力; [a]/ˌkɑːmprɪˈhenʃn/; [or]6j;
limestone: [n][地质学]石灰岩;石灰石; [a]/ˈlaɪmstoʊn/; [or]6j;
pistol: [n]手枪,信号,发令枪;  [v]用手枪杀死,用手枪伤害; [a]/ˈpɪstl/; [or]6j;
hurrah: excl. 好哇;  [v]欢呼;  [n]欢呼声;骚动;欢乐; [a]/həˈrɑː/; [or]6j;
attachment: [n]依恋;(机器的,通过邮件发送的)附件;连接物; [a]/əˈtætʃmənt/; [or]6j;
sustain: [v]维持;支撑,承受;供养;忍受;遭受,蒙受; [a]/səˈsteɪn/; [or]6j;
cloak: [n]斗篷,披风;覆盖物;  [vt]给.披斗篷;掩饰; [a]/kloʊk/; [or]6j;
outbreak: [n](战争,叛乱,感情等的)爆发;突然发生;  [vi]爆发; [a]/ˈaʊtbreɪk/; [or]6j;
pedal: [n]踏脚板;  [v]踏踩板;  [adj]脚踏的;  [vt]踏.的踏板; [a]/ˈpedl/; [or]6j;
profession: [n]职业;行业;声明;立誓信教; [a]/prəˈfeʃn/; [or]6j;
accomplish: [v]完成,做到;实现; [a]/əˈkɑːmplɪʃ/; [or]6j;
forerunner: [n]先驱;祖先;前兆;预兆; [a]/ˈfɔːrʌnər/; [or]6j;
decompose: [v](使)腐烂;分解; [a]/ˌdiːkəmˈpoʊz/; [or]6j;
numerous: [adj]为数众多的,许多的; [a]/ˈnuːmərəs/; [or]6j;
evidence: [v]证明;  [n]证据,证明;证物,证词; [a]/ˈevɪdəns/; [or]6j;
frequency: [n]频繁;屡次,经常发生;次数;频率; [a]/ˈfriːkwənsi/; [or]6j;
recovery: [n]痊愈;恢复,复苏;重获; [a]/rɪˈkʌvəri/; [or]6j;
viscous: [adj]黏的;黏稠的;黏滞的;有黏性的; [a]/ˈvɪskəs/; [or]6j;
collaborate: [v]合作; [a]/kəˈlæbəreɪt/; [or]6j;
superficial: [adj]肤浅的;表面的;微不足道的;  [n]表面文章; [a]/ˌsuːpərˈfɪʃl/; [or]6j;
arrange: [v]整理;改编(乐曲);筹备,安排;达成;达成协议;做安排; [a]/əˈreɪndʒ/; [or]6j;
yoke: [n]牛轭;枷锁;纽带;  [v]结合;连结; [a]/joʊk/; [or]6j;
budge: [v]移动一点;妥协; [a]/bʌdʒ/; [or]6j;
therefore: [adv]因此,所以; [a]/ˈðerfɔːr/; [or]6j;
racket: [n]吵闹声;球拍;  [v]嚷闹,吵闹,纵情欢闹;用球拍打; [a]/ˈrækɪt/; [or]6j;
canteen: [n]食堂,小卖部;水壶; [a]/kænˈtiːn/; [or]6j;
profile: [n]侧面像;外形,轮廓;  [v]描绘..的轮廓,扼要描述; [a]/ˈproʊfaɪl/; [or]6j;
fold: [v]折叠;彻底失败;合拢;  [n]折叠;褶; [a]/foʊld/; [or]6j;
thirst: [n]渴;干渴,缺水;渴求,渴望;  [v]渴求; [a]/θɜːrst/; [or]6j;
magnetic: [adj]有磁性的;有吸引力的; [a]/mæɡˈnetɪk/; [or]6j;
serpent: [n]大毒蛇,阴险的人; [a]/ˈsɜːrpənt/; [or]6j;
perpetual: [adj]永远的,永恒的;不断的; [a]/pərˈpetʃuəl/; [or]6j;
slander: [n]诽谤,诋毁;  [v]讲坏话,污蔑,诽谤; [a]/ˈslændər/; [or]6j;
dispose: [v]处理,处置,除去;使愿意; [a]/dɪˈspoʊz/; [or]6j;
thigh: [n]大腿; [a]/θaɪ/; [or]6j;
emigrate: [v]移居国外(或外地); [a]/ˈemɪɡreɪt/; [or]6j;
alcohol: [n]酒;酒精,乙醇; [a]/ˈælkəhɔːl/; [or]6j;
energetic: [adj]精力充沛的,充满活力的;有力的,积极的; [a]/ˌenərˈdʒetɪk/; [or]6j;
utilize: [v]利用;使用; [a]/ˈjuːtəlaɪz/; [or]6j;
slaughter: [v]屠杀,屠宰;  [n]屠宰,屠杀; [a]/ˈslɔːtər/; [or]6j;
insanity: [n]疯狂;精神错乱,精神病;荒谬,愚蠢; [a]/ɪnˈsænəti/; [or]6j;
feudal: [adj]领地的;封建制度的;封建时代的;世仇的; [a]/ˈfjuːdl/; [or]6j;
streamline: [n]流线型;  [adj]流线型的;  [vt]使成流线型;使.简化; [a]/ˈstriːmlaɪn/; [or]6j;
impact: [n]碰撞,冲击;冲击力;影响;  [v]冲击;压紧;产生影响;塞满; [a]/ˈɪmpækt/; [or]6j;
analyst: [n]分析员; [a]/ˈænəlɪst/; [or]6j;
promising: [adj]有前途的,有希望的;(前景)光明的; [a]/ˈprɑːmɪsɪŋ/; [or]6j;
badge: [n]徽章;象征;标记;  [vt]给予.标记;授予.徽章; [a]/bædʒ/; [or]6j;
distortion: [n]扭曲,变形;曲解;失真; [a]/dɪˈstɔːrʃn/; [or]6j;
luncheon: [n]午宴; [a]/ˈlʌntʃən/; [or]6j;
sequence: [n]顺序,次序;连续,继续; [a]/ˈsiːkwəns/; [or]6j;
reckless: [adj]不顾虑的;鲁莽的,不顾后果的; [a]/ˈrekləs/; [or]6j;
sauce: [n]酱,调味汁;莽撞,冒失; [a]/sɔːs/; [or]6j;
exclamation: [n]感叹,惊叹,惊呼;惊叹词; [a]/ˌekskləˈmeɪʃn/; [or]6j;
illuminate: [vt]照亮;阐释;说明; [a]/ɪˈluːmɪneɪt/; [or]6j;
squad: [n](军队的)班,小队,小组;  [v]编成班; [a]/skwɑːd/; [or]6j;
automation: [n]自动化; [a]/ˌɔːtəˈmeɪʃn/; [or]6j;
miniature: [adj]小型的,微小的;  [n]微小的模型,缩影,微型人物像;  [vt]使成小型;把.画成纤细画;缩写; [a]/ˈmɪnətʃər/; [or]6j;
exclude: [vt]不包括;排挤;排除;驱逐,赶出; [a]/ɪkˈskluːd/; [or]6j;
boycott: [vt]抵制;  [n]抵制; [a]/ˈbɔɪkɑːt/; [or]6j;
deafen: [v]变聋; [a]/ˈdefn/; [or]6j;
defy: [v]违抗,藐视;使不可能 (理解或解释);违背;赌.也不能;  [n]挑战;对抗; [a]/dɪˈfaɪ/; [or]6j;
preserve: [v]贮鲜,保鲜;保存;保护;  [n]独揽之事,独占的活动; [a]/prɪˈzɜːrv/; [or]6j;
eloquent: [adj]有口才的;雄辩的;演说动人的; [a]/ˈeləkwənt/; [or]6j;
dreadful: [adj]糟透了的,极不合意的;可怕的; [a]/ˈdredfl/; [or]6j;
recycle: [v]回收利用;改建;  [n]再循环; [a]/ˌriːˈsaɪkl/; [or]6j;
string: [n]弦,线,细绳,一系列;一行;  [v]串起;悬挂;使紧张;  [adj]线的,线织的;由弦乐器组成的; [a]/strɪŋ/; [or]6j;
series: [n]系列,系列节目;连续比赛;连续,接连; [a]/ˈsɪriːz/; [or]6j;
nurture: [v]养育,培育;培植;  [n]养育,培养;教养;营养物; [a]/ˈnɜːrtʃər/; [or]6j;
literature: [n]文学;宣传册;文献; [a]/ˈlɪtrətʃər/; [or]6j;
massive: [adj]巨大的;大规模的;大量的; [a]/ˈmæsɪv/; [or]6j;
concise: [adj]简明的,简要的;简洁的,简要的; [a]/kənˈsaɪs/; [or]6j;
combustion: [n]燃烧; [a]/kəmˈbʌstʃən/; [or]6j;
clearing: [n]清除,清洁;空旷地; [a]/ˈklɪrɪŋ/; [or]6j;
encounter: [v]邂逅,遭遇,偶遇;  [n]偶然碰见,遭遇; [a]/ɪnˈkaʊntər/; [or]6j;
staircase: [n]楼梯; [a]/ˈsterkeɪs/; [or]6j;
glow: [n]光辉,红光,热情;  [v]发光,发红光,发热; [a]/ɡloʊ/; [or]6j;
comply: [vi]依从,服从,遵守; [a]/kəmˈplaɪ/; [or]6j;
insulator: [n]绝缘体,绝热器; [a]/ˈɪnsəleɪtər/; [or]6j;
colleague: [n]同事;同行; [a]/ˈkɑːliːɡ/; [or]6j;
graze: [v](牲畜)吃草;放牧;擦过;  [n]擦,擦伤; [a]/ɡreɪz/; [or]6j;
extinct: [adj]灭绝的;破灭了的,消亡了的; [a]/ɪkˈstɪŋkt/; [or]6j;
agony: [n]极大痛苦; [a]/ˈæɡəni/; [or]6j;
census: [n]人口普查,人口调查;统计;  [v]调查(某地区等的)人口数字;统计.的数字; [a]/ˈsensəs/; [or]6j;
nominate: [v]提名;任命;  [adj]有特定名字的;被提名的;被指定的; [a]/ˈnɑːmɪneɪt/; [or]6j;
hiss: [n]嘶嘶声;发嘘声;  [vi]发出嘶嘶声;  [vt]嘶嘶地发出;发嘘声让(某人)别做声; [a]/hɪs/; [or]6j;
drill: [n]训练;反复操练;钻头;  [v]在..上钻孔;钻孔; [a]/drɪl/; [or]6j;
thesis: [n](学位)论文,论题,论点; [a]/ˈθiːsɪs/; [or]6j;
distill: [v]抽出..的精华;蒸馏; [a]/dɪˈstɪl/; [or]6j;
insane: [adj]精神失常的,疯狂的;精神病患者的;荒唐的;  [n]精神失常的人;精神错乱的人; [a]/ɪnˈseɪn/; [or]6j;
sanction: [n]批准;制裁,处罚;  [v]批准,支持,对..实施制裁; [a]/ˈsæŋkʃn/; [or]6j;
edit: [v]剪辑;编辑;校订;  [n]编辑[校订]工作; [a]/ˈedɪt/; [or]6j;
default: [n]违约;缺席;缺乏;默认;  [vi]不履行义务;拖欠;  [vt]不履行;不参加; [a]/dɪˈfɔːlt/; [or]6j;
attain: [v]获得;达到(某个年纪,水平,条件);实现;  [n]成就; [a]/əˈteɪn/; [or]6j;
mason: [n]泥瓦匠,共济会会员(等于freemason); [a]/ˈmeɪsn/; [or]6j;
propeller: [n]螺旋桨;推进器; [a]/prəˈpelər/; [or]6j;
therapy: [n]治疗,理疗;疗法; [a]/ˈθerəpi/; [or]6j;
loyal: [adj]忠心的;忠诚的;  [n]效忠(君主)的臣民; [a]/ˈlɔɪəl/; [or]6j;
resume: [n]简历;  [v]重新开始;继续;  [vt]回到;恢复;重新开始; [a]/ˈrezəmeɪ/; [or]6j;
frantic: [adj]疯狂的;狂乱的;慌乱的; [a]/ˈfræntɪk/; [or]6j;
vertical: [adj]垂直的;顶点的;  [n]垂直线,垂直面; [a]/ˈvɜːrtɪkl/; [or]6j;
pedlar: [n]小贩;传播者; [a]/ˈpedlər/; [or]6j;
fragrant: [adj]芬芳的;香的; [a]/ˈfreɪɡrənt/; [or]6j;
persist: [v]坚持,固执;继续存留; [a]/pərˈsɪst/; [or]6j;
clinic: [n]诊所;门诊(部,室); [a]/ˈklɪnɪk/; [or]6j;
astronomy: [n]天文学; [a]/əˈstrɑːnəmi/; [or]6j;
nickname: [n]绰号;诨号;昵称;  [vt]起绰号;叫错.的名字; [a]/ˈnɪkneɪm/; [or]6j;
resonance: [n]共振;回声;(情感等的)共鸣; [a]/ˈrezənəns/; [or]6j;
award: [n]奖品;奖学金;判决;  [vt]授予;给予; [a]/əˈwɔːrd/; [or]6j;
tuition: [n]学费,教学,讲授; [a]/tuˈɪʃn/; [or]6j;
photography: [n]摄影;摄影术; [a]/fəˈtɑːɡrəfi/; [or]6j;
convert: [v]可转变为,可变换成;改变,转变,转化;使改变信仰;  [n]皈依者;改变宗教信仰者; [a]/kənˈvɜːrt/; [or]6j;
harmonious: [adj]和谐的,协调的;和睦的;悦耳的; [a]/hɑːrˈmoʊniəs/; [or]6j;
howl: [v](狼,狗等)嗥叫;(风等)呼啸;(因愤怒,痛苦等)吼叫,哀号;  [n]嚎叫,哀号; [a]/haʊl/; [or]6j;
subtle: [adj]微妙的;敏锐的;不明显的;精细的;狡猾的; [a]/ˈsʌtl/; [or]6j;
medal: [n]奖牌;勋章;  [v]授予奖章; [a]/ˈmedl/; [or]6j;
deceive: [v]欺骗,行骗; [a]/dɪˈsiːv/; [or]6j;
triumphant: [adj]得胜的,得意洋洋的; [a]/traɪˈʌmfənt/; [or]6j;
exhaust: [v]使筋疲力尽;耗尽;详尽论述;  [n]排气装置;废气; [a]/ɪɡˈzɔːst/; [or]6j;
terminate: [adj]终止的;可结尾的;  [vi]结束;结尾;  [v]使结束,终止; [a]/ˈtɜːrmɪneɪt/; [or]6j;
combat: [n]战斗,格斗;  [v]与.战斗,与.斗争;  [adj]战斗的; [a]/ˈkɑːmbæt/; [or]6j;
embroidery: [n]刺绣(品),润色; [a]/ɪmˈbrɔɪdəri/; [or]6j;
reckon: [vt]计算;想,指望;把.看做;  [v]认为;  [vi]计算;估计; [a]/ˈrekən/; [or]6j;
grab: [v]攫取,抓取,掠夺;赶紧做;吸引;  [n]抓取,非法所得; [a]/ɡræb/; [or]6j;
refreshment: [n]茶点;食物,饮料;(会议或旅行期间提供的)饮料,点心,茶点; [a]/rɪˈfreʃmənt/; [or]6j;
crisis: [n]危机;存亡之际; [a]/ˈkraɪsɪs/; [or]6j;
accusation: [n]谴责;[律]指控; [a]/ˌækjuˈzeɪʃn/; [or]6j;
tabulate: [v]将.制成表;制成表格;  [vt]把.列表显示;  [adj]平面的;板状的; [a]/ˈtæbjuleɪt/; [or]6j;
questionnaire: [n]调查表,问卷; [a]/ˌkwestʃəˈner/; [or]6j;
smog: [n]烟雾; [a]/smɑːɡ/; [or]6j;
sip: [v]啜饮;  [n]一小口; [a]/sɪp/; [or]6j;
phase: [n](月等的)变相;盈亏;方面;阶段; [a]/feɪz/; [or]6j;
shortcut: [n]捷径;快捷之法;  [adj]提供捷径的;有简便方法的;  [v]抄近路,走捷径; [a]/ˈʃɔːrtkʌt/; [or]6j;
shear: [vt]剪羊毛;剪头发;  [n](复数)大剪刀; [a]/ʃɪr/; [or]6j;
amplify: [v]放大(声音等);扩大;增强;详述;进一步阐述; [a]/ˈæmplɪfaɪ/; [or]6j;
idiom: [n]习语;成语;惯用语法; [a]/ˈɪdiəm/; [or]6j;
mutual: [adj]互相的;彼此的;共同的; [a]/ˈmjuːtʃuəl/; [or]6j;
allegiance: [n]忠诚,拥护; [a]/əˈliːdʒəns/; [or]6j;
wrestle: [v]摔跤,角斗;斗争,努力;  [n]摔跤,角力,扭斗; [a]/ˈresl/; [or]6j;
deficit: [n]亏损;赤字;不足额; [a]/ˈdefɪsɪt/; [or]6j;
conservation: [n]保护;保存;维持; [a]/ˌkɑːnsərˈveɪʃn/; [or]6j;
preference: [n]偏爱;喜爱物; [a]/ˈprefrəns/; [or]6j;
meadow: [n]草地; [a]/ˈmedoʊ/; [or]6j;
loosely: [adv]宽松地,松散地; [a]/ˈluːsli/; [or]6j;
referee: [n]裁判员,仲裁者;  [v]裁判,仲裁; [a]/ˌrefəˈriː/; [or]6j;
hover: [v](鸟,直升机)盘旋,翱翔;(人)逗留在附近,徘徊; [a]/ˈhʌvər/; [or]6j;
bunch: [n]束;串;群,伙;  [v]集中,挤在一起;使成一束(或一群等); [a]/bʌntʃ/; [or]6j;
clearance: [n]清除;清理;清空;许可; [a]/ˈklɪrəns/; [or]6j;
contrive: [v]发明;设计出;设法做到;谋划;策划; [a]/kənˈtraɪv/; [or]6j;
constitute: [v]构成,组成;任命; [a]/ˈkɑːnstətuːt/; [or]6j;
prestige: [n]威望,声望; [a]/preˈstiːʒ/; [or]6j;
attract: [v]吸引,引诱; [a]/əˈtrækt/; [or]6j;
arc: [n]弧形物,弧;弧光;电弧; [a]/ɑːrk/; [or]6j;
tranquil: [adj]宁静的,安静的; [a]/ˈtræŋkwɪl/; [or]6j;
emergence: [n]冒出;出现;浮现;发生; [a]/iˈmɜːrdʒəns/; [or]6j;
semester: [n]一学期;半年; [a]/sɪˈmestər/; [or]6j;
lodging: [n]住所;寄宿;(大学生的)校外宿舍; [a]/ˈlɑːdʒɪŋ/; [or]6j;
intact: [adj]原封未动的,未受损的,完整无缺的; [a]/ɪnˈtækt/; [or]6j;
expand: [v]膨胀;扩大;  [vt]详细展开; [a]/ɪkˈspænd/; [or]6j;
reference: [n]参考书;提及;推荐人;参考;证明;推荐信;  [v]附.以供参考;引用; [a]/ˈrefrəns/; [or]6j;
piston: [n]活塞,瓣; [a]/ˈpɪstən/; [or]6j;
cable: [n]电缆,缆,索;  [v]拍电报; [a]/ˈkeɪbl/; [or]6j;
appreciable: [adj]很可观的;可感知的;可察觉的;可评估的; [a]/əˈpriːʃəbl/; [or]6j;
errand: [n]差使;差事;使命; [a]/ˈerənd/; [or]6j;
graphite: [n]石墨; [a]/ˈɡræfaɪt/; [or]6j;
bacteria: [n]细菌(复数); [a]/bækˈtɪriə/; [or]6j;
concern: [n]关心,担忧;  [v]感兴趣,涉及,关心,(使)担忧; [a]/kənˈsɜːrn/; [or]6j;
indulge: [v]沉迷于;放纵;满足; [a]/ɪnˈdʌldʒ/; [or]6j;
plunge: [v]跳进,(使)投入;使陷入;暴跌;  [n]卷入,参与;暴跌,骤减; [a]/plʌndʒ/; [or]6j;
specification: [n]规格,载明,详述; [a]/ˌspesɪfɪˈkeɪʃn/; [or]6j;
stock: [n]股票;股份;存货;储备;家畜;  [v]给..装满;储存;  [adj]储备的; [a]/stɑːk/; [or]6j;
epidemic: [adj]流行性的,传染的;  [n]流行病,传染病,(犯罪等的)盛行; [a]/ˌepɪˈdemɪk/; [or]6j;
instantaneous: [adj]瞬间的;即刻的;猝发的; [a]/ˌɪnstənˈteɪniəs/; [or]6j;
barricade: [n]路障;障碍物;栅栏;  [v]设路障;挡住; [a]/ˌbærɪˈkeɪd/; [or]6j;
insect: [n]昆虫; [a]/ˈɪnsekt/; [or]6j;
irregularity: [n]不规律;无常;不良行为; [a]/ɪˌreɡjəˈlærəti/; [or]6j;
staple: [v]用订书钉订;  [n]订书钉;主食;主要产品;  [adj]主要的;基本的;标准的; [a]/ˈsteɪpl/; [or]6j;
electronics: [n]电子学,电子工业;电子设备,电子产品; [a]/ɪˌlekˈtrɑːnɪks/; [or]6j;
transmit: [v]传送;传播,传导;发射; [a]/trænsˈmɪt/; [or]6j;
display: [v]展示;显示;陈列;  [n]表现,流露,展示;显示,显示器;陈列品; [a]/dɪˈspleɪ/; [or]6j;
pole: [n]杆,竿极(点);磁极;电极; [a]/poʊl/; [or]6j;
smoothly: [adv]流畅地;顺畅地,流利地;平滑地;平稳地; [a]/ˈsmuːðli/; [or]6j;
perspiration: [n]汗水;出汗; [a]/ˌpɜːrspəˈreɪʃn/; [or]6j;
flee: [v]逃走,(时间)飞逝;逃离;避开; [a]/fliː/; [or]6j;
muse: [v]沉思;冥想;  [n][希神]缪斯女神,灵感; [a]/mjuːz/; [or]6j;
loyalty: [n]忠诚;忠心耿耿; [a]/ˈlɔɪəlti/; [or]6j;
liable: [adj](for)有责任的;有义务的;(to)有.倾向的;易于.的,有可能.; [a]/ˈlaɪəbl/; [or]6j;
tedious: [adj]沉闷的,冗长乏味的; [a]/ˈtiːdiəs/; [or]6j;
incentive: [n]刺激,激励;鼓励; [a]/ɪnˈsentɪv/; [or]6j;
execute: [v]处决;完成(动作);实行;执行(计划); [a]/ˈeksɪkjuːt/; [or]6j;
paralyze: [vt]使瘫痪;使麻痹;使不能活动; [a]/ˈperəˌlaɪz/; [or]6j;
snail: [n]蜗牛;迟钝的人;  [v]捉蜗牛;缓慢移动; [a]/sneɪl/; [or]6j;
telecommunication: [n]远程通讯;  [adj]与电信有关的; [a]/ˌtelikəˌmjuːnɪˈkeɪʃn/; [or]6j;
deteriorate: [v]恶化;变质;衰退; [a]/dɪˈtɪriəreɪt/; [or]6j;
grumble: [v]埋怨;发牢骚;咕哝;  [n]隆隆响声;抱怨,怨言; [a]/ˈɡrʌmbl/; [or]6j;
merely: [adv]仅仅;仅仅,只不过; [a]/ˈmɪrli/; [or]6j;
productivity: [n]生产力;生产率;多产; [a]/ˌprɑːdʌkˈtɪvəti/; [or]6j;
luxury: [adj]奢侈的,豪华的;  [n]奢侈,奢华; [a]/ˈlʌkʃəri/; [or]6j;
cordial: [adj]热情友好的,衷心的; [a]/ˈkɔːrdʒəl/; [or]6j;
disturbance: [n]骚乱,混乱;扰乱,打扰;心神不安,烦恼; [a]/dɪˈstɜːrbəns/; [or]6j;
certify: [v](发给证书)证明;证实; [a]/ˈsɜːrtɪfaɪ/; [or]6j;
rebellion: [n]反叛,叛乱;反抗; [a]/rɪˈbeljən/; [or]6j;
breakthrough: [n]突破,突破性进展,重要的新发现;  [adj]突破性的; [a]/ˈbreɪkθruː/; [or]6j;
culture: [n]文化;文明;修养;栽培;  [v]使有教养;培养; [a]/ˈkʌltʃər/; [or]6j;
signal: [n]信号;预兆;  [v]发信号;标志;  [adj]显著的,优越的;暗号的,作信号用的; [a]/ˈsɪɡnəl/; [or]6j;
soften: [v](使)变柔软,(使)变柔和;使(态度)温和,变温和;使 (光,颜色或声音) 变柔和; [a]/ˈsɔːfn/; [or]6j;
dimension: [n]维度;尺寸;尺度;方面; [a]/dɪˈmenʃn/; [or]6j;
wholesaler: [n]批发商; [a]/ˈhoʊlseɪlər/; [or]6j;
denounce: [v]谴责,斥责; [a]/dɪˈnaʊns/; [or]6j;
biography: [n]传记文学,传记; [a]/baɪˈɑːɡrəfi/; [or]6j;
addict: [n]上瘾的人;入迷的人;  [v]使沉迷,使上瘾; [a]/ˈædɪkt/; [or]6j;
latitude: [n]纬度;地区;(言论,行动的)自由; [a]/ˈlætɪtuːd/; [or]6j;
submit: [v]提交;屈服,使...服从;建议,主张; [a]/səbˈmɪt/; [or]6j;
treasurer: [n]财务主管; [a]/ˈtreʒərər/; [or]6j;
mercury: [n]水银,汞;水星(Mercury); [a]/ˈmɜːrkjəri/; [or]6j;
peril: [n]危险;  [vt]置.于危险中;危及; [a]/ˈperəl/; [or]6j;
spite: [n]恶意,怨恨;  [v]刁难,欺侮; [a]/spaɪt/; [or]6j;
softness: [n]柔和,温柔; [a]/ˈsɔːftnəs/; [or]6j;
burner: [n]火炉;燃烧嘴;烧火的人; [a]/ˈbɜːrnər/; [or]6j;
freshen: [v]使清新,使新鲜,使精神焕发;添(饮料);增强; [a]/ˈfreʃn/; [or]6j;
amend: [v]改进;修订;修正; [a]/əˈmend/; [or]6j;
orient: [n][the Orient]东方;  [v]定..的方位;  [adj]东方的;(太阳等)上升的,新生的;闪闪发光的; [a]/ˈɔːrient/; [or]6j;
scoff: [vi]讥笑;  [v]嘲笑;  [n]愚弄; [a]/skɔːf/; [or]6j;
sticky: [adj]粘的,黏糊糊的;闷热的;困难的;令人不满意的;  [n]便利贴; [a]/ˈstɪki/; [or]6j;
participation: [n]参与;参加; [a]/pɑːrˌtɪsɪˈpeɪʃn/; [or]6j;
woe: [n]悲哀;痛苦;  int. 唉(表示痛苦,悲伤或悔恨);咳; [a]/woʊ/; [or]6j;
abandon: [v]抛弃;放弃;放纵; [a]/əˈbændən/; [or]6j;
maneuver: [v]操纵;  [n]操纵;花招;调遣;策略; [a]/məˈnʊvər/; [or]6j;
[kk9: 3071个]