tout: [v]招徕顾客,极力赞扬; [acc]/taʊt/; [or]z8;
elicit: [v]引出;诱出;探出; [acc]/iˈlɪsɪt/; [or]z8;
racket: [n]吵闹声;球拍; [v]嚷闹,吵闹,纵情欢闹;用球拍打; [acc]/ˈrækɪt/; [or]z8;
antagonize: [v]使.敌对,使.对抗,引起反抗; [acc]/ænˈtæɡənaɪz/; [or]z8;
contemplate: [v]沉思;对..周密考虑;注视; [acc]/ˈkɑːntəmpleɪt/; [or]z8;
hectic: adj. 紧张的,忙碌的;患肺病的;(因患肺病等)发烧的,有病态潮红的;脸上发红,发热的,兴奋的,狂热的,肺病的; [acc]/ˈhektɪk/; [or]z8;
impotent: adj. 无力的,无能的,阳痿的; [n]虚弱者;阳痿者; [acc]/ˈɪmpətənt/; [or]z8;
dilapidated: adj. 破旧的,破烂的;倾坍的; [acc]/dɪˈlæpɪdeɪtɪd/; [or]z8;
crux: [n]关键,难题,十字架形,坩埚; [acc]/krʌks/; [or]z8;
martial: adj. 武术的;好战的;军事的; [acc]/ˈmɑːrʃl/; [or]z8;
homicide: [n]杀人,杀人者; [acc]/ˈhɑːmɪsaɪd/; [or]z8;
asylum: [n]精神病院,疯人院;避难所; [acc]/əˈsaɪləm/; [or]z8;
entree: [n]进入,入场权,［美］主菜,(歌剧等)开始的乐章; [acc]/ˈɑːntreɪ/; [or]z8;
negligible: adj. 微不足道的,可忽略不计的; [acc]/ˈneɡlɪdʒəbl/; [or]z8;
outfit: [n]装备,全部用品,(协同工作)的一组人; [v]提供装备; [acc]/ˈaʊtfɪt/; [or]z8;
coerce: [v]强迫,压制; [acc]/koʊˈɜːrs/; [or]z8;
mobilize: [v]动员起来;动员;鼓动起; [acc]/ˈmoʊbəlaɪz/; [or]z8;
contort: [v]扭曲,歪曲; [acc]/kənˈtɔːrt/; [or]z8;
deplore: [v]谴责;对...深感遗憾;悲悼;痛惜; [acc]/dɪˈplɔːr/; [or]z8;
tacit: adj. 心照不宣的,静默的; [acc]/ˈtæsɪt/; [or]z8;
obscene: adj. 下流的,淫秽的; [acc]/əbˈsiːn/; [or]z8;
fugitive: adj. 逃亡的,易逝的; [n]逃犯,逃亡者; [acc]/ˈfjuːdʒətɪv/; [or]z8;
aspire: [vi]渴望,有志于(与to,for,after连用或后接不定式); [acc]/əˈspaɪər/; [or]z8;
prudent: adj. 谨慎的,精明的; [acc]/ˈpruːdnt/; [or]z8;
crossword: [n]纵横字谜,纵横填字谜; [acc]/ˈkrɔːswɜːrd/; [or]z8;
dentistry: [n]牙科学;牙医职业; [acc]/ˈdentɪstri/; [or]z8;
surcharge: [n]额外费用,过高的要价; [v]追加罚款;使.装载过多;使.负担过重; [acc]/ˈsɜːrtʃɑːrdʒ/; [or]z8;
tact: [n]机智,得体,老练,圆滑; [acc]/tækt/; [or]z8;
hilarious: adj. 有趣的;令人捧腹的;滑稽的;欢闹的; [acc]/hɪˈleriəs/; [or]z8;
mime: [n]哑剧演员,小丑,笑剧,丑角; [v]作摹拟表演; [acc]/maɪm/; [or]z8;
sensory: adj. 知觉的;感觉的;知觉器官的;感觉的; [acc]/ˈsensəri/; [or]z8;
incapacitate: [v]使不能;使瘫痪;使无能力;使不适合; [acc]/ˌɪnkəˈpæsɪteɪt/; [or]z8;
expulsion: [n]驱逐;开除; [acc]/ɪkˈspʌlʃn/; [or]z8;
profess: [v]表示,承认;宣称; [acc]/prəˈfes/; [or]z8;
demented: adj. 发狂的,精神错乱的; [v]精神错乱;变得痴呆; [acc]/dɪˈmentɪd/; [or]z8;
supersede: [v]代替;紧接着而到来; [acc]/ˌsuːpərˈsiːd/; [or]z8;
goody: [n]好吃的东西;吸引人的东西,好东西; int. 太好啦; [acc]/ˈɡʊdi/; [or]z8;
demon: [n]魔鬼,极残忍的人; [acc]/ˈdiːmən/; [or]z8;
morbid: adj. 疾病的;(精神等)病态的;恐怖的; [acc]/ˈmɔːrbɪd/; [or]z8;
annihilate: [v]消灭; [acc]/əˈnaɪəleɪt/; [or]z8;
slit: [n]投币口,裂缝; [v]切开; [acc]/slɪt/; [or]z8;
pinpoint: [v]准确地解释或说明; adj. 精确的; [n]针尖,极小之物,极不重要的事物; [acc]/ˈpɪnpɔɪnt/; [or]z8;
upkeep: [n]保养,维持;维修费; [acc]/ˈʌpkiːp/; [or]z8;
tirade: [n]长篇的攻击性演说; [acc]/ˈtaɪreɪd/; [or]z8;
mitigate: [v]减轻,缓和; [acc]/ˈmɪtɪɡeɪt/; [or]z8;
flair: [n]天资,特别的本领;敏锐的洞察力;嗜好;格调; [acc]/fler/; [or]z8;
trespass: [v]侵入;犯罪; [n]罪过;非法侵入; [acc]/ˈtrespæs/; [or]z8;
carnivore: [n]食肉动物,食虫植物; [acc]/ˈkɑːrnɪvɔːr/; [or]z8;
expectancy: [n]期待;预期;期望的东西; [acc]/ɪkˈspektənsi/; [or]z8;
deluge: [n]洪水;暴雨;泛滥; [v]使泛滥;压倒; [acc]/ˈdeljuːdʒ/; [or]z8;
retard: [v]延迟,使减速; [n]妨碍,阻碍; [acc]/rɪˈtɑːrd/; [or]z8;
demoralize: [v]使低落,使沮丧;使道德败坏;使士气低落; [acc]/dɪˈmɔːrəlaɪz/; [or]z8;
plasma: [n]血浆;等离子体;深绿玉髓; [acc]/ˈplæzmə/; [or]z8;
fauna: [n]动物区系,动物群; [acc]/ˈfɔːnə/; [or]z8;
madden: [v]使发疯,使发狂; [acc]/ˈmædn/; [or]z8;
anesthetic: [n]麻醉剂,麻药; adj. 麻醉的,感觉缺失的; [acc]/ˌænəs'θetɪk/; [or]z8;
smug: adj. 自鸣得意的; [acc]/smʌɡ/; [or]z8;
ensemble: [n]合唱团,表演团体;总效果;全套服装;全套家具; [acc]/ɑːnˈsɑːmbl/; [or]z8;
fiasco: [n]大失败,惨败; [acc]/fiˈæskoʊ/; [or]z8;
plank: [n]厚木板;木板制成物;政纲条款;要点; [v]在..上铺板;砰一声放下;用菜板端出; [acc]/plæŋk/; [or]z8;
adversary: [n]对手,敌手; [acc]/ˈædvərseri/; [or]z8;
diverge: [v]分歧,分开; [acc]/daɪˈvɜːrdʒ/; [or]z8;
rodeo: [n]牧马骑术表演,竞技者; [v]竞技; [acc]/ˈroʊdioʊ/; [or]z8;
mainstream: [n]主流,主要倾向; [v]使.成为主流;将(残障儿童等)纳入正规班级; adj. 主流的; [acc]/ˈmeɪnstriːm/; [or]z8;
intoxicant: adj. 醉人的,麻醉的,沉醉的; [n]酒精饮料,麻醉品; [acc]/ɪnˈtɑːksɪkənt/; [or]z8;
fleck: [n]斑点,斑纹;雀斑;微粒,小片; [v]使起斑点;使有斑纹; [acc]/flek/; [or]z8;
contend: [v]争辩;坚决主张;搏斗; [acc]/kənˈtend/; [or]z8;
glutton: [n]贪吃者,对..贪婪的人; [acc]/ˈɡlʌtn/; [or]z8;
beastly: adj. 兽性的,恶毒的,刻薄的;令人厌恶的,令人极其不快的; [acc]/ˈbiːstli/; [or]z8;
predicament: [n]困境,穷境,尴尬的处境; [acc]/prɪˈdɪkəmənt/; [or]z8;
perpetrator: [n]作恶者,犯罪者,行凶者; [acc]/ˈpɜːrpətreɪtər/; [or]z8;
mean: [n]平均值,中庸; [v]意思是,打算,导致; adj. 吝啬的,低劣的,刻薄的,卑鄙的,平均的,中等的; [acc]/miːn/; [or]z8;
paramount: [n]元首;最高; adj. 最高的,至上的,首要的; [acc]/ˈpærəmaʊnt/; [or]z8;
ascribe: [v]把.归因于;把.归属于; [acc]/əˈskraɪb/; [or]z8;
potent: adj. 强有力的;有权势的;有说服力的; [acc]/ˈpoʊtnt/; [or]z8;
foreground: [n]前景,最显著的位置; [v]强调; [acc]/ˈfɔːrɡraʊnd/; [or]z8;
unseemly: adj. 不适宜的;不得体的; [adv]不适当地; [acc]/ʌnˈsiːmli/; [or]z8;
callow: adj. (鸟)未生羽毛的;年轻而无经验的; [acc]/ˈkæloʊ/; [or]z8;
rove: [vt]漫游于,漂泊于; [vi]流浪,飘忽不定; [n]流浪,徘徊,粗纺线; [acc]/roʊv/; [or]z8;
quail: [n]鹌鹑; [v]畏缩;感到恐惧; [acc]/kweɪl/; [or]z8;
usurp: [vi]篡夺,篡位; [vt]篡夺,强夺; [acc]/juːˈzɜːrp/; [or]z8;
illicit: adj. 违法的,违禁的; [acc]/ɪˈlɪsɪt/; [or]z8;
buttock: [n]屁股的一半,屁股,船尾; [v][跤]背摔; [acc]/ˈbʌtək/; [or]z8;
intermediary: adj. 中间的;媒介的;中途的; [n]中间人;仲裁者;调解者;媒介物; [acc]/ˌɪntərˈmiːdieri/; [or]z8;
cedar: [n]雪松,香柏,西洋杉木; [acc]/ˈsiːdər/; [or]z8;
underling: [n]下属,手下; [acc]/ˈʌndərlɪŋ/; [or]z8;
impale: [v]刺穿,刺住; [acc]/ɪmˈpeɪl/; [or]z8;
infrared: adj. 红外线的; [n]红外线; [acc]/ˌɪnfrəˈred/; [or]z8;
debilitate: [v]使衰弱; [acc]/dɪˈbɪlɪteɪt/; [or]z8;
nip: [v]咬;捏;剪断;冻伤;阻止; [n]夹;捏;刺骨;小饮; [acc]/nɪp/; [or]z8;
fondle: [v]抚弄,抚摸; [acc]/ˈfɑːndl/; [or]z8;
relish: [v]享受;享受.的味道;品味; [n]乐趣;调味品; [acc]/ˈrelɪʃ/; [or]z8;
haze: [n]阴霾;薄雾;疑惑,迷糊; [v](使)变朦胧;(使)变糊涂; [acc]/heɪz/; [or]z8;
archipelago: [n]群岛; [acc]/ˌɑːrkɪˈpeləɡoʊ/; [or]z8;
pervert: [v]使堕落,误导,曲解; [n]变态,色狼; [acc]/ˈpɜːrvɜːrt/; [or]z8;
shoal: [n]浅滩,沙洲,一群(鱼); adj. (水)浅的; [v]变成浅滩;驶入浅水的地方;(鱼)成群集聚; [acc]/ʃoʊl/; [or]z8;
plush: [n]长毛绒; adj. 豪华的,长毛绒做的,舒服的; [acc]/plʌʃ/; [or]z8;
awesome: adj. 〔俚语〕极好的,棒极了的;引起敬畏的,可怕的; [acc]/ˈɔːsəm/; [or]z8;
hassle: [vt]找麻烦,搅扰;与.争辩;使.烦恼; [n]困难,麻烦;激战; [vi]争论,争辩; [acc]/ˈhæsl/; [or]z8;
supplant: [v]代替;排挤掉; [acc]/səˈplænt/; [or]z8;
forthright: adj. 直接的,直率的,坦白的,豪爽的; [adv]马上,立即; [n]直路; [acc]/ˈfɔːrθraɪt/; [or]z8;
cliche: [n]陈腐思想,陈词滥调; adj. 陈腐的; [acc]/klɪˈʃeɪ/; [or]z8;
enclave: [n]飞地(指在本国境内的隶属另一国的一块领土),被包围的领土,被包围物; [acc]/ˈenkleɪv/; [or]z8;
intangible: adj. 不可捉摸的,无形的; [n]无形的东西; [acc]/ɪnˈtændʒəbl/; [or]z8;
sustenance: [n]生计;食物,粮食; [acc]/ˈsʌstənəns/; [or]z8;
faction: [n]派别,小集团,小派系;派系斗争,内讧; [acc]/ˈfækʃn/; [or]z8;
confetti: [n](婚礼,狂欢节中抛撒的)五彩纸屑; [acc]/kənˈfeti/; [or]z8;
husbandry: [n]饲养;务农,耕种;家政; [acc]/ˈhʌzbəndri/; [or]z8;
deliberate: adj. 故意的;深思熟虑的;从容不迫的; [v]仔细考虑;研讨; [acc]/dɪˈlɪbərət/; [or]z8;
captivity: [n]囚禁;被关; [acc]/kæpˈtɪvəti/; [or]z8;
emulate: [v]努力赶上(超过),仿效; [n]仿真; [acc]/ˈemjuleɪt/; [or]z8;
defrost: [v]除霜,解冻; [acc]/ˌdiːˈfrɔːst/; [or]z8;
disinterested: adj. 公正的;不感兴趣的;无私的;廉洁的; [acc]/dɪsˈɪntrəstɪd/; [or]z8;
expiry: [n]满期,逾期,呼气,终结; [acc]/ɪkˈspaɪəri/; [or]z8;
registrar: [n]登记员,记录员; [acc]/ˌredʒɪˈstrɑːr/; [or]z8;
anemia: [n]贫血,贫血症; [acc]/ə'niːmiːə/; [or]z8;
cursive: [n]草书;草书原稿; adj. 草书的;草书体的; [acc]/ˈkɜːrsɪv/; [or]z8;
coercion: [n]胁迫,威压; [acc]/koʊˈɜːrʒn/; [or]z8;
demote: [v]降级,降职; [acc]/ˌdiːˈmoʊt/; [or]z8;
excise: [v]切除,删去; [n]消费税,货物税,国产税; [acc]/ˈeksaɪz/; [or]z8;
confidant: [n]密友; [acc]/ˈkɑːnfɪdænt/; [or]z8;
orchestrate: [v]精心安排,编管弦乐曲,协调; [acc]/ˈɔːrkɪstreɪt/; [or]z8;
dissolute: adj. 无节制的;放荡的; [acc]/ˈdɪsəluːt/; [or]z8;
irreparable: adj. 不能修复的;不可弥补的; [acc]/ɪˈrepərəbl/; [or]z8;
ascetic: adj. 禁欲的;苦行的; [n]禁欲者;苦行者; [acc]/əˈsetɪk/; [or]z8;
legible: adj. 清晰的;易读的;易辨认的; [acc]/ˈledʒəbl/; [or]z8;
redemption: [n]赎回,拯救,偿还,实践; [acc]/rɪˈdempʃn/; [or]z8;
querulous: adj. 抱怨的,挑剔的; [acc]/ˈkwerələs/; [or]z8;
incipient: adj. 初期的;刚出现的; [acc]/ɪnˈsɪpiənt/; [or]z8;
icicle: [n]冰柱,冰垂; [acc]/ˈaɪsɪkl/; [or]z8;
stubble: [n]残株,发茬,须茬; [acc]/ˈstʌbl/; [or]z8;
attest: [vt]证明;证实;为.作证; [vi]证明;作证; [acc]/əˈtest/; [or]z8;
convulse: [v]使抽搐,使震动,震惊; [acc]/kənˈvʌls/; [or]z8;
demography: [n]人口统计,人口统计学; [acc]/dɪˈmɑːɡrəfi/; [or]z8;
exacerbate: [v]加重;恶化;激怒; [acc]/ɪɡˈzæsərbeɪt/; [or]z8;
enigma: [n]谜,哑谜;闷葫芦; [acc]/ɪˈnɪɡmə/; [or]z8;
heresy: [n]异端邪说;异教; [acc]/ˈherəsi/; [or]z8;
nitrate: [n]硝酸盐,氮肥; [vt]用硝酸处理;使硝化; [acc]/ˈnaɪtreɪt/; [or]z8;
numb: adj. 麻木的,失去知觉的; [vt]使麻木,使失去知觉; [acc]/nʌm/; [or]z8;
hypnosis: [n]催眠,催眠状态; [acc]/hɪpˈnoʊsɪs/; [or]z8;
assertive: adj. 肯定的;决断的;坚定而自信的;独断的; [acc]/əˈsɜːrtɪv/; [or]z8;
torrid: adj. 酷热的,热烈; [acc]/ˈtɔːrɪd/; [or]z8;
hallowed: adj. 神圣的; [acc]/ˈhæloʊd/; [or]z8;
expedite: [v]加快;促进;发出; adj. 畅通的;迅速的;方便的; [acc]/ˈekspədaɪt/; [or]z8;
assail: [v]攻击;质问;着手解决; [acc]/əˈseɪl/; [or]z8;
freighter: [n][水运][船]货船;承运人; [acc]/ˈfreɪtər/; [or]z8;
seclude: [v]与世隔绝,使隔绝; [acc]/sɪˈkluːd/; [or]z8;
hew: [v]砍伐;劈;遵守,坚持; [acc]/hjuː/; [or]z8;
encompass: [vt]环绕,包围;包含;完成; [acc]/ɪnˈkʌmpəs/; [or]z8;
virile: adj. 成年男子的,有男子气概的,强壮的; [acc]/ˈvɪrəl/; [or]z8;
humility: [n]谦逊,谦恭; [acc]/hjuːˈmɪləti/; [or]z8;
scripture: [n]经文;圣经; [acc]/ˈskrɪptʃər/; [or]z8;
squirt: [v]喷射,喷湿,喷出; [n]喷,细的喷流,讨厌鬼; [acc]/skwɜːrt/; [or]z8;
audible: adj. 听得见的; [acc]/ˈɔːdəbl/; [or]z8;
kernel: [n]子粒,谷粒;核心; [acc]/ˈkɜːrnl/; [or]z8;
Sabbath: [n]安息日; [acc]/ˈsæbəθ/; [or]z8;
sleazy: adj. 质地单薄的,低劣的,肮脏的; [acc]/ˈsliːzi/; [or]z8;
revel: [n]狂欢; [v]狂欢; [acc]/ˈrevl/; [or]z8;
heckle: [v]诘问,困扰; [n]麻梳;梳理;[印]针排; [acc]/ˈhekl/; [or]z8;
sultan: [n]苏丹(某些伊斯兰国家最高统治者称号); [acc]/ˈsʌltən/; [or]z8;
pretentious: adj. 做作的,自命不凡的,炫耀的; [acc]/prɪˈtenʃəs/; [or]z8;
harpoon: [n](捕鲸的)鱼叉; [vt]用鱼叉叉;用鱼叉捕获; [acc]/hɑːrˈpuːn/; [or]z8;
prodigal: adj. 挥霍的,十分慷慨的; [n]浪子,挥霍者; [acc]/ˈprɑːdɪɡl/; [or]z8;
mural: [n]壁画;壁饰; adj. 墙壁的;挂在墙壁上的; [acc]/ˈmjʊrəl/; [or]z8;
rodent: [n]啮齿类动物(如鼠等); [acc]/ˈroʊdnt/; [or]z8;
mussel: [n]蚌类; [acc]/ˈmʌsl/; [or]z8;
accede: [v]同意,就任,加入; [acc]/əkˈsiːd/; [or]z8;
fillet: [n]肉片;头带;平边;饰线; [v]用带缚;把.切成片; [acc]/fɪˈleɪ/; [or]z8;
slick: adj. 光滑的;圆滑的;顺利的;不费力的; [n]海面浮油;小块湿润的区域; [v]使平滑; [acc]/slɪk/; [or]z8;
laryngitis: [n]喉炎; [acc]/ˌlærɪnˈdʒaɪtɪs/; [or]z8;
omniscient: adj. 无所不知的,博识的; [n]无所不知者,上帝; [acc]/ɑːmˈnɪsiənt/; [or]z8;
wobble: [v]摇晃;摇摆;游移不定; [n]摆动;摇晃;不稳定; [acc]/ˈwɑːbl/; [or]z8;
stereotype: [n]老套的模式,陈规,成见; [v]对..产生成见; [acc]/ˈsteriətaɪp/; [or]z8;
chime: [n]一套钟,合奏钟声; [v]鸣响,敲出和谐的声音; [acc]/tʃaɪm/; [or]z8;
nirvana: [n]涅槃,心灵的平静,极乐; [acc]/nɪrˈvɑːnə/; [or]z8;
correlate: [v](使)相关联; [n]相关物; [acc]/ˈkɔːrələt/; [or]z8;
mandate: [n]授权;命令,指令;委托管理;受命进行的工作; [v]授权;托管; [acc]/ˈmændeɪt/; [or]z8;
stricture: [n]谴责;严厉;束缚; [acc]/ˈstrɪktʃər/; [or]z8;
freckle: [n]雀斑;斑点; [acc]/ˈfrekl/; [or]z8;
jog: [v]慢跑;轻碰; [n]轻推,慢跑,漫步; [acc]/dʒɑːɡ/; [or]z8;
autograph: [n]亲笔签名; [v]署名; adj. 亲笔的; [acc]/ˈɔːtəɡræf/; [or]z8;
brash: adj. 无礼的,傲慢的;仓促的,性急的; [n]骤雨;碎片;[医]胃灼热; [acc]/bræʃ/; [or]z8;
jest: [n]笑话,俏皮话;玩笑; [v]开玩笑;嘲笑; [acc]/dʒest/; [or]z8;
elope: [v]私奔;潜逃;出走; [acc]/ɪˈloʊp/; [or]z8;
impinge: [v]侵犯,撞击,碰撞; [acc]/ɪmˈpɪndʒ/; [or]z8;
accompanist: [n]伴奏者,伴随者; [acc]/əˈkʌmpənɪst/; [or]z8;
python: [n]蟒蛇,巨蛇; [acc]/ˈpaɪθɑːn/; [or]z8;
glossary: [n]词汇表,术语汇编; [acc]/ˈɡlɑːsəri/; [or]z8;
embody: [v]包含;体现,象征; [acc]/ɪmˈbɑːdi/; [or]z8;
windfall: [n]风吹落果;意外的收获,意外幸运; [acc]/ˈwɪndfɔːl/; [or]z8;
tepid: adj. 微温的,不热烈的; [acc]/ˈtepɪd/; [or]z8;
crease: [n]折缝,皱痕; [v]起折痕; [acc]/kriːs/; [or]z8;
booze: [n]酒宴,酒; [v]暴饮; [acc]/buːz/; [or]z8;
gusto: [n]由衷的高兴;爱好,嗜好; [acc]/ˈɡʌstoʊ/; [or]z8;
slash: [n]砍痕;砍; [v]砍,大幅度削减; [acc]/slæʃ/; [or]z8;
aerodynamics: [n][流]气体力学;空气动力学; adj. 空气动力(学)的; [acc]/ˌeroʊdaɪˈnæmɪks/; [or]z8;
misgiving: [n]疑虑; [vt]担忧;使.疑虑;害怕(misgive的变形); [acc]/ˌmɪsˈɡɪvɪŋ/; [or]z8;
apparel: [n]服装,衣服; [vt]给.穿衣服(尤指华丽或特殊的服装); [acc]/əˈpærəl/; [or]z8;
inflict: [v]使遭受(损伤,痛苦等);使承担(负担等); [acc]/ɪnˈflɪkt/; [or]z8;
orthodoxy: [n]正统,正教,正统说法; [acc]/ˈɔːrθədɑːksi/; [or]z8;
haggle: [n]讨价还价; [v]争论,讨价还价; [acc]/ˈhæɡl/; [or]z8;
lieu: [n]代替;场所; [acc]/luː/; [or]z8;
indisputable: adj. 没有争论余地,非常清楚的; [acc]/ˌɪndɪˈspjuːtəbl/; [or]z8;
lineage: [n]血统,世系,门第,宗族;传承; [acc]/ˈlɪniɪdʒ/; [or]z8;
confederate: [n]同盟国,同盟者; adj. 同盟的,联合的; [v]结盟,联合; [acc]/kənˈfedərət/; [or]z8;
shin: [n]胫骨; [v]爬,攀,快步走; [acc]/ʃɪn/; [or]z8;
gorge: [n]峡谷;胃;暴食;咽喉;障碍物; [v]拼命吃;吞下,狼吞虎咽;塞满,填满; [acc]/ɡɔːrdʒ/; [or]z8;
belie: [vt]与.不符;矛盾,误解; [acc]/bɪˈlaɪ/; [or]z8;
definitive: adj. 可靠的,明确的,权威的;决定性的; [acc]/dɪˈfɪnətɪv/; [or]z8;
mercenary: [n]外国雇佣兵;唯利是图者; adj. 唯利是图的;雇佣的; [acc]/ˈmɜːrsəneri/; [or]z8;
underdog: [n]弱势的一方,受害者,输家; [acc]/ˈʌndərdɔːɡ/; [or]z8;
virtuous: adj. 善良的,有德行的,贞洁的; [acc]/ˈvɜːrtʃuəs/; [or]z8;
cocaine: [n]可卡因,古柯碱; [acc]/koʊˈkeɪn/; [or]z8;
florid: adj. 涨红的,华丽的,红润的; [acc]/ˈflɔːrɪd/; [or]z8;
nominal: adj. 名义上的;象征性的,很少的;名词性的; [acc]/ˈnɑːmɪnl/; [or]z8;
taunt: [n]辱骂,嘲弄; [vt]嘲弄,奚落; adj. [海](桅杆)很高的; [adv]扯满风帆; [acc]/tɔːnt/; [or]z8;
mesh: [n]网,筛孔; [v]相啮合; [acc]/meʃ/; [or]z8;
diarrhea: [n]腹泻,拉肚子; [acc]/ˌdaɪə'riːə/; [or]z8;
communion: [n]共享,恳谈,宗教团体,圣餐仪式; [acc]/kəˈmjuːniən/; [or]z8;
painstaking: adj. (不辞)劳苦的,辛勤的; [n]辛劳,煞费苦心; [acc]/ˈpeɪnzteɪkɪŋ/; [or]z8;
partake: [v]分享,参与,分担; [n]参与者,分担者; [acc]/pɑːrˈteɪk/; [or]z8;
acquiesce: [v]默许;勉强同意; adj. 默认的; [acc]/ˌækwiˈes/; [or]z8;
wean: [v]断奶,戒掉(off/from),(从早年开始)使用; [n]〈英〉婴儿;小儿; [acc]/wiːn/; [or]z8;
banish: [v]放逐;摒弃; [acc]/ˈbænɪʃ/; [or]z8;
duet: [n]二重唱; [vi]演奏二重奏或二重唱; [acc]/duˈet/; [or]z8;
scum: [n]浮沫,浮渣; [acc]/skʌm/; [or]z8;
premature: adj. 早产的,过早的,早熟的; [n]早产儿; [acc]/ˌpriːməˈtʃʊr/; [or]z8;
fend: [v](靠自己)照顾,照料;保护;力争; [acc]/fend/; [or]z8;
perish: [vi]死去;毁灭,灭亡; [v]脆裂,老化,腐烂; [acc]/ˈperɪʃ/; [or]z8;
hillock: [n]小丘,小山似的一堆; [acc]/ˈhɪlək/; [or]z8;
ignite: [v]点燃,发光,燃烧; [acc]/ɪɡˈnaɪt/; [or]z8;
yeoman: [n]自耕农;自由民;仆人; adj. 坚毅的:刚毅的,忠实的; [acc]/ˈjoʊmən/; [or]z8;
damsel: [n]少女,年轻女子; [acc]/ˈdæmzl/; [or]z8;
idyllic: adj. 田园短诗的,牧歌的,生动逼真的; [acc]/aɪˈdɪlɪk/; [or]z8;
vignette: [n]装饰图案;小插图; [v]把..印放为虚光照,晕映; [acc]/vɪnˈjet/; [or]z8;
blues: [n]忧郁布鲁斯歌曲;蓝色物;忧郁,悲伤; [acc]/bluːz/; [or]z8;
simulate: [v]假装;模仿;模拟; [acc]/ˈsɪmjuleɪt/; [or]z8;
undercharge: [n]索价低于常价;充电不足; [vi]向.少收钱; [vt]向.少收钱; [acc]/ˌʌndərˈtʃɑːrdʒ/; [or]z8;
suitor: [n]求婚者,(法律)原告; [acc]/ˈsuːtər/; [or]z8;
mastery: [n]权力;优势;精通,掌握; [acc]/ˈmæstəri/; [or]z8;
utilitarian: adj. 实用的;功利的; [n]实用主义者; [acc]/ˌjuːtɪlɪˈteriən/; [or]z8;
tractable: adj. 易于管教的,易驾驭的,易处理的,驯良的; [acc]/ˈtræktəbl/; [or]z8;
wrest: [n]扭,拧; [vt]用力拧;强夺;歪曲; [acc]/rest/; [or]z8;
voluble: adj. 健谈的,缠绕的,易旋转的; [acc]/ˈvɑːljəbl/; [or]z8;
stipulate: [v]规定;保证;保证;要求以.为条件; [acc]/ˈstɪpjuleɪt/; [or]z8;
gloss: [n]光泽;假象;唇膏; [vt]使有光彩;掩盖; [acc]/ɡlɑːs/; [or]z8;
negotiable: adj. 可谈判的,可商议的;可兑换现金的;可通行的(道路,河流); [acc]/nɪˈɡoʊʃiəbl/; [or]z8;
diarrhoea: [n]腹泻; [acc]/ˌdaɪəˈriːə/; [or]z8;
antidote: [n][药]解毒剂,解药;矫正方法; [acc]/ˈæntidoʊt/; [or]z8;
flag: [v](以旗子)标出,标记;疲乏,热情衰减; [n]国旗,旗帜; [acc]/flæɡ/; [or]z8;
espouse: [v]支持,拥护; [acc]/ɪˈspaʊz/; [or]z8;
forum: [n]论坛;讨论会; [acc]/ˈfɔːrəm/; [or]z8;
frenzy: [n]狂暴;狂怒,暴怒;疯狂,迷乱; [v]使发狂,使狂怒; [acc]/ˈfrenzi/; [or]z8;
secrete: [v]藏匿;私下侵吞;分泌; [acc]/sɪˈkriːt/; [or]z8;
recur: [v]重新出现;再次发生;重新提起;诉诸;反复; [acc]/rɪˈkɜːr/; [or]z8;
impart: [v]传授,给予,将(某性质)给予或赋予某事物; [acc]/ɪmˈpɑːrt/; [or]z8;
generate: [v]产生(热,电等能量),创造; [acc]/ˈdʒenəreɪt/; [or]z8;
adorn: [v]装饰; [acc]/əˈdɔːrn/; [or]z8;
premiere: [n]首次公演; [vi]首次上演; [vt]初次演出; adj. 初次的,女主角的; [acc]/prɪˈmɪr/; [or]z8;
randy: adj. 好色的; [n][苏格兰]粗野的女人,强讨的叫花子,莽汉,粗鲁悍妇; [acc]/ˈrændi/; [or]z8;
sacrament: [n]圣礼,圣事; [vt]使立誓,使宣誓; [acc]/ˈsækrəmənt/; [or]z8;
kindred: [n]亲戚,家族,亲属关系,相似; adj. 有血缘关系的,同宗的,同源的,类似的; [acc]/ˈkɪndrəd/; [or]z8;
spurious: adj. 假的,伪造的,欺骗的; [acc]/ˈspjʊriəs/; [or]z8;
tract: [n]器官系统;一大片地;短文,小册子; [acc]/trækt/; [or]z8;
handstand: [n]手倒立; [acc]/ˈhændstænd/; [or]z8;
hilt: [n]刀把,柄; [vt]给.装柄; [acc]/hɪlt/; [or]z8;
rustle: [v]发出沙沙声,使沙沙作响,偷窃; [n]沙沙声; [acc]/ˈrʌsl/; [or]z8;
allay: [v]减轻;使缓和;使平静; [acc]/əˈleɪ/; [or]z8;
smother: [v]窒息; [acc]/ˈsmʌðər/; [or]z8;
translucent: adj. 半透明的;透亮的,有光泽的;易懂的;真实的; [acc]/trænsˈluːsnt/; [or]z8;
irrespective: adj. 不考虑的,不顾的; [acc]/ˌɪrɪˈspektɪv/; [or]z8;
snarl: [v]缠结,混乱,吠,咆哮,怒骂; [n]咆哮,吼叫,怒骂,缠结,混乱; [acc]/snɑːrl/; [or]z8;
lethal: adj. 致命的,致死的;杀伤性的; [n]致死因子; [acc]/ˈliːθl/; [or]z8;
impede: [v]妨碍,阻碍; [acc]/ɪmˈpiːd/; [or]z8;
quadrant: [n]象限,四分之一圆; [acc]/ˈkwɑːdrənt/; [or]z8;
invigorate: [v]鼓舞;提神,使精力充沛; adj. 生气勃勃的,精力充沛的,健壮的; [n]滋补;鼓舞; [acc]/ɪnˈvɪɡəreɪt/; [or]z8;
abrasive: adj. 粗糙的;有研磨作用的;伤人感情的; [n]研磨料; [acc]/əˈbreɪsɪv/; [or]z8;
artisan: [n]工匠,手艺人; [acc]/ˈɑːrtəzn/; [or]z8;
exploit: [v]剥削,利用;开发,开拓; [n]辉煌功绩; [acc]/ɪkˈsplɔɪt/; [or]z8;
perk: [v]昂首,意气洋洋,振作; [n]好处;福利; adj. 〈罕〉同"perky"; [acc]/pɜːrk/; [or]z8;
addictive: adj. 使人上瘾的; [acc]/əˈdɪktɪv/; [or]z8;
sporadic: adj. 不定时发生的;零星的;分散的; [acc]/spəˈrædɪk/; [or]z8;
abdominal: adj. 腹部的,有腹鳍的; [acc]/æbˈdɑːmɪnl/; [or]z8;
terrestrial: adj. 地球的,陆地的; [n]陆地生物;地球上的人; [acc]/təˈrestriəl/; [or]z8;
divine: adj. 神的,神圣的;极好的; [v](凭直觉)发现,猜到; [n]神学家;圣职人员;教士;上帝; [acc]/dɪˈvaɪn/; [or]z8;
wary: adj. 谨慎的,小心的,提防的;考虑周到的; [acc]/ˈweri/; [or]z8;
interlocutor: [n]对话者,谈话者; [acc]/ˌɪntərˈlɑːkjətər/; [or]z8;
cryptic: adj. 秘密的,含义模糊的,神秘的,隐藏的; [acc]/ˈkrɪptɪk/; [or]z8;
squeal: [n]长而尖锐的刺耳叫声; [vi]发出长而尖锐的刺耳叫声; [vt]以尖厉刺耳的声音发出; [acc]/skwiːl/; [or]z8;
dent: [n]缺口,凹痕; [v]使凹下,凹进,削弱; [acc]/dent/; [or]z8;
cameo: [n]石雕,贝雕;浮雕玉石;文学小品; [acc]/ˈkæmioʊ/; [or]z8;
unwieldy: adj. 使用不便的,不灵巧的,难处理的;笨重的; [acc]/ʌnˈwiːldi/; [or]z8;
meditate: [v]考虑,沉思,冥想; [acc]/ˈmedɪteɪt/; [or]z8;
deplete: [v]使大大减少;耗尽,用尽; [acc]/dɪˈpliːt/; [or]z8;
acrimony: [n]尖刻,刻薄; [acc]/ˈækrɪmoʊni/; [or]z8;
dimple: [n]酒窝,涟漪,浅凹;酒窝;浅凹;酒涡,涟漪,浅凹; [v]做出凹痕;(使)起波纹;(使)起涟漪; [acc]/ˈdɪmpl/; [or]z8;
incumbent: [n]在职者,现任者; adj. 现任的;依靠的;负有职责的; [acc]/ɪnˈkʌmbənt/; [or]z8;
allegory: [n]讽喻;寓意;寓言; [acc]/ˈæləɡɔːri/; [or]z8;
rebate: [vt]减少;打折扣; [vi]退还部分付款,打折扣; [n]折扣; [acc]/ˈriːbeɪt/; [or]z8;
confection: [n]糖果,蜜饯,调制,糖膏(剂),精制工艺品; [v]〈古〉调制; [acc]/kənˈfekʃn/; [or]z8;
immaterial: adj. 非实体的,无关紧要的; [acc]/ˌɪməˈtɪriəl/; [or]z8;
intrigue: [n]阴谋;诡计; [v]密谋;欺骗;引起极大兴趣; [acc]/ɪnˈtriːɡ/; [or]z8;
candid: adj. 坦白的;无偏见的;公正的;率直的; [acc]/ˈkændɪd/; [or]z8;
cobble: [v]修,拙劣地修补;铺鹅卵石,用圆石铺面; [n]鹅卵石,圆石; [acc]/ˈkɑːbl/; [or]z8;
tremor: [n](小)地震;[医]震颤,战栗,发抖; [acc]/ˈtremər/; [or]z8;
leverage: [n]杠杆作用;杠杆效率; [v]举债经营;借贷收购;利用; [acc]/ˈlevərɪdʒ/; [or]z8;
pleat: [n]褶,褶状物; [acc]/pliːt/; [or]z8;
wield: [v]运用,行使;挥; [vt]使用; [acc]/wiːld/; [or]z8;
retaliate: [v]报复,反击; [acc]/rɪˈtælieɪt/; [or]z8;
ominous: adj. 不祥的,不吉利的; [acc]/ˈɑːmɪnəs/; [or]z8;
egoist: [n]自我主义者,利己主义者; [acc]/ˈiːɡoʊɪst/; [or]z8;
infamous: adj. 声名狼藉的,无耻的; [acc]/ˈɪnfəməs/; [or]z8;
snare: [n]罗网;陷阱;圈套; [acc]/sner/; [or]z8;
outgoing: adj. 外向的;外出的;乐于助人的;即将离职的,卸任的; [n]流出;开支; [acc]/ˈaʊtɡoʊɪŋ/; [or]z8;
causal: adj. 因果关系的,有原因的; [n]表示原因的连词; [acc]/ˈkɔːzl/; [or]z8;
mores: [n]风俗习惯,道德观念; [acc]/ˈmɔːreɪz/; [or]z8;
mongrel: [n]杂种动物,混血儿; adj. 杂种的;杂交的;混血的; [acc]/ˈmʌŋɡrəl/; [or]z8;
piss: int. 〈美俚〉呸; [v]小便; [n]小便; [acc]/pɪs/; [or]z8;
aggrieved: adj. 忿忿不平的,痛心的;权利受到不法侵害的; [acc]/əˈɡriːvd/; [or]z8;
motley: adj. 混杂的,杂色的; [n]混杂;杂色衣服;小丑; [acc]/ˈmɑːtli/; [or]z8;
aspiration: [n]抱负,志向;发 h 音; [acc]/ˌæspəˈreɪʃn/; [or]z8;
swathe: [n]带子,绷带;包装品; [vt]包围;紧绑;裹; [acc]/sweɪð/; [or]z8;
alcoholism: [n]酒精中毒; [acc]/ˈælkəhɔːlɪzəm/; [or]z8;
fairground: [n]露天市场,举行赛会的场所; [acc]/ˈferɡraʊnd/; [or]z8;
frivolous: adj. 轻佻的,不重要的,缺乏基础的; [acc]/ˈfrɪvələs/; [or]z8;
payroll: [n]工资单; [acc]/ˈpeɪroʊl/; [or]z8;
sulk: [n]生气,愠怒,愠怒的人; [v]生气,愠怒; [acc]/sʌlk/; [or]z8;
peripheral: adj. 外围的; [n]外围设备; [acc]/pəˈrɪfərəl/; [or]z8;
cumbersome: adj. 笨重的;麻烦的; [acc]/ˈkʌmbərsəm/; [or]z8;
secretive: adj. 秘密的;偷偷摸摸的;促进分泌的; [acc]/ˈsiːkrətɪv/; [or]z8;
spate: [n]洪水;一阵;大雨;突然迸发; [acc]/speɪt/; [or]z8;
venison: [n]鹿肉;野味; [acc]/ˈvenɪsn/; [or]z8;
rap: [n]饶舌歌; [v]轻敲;表演说唱;严厉批评; [acc]/ræp/; [or]z8;
convoy: [n]护送,护卫,护航队; [v]护航,护送; [acc]/ˈkɑːnvɔɪ/; [or]z8;
abase: [v]贬抑;使卑下;降低.的地位; [n]贬低;屈辱;贬低别人的人; [acc]/əˈbeɪs/; [or]z8;
precipitate: [v]促成,使..沉淀,猛摔;[气象]凝结; [n]沉淀物,冷凝物; adj. 突如其来的,仓促的,迅猛的;感情用事的; [acc]/prɪˈsɪpɪteɪt/; [or]z8;
slimy: adj. 黏糊糊的;黏滑的;谄媚的; [acc]/ˈslaɪmi/; [or]z8;
flaunt: [n]招摇;飘扬;藐视; [vi]炫耀;飘扬; [vt]炫耀; [acc]/flɔːnt/; [or]z8;
incense: [n]焚香时的烟,香味; [v]激怒; [acc]/ˈɪnsens/; [or]z8;
elite: [n]精英; adj. 高级的; [acc]/ɪˈliːt/; [or]z8;
novelty: [n]新奇;新奇的事物;新颖小巧而廉价的小物品; adj. 新奇的;风格独特的; [acc]/ˈnɑːvlti/; [or]z8;
devout: adj. 虔诚的,真挚的,诚恳的; [n]虔诚;真挚,诚恳; [acc]/dɪˈvaʊt/; [or]z8;
galvanize: [v]镀锌,通电,刺激; [acc]/ˈɡælvənaɪz/; [or]z8;
granular: adj. 粒状的,含颗粒的; [acc]/ˈɡrænjələr/; [or]z8;
scavenge: [v](在废物中)寻觅;(动物)食腐肉;打扫;排除废气; [acc]/ˈskævɪndʒ/; [or]z8;
hydraulic: adj. 水力的,水压的; [acc]/haɪˈdrɔːlɪk/; [or]z8;
censorious: adj. 爱挑剔的,吹毛求疵的,严厉批评的; [acc]/senˈsɔːriəs/; [or]z8;
hypnotic: [n]安眠药; adj. 催眠的,令人着迷的; [acc]/hɪpˈnɑːtɪk/; [or]z8;
circumvent: [v]用计避免,规避; [acc]/ˌsɜːrkəmˈvent/; [or]z8;
bawl: [v]大叫,大喊,放声痛哭; [n]叫喊声,叫骂声,号哭; [acc]/bɔːl/; [or]z8;
critique: [n]批评;评论文章; [v]批判,评论;评论; [acc]/krɪˈtiːk/; [or]z8;
diphthong: [n]双元音,元音连字; [acc]/ˈdɪfθɑːŋ/; [or]z8;
decease: [n]死亡; [v]死; [acc]/dɪˈsiːs/; [or]z8;
endemic: adj. 地方性的; [n]地方病; [acc]/enˈdemɪk/; [or]z8;
validate: [v]使.生效,使合法化;证明正确; [acc]/ˈvælɪdeɪt/; [or]z8;
ailing: adj. 生病的,身体不舒服的;体衰的; [acc]/ˈeɪlɪŋ/; [or]z8;
hooligan: [n]流氓,歹徒; [acc]/ˈhuːlɪɡən/; [or]z8;
salvo: [n]齐射,齐鸣,齐声欢呼喝彩,保留条款,遁辞; [v]齐鸣; [acc]/ˈsælvoʊ/; [or]z8;
accredit: [v]授权;信任;委派;归因于; [acc]/əˈkredɪt/; [or]z8;
foolproof: adj. 万无一失的,简单的,肯定成功的; [acc]/ˈfuːlpruːf/; [or]z8;
poach: [v]水煮;小火煮;偷猎;窃取; [acc]/poʊtʃ/; [or]z8;
liquidate: [vt]清理,清算,停业清理;清偿,清理,清算(破产的公司等),变卖,杀戮,废除; [acc]/ˈlɪkwɪdeɪt/; [or]z8;
permissible: adj. 容许的;许可的; [acc]/pərˈmɪsəbl/; [or]z8;
tantrum: [n](孩子气的)脾气发作; [acc]/ˈtæntrəm/; [or]z8;
Utopia: [n]乌托邦(理想中最美好的社会),理想国; [acc]/juːˈtoʊpiə/; [or]z8;
insomnia: [n]失眠; [acc]/ɪnˈsɑːmniə/; [or]z8;
ion: [n]［物］离子; [acc]/ˈaɪən/; [or]z8;
configuration: [n]配置,布局,构造; [acc]/kənˌfɪɡjəˈreɪʃn/; [or]z8;
totter: [n]蹒跚,踉跄; [vi]蹒跚,踉跄,动摇,摇摇欲坠; [acc]/ˈtɑːtər/; [or]z8;
lyric: [n]抒情诗;歌词; adj. (供)吟唱的;抒情的; [acc]/ˈlɪrɪk/; [or]z8;
seethe: [v]沸腾;汹涌;激动; [acc]/siːð/; [or]z8;
compatible: adj. 可和谐共存的;兼容的; [acc]/kəmˈpætəbl/; [or]z8;
inborn: adj. 天生的;先天的; [acc]/ˌɪnˈbɔːrn/; [or]z8;
halo: [n](日月等)晕;神像之光环; [vt]使有晕轮;围以光环; [vi]成晕轮; [acc]/ˈheɪloʊ/; [or]z8;
tensile: adj. 可拉长的,可伸长的,[物]张力的,拉力的; [acc]/ˈtensl/; [or]z8;
drench: [v]使淋透;使湿透; [n]淋透;雨淋;浸渍液;(制革时浸泡熟皮的)脱灰水; [acc]/drentʃ/; [or]z8;
harmonica: [n]口琴; [acc]/hɑːrˈmɑːnɪkə/; [or]z8;
brusque: adj. 唐突的,直率的,无礼的; [acc]/brʌsk/; [or]z8;
puberty: [n]青春期; [acc]/ˈpjuːbərti/; [or]z8;
renunciation: [n]放弃;脱离关系;拒绝承认;抛弃;弃权;出家; [acc]/rɪˌnʌnsiˈeɪʃn/; [or]z8;
gibberish: [n]乱语;快速而不清楚的言语; [acc]/ˈdʒɪbərɪʃ/; [or]z8;
Satanic: adj. 邪恶的,魔鬼的; [acc]/səˈtænɪk/; [or]z8;
plead: [v]恳求,辩护,(不)认罪;提出.为理由; [acc]/pliːd/; [or]z8;
juror: [n]审查委员,陪审员; [acc]/ˈdʒʊrər/; [or]z8;
bountiful: adj. 充足的,慷慨的,丰裕的; [acc]/ˈbaʊntɪfl/; [or]z8;
meander: [n]蜿蜒曲折,迂回曲折的旅程;漫步; [v]迂回曲折;漫步;漫谈; [acc]/miˈændər/; [or]z8;
bridal: adj. 新娘的;婚礼的; [n]婚礼; [acc]/ˈbraɪdl/; [or]z8;
neurosis: [n][心理]神经症,神经衰弱症; [acc]/nʊˈroʊsɪs/; [or]z8;
venerate: [v]崇敬,敬仰; [acc]/ˈvenəreɪt/; [or]z8;
mortality: [n]死亡数,死亡率;必死的命运; [acc]/mɔːrˈtæləti/; [or]z8;
audacious: adj. 大胆的,鲁莽的,大胆创新的; [acc]/ɔːˈdeɪʃəs/; [or]z8;
nudge: [v](用臂肘)轻推(促其注意),鼓动,接近; [n]推动,用肘轻推; [acc]/nʌdʒ/; [or]z8;
hulking: adj. 笨重的; [acc]/ˈhʌlkɪŋ/; [or]z8;
cringe: [vi]畏缩;觉得尴尬不安或难为情; [v]奉承,阿谀; [n]畏缩;奉承; [acc]/krɪndʒ/; [or]z8;
defer: [v]使推迟,使延期;听从,顺从; [vi]延期; [acc]/dɪˈfɜːr/; [or]z8;
glee: [n]欢喜,高兴; [acc]/ɡliː/; [or]z8;
plaster: [n]灰泥,石膏; [v]抹泥; [acc]/ˈplæstər/; [or]z8;
espionage: [n]间谍活动,侦查,监视; [acc]/ˈespiənɑːʒ/; [or]z8;
itinerary: [n]旅程,路线;旅行计划; [acc]/aɪˈtɪnəreri/; [or]z8;
infernal: adj. 地狱的;恶魔的;可憎的; [acc]/ɪnˈfɜːrnl/; [or]z8;
animate: [v]使有生气,使活泼;鼓舞,推动; adj. 有生命的; [acc]/ˈænɪmeɪt/; [or]z8;
knead: [v]揉捏,塑造; [acc]/niːd/; [or]z8;
artifice: [n]诡计;欺骗;巧妙的办法; [acc]/ˈɑːrtɪfɪs/; [or]z8;
hobgoblin: [n]妖怪; [acc]/ˈhɑːbɡɑːblɪn/; [or]z8;
seduce: [v]引诱,诱使,诱惑,勾引;着迷; [acc]/sɪˈduːs/; [or]z8;
unkempt: adj. (衣服,头发)不整洁的;蓬乱的; [acc]/ˌʌnˈkempt/; [or]z8;
formulate: [v]构想出(计划,方法等);系统地阐述; [acc]/ˈfɔːrmjuleɪt/; [or]z8;
incinerate: [v]焚化,毁弃; [acc]/ɪnˈsɪnəreɪt/; [or]z8;
ubiquitous: adj. 普遍存在的;无所不在的; [acc]/juːˈbɪkwɪtəs/; [or]z8;
rivet: [n]铆钉; [v](用铆钉)铆接,敲打(螺栓)使成铆钉头,吸引(注意力); [acc]/ˈrɪvɪt/; [or]z8;
bulk: [n]大批;容量;体积;大块; adj. 大量的;散装的; [v]膨胀;显得重要; [acc]/bʌlk/; [or]z8;
cleave: [v]劈开,分裂; [acc]/kliːv/; [or]z8;
hybrid: [n]杂种,混血儿,混合物; adj. 混合的;杂种的; [acc]/ˈhaɪbrɪd/; [or]z8;
meteorology: [n]气象学; [acc]/ˌmiːtiəˈrɑːlədʒi/; [or]z8;
equable: adj. 温和,平均,稳定的,不变的,(脾气)温和的; [acc]/ˈekwəbl/; [or]z8;
incompatible: adj. 不兼容的,矛盾的,不调和的; [acc]/ˌɪnkəmˈpætəbl/; [or]z8;
cursory: adj. 匆忙的,不注意细节的;草率地;粗略地; [acc]/ˈkɜːrsəri/; [or]z8;
contingent: [n]分遣队; adj. 意外的,视情况条件而定的; [acc]/kənˈtɪndʒənt/; [or]z8;
dishonour: [n]失去名誉;不光彩,耻辱;丢脸的人;无礼; [v]使受耻辱;不遵守;奸污; [acc]/dɪsˈɑːnər/; [or]z8;
mortuary: [n]太平间,停尸间; adj. 死的,悲哀的; [acc]/ˈmɔːrtʃueri/; [or]z8;
vagrant: [n]游民; adj. 漂泊的; [acc]/ˈveɪɡrənt/; [or]z8;
blanch: [v]变白;漂白; [n]铅矿石; adj. 漂白的;银白色的; [acc]/blæntʃ/; [or]z8;
resultant: adj. 作为结果的; [acc]/rɪˈzʌltənt/; [or]z8;
immerse: [v]沉浸,沉浸于;使陷入; [acc]/ɪˈmɜːrs/; [or]z8;
impenetrable: adj. 难以渗透的,坚不可摧的; [acc]/ɪmˈpenɪtrəbl/; [or]z8;
matriculate: [n]被录取者; [v]准许.入学; [acc]/məˈtrɪkjuleɪt/; [or]z8;
vex: [v]使烦恼,使苦恼,使恼怒; [acc]/veks/; [or]z8;
wane: [n]衰退(期);月亏(期);减少; [v](月)缺损;(光,势力,治理等)衰落;减少; [acc]/weɪn/; [or]z8;
arsenal: [n]兵工厂,军械库;储藏; [acc]/ˈɑːrsənl/; [or]z8;
aura: [n](人或物发出的)气味,气氛,先兆; [acc]/ˈɔːrə/; [or]z8;
con: [v]熟读,精读;哄骗; [adv]反对;从反面; prep. 反对;[意大利语][音乐]以; [n]指挥操舵;指挥操舵者的位置;反对(论点); adj. 骗取信任的; [acc]/kɑːn/; [or]z8;
unethical: adj. 不道德的;缺乏职业道德的; [acc]/ʌnˈeθɪkl/; [or]z8;
restitution: [n]归还,赔偿; [acc]/ˌrestɪˈtuːʃn/; [or]z8;
acoustics: [n]声学; [acc]/əˈkuːstɪks/; [or]z8;
nab: [v]逮捕,攫取; [acc]/næb/; [or]z8;
impromptu: adj. 一触即发的;即席的,即兴的; [adv]即席地,即兴地; [n]即兴之作; [acc]/ɪmˈprɑːmptuː/; [or]z8;
deity: [n]上帝,神性; [acc]/ˈdiːəti/; [or]z8;
abstain: [v]戒掉(烟\酒等);避开;弃权; [acc]/əbˈsteɪn/; [or]z8;
exhort: [vt]敦促,劝告; [vi]规劝,劝告; [acc]/ɪɡˈzɔːrt/; [or]z8;
plaintiff: [n]原告; [acc]/ˈpleɪntɪf/; [or]z8;
sip: [v]啜饮; [n]一小口; [acc]/sɪp/; [or]z8;
populous: adj. 人口稠密的,人口众多的; [acc]/ˈpɑːpjələs/; [or]z8;
rejuvenate: [v]使..年轻;使..恢复精神;变年轻; [vi]返老还童,恢复活力,复原; [acc]/rɪˈdʒuːvəneɪt/; [or]z8;
scruple: [n]顾虑,不安; [vi]有顾虑,良心上感到不安; [acc]/ˈskruːpl/; [or]z8;
hovel: [n]茅舍,肮脏的小屋; [acc]/ˈhʌvl/; [or]z8;
remunerate: [v]酬劳;给与报酬;赔偿; [acc]/rɪˈmjuːnəreɪt/; [or]z8;
coax: [v]哄,哄诱; [acc]/koʊks/; [or]z8;
stoppage: [n]停止,故障,罢工; [acc]/ˈstɑːpɪdʒ/; [or]z8;
repercussion: [n]反响;弹回;反射; [acc]/ˌriːpərˈkʌʃn/; [or]z8;
strew: [vt]撒;把.撒在.上;散播,点缀; [acc]/struː/; [or]z8;
diabetes: [n]糖尿病,多尿症; [acc]/ˌdaɪəˈbiːtiːz/; [or]z8;
counterbalance: [n]平衡力;抵销; [v]使平衡;抵消; [acc]/ˌkaʊntərˈbæləns/; [or]z8;
hormone: [n]荷尔蒙,激素; [acc]/ˈhɔːrmoʊn/; [or]z8;
cinder: [n]余烬,矿渣; [acc]/ˈsɪndər/; [or]z8;
trudge: [n]长途跋涉,沉重的步伐; [v]跋涉,吃力地走; [acc]/trʌdʒ/; [or]z8;
obese: adj. 肥胖的;过胖的; [acc]/oʊˈbiːs/; [or]z8;
flawless: adj. 完美的,无瑕疵的; [acc]/ˈflɔːləs/; [or]z8;
ethos: [n]民族精神,气质,社会思潮; [acc]/ˈiːθɑːs/; [or]z8;
repulsive: adj. 排斥的,严拒的,令人厌恶的; [acc]/rɪˈpʌlsɪv/; [or]z8;
amnesia: [n][医学]遗忘症; [acc]/æmˈniːʒə/; [or]z8;
notary: [n]公证人;公证员; [acc]/ˈnoʊtəri/; [or]z8;
introvert: [v]使内翻,使内向,使内省; [n]内向的人,内弯(内翻)的东西; [acc]/ˈɪntrəvɜːrt/; [or]z8;
collate: [v]核对,校对;校勘; [acc]/kəˈleɪt/; [or]z8;
sensual: adj. 感官的;色情的,肉欲的; [acc]/ˈsenʃuəl/; [or]z8;
whiff: [n]一吹,一吸,一阵香气,一点点,香烟的一口; [v]轻轻地吹,喷气,[棒]三击出局; [acc]/wɪf/; [or]z8;
mummy: [n]木乃伊,干瘪的人,妈咪(口语); [acc]/ˈmʌmi/; [or]z8;
denominate: [v]命名,取名; adj. 有说明性名称的; [acc]/dɪˈnɑːmɪneɪt/; [or]z8;
pier: [n]码头;桥墩; [acc]/pɪr/; [or]z8;
chubby: adj. 圆脸的,胖乎乎的; [acc]/ˈtʃʌbi/; [or]z8;
shag: [n]粗毛,粗烟丝,蓬乱一团; [v]使杂乱,使蓬松; adj. 有粗毛的,蓬乱的; [acc]/ʃæɡ/; [or]z8;
coroner: [n]验尸官; [acc]/ˈkɔːrənər/; [or]z8;
entrust: [v]委托,托管; [acc]/ɪnˈtrʌst/; [or]z8;
faucet: [n]龙头,旋塞,(连接管子的)插口; [acc]/ˈfɔːsɪt/; [or]z8;
involuntary: adj. 非自愿的,非出自本意的;无意识的,不自觉的; [acc]/ɪnˈvɑːlənteri/; [or]z8;
gesticulate: [vt]用手势表达,用姿势,表示; [vi](讲话时)做手势; [n]做手势,做示意动作,手势; [acc]/dʒeˈstɪkjuleɪt/; [or]z8;
arthritis: [n][外科]关节炎; [acc]/ɑːrˈθraɪtɪs/; [or]z8;
cornet: [n]短号;圆锥形蛋卷; [acc]/ˈkɔːrnɪt/; [or]z8;
periphery: [n]外围,不重要的部份; [acc]/pəˈrɪfəri/; [or]z8;
sidestep: [n](侧面)台阶;拳击等横跨一步躲避打击;［喻］回避(困难); [v]回避;横跨一步躲避; [acc]/ˈsaɪdstep/; [or]z8;
dissonance: [n]不一致;不调和;不和谐音; [acc]/ˈdɪsənəns/; [or]z8;
swoop: [v]攫取,飞扑,突然袭击; [n]突然下降,猛扑; [acc]/swuːp/; [or]z8;
bout: [n]一回合,较量,一阵; [acc]/baʊt/; [or]z8;
tinge: [n]淡淡的(颜色,神色),轻微,少量; [v]给.染色,轻微地影响; [acc]/tɪndʒ/; [or]z8;
decorous: adj. 端庄稳重的,正派得体的,有礼貌的,高雅的; [acc]/ˈdekərəs/; [or]z8;
chromosome: [n]染色体; [acc]/ˈkroʊməsoʊm/; [or]z8;
domain: [n]域名;领土;管区,势力圈; [acc]/doʊˈmeɪn/; [or]z8;
reassure: [v]使放心,使消除疑虑; [acc]/ˌriːəˈʃʊr/; [or]z8;
flout: [n]表示轻蔑的言行;嘲弄;嘲笑; [vi]藐视;嘲弄;嘲笑; [vt]嘲弄;嘲笑;藐视; [acc]/flaʊt/; [or]z8;
aggravate: [v]使恶化,加重;使气恼,激怒; [acc]/ˈæɡrəveɪt/; [or]z8;
disavow: [v]不承认,抵赖,拒绝对..承担责任; [acc]/ˌdɪsəˈvaʊ/; [or]z8;
preoccupied: adj. 全神贯注的,心事重重的,被先占的; [acc]/priˈɑːkjupaɪd/; [or]z8;
squall: [n](通常伴随着雨或雪的)风暴,暴风雪; [v]尖叫; [acc]/skwɔːl/; [or]z8;
schizophrenia: [n][内科]精神分裂症; [acc]/ˌskɪtsəˈfriːniə/; [or]z8;
complexion: [n]肤色;特性; [acc]/kəmˈplekʃn/; [or]z8;
nominee: [n]被任命者,被提名的人,代名人; [acc]/ˌnɑːmɪˈniː/; [or]z8;
onset: [n]开始;攻击,袭击; [acc]/ˈɑːnset/; [or]z8;
rake: [n]耙子,耙机; [v]耙;搜索,探索; [acc]/reɪk/; [or]z8;
rendezvous: [n]集会,幽会,约会地点; [v]约会,幽会,(秘密)集会; [acc]/ˈrɑːndɪvuː/; [or]z8;
assiduous: adj. 勤勉的,刻苦的; [acc]/əˈsɪdʒuəs/; [or]z8;
piston: [n]活塞,瓣; [acc]/ˈpɪstən/; [or]z8;
edict: [n]法令,布告; [acc]/ˈiːdɪkt/; [or]z8;
paradigm: [n]范例,示范; [acc]/ˈpærədaɪm/; [or]z8;
badger: [n]獾;獾皮毛; [v]纠缠;烦扰(反复提提出问题或要求); [acc]/ˈbædʒər/; [or]z8;
mainstay: [n]支柱,中流砥柱,主要的依靠,主桅支索; [acc]/ˈmeɪnsteɪ/; [or]z8;
boutique: [n]专卖流行衣服的小商店; adj. (商店)精品的; [acc]/buːˈtiːk/; [or]z8;
devolve: [v]被移交;转让;移交;使滚下;衰落; [acc]/dɪˈvɑːlv/; [or]z8;
delve: [v]钻研;探究;挖; [n]穴;洞; [acc]/delv/; [or]z8;
bemused: adj. 困惑的,发呆的; [acc]/bɪˈmjuːzd/; [or]z8;
insurrection: [n]造反,叛乱; [acc]/ˌɪnsəˈrekʃn/; [or]z8;
parole: [n]特别口令;假释; [v]有条件释放,假释;使假释出狱;宣誓后释放; adj. 假释的; [acc]/pəˈroʊl/; [or]z8;
magnate: [n]大人物;大亨,巨头;权贵; [acc]/ˈmæɡneɪt/; [or]z8;
sabre: [n]军刀,击剑用刀; [acc]/ˈseɪbər/; [or]z8;
calamity: [n]大灾祸,不幸之事; [acc]/kəˈlæməti/; [or]z8;
deodorant: adj. 除臭的;防臭的; [n]除臭剂; [acc]/diˈoʊdərənt/; [or]z8;
loll: [vi]懒洋洋地倚靠;闲荡; [vt]懒洋洋地倚靠着;使悬垂; [acc]/lɑːl/; [or]z8;
monolingual: [n]只用一种语言的人; adj. 单语的,仅用一种语言的; [acc]/ˌmɑːnəˈlɪŋɡwəl/; [or]z8;
amphibious: adj. 两栖的; [acc]/æmˈfɪbiəs/; [or]z8;
pedigree: [n]血统,家谱;出身,门第;(纯种家畜的)血统表;纯种;(语言的)起源; [acc]/ˈpedɪɡriː/; [or]z8;
blackout: [n]断电; adj. 防空袭的; [acc]/ˈblækaʊt/; [or]z8;
anew: [adv]重新,再; [acc]/əˈnuː/; [or]z8;
gastric: adj. 胃的,胃部的; [acc]/ˈɡæstrɪk/; [or]z8;
automate: [v]使自动化,自动操作; [acc]/ˈɔːtəmeɪt/; [or]z8;
havoc: [n](天灾,战争等造成的)大破坏,大毁灭; [vi]损毁; [vt]严重破坏; [acc]/ˈhævək/; [or]z8;
din: [n]喧闹声,嘈杂声; [v]喧闹,喋喋不休地说; [acc]/dɪn/; [or]z8;
livid: adj. 气急败坏的,铅色的; [acc]/ˈlɪvɪd/; [or]z8;
remit: [v]汇款,汇寄,饶恕,免除; [n]职权范围,职责; [acc]/ˈriːmɪt/; [or]z8;
pharmaceutical: adj. 制药的,药物的; [n]药物; [acc]/ˌfɑːrməˈsuːtɪkl/; [or]z8;
palate: [n]味觉;上颚;趣味; [acc]/ˈpælət/; [or]z8;
scoff: [vi]讥笑; [v]嘲笑; [n]愚弄; [acc]/skɔːf/; [or]z8;
bastion: [n]堡垒;棱堡; [acc]/ˈbæstiən/; [or]z8;
manoeuvre: [n]谨慎或熟练的动作;花招,巧计;(军队)调遣,演习; [acc]/məˈnuːvər/; [or]z8;
pendant: [n]吊坠,下垂物; [acc]/ˈpendənt/; [or]z8;
impediment: [n]妨碍,阻碍;障碍物;(言语)障碍;口吃; [acc]/ɪmˈpedɪmənt/; [or]z8;
succulent: [n]肉质植物; adj. 多汁鲜美的;丰富多彩的; [acc]/ˈsʌkjələnt/; [or]z8;
hereditary: adj. 世袭的,遗传的; [acc]/həˈredɪteri/; [or]z8;
ravine: [n]山涧,小峡谷; [acc]/rəˈviːn/; [or]z8;
solace: [n]慰藉,给予安慰的人或事物; [v]安慰,缓和,使开心; [acc]/ˈsɑːləs/; [or]z8;
sedan: [n]轿子,轿车,单舱汽艇; [acc]/sɪˈdæn/; [or]z8;
closure: [n]关闭,终止,结束; [acc]/ˈkloʊʒər/; [or]z8;
foreshadow: [v]预示; [n]预兆; [acc]/fɔːrˈʃædoʊ/; [or]z8;
postscript: [n]附言;后评; [acc]/ˈpoʊstskrɪpt/; [or]z8;
misplace: [v]放错地方; [acc]/ˌmɪsˈpleɪs/; [or]z8;
matrix: [n][数]矩阵,模子; [acc]/ˈmeɪtrɪks/; [or]z8;
sentry: [n]哨兵,警卫; [vi]站岗,放哨; [vt]设岗哨; [acc]/ˈsentri/; [or]z8;
wreckage: [n]残骸;失事;破坏; [acc]/ˈrekɪdʒ/; [or]z8;
lopsided: adj. 不平衡的,倾向一方的; [acc]/ˌlɑːpˈsaɪdɪd/; [or]z8;
supple: adj. 柔软的;柔顺的; [acc]/ˈsʌpl/; [or]z8;
wicked: adj. 邪恶的,恶毒的;淘气的,恶作剧的; [n]恶人;邪恶的人; [adv]用作加强语气用; [acc]/ˈwɪkɪd/; [or]z8;
falsehood: [n]谬误,不真实,谎言,虚假; [acc]/ˈfɔːlshʊd/; [or]z8;
stealth: [n]隐秘,秘密; [acc]/stelθ/; [or]z8;
kennel: [n]狗窝;一群狗;阴沟; [v]使住在狗窝,进狗窝; [acc]/ˈkenl/; [or]z8;
propel: [v]推进,推动,激励; [acc]/prəˈpel/; [or]z8;
nurture: [v]养育,培育;培植; [n]养育,培养;教养;营养物; [acc]/ˈnɜːrtʃər/; [or]z8;
blizzard: [n]暴风雪; [acc]/ˈblɪzərd/; [or]z8;
gospel: [n]教义,信条;福音书; adj. 传播福音的;福音赞美诗的; [acc]/ˈɡɑːspl/; [or]z8;
spleen: [n]脾,脾气,怒气; [acc]/spliːn/; [or]z8;
interminable: adj. 没完没了的,无穷无尽的,冗长的; [acc]/ɪnˈtɜːrmɪnəbl/; [or]z8;
parson: [n]教区牧师; [acc]/ˈpɑːrsn/; [or]z8;
censorship: [n]审查制度;审查机构; [acc]/ˈsensərʃɪp/; [or]z8;
inflammation: [n][病理]炎症,[医]发炎,燃烧,发火; [acc]/ˌɪnfləˈmeɪʃn/; [or]z8;
incarnation: [n]赋与肉体,具人形,化身; [acc]/ˌɪnkɑːrˈneɪʃn/; [or]z8;
untenable: adj. 防守不住的,站不住脚的; [acc]/ʌnˈtenəbl/; [or]z8;
footloose: adj. 自由自在的,无拘束的,到处走动的; [acc]/ˈfʊtluːs/; [or]z8;
exuberant: adj. (植物)茂盛的,(人)充满活力的; [acc]/ɪɡˈzuːbərənt/; [or]z8;
aggregate: [n]合计;总数;混凝料;总计; [v]集合;聚集;合计; adj. 总的,总数的;集合的; [acc]/ˈæɡrɪɡət/; [or]z8;
quartz: [n]石英; [acc]/kwɔːrts/; [or]z8;
rampant: adj. 猖獗的,蔓生的; [acc]/ˈræmpənt/; [or]z8;
absentee: [n]缺席者; adj. 缺席者的;在外地主的,在外业主的; [acc]/ˌæbsənˈtiː/; [or]z8;
flicker: [v]闪烁,摇曳;颤动;扑动翅膀;假装昏倒; [n]闪烁,闪光; [acc]/ˈflɪkər/; [or]z8;
hefty: adj. 重的,肌肉发达的,异常大的; [adv]强有力地,非常; [n]体格健壮的人; [acc]/ˈhefti/; [or]z8;
hatchery: [n]孵卵处,孵化场; [acc]/ˈhætʃəri/; [or]z8;
canoe: [n]独木舟,轻舟; [v]乘独木舟; [acc]/kəˈnuː/; [or]z8;
decadent: adj. 颓废的;衰退的; [acc]/ˈdekədənt/; [or]z8;
prevalent: adj. 普遍的,流行的; [acc]/ˈprevələnt/; [or]z8;
insatiable: adj. 不能满足的,贪得无厌的; [acc]/ɪnˈseɪʃəbl/; [or]z8;
soprano: [n]女高音,女高音歌手,女高音声部; adj. 女高音的,童声高音的,女高音声部的; [acc]/səˈprɑːnoʊ/; [or]z8;
coop: [v]把.关进笼子里;限制;拘禁; [n]鸡笼;小屋;捕鱼篓; [acc]/kuːp/; [or]z8;
pacify: [v]使平静,安慰,抚慰; [acc]/ˈpæsɪfaɪ/; [or]z8;
inordinate: adj. 过度的,无节制的;紊乱的; [acc]/ɪnˈɔːrdɪnət/; [or]z8;
exult: [v]狂喜,欢欣鼓舞; [acc]/ɪɡˈzʌlt/; [or]z8;
wily: adj. 狡猾的; [acc]/ˈwaɪli/; [or]z8;
glean: [v]收集(资料); [acc]/ɡliːn/; [or]z8;
bulky: adj. 体积大的,庞大的;笨重的; [acc]/ˈbʌlki/; [or]z8;
courtship: [n]求爱,求爱时期,交往期间; [acc]/ˈkɔːrtʃɪp/; [or]z8;
monotony: [n]单调乏味,无聊;无变化; [acc]/məˈnɑːtəni/; [or]z8;
obituary: [n]讣告; adj. 关于死者的,讣告的; [acc]/oʊˈbɪtʃueri/; [or]z8;
lenient: adj. 宽大的,宽容的,仁慈的; [acc]/ˈliːniənt/; [or]z8;
invincible: adj. 无敌的;不能征服的; [acc]/ɪnˈvɪnsəbl/; [or]z8;
wilt: [v]使.凋谢,枯萎; [n]枯萎;憔悴; [acc]/wɪlt/; [or]z8;
maze: [n]曲径,迷宫,迷津,迷惘,迷惑,糊涂; [v]使迷惘,使混乱,迷失; [acc]/meɪz/; [or]z8;
fracture: [n]骨折;折断;裂口; [v]使折断;使骨折; [acc]/ˈfræktʃər/; [or]z8;
hotbed: [n]温床,滋长地; [acc]/ˈhɑːtbed/; [or]z8;
countenance: [n]面容,表情,气色; [v]支持,赞成; [acc]/ˈkaʊntənəns/; [or]z8;
mare: [n]母马; [acc]/mer/; [or]z8;
lookout: [n]眺望台;守望,看守,警戒,守望者,看守者; [acc]/ˈlʊkaʊt/; [or]z8;
gnarled: adj. 多节的,粗糙的;多瘤的;弯曲的; [acc]/nɑːrld/; [or]z8;
ointment: [n]药膏,[药]油膏; [acc]/ˈɔɪntmənt/; [or]z8;
allegiance: [n]忠诚,拥护; [acc]/əˈliːdʒəns/; [or]z8;
concord: [n]和睦,公约; [acc]/ˈkɑːŋkɔːrd/; [or]z8;
antiseptic: [n]杀菌剂; adj. 防腐的,抗菌的; [acc]/ˌæntiˈseptɪk/; [or]z8;
antipathy: [n]反感,厌恶,憎恶; [acc]/ænˈtɪpəθi/; [or]z8;
embellish: [vt]装饰; [v]吹嘘;润色(文章); [vi]装饰起来;加以润色;添加细节,对...添枝加叶; [acc]/ɪmˈbelɪʃ/; [or]z8;
snivel: [v]流鼻涕;啜泣; [acc]/ˈsnɪvl/; [or]z8;
inflection: [n]弯曲,变形,音调变化; [acc]/ɪnˈflekʃn/; [or]z8;
freelance: [adv]作为自由职业者地; adj. 自由投稿的; [vi]当自由职业者; [acc]/ˈfriːlæns/; [or]z8;
gaiety: [n]欢乐,快活,庆祝活动,(服饰)华丽,艳丽; [acc]/ˈɡeɪəti/; [or]z8;
scrub: [v]用力擦洗;宣布中止; [n]灌木丛;擦洗; [acc]/skrʌb/; [or]z8;
directive: [n]指示,指令; adj. 指导的,管理的;方向的; [acc]/dəˈrektɪv/; [or]z8;
emanate: [v]发出;放射; [acc]/ˈeməneɪt/; [or]z8;
profiteer: [n]奸商,牟取暴利者; [acc]/ˌprɑːfəˈtɪr/; [or]z8;
autocratic: adj. 独裁的,专断的; [acc]/ˌɔːtəˈkrætɪk/; [or]z8;
measles: [n][医]麻疹; [acc]/ˈmiːzlz/; [or]z8;
treacherous: adj. 不牢靠的,危险的;奸诈的,叛逆的,背叛的; [adv]背信弃义地; [n]背信弃义,背叛; [acc]/ˈtretʃərəs/; [or]z8;
extradite: [v]引渡,获取.的引渡; [acc]/ˈekstrədaɪt/; [or]z8;
afflict: [v]使痛苦;使苦恼; [acc]/əˈflɪkt/; [or]z8;
tutelage: [n]监护,指导; [acc]/ˈtuːtəlɪdʒ/; [or]z8;
preschool: adj. 未满学龄的,就学前的,入学前的; [n]幼儿园,育幼院; [acc]/ˈpriːskuːl/; [or]z8;
sag: [v]下跌,下垂,消沉; [n]下垂,下陷,物价下跌; [acc]/sæɡ/; [or]z8;
arbitrate: [v]仲裁,公断; [acc]/ˈɑːrbɪtreɪt/; [or]z8;
reminiscent: adj. 怀旧的,回忆的,喜谈往事的,暗示..的,提醒的,使人联想..的; [acc]/ˌremɪˈnɪsnt/; [or]z8;
swirl: [n]漩涡;打旋;涡状形; [v]盘绕;打旋;眩晕;大口喝酒; [acc]/swɜːrl/; [or]z8;
stark: adj. 完全的,明显的,荒凉的; [adv]完全,明显地; [acc]/stɑːrk/; [or]z8;
excavate: [v]挖掘,挖出;挖(空),挖(洞); [acc]/ˈekskəveɪt/; [or]z8;
juggle: [v]玩杂耍;同时做;对.巧妙应付; [acc]/ˈdʒʌɡl/; [or]z8;
sparingly: [adv]节俭地,有节制地; [acc]/ˈsperɪŋli/; [or]z8;
conflate: [v]合并; [acc]/kənˈfleɪt/; [or]z8;
amiable: adj. 和蔼的,亲切的;温和的; [acc]/ˈeɪmiəbl/; [or]z8;
bash: [v]猛击,痛击;怒殴; [n]猛烈的一击,痛击; [acc]/bæʃ/; [or]z8;
allergic: adj. 过敏的,对.讨厌的; [acc]/əˈlɜːrdʒɪk/; [or]z8;
foul: adj. 难闻的,发臭的;糟透了的;污秽的;犯规的; [n]犯规; [vi]犯规; [vt]弄脏,使污秽;使纠缠; [acc]/faʊl/; [or]z8;
boisterous: adj. 喧闹的,欢闹的; [acc]/ˈbɔɪstərəs/; [or]z8;
woo: [v]向(女人)求爱,争取.的支持,追求; [acc]/wuː/; [or]z8;
heed: [vt]注意;留心; [v]注意; [vi]留心; [n]注意;留心; [acc]/hiːd/; [or]z8;
forlorn: adj. 被遗弃的; [acc]/fərˈlɔːrn/; [or]z8;
silt: [n]淤泥,淤沙; [v]淤塞; [acc]/sɪlt/; [or]z8;
indict: [v]控诉,起诉; [acc]/ɪnˈdaɪt/; [or]z8;
downstream: [adv]下游地; adj. 下游的; [n]下行;顺流;〔体〕顺水;下游侧; [acc]/ˌdaʊnˈstriːm/; [or]z8;
sprint: [v]疾跑,冲刺; [n]全速奔跑; [acc]/sprɪnt/; [or]z8;
mammoth: [n]长毛象,猛犸象,庞然大物; adj. 巨大的,庞大的,猛犸似的; [acc]/ˈmæməθ/; [or]z8;
horseshoe: [n]马蹄铁,U形物; [vt]装蹄铁于; [acc]/ˈhɔːrʃʃuː/; [or]z8;
dossier: [n]档案,卷宗;病历表册; [acc]/ˈdɔːsieɪ/; [or]z8;
ceremonious: adj. 隆重的;讲究仪式的;正式的; [acc]/ˌserəˈmoʊniəs/; [or]z8;
ruddy: adj. 红的,红润的; [adv]极度,非常; [vt]使变红; [acc]/ˈrʌdi/; [or]z8;
gibbon: [n]长臂猿; [acc]/ˈɡɪbən/; [or]z8;
electrode: [n]电极; [acc]/ɪˈlektroʊd/; [or]z8;
lateral: [n]侧面部分;支线; adj. 侧面的;横向的; [acc]/ˈlætərəl/; [or]z8;
rein: [n]缰绳; [v]控制; [acc]/reɪn/; [or]z8;
macho: adj. 大男子气概的;大男人的; [n]男子汉; [acc]/ˈmɑːtʃoʊ/; [or]z8;
hanger: [n]衣架,挂衣钩; [acc]/ˈhæŋər/; [or]z8;
sod: [n]草地,草皮; [v]铺上草皮,以生草土覆盖,铺草皮于; int. 该死的,该死的; [acc]/sɑːd/; [or]z8;
impassive: adj. 无动于衷的,冷漠的; [acc]/ɪmˈpæsɪv/; [or]z8;
inkling: [n]轻微暗示,小提示,略知; [acc]/ˈɪŋklɪŋ/; [or]z8;
palpable: adj. 明显的,易觉察的,可触知的; [acc]/ˈpælpəbl/; [or]z8;
tangent: [n]切线; adj. 无关的; [acc]/ˈtændʒənt/; [or]z8;
irritant: adj. 刺激的,刺激性的; [n][医]刺激物,刺激剂; [acc]/ˈɪrɪtənt/; [or]z8;
hamlet: [n]小村庄;哈姆雷特; [acc]/ˈhæmlət/; [or]z8;
vermin: [n]害虫,寄生虫; [acc]/ˈvɜːrmɪn/; [or]z8;
imprudent: adj. 轻率的,鲁莽的; [acc]/ɪmˈpruːdnt/; [or]z8;
meteor: [n]流星,大气现象; [acc]/ˈmiːtiər/; [or]z8;
desiccate: [v](使)完全干涸,脱水; [acc]/'desɪˌkeɪt/; [or]z8;
benevolent: adj. 慈爱的,仁慈的;乐善好施的;慈善的; [acc]/bəˈnevələnt/; [or]z8;
coexist: [v]共存;和平共处; [acc]/ˌkoʊɪɡˈzɪst/; [or]z8;
ruffle: [vt]弄皱;使生气,扰乱;连续地轻敲;使起波浪; [n]皱纹;生气;混乱; [vi]起皱;愤怒; [acc]/ˈrʌfl/; [or]z8;
cajole: [v]以甜言蜜语哄骗,勾引; [acc]/kəˈdʒoʊl/; [or]z8;
ledger: [n]账簿;总账;(手脚架上的)横木;[会计]分类账; [acc]/ˈledʒər/; [or]z8;
engender: [v]产生; [acc]/ɪnˈdʒendər/; [or]z8;
tyrannical: adj. 暴君的,专制的,残酷的; [acc]/tɪˈrænɪkl/; [or]z8;
surreptitious: adj. 鬼鬼祟祟的,暗中的,秘密的; [acc]/ˌsɜːrəpˈtɪʃəs/; [or]z8;
sash: [n]饰带,肩带,腰带; [v]用饰带装饰;给.系上腰带[饰带];在.上装吊窗;给.装上窗格; [acc]/sæʃ/; [or]z8;
grievance: [n]牢骚,委屈,抱怨; [acc]/ˈɡriːvəns/; [or]z8;
reshuffle: [v]再洗牌,改组,重新安排; [n]改组;重新洗牌; [acc]/ˈriːʃʌfl/; [or]z8;
allusion: [n]暗示;提及; [acc]/əˈluːʒn/; [or]z8;
delude: [v]欺骗,哄骗; [acc]/dɪˈluːd/; [or]z8;
lousy: adj. 蹩脚的,糟糕的,不清洁的; [acc]/ˈlaʊzi/; [or]z8;
lurk: [n]潜伏,潜行; [vi]潜伏;潜藏;鬼鬼祟祟地走; [acc]/lɜːrk/; [or]z8;
segregation: [n]分离,隔离,种族隔离; [acc]/ˌseɡrɪˈɡeɪʃn/; [or]z8;
sardonic: adj. 讽刺的,嘲笑的; [acc]/sɑːrˈdɑːnɪk/; [or]z8;
gratuitous: adj. 无根据的,无理由的,无报酬的,免费的,多余的; [acc]/ɡrəˈtuːɪtəs/; [or]z8;
gill: [n]鳃,菌褶; [vi]被刺网缠住; [vt]用刺网捕,取出(鱼的)鳃和内脏; [acc]/ɡɪl/; [or]z8;
incisive: adj. 一针见血的,敏锐的; [acc]/ɪnˈsaɪsɪv/; [or]z8;
derogatory: adj. 不敬的,诽谤的; [acc]/dɪˈrɑːɡətɔːri/; [or]z8;
intuitive: adj. 直觉的,凭直觉获知的; [acc]/ɪnˈtuːɪtɪv/; [or]z8;
norm: [n]准则;模范;规范,标准; [acc]/nɔːrm/; [or]z8;
heretic: [n]异教徒,持异端者; adj. 异端的,异教的; [acc]/ˈherətɪk/; [or]z8;
expurgate: [v]净化,删去; [acc]/ˈekspərɡeɪt/; [or]z8;
communicable: adj. 可传达的,会传染的,爱说话的; [acc]/kəˈmjuːnɪkəbl/; [or]z8;
theorem: [n][数]定理,法则; [acc]/ˈθiːərəm/; [or]z8;
anonymity: [n]匿名,作者不明(或不详),无名之辈; [acc]/ˌænəˈnɪməti/; [or]z8;
remnant: [n]遗迹;边角剩料; [acc]/ˈremnənt/; [or]z8;
zest: [n]兴趣,乐趣;滋味,风味; [v]给.调味; [acc]/zest/; [or]z8;
revamp: [v]翻新,整修,升级; [n]改进,换新鞋面; [acc]/ˈriːvæmp/; [or]z8;
deform: [v](使)变形; adj. 畸形的;丑陋的; [acc]/dɪˈfɔːrm/; [or]z8;
vial: [n]小瓶,药水瓶; [v]装入小瓶; [acc]/ˈvaɪəl/; [or]z8;
repository: [n]储藏室;仓库;智囊人物;知识库; [acc]/rɪˈpɑːzətɔːri/; [or]z8;
withstand: [v]忍受;抵挡; [acc]/wɪðˈstænd/; [or]z8;
advocacy: [n]主张;拥护;辩护; [acc]/ˈædvəkəsi/; [or]z8;
abide: [v]遵守;忍受;居住; [acc]/əˈbaɪd/; [or]z8;
regress: [v]后退,退化,恶化; [n]回归;退回; [acc]/rɪˈɡres/; [or]z8;
anthology: [n](诗,文,曲,画等的)选集; [acc]/ænˈθɑːlədʒi/; [or]z8;
scalpel: [n]外科手术刀,解剖刀; [acc]/ˈskælpəl/; [or]z8;
holster: [n]手枪皮套; [acc]/ˈhoʊlstər/; [or]z8;
skinny: adj. 瘦削的,皮包骨的;皮状的,皮质的〈俚〉吝啬的; [n](不公开的)信息,内幕消息; [acc]/ˈskɪni/; [or]z8;
mitten: [n]连指手套; [acc]/ˈmɪtn/; [or]z8;
electrify: [v]通电;使触电;使激动;使震惊; [acc]/ɪˈlektrɪfaɪ/; [or]z8;
woe: [n]悲哀;痛苦; int. 唉(表示痛苦,悲伤或悔恨);咳; [acc]/woʊ/; [or]z8;
hale: adj. 矍铄的(尤指老人);强壮的; [adv]完全地; [v]迫使;猛拉;不断流出; [acc]/heɪl/; [or]z8;
synonymous: adj. 同义的;同义词的;同义突变的; [acc]/sɪˈnɑːnɪməs/; [or]z8;
migraine: [n]［法］［医］周期性偏头痛; [acc]/ˈmaɪɡreɪn/; [or]z8;
exodus: [n]大批离去,成群外出; [acc]/ˈeksədəs/; [or]z8;
carnage: [n]大屠杀,残杀,大量绝灭; [acc]/ˈkɑːrnɪdʒ/; [or]z8;
dispensable: adj. 不必要的,可有可无的; [acc]/dɪˈspensəbl/; [or]z8;
slavish: adj. 照搬的,刻板模仿的;盲从的; [acc]/ˈsleɪvɪʃ/; [or]z8;
expedient: [n]权宜之计,手段; adj. 有利的,方便的;权宜之计的; [acc]/ɪkˈspiːdiənt/; [or]z8;
archer: [n]弓箭手; [acc]/ˈɑːrtʃər/; [or]z8;
grove: [n]小树林;果园; [acc]/ɡroʊv/; [or]z8;
mantle: [n]外壳;披风;地幔; [v]覆盖; [acc]/ˈmæntl/; [or]z8;
fortuitous: adj. 偶然的;幸运的; [acc]/fɔːrˈtuːɪtəs/; [or]z8;
velocity: [n]速度;迅速,快速; [acc]/vəˈlɑːsəti/; [or]z8;
lapse: [n]失误,过失;行为失检;(时间)流逝; [v]退步,倒退,衰退;失效;背弃,放弃(宗教信仰); [acc]/læps/; [or]z8;
advent: [n]来临;到来;出现; [acc]/ˈædvent/; [or]z8;
quip: [n]妙语,嘲弄,讽刺语; [v]嘲弄,讥讽; [acc]/kwɪp/; [or]z8;
flex: [v]弯曲;伸缩;屈曲;(使)收缩; [n]花线;弯曲;弹性;电线;松紧带; adj. 弹性工作制的; [acc]/fleks/; [or]z8;
grovel: [v]摇尾乞怜;奴颜婢膝;匍匐; [acc]/ˈɡrɑːvl/; [or]z8;
euphoria: [n]幸福愉快感; [acc]/juːˈfɔːriə/; [or]z8;
reprimand: [n](特指当权者进行的)严责,谴责,申斥; [v]申斥,谴责,惩戒; [acc]/ˈreprɪmænd/; [or]z8;
nasal: adj. 鼻的,鼻音的; [n]鼻骨,鼻音,鼻音字; [acc]/ˈneɪzl/; [or]z8;
certify: [v](发给证书)证明;证实; [acc]/ˈsɜːrtɪfaɪ/; [or]z8;
fumble: [v]摸索,笨拙地做,漏球; [n]摸索,笨拙的处理,漏球; adj. 笨拙的;迟疑的; [acc]/ˈfʌmbl/; [or]z8;
fresco: [n]壁画;壁画法; [v]在..上做壁画;用壁画法画出; [acc]/ˈfreskoʊ/; [or]z8;
partisan: adj. 党派的;效忠的;偏袒的;盲目推崇的; [n]党羽;虔诚信徒;游击队; [acc]/ˈpɑːrtəzn/; [or]z8;
jumbo: adj. 巨大的,特大的; [n]体大而笨拙的人或物;大型喷气式客机;庞然大物; [acc]/ˈdʒʌmboʊ/; [or]z8;
infrastructure: [n]基础设施; [acc]/ˈɪnfrəstrʌktʃər/; [or]z8;
decor: [n]装饰,布置; [acc]/deɪˈkɔːr/; [or]z8;
yummy: adj. 美味的,好吃的; [acc]/ˈjʌmi/; [or]z8;
epitome: [n]摘要,缩影; [acc]/ɪˈpɪtəmi/; [or]z8;
fatuous: adj. 愚昧而不自知的; [acc]/ˈfætʃuəs/; [or]z8;
methodical: adj. 有系统的,有方法的; [acc]/məˈθɑːdɪkl/; [or]z8;
align: [vi]排队,排成一行; [vt]使成一直线; [acc]/əˈlaɪn/; [or]z8;
arson: [n][法律]纵火,纵火罪; [acc]/ˈɑːrsn/; [or]z8;
pawn: [n]典当;抵押物;兵,卒;人质; [v]当掉;以..担保; [acc]/pɔːn/; [or]z8;
insidious: adj. (暗中或逐渐)为害的; [acc]/ɪnˈsɪdiəs/; [or]z8;
uncanny: adj. 神秘的,不可思议的; [acc]/ʌnˈkæni/; [or]z8;
impostor: [n]骗子;冒充者; [acc]/ɪmˈpɑːstər/; [or]z8;
roost: [n]鸟窝,巢穴,栖木; [vi]栖息; [acc]/ruːst/; [or]z8;
dandy: [n]花花公子; adj. 服装华丽的,极好的,上等的; [acc]/ˈdændi/; [or]z8;
sensuous: adj. 感觉上的,依感观的,诉诸美感的; [acc]/ˈsenʃuəs/; [or]z8;
hangover: [n]宿醉; [acc]/ˈhæŋoʊvər/; [or]z8;
pastel: [n]柔和的色彩,彩色粉笔画;粉蜡笔; adj. 柔和的;彩色蜡笔的,粉蜡笔的; [acc]/pæˈstel/; [or]z8;
upmarket: adj. 质优价高的;高级的; [adv]在高档之列; [n]高档商品; [v]使进入高消费者市场; [acc]/ˌʌpˈmɑːrkɪt/; [or]z8;
reversion: [n]逆转,回复,归还,[遗]隔代遗传,[法]继承权; [acc]/rɪˈvɜːrʒn/; [or]z8;
carnation: [n]康乃馨,粉红色; adj. 淡红色的;肉色的; [acc]/kɑːrˈneɪʃn/; [or]z8;
opaque: adj. 不透明的;难懂的; [acc]/oʊˈpeɪk/; [or]z8;
patriarch: [n]家长;族长;创办人;最年长者; [acc]/ˈpeɪtriɑːrk/; [or]z8;
alimony: [n](法)赡养费,生活费; [acc]/ˈælɪmoʊni/; [or]z8;
sallow: adj. 病黄色的,气色不好的; [n]黄华柳;山毛柳;黄华柳细枝;黄华柳木; [acc]/ˈsæloʊ/; [or]z8;
favoritism: [n]偏爱,偏袒; [acc]/'feɪvərɪtˌɪzəm/; [or]z8;
fender: [n]火炉围栏;挡泥板,防护板;(汽车的)保险杠; [acc]/ˈfendər/; [or]z8;
embed: [v]把.嵌入;使嵌入; [acc]/ɪmˈbed/; [or]z8;
orgy: [n]狂欢;放荡; [acc]/ˈɔːrdʒi/; [or]z8;
rummage: [n]杂物,翻寻; [v]彻底搜查,翻箱倒柜; [acc]/ˈrʌmɪdʒ/; [or]z8;
tarry: [n]逗留,短期滞在; [v]耽搁,踌躇(等待),拖延; adj. 柏油的,涂柏油的; [acc]/ˈtæri/; [or]z8;
infatuated: adj. 入迷的,昏头昏脑的; [acc]/ɪnˈfætʃueɪtɪd/; [or]z8;
knack: [n]诀窍;本领;熟练技术;巧妙手法; [acc]/næk/; [or]z8;
earthenware: [n][总称]陶器; adj. 陶制的; [acc]/ˈɜːrθnwer/; [or]z8;
hull: [n](果实等的)外壳,船体; [v]剥壳; [acc]/hʌl/; [or]z8;
intermittent: adj. 断断续续的,间歇的; [acc]/ˌɪntərˈmɪtənt/; [or]z8;
hypotenuse: [n](直角三角形的)斜边; [acc]/haɪˈpɑːtənuːs/; [or]z8;
conjure: [v]变魔术;使...变戏法般地出现(或消失);使想起;使...呈现于脑际;(a name to conjure with)大名鼎鼎的人;影响巨大的事物;恳求; [acc]/ˈkʌndʒər/; [or]z8;
archaic: adj. 古代的;陈旧的,过时的,老式的;已不通用的; [acc]/ɑːrˈkeɪɪk/; [or]z8;
upheaval: [n]动乱,大变动; [acc]/ʌpˈhiːvl/; [or]z8;
pike: [n]矛,长枪,梭子鱼; [vt]用矛刺穿; [acc]/paɪk/; [or]z8;
rationale: [n]基本原理;原理的阐述; [acc]/ˌræʃəˈnæl/; [or]z8;
insular: adj. 岛屿的,与世隔绝的; [acc]/ˈɪnsələr/; [or]z8;
burrow: [n]洞穴,地道;藏身处,住处; [v]挖;钻进;搜寻; [vt]掩蔽; [acc]/ˈbɜːroʊ/; [or]z8;
incubator: [n]孵卵器,保温箱,早产儿保育器,细菌培养器; [acc]/ˈɪŋkjubeɪtər/; [or]z8;
contraceptive: adj. 避孕的; [n]避孕品,避孕用具; [acc]/ˌkɑːntrəˈseptɪv/; [or]z8;
corrosion: [n]侵蚀,腐蚀状态; [acc]/kəˈroʊʒn/; [or]z8;
frock: [n]僧袍;(妇女,小儿的连衣裙式)长衣; [acc]/frɑːk/; [or]z8;
intransigent: adj. 固执的,不妥协的,不让步的; [n]不妥协,不妥协的人; [acc]/ɪnˈtrænzɪdʒənt/; [or]z8;
wiggle: [v]扭动,蠕动; [n]扭动; [acc]/ˈwɪɡl/; [or]z8;
optimum: adj. 最适宜的;最佳的; [n]最适条件;最适宜; [acc]/ˈɑːptɪməm/; [or]z8;
incubate: [v]孵卵; [acc]/ˈɪŋkjubeɪt/; [or]z8;
demean: [v]贬抑,降低; [acc]/dɪˈmiːn/; [or]z8;
indolent: adj. 懒惰的,懒洋洋的; [acc]/ˈɪndələnt/; [or]z8;
flop: [vt]重重地摔落; [vi]惨败;扑通落下; [n]失败; [adv]扑通一声; [acc]/flɑːp/; [or]z8;
intrinsic: adj. 固有的; [acc]/ɪnˈtrɪnsɪk/; [or]z8;
rabies: [n](单复同型)狂犬病; [acc]/ˈreɪbiːz/; [or]z8;
facet: [n](多面体的)面,小平面;琢面,侧面; [vt]在.上琢面; [acc]/ˈfæsɪt/; [or]z8;
apathy: [n]冷漠,无兴趣;漠不关心,无感情; [acc]/ˈæpəθi/; [or]z8;
unison: [n]一致,(音)齐唱; adj. 同音的; [acc]/ˈjuːnɪsn/; [or]z8;
cannibal: [n]食人者,食同类的动物; adj. 食人者的;同类相食的;凶残的; [acc]/ˈkænɪbl/; [or]z8;
snort: [v]轻蔑或愤怒地发出哼声,喷出蒸汽声,吸毒品; [n]喷鼻息,一小杯酒; [acc]/snɔːrt/; [or]z8;
orator: [n]演说者,演讲者,雄辩家,原告; [acc]/ˈɔːrətər/; [or]z8;
hype: [n]大肆宣传; [v]大肆宣传;使.兴奋; [acc]/haɪp/; [or]z8;
strand: [n](线等的)股,缕;一个组成部分;海滨,河岸,海滩,湖滨; [v]使陷入困境;使滞留,使搁浅; [acc]/strænd/; [or]z8;
cumulative: adj. 渐增的;累积的; [acc]/ˈkjuːmjəleɪtɪv/; [or]z8;
maim: [v]使残废; [acc]/meɪm/; [or]z8;
checkmate: [n](国际象棋)将死,输棋,败局,败北; [acc]/ˌtʃekˈmeɪt/; [or]z8;
vulture: [n]秃鹰,秃鹫;贪婪的人; [acc]/ˈvʌltʃər/; [or]z8;
mince: [v]切碎,小步走路; [n]切碎物; [acc]/mɪns/; [or]z8;
invigilate: [v]监考;监视; [acc]/ɪnˈvɪdʒɪleɪt/; [or]z8;
flagrant: adj. 罪恶昭彰的,残暴的,丑恶可耻的,明目张胆的; [acc]/ˈfleɪɡrənt/; [or]z8;
substantiate: [v]证实;使实体化; [acc]/səbˈstænʃieɪt/; [or]z8;
detour: [n]弯路,绕行之路; [v]绕道,迂回; [acc]/ˈdiːtʊr/; [or]z8;
squabble: [v]发生口角,大声争吵; [n]争吵,口角; [acc]/ˈskwɑːbl/; [or]z8;
synopsis: [n]摘要,概要; [acc]/sɪˈnɑːpsɪs/; [or]z8;
visualize: [v]使形象化;想象; [acc]/ˈvɪʒuəlaɪz/; [or]z8;
courier: [n]快递员,通讯员,导游; [acc]/ˈkʊriər/; [or]z8;
infuse: [v]沏(茶),泡(草药);灌输;使充满; [acc]/ɪnˈfjuːz/; [or]z8;
hyphen: [n]连词号,连字符; [vt]以连字号连接; [acc]/ˈhaɪfn/; [or]z8;
fastidious: adj. 难讨好的,爱挑剔的; [acc]/fæˈstɪdiəs/; [or]z8;
prod: [n]刺针;刺棒;签子; [v]刺;戳;刺激; [acc]/prɑːd/; [or]z8;
shatter: [v]使粉碎;砸碎;打碎;粉碎; [acc]/ˈʃætər/; [or]z8;
montage: [n]蒙太奇(电影的基本结构手段和叙事方式),混合画,拼集的照片; [acc]/ˌmɑːnˈtɑːʒ/; [or]z8;
exemplify: [v]举例说明;例示,是..的典范; [acc]/ɪɡˈzemplɪfaɪ/; [or]z8;
lull: [v]使平静,使安静,哄骗; [n]间歇,暂停,暂时平静; [acc]/lʌl/; [or]z8;
wedge: [v]楔入; [n]楔子; [acc]/wedʒ/; [or]z8;
exonerate: [v]使免罪; [acc]/ɪɡˈzɑːnəreɪt/; [or]z8;
hypothesis: [n]假说;假设; [acc]/haɪˈpɑːθəsɪs/; [or]z8;
mortgage: [n]按揭贷款,抵押贷款; [v]抵押; [acc]/ˈmɔːrɡɪdʒ/; [or]z8;
ode: [n]长诗,颂歌; [acc]/oʊd/; [or]z8;
eschew: [v]避开;戒绝; [acc]/ɪsˈtʃuː/; [or]z8;
testator: [n]立遗嘱者; [acc]/tes'teɪtə/; [or]z8;
invocation: [n]祈祷;咒语;(法权的)行驶; [acc]/ˌɪnvəˈkeɪʃn/; [or]z8;
repulsion: [n]排斥;厌恶;反驳; [acc]/rɪˈpʌlʃn/; [or]z8;
respite: [n]缓解;暂缓;暂时的休息;缓期执行; [v]使缓解;使暂缓;使延期;缓期执行; [acc]/ˈrespɪt/; [or]z8;
indigenous: adj. 土生土长的,本土的; [acc]/ɪnˈdɪdʒənəs/; [or]z8;
intractable: adj. 棘手的;难治的;倔强的;不听话的; [acc]/ɪnˈtræktəbl/; [or]z8;
deflate: [v]放气;使缩小;紧缩通货;打击;使泄气;物价下降; [acc]/dɪˈfleɪt/; [or]z8;
iodine: [n]碘,碘酒; [acc]/ˈaɪədaɪn/; [or]z8;
conversant: adj. 熟悉的;精通的;亲近的; [acc]/kənˈvɜːrsnt/; [or]z8;
formulation: [n]表述方式;构想,规划;公式化; [acc]/ˌfɔːrmjuˈleɪʃn/; [or]z8;
incoherent: adj. 语无伦次的;不合逻辑的;不连贯的; [acc]/ˌɪnkoʊˈhɪrənt/; [or]z8;
warranty: [n]授权;根据;保证书;担保书,保单; [acc]/ˈwɔːrənti/; [or]z8;
procure: [vt](努力)取得;获得;导致;完成; [vi]介绍娼妓;拉皮条; [acc]/prəˈkjʊr/; [or]z8;
anthropology: [n]人类学; [acc]/ˌænθrəˈpɑːlədʒi/; [or]z8;
monologue: [n]独白,个人长篇演说; [acc]/ˈmɑːnəlɔːɡ/; [or]z8;
flurry: [n]阵雪,慌张; [v]慌张,激动; [acc]/ˈflɜːri/; [or]z8;
repulse: [n]击退;断然拒绝; [vt]击退;断然拒绝;憎恶; [v]使排斥,使厌恶; [acc]/rɪˈpʌls/; [or]z8;
gregarious: adj. 群居的,爱社交的; [acc]/ɡrɪˈɡeriəs/; [or]z8;
croak: [n]蛙鸣声; [acc]/kroʊk/; [or]z8;
finery: [n]服饰,华丽的服饰,鲜艳服装,装饰; [acc]/ˈfaɪnəri/; [or]z8;
onslaught: [n]猛攻,猛袭; [acc]/ˈɑːnslɔːt/; [or]z8;
referendum: [n]公民投票,复决权; [acc]/ˌrefəˈrendəm/; [or]z8;
craven: adj. 懦弱的,畏缩的; [acc]/ˈkreɪvn/; [or]z8;
heyday: [n]全盛期; int. 嘿(表喜悦或惊奇等); [acc]/ˈheɪdeɪ/; [or]z8;
coefficient: [n][数]系数; adj. 共同作用的; [acc]/ˌkoʊɪˈfɪʃnt/; [or]z8;
respectability: [n]体面,可尊敬,有社会地位; [acc]/rɪˌspektəˈbɪləti/; [or]z8;
provisional: [n]临时邮票; adj. 临时的,暂时的,暂定的; [acc]/prəˈvɪʒənl/; [or]z8;
lilac: [n]淡紫色,丁香花; adj. 淡紫色的; [acc]/ˈlaɪlək/; [or]z8;
confinement: [n]限制;监禁;分娩; [acc]/kənˈfaɪnmənt/; [or]z8;
cache: [n]隐藏处所,隐藏的粮食或物资,贮藏物; [vt]贮藏; [vi]躲藏; [acc]/kæʃ/; [or]z8;
sierra: [n]锯齿山脊,呈齿状起伏的山脉; [acc]/siˈerə/; [or]z8;
backdrop: [n]背景幕;(事件的)背景; [acc]/ˈbækdrɑːp/; [or]z8;
actuality: [n]现状,现实,事实; [acc]/ˌæktʃuˈæləti/; [or]z8;
padlock: [n]挂锁,关闭,禁止进入; [v]用挂锁锁上,关闭; [acc]/ˈpædlɑːk/; [or]z8;
materialize: [v]赋予形体,具体化,物质化; [acc]/məˈtɪriəlaɪz/; [or]z8;
cowardice: [n]胆小,懦弱; [acc]/ˈkaʊərdɪs/; [or]z8;
cub: [n]幼兽,年轻无经验的人; [v](野兽)生仔; adj. 没经验的; [acc]/kʌb/; [or]z8;
verve: [n]热情,神韵,活力,气魄; [acc]/vɜːrv/; [or]z8;
jumble: [n]混杂;混乱;待义卖的一堆旧什物; [v]使混乱;搞乱; [acc]/ˈdʒʌmbl/; [or]z8;
fuzz: [n]绒毛,模糊,细毛,警员; [vi]作绒毛状飞散,变成绒毛状,变得模糊; [vt]使模糊,起毛; [acc]/fʌz/; [or]z8;
exotic: adj. 奇异的,珍奇的,来自异国的; [acc]/ɪɡˈzɑːtɪk/; [or]z8;
ejaculate: [v]突然叫出,射出; [n]射出;射出者;一次射出的精液;突然的喊出; [acc]/iˈdʒækjuleɪt/; [or]z8;
oracle: [n]代神发布神谕的人,神使,圣贤; [acc]/ˈɔːrəkl/; [or]z8;
horsewhip: [n]马鞭; [vt]用马鞭鞭打,惩罚; [acc]/ˈhɔːrswɪp/; [or]z8;
foray: [n]突袭;首次尝试;短途旅行; [v]袭击; [acc]/ˈfɔːreɪ/; [or]z8;
degrade: [v]贬低;降低品格(身价,价值等);分解;降低; [acc]/dɪˈɡreɪd/; [or]z8;
fiend: [n]恶魔;能手;..迷; [acc]/fiːnd/; [or]z8;
ablaze: adj. 着火的,燃烧的;激昂的;光彩夺目的; [acc]/əˈbleɪz/; [or]z8;
yoga: [n]瑜珈,瑜珈术; [acc]/ˈjoʊɡə/; [or]z8;
jellyfish: [n]水母,海蜇; [acc]/ˈdʒelifɪʃ/; [or]z8;
torso: [n](人体的)躯干,躯干像; [acc]/ˈtɔːrsoʊ/; [or]z8;
estrange: [v]使疏远,离间; [acc]/ɪ'streɪndʒ/; [or]z8;
rebound: [v]弹回,恢复,振作; [n]弹回,重新振作,回应; [acc]/rɪˈbaʊnd/; [or]z8;
dauntless: adj. 勇敢的,无畏的;不屈不挠的; [acc]/ˈdɔːntləs/; [or]z8;
rarity: [n]罕见,珍贵,珍品,稀薄; [acc]/ˈrerəti/; [or]z8;
pinch: [v]捏,掐,夹痛; [n]捏;少量,一撮;困苦; [acc]/pɪntʃ/; [or]z8;
handily: [adv]方便地,敏捷地,灵巧地; [acc]/ˈhændɪli/; [or]z8;
brace: [n][医学]牙齿定位器; [v]支柱;支撑;加固;使绷紧; [acc]/breɪs/; [or]z8;
haphazard: adj. 偶然的;随意的;凑合的;胡乱的; [acc]/hæpˈhæzərd/; [or]z8;
shortfall: [n]不足,亏空; [acc]/ˈʃɔːrtfɔːl/; [or]z8;
vicarious: adj. 代替别人做的;代理的,代替的;发同感的; [acc]/vaɪˈkeriəs/; [or]z8;
muddle: [n]混乱,杂乱,(头脑的)糊涂; [v](使)混乱,(使)迷惑,混淆; adj. 引起困惑的;使人糊涂的;难以理解的; [acc]/ˈmʌdl/; [or]z8;
muse: [v]沉思;冥想; [n][希神]缪斯女神,灵感; [acc]/mjuːz/; [or]z8;
stoic: [n]斯多葛学派哲学家;禁欲主义者;坚守克己之人; adj. 斯多葛派的;禁欲主义的; [acc]/ˈstoʊɪkl/; [or]z8;
prophecy: [n]预言书;预言,预言能力; [acc]/ˈprɑːfəsi/; [or]z8;
bigot: [n](宗教,种族,政治等的)偏执者,盲信者; [acc]/ˈbɪɡət/; [or]z8;
oust: [v]罢免,驱逐,剥夺,取代; [acc]/aʊst/; [or]z8;
converge: [v](向某一点)相交,会合;汇集,聚集,集中; [acc]/kənˈvɜːrdʒ/; [or]z8;
helium: [n][化学]氦(元素符号He); [acc]/ˈhiːliəm/; [or]z8;
dappled: adj. 有斑点的,斑驳的; [acc]/ˈdæpld/; [or]z8;
exemplary: adj. 模范的,可仿效的; [acc]/ɪɡˈzempləri/; [or]z8;
abstention: [n]戒除,回避;弃权;弃权者; [acc]/əbˈstenʃn/; [or]z8;
foible: [n]弱点,小缺点,癖好; [acc]/ˈfɔɪbl/; [or]z8;
mumps: [n][内科]流行性腮腺炎; [acc]/mʌmps/; [or]z8;
digress: [v]离题;走向岔道; [acc]/daɪˈɡres/; [or]z8;
fraught: adj. 担心的,忧虑的;充满.的; [n]货物,装载物; [vt]装货于; [acc]/frɔːt/; [or]z8;
interjection: [n]感叹词,插入语; [acc]/ˌɪntərˈdʒekʃn/; [or]z8;
inexplicable: adj. 无法解释的,难理解的,莫名其妙的; [acc]/ˌɪnɪkˈsplɪkəbl/; [or]z8;
balmy: adj. (气候)温和的; [acc]/ˈbɑːmi/; [or]z8;
heretical: adj. 异端的,异教的; [acc]/həˈretɪkl/; [or]z8;
pedagogic: adj. 教育学的; [acc]/ˌpedəˈɡɑːdʒɪk/; [or]z8;
inexorable: adj. 不为所动的,坚决不变的; [n]坚定不移的人; [acc]/ɪnˈeksərəbl/; [or]z8;
cerebral: adj. 大脑的,深思的; [acc]/səˈriːbrəl/; [or]z8;
colonize: [v]在(某处)开拓殖民地;占据;(为政治目的)打入,混入(某部门等); [acc]/ˈkɑːlənaɪz/; [or]z8;
bicker: [v]斗嘴,流动,闪动; [n]口角,流水声; [acc]/ˈbɪkər/; [or]z8;
fallow: adj. 休耕的;不活跃的;休闲地,休闲的; [n]休耕地;休耕; [v]使(翻耕后的土地)休闲; [acc]/ˈfæloʊ/; [or]z8;
vandalism: [n](对公物)恶意破坏; [acc]/ˈvændəlɪzəm/; [or]z8;
highness: [n]殿下,阁下,高度,高位,高尚,高贵; [acc]/ˈhaɪnəs/; [or]z8;
beneficiary: [n][金融]受益人,受惠者;封臣; adj. 拥有封地的;受圣俸的; [acc]/ˌbenɪˈfɪʃieri/; [or]z8;
decompose: [v](使)腐烂;分解; [acc]/ˌdiːkəmˈpoʊz/; [or]z8;
shrivel: [v]枯萎,皱缩; [acc]/ˈʃrɪvl/; [or]z8;
waddle: [v](鸭,矮胖子等)摇摇摆摆地走,蹒跚而行; [n]摇摆的步子; [acc]/ˈwɑːdl/; [or]z8;
transitory: adj. 短暂的,暂时的,瞬息的; [acc]/ˈtrænsətɔːri/; [or]z8;
gallant: adj. 勇敢的;(男子对女子)殷勤的; [v]向(女子)献殷勤;护卫;求爱; [n](尤指对女子殷勤的)时髦男子; [acc]/ˈɡælənt/; [or]z8;
dice: [n]骰子,小方块; [v]掷骰子;切成方块; [acc]/daɪs/; [or]z8;
proposition: [n]提议,计划,命题; [v]向.求欢; [acc]/ˌprɑːpəˈzɪʃn/; [or]z8;
imperious: adj. 傲慢的,专横的; [acc]/ɪmˈpɪriəs/; [or]z8;
turbid: adj. 混浊的,紊乱的; [acc]/ˈtɜːrbɪd/; [or]z8;
turning: [n]转弯处; [acc]/ˈtɜːrnɪŋ/; [or]z8;
evangelical: adj. 福音的,热切的; [n]福音派信徒; [acc]/ˌiːvænˈdʒelɪkl/; [or]z8;
crave: [v]渴望;恳求; [acc]/kreɪv/; [or]z8;
rueful: adj. 悔恨的; [acc]/ˈruːfl/; [or]z8;
bashful: adj. 害羞的;羞怯的; [acc]/ˈbæʃfl/; [or]z8;
cavity: [n]洞;龋洞; [acc]/ˈkævəti/; [or]z8;
malign: [v]诽谤,中伤; adj. 邪恶的;有害的; [acc]/məˈlaɪn/; [or]z8;
academician: [n]院士;大学生;学会会员; [acc]/ˌækədəˈmɪʃn/; [or]z8;
stoke: [v]添加燃料,把(火)拨旺,狼吞虎咽吃; [n]斯托克;[物]沲; [acc]/stoʊk/; [or]z8;
decorum: [n]礼节,礼貌,端庄,正派; [acc]/dɪˈkɔːrəm/; [or]z8;
graft: [n]嫁接;嫁接株;移植; [vi]接枝; [vt]将.嫁接;移植(器官); [acc]/ɡræft/; [or]z8;
scrawl: [n]潦草的笔迹; [v]乱涂,乱写,潦草地写; [acc]/skrɔːl/; [or]z8;
sumptuous: adj. 奢侈的;华丽的; [acc]/ˈsʌmptʃuəs/; [or]z8;
inoculate: [v][医]给..接种,给..注射预防针,[植]嫁接,灌输; [acc]/ɪˈnɑːkjuleɪt/; [or]z8;
malfunction: [v]发生故障;不起作用; [n]故障;失灵;疾病; [acc]/ˌmælˈfʌŋkʃn/; [or]z8;
exhilarate: [v]使高兴;使兴奋; adj. 使人高兴的,令人兴奋的; [acc]/ɪɡˈzɪləreɪt/; [or]z8;
vindicate: [vt]证明.无辜;维护,辩护; [acc]/ˈvɪndɪkeɪt/; [or]z8;
lust: [n]性欲,强烈的欲望; [v]产生性欲,渴望; [acc]/lʌst/; [or]z8;
fester: [v]溃烂;化脓;使..痛苦;使..恶化; [n]溃烂;脓疮,脓疱; [acc]/ˈfestər/; [or]z8;
loathe: [v]憎恨,厌恶; [acc]/loʊð/; [or]z8;
incantation: [n]咒语; [acc]/ˌɪnkænˈteɪʃn/; [or]z8;
recoup: [v]收回;恢复;偿还;扣除; [n]获得补偿; [acc]/rɪˈkuːp/; [or]z8;
asthma: [n]哮喘症; [acc]/ˈæzmə/; [or]z8;
adroit: adj. 熟练的,灵巧的; [acc]/əˈdrɔɪt/; [or]z8;
lynch: [v]私刑处死; [n]私刑;私罚; [acc]/lɪntʃ/; [or]z8;
energize: [v]使活跃;给予精力;使兴奋; [acc]/ˈenərdʒaɪz/; [or]z8;
precarious: adj. 不稳定的;危险的;可疑的;说不定的; [acc]/prɪˈkeriəs/; [or]z8;
rectify: [v]纠正;修复; [acc]/ˈrektɪfaɪ/; [or]z8;
dynamics: [n]动力学;力学; [acc]/daɪ'næmɪks/; [or]z8;
stratify: [v]分层,成层,阶层化; [acc]/ˈstrætɪfaɪ/; [or]z8;
unravel: [v]解开;拆开;阐明;解释; [acc]/ʌnˈrævl/; [or]z8;
abdicate: adj. 放弃权力的;退位的; [n]放弃权力者;退位者; [vi]退位,辞职; [vt]辞;放弃; [acc]/ˈæbdɪkeɪt/; [or]z8;
clog: [v]阻塞,阻碍; [n]障碍;木底鞋; [acc]/klɑːɡ/; [or]z8;
perfunctory: adj. 草率的,敷衍搪塞的; [acc]/pərˈfʌŋktəri/; [or]z8;
baffle: [v]使困惑;难住;阻碍; [n]挡板; [acc]/ˈbæfl/; [or]z8;
harbinger: [n]先驱,先兆; [vt]预告;充做.的前驱; [acc]/ˈhɑːrbɪndʒər/; [or]z8;
barrow: [n]搬运架,手推车,弃矿,古坟; [acc]/ˈbæroʊ/; [or]z8;
incursion: [n]入侵,侵犯; [acc]/ɪnˈkɜːrʒn/; [or]z8;
pare: [v]削去,剥去; [acc]/per/; [or]z8;
pasta: [n]意大利面食; [acc]/ˈpɑːstə/; [or]z8;
disclaim: [v]放弃权利,拒绝承认,拒绝; [acc]/dɪsˈkleɪm/; [or]z8;
dormant: adj. 睡眠的,休眠的;静止的,隐伏的; [acc]/ˈdɔːrmənt/; [or]z8;
paranoid: adj. 偏执狂的,过分怀疑的; [acc]/ˈpærənɔɪd/; [or]z8;
spasm: [v]痉挛,抽搐; [n]痉挛; [acc]/ˈspæzəm/; [or]z8;
adhesive: [n]粘合剂,胶水; adj. 带粘性的;粘着的;难忘的; [acc]/ədˈhiːsɪv/; [or]z8;
barter: [v]物物交换;以货易货; [n]物物交换;实物交易; [acc]/ˈbɑːrtər/; [or]z8;
extrapolate: [v]进行推断; [acc]/ɪkˈstræpəleɪt/; [or]z8;
movable: adj. 动产的;可移动的;不固定的; [n]动产;可移动的东西; [acc]/ˈmuːvəbl/; [or]z8;
blur: [n]污点,模糊; [v]使.模糊;弄脏;变模糊; [acc]/blɜːr/; [or]z8;
rind: [n]壳,外皮; [vt]剥去.的皮; [acc]/raɪnd/; [or]z8;
heredity: [n]遗传;遗传特征; [acc]/həˈredəti/; [or]z8;
misappropriate: [v]滥用,误用; adj. =inappropriate; [acc]/ˌmɪsəˈproʊprieɪt/; [or]z8;
vet: [n]兽医; [v]作兽医;诊疗;审查; [acc]/vet/; [or]z8;
orientation: [n]信仰;倾向;[计]定向;(学生)迎新会;定向,方向;(任职,上学等之前的) 情况介绍;训练; [acc]/ˌɔːriənˈteɪʃn/; [or]z8;
elucidate: [v]阐明,说明; [acc]/iˈluːsɪdeɪt/; [or]z8;
filial: adj. 子女的,孝顺的;[生物]子代的,后代的; [adv]子女地; [acc]/ˈfɪliəl/; [or]z8;
graffiti: [n]乱涂乱写; [v]在.上涂鸦; [acc]/ɡrəˈfiːti/; [or]z8;
philanthropic: adj. 博爱的,为他人着想的; [acc]/ˌfɪlənˈθrɑːpɪk/; [or]z8;
loophole: [n]漏洞;枪眼;换气孔;射弹孔; [vt]钻空子;开孔; [acc]/ˈluːphoʊl/; [or]z8;
ensue: [v]跟着发生,接踵而来;因而产生; [acc]/ɪnˈsuː/; [or]z8;
evanescent: adj. 短暂的,容易消散的,(印象等)逐渐消失的,会凋零的; [acc]/ˌevəˈnesnt/; [or]z8;
drool: [v]流口水,胡说; [n]口水,梦话,胡说; [acc]/druːl/; [or]z8;
tantalize: [v]逗弄,挑逗,使(看到拿不到而)焦急; [acc]/ˈtæntəlaɪz/; [or]z8;
vile: adj. 令人讨厌的,恶心的;可恨的;可耻的;简陋的; [acc]/vaɪl/; [or]z8;
venom: [n]毒液;恶意;怨恨; [vt]使有毒;放毒; [acc]/ˈvenəm/; [or]z8;
dislocate: [v]使脱臼;把.弄乱; [acc]/ˈdɪsloʊkeɪt/; [or]z8;
harness: [n]挽具,马具,降落伞背带; [v]上挽具;治理(河流等);利用; [acc]/ˈhɑːrnɪs/; [or]z8;
extract: [v]取出;提取;摘录;设法得到;索取; [n]摘录;提出物; [acc]/ɪkˈstrækt/; [or]z8;
nostalgia: [n]怀旧之情,思乡病; [acc]/nəˈstældʒə/; [or]z8;
lathe: [n]车床; [acc]/leɪð/; [or]z8;
quibble: [n]谬论;双关语;遁辞; [v]诡辩;挑剔;说模棱两可的话; [acc]/ˈkwɪbl/; [or]z8;
trounce: [v]打败;痛打,严惩; [acc]/traʊns/; [or]z8;
fiscal: adj. 会计的;财政的;国库的; [acc]/ˈfɪskl/; [or]z8;
cavern: [n]洞穴;凹处; [v]挖空;置.于洞穴中; [acc]/ˈkævərn/; [or]z8;
viable: adj. 可行的;能养活的;能生育的; [acc]/ˈvaɪəbl/; [or]z8;
stalemate: [n]和棋局面,僵局; [v]使陷入僵局; [acc]/ˈsteɪlmeɪt/; [or]z8;
vocalist: [n]流行歌手,声乐家; [acc]/ˈvoʊkəlɪst/; [or]z8;
drab: adj. 枯黄色的,无聊的,单调的; [n]单调;淡褐色;[印,纺]淡褐色厚呢;邋遢女人; [acc]/dræb/; [or]z8;
thyroid: adj. ［解］甲状腺的; [n]甲状腺; [acc]/ˈθaɪrɔɪd/; [or]z8;
perilous: adj. 危险的; [acc]/ˈperələs/; [or]z8;
imbibe: [v]喝,饮;吸收,接受; [acc]/ɪmˈbaɪb/; [or]z8;
distaste: [n]厌恶,讨厌; [v]厌恶,不喜欢; [acc]/dɪsˈteɪst/; [or]z8;
radiance: [n]发光,容光焕发; [acc]/ˈreɪdiəns/; [or]z8;
inept: adj. 无能的;不称职的;笨拙的; [acc]/ɪˈnept/; [or]z8;
stamina: [n]耐力,持久力; [acc]/ˈstæmɪnə/; [or]z8;
adverse: adj. 不利的;(方向上)逆的;在相反的方向上移动(或运转);相反的; [acc]/ˈædvɜːrs/; [or]z8;
meticulous: adj. 谨小慎微的;一丝不苟的; [acc]/məˈtɪkjələs/; [or]z8;
squirm: [v]蠕动,面容扭曲; [n]蠕动; [acc]/skwɜːrm/; [or]z8;
immaculate: adj. 完美的,无瑕疵的;洁净的; [acc]/ɪˈmækjələt/; [or]z8;
forge: [n]熔炉;锻工车间;铁匠店; [v]锻造;经锻炼而形成;伪造;推进,加强; [acc]/fɔːrdʒ/; [or]z8;
finesse: [n]技巧,计谋,策略; [v]以技巧取胜; [acc]/fɪˈnes/; [or]z8;
abbreviation: [n]缩短;缩写词;省略号; [acc]/əˌbriːviˈeɪʃn/; [or]z8;
impressionable: adj. 敏感的;易受影响的; [acc]/ɪmˈpreʃənəbl/; [or]z8;
rampart: [n]壁垒,城墙; [vt]用壁垒围绕,防卫;守卫; [acc]/ˈræmpɑːrt/; [or]z8;
harrow: [n]耙; [v]耙地,使苦恼,被耙松; [acc]/ˈhæroʊ/; [or]z8;
culprit: [n]罪犯,犯人,犯错者; [acc]/ˈkʌlprɪt/; [or]z8;
psychotherapy: [n]心理疗法,精神疗法; [acc]/ˌsaɪkoʊˈθerəpi/; [or]z8;
mimic: [v]模仿,戏弄; [n]模仿者; adj. 模拟的;假的,伪装的; [acc]/ˈmɪmɪk/; [or]z8;
quench: [v]扑灭(火);止渴; [acc]/kwentʃ/; [or]z8;
quaint: adj. 精巧的;古雅的; [acc]/kweɪnt/; [or]z8;
nibble: [v]一点点地咬,慢慢啃,吹毛求疵; [n]细咬,轻咬,啃; [acc]/ˈnɪbl/; [or]z8;
undulate: adj. 波动的;波浪形的; [v]波动,起伏; [acc]/ˈʌndʒəleɪt/; [or]z8;
ingratiating: adj. 讨好的,谄媚的; [acc]/ɪnˈɡreɪʃieɪtɪŋ/; [or]z8;
dehydrate: [v]除去水份,脱水; [acc]/diːˈhaɪdreɪt/; [or]z8;
trauma: [n]精神创伤,外伤; [acc]/ˈtraʊmə/; [or]z8;
undercut: [v]廉价出售;较便宜的工资工作;从下边削球; [n]底切;牛腰部下侧嫩肉;砍口;切球; adj. 下部被削去[切去,挖掉,凿去]的; [acc]/ˌʌndərˈkʌt/; [or]z8;
urinate: [v]小便,撒尿; [acc]/ˈjʊrəneɪt/; [or]z8;
brittle: adj. 易碎的;脆弱的;靠不住的; [n]薄片脆糖; [acc]/ˈbrɪtl/; [or]z8;
fawn: [v]奉承;生(小鹿或小动物); [n]小鹿;浅黄褐色; [acc]/fɔːn/; [or]z8;
balm: [n]香油,止痛膏,安慰物,香气; [acc]/bɑːm/; [or]z8;
underlie: [v]位于..之下;成为..的基础; [acc]/ˌʌndərˈlaɪ/; [or]z8;
meddle: [vi]干预,多管闲事; [acc]/ˈmedl/; [or]z8;
infirmary: [n]医院,医务室(尤指学校等附设的病房或配药处); [acc]/ɪnˈfɜːrməri/; [or]z8;
divinity: [n]神,神性,神学; [acc]/dɪˈvɪnəti/; [or]z8;
stealthily: [adv]暗地里,悄悄地; [acc]/ˈstelθɪli/; [or]z8;
additive: [n]添加剂,添加物; adj. 附加的;[数]加法的; [acc]/ˈædətɪv/; [or]z8;
disrespect: [n]不礼貌,无礼,失礼; [vt]不尊重,藐视,轻视; [acc]/ˌdɪsrɪˈspekt/; [or]z8;
grandeur: [n]壮观,宏伟,庄严; [acc]/ˈɡrændʒər/; [or]z8;
exalted: adj. 尊贵的,高位的;兴奋的;高尚的; [acc]/ɪɡˈzɔːltɪd/; [or]z8;
impregnable: adj. 攻不破的,征服不了的; [acc]/ɪmˈpreɡnəbl/; [or]z8;
injunction: [n][法]指令,禁令; [acc]/ɪnˈdʒʌŋkʃn/; [or]z8;
agnostic: adj. 不可知论的; [n]不可知论者; [acc]/æɡˈnɑːstɪk/; [or]z8;
parody: [n]嘲弄文章,拙劣的模仿; [v]拙劣模仿; [acc]/ˈpærədi/; [or]z8;
sensor: [n]传感器,灵敏元件; [acc]/ˈsensər/; [or]z8;
bedding: [n]寝具,基床,草垫; adj. 适于花坛种植的; [acc]/ˈbedɪŋ/; [or]z8;
August: [n]八月; [acc]/ˈɔːɡəst/; [or]z8;
volatile: adj. 易气化的;爆炸性的;反复无常的;短暂的;不稳定的; [acc]/ˈvɑːlətl/; [or]z8;
inhibit: [v]阻碍;阻止,防止;抑制,约束; [acc]/ɪnˈhɪbɪt/; [or]z8;
superimpose: [v]添加;重叠;附加;安装; [acc]/ˌsuːpərɪmˈpoʊz/; [or]z8;
confide: [v]倾诉;委托;信赖; [acc]/kənˈfaɪd/; [or]z8;
colossal: adj. 巨像(似)的;巨大的,庞大的; [acc]/kəˈlɑːsl/; [or]z8;
vagabond: [n]流浪者; [v]漂泊,流浪; adj. 流浪的,流浪者的,漂泊的; [acc]/ˈvæɡəbɑːnd/; [or]z8;
cult: [n]异教;风尚,热潮;信徒; adj. 流行的;风靡一时的; [acc]/kʌlt/; [or]z8;
capillary: [n]毛细血管; adj. 毛细血管的;毛状的; [acc]/ˈkæpəleri/; [or]z8;
portfolio: [n]公文包,文件夹,投资组合;股份单; [acc]/pɔːrtˈfoʊlioʊ/; [or]z8;
tempo: [n][音]节奏,拍子;行进速度; [acc]/ˈtempoʊ/; [or]z8;
strident: adj. 尖声的,刺耳的; [acc]/ˈstraɪdnt/; [or]z8;
expound: [v]详细说明,解释,阐述; [acc]/ɪkˈspaʊnd/; [or]z8;
disarray: [n]混乱,漫无秩序; [acc]/ˌdɪsəˈreɪ/; [or]z8;
impoverish: [v]使成赤贫,使枯竭; [acc]/ɪmˈpɑːvərɪʃ/; [or]z8;
pompous: adj. 傲慢的,浮华的; [acc]/ˈpɑːmpəs/; [or]z8;
homosexual: adj. 同性恋的; [n]同性恋; [acc]/ˌhoʊməˈsekʃuəl/; [or]z8;
plaque: [n]饰板,匾,斑块; [acc]/plæk/; [or]z8;
forestall: [v]领先;占先一步;先发制人,阻止,妨碍;垄断;占先一步; [acc]/fɔːrˈstɔːl/; [or]z8;
rickety: adj. 佝偻病的;摇晃的;蹒跚的;不结实的; [acc]/ˈrɪkəti/; [or]z8;
babble: [v]呀呀学语,喋喋不休,作潺潺声;泄露(秘密); [n]儿语,胡言乱语,潺潺声; [acc]/ˈbæbl/; [or]z8;
jocular: adj. 搞笑的,欢乐的; [acc]/ˈdʒɑːkjələr/; [or]z8;
disparity: [n]不同,不一致,不等; [acc]/dɪˈspærəti/; [or]z8;
faraway: adj. 遥远的,久远的,恍惚的,朦胧的; [n]遥远的事物; [acc]/ˈfɑːrəweɪ/; [or]z8;
solvency: [n]偿付能力;溶解力; [acc]/ˈsɑːlvənsi/; [or]z8;
franchise: [n]特许(经营权),公民权,选举权; [v]赋予特权,赋予公民权; [acc]/ˈfræntʃaɪz/; [or]z8;
hallucination: [n]幻觉,幻想; [acc]/həˌluːsɪˈneɪʃn/; [or]z8;
pragmatic: adj. 国事的,团体事务的;实际的,注重实效的; [n]爱管闲事的人;专断的人;国事诏书;实际家; [acc]/præɡˈmætɪk/; [or]z8;
avalanche: [n]雪崩;大量拥至; [vi]崩塌; [acc]/ˈævəlæntʃ/; [or]z8;
hiss: [n]嘶嘶声;发嘘声; [vi]发出嘶嘶声; [vt]嘶嘶地发出;发嘘声让(某人)别做声; [acc]/hɪs/; [or]z8;
headstrong: adj. 任性的;顽固的; [acc]/ˈhedstrɔːŋ/; [or]z8;
alias: [n]别名,化名; [adv]别名为,化名为; [acc]/ˈeɪliəs/; [or]z8;
harrowing: adj. 悲痛的,难受的; [acc]/ˈhæroʊɪŋ/; [or]z8;
bogus: adj. 假的,假装的; [n]伪币;冒牌货; [acc]/ˈboʊɡəs/; [or]z8;
accrue: [v](利息等)增大,增多; [acc]/əˈkruː/; [or]z8;
unobtrusive: adj. 不唐突的,谦虚的,不引人注目的; [acc]/ˌʌnəbˈtruːsɪv/; [or]z8;
nimble: adj. 敏捷的,灵活的,机智的; [acc]/ˈnɪmbl/; [or]z8;
rampage: [n]粗暴;胡闹; [v]暴跳;暴怒;狂暴地乱冲; [acc]/ræmˈpeɪdʒ/; [or]z8;
resuscitation: [n]复活,苏醒; [acc]/rɪˌsʌsɪˈteɪʃn/; [or]z8;
preferential: adj. 优先的;选择的;特惠的; [acc]/ˌprefəˈrenʃl/; [or]z8;
hoodwink: [v]欺骗,遮眼,蒙蔽; [acc]/ˈhʊdwɪŋk/; [or]z8;
encampment: [n]营地,露营; [acc]/ɪnˈkæmpmənt/; [or]z8;
inception: [n]起初;获得学位; [acc]/ɪnˈsepʃn/; [or]z8;
parry: [v]挡开,避开(武器,问题等); [acc]/ˈpæri/; [or]z8;
retention: [n]保留,保持; [acc]/rɪˈtenʃn/; [or]z8;
prophesy: [v]预言,预报; [acc]/ˈprɑːfəsaɪ/; [or]z8;
uranium: [n]铀; [acc]/juˈreɪniəm/; [or]z8;
tartan: [n]单桅三角帆船,格子花,格子织物; adj. 格子花呢的; [acc]/ˈtɑːrtn/; [or]z8;
sully: [v]玷污,污染; [acc]/ˈsʌli/; [or]z8;
prism: [n]棱镜;棱柱; [acc]/ˈprɪzəm/; [or]z8;
wade: [v]涉水而行,淌水;跋涉; [acc]/weɪd/; [or]z8;
selenium: [n]硒; [acc]/səˈliːniəm/; [or]z8;
substantive: adj. 有实质的;大量的;真实的;独立存在的; [n]实词,名词,名词性词组; [acc]/səbˈstæntɪv/; [or]z8;
fret: [v]使烦恼,使焦急;使腐蚀;使磨损; [n](斑卓琴,吉他,曼陀林琴等弦乐器指板上定音的)档;侵蚀; [acc]/fret/; [or]z8;
oxidize: [v]生锈;氧化; [acc]/ˈɑːksɪdaɪz/; [or]z8;
shove: [v]推;猛推; [n]推搡; [acc]/ʃʌv/; [or]z8;
infuriate: [v]使(人)极为愤怒; [acc]/ɪnˈfjʊrieɪt/; [or]z8;
claustrophobia: [n]幽闭恐怖症; [acc]/ˌklɔːstrəˈfoʊbiə/; [or]z8;
reciprocate: [v]互给;酬答;互换;报答; [acc]/rɪˈsɪprəkeɪt/; [or]z8;
fictitious: adj. 虚构的; [acc]/fɪkˈtɪʃəs/; [or]z8;
elusive: adj. 难懂的;难捉摸的;难找的;难懂的;易忘的;逃避的;难捉摸的; [acc]/iˈluːsɪv/; [or]z8;
clatter: [n]咔嗒;哗啦声;嘈杂的谈笑声; [v]发出哗啦声;喧闹的谈笑; [acc]/ˈklætər/; [or]z8;
ordinance: [n]法令;条例;条例;圣餐式; [acc]/ˈɔːrdɪnəns/; [or]z8;
scenario: [n]剧情梗概;情况,情节;设想; [acc]/səˈnærioʊ/; [or]z8;
parable: [n]寓言,比喻; [acc]/ˈpærəbl/; [or]z8;
corpulent: adj. 肥胖的; [acc]/ˈkɔːrpjələnt/; [or]z8;
hulk: [n]废船;笨重的人或物; [vi]赫然显现;<英口>笨拙地挪动; [acc]/hʌlk/; [or]z8;
endorse: [v]赞同,认可;签注(文件); [acc]/ɪnˈdɔːrs/; [or]z8;
foil: [n]箔;锡箔纸;衬托; [v]挫败;使受挫折; [acc]/fɔɪl/; [or]z8;
hump: [n]驼峰;小园丘,峰丘; [v](使)隆起,弓起; [acc]/hʌmp/; [or]z8;
judicious: adj. 有判断力的;明智的; [acc]/dʒuˈdɪʃəs/; [or]z8;
pounce: [n]猛扑,飞扑; [vi]猛扑,突然袭击; [vt]扑过去抓住; [acc]/paʊns/; [or]z8;
blemish: [v]损害,玷污; [n]瑕疵,缺点; [acc]/ˈblemɪʃ/; [or]z8;
shamble: [v]蹒跚,拖沓; [n]蹒跚;摇晃的脚步;(pl.)混乱,废墟; [acc]/ˈʃæmbl/; [or]z8;
recount: [v]叙述; [n]重新计算; [acc]/rɪˈkaʊnt/; [or]z8;
remittance: [n]汇款,汇款额; [acc]/rɪˈmɪtns/; [or]z8;
florist: [n]花商,种花者,花卉研究者; [acc]/ˈflɔːrɪst/; [or]z8;
panacea: [n]灵丹妙药,万能药; [acc]/ˌpænəˈsiːə/; [or]z8;
fatality: [n]死亡;宿命;致命性;不幸,灾祸; [acc]/fəˈtæləti/; [or]z8;
arcade: [n]拱廊;有拱廊的街道;游乐场所,游戏厅; [acc]/ɑːrˈkeɪd/; [or]z8;
grievous: adj. 悲痛的,痛苦的,可叹的,痛心的,剧烈的,严重的,难忍的; [acc]/ˈɡriːvəs/; [or]z8;
thud: [n]砰的一声,重击; [v]砰的一声掉下,发出砰声,砰地击中; [acc]/θʌd/; [or]z8;
tamper: [v]篡改;玩弄;贿赂; [n]填塞者;捣棒; [acc]/ˈtæmpər/; [or]z8;
flirt: [n]急扔;调情者; [vi]卖弄风情,调情;戏弄,不认真地对待;摆动; [vt]急速摆动,挥动; [acc]/flɜːrt/; [or]z8;
antler: [n]鹿角,茸角; [acc]/ˈæntlər/; [or]z8;
counteract: [v]抵消;中和;阻碍; [acc]/ˌkaʊntərˈækt/; [or]z8;
hackneyed: adj. 陈腐的,平常的; [acc]/ˈhæknid/; [or]z8;
unnerve: [v]使失去勇气,使焦躁,使失常; [acc]/ˌʌnˈnɜːrv/; [or]z8;
curfew: [n]宵禁,宵禁令,晚钟声,熄灯就寝时刻; [acc]/ˈkɜːrfjuː/; [or]z8;
sanguine: adj. 乐观的,(脸色等)有血色的,多血质的; [n]血红色,乐观; [acc]/ˈsæŋɡwɪn/; [or]z8;
redress: [n]纠正,革除,救济; [v]修正,救济,革除; [acc]/rɪˈdres/; [or]z8;
prospective: adj. 未来的;预期的; [n]预期; [acc]/prəˈspektɪv/; [or]z8;
alight: [vi]下来;飞落; adj. 烧着的;点亮着的; [acc]/əˈlaɪt/; [or]z8;
morphine: [n]吗啡; [acc]/ˈmɔːrfiːn/; [or]z8;
logistics: [n]后勤,后勤学,物流; [acc]/ləˈdʒɪstɪks/; [or]z8;
plea: [n](法律)抗辩;恳求;请求,托词,口实; [acc]/pliː/; [or]z8;
contrive: [v]发明;设计出;设法做到;谋划;策划; [acc]/kənˈtraɪv/; [or]z8;
chuck: [v]轻轻地扔;抛;丢弃; [acc]/tʃʌk/; [or]z8;
freak: [n]怪人,怪物,奇事; adj. 反常的,怪诞的; [vt]使强烈反应(震惊;畏惧); [vi]在药物影响下变得异乎寻常; [acc]/friːk/; [or]z8;
extraction: [n]抽出,取出;家世,出身;抽出物; [acc]/ɪkˈstrækʃn/; [or]z8;
broke: adj. 一文不名的,破产的; [vt]打破,弄破;(使)破,裂,碎;中断;违犯;背弃;把...换成零钱;找开; [vi]破晓;(风暴)开始; [acc]/broʊk/; [or]z8;
protrude: [v]伸出,突出,凸出; [acc]/proʊˈtruːd/; [or]z8;
incise: [v]切,切割;雕刻; [acc]/ɪnˈsaɪz/; [or]z8;
relinquish: [v]放弃,让出(权利,财产等),撤回; [acc]/rɪˈlɪŋkwɪʃ/; [or]z8;
chirp: [n]唧唧声;喳喳声; [v](鸟或虫)唧唧叫; [acc]/tʃɜːrp/; [or]z8;
ludicrous: adj. 荒谬的,可笑的,滑稽的; [acc]/ˈluːdɪkrəs/; [or]z8;
chisel: [v]刻,凿; [n]凿子; [acc]/ˈtʃɪzl/; [or]z8;
vernal: adj. 春天的,和煦的,青春的; [acc]/ˈvɜːrnl/; [or]z8;
lure: [v]引诱;以诱饵吸引; [n]诱惑力;诱惑物;鱼饵; [acc]/lʊr/; [or]z8;
culminate: [v]使达高潮,使结束; [acc]/ˈkʌlmɪneɪt/; [or]z8;
patriarchal: adj. 族长的;家长的;可尊敬的;德高望重的; [acc]/ˌpeɪtriˈɑːrkl/; [or]z8;
gobble: [v]狼吞虎咽;急急抓住,任意花完;如饥似渴地阅读;发出雄火鸡般的咯咯叫声; [n](火鸡的)咯咯声; [acc]/ˈɡɑːbl/; [or]z8;
legendary: adj. 传说的;传奇的; [n]传说集;圣徒传; [acc]/ˈledʒənderi/; [or]z8;
blare: [v]高声鸣叫,发嘟嘟声; [n]嘟嘟声,号声,巨响; [acc]/bler/; [or]z8;
bronchitis: [n][内科]支气管炎; [acc]/brɑːŋˈkaɪtɪs/; [or]z8;
exponent: [n][数]指数;典型;说明者,说明物; adj. 说明的; [acc]/ɪkˈspoʊnənt/; [or]z8;
satiate: [v]使饱足,生腻; adj. 饱足的;厌腻的; [acc]/ˈseɪʃieɪt/; [or]z8;
untold: adj. 无数的,数不清的; [acc]/ˌʌnˈtoʊld/; [or]z8;
adjudicate: [v]充当裁判,判决; [n]判决,宣判;裁判员; [acc]/əˈdʒuːdɪkeɪt/; [or]z8;
ethics: [n]行为准则;道德规范; [acc]/'eθɪks/; [or]z8;
enrage: [v]使狂怒,激怒; [acc]/ɪnˈreɪdʒ/; [or]z8;
infringe: [v]侵犯,违反,侵害; [acc]/ɪnˈfrɪndʒ/; [or]z8;
hunch: [n]预感,大块,肉峰; [vt]耸肩,预感到,弯腰驼背; [vi]隆起,向前移动; [acc]/hʌntʃ/; [or]z8;
servile: adj. 奴颜婢膝的,卑屈的,隶属的; [n]奴隶; [acc]/ˈsɜːrvl/; [or]z8;
maniac: adj. 发狂的,癫狂的,疯狂的; [n]燥狂(症)者,疯子; [acc]/ˈmeɪniæk/; [or]z8;
facade: [n]建筑物的正面,外表; [acc]/fəˈsɑːd/; [or]z8;
crook: [n]骗子;弯曲处;钩;河弯;诡计; [v]使弯曲; adj. 不正当的;骗人的; [acc]/krʊk/; [or]z8;
evoke: [v]唤起;引起;使人想起; [acc]/ɪˈvoʊk/; [or]z8;
stethoscope: [n]听诊器; [v]用听诊器诊察; [acc]/ˈsteθəskoʊp/; [or]z8;
irascible: adj. 易怒的,性情暴躁的; [acc]/ɪˈræsəbl/; [or]z8;
doctorate: [n]博士头衔; [acc]/ˈdɑːktərət/; [or]z8;
lobe: [n]耳垂,波瓣,(脑,肺等的)叶,裂片; [acc]/loʊb/; [or]z8;
allergy: [n]过敏症,厌恶; [acc]/ˈælərdʒi/; [or]z8;
exhilarating: adj. 令人高兴的; [v]使高兴;使兴奋; [acc]/ɪɡˈzɪləreɪtɪŋ/; [or]z8;
aberrant: [n]离开正路的人,反常的人; adj. 偏离正轨的;异常的,畸变的; [acc]/æˈberənt/; [or]z8;
existential: adj. 存在主义的,有关存在的,存在判断的; [acc]/ˌeɡzɪˈstenʃəl/; [or]z8;
reticent: adj. 沉默不语的;有保留的;含蓄的; [acc]/ˈretɪsnt/; [or]z8;
invalidate: [v]使无效;使无价值; [acc]/ɪnˈvælɪdeɪt/; [or]z8;
goggle: [n]眼睛睁视,风镜,护目镜; adj. 睁眼的,瞪眼的; [v]眼珠转动,瞪眼看,使瞪眼; [acc]/ˈɡɑːɡl/; [or]z8;
apprehension: [n]忧虑,担心,疑惧;逮捕;理解; [acc]/ˌæprɪˈhenʃn/; [or]z8;
subside: [vi]平息,减弱;减弱;(建筑)下陷;(尤指洪水的水位) 回落; [acc]/səbˈsaɪd/; [or]z8;
cleanse: [v]净化; [acc]/klenz/; [or]z8;
pitfall: [n]陷阱,未料到的危险或困难; [acc]/ˈpɪtfɔːl/; [or]z8;
audition: [n]听力,听觉;试听;试镜; [vi]试唱; [vt]对.进行面试;让.试唱; [acc]/ɔːˈdɪʃn/; [or]z8;
preclude: [v]阻止;排除; [acc]/prɪˈkluːd/; [or]z8;
execrable: adj. 极坏的; [acc]/ˈeksɪkrəbl/; [or]z8;
moribund: adj. 濒临失败的,垂死的; [n]垂死的人; [acc]/ˈmɔːrɪbʌnd/; [or]z8;
stipend: [n]奖学金;固定薪金;定期津贴;养老金; [acc]/ˈstaɪpend/; [or]z8;
tenet: [n]信念,原则,教条; [acc]/ˈtenɪt/; [or]z8;
quartet: [n]四重奏,四重唱,四件一组; [acc]/kwɔːrˈtet/; [or]z8;
loft: [n]阁楼,顶楼; [v]把.储放在阁楼内;将球高击;发射(人造卫星等); [acc]/lɔːft/; [or]z8;
lucid: adj. 明晰的;透明的;易懂的;头脑清楚的; [acc]/ˈluːsɪd/; [or]z8;
hydrocarbon: [n]碳氢化合物,烃; [acc]/ˌhaɪdrəˈkɑːrbən/; [or]z8;
evict: [v]驱逐,逐出; [acc]/ɪˈvɪkt/; [or]z8;
redraw: [v]重画; [acc]/ˌriːˈdrɔː/; [or]z8;
strained: adj. 紧张的,不友善的,勉强的,不自然的(态度等),牵强附会的; [acc]/streɪnd/; [or]z8;
stub: [n]存根;烟蒂;树桩;断株; [v]踩熄;连根拔除; [acc]/stʌb/; [or]z8;
cathode: [n](电)阴极,正极; [acc]/ˈkæθoʊd/; [or]z8;
divergent: adj. 叉开的;分歧的; [acc]/daɪˈvɜːrdʒənt/; [or]z8;
nomadic: adj. 游牧的;流浪的;游动的; [acc]/noʊˈmædɪk/; [or]z8;
silhouette: [v]使显出轮廓(或影像); [n]影子,轮廓; [acc]/ˌsɪluˈet/; [or]z8;
incriminate: [v]控告,暗示..有罪; [acc]/ɪnˈkrɪmɪneɪt/; [or]z8;
hearten: [v]激励,鼓励,(使)振作; [acc]/ˈhɑːrtn/; [or]z8;
sultry: adj. 闷热的,狂暴的,淫荡的; [acc]/ˈsʌltri/; [or]z8;
senile: adj. 年老的,衰老的,因年老发生的(记忆力衰退等); [acc]/ˈsiːnaɪl/; [or]z8;
adept: [n]专家,能手; adj. 熟练的;巧妙的; [acc]/əˈdept/; [or]z8;
tantamount: adj. 与.相等的; [acc]/ˈtæntəmaʊnt/; [or]z8;
declaim: [v]高谈阔论,雄辩,大声说; [acc]/dɪˈkleɪm/; [or]z8;
shimmer: [v]闪烁,微微发亮; [n]微光,闪光; [acc]/ˈʃɪmər/; [or]z8;
evacuate: [v]撤离,疏散,排清; [acc]/ɪˈvækjueɪt/; [or]z8;
methodology: [n]方法论,方法学;(某一学科的)一套方法; [acc]/ˌmeθəˈdɑːlədʒi/; [or]z8;
discreet: adj. 谨慎的;思虑周全的,小心的; [acc]/dɪˈskriːt/; [or]z8;
squeamish: adj. 害怕的,易受惊的,想呕吐的; [n]易心烦意乱的人;神经脆弱的人; [acc]/ˈskwiːmɪʃ/; [or]z8;
solemnity: [n]庄严,肃穆,庄严的仪式; [acc]/səˈlemnəti/; [or]z8;
turbine: [n]汽轮机,叶轮机; [acc]/ˈtɜːrbaɪn/; [or]z8;
husk: [n]外壳,皮;无价值之物; [v]削皮;以粗哑的嗓音说; [acc]/hʌsk/; [or]z8;
rouse: [vt]唤醒,唤起;激起; [acc]/raʊz/; [or]z8;
drowse: [v]打瞌睡;发呆;昏昏沉沉地消磨(时光); [n]瞌睡; [acc]/draʊz/; [or]z8;
depose: [v]免职,废黜,作证; [acc]/dɪˈpoʊz/; [or]z8;
flinch: [v]畏缩,退缩; [n]退缩,畏惧; [acc]/flɪntʃ/; [or]z8;
dawdle: [v]闲荡,浪费时间; [acc]/ˈdɔːdl/; [or]z8;
corps: [n](由两个或以上师组成的)军,兵团;一群人;特别小组; [acc]/kɔːr/; [or]z8;
singe: [n](轻微的)烧焦; [v](轻微地)烧焦,烫焦; [acc]/sɪndʒ/; [or]z8;
prerequisite: [n]先决条件,必要条件; adj. 必须先具备的,必要的; [acc]/ˌpriːˈrekwəzɪt/; [or]z8;
captivate: [v]吸引,迷惑; [acc]/ˈkæptɪveɪt/; [or]z8;
honeycomb: [n]蜜蜂巢; [vt]使成蜂巢状;把.弄得千疮百孔; adj. 似蜂巢的; [vi]变成蜂巢状; [acc]/ˈhʌnikoʊm/; [or]z8;
hermitage: [n]隐士生活;隐士住处; [acc]/ˈhɜːrmɪtɪdʒ/; [or]z8;
bypass: [v]绕过;回避; [n]旁路;心脏分流手术; [acc]/ˈbaɪpæs/; [or]z8;
imbecility: [n]愚钝,低能,愚蠢的行为或言语; [acc]/ˌɪmbəˈsɪləti/; [or]z8;
incessant: adj. 无间断的,连续的; [acc]/ɪnˈsesnt/; [or]z8;
redundant: adj. 多余的,过剩的;被下岗的; [acc]/rɪˈdʌndənt/; [or]z8;
despicable: adj. 可鄙的,卑劣的; [acc]/dɪˈspɪkəbl/; [or]z8;
artful: adj. 巧妙的,有技巧的,狡猾的,欺诈的; [acc]/ˈɑːrtfl/; [or]z8;
cranky: adj. 暴躁的;古怪的;动摇的; [acc]/ˈkræŋki/; [or]z8;
prenatal: adj. 产前的,胎儿期的,[医]出生以前的; [acc]/ˌpriːˈneɪtl/; [or]z8;
cohesive: adj. 团结的;紧密结合的;有黏着力的; [acc]/koʊˈhiːsɪv/; [or]z8;
requisition: [n]征用,要求,申请书,引渡要求; [v]征用,申请领取; [acc]/ˌrekwɪˈzɪʃn/; [or]z8;
canvass: [v]仔细检查或详尽地讨论;审查,游说; [n]讨论;细查;劝诱; [acc]/ˈkænvəs/; [or]z8;
perjury: [n]伪证,假誓; [acc]/ˈpɜːrdʒəri/; [or]z8;
intrepid: adj. 无畏的;刚毅的,勇敢的; [acc]/ɪnˈtrepɪd/; [or]z8;
honk: [n]雁叫声,汽车喇叭声; [vi]发雁鸣或汽车喇叭声; [vt]按汽车喇叭; [acc]/hɑːŋk/; [or]z8;
accountancy: [n]会计工作,会计学,会计职业; [acc]/əˈkaʊntənsi/; [or]z8;
carp: [n]鲤鱼; [v]吹毛求疵; [acc]/kɑːrp/; [or]z8;
accessible: adj. 可使用的;可到达的;可进入的;易懂的; [acc]/əkˈsesəbl/; [or]z8;
trample: [v]踩坏(烂),践踏,蔑视; [n]踩踏,蹂躏; [acc]/ˈtræmpl/; [or]z8;
superintend: [v]监督;主管;指挥; [acc]/ˌsuːpərɪnˈtend/; [or]z8;
manure: [n]肥料; [v]施肥于;耕种; [acc]/məˈnʊr/; [or]z8;
salvage: [n]抢救;从灾难中抢救出的物资; [vt]拯救;打捞; [acc]/ˈsælvɪdʒ/; [or]z8;
scour: [v]搜查;洗涤,洗刷,擦洗;冲刷成,冲刷出; [acc]/ˈskaʊər/; [or]z8;
impertinent: adj. 不恰当的,粗鲁的; [acc]/ɪmˈpɜːrtnənt/; [or]z8;
tedium: [n]单调乏味; [acc]/ˈtiːdiəm/; [or]z8;
eaves: [n]屋檐,凸出的边缘; pl. 屋檐; [acc]/iːvz/; [or]z8;
consign: [v]托运,托卖,寄存; [acc]/kənˈsaɪn/; [or]z8;
sophist: [n]诡辩家,哲学家; [acc]/ˈsɑːfɪst/; [or]z8;
grisly: adj. 恐怖的;令人震惊的;厉害的; [acc]/ˈɡrɪzli/; [or]z8;
boggle: [v]畏缩不前;惊恐;使..困惑; [acc]/ˈbɑːɡl/; [or]z8;
secluded: adj. 隐遁的,隔绝的; [acc]/sɪˈkluːdɪd/; [or]z8;
daft: adj. 愚蠢的; [acc]/dæft/; [or]z8;
hepatitis: [n]肝炎; [acc]/ˌhepəˈtaɪtɪs/; [or]z8;
redundancy: [n]裁员,[计][数]冗余(等于redundance),人浮于事; [acc]/rɪˈdʌndənsi/; [or]z8;
enshrine: [v]把.置于神龛内;铭记,珍藏;把.奉为神圣; [acc]/ɪnˈʃraɪn/; [or]z8;
fetter: [n]脚镣;束缚; [vt]给.上脚镣;束缚; [acc]/ˈfetər/; [or]z8;
consignment: [n]委托;运送;托付物; [acc]/kənˈsaɪnmənt/; [or]z8;
salutary: adj. 有益的,有益健康的; [acc]/ˈsæljəteri/; [or]z8;
conspire: [v]密谋策划;共谋,串通一气; [acc]/kənˈspaɪər/; [or]z8;
discrete: adj. 分开的;不连续的; [acc]/dɪˈskriːt/; [or]z8;
sheath: [n](刀,剑)鞘,护套,(植)叶鞘; [acc]/ʃiːθ/; [or]z8;
boo: [n]嘘声; [v]嘘(以表示不满或嘲笑); [acc]/buː/; [or]z8;
mythology: [n]神话,神话学; [acc]/mɪˈθɑːlədʒi/; [or]z8;
precinct: [n]管理区,管辖区;选区;界限,范围; [acc]/ˈpriːsɪŋkt/; [or]z8;
hangnail: [n]手指头的倒拉刺(指甲旁的逆刺皮); [acc]/ˈhæŋneɪl/; [or]z8;
ascertain: [v]探知,弄清,查明(真相等); [acc]/ˌæsərˈteɪn/; [or]z8;
observant: adj. 机警的;严格遵守的;善于观察的; [acc]/əbˈzɜːrvənt/; [or]z8;
paraphrase: [v]解释,释义; [n]转述,释义; [acc]/ˈpærəfreɪz/; [or]z8;
anguish: [n]痛苦;苦恼; [v]感到极度痛苦; [acc]/ˈæŋɡwɪʃ/; [or]z8;
smolder: [v]无火焰地闷烧,(仇恨,嫉妒,愤怒等)在心里郁积; [n]焖烧,文火,冒烟; [acc]/ˈsmoʊldər/; [or]z8;
systematize: [v]使系统化;使组织化;将.分类; [acc]/ˈsɪstəmətaɪz/; [or]z8;
dilettante: [n]半吊子; [acc]/ˌdɪləˈtænti/; [or]z8;
polemic: [n]争论,论战,驳斥; adj. 论战的;喜欢争论的; [acc]/pəˈlemɪk/; [or]z8;
concerto: [n][音乐]协奏曲; [acc]/kənˈtʃɜːrtoʊ/; [or]z8;
operative: [n]技工;特工;侦探; adj. 运转着的,从事生产劳动的;有效的; [acc]/ˈɑːpərətɪv/; [or]z8;
literate: adj. 受过教育的;精通文学的; [n]学者; [acc]/ˈlɪtərət/; [or]z8;
icing: [n]结冰,糖衣,酥皮; [v]冰冻; [acc]/ˈaɪsɪŋ/; [or]z8;
girdle: [n]腰带;妇女紧身褡; [v]围,包围,环绕; [acc]/ˈɡɜːrdl/; [or]z8;
duo: [n]一对,二重唱; pref. 表示"二";"一对"; [acc]/ˈduːoʊ/; [or]z8;
abiding: adj. 持久的;永久的,不变的; [acc]/əˈbaɪdɪŋ/; [or]z8;
premonition: [n]预告,征兆,预感; [acc]/ˌpriːməˈnɪʃn/; [or]z8;
haggard: adj. 憔悴的,消瘦的; [n]哈格德;未驯服的鹰;悍鹰; [acc]/ˈhæɡərd/; [or]z8;
deft: adj. 灵巧的,敏捷的,熟练的; [acc]/deft/; [or]z8;
matron: [n]妇女;保姆;女舍监; [acc]/ˈmeɪtrən/; [or]z8;
doodle: [v](无目的地)乱画,漫无目的地打发时光; [n]涂鸦; [acc]/ˈduːdl/; [or]z8;
pheasant: [n]野鸡,雉科鸟; [acc]/ˈfeznt/; [or]z8;
nectar: [n]花蜜,甘露; adj. 〈古〉充满美酒的,芳香甜蜜的; [acc]/ˈnektər/; [or]z8;
invoke: [v]调用,祈求,恳求,引起; [acc]/ɪnˈvoʊk/; [or]z8;
dandelion: [n]蒲公英; [acc]/ˈdændɪlaɪən/; [or]z8;
retribution: [n]报应,惩罚,报答,报偿; [acc]/ˌretrɪˈbjuːʃn/; [or]z8;
threadbare: adj. 磨破的,衣衫褴褛的,乏味的,俗套的; [acc]/ˈθredber/; [or]z8;
hypocrisy: [n]虚伪;伪善; [acc]/hɪˈpɑːkrəsi/; [or]z8;
remedial: adj. 治疗的;补救的;矫正的; [acc]/rɪˈmiːdiəl/; [or]z8;
abhor: [v]痛恨;憎恶; [acc]/əbˈhɔːr/; [or]z8;
viral: adj. 滤过性毒菌引起的;滤过性毒菌的; [n]病毒式传播;[经]病毒式营销; [acc]/ˈvaɪrəl/; [or]z8;
defraud: [v]欺诈,诈取,骗取; [acc]/dɪˈfrɔːd/; [or]z8;
fanciful: adj. 异想天开的;别出心裁的; [acc]/ˈfænsɪfl/; [or]z8;
dope: [n]毒品;粘稠物,胶状物,添加剂;傻瓜,蠢货;内幕消息; [v]给.服用麻醉剂; adj. <俚>极好的; [acc]/doʊp/; [or]z8;
bemoan: [v]哀悼;为..恸哭;哀叹,对..表示惋惜; [acc]/bɪˈmoʊn/; [or]z8;
multilateral: adj. [数学]多边的;多国之间的,多国(或多方)参加的; [acc]/ˌmʌltiˈlætərəl/; [or]z8;
ignominy: [n]耻辱,不体面,丑行; [acc]/ˈɪɡnəmɪni/; [or]z8;
credibility: [n]可靠性,可信性,确实有效性; [acc]/ˌkredəˈbɪləti/; [or]z8;
retrieve: [v]取回,重新得到,挽回,检索; [acc]/rɪˈtriːv/; [or]z8;
eject: [v](使)弹出;喷射;放逐; [acc]/iˈdʒekt/; [or]z8;
charismatic: adj. 超凡魅力的;神赐能力的;有魅力的; [n]有特恩的基督徒; [acc]/ˌkærɪzˈmætɪk/; [or]z8;
barrister: [n]辩护律师,出庭律师; [acc]/ˈbærɪstər/; [or]z8;
euthanasia: [n]安乐死,安乐死术; [acc]/ˌjuːθəˈneɪʒə/; [or]z8;
pivot: [n]枢轴,中心; [v]以..为中心转动; adj. 枢轴的;关键的; [acc]/ˈpɪvət/; [or]z8;
pastry: [n]糕点,点心; [acc]/ˈpeɪstri/; [or]z8;
repertoire: [n](剧团,演员等的)全部节目;全部才能; [acc]/ˈrepərtwɑːr/; [or]z8;
frigid: adj. 寒冷的,冷淡的,死板的,呆板的,性冷淡的; [acc]/ˈfrɪdʒɪd/; [or]z8;
debris: [n]废墟,残骸; [acc]/dəˈbriː/; [or]z8;
homage: [n]敬意;尊敬;效忠; [acc]/ˈhɑːmɪdʒ/; [or]z8;
voluminous: adj. 大量的;长篇的,多产的;庞大的; [adv]宽松地;容量大地;篇幅长地; [n]宽松;容量大,篇幅长; [acc]/vəˈluːmɪnəs/; [or]z8;
furtive: adj. 偷偷的,秘密的,鬼鬼祟祟的,; [acc]/ˈfɜːrtɪv/; [or]z8;
confederacy: [n]联盟;同谋; [acc]/kənˈfedərəsi/; [or]z8;
poppy: [n]罂粟花,罂粟属植物; [acc]/ˈpɑːpi/; [or]z8;
sexist: [n]性别歧视者,男性至上主义者; adj. 性别主义者的,性别歧视者的; [acc]/ˈseksɪst/; [or]z8;
wring: [v]扭,榨取,强求;绞,拧,扭(尤指脖子); [n]扭,榨取,强求;折磨; [acc]/rɪŋ/; [or]z8;
suburbanite: [n]郊区居民; [acc]/səˈbɜːrbənaɪt/; [or]z8;
canny: adj. 精明的,谨慎的,节约的; [adv]<苏格兰>仔细地; [acc]/ˈkæni/; [or]z8;
assorted: adj. 各式各样的; [acc]/əˈsɔːrtəd/; [or]z8;
prominence: [n]卓越;突出物;显著,突出; [acc]/ˈprɑːmɪnəns/; [or]z8;
writhe: [v]扭动(身体);扭曲变形;缠绕打结; [n]扭动;翻腾;苦恼; [acc]/raɪð/; [or]z8;
forbidding: adj. 可怕的,令人生畏的;(表情)冷峻的;形势险恶的; [acc]/fərˈbɪdɪŋ/; [or]z8;
platoon: [n]排,一组,一队人,警察队; [vt]把.分成小队; [acc]/pləˈtuːn/; [or]z8;
estimable: adj. 可估计的;可尊敬的;有价值的; [acc]/ˈestɪməbl/; [or]z8;
bravado: [n]故作勇敢,逞能; [acc]/brəˈvɑːdoʊ/; [or]z8;
concede: [v]承认;承认失败;让给,让与;让步; [acc]/kənˈsiːd/; [or]z8;
lance: [n]长矛; [v]以长矛攻击; [acc]/læns/; [or]z8;
ovation: [n]热烈欢迎,欢呼; [acc]/oʊˈveɪʃn/; [or]z8;
electorate: [n]选民;选区; [acc]/ɪˈlektərət/; [or]z8;
bulge: [n]凸出部分; [v]凸出,膨胀; [acc]/bʌldʒ/; [or]z8;
harp: [n]竖琴; [v]不停地说,喋喋不休; [acc]/hɑːrp/; [or]z8;
delimit: [v]定界,划界; [acc]/diˈlɪmɪt/; [or]z8;
octopus: [n]章鱼; [acc]/ˈɑːktəpʊs/; [or]z8;
diagonal: [n]对角线; adj. 对角线的;斜的;斜纹的; [acc]/daɪˈæɡənl/; [or]z8;
embezzle: [v]盗用,挪用,贪污; [acc]/ɪmˈbezl/; [or]z8;
dividend: [n](股份的)红利,回报,效益,被除数; [acc]/ˈdɪvɪdend/; [or]z8;
accession: [n]加入(国际组织);登基,即位;增加物;增加;接近,到达;同意; [vt]登录,登入新增目录;获得; [acc]/ækˈseʃn/; [or]z8;
quell: [v]镇压,消除,减轻(激动,恐惧等); [n]镇压,平息,减轻; [acc]/kwel/; [or]z8;
dinghy: [n]无篷小船,小艇; [acc]/ˈdɪŋi/; [or]z8;
varicose: adj. ［医］静脉曲张的,治疗静脉曲张用的; [acc]/'værɪˌkoʊs/; [or]z8;
transfigure: [v]美观,改观; [acc]/trænsˈfɪɡjər/; [or]z8;
nudity: [n]裸露,裸体像; [acc]/ˈnuːdəti/; [or]z8;
mirth: [n]欢乐,欢笑; [acc]/mɜːrθ/; [or]z8;
enmity: [n]敌意,憎恨; [acc]/ˈenməti/; [or]z8;
jargon: [n]行话,术语;黄锆石; [acc]/ˈdʒɑːrɡən/; [or]z8;
grandiose: adj. 浮夸的,夸大的,宏伟的; [acc]/ˈɡrændioʊs/; [or]z8;
nicotine: [n]尼古丁; [acc]/ˈnɪkətiːn/; [or]z8;
detest: [vt]厌恶,憎恨,痛恨; [acc]/dɪˈtest/; [or]z8;
piracy: [n]海上掠夺;剽窃;侵犯版权; [acc]/ˈpaɪrəsi/; [or]z8;
zealot: [n]狂热份子,犹太教狂热信徒; [acc]/ˈzelət/; [or]z8;
gastritis: [n][医]胃炎; [acc]/ɡæˈstraɪtɪs/; [or]z8;
elude: [v]逃避,躲避;使.错过,使.找不到;使.不记得;把.难住; [acc]/iˈluːd/; [or]z8;
invoice: [n]发票; [v]开发票;记清单; [acc]/ˈɪnvɔɪs/; [or]z8;
occidental: [n]西方,西洋人; adj. 西方(的); [acc]/ˌɑːksɪˈdentl/; [or]z8;
mania: [n]癫狂,狂热; [acc]/ˈmeɪniə/; [or]z8;
wayward: adj. 任性的,不规则的,刚愎的; [acc]/ˈweɪwərd/; [or]z8;
spout: [v]滔滔不绝地讲;喷出;(鲸鱼)喷射; [vt]把.典当掉; [n]喷口;水管;水柱;水龙卷;水落管; [acc]/spaʊt/; [or]z8;
console: [v]安慰,慰问; [n]控制台,仪表板;落地柜; [acc]/kənˈsoʊl/; [or]z8;
billow: [n]巨浪,波浪般滚滚向前的东西;滚滚烟尘; [v]翻腾; [acc]/ˈbɪloʊ/; [or]z8;
relent: [v]变温和,变宽厚;减弱;缓和;终于答应;不再拒绝; [acc]/rɪˈlent/; [or]z8;
panoramic: adj. 全景的; [acc]/ˌpænəˈræmɪk/; [or]z8;
marital: adj. 婚姻的; [acc]/ˈmærɪtl/; [or]z8;
whack: [v]重打;猛击;击败;削减; [n]重击;尝试;份儿;机会; [acc]/wæk/; [or]z8;
flak: [n]高射炮,抨击,谴责; [acc]/flæk/; [or]z8;
deprecate: [v]反对;轻视; [acc]/ˈdeprəkeɪt/; [or]z8;
ajar: adj. 半开的;微开的; [acc]/əˈdʒɑːr/; [or]z8;
majestic: adj. 威严的;雄伟的;壮丽的; [acc]/məˈdʒestɪk/; [or]z8;
hallmark: [n]特点;品质证明; [v]给.盖上品质证明印记;使具有.标志; [acc]/ˈhɔːlmɑːrk/; [or]z8;
fleeting: adj. 短暂的,飞逝的; [acc]/ˈfliːtɪŋ/; [or]z8;
malignant: adj. 恶性的,恶毒的,充满恨意的; [n]怀有恶意的人;保王党员; [acc]/məˈlɪɡnənt/; [or]z8;
constrain: [v]约束;限制;强迫; [acc]/kənˈstreɪn/; [or]z8;
covet: [v]垂涎;觊觎; [acc]/ˈkʌvət/; [or]z8;
gambit: [n](常指带风险的)策略,弃兵局(指国际象棋开局弃一卒以取得优势),话题,开始,开场白; [acc]/ˈɡæmbɪt/; [or]z8;
slither: [v](蛇)滑动,滑行; [n]滑动;滑行; [acc]/ˈslɪðər/; [or]z8;
acumen: [n]聪明,敏锐; [acc]/ˈækjəmən/; [or]z8;
sabotage: [n]怠工,蓄意破坏,妨碍; [v]怠工,从事破坏活动,故意阻挠; [acc]/ˈsæbətɑːʒ/; [or]z8;
disrepute: [n]不光彩,坏名声; [acc]/ˌdɪsrɪˈpjuːt/; [or]z8;
erotic: adj. 性爱的,性欲的,色情的; [n]好色之徒; [adv]引起性欲地; [acc]/ɪˈrɑːtɪk/; [or]z8;
anarchy: [n]无政府状态,政治混乱; [acc]/ˈænərki/; [or]z8;
vexation: [n]苦恼,恼怒,令人烦恼的事; [acc]/vekˈseɪʃn/; [or]z8;
duplicity: [n]口是心非;表里不一;不诚实; [acc]/duːˈplɪsəti/; [or]z8;
impending: adj. 即将到来的;迫在眉睫的,紧急的; [acc]/ɪmˈpendɪŋ/; [or]z8;
zenith: [n]顶点,顶峰;全盛; [acc]/ˈziːnɪθ/; [or]z8;
slink: [v]潜逃,溜走,早产,潜逃; [n]早产的动物,鬼鬼祟祟的人; adj. 早产的; [acc]/slɪŋk/; [or]z8;
overview: [n]综述,概观; [acc]/ˈoʊvərvjuː/; [or]z8;
sanctuary: [n]圣堂,避难所; [acc]/ˈsæŋktʃueri/; [or]z8;
pantomime: [n]哑剧,〈英〉(圣诞节上演的)童话剧; [vi]打手势,演哑剧; [acc]/ˈpæntəmaɪm/; [or]z8;
reverence: [n]崇敬,尊严,敬礼; [v]敬畏,尊敬; [acc]/ˈrevərəns/; [or]z8;
afield: [adv]在战场上,去野外,在远处,远离着; [acc]/əˈfiːld/; [or]z8;
laurel: [n]月桂树,桂冠,殊荣; [v]使戴桂冠;给以荣誉; [acc]/ˈlɔːrəl/; [or]z8;
maxim: [n]格言;准则;座右铭; [acc]/ˈmæksɪm/; [or]z8;
rend: [v]撕碎;分裂;强夺; [acc]/rend/; [or]z8;
abyss: [n]深渊;深不可测的事物,绝境;深海;深邃;炼狱; [acc]/əˈbɪs/; [or]z8;
nuance: [n]细微差别; [acc]/ˈnuːɑːns/; [or]z8;
curt: adj. 简略的; [acc]/kɜːrt/; [or]z8;
myriad: [n]无数;极大数量; adj. 无数的; [acc]/ˈmɪriəd/; [or]z8;
censure: [v]责难,责备; [n]责难,责备; [acc]/ˈsenʃər/; [or]z8;
unify: [v]使联合,统一;使相同,使一致; [acc]/ˈjuːnɪfaɪ/; [or]z8;
ambivalent: adj. 矛盾的;摇摆不定的;好恶相克的; [n]两性人; [acc]/æmˈbɪvələnt/; [or]z8;
languid: adj. 没精打采的,倦怠的; [acc]/ˈlæŋɡwɪd/; [or]z8;
dichotomy: [n]二分,本质对立; [acc]/daɪˈkɑːtəmi/; [or]z8;
aerosol: [n]烟雾,［化］气溶,烟雾剂; adj. 喷雾的,喷雾器的; [acc]/ˈerəsɔːl/; [or]z8;
nonstop: adj. 直达的,不休息的,不着陆的; [adv]不休息地; [n]直达车,班机; [acc]/nɒn'stɒp/; [or]z8;
camouflage: [n]伪装;掩饰; [v]使改头换面,伪装,掩饰;欺瞒; [acc]/ˈkæməflɑːʒ/; [or]z8;
gladiator: [n]职业格斗者;角斗士,斗剑者; [acc]/ˈɡlædieɪtər/; [or]z8;
clamber: [v]攀登,爬上; [n]攀登,攀爬; [acc]/ˈklæmbər/; [or]z8;
harangue: [n]长篇大论; [v]高谈阔论;大声训斥; [acc]/həˈræŋ/; [or]z8;
redolent: adj. 气味强烈的,芬芳的,令人想起..的; [acc]/ˈredələnt/; [or]z8;
flabby: adj. (肌肉)松软的,意志薄弱的; [adv]肌肉松垂地,肥胖地; [n](肌肉等)不结实,松弛; [acc]/ˈflæbi/; [or]z8;
adjoin: [v]与.毗连;贴近; [acc]/əˈdʒɔɪn/; [or]z8;
mercantile: adj. 商人的,商业的; [acc]/ˈmɜːrkəntaɪl/; [or]z8;
protagonist: [n]主角,领导者,积极参加者; [acc]/prəˈtæɡənɪst/; [or]z8;
demobilize: [v]遣散,使退伍; [acc]/diːˈmoʊbəlaɪz/; [or]z8;
dogma: [n]教条;武断的意见; adj. 教义的,教条的,信条的; [acc]/ˈdɔːɡmə/; [or]z8;
ballad: [n]歌谣;小曲; [acc]/ˈbæləd/; [or]z8;
pollster: [n]民意测验专家,民意调查人;整理民意测验结果的人; [acc]/ˈpoʊlstər/; [or]z8;
curtail: [vt]截短;削减;剥夺.特权; [acc]/kɜːrˈteɪl/; [or]z8;
chum: [n]密友,鱼饵; [v]结为密友,用鱼饵引诱; [acc]/tʃʌm/; [or]z8;
fraternal: adj. 兄弟的,兄弟般的,友爱的; [acc]/frəˈtɜːrnl/; [or]z8;
silica: [n]二氧化硅,硅石; [acc]/ˈsɪlɪkə/; [or]z8;
rigmarole: [n]冗长无聊的废话; [acc]/ˈrɪɡməroʊl/; [or]z8;
amnesty: [n]赦免; [v]对.实行大赦; [acc]/ˈæmnəsti/; [or]z8;
aversion: [n]厌恶;讨厌的人,(或东西); [acc]/əˈvɜːrʒn/; [or]z8;
iris: [n]虹膜,鸢尾属植物; [acc]/ˈaɪrɪs/; [or]z8;
affront: [v]冒犯,有意冒犯,公开侮辱;面对; [n]轻蔑;公开侮辱; [acc]/əˈfrʌnt/; [or]z8;
obesity: [n]肥胖; [acc]/oʊˈbiːsəti/; [or]z8;
divulge: [v]泄露,透露; [acc]/daɪˈvʌldʒ/; [or]z8;
sinuous: adj. 弯曲的,蜿蜒的; [acc]/ˈsɪnjuəs/; [or]z8;
ensign: [n]旗,海军少尉,徽章; [acc]/ˈensən/; [or]z8;
mockery: [n]嘲弄;笑柄;徒劳无功;拙劣可笑的模仿或歪曲; [acc]/ˈmɑːkəri/; [or]z8;
injurious: adj. 有害的,造成伤害的; [acc]/ɪnˈdʒʊriəs/; [or]z8;
downright: adj. 明白的,直率的,显明的; [adv]完全,彻底,全然; [acc]/ˈdaʊnraɪt/; [or]z8;
snub: [n]冷落,怠慢; [vt]冷落;断然拒绝;掐灭; adj. 故意冷落的,断然拒绝的,斥责的; [acc]/snʌb/; [or]z8;
verbatim: adj. 逐字的; [adv]逐字地; [acc]/vɜːrˈbeɪtɪm/; [or]z8;
dab: [n]轻拍,少量,熟手,比目鱼; [v]轻拍,涂,轻擦,轻敷; [acc]/dæb/; [or]z8;
juxtapose: [v]使并排;使并置;使并列; [acc]/ˌdʒʌkstəˈpoʊz/; [or]z8;
retainer: [n]保持器;家臣;保持者;[机]护圈;预付费用; [acc]/rɪˈteɪnər/; [or]z8;
nag: [n]老马,驽马,劣等竞赛马,(作坐骑的)矮小马,唠叨; [v]不断地唠叨,恼人; [acc]/næɡ/; [or]z8;
fray: [n]吵架,打斗,磨损处; [v]磨损,摩擦,使关系紧张; [acc]/freɪ/; [or]z8;
reverent: adj. 虔诚的,恭敬的; [acc]/ˈrevərənt/; [or]z8;
inexhaustible: adj. 无穷无尽的,取之不竭的; [acc]/ˌɪnɪɡˈzɔːstəbl/; [or]z8;
squint: [v]斜视,眯眼睛看; adj. 斜着眼的;斜视的;细眯着眼看的;倾斜的;偏移的; [n]斜视眼;斜视斜眼;趋势; [acc]/skwɪnt/; [or]z8;
amphibian: [n]两栖动物;水陆两用飞机和车辆; adj. 两栖类的;[车辆]水陆两用的;具有双重性格的; [acc]/æmˈfɪbiən/; [or]z8;
bewitch: [v]施魔法于,蛊惑,使着迷; [acc]/bɪˈwɪtʃ/; [or]z8;
hoard: [v]贮藏,秘藏; [n]贮藏物; [acc]/hɔːrd/; [or]z8;
saline: adj. 咸的,含盐的; [acc]/ˈseɪliːn/; [or]z8;
precipitous: adj. 险峻的;急躁的,鲁莽的; [acc]/prɪˈsɪpɪtəs/; [or]z8;
extrovert: [v]变成外向性格;使成外向性格; [n]性格外向者; adj. 性格外向的; [acc]/ˈekstrəvɜːrt/; [or]z8;
insurgent: [n]叛乱分子; adj. 叛乱的,起事的; [acc]/ɪnˈsɜːrdʒənt/; [or]z8;
choreography: [n]编舞艺术;舞蹈编排;舞蹈编排; [acc]/ˌkɔːriˈɑːɡrəfi/; [or]z8;
pristine: adj. 原始的;古时的;纯朴的;崭新的; [acc]/ˈprɪstiːn/; [or]z8;
bequeath: [v]遗赠(留); [acc]/bɪˈkwiːð/; [or]z8;
obsessive: adj. 强迫性的;着迷的;分神的; [n]强迫症患者; [acc]/əbˈsesɪv/; [or]z8;
apiece: [adv]每人;每个;各自地; [acc]/əˈpiːs/; [or]z8;
psychiatrist: [n]精神病医生;精神病学家; [acc]/saɪˈkaɪətrɪst/; [or]z8;
braid: [n]辫子;编带; [vi]交叉往来,迂回前进; [vt]编织;把头发编成辫子; [acc]/breɪd/; [or]z8;
pastoral: adj. 田园生活的,牧师的; [n]牧歌;田园诗;田园景色;牧师写给教区居民的公开信; [acc]/ˈpæstərəl/; [or]z8;
ruinous: adj. 毁坏的;毁灭性的,破坏性的; [acc]/ˈruːɪnəs/; [or]z8;
subjection: [n]隶属;服从;支配; [acc]/səbˈdʒekʃn/; [or]z8;
feverish: adj. 发烧的;狂热的,极其兴奋的;不稳定的; [acc]/ˈfiːvərɪʃ/; [or]z8;
jolt: [n]猛的一击,摇晃,震惊; [v](使)颠簸,摇晃;使震惊; [acc]/dʒoʊlt/; [or]z8;
hoary: adj. 年纪高迈的;(头发等)灰白的;古老的; [acc]/ˈhɔːri/; [or]z8;
hamper: [v]阻碍,妨碍,牵制; [n](有盖的)大篮子; [acc]/ˈhæmpər/; [or]z8;
falcon: [n]猎鹰; [acc]/ˈfælkən/; [or]z8;
bum: [n]流浪汉,乞讨者,游手好闲的人; [v]流浪,乞讨,过游民生活; adj. 差劲的; [acc]/bʌm/; [or]z8;
uprising: [n]起义;升起; adj. 升起的; [v]起义;升起; [acc]/ˈʌpraɪzɪŋ/; [or]z8;
hereafter: [adv]今后,从此以后; [n]将来,来世; [acc]/ˌhɪrˈæftər/; [or]z8;
evasive: adj. 逃避的;托辞的,推托的; [acc]/ɪˈveɪsɪv/; [or]z8;
fad: [n]风尚,风行一时的东西; adj. 极好的; [acc]/fæd/; [or]z8;
skipper: [n]队长,船长,机长; [v]带领,作.的船长(或机长); [acc]/ˈskɪpər/; [or]z8;
pancake: [n]烙饼,薄饼; [acc]/ˈpænkeɪk/; [or]z8;
saga: [n]传奇故事;冒险故事;一连串的事件(或经历); [acc]/ˈsɑːɡə/; [or]z8;
unparalleled: adj. 无比的,无双的,空前的; [acc]/ʌnˈpærəleld/; [or]z8;
insipid: adj. 淡而无味的;枯燥乏味的; [acc]/ɪnˈsɪpɪd/; [or]z8;
coy: adj. 腼腆的,怕羞的;卖弄风情的; [acc]/kɔɪ/; [or]z8;
wrench: [n]扳手;痛苦,难受;猛扭,猛拉; [v]猛拧;挣脱;使扭伤; [acc]/rentʃ/; [or]z8;
ballast: [n](船等)压舱物;稳定因素;<比喻>沉着; [vt]给某物装上压舱物;给.铺道渣;使稳定;使沉着; [acc]/ˈbæləst/; [or]z8;
dosage: [n]剂量; [acc]/ˈdoʊsɪdʒ/; [or]z8;
admonish: [v]训诫,警告; [acc]/ədˈmɑːnɪʃ/; [or]z8;
eye-catching: adj. 引人注目的;耀眼的; [acc]/ˈaɪ kætʃɪŋ/; [or]z8;
unwind: [vt]展开,放松,伸直; [acc]/ˌʌnˈwaɪnd/; [or]z8;
tab: [n]标签,制表,帐单; [v]给.贴标签; [acc]/tæb/; [or]z8;
valve: [n]阀门,活门; [acc]/vælv/; [or]z8;
expansive: adj. 广阔的,扩张的,豪爽的; [acc]/ɪkˈspænsɪv/; [or]z8;
upstart: [n]傲慢自负的人,暴发户,自命不凡的人; adj. 暴富的,自命不凡的; [v](使)突然跳起,(使)崛起; [acc]/ˈʌpstɑːrt/; [or]z8;
tonic: [n]补药;主调音或基音; adj. 滋补的;声调的;使精神振作的; [acc]/ˈtɑːnɪk/; [or]z8;
parenthood: [n]亲子关系,父母身份; [acc]/ˈperənthʊd/; [or]z8;
jeer: [n]嘲笑,戏弄,揶揄的言语; [v]嘲笑,戏弄; [acc]/dʒɪr/; [or]z8;
anomaly: [n]异常,不规则,反常事物; [acc]/əˈnɑːməli/; [or]z8;
beguile: [v]欺骗,迷住,吸引; [acc]/bɪˈɡaɪl/; [or]z8;
airborne: adj. 空运的;在空中的; [acc]/ˈerbɔːrn/; [or]z8;
adjunct: [n]附属物,配件,添加剂;助手,部下; adj. 附加的,辅助的,下级的; [acc]/ˈædʒʌŋkt/; [or]z8;
marijuana: [n]大麻,大麻中的毒质; [acc]/ˌmærəˈwɑːnə/; [or]z8;
disprove: [v]反驳,证明.是虚假的; [acc]/ˌdɪsˈpruːv/; [or]z8;
teeter: [v]使..摇摆;使..上下晃动;蹒跚; [n]跷跷板;摇摆; [acc]/ˈtiːtər/; [or]z8;
mortar: [n]小臼,乳钵,迫击炮,(砌砖用的)灰浆; [v]用迫击炮攻击;用灰泥涂抹; [acc]/ˈmɔːrtər/; [or]z8;
makeshift: adj. 临时的,权宜之计的,凑合的; [n]权宜之计,凑合,临时措施,将就; [acc]/ˈmeɪkʃɪft/; [or]z8;
decency: [n]正派,体面,庄重,合乎礼仪,礼貌; [acc]/ˈdiːsnsi/; [or]z8;
suffice: [v]足够; [acc]/səˈfaɪs/; [or]z8;
phenomenal: adj. 非凡的;现象的;显著的; [acc]/fəˈnɑːmɪnl/; [or]z8;
daunt: [v]使气馁,使畏缩,威吓; [acc]/dɔːnt/; [or]z8;
deterrent: [n]威慑物; [v]威慑的; [acc]/dɪˈtɜːrənt/; [or]z8;
shred: [n]碎片,少量,毁灭; [v]切成细条,撕成碎片; [acc]/ʃred/; [or]z8;
unsightly: adj. 难看的; [acc]/ʌnˈsaɪtli/; [or]z8;
dingy: adj. 昏暗的,肮脏的;褴褛的; [n]同"dingey"; [acc]/ˈdɪndʒi/; [or]z8;
felicity: [n]幸福,快乐,幸运; [acc]/fəˈlɪsəti/; [or]z8;
exalt: [v]提升,提拔,赞扬,使得意; [acc]/ɪɡˈzɔːlt/; [or]z8;
derision: [n]嘲笑,嘲笑的目标,笑柄; [acc]/dɪˈrɪʒn/; [or]z8;
rudimentary: adj. 基本的,初期的;发育不完全的;退化的; [acc]/ˌruːdɪˈmentri/; [or]z8;
flippant: adj. 无礼的,轻率的,随意的; [acc]/ˈflɪpənt/; [or]z8;
indelible: adj. (印记等)无法擦除的,无法忘怀的; [acc]/ɪnˈdeləbl/; [or]z8;
rancid: adj. 腐臭的;令人作呕的,讨厌的; [acc]/ˈrænsɪd/; [or]z8;
horrendous: adj. 可怕的,令人惊惧的; [acc]/həˈrendəs/; [or]z8;
tripod: [n]三脚架,三脚桌; [acc]/ˈtraɪpɑːd/; [or]z8;
holly: [n]冬青树(等于holm oak); adj. 冬青属植物的; [acc]/ˈhɑːli/; [or]z8;
levity: [n]轻率,轻浮,多变,不稳定; [acc]/ˈlevəti/; [or]z8;
finalist: [n]参加决赛的选手; [acc]/ˈfaɪnəlɪst/; [or]z8;
abacus: [n]算盘; [acc]/ˈæbəkəs/; [or]z8;
outgrow: [v]长得过大而不适于;长大成熟而不再;长的比..快; [acc]/ˌaʊtˈɡroʊ/; [or]z8;
prolific: adj. 多育的,多产的;丰富的,富饶的; [acc]/prəˈlɪfɪk/; [or]z8;
marginal: adj. 微小的,不重要的;仅以微弱多数票获胜的; [n](议会或地方委员会的)边缘席位; [acc]/ˈmɑːrdʒɪnl/; [or]z8;
regressive: adj. 回归的,后退的,退化的; [acc]/rɪˈɡresɪv/; [or]z8;
penalize: [v]置(某人)于不利地位,处罚; [acc]/ˈpiːnəlaɪz/; [or]z8;
stately: adj. 雄伟的;庄重的,庄严的; [adv]雄伟,壮观; [acc]/ˈsteɪtli/; [or]z8;
grapple: [v]抓住;格斗; [n]抓住;格斗; [acc]/ˈɡræpl/; [or]z8;
veal: [n]小牛肉; [acc]/viːl/; [or]z8;
entourage: [n]随从,周围,环境; [acc]/ˈɑːnturɑːʒ/; [or]z8;
outspoken: adj. 直言的,坦率的; [acc]/aʊtˈspoʊkən/; [or]z8;
flux: [n]流动,不断的变动; [acc]/flʌks/; [or]z8;
prodigy: [n]天才; [acc]/ˈprɑːdədʒi/; [or]z8;
inflammatory: adj. 炎症性的;煽动性的;激动的; [acc]/ɪnˈflæmətɔːri/; [or]z8;
suffrage: [n]选举权,投票权; [acc]/ˈsʌfrɪdʒ/; [or]z8;
figurehead: [n]名义领袖; [acc]/ˈfɪɡjərhed/; [or]z8;
cardiac: adj. 心脏的,心脏病的; [n]心脏病患者;强心剂;健胃剂; [acc]/ˈkɑːrdiæk/; [or]z8;
whisk: [n]扫帚;毛掸子;搅拌器,打蛋器;拂; [v]扫;拂;挥动;搅拌;飞奔; [acc]/wɪsk/; [or]z8;
momentum: [n](物理)动量;势头;动力; [acc]/moʊˈmentəm/; [or]z8;
domesticate: [vt]使习惯于家庭生活;驯养;引进; [acc]/dəˈmestɪkeɪt/; [or]z8;
piety: [n]虔诚,虔诚的行为或语言; [acc]/ˈpaɪəti/; [or]z8;
inundate: [v]淹没,泛滥; [acc]/ˈɪnʌndeɪt/; [or]z8;
mesmerize: [v]施催眠术;吸引,使神魂颠倒; [acc]/ˈmezməraɪz/; [or]z8;
lenience: [n]宽大,温和; [acc]/'liːnɪəns/; [or]z8;
impassioned: adj. 慷慨激昂的,充满激情的; [acc]/ɪmˈpæʃnd/; [or]z8;
interject: [v]突然插入,插嘴; [acc]/ˌɪntərˈdʒekt/; [or]z8;
beige: [n]米黄色; adj. 浅褐色的,米黄色的; [acc]/beɪʒ/; [or]z8;
veer: [n]方向的转变; [v]转向,改变(话题等),放松(绳,缆等); [acc]/vɪr/; [or]z8;
eerie: adj. 胆怯的,引起恐惧的; [acc]/ˈɪri/; [or]z8;
generic: [n]无注册商标产品;通名; adj. 一般的;非商标的;属的,类的; [acc]/dʒəˈnerɪk/; [or]z8;
gruesome: adj. 阴森的;可怕的; [acc]/ˈɡruːsəm/; [or]z8;
combustible: adj. 易燃的;易激动的; [n]可燃物;易燃物; [acc]/kəmˈbʌstəbl/; [or]z8;
carnal: adj. 肉体的,肉欲的,性欲的,色欲的,淫荡的; [acc]/ˈkɑːrnl/; [or]z8;
impetuous: adj. 冲动的,鲁莽的; [acc]/ɪmˈpetʃuəs/; [or]z8;
obsolete: adj. 已过时的;已废弃的; [v]使过时;使作废; [n]废词;被废弃的事物; [acc]/ˌɑːbsəˈliːt/; [or]z8;
deadlock: [vt](使)相持不下; [vi]僵持; [n]僵局;不分胜负; [acc]/ˈdedlɑːk/; [or]z8;
warp: [n]弯曲,歪曲,偏见; [v]使变形,使有偏见,曲解; [acc]/wɔːrp/; [or]z8;
metabolism: [n]新陈代谢; [acc]/məˈtæbəlɪzəm/; [or]z8;
discredit: [v]使不相信,使怀疑;败坏.的名声; [n]丧失信誉,丧失名誉;败坏名声的人或事,耻辱; [acc]/dɪsˈkredɪt/; [or]z8;
certitude: [n]确实;确信;必然性; [acc]/ˈsɜːrtɪtuːd/; [or]z8;
crater: [n]火山口;弹坑; [v]在.上形成坑;毁坏; [acc]/ˈkreɪtər/; [or]z8;
consummate: adj. 至上的,完美的; [v]完成,使达到极点; [acc]/ˈkɑːnsəmət/; [or]z8;
contraception: [n]避孕,避孕法; [acc]/ˌkɑːntrəˈsepʃn/; [or]z8;
incoming: adj. 引入的,到来的,打入的; [n]进来,到来,收入; [acc]/ˈɪnkʌmɪŋ/; [or]z8;
prologue: [n]开场白,序幕; [acc]/ˈproʊlɔːɡ/; [or]z8;
hegemony: [n]霸权,领导权; [acc]/hɪˈdʒemoʊni/; [or]z8;
therapeutic: adj. 治疗的;治疗学的;有益于健康的; [n]治疗剂;治疗学家; [acc]/ˌθerəˈpjuːtɪk/; [or]z8;
slump: [v]突然倒下;暴跌; [n]下降;经济萧条时期; [acc]/slʌmp/; [or]z8;
enhance: [v]提高(强度,力量,数量等);增加,加强; [acc]/ɪnˈhæns/; [or]z8;
aromatic: adj. 芳香的; [n]芳香植物;芳香族化合物; [acc]/ˌærəˈmætɪk/; [or]z8;
dole: [n]救济,(失业)救济金; [v]发放,发给; [acc]/doʊl/; [or]z8;
interrogate: [v]审问,审讯; [acc]/ɪnˈterəɡeɪt/; [or]z8;
projection: [n]预测,投射,投影规划; [acc]/prəˈdʒekʃn/; [or]z8;
feint: [v]佯攻,虚击; [n]佯攻; adj. 虚假的; [acc]/feɪnt/; [or]z8;
invidious: adj. 惹人反感的,招人嫉妒的,令人厌恶的,诽谤的,不公平的; [acc]/ɪnˈvɪdiəs/; [or]z8;
forte: [n]长处,特长; adj. 强音的;响的; [adv]响亮地; [acc]/fɔːrt/; [or]z8;
microscope: [n]显微镜; [acc]/ˈmaɪkrəskoʊp/; [or]z8;
orchid: [n]兰花,淡紫色; [acc]/ˈɔːrkɪd/; [or]z8;
mosaic: [n]镶嵌细工,马赛克; adj. 摩西的;拼花的; [vt]镶嵌;用马赛克装饰; [acc]/moʊˈzeɪɪk/; [or]z8;
outright: adj. 完全的,彻底的,全部地;直率的; [adv]完全地;直率地,痛快地;直截了当地; [acc]/ˈaʊtraɪt/; [or]z8;
disenchant: [v]使觉悟,使摆脱幻想; [acc]/ˌdɪsɪn'tʃænt/; [or]z8;
vanguard: [n]先锋,前锋;先驱;领导者; [acc]/ˈvænɡɑːrd/; [or]z8;
stanza: [n]诗节; [acc]/ˈstænzə/; [or]z8;
dribble: [v](液体)往下滴,淌,流口水,运球; [n]口水,运球; [acc]/ˈdrɪbl/; [or]z8;
tinker: [n](流动的)补锅工人; [v]做拙劣修补; [acc]/ˈtɪŋkər/; [or]z8;
equilibrium: [n](心态情感等)平静;平衡; [acc]/ˌiːkwɪˈlɪbriəm/; [or]z8;
hearsay: [n]传闻,谣言; adj. 传闻的,风闻的; [acc]/ˈhɪrseɪ/; [or]z8;
meager: adj. 瘦的;贫乏的;粗劣的;少量的; [acc]/ˈmiːɡər/; [or]z8;
garland: [n]花环; [vt]戴花环; [acc]/ˈɡɑːrlənd/; [or]z8;
idiosyncrasy: [n]特殊癖性或行为; [acc]/ˌɪdiəˈsɪŋkrəsi/; [or]z8;
neural: adj. 神经的;神经系统的;背的;神经中枢的; [acc]/ˈnʊrəl/; [or]z8;
contour: [n]轮廓,等高线,概要; [vt]画轮廓,画等高线; adj. (表示[循着])等高线的;与轮廓相合的; [acc]/ˈkɑːntʊr/; [or]z8;
fickle: adj. (在感情等方面)反复无常的,轻浮的,善变的; [acc]/ˈfɪkl/; [or]z8;
gentility: [n]上流阶层;文雅;有教养; [acc]/dʒenˈtɪləti/; [or]z8;
luminous: adj. 发光的;鲜艳的;明亮的;夜光的; [acc]/ˈluːmɪnəs/; [or]z8;
fabricate: [v]建造,制造,伪造(文件等),捏造,编造(谎言,借口等); [acc]/ˈfæbrɪkeɪt/; [or]z8;
somber: adj. 忧郁的;昏暗的,阴天的; [acc]/'sɒmbə/; [or]z8;
sprawl: [n]四肢伸开的躺卧姿势;蔓生; [v]四肢伸开地坐(或卧);爬行;蔓生; [acc]/sprɔːl/; [or]z8;
covenant: [n]契约; [v]立书保证; [acc]/ˈkʌvənənt/; [or]z8;
procedural: adj. 程序上的; [acc]/prəˈsiːdʒərəl/; [or]z8;
asymmetric: adj. 不对称的,不匀称的; [acc]/ˌeɪsɪˈmetrɪk/; [or]z8;
overt: adj. 明显的;公开的;公然的; [acc]/oʊˈvɜːrt/; [or]z8;
unwitting: adj. 不知情的;无意的; [acc]/ʌnˈwɪtɪŋ/; [or]z8;
sordid: adj. 卑鄙的,肮脏的,色彩死气沉沉暗淡的; [acc]/ˈsɔːrdɪd/; [or]z8;
impious: adj. 不敬神的,不虔诚的,不孝的; [acc]/ɪmˈpaɪəs/; [or]z8;
pamper: [v]纵容,过分关怀,精心照料; [acc]/ˈpæmpər/; [or]z8;
incubation: [n]孵化,孵卵,酝酿,培育,(传染病的)潜伏期; [acc]/ˌɪŋkjuˈbeɪʃn/; [or]z8;
insolent: adj. 傲慢的,粗鲁的,无礼的; [acc]/ˈɪnsələnt/; [or]z8;
indent: [v]切割成锯齿状;(书写)缩排,印刷;定货;印凹痕; [n]缩进;契约;订货单;凹痕; [acc]/ɪnˈdent/; [or]z8;
oasis: [n]绿洲;令人欣慰的事物; [acc]/oʊˈeɪsɪs/; [or]z8;
parameter: [n]决定因素;界限;参(变)数;参量; [acc]/pəˈræmɪtər/; [or]z8;
ruffian: [n]流氓,无赖,恶棍; adj. 凶狠的,残暴的,无法无天的; [acc]/ˈrʌfiən/; [or]z8;
hamstring: [n]腿筋; [v]切断腿筋使成跛腿;使无效; [acc]/ˈhæmstrɪŋ/; [or]z8;
flare: [v]燃烧(摇曳着);突然发怒; [n]照明弹;摇曳的火焰;闪光信号; [acc]/fler/; [or]z8;
staccato: adj. (音乐)断音的,不连贯的; [n]断奏;断续的一段音乐;不连贯的东西(如说话,发动机的声音等); [adv]断音地;不连接地; [acc]/stəˈkɑːtoʊ/; [or]z8;
screech: [vi]发出尖锐的声音,发出恐惧或痛苦的叫喊声; [n]尖叫声,尖利刺耳的声音,尖声喊叫; [vt]尖着声音讲或喊; [acc]/skriːtʃ/; [or]z8;
resigned: adj. 逆来顺受的;已辞职的;已放弃的; [acc]/rɪˈzaɪnd/; [or]z8;
zoom: [v](镜头)拉近(拉远);急速上升,嗡嗡作响; [n]车辆疾驰的声音,嗡嗡声,(摄影)变焦; [acc]/zuːm/; [or]z8;
cape: [n]斗篷;披肩;岬,海岬,海角; [acc]/keɪp/; [or]z8;
eclectic: adj. 折衷主义的;选择的; [n]折衷主义者,折衷派的人; [acc]/ɪˈklektɪk/; [or]z8;
intake: [n]吸入,收纳;纳入(数量); [acc]/ˈɪnteɪk/; [or]z8;
neutralize: [v]宣布中立,使中立化;使无效;中和; [acc]/ˈnuːtrəlaɪz/; [or]z8;
lush: adj. 草木茂盛的,多的,丰富豪华的; [n]酒;醉汉; [acc]/lʌʃ/; [or]z8;
genial: adj. 愉快的,脾气好的,友好的; [acc]/ˈdʒiːniəl/; [or]z8;
fractious: adj. 易怒的;难以对待的;倔强的;好争吵的; [acc]/ˈfrækʃəs/; [or]z8;
blackmail: [n]敲诈,勒索;保护费; [vt]向.敲诈; [acc]/ˈblækmeɪl/; [or]z8;
composure: [n]镇静,沉着; [acc]/kəmˈpoʊʒər/; [or]z8;
odor: [n]气味; [acc]/ˈoʊdər/; [or]z8;
tenuous: adj. 纤细的;稀薄的;贫乏的;脆弱的; [acc]/ˈtenjuəs/; [or]z8;
flax: [n]亚麻,亚麻纤维; adj. 亚麻科; [acc]/flæks/; [or]z8;
vehement: adj. 猛烈的,强烈的; [acc]/ˈviːəmənt/; [or]z8;
implore: [v]恳求; [acc]/ɪmˈplɔːr/; [or]z8;
overshadow: [v]遮蔽,使显得不重要; [acc]/ˌoʊvərˈʃædoʊ/; [or]z8;
kinship: [n][法]亲属关系,家属关系;亲密关系; [acc]/ˈkɪnʃɪp/; [or]z8;
illustrious: adj. 著名的,杰出的;辉煌的; [acc]/ɪˈlʌstriəs/; [or]z8;
hue: [n]色彩;色度,颜色;叫声; [acc]/hjuː/; [or]z8;
itch: [n]发痒,渴望; [v]发痒,渴望; [acc]/ɪtʃ/; [or]z8;
evince: [v]表明,表示,引起; [acc]/ɪˈvɪns/; [or]z8;
backfire: [v]放出逆火,产生出乎意料及事与愿违的结果; [n]逆火;后爆的巨大响声; [acc]/ˌbækˈfaɪər/; [or]z8;
coed: [n]男女同校的女生; adj. 男女同校的; [acc]/ˌkoʊˈed/; [or]z8;
leeway: [n]［海］［空］风压差;余地; [acc]/ˈliːweɪ/; [or]z8;
RAM: [n]公羊,撞锤,[计]随机存取内存; [v]猛击,撞; [acc]/ræm/; [or]z8;
inquisitive: adj. 好奇的,好打听的; [acc]/ɪnˈkwɪzətɪv/; [or]z8;
premium: adj. 高级的;高价的;(汽油)辛烷值高的; [n]额外费用,溢价;保险金; [acc]/ˈpriːmiəm/; [or]z8;
hypodermic: adj. 皮下注射的; [n]皮下注射器; [acc]/ˌhaɪpəˈdɜːrmɪk/; [or]z8;
whimsical: adj. 古怪的,异想天开的; [acc]/ˈwɪmzɪkl/; [or]z8;
bisect: [n]对剖邮票; [vi]分开; [vt]把.分切为二,把.二等分;二等分; [acc]/baɪˈsekt/; [or]z8;
repressive: adj. 压抑的;抑制的,强制的; [acc]/rɪˈpresɪv/; [or]z8;
trek: [n]艰苦跋涉; [v]拉(货车),搬运; [acc]/trek/; [or]z8;
hidebound: adj. 死板的,顽固的,墨守成规的; [acc]/ˈhaɪdbaʊnd/; [or]z8;
clandestine: adj. 秘密的,私下的,暗中的; [acc]/klænˈdestɪn/; [or]z8;
humdrum: adj. 单调的;乏味的; [n]平凡;单调; [vi]单调乏味地进行; [acc]/ˈhʌmdrʌm/; [or]z8;
irk: [v]使苦恼,使厌烦; [n]厌烦,厌倦; [acc]/ɜːrk/; [or]z8;
jagged: adj. 锯齿状的,参差不齐的;锯齿状的; [acc]/ˈdʒæɡɪd/; [or]z8;
quadrilateral: adj. 四边形的; [acc]/ˌkwɑːdrɪˈlætərəl/; [or]z8;
indisposed: adj. 不舒服的,不愿意的,不合适的; [acc]/ˌɪndɪˈspoʊzd/; [or]z8;
taciturn: adj. 沉默寡言的; [acc]/ˈtæsɪtɜːrn/; [or]z8;
shun: [v](有意或习惯性地)避开,躲开; [acc]/ʃʌn/; [or]z8;
patronize: [v]惠顾;赞助,资助; [acc]/ˈpeɪtrənaɪz/; [or]z8;
facing: [n]饰面,衣服等的贴边; [acc]/ˈfeɪsɪŋ/; [or]z8;
meek: adj. 温顺的,逆来顺受的;谦恭的; [n]温顺的人;谦恭的人; [acc]/miːk/; [or]z8;
animation: [n]活泼,有生气,动画片,动画片制作; [acc]/ˌænɪˈmeɪʃn/; [or]z8;
watery: adj. 水的;水分多的;水淋淋的,平淡的,稀薄的,松软的,有雨意的;微弱的,淡薄的; [acc]/ˈwɔːtəri/; [or]z8;
allude: [v]间接提到,暗指,暗示; [acc]/əˈluːd/; [or]z8;
extol: [v]赞美,称赞,颂扬; [acc]/ɪkˈstoʊl/; [or]z8;
innate: adj. 与生俱来的,天生的; [acc]/ɪˈneɪt/; [or]z8;
commensurate: adj. 相称的,相应的;同量的;同样大小的; [acc]/kəˈmenʃərət/; [or]z8;
incur: [v]遭受;招致;引起; [acc]/ɪnˈkɜːr/; [or]z8;
stint: [n]节约;从事某工作的时间;固定; [v]节省;限制; [acc]/stɪnt/; [or]z8;
banjo: [n]班卓琴;五弦琴; [acc]/ˈbændʒoʊ/; [or]z8;
inoffensive: adj. 无害的;不冒犯人的;不令人讨厌的,不引起反对的; [acc]/ˌɪnəˈfensɪv/; [or]z8;
homogeneous: adj. 同类的,同质的,有相同特征的; [acc]/ˌhoʊməˈdʒiːniəs/; [or]z8;
formative: adj. 形成的;造形的;影响发展的;造型的;格式化的; [n]构词要素; [acc]/ˈfɔːrmətɪv/; [or]z8;
pigsty: [n]猪圈,脏乱的地方; [acc]/ˈpɪɡstaɪ/; [or]z8;
grumpy: adj. 脾气暴躁的,性情乖戾的; [n]脾气坏的人,爱抱怨的人; [acc]/ˈɡrʌmpi/; [or]z8;
proliferation: [n]增殖;增加; [acc]/prəˌlɪfəˈreɪʃn/; [or]z8;
intimacy: [n]亲密,亲近;亲昵行为;<婉>性行为;[婉辞]私通; [acc]/ˈɪntɪməsi/; [or]z8;
claimant: [n]原告,[贸易]索赔人,提出要求者; [acc]/ˈkleɪmənt/; [or]z8;
treatise: [n]论述;论文;专著; [acc]/ˈtriːtɪs/; [or]z8;
influx: [n]流入,涌入;河口; [acc]/ˈɪnflʌks/; [or]z8;
dusky: adj. 暗淡的,微暗的,忧郁的,朦胧的; [adv]昏暗地,黑暗地; [n]昏暗,黑暗; [acc]/ˈdʌski/; [or]z8;
incendiary: [n]放火者,纵火者,燃烧弹,煽动者; adj. 放火的,纵火的,能燃烧的,煽动性的; [acc]/ɪnˈsendieri/; [or]z8;
boost: [v]增加;偷盗; [n]提高;激励;后推;助推发动机; [acc]/buːst/; [or]z8;
forerunner: [n]先驱;祖先;前兆;预兆; [acc]/ˈfɔːrʌnər/; [or]z8;
complementary: adj. 补足的,补充的,互补的; [acc]/ˌkɑːmplɪˈmentri/; [or]z8;
ferret: [n]雪貂;白鼬;侦探; [v]搜寻;查获;驱出;用雪貂猎取; adj. 雪貂似的;搜索者般的;爱窥探的; [acc]/ˈferɪt/; [or]z8;
ungainly: adj. 笨拙的,不雅的; [adv]笨拙地;不雅地; [acc]/ʌnˈɡeɪnli/; [or]z8;
forceps: [n]钳子,镊子,手术钳; [acc]/ˈfɔːrseps/; [or]z8;
pernicious: adj. 有害的,恶性的,致命的; [acc]/pərˈnɪʃəs/; [or]z8;
iterate: [vt]重申,重复,反复申说; [acc]/ˈɪtəreɪt/; [or]z8;
interface: [n]界面;[地质]分界面,接触面; [v]相互作用(或影响);交流,交谈; [acc]/ˈɪntərfeɪs/; [or]z8;
operational: adj. 操作的,运转的; [acc]/ˌɑːpəˈreɪʃənl/; [or]z8;
bumper: [n]汽车前后的保险杆; adj. 特大的;丰盛的; [vt]装满;为.祝酒; [vi]干杯; [acc]/ˈbʌmpər/; [or]z8;
offensive: adj. 冒犯的,进攻的,无礼的,令人不快的,得罪人的; [n]进攻; [acc]/əˈfensɪv/; [or]z8;
condom: [n]安全套,避孕套; [acc]/ˈkɑːndəm/; [or]z8;
empiricism: [n]经验主义,经验论; [acc]/ɪmˈpɪrɪsɪzəm/; [or]z8;
purge: [v]通便,净化,使(身,心)清净; [n]驱赶,泻药,净化; [acc]/pɜːrdʒ/; [or]z8;
heinous: adj. 可憎的;极凶恶的; [acc]/ˈheɪnəs/; [or]z8;
heirloom: [n]传家宝,祖传遗物; adj. (植物)原种的(通常指过去大量种植,但已不再作为经济作物而种植的植物); [acc]/ˈerluːm/; [or]z8;
pensioner: [n]领取养老金者,退休的人;随从; [acc]/ˈpenʃənər/; [or]z8;
genteel: adj. 有教养的,文雅的;高雅的;假斯文的,装作体面的; [acc]/dʒenˈtiːl/; [or]z8;
safari: [n]狩猎旅行(特指在非洲东部〕,长途考察,野生动物园; [acc]/səˈfɑːri/; [or]z8;
heady: adj. 兴奋的,任性的,性急的,顽固的,使人头晕的; [acc]/ˈhedi/; [or]z8;
regularity: [n]规律性,整齐,正规事物; [acc]/ˌreɡjuˈlærəti/; [or]z8;
juncture: [n]连接;交接处,交界;关键时刻;形势; [acc]/ˈdʒʌŋktʃər/; [or]z8;
squalor: [n]肮脏,邋遢,(道德品质等的)卑劣; [acc]/ˈskwɑːlər/; [or]z8;
scrutinize: [v]仔细检查,细看; [acc]/ˈskruːtənaɪz/; [or]z8;
intestinal: adj. 肠的; [acc]/ɪnˈtestɪnl/; [or]z8;
peat: [n]泥煤,泥炭块,泥炭色; [acc]/piːt/; [or]z8;
temporal: adj. 现世的,世俗的;当时的,暂时的;[解]颞的;时间的; [n]世间万物;教会财产; [acc]/ˈtempərəl/; [or]z8;
forsake: [v]放弃;抛弃,离开; [acc]/fərˈseɪk/; [or]z8;
infantry: [n]步兵,步兵团; [acc]/ˈɪnfəntri/; [or]z8;
erasure: [n]消除,涂擦的痕迹,消磁; [acc]/ɪˈreɪʒər/; [or]z8;
fecund: adj. 肥沃的;多产的;丰饶的;生殖力旺盛的; [acc]/ˈfiːkənd/; [or]z8;
mane: [n](马,狮子等的)鬃毛,(人的)长头发; [acc]/meɪn/; [or]z8;
shoddy: adj. 劣等的;假的;冒充的;虚有其表的; [n]赝品,不值钱的东西; [acc]/ˈʃɑːdi/; [or]z8;
scurry: [v]快速疾走,急跑,急躁不安地来回走动; [n]快步急跑;疾走;仓皇奔跑声;骤雨; [acc]/ˈskɜːri/; [or]z8;
frantic: adj. 疯狂的;狂乱的;慌乱的; [acc]/ˈfræntɪk/; [or]z8;
reprisal: [n]报复;报复性劫掠; [acc]/rɪˈpraɪzl/; [or]z8;
exasperate: [vt]激怒;加剧; [acc]/ɪɡˈzæspəreɪt/; [or]z8;
dune: [n](由风吹积而成的)沙丘; [acc]/duːn/; [or]z8;
hiatus: [n]空隙,裂缝,中断; [acc]/haɪˈeɪtəs/; [or]z8;
vengeance: [n]复仇,报仇; [acc]/ˈvendʒəns/; [or]z8;
shear: [vt]剪羊毛;剪头发; [n](复数)大剪刀; [acc]/ʃɪr/; [or]z8;
decipher: [n]密电译文; [vt]解释;破译; [acc]/dɪˈsaɪfər/; [or]z8;
chivalry: [n]骑士精神,骑士气概;骑士制度; [acc]/ˈʃɪvəlri/; [or]z8;
doleful: adj. 寂寞的;悲哀的;阴沉的; [acc]/ˈdoʊlfl/; [or]z8;
dowry: [n]嫁妆,天资,亡夫遗产; [acc]/ˈdaʊri/; [or]z8;
fallible: adj. 会犯错的,易犯错的; [acc]/ˈfæləbl/; [or]z8;
horrid: adj. 可怕的,恐怖的,极讨厌的; [acc]/ˈhɔːrɪd/; [or]z8;
patio: [n]屋内庭院,天井;平台; [acc]/ˈpætioʊ/; [or]z8;
sweeping: [n]扫除;垃圾; adj. 彻底的;广泛的; [v]扫除; [acc]/ˈswiːpɪŋ/; [or]z8;
gag: [n]塞口物,随口科白,打诨,箝口物,言论,讨论终结; [v]塞物于..的口中,禁止,使窒息,使呕吐,欺骗,作呕; [acc]/ɡæɡ/; [or]z8;
dissension: [n]意见分歧;纷争;倾轧; [acc]/dɪˈsenʃn/; [or]z8;
pant: [v]喘息;气喘吁吁地说;喘气; [n]喘气; [acc]/pænt/; [or]z8;
hairdo: [n]发型; [acc]/ˈherduː/; [or]z8;
erudite: adj. 博学的,有学问的; [n]饱学之士,有学问的人; [acc]/ˈerudaɪt/; [or]z8;
incite: [v]刺激;煽动; [acc]/ɪnˈsaɪt/; [or]z8;
sleek: adj. (毛发等)柔滑的;性格油滑的,嘴甜的,圆滑的; [v]使光滑,使有光泽;(口语)滑动(口语)打扮整洁; [acc]/sliːk/; [or]z8;
repression: [n]压抑,压制,镇压; [acc]/rɪˈpreʃn/; [or]z8;
scuffle: [v]混战,扭打,拖着脚步快速行走; [n]混战,扭打; [acc]/ˈskʌfl/; [or]z8;
repugnant: adj. 令人厌恶的; [acc]/rɪˈpʌɡnənt/; [or]z8;
imperceptible: adj. 极细微的,觉察不到的,感觉不到的,; [acc]/ˌɪmpərˈseptəbl/; [or]z8;
abominable: adj. 讨厌的,令人憎恶的,糟透的; [n]讨厌,可恶; [adv]恶劣地,令人厌恶地; [acc]/əˈbɑːmɪnəbl/; [or]z8;
pedestal: [n](雕像等)基座,支座,受人尊敬的地位; [vt]搁在台上,颂扬; [acc]/ˈpedɪstl/; [or]z8;
congenial: adj. 意气相投的,令人愉快的,意气相投的,协调的; [acc]/kənˈdʒiːniəl/; [or]z8;
regeneration: [n]新生,更新,重建; [acc]/rɪˌdʒenəˈreɪʃn/; [or]z8;
lurch: [n]突然倾斜,挫折,举步蹒跚,徘徊,困境; [v]惨败,倾斜,徘徊,击败; [acc]/lɜːrtʃ/; [or]z8;
pivotal: adj. 关键的,枢轴的; [acc]/ˈpɪvətl/; [or]z8;
transmute: [v]使改变,使变形; [acc]/trænzˈmjuːt/; [or]z8;
strenuous: adj. 费力的;奋发的;热心的;艰苦的;紧张的; [acc]/ˈstrenjuəs/; [or]z8;
miscarriage: [n]流产,失败,误送; [acc]/ˈmɪskærɪdʒ/; [or]z8;
inanimate: adj. 无生命的;无生气的; [acc]/ɪnˈænɪmət/; [or]z8;
paralysis: [n]瘫痪(症),麻痹(症); [acc]/pəˈræləsɪs/; [or]z8;
congested: adj. 拥挤的,密集的; [acc]/kənˈdʒestɪd/; [or]z8;
tilt: [v](使)倾斜; [n]倾斜,斜坡; [acc]/tɪlt/; [or]z8;
carbohydrate: [n][化]碳水化合物;淀粉质食物; [acc]/ˌkɑːrboʊˈhaɪdreɪt/; [or]z8;
entreat: [v]恳求,请求; [acc]/ɪnˈtriːt/; [or]z8;
caste: [n](印度社会中的)种姓;(具有严格等级差别的)社会地位;(排他的)社会团体; [acc]/kæst/; [or]z8;
patter: [n]行话,轻快脚步声,急速拍打声; [v]滴答地响,急速地说,发出急速轻拍声,使.发出嗒嗒声; [acc]/ˈpætər/; [or]z8;
bombard: [v]不断攻击,炮击; [acc]/bɑːmˈbɑːrd/; [or]z8;
austere: adj. 严峻的;简朴的;苦行的;无装饰的; [acc]/ɔːˈstɪr/; [or]z8;
lubricant: [n]润滑剂,润滑油; adj. 润滑的; [acc]/ˈluːbrɪkənt/; [or]z8;
entwine: [v]使缠绕,交织; [acc]/ɪnˈtwaɪn/; [or]z8;
dated: adj. 注有(或注明)日期的;过时的,旧式的; [acc]/ˈdeɪtɪd/; [or]z8;
eccentricity: [n]古怪;怪癖;[数]离心率; [acc]/ˌeksenˈtrɪsəti/; [or]z8;
negate: [vt]取消,使无效;否定,否认; [n]反面,对立面; [vi]否定,否认; [acc]/nɪˈɡeɪt/; [or]z8;
metaphysical: adj. 形而上学的;超自然的;玄学派诗歌的; [acc]/ˌmetəˈfɪzɪkl/; [or]z8;
brokerage: [n]中间人业务,经济业;付给经纪人的经手费,佣金,回扣; [acc]/ˈbroʊkərɪdʒ/; [or]z8;
tether: [n]范围,系链,拴绳; [v]用绳或链拴住; [acc]/ˈteðər/; [or]z8;
sagacious: adj. 有洞察力的,有远见的,精明的,敏锐的; [acc]/səˈɡeɪʃəs/; [or]z8;
rocker: [n]摇者,摇杆,摇滚乐歌手,镰刀弯,套钩; [acc]/ˈrɑːkər/; [or]z8;
balk: [v]畏缩;阻止;停止; [n]障碍;错误; [acc]/bɔːk/; [or]z8;
tactful: adj. 机智的;老练的; [acc]/ˈtæktfl/; [or]z8;
mirage: [n]幻影,海市蜃楼; [acc]/məˈrɑːʒ/; [or]z8;
perceptible: adj. 可察觉的,可注意到的; [acc]/pərˈseptəbl/; [or]z8;
module: [n]组件,模件,(航天器的)舱;(组成一门课程的)独立单元; [acc]/ˈmɑːdʒuːl/; [or]z8;
concentric: adj. 同中心的; [adv]同一中心地;同轴地; [acc]/kənˈsentrɪk/; [or]z8;
heathen: [n]无宗教信仰者,异教徒; adj. 不信神的,未开化的,异教徒的,异国的; [acc]/ˈhiːðn/; [or]z8;
underwrite: [v]给.保险,承诺支付;同意赔款(海上保险); [acc]/ˌʌndərˈraɪt/; [or]z8;
crescent: [n]新月,新月状物,伊斯兰教的标记,土耳其的新月形国徽; adj. 新月形的,逐渐增加的; [v]以新月形物装饰,使成新月形; [acc]/ˈkresnt/; [or]z8;
rut: [n]发情期,惯例,车辙; [vt]犁; [vi]处于发情发动期; adj. 处于发情期的; [acc]/rʌt/; [or]z8;
emissary: [n]代理,信使,使者; [acc]/ˈemɪseri/; [or]z8;
authoritarian: adj. 独裁主义的,权力主义的; [n]权力主义者,独裁主义者; [acc]/əˌθɔːrəˈteriən/; [or]z8;
censor: [n]检查员; [vt]审查,检查;修改; [acc]/ˈsensər/; [or]z8;
entangle: [v]使纠缠,卷入; [acc]/ɪnˈtæŋɡl/; [or]z8;
node: [n]节点,瘤,[数]叉点; [acc]/noʊd/; [or]z8;
intriguing: adj. 迷人的,有迷惑力的,引起兴趣(或好奇心)的; [acc]/ɪnˈtriːɡɪŋ/; [or]z8;
nautical: adj. 航海的;海上的;海员的; [acc]/ˈnɔːtɪkl/; [or]z8;
recline: [vi]躺,斜倚(常与on,upon或against连用);信赖; [vt]使后靠,使斜倚; [acc]/rɪˈklaɪn/; [or]z8;
rapture: [n]狂喜; [acc]/ˈræptʃər/; [or]z8;
engross: [v]独占;正式誊写;使全神贯注于;用大字体书写; [acc]/ɪnˈɡroʊs/; [or]z8;
narcissus: [n]水仙; [acc]/nɑːrˈsɪsəs/; [or]z8;
wrapper: [n]包装材料;[包装]包装纸;书皮; [acc]/ˈræpər/; [or]z8;
buoyancy: [n]浮力,浮性,浮动性; [acc]/ˈbɔɪənsi/; [or]z8;
reimburse: [v]偿还;赔偿;退还(钱),付还; [acc]/ˌriːɪmˈbɜːrs/; [or]z8;
harmonize: [v]使调和,使一致; [acc]/ˈhɑːrmənaɪz/; [or]z8;
barrage: [n]大量;阻塞;齐射式攻击;[水利]拦河坝; [v]以密集火力阻击; [acc]/bəˈrɑːʒ/; [or]z8;
diffident: adj. 羞怯的,缺乏自信的,谦虚谨慎的; [acc]/ˈdɪfɪdənt/; [or]z8;
corrode: [v]受腐蚀;腐蚀,侵蚀; [acc]/kəˈroʊd/; [or]z8;
cuckoo: [n]杜鹃鸟;布谷鸟; adj. 疯狂的; [acc]/ˈkʊkuː/; [or]z8;
effeminate: adj. 柔弱的,女人气的,娇气的; [v](使)带女人气; [acc]/ɪˈfemɪnət/; [or]z8;
entice: [v]怂恿,引诱; [acc]/ɪnˈtaɪs/; [or]z8;
venerable: adj. 令人尊敬的;(因历史悠久而) 神圣庄严的; [acc]/ˈvenərəbl/; [or]z8;
accountable: adj. 应负责的,应作解释的;可解释的; [acc]/əˈkaʊntəbl/; [or]z8;
wail: [n]恸哭;哀诉; [vi]恸哭;悲叹; [vt]哀悼; [acc]/weɪl/; [or]z8;
deem: [v]认为,视为;知道,相信; [acc]/diːm/; [or]z8;
vindictive: adj. 报复性的,怀恨的,惩罚的; [acc]/vɪnˈdɪktɪv/; [or]z8;
luxuriant: adj. 繁茂的;多产的;绚烂的;奢华的; [acc]/lʌɡˈʒʊriənt/; [or]z8;
reprove: [v]责骂,申斥; [acc]/rɪˈpruːv/; [or]z8;
nostalgic: adj. 乡愁的,怀旧的;怀旧的; [acc]/nəˈstældʒɪk/; [or]z8;
feign: [v]假装,装作; [acc]/feɪn/; [or]z8;
bazaar: [n]集市,商店集中区; [acc]/bəˈzɑːr/; [or]z8;
turmoil: [n]骚动,骚乱; [acc]/ˈtɜːrmɔɪl/; [or]z8;
fitful: adj. 发作的,间歇的,不定的; [acc]/ˈfɪtfl/; [or]z8;
adrift: adj. 漂泊的,漂浮着的; [adv]随波逐流地;漂流无定;<比喻>无定职;<口>孤陋寡闻; [acc]/əˈdrɪft/; [or]z8;
scowl: [n]愁容,怒容,暴风雨前的阴沉晦暗; [v]皱眉头,怒目而视; [acc]/skaʊl/; [or]z8;
negligent: adj. 疏忽的,粗心大意的;随意的; [acc]/ˈneɡlɪdʒənt/; [or]z8;
hatchback: [n]［美］有可向上开启天窗的汽车背部; [acc]/ˈhætʃbæk/; [or]z8;
insuperable: adj. 难以克服的,无敌的; [acc]/ɪnˈsuːpərəbl/; [or]z8;
practicality: [n]实用性,实际性;实际,实例; [acc]/ˌpræktɪˈkæləti/; [or]z8;
lyrical: adj. 抒情诗调的;感情丰富的;充满愉悦的; [acc]/ˈlɪrɪkl/; [or]z8;
imbecile: [n]低能者,愚蠢的人; adj. 低能的,愚笨的,虚弱的; [acc]/ˈɪmbəsl/; [or]z8;
ambush: [n]埋伏,伏击;伏兵; [v]埋伏,伏击; [acc]/ˈæmbʊʃ/; [or]z8;
fervent: adj. 热烈的,满怀热情的;狂热的; [acc]/ˈfɜːrvənt/; [or]z8;
superfluous: adj. 多余的,过剩的;不必要的; [acc]/suːˈpɜːrfluəs/; [or]z8;
integer: [n]整数;整体; [acc]/ˈɪntɪdʒər/; [or]z8;
recurrent: adj. 复发的;周期性的,经常发生的; [acc]/rɪˈkɜːrənt/; [or]z8;
mar: [v]毁坏,弄糟,玷污; [acc]/mɑːr/; [or]z8;
consensus: [n]一致同意,合意; [acc]/kənˈsensəs/; [or]z8;
sheepish: adj. 羞怯的,腼腆的(像绵羊一样)驯顺的,胆怯的,愚钝的; [acc]/ˈʃiːpɪʃ/; [or]z8;
gloat: [v]幸灾乐祸地看,窃喜; [acc]/ɡloʊt/; [or]z8;
repellent: adj. 令人厌恶的; [n]消肿药,驱虫剂; [acc]/rɪˈpelənt/; [or]z8;
inflammable: adj. 可燃的,易激怒的; [n]易燃物; [acc]/ɪnˈflæməbl/; [or]z8;
pentathlon: [n]五项运动,五项全能运动; [acc]/penˈtæθlən/; [or]z8;
nude: adj. 赤裸的,与生俱有的,无装饰的; [n]裸体者;裸体画; [v]〈罕〉使裸; [acc]/nuːd/; [or]z8;
interlude: [n]插曲;穿插;间歇;幕间节目; [acc]/ˈɪntərluːd/; [or]z8;
vernacular: adj. 本国的,地方的,用本地语写成的; [n]方言;土语;(建筑的)民间风格; [acc]/vərˈnækjələr/; [or]z8;
slag: [n]炉渣,矿渣; [acc]/slæɡ/; [or]z8;
dissuade: [v]劝阻,阻止; [acc]/dɪˈsweɪd/; [or]z8;
connoisseur: [n](艺术品等的)鉴赏家,鉴定家,行家; [acc]/ˌkɑːnəˈsɜːr/; [or]z8;
animosity: [n]憎恶,仇恨; [acc]/ˌænɪˈmɑːsəti/; [or]z8;
chant: [v]吟唱;诵扬; [n]圣歌;赞美诗;旋律; [acc]/tʃænt/; [or]z8;
fornicate: [v]与..通奸,私通; [acc]/ˈfɔːrnɪkeɪt/; [or]z8;
squeak: [v]尖叫,以短促尖锐声发出,险胜; [n]吱吱声,机会; [acc]/skwiːk/; [or]z8;
baleful: adj. 邪恶的,恶意的; [adv]凶恶地,有害地; [acc]/ˈbeɪlfl/; [or]z8;
shunt: [n]转轨;[电]分流器; [v]使(火车)转到另一轨道,转移方向; [acc]/ʃʌnt/; [or]z8;
intuition: [n]直觉;感觉; [acc]/ˌɪntuˈɪʃn/; [or]z8;
irreconcilable: adj. 不能妥协的,不能和解的,不能协调的; [n]不能和解的人,(政治上的)死硬派; [acc]/ɪˈrekənsaɪləbl/; [or]z8;
dogmatic: adj. 教条的,武断的; [acc]/dɔːɡˈmætɪk/; [or]z8;
abort: [v]异常中断,中途失败,流产,发育不全; [acc]/əˈbɔːrt/; [or]z8;
xenophobia: [n]仇外,对外国人的恐惧或憎恨; [acc]/ˌzenəˈfoʊbiə/; [or]z8;
inadvertent: adj. 疏忽的,漫不经心的,无意中的; [acc]/ˌɪnədˈvɜːrtənt/; [or]z8;
sibling: [n]兄弟姊妹;同胞;(生物)同科,同属; [acc]/ˈsɪblɪŋ/; [or]z8;
abduct: [v]绑架,拐走; [acc]/æbˈdʌkt/; [or]z8;
appraise: [v]评价,鉴定;估价; [acc]/əˈpreɪz/; [or]z8;
hedonist: [n]享乐主义者,［心］欢乐主义者; adj. 享乐主义者的; [acc]/ˈhiːdənɪst/; [or]z8;
electrocute: [v](美)以电椅处死,使触电致死; [acc]/ɪˈlektrəkjuːt/; [or]z8;
vicinity: [n]附近地区;近邻;附近; [acc]/vəˈsɪnəti/; [or]z8;
crypt: [n]地窟,［解］腺窝,小囊; pref. 隐藏的;秘密的(=crypto); [acc]/krɪpt/; [or]z8;
esoteric: adj. 秘传的,神秘的,限于少数人的; [n]受秘传的人; [acc]/ˌesəˈterɪk/; [or]z8;
ledge: [n]暗礁;突出部分; [acc]/ledʒ/; [or]z8;
archive: [n]档案室,档案; [vt]把.收集归档; [acc]/ˈɑːrkaɪv/; [or]z8;
seep: [v](液体等)渗漏,(观念等)渗入,(疾病恐惧等)扩散; [n]小泉,水陆两用的吉普车; [acc]/siːp/; [or]z8;
languish: [v]凋萎,衰弱,变得消瘦; [acc]/ˈlæŋɡwɪʃ/; [or]z8;
gazette: [n]报纸; [v]在报上刊载; [acc]/ɡəˈzet/; [or]z8;
thatch: [n]草屋顶,盖屋顶的稻草,(茂密的)头发; [v](用稻草等)盖(屋顶); [acc]/θætʃ/; [or]z8;
mainspring: [n]主要动力;主要原因;(钟表)主发条; [acc]/ˈmeɪnsprɪŋ/; [or]z8;
manacle: [v]上手铐,束缚; [n]手铐; [acc]/ˈmænəkl/; [or]z8;
brevity: [n]简短,短小,精炼; [acc]/ˈbrevəti/; [or]z8;
exterminate: [v]消灭,灭绝;根除; [acc]/ɪkˈstɜːrmɪneɪt/; [or]z8;
onomatopoeia: [n]拟声,拟声词; [acc]/ˌɑːnəˌmætəˈpiːə/; [or]z8;
figment: [n]空想;虚构的理论,故事等; [acc]/ˈfɪɡmənt/; [or]z8;
ordain: [v]注定;规定;任命(牧师);颁布命令; [acc]/ɔːrˈdeɪn/; [or]z8;
emblem: [n]象征;徽章;符号; [acc]/ˈembləm/; [or]z8;
traverse: [v]横越;穿过; [n]横越; [acc]/trəˈvɜːrs/; [or]z8;
ghastly: adj. 苍白的,可怕的,令人不快的; [adv]恐怖地,惨白地; [acc]/ˈɡæstli/; [or]z8;
niche: [n]壁龛;合适的职业,生活方式;(有利可图的)市场,商机; [vt]放在适当的位置; [acc]/nɪtʃ/; [or]z8;
nuzzle: [v]用鼻紧挨,用鼻爱抚,紧贴某人; [acc]/ˈnʌzl/; [or]z8;
rhinoceros: [n]犀牛; [acc]/raɪˈnɑːsərəs/; [or]z8;
mandatory: adj. 命令的,强制性的; [acc]/ˈmændətɔːri/; [or]z8;
fetus: [n]胎儿; [acc]/ˈfiːtəs/; [or]z8;
irrevocable: adj. 不可改变的;不能取消的;不能挽回的; [acc]/ɪˈrevəkəbl/; [or]z8;
clump: [n]土块; [v]丛生; [acc]/klʌmp/; [or]z8;
fence: [n]篱笆,围栏,栅栏; [v]击剑;用篱笆围住;束缚; [acc]/fens/; [or]z8;
vie: [v]竞争;使针锋相对;以..作较量; [acc]/vaɪ/; [or]z8;
menopause: [n]更年期,活动终止期; [acc]/ˈmenəpɔːz/; [or]z8;
acquittal: [n]宣告无罪,开释; [acc]/əˈkwɪtl/; [or]z8;
scrupulous: adj. 小心谨慎的;严谨的;细心的; [acc]/ˈskruːpjələs/; [or]z8;
edifice: [n]宏伟的建筑物;大厦;(知识的)体系,结构; [acc]/ˈedɪfɪs/; [or]z8;
bustle: [n]喧闹,熙攘;腰垫;奔走,奔忙; [v]喧闹;忙乱,奔忙; [acc]/ˈbʌsl/; [or]z8;
gravitate: [v]受引力作用;被吸引; [acc]/ˈɡrævɪteɪt/; [or]z8;
etch: [n]蚀刻; [vi]蚀刻; [vt]蚀镂,蚀刻,描述,铭记; [acc]/etʃ/; [or]z8;
treble: [n]最高声部; [v]使成三倍; adj. 三倍的,最高声部的; [acc]/ˈtrebl/; [or]z8;
regal: adj. 帝王的,豪华的,帝王般的; [acc]/ˈriːɡl/; [or]z8;
nib: [n]钢笔尖; [acc]/nɪb/; [or]z8;
euphemism: [n]婉言,委婉的说法; [acc]/ˈjuːfəmɪzəm/; [or]z8;
strut: [n]高视阔步,抗压装置; [v]昂首阔步地走,趾高气昂地走; [acc]/strʌt/; [or]z8;
reinstate: [vt]使恢复;使复原; [acc]/ˌriːɪnˈsteɪt/; [or]z8;
impartial: adj. 公平的,不偏不倚的; [acc]/ɪmˈpɑːrʃl/; [or]z8;
maverick: [n]独行者,想法与众不同的人; adj. 行为不合常规的; [v]用不正当手段获取;迷路; [acc]/ˈmævərɪk/; [or]z8;
neoclassical: adj. 新古典主义的; [acc]/ˌniːoʊˈklæsɪkl/; [or]z8;
enormity: [n]巨大;暴行;极恶; [acc]/ɪˈnɔːrməti/; [or]z8;
ostentatious: adj. 浮华的,虚饰的,外观美丽的; [acc]/ˌɑːstenˈteɪʃəs/; [or]z8;
stringent: adj. 严厉的;迫切的;银根紧的; [acc]/ˈstrɪndʒənt/; [or]z8;
presumption: [n]放肆,傲慢;推测; [acc]/prɪˈzʌmpʃn/; [or]z8;
floral: adj. 花的,像花的;植物区系的; [n]以花占主要的图片或设计; [acc]/ˈflɔːrəl/; [or]z8;
fingertip: [n]指尖;指套; [acc]/ˈfɪŋɡərtɪp/; [or]z8;
mutilate: [v]残害,切断(手足等),使残缺不全; [acc]/ˈmjuːtɪleɪt/; [or]z8;
stardom: [n]明星地位;演员身份;明星界; [acc]/ˈstɑːrdəm/; [or]z8;
palatable: adj. 美味的,合口味的,合心意的; [acc]/ˈpælətəbl/; [or]z8;
capricious: adj. 变化无常的,任性的; [acc]/kəˈprɪʃəs/; [or]z8;
ramble: [vi]瞎扯;溜达;漫步于; [n]漫步; [acc]/ˈræmbl/; [or]z8;
collude: [v]串通,共谋; [acc]/kəˈluːd/; [or]z8;
pollen: [n]花粉; [acc]/ˈpɑːlən/; [or]z8;
succor: [n]救援,援助者,救援人员; [v]援助,救援; [acc]/ˈsʌkər/; [or]z8;
fervor: [n]强烈感情,激情,热情; [acc]/ˈfɜrvər/; [or]z8;
Quaker: [n]夸克党,教友派信徒; [acc]/ˈkweɪkər/; [or]z8;
horde: [n]一大群,群,游牧部落; [v]成群;结成部落而居; [acc]/hɔːrd/; [or]z8;
frisk: [v]搜身;蹦跳,欢跃; [n]欢跃,蹦跳,快活的时刻; [acc]/frɪsk/; [or]z8;
intimidate: [v]恫吓,威胁; [acc]/ɪnˈtɪmɪdeɪt/; [or]z8;
indiscriminate: adj. 任意的;不加区别的,不加选择的; [acc]/ˌɪndɪˈskrɪmɪnət/; [or]z8;
slouch: [v]耷拉,低垂,使低垂; [n](帽边等的)下垂,耷拉,萎靡不振的人; [acc]/slaʊtʃ/; [or]z8;
vault: [n]保险库,金库,拱顶,墓室; [v]越过,跳过; [acc]/vɔːlt/; [or]z8;
rupture: [n]破裂;割裂; [v]使破裂;断绝(关系); [acc]/ˈrʌptʃər/; [or]z8;
frontal: adj. 额的,正面的,前面的; [n]额骨,额部,房屋的正面; [acc]/ˈfrʌntl/; [or]z8;
apex: [n]顶点;尖端; [acc]/ˈeɪpeks/; [or]z8;
plummet: [v]垂直或突然地堕下,骤然下降; [n]测锤(钓丝的)坠子;线锤;铅锤线;锤规; [acc]/ˈplʌmɪt/; [or]z8;
hurtle: [v]猛冲,猛烈碰撞,使冲向; [n]碰撞;碰撞声;猛冲; [acc]/ˈhɜːrtl/; [or]z8;
dither: [n]慌乱,犹豫,颤抖; [v]慌乱,踌躇犹豫,颤抖; [acc]/ˈdɪðər/; [or]z8;
forensic: adj. 科学手段的,法庭的,辩论的; [n]辩论练习;辩论学,辩论术; [acc]/fəˈrensɪk/; [or]z8;
momentary: adj. 短暂的,瞬间的; [acc]/ˈmoʊmənteri/; [or]z8;
Canon: [n]标准,教规,正典圣经,教士; [acc]/ˈkænən/; [or]z8;
prowess: [n]勇敢,不凡的能力;超凡技术; [acc]/ˈpraʊəs/; [or]z8;
opt: [v]选择; [acc]/ɑːpt/; [or]z8;
rink: [n]溜冰场,冰球场,室内溜冰场; [vi]溜冰; [acc]/rɪŋk/; [or]z8;
stalk: [n]茎,梗; [v]隐伏跟踪,(为搜索而)走遍;高视阔步,蔓延; [acc]/stɔːk/; [or]z8;
vortex: [n]旋涡,气旋;涡流; [acc]/ˈvɔːrteks/; [or]z8;
obsess: [vt]迷住,使着迷,使烦扰; [acc]/əbˈses/; [or]z8;
impersonate: [v]模仿,扮演,人格化,拟人; [acc]/ɪmˈpɜːrsəneɪt/; [or]z8;
heterogeneous: adj. 多相的,异种的,不均匀的,由不同成分形成的; [acc]/ˌhetərəˈdʒiːniəs/; [or]z8;
wallow: [v]打滚;沉迷,沉溺;颠簸; [n]打滚;堕落;泥坑; [acc]/ˈwɑːloʊ/; [or]z8;
trait: [n]特征; [acc]/treɪt/; [or]z8;
cramp: [n]痉挛,绞痛;[五金]铁夹钳; [v]束缚,限制;使.抽筋;以铁箍扣紧; [acc]/kræmp/; [or]z8;
Hispanic: adj. 拉丁美洲的;西班牙人的;西班牙的; [n]讲西班牙语的人;拉美裔美国人; [acc]/hɪˈspænɪk/; [or]z8;
enfold: [v]拥抱,包裹,折叠; [acc]/ɪnˈfoʊld/; [or]z8;
composite: adj. 合成的,复合的; [n]合成物,复合材料; [v]使合成,使混合; [acc]/kəmˈpɑːzət/; [or]z8;
savor: [n]味道,气味,特点,趣味; [v]调味,品尝,欣赏,玩味; [acc]/ˈseɪvər/; [or]z8;
irradiate: [vt]照亮;扩散;启发; [vi]发光; adj. 发光的; [acc]/ɪˈreɪdieɪt/; [or]z8;
recipient: [n]接受者;容器;间接宾语; adj. 接受的;善于接受的;接受能力强的; [acc]/rɪˈsɪpiənt/; [or]z8;
irksome: adj. 令人厌烦的,讨厌的; [acc]/ˈɜːrksəm/; [or]z8;
obliterate: [v]消灭;涂去;冲刷;忘掉; [acc]/əˈblɪtəreɪt/; [or]z8;
predatory: adj. 掠夺的;捕食生物的; [acc]/ˈpredətɔːri/; [or]z8;
beset: [v]困扰;镶嵌;围绕; [acc]/bɪˈset/; [or]z8;
bunk: [n](火车等)床铺,铺位,卧铺;骗人的话,废话; [v]睡(在床铺上),去睡; [acc]/bʌŋk/; [or]z8;
ardent: adj. 热心的,热烈的; [acc]/ˈɑːrdnt/; [or]z8;
ephemeral: adj. 短暂的,短命的; [n]生存极短时间的事物; [acc]/ɪˈfemərəl/; [or]z8;
seminal: adj. 重要的,精液的,种子的; [acc]/ˈsemɪnl/; [or]z8;
rabid: adj. 激烈的;狂暴的;偏激的;患狂犬病的; [acc]/ˈræbɪd/; [or]z8;
abject: adj. 糟糕透顶的;可怜的,不幸的; [acc]/ˈæbdʒekt/; [or]z8;
corrugated: adj. 褶皱的; [acc]/ˈkɔːrəɡeɪtɪd/; [or]z8;
litigation: [n]诉讼;起诉; [acc]/ˌlɪtɪˈɡeɪʃn/; [or]z8;
dregs: [n]渣滓;少量;沉淀物; [acc]/dreɡz/; [or]z8;
appendix: [n]附录;阑尾;附属物; [acc]/əˈpendɪks/; [or]z8;
confer: [v]授予(奖项,学位,荣誉或权利);商讨,协商; [acc]/kənˈfɜːr/; [or]z8;
lacquer: [n]漆器;天然漆; [v]涂漆; [acc]/ˈlækər/; [or]z8;
defoliate: [v]落叶; adj. 〈罕〉落了叶的; [acc]/ˌdiːˈfoʊlieɪt/; [or]z8;
crucify: [v]折磨,迫害;十字架上钉死;克制; [acc]/ˈkruːsɪfaɪ/; [or]z8;
hangar: [n]飞机库; [acc]/ˈhæŋər/; [or]z8;
rattle: [n]格格声,发出嘎嘎声的儿童玩具,(响尾蛇)音响器官; [v](使)发出格格声,(人或车)疾驰,使烦扰; [acc]/ˈrætl/; [or]z8;
manifestation: [n]表现,表示;显灵;示威运动; [acc]/ˌmænɪfeˈsteɪʃn/; [or]z8;
cognitive: adj. 认识能力的;认知的; [acc]/ˈkɑːɡnətɪv/; [or]z8;
cuddle: [n]拥抱; [v]拥抱,搂抱;紧贴着身子睡; [acc]/ˈkʌdl/; [or]z8;
supplementary: adj. 补充的;附加的; [n]补充者; [acc]/ˌsʌplɪˈmentri/; [or]z8;
crooked: adj. 弯曲的;歪的;不正当的;不正直的; [acc]/ˈkrʊkɪd/; [or]z8;
outlay: [v]花费; [n][会计]费用;支出;经费; [acc]/ˈaʊtleɪ/; [or]z8;
outlandish: adj. 稀奇古怪的,奇特的;异国风情的; [acc]/aʊtˈlændɪʃ/; [or]z8;
wince: [v]避开,畏缩; [n]畏缩;脸部肌肉的抽搐; [acc]/wɪns/; [or]z8;
pendent: adj. 吊着的,悬挂的; [acc]/'pendənt/; [or]z8;
Armada: [n](西班牙的)无敌舰队; [acc]/ɑːrˈmɑːdə/; [or]z8;
malt: [n]麦芽,麦芽酒; [vt]使(谷物)成为麦芽;制麦芽; adj. 麦芽的;含麦芽的;用麦芽作的; [acc]/mɔːlt/; [or]z8;
fold: [v]折叠;彻底失败;合拢; [n]折叠;褶; [acc]/foʊld/; [or]z8;
thee: [pron]你(古英语thou的宾格); [acc]/ðiː/; [or]z8;
antibody: [n][免疫]抗体; [acc]/ˈæntibɑːdi/; [or]z8;
sliver: [n]长条,细片; [v]裂成细片; [acc]/ˈslɪvər/; [or]z8;
efficacy: [n]功效,效力; [acc]/ˈefɪkəsi/; [or]z8;
gravel: [n]沙砾,小石,砾石; adj. 粗重而沙哑的,刺耳的; [vt]用砾石铺;使困惑; [acc]/ˈɡrævl/; [or]z8;
impregnate: [v]使怀孕,使充满; [acc]/ɪmˈpreɡneɪt/; [or]z8;
ooze: [v](使)渗出,流出,泄漏; [n]软泥,渗出物; [acc]/uːz/; [or]z8;
perpetuate: adj. 长存的; [vt]使永久存在,使不朽; [acc]/pərˈpetʃueɪt/; [or]z8;
accomplice: [n]同谋者,帮凶; [acc]/əˈkɑːmplɪs/; [or]z8;
eddy: [n]漩涡; [v]旋转;起漩涡; [acc]/ˈedi/; [or]z8;
prototype: [n]原型,典型,样本; [acc]/ˈproʊtətaɪp/; [or]z8;
christen: [v]为.命名,为.施洗礼; [n][女名]女子名; [acc]/ˈkrɪsn/; [or]z8;
hutch: [n]笼,小屋,贮藏箱,矿车; [vt]把.装箱; [acc]/hʌtʃ/; [or]z8;
anarchist: [n]无政府主义者; [acc]/ˈænərkɪst/; [or]z8;
cholesterol: [n]胆固醇; [acc]/kəˈlestərɔːl/; [or]z8;
regret: [n]后悔,遗憾; [vt]懊悔,后悔;抱歉; [vi]感到后悔,感到抱歉; [acc]/rɪˈɡret/; [or]z8;
scathing: adj. 严厉的;损伤的; [v]损伤;伤害; [acc]/ˈskeɪðɪŋ/; [or]z8;
enumerate: [v]列举; [acc]/ɪˈnuːməreɪt/; [or]z8;
recital: [n]独奏,吟诵,演奏会; [acc]/rɪˈsaɪtl/; [or]z8;
hive: [n]蜂房,忙碌之地; [v]分开,隔开; [acc]/haɪv/; [or]z8;
opus: [n]作品; [acc]/ˈoʊpəs/; [or]z8;
instigate: [v]发起,煽动; [acc]/ˈɪnstɪɡeɪt/; [or]z8;
whitewash: [v]用石灰水把..刷白; [n]石灰水,白色涂料,白粉胶泥水,涂脂抹粉; [acc]/ˈwaɪtwɑːʃ/; [or]z8;
jigsaw: [n]拼图游戏,竖锯; [vt]用竖锯锯,使互相交错搭接; [acc]/ˈdʒɪɡsɔː/; [or]z8;
sleeper: [n]睡眠者;卧车,卧铺;枕木; [acc]/ˈsliːpər/; [or]z8;
ravish: [v]强夺,强奸,使着迷; [acc]/ˈrævɪʃ/; [or]z8;
nomad: [n]流浪者,游牧民; adj. 游牧的;流浪的; [acc]/ˈnoʊmæd/; [or]z8;
bliss: [n]福佑,天赐的福; [vt]使欣喜若狂,使狂喜; [vi]欣喜若狂,狂喜; [acc]/blɪs/; [or]z8;
inflame: [v]使燃烧,激怒(某人); [acc]/ɪnˈfleɪm/; [or]z8;
impeccable: adj. 无瑕疵的,没有缺点的; [acc]/ɪmˈpekəbl/; [or]z8;
outnumber: [v]在数量上超过; [acc]/ˌaʊtˈnʌmbər/; [or]z8;
rubble: [n]碎石,瓦砾; [acc]/ˈrʌbl/; [or]z8;
collusion: [n]勾结;共谋; [acc]/kəˈluːʒn/; [or]z8;
sage: adj. 贤明的,审慎的; [n]圣人,年高望重的人; [acc]/seɪdʒ/; [or]z8;
bridle: [n]马笼头,缰绳; [v]上笼头;昂首(表傲慢,愤怒等);抑制,控制; [acc]/ˈbraɪdl/; [or]z8;
dexterity: [n]纯熟;灵巧; [acc]/dekˈsterəti/; [or]z8;
holiness: [n]神圣,圣座(大写,对教宗等的尊称); [acc]/ˈhoʊlinəs/; [or]z8;
impound: [v]没收,拘留; [acc]/ɪmˈpaʊnd/; [or]z8;
sonata: [n]奏鸣曲; [acc]/səˈnɑːtə/; [or]z8;
arrears: [n]债,欠债; [acc]/əˈrɪrz/; [or]z8;
paranoia: [n](心理)偏执狂,多疑症; [acc]/ˌpærəˈnɔɪə/; [or]z8;
manifesto: [n]宣言,声明;告示; [v]发表宣言; [acc]/ˌmænɪˈfestoʊ/; [or]z8;
glum: adj. 闷闷不乐的,阴郁的; [n]闷闷不乐;忧郁; [acc]/ɡlʌm/; [or]z8;
derrick: [n]起重机,转臂起重机,油井的铁架塔; [acc]/ˈderɪk/; [or]z8;
unequivocal: adj. 明确的,不含糊的; [acc]/ˌʌnɪˈkwɪvəkl/; [or]z8;
frolic: [n]嬉闹; [v]嬉戏,雀跃; adj. 嬉戏的,欢乐的; [acc]/ˈfrɑːlɪk/; [or]z8;
tinder: [n]火绒,火种; adj. 易燃的; [acc]/ˈtɪndər/; [or]z8;
dampen: [v]变潮湿; [vi]沮丧; [vt]使潮湿;抑制,使扫兴; [acc]/ˈdæmpən/; [or]z8;
wrath: [n]愤怒; [acc]/ræθ/; [or]z8;
remission: [n]缓解;宽恕;豁免; [acc]/rɪˈmɪʃn/; [or]z8;
defuse: [vi]平息,变弱; [vt]拆除;使消除危险性,平息; [acc]/ˌdiːˈfjuːz/; [or]z8;
membrane: [n]膜;薄膜;羊皮纸; [acc]/ˈmembreɪn/; [or]z8;
palette: [n]调色板,一套颜料; [acc]/ˈpælət/; [or]z8;
immobile: adj. 不动的;不能活动的;不变的;静止的; [acc]/ɪˈmoʊbl/; [or]z8;
rectitude: [n]正直,公正,正确; [acc]/ˈrektɪtuːd/; [or]z8;
clutter: [n]混乱,凌乱; [v]弄乱,搅乱; [acc]/ˈklʌtər/; [or]z8;
effluent: [n]污水; adj. 流出的; [acc]/ˈefluənt/; [or]z8;
churn: [n](炼制黄油用的)搅乳器; [v]用搅乳器搅拌; [acc]/tʃɜːrn/; [or]z8;
proponent: [n]支持者;提议者;主张者;提出认证遗嘱者; adj. 建议的;支持的;辩护的; [acc]/prəˈpoʊnənt/; [or]z8;
neurotic: adj. 神经质的;神经官能病的; [n]神经病患者; [acc]/nʊˈrɑːtɪk/; [or]z8;
caricature: [n]讽刺画,滑稽模仿;扭曲,夸张的描述; [acc]/ˈkærɪkətʃər/; [or]z8;
infiltrate: [v]渗入,潜入 (某地方或组织);(气,液)渗透; [n]渗透物; [acc]/ˈɪnfɪltreɪt/; [or]z8;
lotion: [n]洗液,洗涤剂; [acc]/ˈloʊʃn/; [or]z8;
caviar: [n]鱼子酱; [acc]/ˈkæviɑːr/; [or]z8;
tulip: [n][植]郁金香; [acc]/ˈtuːlɪp/; [or]z8;
festive: adj. 庆祝的,喜庆的,欢乐的,节日似的; [acc]/ˈfestɪv/; [or]z8;
sublime: adj. 雄伟的,崇高的,极端的,超群的;(行为,态度)极端的,漠不关心的; [n]顶峰,崇高; [v]使.纯化,使.升华,变高尚; [acc]/səˈblaɪm/; [or]z8;
defame: [v]诽谤,中伤; [acc]/dɪˈfeɪm/; [or]z8;
baton: [n]警棍,指挥棒,接力棒; [v]用短棒打; [acc]/bəˈtɑːn/; [or]z8;
giddy: adj. 眼花缭乱的,头晕的,轻率的; [v](使)眼花,(使)眩晕; [acc]/ˈɡɪdi/; [or]z8;
militant: adj. 好战的,好暴力的; [n]激进分子,斗士; [acc]/ˈmɪlɪtənt/; [or]z8;
trestle: [n]高架桥; [acc]/ˈtresl/; [or]z8;
felony: [n]重罪; [acc]/ˈfeləni/; [or]z8;
folklore: [n]民俗学,民间传说;民间看法;民俗; [acc]/ˈfoʊklɔːr/; [or]z8;
fidget: [v]坐立不安; [n]烦躁之人,烦躁; adj. 坐立不安的,不安定的,为琐事操心的; [acc]/ˈfɪdʒɪt/; [or]z8;
slab: [n]厚片,硬板; [v]把.分成厚片;用石板铺; [acc]/slæb/; [or]z8;
trance: [n](因走神发呆而)恍惚,(医)神志昏迷; [v]使着迷; [acc]/træns/; [or]z8;
motionless: adj. 静止的;不运动的; [acc]/ˈmoʊʃnləs/; [or]z8;
inmate: [n]囚犯;(精神病院等中的)被收容者; [acc]/ˈɪnmeɪt/; [or]z8;
lagoon: [n]泻湖,环礁湖,咸水湖; [acc]/ləˈɡuːn/; [or]z8;
hiccup: [n]打嗝,小问题; [v]打嗝; [acc]/ˈhɪkʌp/; [or]z8;
daisy: [n]雏菊;菊科植物;极好的东西; adj. 极好的;上等的; [acc]/ˈdeɪzi/; [or]z8;
hardheaded: adj. 现实的,精明的,顽固的; [acc]/'hɑːd'hedɪd/; [or]z8;
tactical: adj. 手段的,战术的; [acc]/ˈtæktɪkl/; [or]z8;
perception: [n]洞察力,理解力;洞察力,理解力,认识,观念,看法; [acc]/pərˈsepʃn/; [or]z8;
raft: [n]木筏;救生艇; [acc]/ræft/; [or]z8;
flamboyant: adj. 辉耀的;华丽的,艳丽的;火焰似的; [acc]/flæmˈbɔɪənt/; [or]z8;
amoral: adj. 不知是非的; [acc]/ˌeɪˈmɔːrəl/; [or]z8;
epilogue: [n]收场白;尾声; [acc]/ˈepɪlɔːɡ/; [or]z8;
resurrect: [v]复苏,复兴;使复活; [acc]/ˌrezəˈrekt/; [or]z8;
custard: [n]奶油冻,奶油蛋羹; [acc]/ˈkʌstərd/; [or]z8;
sideline: [n]球场边线,副业; [v]迫使退出; [acc]/ˈsaɪdlaɪn/; [or]z8;
compulsion: [n]强制,强迫,强制力; [acc]/kəmˈpʌlʃn/; [or]z8;
autocrat: [n]独裁者; [acc]/ˈɔːtəkræt/; [or]z8;
stalwart: [n]坚定的成员;健壮的人; adj. 强壮的,坚定的,忠诚的; [acc]/ˈstɔːlwərt/; [or]z8;
abstinence: [n]节制,禁欲; [acc]/ˈæbstɪnəns/; [or]z8;
susceptibility: [n]易感性的,敏感性,感情; [acc]/səˌseptəˈbɪləti/; [or]z8;
rostrum: [n]讲坛,讲台; [acc]/ˈrɑːstrəm/; [or]z8;
motif: [n]基本图案;主题,中心思想,[音]乐旨; [acc]/moʊˈtiːf/; [or]z8;
mediocre: adj. 普通的;平凡的;中等的; [acc]/ˌmiːdiˈoʊkər/; [or]z8;
domesticity: [n]家庭生活,专心于家务,对家庭的挚爱; [acc]/ˌdoʊmeˈstɪsəti/; [or]z8;
void: [n]空间;空洞;空位;空虚感; adj. 缺乏的;空的,没有的;[律]无效的; [v]使无效,把.作废, 宣布.作废;腾出,清理; [vi]排泄; [acc]/vɔɪd/; [or]z8;
cascade: [n]层叠;小瀑布;喷流; [v]像瀑布般冲下或倾泻; [acc]/kæˈskeɪd/; [or]z8;
crinkle: [n]皱纹,波纹,沙沙声; [v]起皱,使沙沙作响; [acc]/ˈkrɪŋkl/; [or]z8;
glaze: [n](浇在糕点上的)糖浆,蛋浆,釉;[气]雨淞; [v](眼睛)变呆滞;浇浆汁于 (食物) 表面;给.安装玻璃; [acc]/ɡleɪz/; [or]z8;
coup: [n]政变;出乎意料的行动或胜利; [acc]/kuː/; [or]z8;
victimize: [v]使受害,使牺牲,欺骗; [acc]/ˈvɪktɪmaɪz/; [or]z8;
flighty: adj. 轻浮的;轻狂的;心情浮动的,容易激动的;(马等)易惊的; [acc]/ˈflaɪti/; [or]z8;
harass: [v]使困扰,使烦恼,反复袭击; [acc]/həˈræs/; [or]z8;
homogenize: [vi]变均匀; [vt]使均匀,使类同; [acc]/həˈmɑdʒəˌnaɪz/; [or]z8;
froth: [n]泡沫,泡;口沫; [v]吐白沫;起泡沫; [acc]/frɔːθ/; [or]z8;
tentative: adj. 试探性的;不确定的;暂时的;犹豫不决的; [acc]/ˈtentətɪv/; [or]z8;
fig: [n]无花果;无花果树;少许,一些;无价值的东西;服装; [vt]打扮;使马跑快; [acc]/fɪɡ/; [or]z8;
nappy: [n]尿布; adj. 起毛的; [acc]/ˈnæpi/; [or]z8;
capitulate: [vi]有条件投降,认输,屈服,让步,停止抵抗; [acc]/kəˈpɪtʃuleɪt/; [or]z8;
debacle: [n]解冻,崩溃;灾害; [acc]/dɪˈbɑːkl/; [or]z8;
conjecture: [n]推测;猜想; [v]推测;揣摩; [acc]/kənˈdʒektʃər/; [or]z8;
charisma: [n]魅力; [acc]/kəˈrɪzmə/; [or]z8;
patronage: [n]惠顾;赞助;任免权; [acc]/ˈpætrənɪdʒ/; [or]z8;
dote: [v]溺爱;昏愦; [acc]/doʊt/; [or]z8;
grate: [n]壁炉;格栅; [v]磨碎,使人烦燥; [acc]/ɡreɪt/; [or]z8;
spinner: [n]纺纱机,纺纱工人,旋式诱饵; [acc]/ˈspɪnər/; [or]z8;
buddy: [n]密友,好朋友,伙伴;小男孩; [vi]交朋友,做好朋友; [acc]/ˈbʌdi/; [or]z8;
pervade: [vt]普及;渗透;弥漫; [vi]弥漫;渗透; [acc]/pərˈveɪd/; [or]z8;
centenary: [n]一百年; adj. 一百年的; [acc]/senˈtenəri/; [or]z8;
icon: [n]图标,肖像,偶像; [acc]/ˈaɪkɑːn/; [or]z8;
legislate: [v]立法,制定法律; [acc]/ˈledʒɪsleɪt/; [or]z8;
intermingle: [v]混合,搀杂; [acc]/ˌɪntərˈmɪŋɡl/; [or]z8;
enigmatic: adj. 神秘的,高深莫测的,谜一般的; [acc]/ˌenɪɡˈmætɪk/; [or]z8;
falsity: [n]谎言,不真实; [acc]/ˈfɔːlsəti/; [or]z8;
extricate: [v]拯救,救出; [n]解脱;解脱者; [acc]/ˈekstrɪkeɪt/; [or]z8;
devastate: [v]摧毁;使垮掉,使不知所措,使陷于混乱; [acc]/ˈdevəsteɪt/; [or]z8;
spectrum: [n]光谱,范围,系列; [acc]/ˈspektrəm/; [or]z8;
lucrative: adj. 合算的;获利的;有利可图的; [acc]/ˈluːkrətɪv/; [or]z8;
salient: adj. 显著的;突出的;跳跃的; [n]凸角;突出部分; [acc]/ˈseɪliənt/; [or]z8;
depreciate: [v]贬低,轻视;贬值;折旧; [acc]/dɪˈpriːʃieɪt/; [or]z8;
vanilla: [n]香草子,香草精; [acc]/vəˈnɪlə/; [or]z8;
municipality: [n]市民;市政当局;自治市或区; [acc]/mjuːˌnɪsɪˈpæləti/; [or]z8;
hunk: [n]大块,有魅力的健壮男子; [acc]/hʌŋk/; [or]z8;
snout: [n]猪嘴,猪鼻子; [v]装管嘴; [acc]/snaʊt/; [or]z8;
stimulant: [n][药]兴奋剂;刺激物;酒精饮料; adj. 激励的;使人兴奋的; [acc]/ˈstɪmjələnt/; [or]z8;
etiquette: [n]礼仪; [acc]/ˈetɪket/; [or]z8;
ascendant: [n]优势,支配地位; adj. 上升的,优越的; [acc]/əˈsendənt/; [or]z8;
tongs: [n]夹子,钳子; [v]用钳子(夹); [acc]/tɔːŋz/; [or]z8;
retrospective: adj. 回顾的;怀旧的;可追溯的; [n]作品回顾展出; [acc]/ˌretrəˈspektɪv/; [or]z8;
nestle: [vt]依偎; [vi](舒适地)安顿;抱; [v]半隐半现地处于;安顿下来; [acc]/ˈnesl/; [or]z8;
detonate: [v](使)爆炸,引爆; [acc]/ˈdetəneɪt/; [or]z8;
prone: adj. 易于.的;有.倾向的;俯卧的; [acc]/proʊn/; [or]z8;
savant: [n]博学之士,大学士; [acc]/sæˈvɑːnt/; [or]z8;
magpie: [n][鸟类]喜鹊,饶舌者; adj. 似喜鹊的,喜欢随便收集的; [acc]/ˈmæɡpaɪ/; [or]z8;
juvenile: [n]青少年;雏鸟; adj. 青少年的;幼稚的; [acc]/ˈdʒuːvənl/; [or]z8;
delirious: adj. 精神错乱的,发狂的; [acc]/dɪˈlɪriəs/; [or]z8;
fixture: [n]固定装置;体育项目; [acc]/ˈfɪkstʃər/; [or]z8;
insurmountable: adj. 不能克服的,不能超越的,难以对付的; [acc]/ˌɪnsərˈmaʊntəbl/; [or]z8;
pouch: [n]小袋,烟草袋,钱袋,育儿袋; [v]把..装入袋中,使成袋状; [acc]/paʊtʃ/; [or]z8;
assortment: [n]分类;混合物; [acc]/əˈsɔːrtmənt/; [or]z8;
instantaneous: adj. 瞬间的;即刻的;猝发的; [acc]/ˌɪnstənˈteɪniəs/; [or]z8;
forgo: [v]放弃;停止;对.断念; [acc]/fɔːrˈɡoʊ/; [or]z8;
abode: [n]住处,住所; [vt]<古>预兆,预示; [acc]/əˈboʊd/; [or]z8;
kin: [n]亲属; [acc]/kɪn/; [or]z8;
mundane: adj. 普通的,平凡的;单调的;现世的,世俗的; [acc]/mʌnˈdeɪn/; [or]z8;
bitch: [n]母狗;泼妇; [vi]发牢骚; adj. 不合标准的; [vt]轻率拙劣地把.弄糟; [acc]/bɪtʃ/; [or]z8;
shack: [n]棚屋;小室; [v]居住; [acc]/ʃæk/; [or]z8;
twitch: [v]猛拉,抽筋,痉挛; [n]抽搐,颤动; [acc]/twɪtʃ/; [or]z8;
lesbian: [n]女性同性恋者; adj. 女同性恋的;女同性恋者的; [acc]/ˈlezbiən/; [or]z8;
memorandum: [n]便签,备忘录;报告; [acc]/ˌmeməˈrændəm/; [or]z8;
serrated: adj. 呈锯齿状的; [acc]/səˈreɪtɪd/; [or]z8;
dispirited: adj. 沮丧的;消沉的;情绪低落的;灰心的; [acc]/dɪˈspɪrɪtɪd/; [or]z8;
hermetic: adj. 密封的;与外界隔绝的;不透气的;炼金术的; [acc]/hɜːrˈmetɪk/; [or]z8;
debase: [v]贬值,降低; [acc]/dɪˈbeɪs/; [or]z8;
assimilate: [v]使同化;吸收;消化; [acc]/əˈsɪməleɪt/; [or]z8;
gratify: [v]使高兴,使满足; [acc]/ˈɡrætɪfaɪ/; [or]z8;
bog: [n]沼泽;泥塘; [v]陷于泥沼;动弹不得; [acc]/bɑːɡ/; [or]z8;
faze: [v]打扰,折磨,使狼狈,使担忧; [acc]/feɪz/; [or]z8;
tacky: adj. 粘而未干的,缺乏教养或风度的,俗气的; [acc]/ˈtæki/; [or]z8;
polarity: [n](分)极性;相对的观点; [acc]/pəˈlærəti/; [or]z8;
taint: [n]污点;感染;异味; [vi]腐败,腐烂; [vt]污染;玷污,使受不良影响; [acc]/teɪnt/; [or]z8;
airy: adj. 空气的;通风的;幻想的;轻快的;空中的; [acc]/ˈeri/; [or]z8;
hornet: [n]大黄蜂; [acc]/ˈhɔːrnɪt/; [or]z8;
ferocity: [n]凶猛,残暴; [acc]/fəˈrɑːsəti/; [or]z8;
arduous: adj. 艰巨的;努力的;陡峭的; [acc]/ˈɑːrdʒuəs/; [or]z8;
errant: adj. 错误的,脱离正途的,迷路的;周游的,漂泊的;无定的; [n]游侠; [acc]/ˈerənt/; [or]z8;
canter: [n]慢跑(多用于马); [acc]/ˈkæntər/; [or]z8;
billiards: [n]台球;英式台球;弹子戏; [acc]/ˈbɪljərdz/; [or]z8;
rapt: adj. 全神贯注的,着迷的;狂喜的; [acc]/ræpt/; [or]z8;
impasse: [n]僵局;死路; [acc]/ˈɪmpæs/; [or]z8;
handicraft: [n]手工艺;手工制品; [acc]/ˈhændikræft/; [or]z8;
waive: [v]放弃;不坚持;推迟;搁置; [vt]抑制;搁置; [acc]/weɪv/; [or]z8;
defile: [v]污损,弄脏;以纵队前进; [n]狭谷;隘路; [acc]/dɪˈfaɪl/; [or]z8;
helm: [n]舵;驾驶盘;领导地位; [v]指挥;给..掌舵; [acc]/helm/; [or]z8;
squash: [v]压扁,压制; [n]南瓜,易压烂的物品,拥挤的人群,壁球; [acc]/skwɑːʃ/; [or]z8;
isotope: [n]同位素; [acc]/ˈaɪsətoʊp/; [or]z8;
wizard: [n]男巫,奇才; adj. 男巫的,有魔力的; [v]〈罕〉施巫术; [acc]/ˈwɪzərd/; [or]z8;
abusive: adj. 辱骂的;滥用的;虐待的; [acc]/əˈbjuːsɪv/; [or]z8;
broker: [n]经纪人,掮客; [v]作为经纪人进行谈判,以中间人等身份安排; [acc]/ˈbroʊkər/; [or]z8;
feckless: adj. 不负责任的,无目标无计划的,无效的; [adv]没有价值地;没有长远目标地;不负责任地; [n]没有价值,没有长远目标,不负责任; [acc]/ˈfekləs/; [or]z8;
syndicate: [n]辛迪加;企业联合;财团; [v]联合成辛迪加;组成企业联合组织;在多家报刊上同时发表; [acc]/ˈsɪndɪkət/; [or]z8;
menial: adj. 仆人的,乏味的; [n]家仆; [acc]/ˈmiːniəl/; [or]z8;
weird: adj. 古怪的;荒唐的; [acc]/wɪrd/; [or]z8;
pungent: adj. 刺激性的;刺鼻的;尖锐的; [acc]/ˈpʌndʒənt/; [or]z8;
falsify: [v]篡改,说谎; [acc]/ˈfɔːlsɪfaɪ/; [or]z8;
figurative: adj. 比喻的,修饰丰富的,形容多的; [acc]/ˈfɪɡərətɪv/; [or]z8;
truce: [n]停战;休战;休战协定; [acc]/truːs/; [or]z8;
mire: [n]泥沼,困境; [acc]/ˈmaɪər/; [or]z8;
monsoon: [n]季雨,季风,大雨; [acc]/ˌmɑːnˈsuːn/; [or]z8;
monochrome: adj. 单色的; [n]单色画;单色照片,黑白照片; [acc]/ˈmɑːnəkroʊm/; [or]z8;
muzzle: [n]动物之鼻口,(动物的)口套,钳制言论的手段,枪口,喷嘴; [vt]戴口络于,上口罩; [acc]/ˈmʌzl/; [or]z8;
adamant: adj. 强硬的,固执的; [n]坚硬的东西;坚石; [acc]/ˈædəmənt/; [or]z8;
crap: [n]废话,废物,屎; [v]掷骰子,拉屎; adj. 坏的;糟糕的;劣质的; [acc]/kræp/; [or]z8;
miscellaneous: adj. 多种的,混杂的; [n]杂货;杂项; [acc]/ˌmɪsəˈleɪniəs/; [or]z8;
javelin: [n]标枪,投枪; [acc]/ˈdʒævlɪn/; [or]z8;
tenure: [n]任期;终身职位; [acc]/ˈtenjər/; [or]z8;
disseminate: [v]宣传,传播;散布; [acc]/dɪˈsemɪneɪt/; [or]z8;
picket: [n]警戒哨,纠察队,尖木桩; [v]派..担任纠察,担任纠察; [acc]/ˈpɪkɪt/; [or]z8;
continuum: [n]连续,连续统,闭连集; [acc]/kənˈtɪnjuəm/; [or]z8;
upsurge: [n]高潮,高涨; [acc]/ˈʌpsɜːrdʒ/; [or]z8;
encore: [n]再演唱的要求,经要求而再唱; [v]要求再演或唱; int. 再来一个; [acc]/ˈɑːŋkɔːr/; [or]z8;
flaccid: adj. 软弱的,无活力的,没气力的,松弛的; [acc]/ˈflæsɪd/; [or]z8;
succumb: [v]屈从,屈服,因.死亡(to); [acc]/səˈkʌm/; [or]z8;
renegade: [n]叛教者,脱党者,叛徒; [v]背叛,背教,变节; adj. 叛教的,背叛的,变节的; [acc]/ˈrenɪɡeɪd/; [or]z8;
posthumous: adj. 遗腹的;著作者死后出版的;死后的; [acc]/ˈpɑːstʃəməs/; [or]z8;
lunge: [n]突然刺(入);突然向前冲〔扑等);套马索; [v](用剑等)刺,戳;猛向前冲,猛扑; [acc]/lʌndʒ/; [or]z8;
rinse: [v](用清水)刷,冲洗掉,漂净,漱口; [n]嗽洗,漂洗,漂清,冲洗; [acc]/rɪns/; [or]z8;
solvent: adj. 有偿付能力的;有溶解力的; [n]溶剂;解决方法; [acc]/ˈsɑːlvənt/; [or]z8;
vantage: [n]优势;有利情况; [acc]/'vɑːntɪdʒ/; [or]z8;
revoke: [v]撤回,取消;废除; [n]有牌不跟; [acc]/rɪˈvoʊk/; [or]z8;
tributary: [n]支流;进贡国;附属国; adj. 支流的;附属的;辅助的; [acc]/ˈtrɪbjəteri/; [or]z8;
budge: [v]移动一点;妥协; [acc]/bʌdʒ/; [or]z8;
rumble: [vt]使隆隆响; [v]低沉地说; [n]隆隆声;抱怨声; [vi]隆隆响; [acc]/ˈrʌmbl/; [or]z8;
deride: [v]嘲弄,愚弄; [acc]/dɪˈraɪd/; [or]z8;
stow: [v]装载,收藏,使暂留; [n]斯托; [acc]/stoʊ/; [or]z8;
evolutionary: adj. 进化的,演进的; [acc]/ˌevəˈluːʃəneri/; [or]z8;
blunder: [n]愚蠢之举;大错; [vi]犯大错; [v]失策;绊倒; [acc]/ˈblʌndər/; [or]z8;
requisite: [n]必需品; adj. 需要的,必不可少的,必备的; [acc]/ˈrekwɪzɪt/; [or]z8;
chronology: [n]年代学;(事件等)按年月次序的排列;年表; [acc]/krəˈnɑːlədʒi/; [or]z8;
fishery: [n]渔场;养鱼场所; [acc]/ˈfɪʃəri/; [or]z8;
augment: [v]增加;助长; [acc]/ɔːɡˈment/; [or]z8;
bounty: [n]慷慨;赠物;奖金; [vt]发给.奖金; [acc]/ˈbaʊnti/; [or]z8;
migrant: [n]候鸟;移民; [acc]/ˈmaɪɡrənt/; [or]z8;
buffer: [n]缓冲,缓冲区; [v]缓冲; [acc]/ˈbʌfər/; [or]z8;
proximity: [n]接近;邻近; [acc]/prɑːkˈsɪməti/; [or]z8;
stance: [n]立场,姿态,位置; [acc]/stæns/; [or]z8;
blurt: [v]突然说出,冲动地说; [acc]/blɜːrt/; [or]z8;
insulate: [v]隔离,使隔绝(以免受到影响);使隔热; [acc]/ˈɪnsəleɪt/; [or]z8;
extort: [vt]敲诈,勒索; [acc]/ɪkˈstɔːrt/; [or]z8;
disparate: adj. 迥然不同的; [acc]/ˈdɪspərət/; [or]z8;
dapper: adj. 干净利落的,衣冠楚楚的; [acc]/ˈdæpər/; [or]z8;
chaplain: [n]牧师,专职教士; [acc]/ˈtʃæplɪn/; [or]z8;
consecrate: [v]使神圣,(用宗教仪式)授予..以某种职位; adj. 神圣的;被献给神的; [acc]/ˈkɑːnsɪkreɪt/; [or]z8;
eulogy: [n]颂词,赞美词; [acc]/ˈjuːlədʒi/; [or]z8;
conspiracy: [n]密谋,阴谋; [acc]/kənˈspɪrəsi/; [or]z8;
omelette: [n]煎蛋卷,摊鸡蛋,鸡蛋饼; [acc]/ˈɑːmlət/; [or]z8;
gripe: [n]控制,发牢骚,肠绞痛; [v]抱怨,发牢骚; [acc]/ɡraɪp/; [or]z8;
hubbub: [n]嘈杂,喧哗; [acc]/ˈhʌbʌb/; [or]z8;
uncouth: adj. 笨拙的;粗野的;不舒适的;陌生的; [acc]/ʌnˈkuːθ/; [or]z8;
scaffold: [n]支架;断头台;脚手架;脚手架材料; [vt]给.搭脚手架; [acc]/ˈskæfoʊld/; [or]z8;
fluke: [n]侥幸成功;意外的挫折; [v]侥幸做成;意外受挫; [acc]/fluːk/; [or]z8;
histrionic: adj. 戏剧的,装腔作势的,作戏的; [n]演员;戏剧表演;舞台艺术;戏剧似的言行; [acc]/ˌhɪstriˈɑːnɪk/; [or]z8;
horoscope: [n]占星术,星象,十二宫图; [acc]/ˈhɔːrəskoʊp/; [or]z8;
hike: [n]远足,徒步旅行;(数量,价格等)增加,上升; [v]作长途徒步旅行;使高涨,提高(价格); [acc]/haɪk/; [or]z8;
anesthesia: [n]麻醉;麻木(等于anaesthesia); [acc]/ˌænəsˈθiʒə/; [or]z8;
outcast: [n]被逐出者;流浪者; adj. 被抛弃的,被逐出的; [acc]/ˈaʊtkæst/; [or]z8;
chaste: adj. 贞洁的;纯洁的;朴素的; [acc]/tʃeɪst/; [or]z8;
distraught: adj. 发狂的;心烦意乱的; [acc]/dɪˈstrɔːt/; [or]z8;
infirm: adj. 衰弱的;意志薄弱的;不坚固的; [acc]/ɪnˈfɜːrm/; [or]z8;
relentless: adj. 顽强的;持续的;坚定地;冷酷的; [acc]/rɪˈlentləs/; [or]z8;
benchmark: [n]基准;标准检查程序; [v]用基准问题测试(计算机系统等); [acc]/ˈbentʃmɑːrk/; [or]z8;
corroborate: [v]支持或证实,强化; [n]确证者,证物; [acc]/kəˈrɑːbəreɪt/; [or]z8;
encroach: [v]侵犯,侵占;蚕食(on); [acc]/ɪnˈkroʊtʃ/; [or]z8;
lament: [v]哀悼;惋惜;悲叹; [n]悲叹;悼词; [acc]/ləˈment/; [or]z8;
roundup: [n]综述,集拢,围捕; [acc]/'raʊndˌʌp/; [or]z8;
begrudge: [v]嫉妒,吝惜,舍不得给; [acc]/bɪˈɡrʌdʒ/; [or]z8;
seduction: [n]诱惑,魅力;诱惑物; [acc]/sɪˈdʌkʃn/; [or]z8;
resilience: [n]恢复力;弹力;顺应力; [acc]/rɪˈzɪliəns/; [or]z8;
gaunt: adj. 憔悴的,瘦削的; [n]憔悴,荒凉; [acc]/ɡɔːnt/; [or]z8;
dictum: [n]名言,格言;法官的附带意见; [acc]/ˈdɪktəm/; [or]z8;
acclaim: [n]欢呼,赞扬,称赞; [v]欢呼,喝彩,鼓掌欢迎; [vt]鼓掌欢迎,向.欢呼,为.喝彩;推选; [acc]/əˈkleɪm/; [or]z8;
diehard: [n]顽固分子,保守分子; adj. 顽固的,执拗的; [acc]/ˈdaɪhɑːrd/; [or]z8;
emboss: [v]加浮雕花纹于;使凸出;装饰; [acc]/ɪmˈbɔːs/; [or]z8;
stupor: [n]恍惚,昏迷,不醒人事; [acc]/ˈstuːpər/; [or]z8;
dissipated: adj. 消散的;沉迷于酒色的;闲游浪荡的;放荡的; [acc]/ˈdɪsɪpeɪtɪd/; [or]z8;
finicky: adj. 苛求的,过份讲究的; [acc]/ˈfɪnɪki/; [or]z8;
moat: [n]壕沟,护城河; [acc]/moʊt/; [or]z8;
horticulture: [n]园艺;园艺学; [acc]/ˈhɔːrtɪkʌltʃər/; [or]z8;
shrinkage: [n]收缩;减低; [acc]/ˈʃrɪŋkɪdʒ/; [or]z8;
ineluctable: adj. 不可改变的,无法逃避的; [acc]/ˌɪnɪˈlʌktəbl/; [or]z8;
adversity: [n]逆境,不幸,灾难; [acc]/ədˈvɜːrsəti/; [or]z8;
seedy: adj. 多种子的,结籽的,破旧的,褴褛的; [acc]/ˈsiːdi/; [or]z8;
overture: [n]主动表示,姿态;前奏曲;序言,事件的开端;提出问题; [vt]作为一种主动姿态提出;向.提出建议; [acc]/ˈoʊvərtʃər/; [or]z8;
insinuate: [v]暗指,暗示; [acc]/ɪnˈsɪnjueɪt/; [or]z8;
doldrums: [n](海洋上的)无风带,情绪低沉; [acc]/ˈdoʊldrəmz/; [or]z8;
fraudulent: adj. 欺诈的,欺骗性的,骗得的; [acc]/ˈfrɔːdʒələnt/; [or]z8;
flit: [n]轻快的飞行;迁移; [vi]掠过;轻快地飞过;偷偷溜走;去世; [acc]/flɪt/; [or]z8;
semblance: [n]相似;外表,外貌; [acc]/ˈsembləns/; [or]z8;
gush: [v]涌出;滔滔不绝地说,洋洋洒洒地写; [n]迸发; [acc]/ɡʌʃ/; [or]z8;
decelerate: [v](使)减速; [acc]/ˌdiːˈseləreɪt/; [or]z8;
tarnish: [n]弄脏;失去光泽,生锈; [v]变灰暗,失去光泽,破坏(形象等); [acc]/ˈtɑːrnɪʃ/; [or]z8;
observance: [n](法律习俗等的)遵守;奉行;庆祝,礼仪,仪式; [acc]/əbˈzɜːrvəns/; [or]z8;
accentuate: [v]强调;重读; [acc]/əkˈsentʃueɪt/; [or]z8;
marquee: [n]选取框;大天幕;华盖; adj. 〈美〉最重要的; [acc]/mɑːrˈkiː/; [or]z8;
grid: [n]格子,地图坐标; [acc]/ɡrɪd/; [or]z8;
propagate: [v]繁殖,增殖; [vt]传播,宣传; [acc]/ˈprɑːpəɡeɪt/; [or]z8;
mollify: [v]安慰,安抚; [acc]/ˈmɑːlɪfaɪ/; [or]z8;
stratum: [n]层次;薄层;地层;阶层; [acc]/ˈstreɪtəm/; [or]z8;
irreverent: adj. 不敬的,无礼的; [acc]/ɪˈrevərənt/; [or]z8;
revulsion: [n]剧变,厌恶,强烈反感; [acc]/rɪˈvʌlʃn/; [or]z8;
pun: [n]双关语; [v]说双关语,用双关语; [acc]/pʌn/; [or]z8;
revere: [v]敬畏;尊敬;崇敬; [acc]/rɪˈvɪr/; [or]z8;
reverie: [n]幻想,沉思,幻想曲; [acc]/ˈrevəri/; [or]z8;
ewe: [n][畜牧]母羊; [acc]/juː/; [or]z8;
pester: [v]使烦恼,纠缠; [acc]/ˈpestər/; [or]z8;
deluxe: adj. 豪华的,华丽的; [acc]/dɪˈlʌks/; [or]z8;
convene: [v]集合,召集,召唤; [acc]/kənˈviːn/; [or]z8;
hospice: [n]收容所,旅客招待所,救济院; [acc]/ˈhɑːspɪs/; [or]z8;
germinate: [v]发芽,发展,生长; [acc]/ˈdʒɜːrmɪneɪt/; [or]z8;
nipple: [n]乳头;奶嘴; [acc]/ˈnɪpl/; [or]z8;
fuse: [n]导火线,引信,保险丝; [v](使)因保险丝熔断而中断工作,熔合,合并; [acc]/fjuːz/; [or]z8;
blatant: adj. 喧哗的;露骨的;公然的;明目张胆的; [acc]/ˈbleɪtnt/; [or]z8;
drape: [v]用布帘覆盖,使呈褶裥状; [n]窗帘,褶裥; [acc]/dreɪp/; [or]z8;
frenetic: adj. 狂乱的;非常激动的; [n]疯子;狂人; [acc]/frəˈnetɪk/; [or]z8;
opulent: adj. 富裕的,充足的; [acc]/ˈɑːpjələnt/; [or]z8;
denizen: [n]居民,外籍居民; [acc]/ˈdenɪzn/; [or]z8;
choppy: adj. 波涛汹涌的;不断改变方向的; [acc]/ˈtʃɑːpi/; [or]z8;
severity: [n]严格,严肃; [acc]/sɪˈverəti/; [or]z8;
mash: [v]捣碎; [n]糊状物; [acc]/mæʃ/; [or]z8;
girder: [n][建]大梁;纵梁;撑住; [acc]/ˈɡɜːrdər/; [or]z8;
indigestion: [n]消化不良;不消化; [acc]/ˌɪndɪˈdʒestʃən/; [or]z8;
laborious: adj. 费时费力的,辛苦的;艰苦的; [acc]/ləˈbɔːriəs/; [or]z8;
rapport: [n]密切关系,交往;和谐一致;意见一致; [acc]/ræˈpɔːr/; [or]z8;
banal: adj. 陈腐的;平庸的;老一套的; [acc]/bəˈnɑːl/; [or]z8;
robust: adj. 健壮的,强壮的;精力充沛的;坚固的;粗鲁的; [acc]/roʊˈbʌst/; [or]z8;
exude: [v]慢慢流出,四溢,渗出,散发; [acc]/ɪɡˈzuːd/; [or]z8;
indoctrinate: [v]灌输思想; [acc]/ɪnˈdɑːktrɪneɪt/; [or]z8;
coddle: [v]溺爱;用文火煮; [n]〈口〉娇生惯养的人; [acc]/ˈkɑːdl/; [or]z8;
daredevil: [n]铤而走险的人,蛮勇的人; adj. 蛮勇的,不怕死的; [acc]/ˈderdevl/; [or]z8;
benediction: [n]祝福,祈祷; [acc]/ˌbenɪˈdɪkʃn/; [or]z8;
bearing: [n]方向;举止;轴承; [acc]/ˈberɪŋ/; [or]z8;
corollary: [n]推论;必然的结果; [acc]/ˈkɔːrəleri/; [or]z8;
unruly: adj. 不守规矩的;任性的;难驾驭的; [acc]/ʌnˈruːli/; [or]z8;
carat: [n]公制克拉;(金子)开; [acc]/ˈkærət/; [or]z8;
panther: [n]豹;黑豹; [acc]/ˈpænθər/; [or]z8;
resin: [n]树脂,松香; [vt]涂树脂,用树脂处理; [acc]/ˈrezn/; [or]z8;
nebulous: adj. 朦胧的,星云的,星云状的; [acc]/ˈnebjələs/; [or]z8;
percussion: [n]撞击,敲击;敲打乐器; [acc]/pərˈkʌʃn/; [or]z8;
peek: [v]偷看,窥视; [n]偷看,窥见; [acc]/piːk/; [or]z8;
catalyst: [n]催化剂;造成变化的人或事; [acc]/ˈkætəlɪst/; [or]z8;
adulterate: [v]掺假; adj. 通奸的;搀杂的; [n]掺假; [acc]/əˈdʌltəreɪt/; [or]z8;
swap: [v]交换;替换;对调; [n]交换;交换物; [acc]/swɑːp/; [or]z8;
waver: [vi]犹豫;摇摆;颤抖; [acc]/ˈweɪvər/; [or]z8;
bonnet: [n]圆帽,扁平软帽; [vt]给.戴上; [acc]/ˈbɑːnət/; [or]z8;
whirlwind: [n]旋风,旋风般的快速行动; adj. 旋风般的; [acc]/ˈwɜːrlwɪnd/; [or]z8;
amalgamate: [v]合并,混合; [acc]/əˈmælɡəmeɪt/; [or]z8;
unforeseen: adj. 无法预料的; [acc]/ˌʌnfɔːrˈsiːn/; [or]z8;
pesticide: [n]杀虫剂;农药; [acc]/ˈpestɪsaɪd/; [or]z8;
requiem: [n]安魂曲;追思弥撒; [acc]/ˈrekwiəm/; [or]z8;
flavoring: [n]调味品; [acc]/ˈfleɪvərɪŋ/; [or]z8;
bane: [n]祸根; [acc]/beɪn/; [or]z8;
autopsy: [n]验尸;[病理][特医]剖检; [acc]/ˈɔːtɑːpsi/; [or]z8;
subversive: [n]颠覆分子,破坏分子; adj. 颠覆性的,破坏性的; [acc]/səbˈvɜːrsɪv/; [or]z8;
pageant: [n]盛会,历史剧,选美; [acc]/ˈpædʒənt/; [or]z8;
fieldwork: [n]现场工作,野外工作; [acc]/ˈfiːldwɜːrk/; [or]z8;
rapprochement: [n]和好,恢复邦交; [acc]/ˌræproʊʃˈmɑːn/; [or]z8;
wag: [n]摇摆;爱说笑的人; [v]摇动; [acc]/wæɡ/; [or]z8;
fallacious: adj. 谬误的,易误解的,虚妄的; [acc]/fəˈleɪʃəs/; [or]z8;
expunge: [v]删除; [acc]/ɪkˈspʌndʒ/; [or]z8;
reshape: [v]改造,改变形式; [acc]/ˌriːˈʃeɪp/; [or]z8;
transcribe: [v]抄写,转录; [acc]/trænˈskraɪb/; [or]z8;
agitation: [n]摇动;焦虑,忧虑;煽动; [acc]/ˌædʒɪˈteɪʃn/; [or]z8;
surly: adj. 乖戾的;无礼的;阴沉的; [acc]/ˈsɜːrli/; [or]z8;
disconcert: [v]使仓皇失措;使困惑;破坏; [acc]/ˌdɪskənˈsɜːrt/; [or]z8;
supremacy: [n]至高;最高权力,霸权; [acc]/suːˈpreməsi/; [or]z8;
ensconce: [v]安置;安顿下来;使.隐藏; [acc]/ɪnˈskɑːns/; [or]z8;
extant: adj. 现存的;显著的; [acc]/ekˈstænt/; [or]z8;
atrocious: adj. 糟透的,残暴的,骇人听闻的; [acc]/əˈtroʊʃəs/; [or]z8;
simpleton: [n]傻子;笨蛋; [acc]/ˈsɪmpltən/; [or]z8;
nomenclature: [n]术语,命名系统; [acc]/ˈnoʊmənkleɪtʃər/; [or]z8;
muffin: [n]小松饼; [acc]/ˈmʌfɪn/; [or]z8;
auspicious: adj. 吉兆的,幸运的; [acc]/ɔːˈspɪʃəs/; [or]z8;
shroud: [n]寿衣,覆盖物; [v]覆盖,包以尸衣; [acc]/ʃraʊd/; [or]z8;
daffodil: [n]水仙花; adj. 水仙花色的; [acc]/ˈdæfədɪl/; [or]z8;
vat: [n]大缸,瓮染料制剂; [vt]把.装入大桶; [acc]/væt/; [or]z8;
outcry: [n]大声喊叫;强烈抗议;拍卖; [acc]/ˈaʊtkraɪ/; [or]z8;
surrogate: [n]代替品,代理人,代孕妈妈; adj. 代理的,替代的; [v]代替,代理;指定为自己的代理人,接替; [acc]/ˈsɜːrəɡət/; [or]z8;
righteous: adj. 正直的,正当的,公正的; [acc]/ˈraɪtʃəs/; [or]z8;
rendition: [n]表演,演奏;译文;给予,提供; [acc]/renˈdɪʃn/; [or]z8;
thermodynamics: [n]热力学; [acc]/ˌθɜːrmoʊdaɪˈnæmɪks/; [or]z8;
hurdle: [n]跳栏,障碍; [v]用篱笆围; [acc]/ˈhɜːrdl/; [or]z8;
inveterate: adj. 积习已深的,根深蒂固的,长期形成的; [acc]/ɪnˈvetərət/; [or]z8;
compunction: [n]懊悔,良心不安; [acc]/kəmˈpʌŋkʃn/; [or]z8;
domicile: [n]住宅;永久居住地;期票支付场所; [v]居住;使在指定的场所支付(期票等; adj. 定居;在固定住所生活; [acc]/ˈdɑːmɪsaɪl/; [or]z8;
verse: [n]诗句,诗节,诗; [acc]/vɜːrs/; [or]z8;
aquarium: [n]水族馆,水族箱,鱼缸; [acc]/əˈkweriəm/; [or]z8;
extremity: [n]尽头,末端,极端;绝境;身体末端 (尤指手和脚);脚趾; [acc]/ɪkˈstreməti/; [or]z8;
perceptive: adj. 感知的,知觉的;有知觉力的; [acc]/pərˈseptɪv/; [or]z8;
refurbish: [v]刷新,再磨光; [acc]/ˌriːˈfɜːrbɪʃ/; [or]z8;
downhill: [adv]下坡,向下,每况愈下; adj. 下坡的,容易的; [n]下坡,滑降; [acc]/ˈdaʊnhɪl/; [or]z8;
homestead: [n]家园; [acc]/ˈhoʊmsted/; [or]z8;
snooty: adj. 自大的,傲慢的; [acc]/ˈsnuːti/; [or]z8;
transient: adj. 短暂的,路过的;转瞬即逝的; [n]过客; [acc]/ˈtrænʃnt/; [or]z8;
loiter: [v]虚度,闲荡,徘徊,走走停停; [acc]/ˈlɔɪtər/; [or]z8;
amenity: [n]适意;舒适;便利设施;舒适,愉快;礼仪; [acc]/əˈmenəti/; [or]z8;
boon: [n]恩惠,福利,利益; adj. 愉快的; [acc]/buːn/; [or]z8;
binge: [n]狂饮,无节制的行为; [v]狂饮作乐;大吃大喝; [acc]/bɪndʒ/; [or]z8;
lullaby: [n]催眠曲,摇篮曲,轻柔的声音; [v]唱催眠曲使入睡; [acc]/ˈlʌləbaɪ/; [or]z8;
canopy: [n]华盖;天篷;顶篷;苍穹; [vt]用天篷遮盖;遮蔽; [acc]/ˈkænəpi/; [or]z8;
inflexible: adj. 顽固的;不可弯曲的;不屈挠的;不可改变的; [acc]/ɪnˈfleksəbl/; [or]z8;
compatriot: [n]同胞; adj. 同胞的; [acc]/kəmˈpeɪtriət/; [or]z8;
hanker: [vi]渴望,追求; [acc]/ˈhæŋkər/; [or]z8;
battalion: [n]营,军营;军队,部队; [acc]/bəˈtæliən/; [or]z8;
tawdry: adj. 非常华丽的,廉价而俗丽的; [n]俗丽的东西,廉价而俗丽之物; [adv]俗丽地,华而不实地; [acc]/ˈtɔːdri/; [or]z8;
speckle: [n]斑点; [v]使弄上斑点,沾污; [acc]/ˈspekl/; [or]z8;
vogue: [n]时髦,时尚; adj. 流行的; [acc]/voʊɡ/; [or]z8;
docile: adj. 驯服的,温顺的; [acc]/ˈdɑːsl/; [or]z8;
tapeworm: [n]绦虫; [acc]/ˈteɪpwɜːrm/; [or]z8;
escalate: [v]逐步升高,逐步增强,加剧恶化; [acc]/ˈeskəleɪt/; [or]z8;
assent: [v]同意,赞成; [n]同意;赞成; [acc]/əˈsent/; [or]z8;
backbreaking: adj. 非常辛劳的,费力的; [acc]/'bækˌbreɪkɪŋ/; [or]z8;
dire: adj. 可怕的;悲惨的;极端的; [acc]/ˈdaɪər/; [or]z8;
vanquish: [v]征服,击败; [acc]/ˈvæŋkwɪʃ/; [or]z8;
memento: [n]纪念品; [acc]/məˈmentoʊ/; [or]z8;
equivocal: adj. 模棱两可的,不明确的,可疑的; [acc]/ɪˈkwɪvəkl/; [or]z8;
alleviate: [v]减轻;缓解;缓和; [acc]/əˈliːvieɪt/; [or]z8;
masquerade: [n]化装舞会;伪装,假扮; [vi]假扮; [acc]/ˌmæskəˈreɪd/; [or]z8;
quick: adj. 迅速的,快捷的; [adv]迅速地; [n](指甲下的)活肉; [acc]/kwɪk/; [or]z8;
spatial: adj. 空间的,关于空间的; [acc]/ˈspeɪʃl/; [or]z8;
versatility: [n]多功能;多用途; [acc]/ˌvɜːrsəˈtɪləti/; [or]z8;
invulnerable: adj. 无法伤害的;无懈可击的; [acc]/ɪnˈvʌlnərəbl/; [or]z8;
terse: adj. 简洁的,简明的; [acc]/tɜːrs/; [or]z8;
epitaph: [n]碑文,墓志铭; [acc]/ˈepɪtæf/; [or]z8;
jubilant: adj. 喜悦的,欢呼的; [acc]/ˈdʒuːbɪlənt/; [or]z8;
replenish: [v]补充,再装满;把.装满;给.添加燃料; [acc]/rɪˈplenɪʃ/; [or]z8;
caress: [v]抚摸; [vt]拥抱; [n]爱抚;拥抱;亲吻; [acc]/kəˈres/; [or]z8;
sartorial: adj. 裁缝匠的,裁缝的;缝纫的; [acc]/sɑːrˈtɔːriəl/; [or]z8;
centralize: [v]使集中;使成为.的中心;使集权; [acc]/ˈsentrəlaɪz/; [or]z8;
disjointed: adj. 杂乱的,无逻辑的,脱节的; [acc]/dɪsˈdʒɔɪntɪd/; [or]z8;
abreast: [adv]并肩地,并列; adj. 并排的;并肩的; [acc]/əˈbrest/; [or]z8;
finely: [adv]细小地;美好地; [acc]/ˈfaɪnli/; [or]z8;
sap: [n]树液,汁液;易上当的人; [v]削弱;逐渐耗竭; [vt]使伤元气; [vi]挖坑道进攻; [acc]/sæp/; [or]z8;
egocentric: adj. 自我中心的,利己的; [n]自我主义者; [acc]/ˌiːɡoʊˈsentrɪk/; [or]z8;
agitate: [v](尤指为法律,社会状况的改变而)激烈争论,鼓动,煽动;搅动(液体);激怒; [acc]/ˈædʒɪteɪt/; [or]z8;
poplar: [n]白杨; [acc]/ˈpɑːplər/; [or]z8;
lug: [n]耳状物;把手;笨家伙; [v]拖拉; [acc]/lʌɡ/; [or]z8;
agile: adj. 灵活的,敏捷的; [acc]/ˈædʒl/; [or]z8;
afloat: adj. 在海上的;飘浮的;浸满水的;在传播的; [adv]在海上;飘浮著;浸满水; [acc]/əˈfloʊt/; [or]z8;
allure: [v]吸引;诱使; [n]诱惑力; [acc]/əˈlʊr/; [or]z8;
tint: [n]色彩;染发剂;染色; [v]染色,着色于.; [acc]/tɪnt/; [or]z8;
equinox: [n]春分;秋分;昼夜平分点; [acc]/ˈiːkwɪnɑːks/; [or]z8;
amass: [vi]聚集; [vt]收集;积累,积聚; [acc]/əˈmæs/; [or]z8;
notwithstanding: prep. 尽管,虽然; [adv]尽管,虽然; conj. 尽管,虽然; [acc]/ˌnɑːtwɪθˈstændɪŋ/; [or]z8;
impair: [v]损害;削弱; [acc]/ɪmˈper/; [or]z8;
replica: [n]复制品; [acc]/ˈreplɪkə/; [or]z8;
fateful: adj. 重大的;决定性的;宿命的; [acc]/ˈfeɪtfl/; [or]z8;
affable: adj. 易于交谈的,和蔼的; [acc]/ˈæfəbl/; [or]z8;
mound: [n]堆,高地,护堤; [v]堆起,积成堆; [acc]/maʊnd/; [or]z8;
perimeter: [n]周长;周界; [acc]/pəˈrɪmɪtər/; [or]z8;
aroma: [n]芳香,香气; [acc]/əˈroʊmə/; [or]z8;
visage: [n]脸,面貌; [acc]/ˈvɪzɪdʒ/; [or]z8;
stag: [n]牡鹿;不带女伴的舞客;阉割过的雄鹿; adj. 全是男人的; [v]不带女伴参加晚会; [acc]/stæɡ/; [or]z8;
seductive: adj. 有魅力的;性感的;引人注意的; [acc]/sɪˈdʌktɪv/; [or]z8;
avid: adj. 渴望的,贪婪的;热心的; [acc]/ˈævɪd/; [or]z8;
forage: [v]搜寻,翻寻,觅食; [n](牛马的)饲料,粮草; [acc]/ˈfɔːrɪdʒ/; [or]z8;
coverage: [n]新闻报道;可达范围;覆盖范围; [acc]/ˈkʌvərɪdʒ/; [or]z8;
articulate: adj. 善于表达的;发音清晰的; [v]清晰地发音;清楚地讲话;连接,接合;与.合成整体 ,使相互连贯; [acc]/ɑːrˈtɪkjuleɪt/; [or]z8;
alchemy: [n]炼金术;魔力; [acc]/ˈælkəmi/; [or]z8;
renown: [n]声誉;名望; [vt]使有声望; [acc]/rɪˈnaʊn/; [or]z8;
guise: [n]外观,姿态,装束,伪装; [v]伪装; [acc]/ɡaɪz/; [or]z8;
bingo: [n]宾戈游戏; [acc]/ˈbɪŋɡoʊ/; [or]z8;
perturb: [vt]使不安;烦扰;使紊乱; [acc]/pərˈtɜːrb/; [or]z8;
embroil: [v]使卷入;使混乱; [acc]/ɪmˈbrɔɪl/; [or]z8;
feud: [n]不和;争执;封地; [v]长期不和,长期争斗; [acc]/fjuːd/; [or]z8;
infidelity: [n]不忠实,不贞; [acc]/ˌɪnfɪˈdeləti/; [or]z8;
perpetrate: [vt]犯罪,作恶;干坏事; [acc]/ˈpɜːrpətreɪt/; [or]z8;
deface: [v]损伤外观,丑化; [acc]/dɪˈfeɪs/; [or]z8;
soliloquy: [n]自言自语,独白; [acc]/səˈlɪləkwi/; [or]z8;
physique: [n]体格,体魄; [acc]/fɪˈziːk/; [or]z8;
abbreviate: [v]缩写,使省略,使用缩写词; [n]使用缩写词的人;缩短,缩写(词,短语,名字,名称); [acc]/əˈbriːvieɪt/; [or]z8;
vestige: [n]遗迹,(生)退化的器官,残余,微量(一般用于否定句); [acc]/ˈvestɪdʒ/; [or]z8;
devoid: adj. 全无的,缺乏的; [acc]/dɪˈvɔɪd/; [or]z8;
tenor: [n]男高音,要点,要旨,稳定的进程; adj. (乐器)次中音的;(组钟中的)最低音的;男高音的; [acc]/ˈtenər/; [or]z8;
intoxicate: [v]使醉,使陶醉,使中毒; adj. 陶醉的; [acc]/ɪnˈtɑːksɪkeɪt/; [or]z8;
flounder: [n]比目鱼;踉跄前进; [v]踉跄前行;(在水或泥浆中)挣扎,陷入困境; [acc]/ˈflaʊndər/; [or]z8;
sobriety: [n]清醒,冷静,节制,严肃; [acc]/səˈbraɪəti/; [or]z8;
dupe: [n]受骗的人,上当者; [v]欺骗,愚弄; [acc]/duːp/; [or]z8;
scavenger: [n]捡垃圾者;食腐动物;净化剂; [vi]作清道夫; [acc]/ˈskævɪndʒər/; [or]z8;
hedonism: [n]享乐主义; [acc]/ˈhiːdənɪzəm/; [or]z8;
implacable: adj. 难以满足的,难平息的; [acc]/ɪmˈplækəbl/; [or]z8;
epigram: [n]机智的言语; [acc]/ˈepɪɡræm/; [or]z8;
scholarly: adj. 学者气质的,学者风度的,学术的; [acc]/ˈskɑːlərli/; [or]z8;
posture: [n]姿势;看法;态度; [v]装模作样; [acc]/ˈpɑːstʃər/; [or]z8;
draught: [n]气流,通风,穿堂风;药水; [v]起草;选派; adj. 桶装的;驮物的; [acc]/dræft/; [or]z8;
pitcher: [n][棒球]投手,水罐,[植]瓶状叶; [acc]/ˈpɪtʃər/; [or]z8;
blob: [n]一滴,一抹,难以名状的一团; [v]弄脏,把.做错,得零分; [acc]/blɑːb/; [or]z8;
intern: [n]实习生;实习医师;被拘留者; [v]作实习医师;拘留; [acc]/ɪnˈtɜːrn/; [or]z8;
appease: [v]抚慰;平息; [acc]/əˈpiːz/; [or]z8;
methane: [n][有化]甲烷,[能源]沼气; [acc]/ˈmeθeɪn/; [or]z8;
nymph: [n]年轻女神,少女,蛹; [acc]/nɪmf/; [or]z8;
scuba: [n]自携式水下呼吸器; [acc]/'skjuːbə/; [or]z8;
chic: [n]时髦,款式别致; adj. 别致的;时髦的; [acc]/ʃiːk/; [or]z8;
handiwork: [n]手工艺,手工制品,行为后果; [acc]/ˈhændiwɜːrk/; [or]z8;
ornate: adj. 装饰华丽的;修辞上极考究的; [acc]/ɔːrˈneɪt/; [or]z8;
benign: adj. 仁慈的;慈祥的;(病)良性的; [acc]/bɪˈnaɪn/; [or]z8;
protocol: [n]外交礼节;草案;外交议定书; [vi]拟定议定书; [vt]把.写入议定书; [acc]/ˈproʊtəkɔːl/; [or]z8;
nonchalant: adj. 若无其事的;满不在乎的;冷静的;冷漠的; [acc]/ˌnɑːnʃəˈlɑːnt/; [or]z8;
taut: adj. 拉紧的;紧张的;整洁的; [acc]/tɔːt/; [or]z8;
banter: [n]善意地取笑,逗弄; [v]善意的与人开玩笑; [acc]/ˈbæntər/; [or]z8;
exaltation: [n]提升,提高,兴奋,得意洋洋; [acc]/ˌeɡzɔːlˈteɪʃn/; [or]z8;
repress: [vt]抑制;镇压;约束; [acc]/rɪˈpres/; [or]z8;
valor: [n]勇猛,英勇; [acc]/'vælə/; [or]z8;
venomous: adj. 恶毒的;有毒的,分泌毒液的;怨恨的; [acc]/ˈvenəməs/; [or]z8;
grotesque: adj. 奇形怪状的,奇异的; [n]奇形怪状的人(或物,图案等);奇异风格; [acc]/ɡroʊˈtesk/; [or]z8;
imagery: [n]像,肖像,画像,雕像;意象;比喻;形象化的描述; [acc]/ˈɪmɪdʒəri/; [or]z8;
categorical: adj. 绝对的;直接了当的;无条件的;属于某一范畴的; [acc]/ˌkætəˈɡɔːrɪkl/; [or]z8;
farce: [n]闹剧;胡闹;笑剧; [acc]/fɑːrs/; [or]z8;
affinity: [n]姻亲关系;密切关系;近似,类似关系;亲近; [acc]/əˈfɪnəti/; [or]z8;
twirl: [n]旋转,转动; [vi]旋转,回旋; [vt]旋转,转动; [acc]/twɜːrl/; [or]z8;
roach: [n]蟑螂,蜚蠊; [vt]梳(发)使成拱状,切短(马鬃等)使竖立; [acc]/roʊtʃ/; [or]z8;
sedative: adj. (药物)镇静的,起镇定作用的; [n](药物)镇静剂,起镇定作用的东西; [acc]/ˈsedətɪv/; [or]z8;
monumental: adj. 纪念碑的;不朽的;非常的; [acc]/ˌmɑːnjuˈmentl/; [or]z8;
intrusive: adj. 侵入的;打扰的; [acc]/ɪnˈtruːsɪv/; [or]z8;
decoy: [n]诱饵;诱骗; [v]诱骗; [acc]/dɪˈkɔɪ/; [or]z8;
efface: [v]擦掉,抹去;消去; [acc]/ɪˈfeɪs/; [or]z8;
servitude: [n]劳役,奴役; [acc]/ˈsɜːrvətuːd/; [or]z8;
suggestive: adj. 提示的,启发的,暗示的; [acc]/səˈdʒestɪv/; [or]z8;
bile: [n]胆汁;愤怒; [acc]/baɪl/; [or]z8;
shapely: adj. 定形的;形状美观的;样子好的;有条理的; [acc]/ˈʃeɪpli/; [or]z8;
itinerant: [n]巡回工作者; adj. 巡回的;流动的; [acc]/aɪˈtɪnərənt/; [or]z8;
bequest: [n]遗产;遗赠物; [acc]/bɪˈkwest/; [or]z8;
vertebrate: adj. 有脊椎的; [n]脊椎动物; [acc]/ˈvɜːrtɪbrət/; [or]z8;
hub: [n]轴心,中心;木片; [acc]/hʌb/; [or]z8;
caprice: [n]任性,反复无常,随想曲; [acc]/kəˈpriːs/; [or]z8;
sexism: [n](针对女性的)性别歧视,男性至上主义; [acc]/ˈseksɪzəm/; [or]z8;
didactic: adj. 说教的;教诲的; [acc]/daɪˈdæktɪk/; [or]z8;
ignition: [n]点火,着火;点火开关; [acc]/ɪɡˈnɪʃn/; [or]z8;
tanner: [n]制革工人,六便士; [acc]/ˈtænər/; [or]z8;
fallacy: [n]谬论,谬见;错误,谬误; [acc]/ˈfæləsi/; [or]z8;
larynx: [n]喉; [acc]/ˈlærɪŋks/; [or]z8;
megaphone: [n]扩音器,喇叭筒; [v]用扩音器讲; [acc]/ˈmeɡəfoʊn/; [or]z8;
mumble: [v]含糊地说;抿着嘴嚼; [n]含糊的话;咕噜; [acc]/ˈmʌmbl/; [or]z8;
astrology: [n]占星学,占星术,星座; [acc]/əˈstrɑːlədʒi/; [or]z8;
pickle: [n]盐汁;泡菜; [v]腌; [acc]/ˈpɪkl/; [or]z8;
herbivorous: adj. 食草的; [acc]/ɜːrˈbɪvərəs/; [or]z8;
segregate: [v]分开,隔离,进行种族隔离; [acc]/ˈseɡrɪɡeɪt/; [or]z8;
brunt: [n]冲击,主要冲力; [acc]/brʌnt/; [or]z8;
decry: [v]谴责,责难,诽谤; [acc]/dɪˈkraɪ/; [or]z8;
foreboding: [n]预感,预兆; adj. 预感的,不祥之兆的; [acc]/fɔːrˈboʊdɪŋ/; [or]z8;
trinket: [n]小装饰品,不值钱的珠宝; [acc]/ˈtrɪŋkɪt/; [or]z8;
reputable: adj. 声誉好的;受尊敬的;卓越的; [acc]/ˈrepjətəbl/; [or]z8;
archetype: [n]原型,典型; [acc]/ˈɑːrkitaɪp/; [or]z8;
nucleus: [n]原子核,核心,细胞核; [acc]/ˈnuːkliəs/; [or]z8;
discerning: adj. 有辨别力的,敏锐的; [acc]/dɪˈsɜːrnɪŋ/; [or]z8;
skid: [v]打滑; [n]打滑; [acc]/skɪd/; [or]z8;
fruition: [n]享有;最后完成,实现,取得成果; [acc]/fruˈɪʃn/; [or]z8;
sentinel: [n]哨兵,看守; [v]守卫,放哨; [acc]/ˈsentɪnl/; [or]z8;
reconciliation: [n]和解,修好,和好,调停,调解; [acc]/ˌrekənsɪliˈeɪʃn/; [or]z8;
sequel: [n]续集;结局;继续;后果; [acc]/ˈsiːkwəl/; [or]z8;
stuffy: adj. 闷热的;古板的;鼻子不通气的; [acc]/ˈstʌfi/; [or]z8;
apprehend: [vt]理解,领会;逮捕;对.忧虑;把.视作; [vi]忧虑; [acc]/ˌæprɪˈhend/; [or]z8;
cleavage: [n]分裂;乳沟;裂缝; [acc]/ˈkliːvɪdʒ/; [or]z8;
permeate: [v]弥漫;普及;渗透; [acc]/ˈpɜːrmieɪt/; [or]z8;
taper: [v]逐渐变细; [n]锥形;渐弱;蜡芯,小蜡烛; [vi]变尖;逐渐减弱; [vt]变尖;逐渐减弱; adj. 渐细的;斜的;依次递减的; [acc]/ˈteɪpər/; [or]z8;
radiant: adj. 光芒四射的,绚丽的;喜悦的; [acc]/ˈreɪdiənt/; [or]z8;
churlish: adj. 脾气暴躁的;没有礼貌的; [acc]/ˈtʃɜːrlɪʃ/; [or]z8;
monogamy: [n]一夫一妻制; [acc]/məˈnɑːɡəmi/; [or]z8;
hibernate: [vi]冬眠,蛰居; [acc]/ˈhaɪbərneɪt/; [or]z8;
bonfire: [n]篝火;营火; [acc]/ˈbɑːnfaɪər/; [or]z8;
eligible: adj. 适合被选的,符合条件的;(尤指婚姻等)合适的,合意的; [acc]/ˈelɪdʒəbl/; [or]z8;
penis: [n]阳物,阴茎; [acc]/ˈpiːnɪs/; [or]z8;
liken: [v]把..比作,比拟; [acc]/ˈlaɪkən/; [or]z8;
infest: [v]骚扰,寄生于,大批出没; [acc]/ɪnˈfest/; [or]z8;
infirmity: [n]虚弱; [acc]/ɪnˈfɜːrməti/; [or]z8;
hack: [n]砍,劈;出租马车;出租车; [vt]砍,乱劈;胡乱删改;[计算机](熟练地编辑或修改)程序;非法侵入(他人计算机系统); adj. 出租的;用旧了的;(文人等)被雇佣的;雇佣文人做的; [acc]/hæk/; [or]z8;
gabble: [n]急促不清的话,胡言乱语; [vi]急促而不清楚地说,闲聊,啰嗦,喋喋不休地说; [vt]急促而不清楚地说,胡说八道; [acc]/ˈɡæbl/; [or]z8;
totalitarian: [n]极权主义者; adj. 极权主义的; [acc]/toʊˌtæləˈteriən/; [or]z8;
snuff: [v](伤风鼻阻时)用鼻子使劲地吸,扑灭; [n]灯花,烛花,鼻吸气息,气息; [acc]/snʌf/; [or]z8;
foothold: [n]立足点,根据地; [acc]/ˈfʊthoʊld/; [or]z8;
unpalatable: adj. 不可口的,不好吃的;令人不愉快的; 使人难以接受的; [acc]/ʌnˈpælətəbl/; [or]z8;
repute: [n]名声,荣誉; [vt]被认为,被称为; [acc]/rɪˈpjuːt/; [or]z8;
imprint: [n]印痕;特征;版本说明; [vt]盖;铭刻; [acc]/ɪmˈprɪnt/; [or]z8;
unilateral: adj. 单边的,单方面的;[植]单侧的;单边音;(父母)单系的; [acc]/ˌjuːnɪˈlætrəl/; [or]z8;
upcoming: adj. 即将来临的; [acc]/ˈʌpkʌmɪŋ/; [or]z8;
lawsuit: [n]诉讼,诉讼案件; [acc]/ˈlɔːsuːt/; [or]z8;
flunk: [v]考试不及格; [n]失败,不及格; [acc]/flʌŋk/; [or]z8;
muster: [vi]集合;聚集; [vt]集合;召集; [n]集合;集合人员; [acc]/ˈmʌstər/; [or]z8;
steep: [v]沉浸于..; adj. 陡峭的;急剧的;过高的; [n]陡坡; [acc]/stiːp/; [or]z8;
encumber: [v]阻塞,妨害,拖累; [acc]/ɪnˈkʌmbər/; [or]z8;
hemlock: [n]铁杉,常青树; [acc]/ˈhemlɑːk/; [or]z8;
cartridge: [n]墨盒;弹药筒,弹药;墨水,笔芯; [acc]/ˈkɑːrtrɪdʒ/; [or]z8;
indemnity: [n]赔偿物;补偿,赔偿;保障; [acc]/ɪnˈdemnəti/; [or]z8;
expectant: adj. 期待的;怀孕的;预期中的; [n]期待者;候选; [acc]/ɪkˈspektənt/; [or]z8;
medication: [n]药物;药物治疗;药物处理; [acc]/ˌmedɪˈkeɪʃn/; [or]z8;
bask: [vi]晒太阳(享受温暖),感到温暖,愉快或舒适; [n]晒太阳,取暖;沉浸于; [acc]/bæsk/; [or]z8;
raffle: [n]废物;抽彩票; [v]抽彩票; [acc]/ˈræfl/; [or]z8;
sanctify: [vt]使神圣化,使合法化; [acc]/ˈsæŋktɪfaɪ/; [or]z8;
emaciated: adj. 瘦弱的;憔悴的; [acc]/ɪˈmeɪʃieɪtɪd/; [or]z8;
improvise: [v]即席创作,临时凑成; [acc]/ˈɪmprəvaɪz/; [or]z8;
incredulous: adj. 怀疑的,不轻信的; [acc]/ɪnˈkredʒələs/; [or]z8;
slime: [n]烂泥;粘土;黏液; [vi]覆有黏液; [vt]用(稀泥,粘液等)涂抹,使变黏滑; [acc]/slaɪm/; [or]z8;
festivity: [n]欢庆,欢宴,庆典,欢乐; [acc]/feˈstɪvəti/; [or]z8;
gape: [n]裂口,张嘴,打哈欠; [v]目瞪口呆地凝视,打哈欠,张开,裂开; [acc]/ɡeɪp/; [or]z8;
handsomely: [adv]漂亮地,慷慨地,相当大地; [acc]/ˈhænsəmli/; [or]z8;
huckster: [v]叫卖,讨价还价; [n]叫卖的小贩,小商人,零售商; [acc]/ˈhʌkstər/; [or]z8;
slug: [n]鼻涕虫,子弹,懒汉; [vi]偷懒; [vt][印刷]在.插嵌片; [acc]/slʌɡ/; [or]z8;
rue: [v]后悔,遗憾; [acc]/ruː/; [or]z8;
shirk: [v]逃避;规避(义务,责任等); [n]偷懒者; [acc]/ʃɜːrk/; [or]z8;
atrocity: [n]残暴,暴行; [acc]/əˈtrɑːsəti/; [or]z8;
epitomize: [v]摘要;化身;成为.的缩影; [acc]/ɪˈpɪtəmaɪz/; [or]z8;
flimsy: adj. 轻而薄的,脆弱的,没有价值的,不足信的; [acc]/ˈflɪmzi/; [or]z8;
plumb: [n]铅锤,测锤; [vi]垂直悬挂; adj. 垂直的; [vt]用铅锤测量; [adv]垂直地; [acc]/plʌm/; [or]z8;
fissure: [v]裂开,龟裂; [n]裂缝,裂隙; [acc]/ˈfɪʃər/; [or]z8;
terrain: [n]地面,地形; [acc]/təˈreɪn/; [or]z8;
defunct: adj. 已故的,不复存在的;不再使用的; [acc]/dɪˈfʌŋkt/; [or]z8;
gauge: [n]测量仪;尺度,标准; [v]估计,判断;计量; [acc]/ɡeɪdʒ/; [or]z8;
oversight: [n]勘漏,疏忽,失察;监督; [acc]/ˈoʊvərsaɪt/; [or]z8;
adjourn: [v]延期,休会,推迟对.采取行动; [vi]休会; [acc]/əˈdʒɜːrn/; [or]z8;
debit: [vt]记入借方,登入借方; [n]借方; [acc]/ˈdebɪt/; [or]z8;
elated: adj. 得意洋洋的;振奋的; [acc]/iˈleɪtɪd/; [or]z8;
evade: [v]躲避,回避; [acc]/ɪˈveɪd/; [or]z8;
Halloween: [n]万圣节前夕(指十月三十一日夜晚); [acc]/ˌhæloʊˈiːn/; [or]z8;
irreversible: adj. 不能翻转的;不可撤销的;不可逆的; [acc]/ˌɪrɪˈvɜːrsəbl/; [or]z8;
fortify: [v]设防于;增强; [acc]/ˈfɔːrtɪfaɪ/; [or]z8;
ultrasonic: adj. 超声的; [acc]/ˌʌltrəˈsɑːnɪk/; [or]z8;
quarantine: [v]检疫;隔离;使隔离; [n]检疫;隔离;检疫期;封锁; [acc]/ˈkwɔːrəntiːn/; [or]z8;
insanity: [n]疯狂;精神错乱,精神病;荒谬,愚蠢; [acc]/ɪnˈsænəti/; [or]z8;
ecstasy: [n]狂喜,心醉神怡; [acc]/ˈekstəsi/; [or]z8;
cede: [v]放弃;割让(领土); [acc]/siːd/; [or]z8;
mope: [v]忧郁,百无聊赖,没精打采地度过; [n]抑郁不乐; [acc]/moʊp/; [or]z8;
virulent: adj. 剧毒的;恶性的;有恶意的; [acc]/ˈvɪrələnt/; [or]z8;
hoax: [n]骗局;恶作剧; [vt]愚弄;欺骗; [acc]/hoʊks/; [or]z8;
ongoing: [n]进行,前进,发展; adj. 进行中的,不间断的; [acc]/ˈɑːnɡoʊɪŋ/; [or]z8;
sinew: [n]腱,筋,中坚力量; [v]用腱连结,(好像使用肌筋似的)给..以力量,支持; [acc]/ˈsɪnjuː/; [or]z8;
sheaf: [n]一捆,一束; [v]捆,束; [acc]/ʃiːf/; [or]z8;
buff: [vt]擦亮,擦净; [n]浅黄,浅黄色,爱好者; adj. 浅黄牛皮革制的,浅黄色的; [acc]/bʌf/; [or]z8;
incontrovertible: adj. 无可争议的; [acc]/ˌɪnkɑːntrəˈvɜːrtəbl/; [or]z8;
evocative: adj. 唤起的;唤出的; [acc]/ɪˈvɑːkətɪv/; [or]z8;
managerial: adj. 管理上的,经理的; [acc]/ˌmænəˈdʒɪriəl/; [or]z8;
henpecked: adj. 妻管严,怕老婆的; [acc]/ˈhenpekt/; [or]z8;
notification: [n]通知,布告,告示; [acc]/ˌnoʊtɪfɪˈkeɪʃn/; [or]z8;
hazel: [n]淡褐色;榛子; adj. 淡褐色的;榛树的; [acc]/ˈheɪzl/; [or]z8;
swagger: [n]傲慢的态度,大摇大摆; [v]大摇大摆地走,吹牛,傲慢; adj. 豪华时髦的; [acc]/ˈswæɡər/; [or]z8;
annuity: [n]年金,养老金;年金保险;年金享受权; [acc]/əˈnuːəti/; [or]z8;
squalid: adj. 污秽的,肮脏的,卑劣的; [acc]/ˈskwɑːlɪd/; [or]z8;
chimpanzee: [n][动物]黑猩猩; [acc]/ˌtʃɪmpænˈziː/; [or]z8;
quaver: [v]颤抖,发颤音; [n]八分音符,颤音; [acc]/ˈkweɪvər/; [or]z8;
sterilize: [vt]消毒;使不孕;使(土地)不毛; [acc]/ˈsterəlaɪz/; [or]z8;
dank: adj. 潮湿的,阴湿的;透水的; [acc]/dæŋk/; [or]z8;
dub: [v]授予(称号);为(电影)配音;混录录制(音乐); [n](西印度群岛的)强节奏音乐; [acc]/dʌb/; [or]z8;
punitive: adj. 给予惩罚,刑罚的; [acc]/ˈpjuːnətɪv/; [or]z8;
bipartisan: adj. 由两党成员组成的;被两党支持的; [acc]/ˌbaɪˈpɑːrtɪzn/; [or]z8;
gruff: adj. 粗暴的,粗哑的,脾气坏的; [vt]粗鲁地说,生硬地说; [vi]粗鲁地说,生硬地说话; [acc]/ɡrʌf/; [or]z8;
lavish: adj. 奢华的;铺张浪费的; [v]浪费;慷慨给予; [acc]/ˈlævɪʃ/; [or]z8;
headdress: [n]头巾,头饰; [acc]/ˈheddres/; [or]z8;
hypertension: [n]［医］高血压,过度紧张; [acc]/ˌhaɪpərˈtenʃn/; [or]z8;
wry: adj. 歪斜的,扭歪的,歪曲的; [v]歪曲,扭曲;扭转; [acc]/raɪ/; [or]z8;
hierarchical: adj. 分等级的; [acc]/ˌhaɪəˈrɑːrkɪkl/; [or]z8;
impetus: [n]推动力;促进; [acc]/ˈɪmpɪtəs/; [or]z8;
melodrama: [n]情节剧,传奇剧;音乐戏剧; [acc]/ˈmelədrɑːmə/; [or]z8;
ailment: [n]疾病(尤指微恙),不宁,不安; [acc]/ˈeɪlmənt/; [or]z8;
discernible: adj. 可辨别的;可识别的; [acc]/dɪˈsɜːrnəbl/; [or]z8;
jingle: [n](硬币,铃铛等发出的)叮当声;含有轻松而有节奏的韵律的诗篇; [v]发出叮当声; [acc]/ˈdʒɪŋɡl/; [or]z8;
genesis: [n](事物的)起源,发生; [acc]/ˈdʒenəsɪs/; [or]z8;
stallion: [n]种马,成年公马; [acc]/ˈstæliən/; [or]z8;
howler: [n]嚎叫的人或动物,滑稽可笑的错误; [acc]/ˈhaʊlər/; [or]z8;
rookie: [n]新手,新兵,新球员; [acc]/ˈrʊki/; [or]z8;
specter: [n]鬼魂,幽灵,恐惧; [acc]/'spektə/; [or]z8;
Baroque: adj. 巴洛克式的,结构复杂的,形式怪样的; [n]巴洛克风格,巴洛克艺术; [acc]/bəˈroʊk/; [or]z8;
extraterrestrial: adj. 地球外的,地球大气圈外的; [n]外星人,外星生物,宇航员; [acc]/ˌekstrətəˈrestriəl/; [or]z8;
implant: [v]嵌入,注入,灌输; [n][医]植入物,植入管; [acc]/ɪmˈplænt/; [or]z8;
furrow: [n]犁沟,皱纹; [v]犁田,开沟,犁出浪迹; [acc]/ˈfɜːroʊ/; [or]z8;
holocaust: [n]大屠杀,浩劫; [acc]/ˈhɑːləkɔːst/; [or]z8;
multitude: [n]大量;众多;大批;群众; [acc]/ˈmʌltɪtuːd/; [or]z8;
eavesdrop: [v]偷听,窃听; [n]屋檐水; [acc]/ˈiːvzdrɑːp/; [or]z8;
dishonor: [n]不光彩,不名誉; [v]使丢脸,凌辱; [acc]/dɪs'ɒnə/; [or]z8;
devious: adj. 迂回弯曲的,狡猾的; [acc]/ˈdiːviəs/; [or]z8;
outweigh: [v]比..重要;比..有价值;比.重; [acc]/ˌaʊtˈweɪ/; [or]z8;
shuffle: [n]拖着脚走路;混淆;洗牌; [vi]拖着脚走;推诿;洗牌; [vt]拖着;弄混;洗牌; [acc]/ˈʃʌfl/; [or]z8;
rigorous: adj. 严厉的,严格的; [acc]/ˈrɪɡərəs/; [or]z8;
susceptible: adj. 易受感染的;易受影响的;多情的; [acc]/səˈseptəbl/; [or]z8;
plight: [n]困境; [v]宣誓,保证; [acc]/plaɪt/; [or]z8;
drone: [n]无人机,无人驾驶飞机;雄蜂;单调的低音; [v]嗡嗡地响; [vi]混日子; [acc]/droʊn/; [or]z8;
glacial: adj. 冰的;冰冷的;冰河时代的; [acc]/ˈɡleɪʃl/; [or]z8;
bay: [n]海湾,港湾;困境; [vi](尤指猎犬等)吠,叫,咆哮;筑堤遏(水); [v]穷追,使陷入绝境;阻止(敌人)不使前进;向.吠叫; adj. 赤褐色的,栗色的; [acc]/beɪ/; [or]z8;
elemental: adj. 基本的;自然力的; [acc]/ˌelɪˈmentl/; [or]z8;
probation: [n]试用;缓刑;察看; [acc]/proʊˈbeɪʃn/; [or]z8;
amicable: adj. 友善的,温和的,平心静气的; [acc]/ˈæmɪkəbl/; [or]z8;
clot: [v]使凝成块; [n]凝块; [acc]/klɑːt/; [or]z8;
divisive: adj. 分裂的;区分的;造成不和的; [acc]/dɪˈvaɪsɪv/; [or]z8;
celestial: adj. 天体的,天上的; [n]天人,神仙;(指封建时代的)中国人,天朝之人; [acc]/səˈlestʃl/; [or]z8;
swine: [n]猪,卑鄙的人; [acc]/swaɪn/; [or]z8;
chauvinism: [n]沙文主义者,盲目爱国主义; [acc]/ˈʃoʊvɪnɪzəm/; [or]z8;
telling: adj. 明显的;生动的; [n]叙述; [acc]/ˈtelɪŋ/; [or]z8;
encase: [v]装入,包住,围; [acc]/ɪnˈkeɪs/; [or]z8;
magnitude: [n]巨大;震级;重要性;[数]量值; [acc]/ˈmæɡnɪtuːd/; [or]z8;
showy: adj. 华丽的,(过分)艳丽的,浮华的; [acc]/ˈʃoʊi/; [or]z8;
incarnate: adj. 化身的,人体化的,肉色的; [v]体现,使.具体化,使实体化; [acc]/ɪnˈkɑːrnət/; [or]z8;
humus: [n]腐殖质,腐植土; [acc]/ˈhjuːməs/; [or]z8;
infantile: adj. 婴儿的,幼稚的,初期的; [acc]/ˈɪnfəntaɪl/; [or]z8;
endanger: [v]危及,危害; [acc]/ɪnˈdeɪndʒər/; [or]z8;
ranger: [n]游侠,巡逻骑兵,突击队员,护林员,游荡的人,测距仪; [acc]/ˈreɪndʒər/; [or]z8;
repine: [v]不满,心中抱怨; [acc]/rɪ'paɪn/; [or]z8;
sham: [n]假货;虚假;欺诈; [v]假装; adj. 虚假的,假装的; [acc]/ʃæm/; [or]z8;
mediate: [v]调解,调停,斡旋; [acc]/ˈmiːdieɪt/; [or]z8;
pang: [n]剧痛,痛苦; [v]使剧痛,折磨; [acc]/pæŋ/; [or]z8;
frivolity: [n]轻浮;轻佻;轻薄的话(或举动); [acc]/frɪˈvɑːləti/; [or]z8;
likeness: [n]相像,相似;画像,写真; [acc]/ˈlaɪknəs/; [or]z8;
cram: [v]塞满;猛吃;仓促备考; [acc]/kræm/; [or]z8;
snigger: [v]嘻皮笑脸地笑,吃吃地笑,窃笑; [n]窃笑; [acc]/ˈsnɪɡər/; [or]z8;
mermaid: [n]美人鱼(传说中的),女子游泳健将; [acc]/ˈmɜːrmeɪd/; [or]z8;
erratic: adj. 古怪的;反复无常的,不稳定的; [acc]/ɪˈrætɪk/; [or]z8;
depository: [n]贮藏所,受托者; adj. 保管的,存储的; [acc]/dɪˈpɑːzətɔːri/; [or]z8;
mileometer: [n]计程表; [acc]/maɪˈlɑːmɪtər/; [or]z8;
transfuse: [v]输血,充满; [acc]/trænsˈfjuz/; [or]z8;
artifact: [n]人工制品;手工艺品; [acc]/ˈɑːrtɪfækt/; [or]z8;
latch: [n]闩,碰锁,弹簧锁; [v]用闩把..闩上; [acc]/lætʃ/; [or]z8;
equitable: adj. 公正的,公平的; [acc]/ˈekwɪtəbl/; [or]z8;
repentance: [n]悔恨; [acc]/rɪˈpentəns/; [or]z8;
orbital: adj. 轨道的;(城市)外环路的; [acc]/ˈɔːrbɪtl/; [or]z8;
phosphorus: [n]磷; [acc]/ˈfɑːsfərəs/; [or]z8;
haven: [n]港湾;避难所; [vt]为.提供庇护所; [acc]/ˈheɪvn/; [or]z8;
funk: [n]恐慌,怯懦,早期爵士乐; [vt](因恐惧)避开(某事物);害怕;使闻到刺鼻的味道; [vi]畏缩;发出刺鼻臭味; [acc]/fʌŋk/; [or]z8;
synoptic: adj. 天气的,概要的,一览无余的; [acc]/sɪˈnɑːptɪk/; [or]z8;
manicure: [n]修指甲; [v]修剪; [acc]/ˈmænɪkjʊr/; [or]z8;
buggy: [n]轻型马车,婴儿车; [acc]/ˈbʌɡi/; [or]z8;
hobble: [v]蹒跚,跛行; [n]跛行;韵律不全的诗;马的脚绊;〈口,方〉困境; [acc]/ˈhɑːbl/; [or]z8;
remorse: [n]懊悔,自责,同情,怜悯; [acc]/rɪˈmɔːrs/; [or]z8;
rig: [n]钻井架;装备;帆具;成套器械; [v]操纵;装配;欺骗; [acc]/rɪɡ/; [or]z8;
dilate: [v]使膨胀,扩张,膨胀;详述; [acc]/daɪˈleɪt/; [or]z8;
flank: [v]位于.的侧面; [n]肋,肋腹,侧翼; [acc]/flæŋk/; [or]z8;
jeopardize: [v]危及,损害(也作jeopardise); [acc]/ˈdʒepərdaɪz/; [or]z8;
granule: [n]颗粒,微粒,粒状斑点; [acc]/ˈɡrænjuːl/; [or]z8;
metallurgy: [n]冶金学,冶金术; [acc]/ˈmetlɜːrdʒi/; [or]z8;
ardor: [n]热情,狂热; [acc]/'ɑːdə/; [or]z8;
impel: [v]推进,驱使; [acc]/ɪmˈpel/; [or]z8;
forebode: [v]预示,预兆,预言; [acc]/foʊr'boʊd/; [or]z8;
clinch: [n]扭抱;紧紧相拥; [v]达成,取得;解决; [acc]/klɪntʃ/; [or]z8;
hierarchy: [n]阶层,等级制度; [acc]/ˈhaɪərɑːrki/; [or]z8;
interlock: [v]连锁,连串; [n]〔电信〕结合;联锁装置;相关;联动; [acc]/ˌɪntərˈlɑːk/; [or]z8;
fry: [v]油煎;油炸; [n]鱼苗,鱼秧;弗赖伊(姓氏);油炸食物;(口语)烦恼,愤激; adj. 油炸的,油煎的(fried); [acc]/fraɪ/; [or]z8;
patchy: adj. 断续的,不连贯的;良莠不齐的,好坏掺杂的;不充足的; [acc]/ˈpætʃi/; [or]z8;
problematic: adj. 问题的;有疑问的;不确定的; [acc]/ˌprɑːbləˈmætɪk/; [or]z8;
quash: [v]镇压,平息,废除,使无效; [acc]/kwɔːʃ/; [or]z8;
lexical: adj. 词汇的,词典的; [acc]/ˈleksɪkl/; [or]z8;
quantum: [n]量子论; [acc]/ˈkwɑːntəm/; [or]z8;
kiwi: [n]猕猴桃,奇异果; adj. 〈非正式〉与新西兰或新西兰人有关的; [acc]/ˈkiːwiː/; [or]z8;
gimmick: [n]吸引人的花招,噱头; [vt]用暗机关改变或影响; [acc]/ˈɡɪmɪk/; [or]z8;
provident: adj. 节俭的,深谋远虑的,顾及未来的; [acc]/ˈprɑːvɪdənt/; [or]z8;
contingency: [n]偶然性;[安全]意外事故;可能性;[审计]意外开支; [acc]/kənˈtɪndʒənsi/; [or]z8;
novice: [n]生手,新手; [acc]/ˈnɑːvɪs/; [or]z8;
congenital: adj. 天生的,固有的; [acc]/kənˈdʒenɪtl/; [or]z8;
degenerate: [v]堕落,衰减; adj. 腐化的,颓废的,退化的;变质的; [n]堕落者; [acc]/dɪˈdʒenəreɪt/; [or]z8;
inflamed: adj. 发炎的,红肿的,激怒的,燃烧的; [acc]/ɪnˈfleɪmd/; [or]z8;
hydrant: [n]消防栓,消防龙头; [acc]/ˈhaɪdrənt/; [or]z8;
lunacy: [n]精神失常,愚蠢的行为; [acc]/ˈluːnəsi/; [or]z8;
mutant: [n]突变体,突变异种; adj. 突变的; [acc]/ˈmjuːtənt/; [or]z8;
bereaved: adj. 丧失的;死了.的; [n]丧失亲人的人; [acc]/bɪˈriːvd/; [or]z8;
broccoli: [n]硬花球花椰菜;花茎甘蓝; [acc]/ˈbrɑːkəli/; [or]z8;
deify: [v]奉为神;崇拜; [acc]/ˈdeɪɪfaɪ/; [or]z8;
viola: [n]中提琴; [acc]/viˈoʊlə/; [or]z8;
demeanor: [n]举止,行为,风度; [acc]/dɪ'miːnə/; [or]z8;
dislodge: [v]驱逐;移去;取出; [acc]/dɪsˈlɑːdʒ/; [or]z8;
stupendous: adj. 巨大的,大得惊人的; [acc]/stuːˈpendəs/; [or]z8;
odds: [n]几率;可能性;投注赔率;优势;差异,不平等; [acc]/ɑːdz/; [or]z8;
fetid: adj. 有恶臭的; [acc]/ˈfetɪd/; [or]z8;
sanctum: [n]圣地,密室; [acc]/ˈsæŋktəm/; [or]z8;
colt: [n]小马,生手; [v]以笞绳鞭打; [acc]/koʊlt/; [or]z8;
concur: [v]同意;一致; [acc]/kənˈkɜːr/; [or]z8;
ethical: adj. 伦理的;道德的;凭处方出售的; [n]处方药; [acc]/ˈeθɪkl/; [or]z8;
nutrient: [n]营养物;滋养物; adj. 营养的;滋养的; [acc]/ˈnuːtriənt/; [or]z8;
measurable: adj. 可测量的;重要的,重大的; [acc]/ˈmeʒərəbl/; [or]z8;
literal: adj. 字面上的;照字面的;缺乏想像力的; [acc]/ˈlɪtərəl/; [or]z8;
ethereal: adj. 太空的,轻巧的,像空气的; [acc]/iˈθɪriəl/; [or]z8;
constancy: [n]坚贞,忠诚,专一;稳定性,恒定性; [acc]/ˈkɑːnstənsi/; [or]z8;
slur: [n]含糊的发音,藐视,污点,连线符; [vi]含糊地说; [vt]对.忽略,含糊不清地说出,贬低; [acc]/slɜːr/; [or]z8;
relapse: [n](旧病的)复发,重陷,回复; [vi]重新陷入,回复; [acc]/rɪˈlæps/; [or]z8;
qualm: [n]疑惧,紧张不安; [acc]/kwɑːm/; [or]z8;
quack: [n]庸医;鸭叫声; [v]嘎嘎叫;吹嘘;大声闲聊; adj. 骗人的,江湖医生的; [acc]/kwæk/; [or]z8;
constraint: [n]限制;强迫,拘束;强制; [acc]/kənˈstreɪnt/; [or]z8;
transcend: [v]超越(经验,理性,信念等)的范围,超过; [acc]/trænˈsend/; [or]z8;
barricade: [n]路障;障碍物;栅栏; [v]设路障;挡住; [acc]/ˌbærɪˈkeɪd/; [or]z8;
notation: [n]记号;标记法;记录; [acc]/noʊˈteɪʃn/; [or]z8;
Titanic: adj. 巨人的,力大无比的; [n]泰坦尼克号; [acc]/taɪˈtænɪk/; [or]z8;
deviation: [n]偏离,背离; [acc]/ˌdiːviˈeɪʃn/; [or]z8;
ramification: [n]分枝;分枝(或分叉)的结果; [acc]/ˌræmɪfɪˈkeɪʃn/; [or]z8;
neon: [n]氖;霓虹灯; adj. 霓虹的; [acc]/ˈniːɑːn/; [or]z8;
pertinent: adj. 有关的;适当的;中肯的; [n]附属物;参考; [acc]/ˈpɜːrtnənt/; [or]z8;
dais: [n]主席台,嘉宾席; [acc]/ˈdeɪɪs/; [or]z8;
bizarre: adj. 稀奇古怪的; [acc]/bɪˈzɑːr/; [or]z8;
horrific: adj. 可怖的,令人恐惧的,极其可怕的; [acc]/həˈrɪfɪk/; [or]z8;
incest: [n]乱伦,近亲通婚; [acc]/ˈɪnsest/; [or]z8;
hatchet: [n]短柄小斧; [vt]扼杀; adj. 瘦削而棱角分明的; [acc]/ˈhætʃɪt/; [or]z8;
coronation: [n]加冕,加冕礼; [acc]/ˌkɔːrəˈneɪʃn/; [or]z8;
haversack: [n]干粮袋,背袋; [acc]/ˈhævərsæk/; [or]z8;
rift: [n]裂缝,裂口; [acc]/rɪft/; [or]z8;
delineate: [v]描画;画出..轮廓; [acc]/dɪˈlɪnieɪt/; [or]z8;
banister: [n]栏杆的支柱,楼梯的扶栏; [acc]/ˈbænɪstər/; [or]z8;
replicate: [v]复制;重复,反复; [acc]/ˈreplɪkeɪt/; [or]z8;
despoil: [v]掠夺,剥夺;夺取; [acc]/dɪˈspɔɪl/; [or]z8;
obligatory: adj. 强制性的;义务的;必须的; [acc]/əˈblɪɡətɔːri/; [or]z8;
differentiate: [v]使有差异;区别; [acc]/ˌdɪfəˈrenʃieɪt/; [or]z8;
deviate: [v]偏离;背离; adj. 脱离常轨的; [n]脱离常轨的人; [acc]/ˈdiːvieɪt/; [or]z8;
pal: [n]伙伴,好朋友; [v]交友; [acc]/pæl/; [or]z8;
intelligible: adj. 可理解的,明白易懂的; [acc]/ɪnˈtelɪdʒəbl/; [or]z8;
recourse: [n]求援(对象),求助(对象,[商][律]追索权; [acc]/ˈriːkɔːrs/; [or]z8;
coherent: adj. 协调一致的;条理清楚的,有条理的;连贯的;有黏性的,黏合在一起的,粘着的; [acc]/koʊˈhɪrənt/; [or]z8;
splutter: [n]劈啪声,急忙说出的话,杂乱的声音; [v]喷溅,气急败坏地说; [acc]/ˈsplʌtər/; [or]z8;
magnetism: [n]吸引力;磁性; [acc]/ˈmæɡnətɪzəm/; [or]z8;
molest: [v]骚扰,干扰; [acc]/məˈlest/; [or]z8;
empathy: [n]共鸣,同感;移情作用; [acc]/ˈempəθi/; [or]z8;
pertain: [vi]属于;适合;有关; [acc]/pərˈteɪn/; [or]z8;
counterfeit: [n]仿制品,伪造物; adj. 仿造的.假冒的; [v]伪造,仿造; [acc]/ˈkaʊntərfɪt/; [or]z8;
implicit: adj. 隐含的;盲目的;完全的,绝对的;成为一部分的; [acc]/ɪmˈplɪsɪt/; [or]z8;
magnanimous: adj. 宽宏大量的,大度的;慷慨的; [acc]/mæɡˈnænɪməs/; [or]z8;
crunch: [n]嘎吱嘎吱的声音; [vt]嘎吱嘎吱地咀嚼; [vi]嘎吱嘎吱地咀嚼;嘎吱嘎吱地动;发嘎吱嘎吱声; [acc]/krʌntʃ/; [or]z8;
inculcate: [v]灌输,谆谆教诲; [acc]/ɪnˈkʌlkeɪt/; [or]z8;
immune: adj. 免疫的,有免疫力的;不受影响的;免除的; [acc]/ɪˈmjuːn/; [or]z8;
callous: adj. 无情的,铁石心肠的,硬结的; [vt](使)变硬,(使)起茧;(使)冷酷无情; [acc]/ˈkæləs/; [or]z8;
resplendent: adj. 华丽的,辉煌的; [acc]/rɪˈsplendənt/; [or]z8;
parasite: [n]寄生虫;靠他人为生的人; [acc]/ˈpærəsaɪt/; [or]z8;
wanton: [n]水性杨花的人,任性的孩子,无节制的人; [v]放肆,胡作非为,挥霍; adj. 胡作非为的,淫荡的,无节制的; [acc]/ˈwɑːntən/; [or]z8;
repudiate: [v]拒绝,否定,驳斥; [acc]/rɪˈpjuːdieɪt/; [or]z8;
destitute: adj. 贫穷的,缺乏的; [acc]/ˈdestɪtuːt/; [or]z8;
lax: adj. 松懈的;松弛的;[语]松弛元音的; [n]松元音;泻肚; [acc]/læks/; [or]z8;
colossus: [n]巨像,巨人,巨大的东西; [acc]/kəˈlɑːsəs/; [or]z8;
flip: [v]把.往上抛;掷;抽打;用指轻弹;空翻; adj. 轻率的,无礼的; [acc]/flɪp/; [or]z8;
pore: [n]毛孔,细孔; [v]深思熟虑,仔细阅读,审视; [acc]/pɔːr/; [or]z8;
constituent: adj. 组成的;有选举权的; [n]选民;成分; [acc]/kənˈstɪtʃuənt/; [or]z8;
darn: [v]缝补; adj. 可恶的;完全的; [adv]极其; int. 可恶; [n]补丁;织补之处; [acc]/dɑːrn/; [or]z8;
conciliate: [v]调和,安抚; [acc]/kənˈsɪlieɪt/; [or]z8;
excerpt: [n]摘录,节选; [v]摘,选;引用; [acc]/ˈeksɜːrpt/; [or]z8;
sacrilegious: adj. 该受天谴的,亵渎神明的; [acc]/ˌsækrəˈlɪdʒəs/; [or]z8;
sunken: adj. 沉没的,凹陷的; [acc]/ˈsʌŋkən/; [or]z8;
secession: [n]脱离,退出; [acc]/sɪˈseʃn/; [or]z8;
trilogy: [n]三部曲; [acc]/ˈtrɪlədʒi/; [or]z8;
jurisdiction: [n]司法权,审判权;管辖权;权限,权力; [acc]/ˌdʒʊrɪsˈdɪkʃn/; [or]z8;
turret: [n]塔楼,角塔; [acc]/ˈtɜːrət/; [or]z8;
unicorn: [n]独角兽; [acc]/ˈjuːnɪkɔːrn/; [or]z8;
spar: [n]圆材(如桅,桁等),争论,拳斗; [v]争论,拳击; [acc]/spɑːr/; [or]z8;
hector: [v]凌辱,威吓; [n]暴徒,威吓者,作威作福的人; [acc]/ˈhektər/; [or]z8;
unassuming: adj. 谦逊的,不装腔作势的; [acc]/ˌʌnəˈsuːmɪŋ/; [or]z8;
deviant: adj. 变态的,反常的(多指性行为);越出常规的; [n]异常的人;性变态者; [acc]/ˈdiːviənt/; [or]z8;
duchy: [n]公国,公爵领地,直辖领地; [acc]/ˈdʌtʃi/; [or]z8;
parenthetical: adj. 作为插入语的,放在括号里的,［喻］插曲的; [acc]/ˌpærənˈθetɪkl/; [or]z8;
hooray: excl. 万岁; [acc]/huˈreɪ/; [or]z8;
omelet: [n]煎蛋卷; [acc]/ˈɑːmlət/; [or]z8;
luscious: adj. 美味的;满足感官的; [acc]/ˈlʌʃəs/; [or]z8;
Yank: [n]美国人(等于Yankee); [acc]/jæŋk/; [or]z8;
[kk9: zhuang8/2838]