preposterous: [adj]荒谬的,可笑的; [a]/prɪˈpɑːstərəs/; [or]sat;
flair: [n]天资,特别的本领;敏锐的洞察力;嗜好;格调; [a]/fler/; [or]sat;
dubious: [adj]可疑的;怀疑的;无把握的; [a]/ˈduːbiəs/; [or]sat;
wistful: [adj]渴望的,向往的;深思的;留恋的; [a]/ˈwɪstfl/; [or]sat;
prudent: [adj]谨慎的,精明的; [a]/ˈpruːdnt/; [or]sat;
default: [n]违约;缺席;缺乏;默认; [vi]不履行义务;拖欠; [vt]不履行;不参加; [a]/dɪˈfɔːlt/; [or]sat;
deplore: [v]谴责;对...深感遗憾;悲悼;痛惜; [a]/dɪˈplɔːr/; [or]sat;
redundant: [adj]多余的,过剩的;被下岗的; [a]/rɪˈdʌndənt/; [or]sat;
tantamount: [adj]与.相等的; [a]/ˈtæntəmaʊnt/; [or]sat;
assail: [v]攻击;质问;着手解决; [a]/əˈseɪl/; [or]sat;
quaff: [v]痛饮; [a]/kwæf/; [or]sat;
acknowledge: [v]告知收到;对(人)打招呼,招呼(某人)以示相识,致意;就..表示谢忱,鸣谢,感谢,感激,答谢,对..表示感谢;承认(属实),承认(权威,地位); [a]/əkˈnɑːlɪdʒ/; [or]sat;
negligible: [adj]微不足道的,可忽略不计的; [a]/ˈneɡlɪdʒəbl/; [or]sat;
tacit: [adj]心照不宣的,静默的; [a]/ˈtæsɪt/; [or]sat;
replenish: [v]补充,再装满;把.装满;给.添加燃料; [a]/rɪˈplenɪʃ/; [or]sat;
deluge: [n]洪水;暴雨;泛滥; [v]使泛滥;压倒; [a]/ˈdeljuːdʒ/; [or]sat;
champion: [n]冠军;拥护者,战士; [v]拥护;保卫;为..而斗争; [adj]夺得第一名的;优胜的; [a]/ˈtʃæmpiən/; [or]sat;
comprehensive: [adj]综合的;有充分理解力的,悟性好的;全面的,完整的;详尽的;广泛的,无所不包的;广义的; [n]综合测验;综合学校; [a]/ˌkɑːmprɪˈhensɪv/; [or]sat;
anecdote: [n]轶事,趣闻; [a]/ˈænɪkdoʊt/; [or]sat;
lofty: [adj]极高的,巍峨的;崇高的;高傲的; [a]/ˈlɔːfti/; [or]sat;
virtue: [n]正直,善良;美德,德行;好处,优点; [a]/ˈvɜːrtʃuː/; [or]sat;
noisome: [adj]恶臭的;令人不快的; [a]/ˈnɔɪsəm/; [or]sat;
sedentary: [adj]久坐不动的;静止的;坐惯的,定栖的; [a]/ˈsednteri/; [or]sat;
martial: [adj]武术的;好战的;军事的; [a]/ˈmɑːrʃl/; [or]sat;
glut: [n]供过于求,过多; [vt]使吃饱;使充斥; [vi]过量地吃; [a]/ɡlʌt/; [or]sat;
cupidity: [n]贪婪; [a]/kjuːˈpɪdəti/; [or]sat;
cache: [n]隐藏处所,隐藏的粮食或物资,贮藏物; [vt]贮藏; [vi]躲藏; [a]/kæʃ/; [or]sat;
carat: [n]公制克拉;(金子)开; [a]/ˈkærət/; [or]sat;
render: [v]使成为,致使,使处于(某种状态);提供,给予,以.回报;(以某种方式)表达,表现;翻译;粉刷,往(墙上)抹灰;将(脂肪)熬成油,使熔化; [n]粉刷,打底,交纳; [a]/ˈrendər/; [or]sat;
projectile: [n]抛射物,发射体,火箭,导弹; [adj]发射的; [a]/prəˈdʒektl/; [or]sat;
wastrel: [n]败家子,挥霍无度的人; [a]/ˈweɪstrəl/; [or]sat;
repel: [v]击退,驱逐;排斥,抵制;使厌恶,使反感;使恐惧; [a]/rɪˈpel/; [or]sat;
mire: [n]泥沼,困境; [a]/ˈmaɪər/; [or]sat;
log: [n]原木;航海日志; [v]伐木;航行;记录;登录; [a]/lɔːɡ/; [or]sat;
optional: [adj]可选择的; [a]/ˈɑːpʃənl/; [or]sat;
compunction: [n]懊悔,良心不安; [a]/kəmˈpʌŋkʃn/; [or]sat;
procrastinate: [v](因不愿意做或习惯性地)耽搁,拖延; [a]/proʊˈkræstɪneɪt/; [or]sat;
inverse: [adj]相反的;反面的;倒转的; [n](the inverse)反面; [a]/ˌɪnˈvɜːrs/; [or]sat;
panacea: [n]灵丹妙药,万能药; [a]/ˌpænəˈsiːə/; [or]sat;
chagrin: [n]懊恼;委屈;气愤; [v]使.懊恼; [a]/ʃəˈɡrɪn/; [or]sat;
diverse: [adj]不同的,差异的,多种多样的; [a]/daɪˈvɜːrs/; [or]sat;
pariah: [n]被排斥或鄙视的人; [a]/pəˈraɪə/; [or]sat;
steadfast: [adj]坚定的;不变的; [a]/ˈstedfæst/; [or]sat;
facilitate: [v]为他人提供方便;使便利; [vt]促进; [a]/fəˈsɪlɪteɪt/; [or]sat;
intrude: [vi]闯入,侵入; [vt]强挤入,把(自己的思想)强加于人; [a]/ɪnˈtruːd/; [or]sat;
asylum: [n]精神病院,疯人院;避难所; [a]/əˈsaɪləm/; [or]sat;
hindrance: [n]妨碍;障碍物; [a]/ˈhɪndrəns/; [or]sat;
maritime: [adj]海事的,海上的,沿海的,近海的;海员的,水手的; [a]/ˈmærɪtaɪm/; [or]sat;
supersede: [v]代替;紧接着而到来; [a]/ˌsuːpərˈsiːd/; [or]sat;
eminent: [adj]显赫的;杰出的;有名的;(品质)优良的; [a]/ˈemɪnənt/; [or]sat;
incarcerate: [v]把..关进监狱,监禁,幽闭; [a]/ɪnˈkɑːrsəreɪt/; [or]sat;
irresolute: [adj]优柔寡断的;踌躇不定的; [a]/ɪˈrezəluːt/; [or]sat;
elicit: [v]引出;诱出;探出; [a]/iˈlɪsɪt/; [or]sat;
doldrums: [n](海洋上的)无风带,情绪低沉; [a]/ˈdoʊldrəmz/; [or]sat;
curator: [n]馆长;监护人;管理者; [a]/kjʊˈreɪtər/; [or]sat;
mitigate: [v]减轻,缓和; [a]/ˈmɪtɪɡeɪt/; [or]sat;
forum: [n]论坛;讨论会; [a]/ˈfɔːrəm/; [or]sat;
fundamental: [adj]基本的,根本的;重要的;基础的; [n]基本原理;基本原则; [a]/ˌfʌndəˈmentl/; [or]sat;
orient: [n][the Orient]东方; [v]定..的方位; [adj]东方的;(太阳等)上升的,新生的;闪闪发光的; [a]/ˈɔːrient/; [or]sat;
exult: [v]狂喜,欢欣鼓舞; [a]/ɪɡˈzʌlt/; [or]sat;
sacrilegious: [adj]该受天谴的,亵渎神明的; [a]/ˌsækrəˈlɪdʒəs/; [or]sat;
phobia: [n]恐惧症; [a]/ˈfoʊbiə/; [or]sat;
aspire: [vi]渴望,有志于(与to,for,after连用或后接不定式); [a]/əˈspaɪər/; [or]sat;
opus: [n]作品; [a]/ˈoʊpəs/; [or]sat;
distinction: [n]差别,区分;优秀,卓越,杰出;特性,独特,不同凡响;优等评分,荣誉分数,殊荣; [a]/dɪˈstɪŋkʃn/; [or]sat;
surpass: [v]胜过;超出; [a]/sərˈpæs/; [or]sat;
objective: [n]目标;目的; [adj]客观的; [a]/əbˈdʒektɪv/; [or]sat;
subdued: [adj]减弱的;被制服的;被抑制的; [a]/səbˈduːd/; [or]sat;
paltry: [adj]不足取的,无价值的,琐碎的,卑鄙的; [a]/ˈpɔːltri/; [or]sat;
implore: [v]恳求; [a]/ɪmˈplɔːr/; [or]sat;
roil: [v]搅浑,惹怒,动荡,喧闹; [n]小股汹涌的急流; [a]/rɔɪl/; [or]sat;
appropriate: [adj]合适的;适当的; [v]挪用;拨款;私占; [a]/əˈproʊpriət/; [or]sat;
morbid: [adj]疾病的;(精神等)病态的;恐怖的; [a]/ˈmɔːrbɪd/; [or]sat;
lunar: [adj]月亮的; [a]/ˈluːnər/; [or]sat;
chalice: [n](高脚)酒杯;圣餐杯;［植］杯状花; [a]/ˈtʃælɪs/; [or]sat;
libel: [n]诽谤,中伤,诋毁;毁坏名誉的东西;控诉书; [v]中伤;控告;对.进行诽谤; [a]/ˈlaɪbl/; [or]sat;
trespass: [v]侵入;犯罪; [n]罪过;非法侵入; [a]/ˈtrespæs/; [or]sat;
resolve: [n]决心; [v]解决,决定,表决; [a]/rɪˈzɑːlv/; [or]sat;
goad: [vt]驱赶;刺激;鼓励; [n](赶牛用的)刺棒; [a]/ɡoʊd/; [or]sat;
compile: [v]收集,汇编; [a]/kəmˈpaɪl/; [or]sat;
aquatic: [adj]水生的,水栖的,水中的,水上的; [n]水生动物,水生植物;水上运动; [a]/əˈkwætɪk/; [or]sat;
subjective: [adj]主观(上)的,个人的; [a]/səbˈdʒektɪv/; [or]sat;
breach: [n]破裂;裂痕;冲击;违反; [v]使有裂口;破坏; [a]/briːtʃ/; [or]sat;
calligraphy: [n]笔迹,墨宝,书法; [a]/kəˈlɪɡrəfi/; [or]sat;
casualty: [n]伤亡人员,死伤者,受害人;急诊室(英); [a]/ˈkæʒuəlti/; [or]sat;
distort: [v]扭曲,使变形;歪曲,曲解; [a]/dɪˈstɔːrt/; [or]sat;
embryonic: [adj][生物学]胚胎的;初期的; [a]/ˌembriˈɑːnɪk/; [or]sat;
frustrate: [v]使灰心;挫败;阻挠; [a]/ˈfrʌstreɪt/; [or]sat;
hamper: [v]阻碍,妨碍,牵制; [n](有盖的)大篮子; [a]/ˈhæmpər/; [or]sat;
melancholy: [n]忧郁,悲哀; [adj]忧郁的,令人伤感的; [a]/ˈmelənkɑːli/; [or]sat;
molten: [adj]熔化的; [a]/ˈmoʊltən/; [or]sat;
prodigy: [n]天才; [a]/ˈprɑːdədʒi/; [or]sat;
provocative: [adj]挑衅的,煽动的,刺激的;挑逗的; [a]/prəˈvɑːkətɪv/; [or]sat;
simulate: [v]假装;模仿;模拟; [a]/ˈsɪmjuleɪt/; [or]sat;
declivity: [n]下坡;倾斜; [a]/dɪ'klɪvətɪ/; [or]sat;
infraction: [n]违法; [a]/ɪnˈfrækʃn/; [or]sat;
inundate: [v]淹没,泛滥; [a]/ˈɪnʌndeɪt/; [or]sat;
languish: [v]凋萎,衰弱,变得消瘦; [a]/ˈlæŋɡwɪʃ/; [or]sat;
embroider: [v]刺绣,绣花;润色,渲染; [a]/ɪmˈbrɔɪdər/; [or]sat;
anthropoid: [adj]像人类的,类人猿的; [n]类人猿;灵长类动物的类人猿亚目; [a]/ˈænθrəpɔɪd/; [or]sat;
filch: [vt]偷窃; [a]/fɪltʃ/; [or]sat;
vituperative: [adj]责骂的,辱骂的; [a]/vaɪˈtuːpəreɪtɪv/; [or]sat;
voyeur: [n]窥淫狂者,窥隐私者; [a]/vwaɪˈɜːr/; [or]sat;
berate: [v]猛烈责骂; [a]/bɪˈreɪt/; [or]sat;
bicker: [v]斗嘴,流动,闪动; [n]口角,流水声; [a]/ˈbɪkər/; [or]sat;
frond: [n](羊齿,棕榈等的)叶子;叶状体; [a]/frɑːnd/; [or]sat;
laceration: [n]撕裂,割破,裂口,伤口,痛苦; [a]/ˌlæsəˈreɪʃn/; [or]sat;
revelry: [n]狂欢;欢宴; [a]/ˈrevlri/; [or]sat;
cadaver: [n]尸体; [a]/kəˈdævər/; [or]sat;
choreography: [n]编舞艺术;舞蹈编排;舞蹈编排; [a]/ˌkɔːriˈɑːɡrəfi/; [or]sat;
clapper: [n]拍手者;铃舌;响板;唠唠叨叨的嘴巴; [a]/ˈklæpər/; [or]sat;
disgorge: [v]涌出,流出;吐出; [a]/dɪsˈɡɔːrdʒ/; [or]sat;
olfactory: [adj]嗅觉的; [a]/ɑːlˈfæktəri/; [or]sat;
pusillanimous: [adj]懦弱的,胆小的;优柔寡断的; [a]/ˌpjuːsɪˈlænɪməs/; [or]sat;
circumvent: [v]用计避免,规避; [a]/ˌsɜːrkəmˈvent/; [or]sat;
glower: [v]怒目而视; [a]/ˈɡlaʊər/; [or]sat;
compute: [v]计算,估计; [a]/kəmˈpjuːt/; [or]sat;
rail: [n]铁轨;扶手,栏杆; [v]咒骂; [a]/reɪl/; [or]sat;
spectrum: [n]光谱,范围,系列; [a]/ˈspektrəm/; [or]sat;
mammal: [n]哺乳动物; [a]/ˈmæml/; [or]sat;
bleak: [adj]凄凉的;萧瑟的;阴郁的;无希望的; [a]/bliːk/; [or]sat;
chisel: [v]刻,凿; [n]凿子; [a]/ˈtʃɪzl/; [or]sat;
trigger: [n](枪等的)扳机,诱因; [v]触发,引起,激发,扣扳机; [a]/ˈtrɪɡər/; [or]sat;
paramount: [n]元首;最高; [adj]最高的,至上的,首要的; [a]/ˈpærəmaʊnt/; [or]sat;
manipulate: [v]操纵,影响;正骨; [a]/məˈnɪpjuleɪt/; [or]sat;
ardent: [adj]热心的,热烈的; [a]/ˈɑːrdnt/; [or]sat;
eclipse: [n](日,月)食;黯然失色; [v]掩盖..的重要性;使暗淡; [a]/ɪˈklɪps/; [or]sat;
amphibian: [n]两栖动物;水陆两用飞机和车辆; [adj]两栖类的;[车辆]水陆两用的;具有双重性格的; [a]/æmˈfɪbiən/; [or]sat;
complement: [v]补充;与.相配; [n]补充;互为补充的东西;补语; [a]/ˈkɑːmplɪment/; [or]sat;
tedious: [adj]沉闷的,冗长乏味的; [a]/ˈtiːdiəs/; [or]sat;
illuminate: [vt]照亮;阐释;说明; [a]/ɪˈluːmɪneɪt/; [or]sat;
missile: [n]导弹;投射出的物体或武器; [adj]导弹的;可投掷的;用以发射导弹的; [a]/ˈmɪsl/; [or]sat;
barricade: [n]路障;障碍物;栅栏; [v]设路障;挡住; [a]/ˌbærɪˈkeɪd/; [or]sat;
chasm: [n](地壳,冰上的)隐窟,深坑,峡谷;显著差距,巨大分歧; [a]/ˈkæzəm/; [or]sat;
versatile: [adj]万能的,综合的,多才多艺的; [a]/ˈvɜːrsətl/; [or]sat;
anchor: [n]担任(广播电视新闻节目)的主持人;支柱;锚; [v]抛锚; [vt]使固定; [a]/ˈæŋkər/; [or]sat;
grill: [n]烤架; [v]烤;拷问; [a]/ɡrɪl/; [or]sat;
lament: [v]哀悼;惋惜;悲叹; [n]悲叹;悼词; [a]/ləˈment/; [or]sat;
steep: [v]沉浸于..; [adj]陡峭的;急剧的;过高的; [n]陡坡; [a]/stiːp/; [or]sat;
underlying: [adj]基本的;潜在的;在下面的; [a]/ˌʌndərˈlaɪɪŋ/; [or]sat;
embrace: [v]拥抱;包含;欣然接受,乐意采纳; [n]拥抱;接受;领会; [a]/ɪmˈbreɪs/; [or]sat;
mushroom: [n]蘑菇; [vi]迅速发展;采蘑菇; [a]/ˈmʌʃrʊm/; [or]sat;
barren: [adj]贫瘠的,不孕的; [n]荒原,不毛之地; [a]/ˈbærən/; [or]sat;
exotic: [adj]奇异的,珍奇的,来自异国的; [a]/ɪɡˈzɑːtɪk/; [or]sat;
diverge: [v]分歧,分开; [a]/daɪˈvɜːrdʒ/; [or]sat;
bovine: [adj](似)牛的,迟钝的; [n]牛科动物; [a]/ˈboʊvaɪn/; [or]sat;
collaborate: [v]合作; [a]/kəˈlæbəreɪt/; [or]sat;
gape: [n]裂口,张嘴,打哈欠; [v]目瞪口呆地凝视,打哈欠,张开,裂开; [a]/ɡeɪp/; [or]sat;
precipice: [n]危险的处境,灾难的边缘,濒危点;悬崖; [a]/ˈpresəpɪs/; [or]sat;
divergent: [adj]叉开的;分歧的; [a]/daɪˈvɜːrdʒənt/; [or]sat;
hibernate: [vi]冬眠,蛰居; [a]/ˈhaɪbərneɪt/; [or]sat;
palette: [n]调色板,一套颜料; [a]/ˈpælət/; [or]sat;
clip: [n]回形针,夹子;(电影,广播,电视节目的)片段; [v]夹住;删剪;剪辑; [a]/klɪp/; [or]sat;
arrest: [v]逮捕,拘留;吸引; [n]逮捕,拘留; [a]/əˈrest/; [or]sat;
solicit: [v]乞求,恳求给予(帮助,金钱); [a]/səˈlɪsɪt/; [or]sat;
fester: [v]溃烂;化脓;使..痛苦;使..恶化; [n]溃烂;脓疮,脓疱; [a]/ˈfestər/; [or]sat;
decomposition: [n]腐败,腐烂;分解; [a]/ˌdiːkɑːmpəˈzɪʃn/; [or]sat;
catastrophe: [n]大灾难; [a]/kəˈtæstrəfi/; [or]sat;
pigment: [n]天然色素,颜料; [a]/ˈpɪɡmənt/; [or]sat;
intrepid: [adj]无畏的;刚毅的,勇敢的; [a]/ɪnˈtrepɪd/; [or]sat;
squat: [adj]蹲着的; [v]蹲坐,蹲伏; [n]蹲坐; [a]/skwɑːt/; [or]sat;
corrode: [v]受腐蚀;腐蚀,侵蚀; [a]/kəˈroʊd/; [or]sat;
satellite: [n]卫星;人造卫星;随体; [adj]卫视的; [a]/ˈsætəlaɪt/; [or]sat;
whittle: [v]削(木头);削减; [n]大刀,屠刀; [a]/ˈwɪtl/; [or]sat;
cipher: [n]密码,暗号,不重要的人; [a]/ˈsaɪfər/; [or]sat;
precipitous: [adj]险峻的;急躁的,鲁莽的; [a]/prɪˈsɪpɪtəs/; [or]sat;
barb: [n]箭头鱼钩等的倒钩;伤人的话; [v]装倒钩于; [adj]具倒刺的;(话)带刺的; [a]/bɑːrb/; [or]sat;
dismember: [v]肢解;瓜分; [a]/dɪsˈmembər/; [or]sat;
repudiate: [v]拒绝,否定,驳斥; [a]/rɪˈpjuːdieɪt/; [or]sat;
emulate: [v]努力赶上(超过),仿效; [n]仿真; [a]/ˈemjuleɪt/; [or]sat;
spate: [n]洪水;一阵;大雨;突然迸发; [a]/speɪt/; [or]sat;
repository: [n]储藏室;仓库;智囊人物;知识库; [a]/rɪˈpɑːzətɔːri/; [or]sat;
dismantle: [v]拆开;拆除; [a]/dɪsˈmæntl/; [or]sat;
gory: [adj]血淋淋的,血污的,满是血的; [a]/ˈɡɔːri/; [or]sat;
chameleon: [n]蜥蜴;变色龙;善变的人; [a]/kəˈmiːliən/; [or]sat;
vanguard: [n]先锋,前锋;先驱;领导者; [a]/ˈvænɡɑːrd/; [or]sat;
castigate: [v]严惩;苛评;矫正;修订; [a]/ˈkæstɪɡeɪt/; [or]sat;
precis: [n]摘要,大纲; [vt]〈法〉为.写摘要,概括.的大意; [a]/preɪˈsiː/; [or]sat;
divine: [adj]神的,神圣的;极好的; [v](凭直觉)发现,猜到; [n]神学家;圣职人员;教士;上帝; [a]/dɪˈvaɪn/; [or]sat;
incisive: [adj]一针见血的,敏锐的; [a]/ɪnˈsaɪsɪv/; [or]sat;
idiom: [n]习语;成语;惯用语法; [a]/ˈɪdiəm/; [or]sat;
surfeit: [n]饮食过度,过量; [a]/ˈsɜːrfɪt/; [or]sat;
symbiosis: [n]共生,共栖; [a]/ˌsɪmbɪˈoʊsɪs/; [or]sat;
acidulous: [adj]有酸味的,刻薄的; [a]/əˈsɪdʒələs/; [or]sat;
ethnic: [adj]种族的,少数民族的; [n]少数民族成员;人种学; [a]/ˈeθnɪk/; [or]sat;
vigilance: [n]警戒;警惕;警戒; [a]/ˈvɪdʒɪləns/; [or]sat;
upshot: [n]结果,结局;要点; [a]/'ʌpʃɑːt/; [or]sat;
attentive: [adj]留意的,注意的,肯帮忙的; [a]/əˈtentɪv/; [or]sat;
incessant: [adj]无间断的,连续的; [a]/ɪnˈsesnt/; [or]sat;
talon: [n]猛禽的锐爪; [a]/ˈtælən/; [or]sat;
wanton: [n]水性杨花的人,任性的孩子,无节制的人; [v]放肆,胡作非为,挥霍; [adj]胡作非为的,淫荡的,无节制的; [a]/ˈwɑːntən/; [or]sat;
heterogeneous: [adj]多相的,异种的,不均匀的,由不同成分形成的; [a]/ˌhetərəˈdʒiːniəs/; [or]sat;
abusive: [adj]辱骂的;滥用的;虐待的; [a]/əˈbjuːsɪv/; [or]sat;
uniformity: [n]均匀性;一致,一致性;同样; [a]/ˌjuːnɪˈfɔːrməti/; [or]sat;
anthropomorphic: [adj]拟人的,拟人化; [a]/ˌænθrəpəˈmɔːrfɪk/; [or]sat;
unearth: [vt]发掘,掘出,揭露,发现;揭发; [a]/ʌnˈɜːrθ/; [or]sat;
skirmish: [n]小战役,小争吵; [v]卷入战役(争论),搜索; [a]/ˈskɜːrmɪʃ/; [or]sat;
assessment: [n]评估;评价;估价; [a]/əˈsesmənt/; [or]sat;
trajectory: [n]弹道,航线;轨线; [a]/trəˈdʒektəri/; [or]sat;
authoritarian: [adj]独裁主义的,权力主义的; [n]权力主义者,独裁主义者; [a]/əˌθɔːrəˈteriən/; [or]sat;
dislodge: [v]驱逐;移去;取出; [a]/dɪsˈlɑːdʒ/; [or]sat;
pan: [n]平底锅; [v]严厉批评;淘金; [a]/pæn/; [or]sat;
hydrophobia: [n]狂犬病,恐水病; [a]/ˌhaɪdrəˈfoʊbiə/; [or]sat;
limber: [adj]松软的,柔软的;可塑的; [n](炮车的)拖车; [a]/ˈlɪmbər/; [or]sat;
droll: [adj]滑稽的;好笑的;逗趣的; [n]逗人发笑的人;滑稽演员;小丑; [v]开玩笑; [adv]古里古怪地,滑稽地; [a]/droʊl/; [or]sat;
biennial: [adj]两年一次的;二年生植物的; [n]两年生植物;两年一次的事; [a]/baɪˈeniəl/; [or]sat;
clique: [n]朋党派系,小集团; [vi]结派,结党; [a]/kliːk/; [or]sat;
verge: [n]边缘;边界; [v]接近;濒临; [a]/vɜːrdʒ/; [or]sat;
odyssey: [n]长途冒险旅行;一连串的冒险;奥德赛; [a]/ˈɑːdəsi/; [or]sat;
diagnosis: [n]诊断; [a]/ˌdaɪəɡˈnoʊsɪs/; [or]sat;
prostrate: [adj]降伏的,沮丧的,衰竭的,俯卧的; [v]弄倒,使屈服; [a]/ˈprɑːstreɪt/; [or]sat;
defray: [v]支出;支付; [a]/dɪˈfreɪ/; [or]sat;
decrepitude: [n]衰老,破旧; [a]/dɪˈkrepɪtuːd/; [or]sat;
legerdemain: [n]手法;骗术;巧妙的花招; [a]/ˈledʒərdəmeɪn/; [or]sat;
addendum: [n]附录,附件;补遗;附加物; [a]/əˈdendəm/; [or]sat;
ramification: [n]分枝;分枝(或分叉)的结果; [a]/ˌræmɪfɪˈkeɪʃn/; [or]sat;
malediction: [n]诅咒;坏话; [a]/ˌmæləˈdɪkʃən/; [or]sat;
aberrant: [n]离开正路的人,反常的人; [adj]偏离正轨的;异常的,畸变的; [a]/æˈberənt/; [or]sat;
facet: [n](多面体的)面,小平面;琢面,侧面; [vt]在.上琢面; [a]/ˈfæsɪt/; [or]sat;
adjacent: [adj]邻接的,毗连的;邻近的; [a]/əˈdʒeɪsnt/; [or]sat;
carnal: [adj]肉体的,肉欲的,性欲的,色欲的,淫荡的; [a]/ˈkɑːrnl/; [or]sat;
disinterested: [adj]公正的;不感兴趣的;无私的;廉洁的; [a]/dɪsˈɪntrəstɪd/; [or]sat;
hypocritical: [adj]虚伪的;伪善的; [a]/ˌhɪpəˈkrɪtɪkl/; [or]sat;
douse: [v]把.浸入水中,用水泼; [a]/daʊs/; [or]sat;
provident: [adj]节俭的,深谋远虑的,顾及未来的; [a]/ˈprɑːvɪdənt/; [or]sat;
gargantuan: [adj]巨大的,庞大的; [a]/ɡɑːrˈɡæntʃuən/; [or]sat;
neutral: [adj]中立的;中性的; [n]中立国;中性色; [a]/ˈnuːtrəl/; [or]sat;
discord: [n]不和,争吵;(声音)不和谐; [a]/ˈdɪskɔːrd/; [or]sat;
trite: [adj]陈腐的;平庸的;老一套的; [a]/traɪt/; [or]sat;
corpulent: [adj]肥胖的; [a]/ˈkɔːrpjələnt/; [or]sat;
stealth: [n]隐秘,秘密; [a]/stelθ/; [or]sat;
abeyance: [n]中止,搁置; [a]/əˈbeɪəns/; [or]sat;
worldly: [adj]世间的,尘世的;世俗的; [adv]世故地; [a]/ˈwɜːrldli/; [or]sat;
inherent: [adj]内在的,固有的;生来就有的; [a]/ɪnˈhɪrənt/; [or]sat;
bourgeois: [n]中产阶级;资产阶级; [adj]中产阶级的; [a]/ˌbʊrˈʒwɑː/; [or]sat;
reparable: [adj]可修缮的;可挽回的; [a]/'repərəbəl/; [or]sat;
quench: [v]扑灭(火);止渴; [a]/kwentʃ/; [or]sat;
irate: [adj]发怒的,愤怒的; [a]/aɪˈreɪt/; [or]sat;
underscore: [v]强调,加强,划线于.下; [n]底线; [a]/ˌʌndərˈskɔːr/; [or]sat;
converse: [v]交谈; [adj]相反的,颠倒的; [n]相反的事物; [a]/kənˈvɜːrs/; [or]sat;
quarry: [n]采石场;猎物;来源; [v]挖出;努力挖掘; [a]/ˈkwɔːri/; [or]sat;
conveyance: [n]运输;运输工具;财产让与; [a]/kənˈveɪəns/; [or]sat;
sanctuary: [n]圣堂,避难所; [a]/ˈsæŋktʃueri/; [or]sat;
exclaim: [v]呼叫,惊叫; [a]/ɪkˈskleɪm/; [or]sat;
hostility: [n]虐待,敌意;不友善;敌对; [a]/hɑːˈstɪləti/; [or]sat;
calorific: [adj]发热的,富含卡路里的; [a]/ˌkæləˈrɪfɪk/; [or]sat;
magnate: [n]大人物;大亨,巨头;权贵; [a]/ˈmæɡneɪt/; [or]sat;
retrieve: [v]取回,重新得到,挽回,检索; [a]/rɪˈtriːv/; [or]sat;
shimmer: [v]闪烁,微微发亮; [n]微光,闪光; [a]/ˈʃɪmər/; [or]sat;
rally: [n]集会;公路汽车赛; [v]集合;恢复(健康等),重新振作; [a]/ˈræli/; [or]sat;
epitome: [n]摘要,缩影; [a]/ɪˈpɪtəmi/; [or]sat;
obligatory: [adj]强制性的;义务的;必须的; [a]/əˈblɪɡətɔːri/; [or]sat;
limerick: [n]五行打油诗; [a]/ˈlɪmərɪk/; [or]sat;
authoritative: [adj]权威性的;可信的;命令式的,专断的; [a]/əˈθɔːrəteɪtɪv/; [or]sat;
ambiguous: [adj]含糊不清的,引起歧义的,模棱两可的; [a]/æmˈbɪɡjuəs/; [or]sat;
moratorium: [n]暂停,中止;[金融]延期偿付; [a]/ˌmɔːrəˈtɔːriəm/; [or]sat;
awry: [adj]扭曲的,走样的; [adv]歪曲地;歪斜地;错误地; [a]/əˈraɪ/; [or]sat;
egress: [n]出去,出口; [a]/ˈiːɡres/; [or]sat;
acrid: [adj]辛辣的,(言语或语调)刻薄的; [a]/ˈækrɪd/; [or]sat;
indices: [n]目录,指数; [a]/ˈɪndɪsiːz/; [or]sat;
balmy: [adj](气候)温和的; [a]/ˈbɑːmi/; [or]sat;
amputate: [v]切除;截肢;切断; [a]/ˈæmpjuteɪt/; [or]sat;
nebulous: [adj]朦胧的,星云的,星云状的; [a]/ˈnebjələs/; [or]sat;
palatable: [adj]美味的,合口味的,合心意的; [a]/ˈpælətəbl/; [or]sat;
redress: [n]纠正,革除,救济; [v]修正,救济,革除; [a]/rɪˈdres/; [or]sat;
stalwart: [n]坚定的成员;健壮的人; [adj]强壮的,坚定的,忠诚的; [a]/ˈstɔːlwərt/; [or]sat;
sequester: [v]使隔离,隔绝,使隐退,没收,扣押; [a]/sɪˈkwestər/; [or]sat;
aspirant: [n]有抱负的人,野心家; [adj]上进的,有野心的; [a]/əˈspaɪərənt/; [or]sat;
officious: [adj]多管闲事的,非官方的; [adv]过分殷勤地; [n]过分殷勤,爱管闲事; [a]/əˈfɪʃəs/; [or]sat;
dutiful: [adj]顺从的,尽职的;有责任心的; [a]/ˈduːtɪfl/; [or]sat;
licentious: [adj]纵欲的,放肆的; [a]/laɪˈsenʃəs/; [or]sat;
disputatious: [adj]好争辩的; [a]/ˌdɪspjʊ'teɪʃəs/; [or]sat;
recount: [v]叙述; [n]重新计算; [a]/rɪˈkaʊnt/; [or]sat;
ablution: [n](宗教的)净礼,沐浴; [a]/əb'luːʃən/; [or]sat;
redoubtable: [adj]可敬畏的,可怕的; [a]/rɪˈdaʊtəbl/; [or]sat;
nullify: [v]使无效,废弃,取消; [a]/ˈnʌlɪfaɪ/; [or]sat;
invoke: [v]调用,祈求,恳求,引起; [a]/ɪnˈvoʊk/; [or]sat;
deposition: [n]证言,沉积物,矿床,革职; [a]/ˌdepəˈzɪʃn/; [or]sat;
efficacy: [n]功效,效力; [a]/ˈefɪkəsi/; [or]sat;
felon: [n]重罪犯; [a]/ˈfelən/; [or]sat;
averse: [adj]不乐意的,不情愿的; [a]/əˈvɜːrs/; [or]sat;
spat: [n]口角,小争论; [v]轻轻拍打;发生小争吵; [a]/spæt/; [or]sat;
irksome: [adj]令人厌烦的,讨厌的; [a]/ˈɜːrksəm/; [or]sat;
raconteur: [n]健谈者;善谈者;擅长讲故事的人; [a]/ˌrækɑːnˈtɜːr/; [or]sat;
disparity: [n]不同,不一致,不等; [a]/dɪˈspærəti/; [or]sat;
incur: [v]遭受;招致;引起; [a]/ɪnˈkɜːr/; [or]sat;
virile: [adj]成年男子的,有男子气概的,强壮的; [a]/ˈvɪrəl/; [or]sat;
feral: [adj]未驯服的,野生的;凶猛的; [a]/ˈferəl/; [or]sat;
inane: [adj]无意义的,空洞的;愚蠢的; [a]/ɪˈneɪn/; [or]sat;
blandishment: [n]甜言蜜语,奉承;谄媚;哄诱; [a]/ˈblændɪʃmənt/; [or]sat;
devoid: [adj]全无的,缺乏的; [a]/dɪˈvɔɪd/; [or]sat;
ornithologist: [n]鸟类学者; [a]/ˌɔːrnɪˈθɑːlədʒɪst/; [or]sat;
withhold: [v]抑制,拒绝给某事物; [a]/wɪðˈhoʊld/; [or]sat;
monetary: [adj]货币的,金融的;金钱的; [a]/ˈmɑːnɪteri/; [or]sat;
ashen: [adj]灰色; [a]/ˈæʃn/; [or]sat;
deft: [adj]灵巧的,敏捷的,熟练的; [a]/deft/; [or]sat;
madrigal: [n]情歌,小曲; [a]/ˈmædrɪɡl/; [or]sat;
agnostic: [adj]不可知论的; [n]不可知论者; [a]/æɡˈnɑːstɪk/; [or]sat;
tirade: [n]长篇的攻击性演说; [a]/ˈtaɪreɪd/; [or]sat;
solder: [v]焊接;使联接在一起; [n]焊接;接合物; [a]/ˈsɑːdər/; [or]sat;
loll: [vi]懒洋洋地倚靠;闲荡; [vt]懒洋洋地倚靠着;使悬垂; [a]/lɑːl/; [or]sat;
irrational: [adj]无理性的,失去理性的; [a]/ɪˈræʃənl/; [or]sat;
aggrandize: [v]增大;夸大;吹捧; [a]/ə'grænˌdaɪz/; [or]sat;
vitriolic: [adj]刻薄的,强烈的,硫酸(盐)的,由硫酸制成的; [a]/ˌvɪtriˈɑːlɪk/; [or]sat;
enthrall: [v]迷惑,迷住; [a]/ɪnˈθrɔl/; [or]sat;
unimpeachable: [adj]可信的,无可挑剔的; [a]/ˌʌnɪmˈpiːtʃəbl/; [or]sat;
perpetual: [adj]永远的,永恒的;不断的; [a]/pərˈpetʃuəl/; [or]sat;
acetic: [adj]酸的,醋的; [a]/ə'siːtɪk/; [or]sat;
wrath: [n]愤怒; [a]/ræθ/; [or]sat;
satiate: [v]使饱足,生腻; [adj]饱足的;厌腻的; [a]/ˈseɪʃieɪt/; [or]sat;
conceit: [n]自负;狂妄;想法,观点;构想,幻想; [a]/kənˈsiːt/; [or]sat;
discount: [n](价格,债款等)折扣; [v]打折扣,不全信,怀疑地看待; [a]/ˈdɪskaʊnt/; [or]sat;
austere: [adj]严峻的;简朴的;苦行的;无装饰的; [a]/ɔːˈstɪr/; [or]sat;
meander: [n]蜿蜒曲折,迂回曲折的旅程;漫步; [v]迂回曲折;漫步;漫谈; [a]/miˈændər/; [or]sat;
conundrum: [n](答案有双关意义的)谜语;机智问答;难题; [a]/kəˈnʌndrəm/; [or]sat;
drivel: [n]胡言乱语; [v]胡言乱语,说傻话; [a]/ˈdrɪvl/; [or]sat;
imply: [vt]暗示;暗指;意味着; [a]/ɪmˈplaɪ/; [or]sat;
vulnerable: [adj]易受伤的;脆弱的;易受攻击的; [a]/ˈvʌlnərəbl/; [or]sat;
taint: [n]污点;感染;异味; [vi]腐败,腐烂; [vt]污染;玷污,使受不良影响; [a]/teɪnt/; [or]sat;
stolid: [adj]无动于衷的,感情麻木的; [a]/ˈstɑːlɪd/; [or]sat;
fleece: [n]羊毛,羊毛状物; [v]剪羊毛,诈取; [a]/fliːs/; [or]sat;
soporific: [adj]催眠的; [n]安眠药; [a]/ˌsɑːpəˈrɪfɪk/; [or]sat;
lavish: [adj]奢华的;铺张浪费的; [v]浪费;慷慨给予; [a]/ˈlævɪʃ/; [or]sat;
gratis: [adj]免费的; [a]/ˈɡrætɪs/; [or]sat;
aseptic: [adj]无菌的,洁净的; [a]/ˌeɪˈseptɪk/; [or]sat;
compound: [n]复合物;[化学]化合物; [adj]合成的;复合的;多功能的; [vi]妥协;和解; [vt]混合;调和;调停;使恶化; [a]/ˈkɑːmpaʊnd/; [or]sat;
pulchritude: [n]漂亮,标致; [a]/ˈpʌlkrɪtjuːd/; [or]sat;
germane: [adj]有密切关系的;贴切的;恰当的; [a]/dʒɜːrˈmeɪn/; [or]sat;
flounder: [n]比目鱼;踉跄前进; [v]踉跄前行;(在水或泥浆中)挣扎,陷入困境; [a]/ˈflaʊndər/; [or]sat;
degenerate: [v]堕落,衰减; [adj]腐化的,颓废的,退化的;变质的; [n]堕落者; [a]/dɪˈdʒenəreɪt/; [or]sat;
eclectic: [adj]折衷主义的;选择的; [n]折衷主义者,折衷派的人; [a]/ɪˈklektɪk/; [or]sat;
overwrought: [adj]过分紧张的,过度兴奋的; [a]/ˌoʊvərˈrɔːt/; [or]sat;
prone: [adj]易于.的;有.倾向的;俯卧的; [a]/proʊn/; [or]sat;
privation: [n]缺乏,贫困,丧失,被剥夺了某物的状态; [a]/praɪˈveɪʃn/; [or]sat;
corroborate: [v]支持或证实,强化; [n]确证者,证物; [a]/kəˈrɑːbəreɪt/; [or]sat;
pine: [n]松树; [v](因死亡,离别等)难过,悲伤; [a]/paɪn/; [or]sat;
impede: [v]妨碍,阻碍; [a]/ɪmˈpiːd/; [or]sat;
curmudgeon: [n]脾气暴躁之人; [a]/kɜːrˈmʌdʒən/; [or]sat;
broach: [v]提出;钻孔;开始讨论;给.开口; [a]/broʊtʃ/; [or]sat;
censorious: [adj]爱挑剔的,吹毛求疵的,严厉批评的; [a]/senˈsɔːriəs/; [or]sat;
duplicity: [n]口是心非;表里不一;不诚实; [a]/duːˈplɪsəti/; [or]sat;
inculcate: [v]灌输,谆谆教诲; [a]/ɪnˈkʌlkeɪt/; [or]sat;
salutary: [adj]有益的,有益健康的; [a]/ˈsæljəteri/; [or]sat;
enduring: [adj]持久的,不朽的;能忍受的; [a]/ɪnˈdʊrɪŋ/; [or]sat;
dismiss: [v]开除;解散;摒除,不再考虑; [a]/dɪsˈmɪs/; [or]sat;
ramp: [n]斜坡,坡道;倾斜装置; [v]蔓延; [a]/ræmp/; [or]sat;
lucid: [adj]明晰的;透明的;易懂的;头脑清楚的; [a]/ˈluːsɪd/; [or]sat;
frenetic: [adj]狂乱的;非常激动的; [n]疯子;狂人; [a]/frəˈnetɪk/; [or]sat;
embody: [v]包含;体现,象征; [a]/ɪmˈbɑːdi/; [or]sat;
languor: [n]身心疲惫;柔情;呆滞; [a]/ˈlæŋɡər/; [or]sat;
relish: [v]享受;享受.的味道;品味; [n]乐趣;调味品; [a]/ˈrelɪʃ/; [or]sat;
usurp: [vi]篡夺,篡位; [vt]篡夺,强夺; [a]/juːˈzɜːrp/; [or]sat;
convention: [n]会议;习俗;惯例; [a]/kənˈvenʃn/; [or]sat;
venturesome: [adj]好冒险的,大胆的;危险的; [a]/ˈventʃərsəm/; [or]sat;
deranged: [adj]不理智;疯狂的; [a]/dɪˈreɪndʒd/; [or]sat;
nemesis: [n]报应,天罚,主要敌人,强硬对手; [a]/ˈneməsɪs/; [or]sat;
fraught: [adj]担心的,忧虑的;充满.的; [n]货物,装载物; [vt]装货于; [a]/frɔːt/; [or]sat;
ignite: [v]点燃,发光,燃烧; [a]/ɪɡˈnaɪt/; [or]sat;
benign: [adj]仁慈的;慈祥的;(病)良性的; [a]/bɪˈnaɪn/; [or]sat;
schism: [n]分裂,(教派或政党的)分裂; [a]/ˈsɪzəm/; [or]sat;
comatose: [adj]昏迷的,昏睡状态的,麻木的,怠惰的; [a]/ˈkoʊmətoʊs/; [or]sat;
provincial: [adj]省的;地方性的;偏狭的; [n]地方人民;乡下人;外地人; [a]/prəˈvɪnʃl/; [or]sat;
tanner: [n]制革工人,六便士; [a]/ˈtænər/; [or]sat;
affinity: [n]姻亲关系;密切关系;近似,类似关系;亲近; [a]/əˈfɪnəti/; [or]sat;
thrifty: [adj]节省的,节俭的; [a]/ˈθrɪfti/; [or]sat;
ruse: [n]诡计; [a]/ruːz/; [or]sat;
stellar: [adj]星的,星球的,主要的; [a]/ˈstelər/; [or]sat;
derogatory: [adj]不敬的,诽谤的; [a]/dɪˈrɑːɡətɔːri/; [or]sat;
prosperity: [n]繁荣,兴旺,发达; [a]/prɑːˈsperəti/; [or]sat;
divest: [v]剥夺;使脱去;迫使放弃; [a]/daɪˈvest/; [or]sat;
veneer: [n](镶于劣质东西上的)镶面板;掩饰; [v]虚饰;给.镶以饰片; [a]/vəˈnɪr/; [or]sat;
besiege: [v]围攻,困扰; [a]/bɪˈsiːdʒ/; [or]sat;
multiplicity: [n]多样性;许多,大量; [a]/ˌmʌltɪˈplɪsəti/; [or]sat;
filial: [adj]子女的,孝顺的;[生物]子代的,后代的; [adv]子女地; [a]/ˈfɪliəl/; [or]sat;
surrogate: [n]代替品,代理人,代孕妈妈; [adj]代理的,替代的; [v]代替,代理;指定为自己的代理人,接替; [a]/ˈsɜːrəɡət/; [or]sat;
scoff: [vi]讥笑; [v]嘲笑; [n]愚弄; [a]/skɔːf/; [or]sat;
codify: [v]编纂;将..编成法典; [a]/ˈkɑːdɪfaɪ/; [or]sat;
gratuitous: [adj]无根据的,无理由的,无报酬的,免费的,多余的; [a]/ɡrəˈtuːɪtəs/; [or]sat;
somnolent: [adj]思睡的,催眠的; [adv]瞌睡地;昏昏欲睡地;使人瞌睡地;催眠地; [a]/ˈsɑːmnələnt/; [or]sat;
dexterous: [adj]灵巧的,熟练的; [a]/ˈdekstrəs/; [or]sat;
hypothetical: [adj]假设的,假定的; [a]/ˌhaɪpəˈθetɪkl/; [or]sat;
compact: [adj]小巧的,小型的,袖珍的,体积小的;紧密的,紧凑的,密集的; [v]把..压紧;变得坚实; [n]带镜小粉盒;合约,条约; [a]/ˈkɑːmpækt/; [or]sat;
turbid: [adj]混浊的,紊乱的; [a]/ˈtɜːrbɪd/; [or]sat;
mote: [n]微粒,微尘; [a]/moʊt/; [or]sat;
pristine: [adj]原始的;古时的;纯朴的;崭新的; [a]/ˈprɪstiːn/; [or]sat;
sap: [n]树液,汁液;易上当的人; [v]削弱;逐渐耗竭; [vt]使伤元气; [vi]挖坑道进攻; [a]/sæp/; [or]sat;
static: [adj]静电的,静态的,静止的; [n]静电,静电干扰; [a]/ˈstætɪk/; [or]sat;
fop: [n]花花公子,纨绔子弟; [a]/fɑːp/; [or]sat;
fictitious: [adj]虚构的; [a]/fɪkˈtɪʃəs/; [or]sat;
endorse: [v]赞同,认可;签注(文件); [a]/ɪnˈdɔːrs/; [or]sat;
intimidate: [v]恫吓,威胁; [a]/ɪnˈtɪmɪdeɪt/; [or]sat;
resplendent: [adj]华丽的,辉煌的; [a]/rɪˈsplendənt/; [or]sat;
pathological: [adj]病理学的;病态的;由疾病引起的(等于pathologic); [a]/ˌpæθəˈlɑːdʒɪkl/; [or]sat;
equity: [n]公平,公正;衡平法;普通股;抵押资产的净值; [a]/ˈekwəti/; [or]sat;
conviction: [n]定罪;信服;坚强信念; [a]/kənˈvɪkʃn/; [or]sat;
paradigm: [n]范例,示范; [a]/ˈpærədaɪm/; [or]sat;
ultimate: [adj]根本的;最后的,最终的; [a]/ˈʌltɪmət/; [or]sat;
flit: [n]轻快的飞行;迁移; [vi]掠过;轻快地飞过;偷偷溜走;去世; [a]/flɪt/; [or]sat;
purge: [v]通便,净化,使(身,心)清净; [n]驱赶,泻药,净化; [a]/pɜːrdʒ/; [or]sat;
throng: [v]群集,蜂拥; [n]一大群人; [vt]挤向; [a]/θrɔːŋ/; [or]sat;
indulgent: [adj]放纵的;宽容的;任性的; [a]/ɪnˈdʌldʒənt/; [or]sat;
adverse: [adj]不利的;(方向上)逆的;在相反的方向上移动(或运转);相反的; [a]/ˈædvɜːrs/; [or]sat;
compliant: [adj]顺从的,服从的,应允的; [a]/kəmˈplaɪənt/; [or]sat;
onerous: [adj]繁重的,麻烦的;负有义务的;负有法律责任的; [a]/ˈɑːnərəs/; [or]sat;
requite: [v]报答,酬谢,回报,补偿;报复; [a]/rɪˈkwaɪt/; [or]sat;
remedial: [adj]治疗的;补救的;矫正的; [a]/rɪˈmiːdiəl/; [or]sat;
accommodate: [v]向.提供住处(或膳宿);给.提供方便;容纳;使适应,顺应; [a]/əˈkɑːmədeɪt/; [or]sat;
divulge: [v]泄露,透露; [a]/daɪˈvʌldʒ/; [or]sat;
annihilate: [v]消灭; [a]/əˈnaɪəleɪt/; [or]sat;
bungalow: [n]平房,小屋; [a]/ˈbʌŋɡəloʊ/; [or]sat;
parasite: [n]寄生虫;靠他人为生的人; [a]/ˈpærəsaɪt/; [or]sat;
indelible: [adj](印记等)无法擦除的,无法忘怀的; [a]/ɪnˈdeləbl/; [or]sat;
lechery: [n]好色,纵欲; [a]/ˈletʃəri/; [or]sat;
nocturnal: [adj]夜晚的,夜间发生的; [a]/nɑːkˈtɜːrnl/; [or]sat;
anthropologist: [n]人类学家,人类学者; [a]/ˌænθrəˈpɑːlədʒɪst/; [or]sat;
insidious: [adj](暗中或逐渐)为害的; [a]/ɪnˈsɪdiəs/; [or]sat;
catharsis: [n]泻法,净化,精神发泄; [a]/kəˈθɑːrsɪs/; [or]sat;
tout: [v]招徕顾客,极力赞扬; [a]/taʊt/; [or]sat;
squander: [n]浪费,挥霍; [v]浪费,挥霍; [a]/ˈskwɑːndər/; [or]sat;
dote: [v]溺爱;昏愦; [a]/doʊt/; [or]sat;
evasive: [adj]逃避的;托辞的,推托的; [a]/ɪˈveɪsɪv/; [or]sat;
pervasive: [adj]深入人心的,普遍的; [a]/pərˈveɪsɪv/; [or]sat;
atrophy: [v]萎缩;衰退;虚脱; [n]萎缩;衰退;萎缩症; [a]/ˈætrəfi/; [or]sat;
rider: [n]骑士;附件,附文;扶手; [a]/ˈraɪdər/; [or]sat;
mirth: [n]欢乐,欢笑; [a]/mɜːrθ/; [or]sat;
sanction: [n]批准;制裁,处罚; [v]批准,支持,对..实施制裁; [a]/ˈsæŋkʃn/; [or]sat;
innate: [adj]与生俱来的,天生的; [a]/ɪˈneɪt/; [or]sat;
venerable: [adj]令人尊敬的;(因历史悠久而) 神圣庄严的; [a]/ˈvenərəbl/; [or]sat;
cordon: [n]哨兵线,警戒线;饰带; [v]布设警戒线;封锁交通; [a]/ˈkɔːrdn/; [or]sat;
tractable: [adj]易于管教的,易驾驭的,易处理的,驯良的; [a]/ˈtræktəbl/; [or]sat;
concerted: [adj]一致的,商定的; [a]/kənˈsɜːrtɪd/; [or]sat;
caliber: [n][军]口径;才干;水准(等于calibre);器量; [a]/'kæləbə/; [or]sat;
propagate: [v]繁殖,增殖; [vt]传播,宣传; [a]/ˈprɑːpəɡeɪt/; [or]sat;
quorum: [n]法定人数; [a]/ˈkwɔːrəm/; [or]sat;
chimerical: [adj]空想的,妄想的;荒唐的; [a]/kaɪ'merɪkəl/; [or]sat;
agenda: [n]议事日程; [a]/əˈdʒendə/; [or]sat;
linger: [v]逗留,留恋; [a]/ˈlɪŋɡər/; [or]sat;
enclave: [n]飞地(指在本国境内的隶属另一国的一块领土),被包围的领土,被包围物; [a]/ˈenkleɪv/; [or]sat;
slander: [n]诽谤,诋毁; [v]讲坏话,污蔑,诽谤; [a]/ˈslændər/; [or]sat;
permeate: [v]弥漫;普及;渗透; [a]/ˈpɜːrmieɪt/; [or]sat;
document: [n]文件,公文;(计算机的)文档; [v]记录;证明; [a]/ˈdɑːkjumənt/; [or]sat;
deference: [n]尊敬,尊重;顺从; [a]/ˈdefərəns/; [or]sat;
beget: [v]产生,引起; [a]/bɪˈɡet/; [or]sat;
vagrant: [n]游民; [adj]漂泊的; [a]/ˈveɪɡrənt/; [or]sat;
combustible: [adj]易燃的;易激动的; [n]可燃物;易燃物; [a]/kəmˈbʌstəbl/; [or]sat;
ethereal: [adj]太空的,轻巧的,像空气的; [a]/iˈθɪriəl/; [or]sat;
mural: [n]壁画;壁饰; [adj]墙壁的;挂在墙壁上的; [a]/ˈmjʊrəl/; [or]sat;
hulking: [adj]笨重的; [a]/ˈhʌlkɪŋ/; [or]sat;
spawn: [n]卵;菌丝;产物; [v]产卵;酿成,造成;大量生产; [a]/spɔːn/; [or]sat;
mishap: [n]不幸的事,灾祸;晦气; [a]/ˈmɪshæp/; [or]sat;
placid: [adj]安静的,平和的; [a]/ˈplæsɪd/; [or]sat;
enrapture: [v]使狂喜,使高兴; [a]/ɪnˈræptʃər/; [or]sat;
scrupulous: [adj]小心谨慎的;严谨的;细心的; [a]/ˈskruːpjələs/; [or]sat;
fervent: [adj]热烈的,满怀热情的;狂热的; [a]/ˈfɜːrvənt/; [or]sat;
tract: [n]器官系统;一大片地;短文,小册子; [a]/trækt/; [or]sat;
component: [n]零件; [adj]组成的; [a]/kəmˈpoʊnənt/; [or]sat;
wince: [v]避开,畏缩; [n]畏缩;脸部肌肉的抽搐; [a]/wɪns/; [or]sat;
accessory: [n](妇女的)装饰品;附件;附属物;同谋; [adj]附属的;辅助的;同谋的; [a]/əkˈsesəri/; [or]sat;
renown: [n]声誉;名望; [vt]使有声望; [a]/rɪˈnaʊn/; [or]sat;
stymie: [v]从中作梗,阻挠;妨碍; [n]妨碍球; [a]/ˈstaɪmi/; [or]sat;
hybrid: [n]杂种,混血儿,混合物; [adj]混合的;杂种的; [a]/ˈhaɪbrɪd/; [or]sat;
pore: [n]毛孔,细孔; [v]深思熟虑,仔细阅读,审视; [a]/pɔːr/; [or]sat;
badinage: [n]开玩笑,嘲弄,揶揄; [a]/ˌbædənˈɑːʒ/; [or]sat;
bustle: [n]喧闹,熙攘;腰垫;奔走,奔忙; [v]喧闹;忙乱,奔忙; [a]/ˈbʌsl/; [or]sat;
preeminent: [adj]卓越的,超群的; [adv]卓越地,杰出地; [a]/priˈemɪnənt/; [or]sat;
discrete: [adj]分开的;不连续的; [a]/dɪˈskriːt/; [or]sat;
asymmetric: [adj]不对称的,不匀称的; [a]/ˌeɪsɪˈmetrɪk/; [or]sat;
canter: [n]慢跑(多用于马); [a]/ˈkæntər/; [or]sat;
tonic: [n]补药;主调音或基音; [adj]滋补的;声调的;使精神振作的; [a]/ˈtɑːnɪk/; [or]sat;
matriculate: [n]被录取者; [v]准许.入学; [a]/məˈtrɪkjuleɪt/; [or]sat;
forgo: [v]放弃;停止;对.断念; [a]/fɔːrˈɡoʊ/; [or]sat;
affiliation: [n]联系,从属关系; [a]/əˌfɪliˈeɪʃn/; [or]sat;
sacrosanct: [adj](因十分重要,神圣)不可改变,批判的; [a]/ˈsækroʊsæŋkt/; [or]sat;
apostate: [adj]变节的,脱党的,背教的; [n]脱党者,变节者,叛教者; [a]/əˈpɑːsteɪt/; [or]sat;
gourmand: [n]贪食者; [adj]贪食的; [a]/ˈɡʊrmɑːnd/; [or]sat;
demeanor: [n]举止,行为,风度; [a]/dɪ'miːnə/; [or]sat;
bulwark: [n]堡垒,壁垒;保障;防波堤; [v]防御,保护;筑垒保卫; [a]/ˈbʊlwɜːrk/; [or]sat;
distraught: [adj]发狂的;心烦意乱的; [a]/dɪˈstrɔːt/; [or]sat;
grove: [n]小树林;果园; [a]/ɡroʊv/; [or]sat;
equable: [adj]温和,平均,稳定的,不变的,(脾气)温和的; [a]/ˈekwəbl/; [or]sat;
cistern: [n]水箱;水池;贮水器; [a]/ˈsɪstərn/; [or]sat;
fatalism: [n]宿命论; [a]/ˈfeɪtəlɪzəm/; [or]sat;
primordial: [adj]原始的;根本的;原生的; [a]/praɪˈmɔːrdiəl/; [or]sat;
plenitude: [n]充分;丰富;大量; [a]/ˈplenɪtuːd/; [or]sat;
nuance: [n]细微差别; [a]/ˈnuːɑːns/; [or]sat;
impartial: [adj]公平的,不偏不倚的; [a]/ɪmˈpɑːrʃl/; [or]sat;
propinquity: [n]接近,邻近,近亲关系; [a]/prəˈpɪŋkwəti/; [or]sat;
beatific: [adj]祝福的,有福的; [a]/ˌbiːəˈtɪfɪk/; [or]sat;
propitious: [adj]适合的;吉利的;顺利的; [a]/prəˈpɪʃəs/; [or]sat;
vernacular: [adj]本国的,地方的,用本地语写成的; [n]方言;土语;(建筑的)民间风格; [a]/vərˈnækjələr/; [or]sat;
burly: [adj]结实的;率直的;粗鲁的; [n]〈美〉滑稽戏;〈美俚〉身材魁伟的人; [a]/ˈbɜːrli/; [or]sat;
gaudy: [n]华丽而俗气的廉价饰物; [adj](服饰,装饰,文风等)华丽而俗气的;浮华的;过分显眼的; [a]/ˈɡɔːdi/; [or]sat;
ecologist: [n]生态学家,生态学者; [a]/iˈkɑːlədʒɪst/; [or]sat;
vivacious: [adj]活泼的,快活的(多指女性); [a]/vɪˈveɪʃəs/; [or]sat;
dissolution: [n](婚姻,组织,议会等的) 解散;毁灭,消失; [a]/ˌdɪsəˈluːʃn/; [or]sat;
rendition: [n]表演,演奏;译文;给予,提供; [a]/renˈdɪʃn/; [or]sat;
extricate: [v]拯救,救出; [n]解脱;解脱者; [a]/ˈekstrɪkeɪt/; [or]sat;
unique: [adj]独特的,独一无二的;(唯一的)特有的;不同寻常的; [a]/juˈniːk/; [or]sat;
clandestine: [adj]秘密的,私下的,暗中的; [a]/klænˈdestɪn/; [or]sat;
motif: [n]基本图案;主题,中心思想,[音]乐旨; [a]/moʊˈtiːf/; [or]sat;
trappings: [n]服饰,礼服,外部标志,马饰; [a]/ˈtræpɪŋz/; [or]sat;
provisional: [n]临时邮票; [adj]临时的,暂时的,暂定的; [a]/prəˈvɪʒənl/; [or]sat;
remunerative: [adj]有报酬的,有利可图的; [a]/rɪˈmjuːnərətɪv/; [or]sat;
ruddy: [adj]红的,红润的; [adv]极度,非常; [vt]使变红; [a]/ˈrʌdi/; [or]sat;
remediable: [adj]可治疗的,可矫正的,可补救的; [a]/rɪˈmiːdiəbl/; [or]sat;
ornate: [adj]装饰华丽的;修辞上极考究的; [a]/ɔːrˈneɪt/; [or]sat;
chivalrous: [adj]像骑士的,侠义的,大侠的; [a]/ˈʃɪvəlrəs/; [or]sat;
reprimand: [n](特指当权者进行的)严责,谴责,申斥; [v]申斥,谴责,惩戒; [a]/ˈreprɪmænd/; [or]sat;
profound: [adj]深刻的;知识渊博的;深奥的;极度的,完全的;深远的;渊博的; [n]深渊;深海; [a]/prəˈfaʊnd/; [or]sat;
odium: [n]憎恶,反感; [a]/ˈoʊdiəm/; [or]sat;
gruel: [n]稀粥; [v]使极度疲劳;累垮; [a]/ˈɡruːəl/; [or]sat;
adversity: [n]逆境,不幸,灾难; [a]/ədˈvɜːrsəti/; [or]sat;
futile: [adj]无益的,无用的; [a]/ˈfjuːtl/; [or]sat;
trenchant: [adj]犀利的,锐利的,有力的,清晰的,一针见血的; [a]/ˈtrentʃənt/; [or]sat;
stoke: [v]添加燃料,把(火)拨旺,狼吞虎咽吃; [n]斯托克;[物]沲; [a]/stoʊk/; [or]sat;
sanguine: [adj]乐观的,(脸色等)有血色的,多血质的; [n]血红色,乐观; [a]/ˈsæŋɡwɪn/; [or]sat;
evocative: [adj]唤起的;唤出的; [a]/ɪˈvɑːkətɪv/; [or]sat;
boycott: [vt]抵制; [n]抵制; [a]/ˈbɔɪkɑːt/; [or]sat;
beatitude: [n]祝福;至福; [a]/bi'ætɪtuːd/; [or]sat;
luminous: [adj]发光的;鲜艳的;明亮的;夜光的; [a]/ˈluːmɪnəs/; [or]sat;
daunt: [v]使气馁,使畏缩,威吓; [a]/dɔːnt/; [or]sat;
prototype: [n]原型,典型,样本; [a]/ˈproʊtətaɪp/; [or]sat;
retentive: [adj]保持的;吸(水)的; [adv]有记性地,记性强地; [n]保持力;〈物〉顽磁性; [a]/rɪˈtentɪv/; [or]sat;
abolish: [v]废除,废止;取消,革除; [a]/əˈbɑːlɪʃ/; [or]sat;
potion: [n]一剂,一服;毒药,魔药; [a]/ˈpoʊʃn/; [or]sat;
venerate: [v]崇敬,敬仰; [a]/ˈvenəreɪt/; [or]sat;
equestrian: [adj]骑马的;骑术的; [n]骑手,马术家; [a]/ɪˈkwestriən/; [or]sat;
glaze: [n](浇在糕点上的)糖浆,蛋浆,釉;[气]雨淞; [v](眼睛)变呆滞;浇浆汁于 (食物) 表面;给.安装玻璃; [a]/ɡleɪz/; [or]sat;
coquette: [n]调情的女子; [v]不认真对待; [a]/koʊˈket/; [or]sat;
founder: [n]奠基者;创始人; [v](船)沉没,浸水而沉没;(计划等)失败,受挫折; [a]/ˈfaʊndər/; [or]sat;
recapitulate: [v]扼要重述; [a]/ˌriːkəˈpɪtʃuleɪt/; [or]sat;
faculty: [n]教职工,全体教员;系;科;能力; [a]/ˈfæklti/; [or]sat;
flourish: [vi]繁荣,茂盛,兴旺; [vt]挥舞;夸耀; [n]兴旺;茂盛;炫耀;挥舞; [a]/ˈflɜːrɪʃ/; [or]sat;
ascetic: [adj]禁欲的;苦行的; [n]禁欲者;苦行者; [a]/əˈsetɪk/; [or]sat;
jocose: [adj]开玩笑的,引人发笑的,诙谐的; [a]/dʒoʊˈkoʊs/; [or]sat;
reputed: [adj]名誉好的;被普遍认为.的; [a]/rɪˈpjuːtɪd/; [or]sat;
incline: [n]倾斜,斜坡,斜面; [v](使)倾斜,(使)倾向于; [a]/ɪnˈklaɪn/; [or]sat;
exhume: [v]发掘,出土; [a]/ɪɡˈzuːm/; [or]sat;
hallucination: [n]幻觉,幻想; [a]/həˌluːsɪˈneɪʃn/; [or]sat;
saturnine: [adj]忧郁的,阴沉的,讥讽的; [a]/ˈsætərnaɪn/; [or]sat;
insightful: [adj]有深刻见解的,富有洞察力的; [a]/ˈɪnsaɪtfʊl/; [or]sat;
retract: [v]缩回;收回;取消; [n]收缩核; [a]/rɪˈtrækt/; [or]sat;
penury: [n]贫穷; [a]/ˈpenjəri/; [or]sat;
baffle: [v]使困惑;难住;阻碍; [n]挡板; [a]/ˈbæfl/; [or]sat;
stint: [n]节约;从事某工作的时间;固定; [v]节省;限制; [a]/stɪnt/; [or]sat;
decimate: [v]大量杀死,十中抽一,大量毁灭; [a]/ˈdesɪmeɪt/; [or]sat;
banal: [adj]陈腐的;平庸的;老一套的; [a]/bəˈnɑːl/; [or]sat;
seethe: [v]沸腾;汹涌;激动; [a]/siːð/; [or]sat;
incorporeal: [adj]灵魂的,无实体的,非物质的; [a]/ˌɪnkɔːrˈpɔːriəl/; [or]sat;
regime: [n]政权;政治制度;养生法,生活规则; [a]/reɪˈʒiːm/; [or]sat;
translucent: [adj]半透明的;透亮的,有光泽的;易懂的;真实的; [a]/trænsˈluːsnt/; [or]sat;
pivotal: [adj]关键的,枢轴的; [a]/ˈpɪvətl/; [or]sat;
incantation: [n]咒语; [a]/ˌɪnkænˈteɪʃn/; [or]sat;
harrowing: [adj]悲痛的,难受的; [a]/ˈhæroʊɪŋ/; [or]sat;
compatible: [adj]可和谐共存的;兼容的; [a]/kəmˈpætəbl/; [or]sat;
audit: [v]审计,查账;旁听; [n]审计;查帐; [a]/ˈɔːdɪt/; [or]sat;
avow: [vt]公开宣称,坦率承认;断言; [adj]可明言的;公开声明的,承认的; [n]公开宣布; [a]/əˈvaʊ/; [or]sat;
exodus: [n]大批离去,成群外出; [a]/ˈeksədəs/; [or]sat;
proxy: [n]代理权,代表权,代理人; [adj]代理的; [a]/ˈprɑːksi/; [or]sat;
tenet: [n]信念,原则,教条; [a]/ˈtenɪt/; [or]sat;
enigma: [n]谜,哑谜;闷葫芦; [a]/ɪˈnɪɡmə/; [or]sat;
deadlock: [vt](使)相持不下; [vi]僵持; [n]僵局;不分胜负; [a]/ˈdedlɑːk/; [or]sat;
cliche: [n]陈腐思想,陈词滥调; [adj]陈腐的; [a]/klɪˈʃeɪ/; [or]sat;
ewe: [n][畜牧]母羊; [a]/juː/; [or]sat;
vertigo: [n]晕头转向;眩晕; [a]/ˈvɜːrtɪɡoʊ/; [or]sat;
arbitrator: [n]公断人; [a]/ˈɑːrbɪtreɪtər/; [or]sat;
quixotic: [adj]空想的,堂吉诃德式的; [n]同"quixotism"; [a]/kwɪkˈsɑːtɪk/; [or]sat;
extrinsic: [adj]外在的,外部的; [a]/eksˈtrɪnzɪk/; [or]sat;
wheedle: [v]以甜言蜜语诱惑,用甜言蜜语欺骗; [a]/ˈwiːdl/; [or]sat;
rampant: [adj]猖獗的,蔓生的; [a]/ˈræmpənt/; [or]sat;
caucus: [n]政党高层会议,核心人物; [a]/ˈkɔːkəs/; [or]sat;
multifarious: [adj]多种的,各式各样的; [a]/ˌmʌltɪˈferiəs/; [or]sat;
partial: [adj]偏爱的,特别喜欢的;偏袒的,不公平的,有偏见的;部分的;不完全的; [n][数学]偏微商; [a]/ˈpɑːrʃl/; [or]sat;
stodgy: [adj]平凡的;塞满的;庸俗的; [a]/ˈstɑːdʒi/; [or]sat;
pomposity: [n]自大,傲慢,摆架子; [a]/pɑːmˈpɑːsəti/; [or]sat;
friction: [n]摩擦,摩擦力;争执,冲突; [a]/ˈfrɪkʃn/; [or]sat;
nostalgia: [n]怀旧之情,思乡病; [a]/nəˈstældʒə/; [or]sat;
voracious: [adj]狼吞虎咽的,贪婪的; [adv]贪婪地; [n]贪婪,贪吃; [a]/vəˈreɪʃəs/; [or]sat;
irrevocable: [adj]不可改变的;不能取消的;不能挽回的; [a]/ɪˈrevəkəbl/; [or]sat;
entitlement: [n]权利,津贴; [a]/ɪnˈtaɪtlmənt/; [or]sat;
lope: [n]轻快的步伐,大步慢跑; [v]轻快地迈着大步; [a]/loʊp/; [or]sat;
prologue: [n]开场白,序幕; [a]/ˈproʊlɔːɡ/; [or]sat;
indomitable: [adj]不屈不挠的;不服输的;不气馁的; [a]/ɪnˈdɑːmɪtəbl/; [or]sat;
reprove: [v]责骂,申斥; [a]/rɪˈpruːv/; [or]sat;
compelling: [adj]引人注目的;紧迫的;令人信服的; [a]/kəmˈpelɪŋ/; [or]sat;
relent: [v]变温和,变宽厚;减弱;缓和;终于答应;不再拒绝; [a]/rɪˈlent/; [or]sat;
metamorphosis: [n]变形,变质,变异;[生物学]变态; [a]/ˌmetəˈmɔːrfəsɪs/; [or]sat;
dolt: [n]笨蛋,傻瓜; [a]/doʊlt/; [or]sat;
animated: [adj]有活力的,活生生的;活泼的,充满生气的;有生命的;动画(片)的; [a]/ˈænɪmeɪtɪd/; [or]sat;
seismic: [adj]地震的;地震引起的;剧烈的; [a]/ˈsaɪzmɪk/; [or]sat;
hierarchy: [n]阶层,等级制度; [a]/ˈhaɪərɑːrki/; [or]sat;
verisimilitude: [n]逼真,真实性; [a]/ˌverɪsɪˈmɪlɪtuːd/; [or]sat;
circuitous: [adj]迂回的,绕圈子的; [a]/sərˈkjuːɪtəs/; [or]sat;
leaven: [n]发酵剂,影响力; [v]发酵,影响,渐变; [a]/ˈlevn/; [or]sat;
abut: [v]紧靠; [a]/əˈbʌt/; [or]sat;
spatula: [n](调和,涂抹用)抹刀,小铲;[医]压舌板; [a]/ˈspætʃələ/; [or]sat;
sycophant: [n]马屁精; [a]/ˈsɪkəfænt/; [or]sat;
propound: [v]提出(问题,计划)供考虑; [a]/prəˈpaʊnd/; [or]sat;
indict: [v]控诉,起诉; [a]/ɪnˈdaɪt/; [or]sat;
astute: [adj]机敏的,精明的,狡猾的; [a]/əˈstuːt/; [or]sat;
necromancy: [n]巫术,通灵术; [a]/ˈnekroʊmænsi/; [or]sat;
knotty: [adj]有节疤的,有结的;棘手的; [a]/ˈnɑːti/; [or]sat;
archaic: [adj]古代的;陈旧的,过时的,老式的;已不通用的; [a]/ɑːrˈkeɪɪk/; [or]sat;
aesthetic: [n]美感;审美观; [adj]美学的;审美的;悦目的;雅致的; [a]/esˈθetɪk/; [or]sat;
muster: [vi]集合;聚集; [vt]集合;召集; [n]集合;集合人员; [a]/ˈmʌstər/; [or]sat;
incoherent: [adj]语无伦次的;不合逻辑的;不连贯的; [a]/ˌɪnkoʊˈhɪrənt/; [or]sat;
vociferous: [adj](表达意见或感情等)大声的,有力的; [a]/voʊˈsɪfərəs/; [or]sat;
toxic: [n]毒物; [adj]有毒的;中毒的; [a]/ˈtɑːksɪk/; [or]sat;
aphorism: [n]格言,警句; [a]/ˈæfərɪzəm/; [or]sat;
outstrip: [v]比.优越,胜过,比.跑得快; [a]/ˌaʊtˈstrɪp/; [or]sat;
doff: [v]脱掉(外衣,帽子); [a]/dɑːf/; [or]sat;
denounce: [v]谴责,斥责; [a]/dɪˈnaʊns/; [or]sat;
tender: [adj]温柔的;嫩的;柔弱的,脆弱的;痛的; [n]煤水车,附属船;投标; [v]提出(希望对方接受的意见等); [a]/ˈtendər/; [or]sat;
requiem: [n]安魂曲;追思弥撒; [a]/ˈrekwiəm/; [or]sat;
obliterate: [v]消灭;涂去;冲刷;忘掉; [a]/əˈblɪtəreɪt/; [or]sat;
savant: [n]博学之士,大学士; [a]/sæˈvɑːnt/; [or]sat;
censor: [n]检查员; [vt]审查,检查;修改; [a]/ˈsensər/; [or]sat;
mock: [v]嘲笑;轻蔑,蔑视; [adj]不真诚的;伪造的; [n]模拟考; [a]/mɑːk/; [or]sat;
lassitude: [n]困乏,厌倦,无精打采; [a]/ˈlæsɪtuːd/; [or]sat;
subpoena: [n](法律)传票; [v]传讯;传审; [a]/səˈpiːnə/; [or]sat;
paradox: [n]矛盾;似矛盾而正确的说法; [a]/ˈpærədɑːks/; [or]sat;
fugitive: [adj]逃亡的,易逝的; [n]逃犯,逃亡者; [a]/ˈfjuːdʒətɪv/; [or]sat;
tepid: [adj]微温的,不热烈的; [a]/ˈtepɪd/; [or]sat;
subservient: [adj]屈从的;奉承的;有用的,有帮助的; [a]/səbˈsɜːrviənt/; [or]sat;
extant: [adj]现存的;显著的; [a]/ekˈstænt/; [or]sat;
avalanche: [n]雪崩;大量拥至; [vi]崩塌; [a]/ˈævəlæntʃ/; [or]sat;
repertoire: [n](剧团,演员等的)全部节目;全部才能; [a]/ˈrepərtwɑːr/; [or]sat;
pliant: [adj]易弯的,柔软的; [n]顺从; [a]/ˈplaɪənt/; [or]sat;
discourse: [n]交谈,演讲,论述,讲道; [v]演讲,谈论; [a]/ˈdɪskɔːrs/; [or]sat;
stipulate: [v]规定;保证;保证;要求以.为条件; [a]/ˈstɪpjuleɪt/; [or]sat;
eccentricity: [n]古怪;怪癖;[数]离心率; [a]/ˌeksenˈtrɪsəti/; [or]sat;
babble: [v]呀呀学语,喋喋不休,作潺潺声;泄露(秘密); [n]儿语,胡言乱语,潺潺声; [a]/ˈbæbl/; [or]sat;
soluble: [adj]可溶解的;可解决的; [a]/ˈsɑːljəbl/; [or]sat;
jollity: [n]欢乐,酒宴,欢庆; [a]/ˈdʒɑːləti/; [or]sat;
corrugated: [adj]褶皱的; [a]/ˈkɔːrəɡeɪtɪd/; [or]sat;
verbiage: [n]罗嗦,冗长,措辞方式; [a]/ˈvɜːrbiɪdʒ/; [or]sat;
exalt: [v]提升,提拔,赞扬,使得意; [a]/ɪɡˈzɔːlt/; [or]sat;
feign: [v]假装,装作; [a]/feɪn/; [or]sat;
brittle: [adj]易碎的;脆弱的;靠不住的; [n]薄片脆糖; [a]/ˈbrɪtl/; [or]sat;
asperity: [n](表面的)粗糙;(气候等的)严酷;艰苦的条件;(性格)粗暴; [a]/æˈsperəti/; [or]sat;
infusion: [n]灌输;注入物;输入; [a]/ɪnˈfjuːʒn/; [or]sat;
pertinent: [adj]有关的;适当的;中肯的; [n]附属物;参考; [a]/ˈpɜːrtnənt/; [or]sat;
infernal: [adj]地狱的;恶魔的;可憎的; [a]/ɪnˈfɜːrnl/; [or]sat;
turbulence: [n]骚乱,动荡;狂暴;(空气或水的)乱流; [a]/ˈtɜːrbjələns/; [or]sat;
abstract: [adj]抽象的; [n]摘要,抽象; [v]提取; [a]/ˈæbstrækt/; [or]sat;
insurmountable: [adj]不能克服的,不能超越的,难以对付的; [a]/ˌɪnsərˈmaʊntəbl/; [or]sat;
epithet: [n]外号,绰号; [a]/ˈepɪθet/; [or]sat;
precipitate: [v]促成,使..沉淀,猛摔;[气象]凝结; [n]沉淀物,冷凝物; [adj]突如其来的,仓促的,迅猛的;感情用事的; [a]/prɪˈsɪpɪteɪt/; [or]sat;
foster: [adj]收养的; [vt]养育;培养,促进; [a]/ˈfɔːstər/; [or]sat;
berserk: [adj]狂暴的,疯的的; [adv]狂暴地,狂怒地; [n]同"berserker"; [a]/bərˈzɜːrk/; [or]sat;
genesis: [n](事物的)起源,发生; [a]/ˈdʒenəsɪs/; [or]sat;
amnesia: [n][医学]遗忘症; [a]/æmˈniːʒə/; [or]sat;
absolve: [v]赦免,宽恕;免除,解除; [a]/əbˈzɑːlv/; [or]sat;
balk: [v]畏缩;阻止;停止; [n]障碍;错误; [a]/bɔːk/; [or]sat;
besmirch: [v]诽谤,玷污; [a]/bɪˈsmɜːrtʃ/; [or]sat;
tarry: [n]逗留,短期滞在; [v]耽搁,踌躇(等待),拖延; [adj]柏油的,涂柏油的; [a]/ˈtæri/; [or]sat;
frivolous: [adj]轻佻的,不重要的,缺乏基础的; [a]/ˈfrɪvələs/; [or]sat;
plaintive: [adj]表示悲痛的,伤心的; [a]/ˈpleɪntɪv/; [or]sat;
unwitting: [adj]不知情的;无意的; [a]/ʌnˈwɪtɪŋ/; [or]sat;
sheaf: [n]一捆,一束; [v]捆,束; [a]/ʃiːf/; [or]sat;
impinge: [v]侵犯,撞击,碰撞; [a]/ɪmˈpɪndʒ/; [or]sat;
cantata: [n]大合唱;清唱剧;(一种声乐套曲)康塔塔; [a]/kænˈtɑːtə/; [or]sat;
impecunious: [adj]贫困的,一文不名的; [a]/ˌɪmpɪˈkjuːniəs/; [or]sat;
forestall: [v]领先;占先一步;先发制人,阻止,妨碍;垄断;占先一步; [a]/fɔːrˈstɔːl/; [or]sat;
herbivorous: [adj]食草的; [a]/ɜːrˈbɪvərəs/; [or]sat;
bluff: [adj]直率的; [v]虚张声势,吓唬; [n]虚张声势;吓唬;断崖,绝壁; [a]/blʌf/; [or]sat;
insensible: [adj]昏迷的,无知觉的,麻木不仁的; [a]/ɪnˈsensəbl/; [or]sat;
insipid: [adj]淡而无味的;枯燥乏味的; [a]/ɪnˈsɪpɪd/; [or]sat;
entice: [v]怂恿,引诱; [a]/ɪnˈtaɪs/; [or]sat;
hovel: [n]茅舍,肮脏的小屋; [a]/ˈhʌvl/; [or]sat;
implicit: [adj]隐含的;盲目的;完全的,绝对的;成为一部分的; [a]/ɪmˈplɪsɪt/; [or]sat;
drab: [adj]枯黄色的,无聊的,单调的; [n]单调;淡褐色;[印,纺]淡褐色厚呢;邋遢女人; [a]/dræb/; [or]sat;
indifferent: [adj]不感兴趣的,不关心的;平庸的;冷漠的; [a]/ɪnˈdɪfrənt/; [or]sat;
incidence: [n]发生率,入射角度; [a]/ˈɪnsɪdəns/; [or]sat;
specious: [adj]外表美观,华而不实的,徒有其表的; [a]/ˈspiːʃəs/; [or]sat;
dissertation: [n](博士学位)论文;学术演讲;专题; [a]/ˌdɪsərˈteɪʃn/; [or]sat;
qualified: [adj]有资格的;保留的,有限度的; [vt]描述,形容;使合适;授权予;有权,达标; [vi]合格,成为合格;取得.的资格; [a]/ˈkwɑːlɪfaɪd/; [or]sat;
effusive: [adj]流出的;感情奔放的; [a]/ɪˈfjuːsɪv/; [or]sat;
fanaticism: [n]狂热,盲信; [a]/fəˈnætɪsɪzəm/; [or]sat;
subside: [vi]平息,减弱;减弱;(建筑)下陷;(尤指洪水的水位) 回落; [a]/səbˈsaɪd/; [or]sat;
remiss: [adj]疏忽的,怠慢的; [a]/rɪˈmɪs/; [or]sat;
quay: [n]码头; [a]/kiː/; [or]sat;
montage: [n]蒙太奇(电影的基本结构手段和叙事方式),混合画,拼集的照片; [a]/ˌmɑːnˈtɑːʒ/; [or]sat;
nicety: [n]细节,讲究; [a]/ˈnaɪsəti/; [or]sat;
clench: [v]紧握,(拳头)牢牢地抓住;确定;敲弯;咬紧(牙关); [n]紧抓;咬紧牙关;咬牙切齿;敲弯的钉头; [a]/klentʃ/; [or]sat;
vaporize: [v](使)蒸发;使.蒸发; [a]/ˈveɪpəraɪz/; [or]sat;
impunity: [n]不受惩罚;无患; [a]/ɪmˈpjuːnəti/; [or]sat;
facetious: [adj]滑稽的,诙谐的,开玩笑的; [a]/fəˈsiːʃəs/; [or]sat;
lucrative: [adj]合算的;获利的;有利可图的; [a]/ˈluːkrətɪv/; [or]sat;
attest: [vt]证明;证实;为.作证; [vi]证明;作证; [a]/əˈtest/; [or]sat;
prey: [n]被掠食者,猎物;牺牲者; [v]使..苦恼; [vi]捕食;受..控制; [a]/preɪ/; [or]sat;
navigable: [adj](江河,海洋)可航行的,可通航的;(船)适航的; [a]/ˈnævɪɡəbl/; [or]sat;
pragmatic: [adj]国事的,团体事务的;实际的,注重实效的; [n]爱管闲事的人;专断的人;国事诏书;实际家; [a]/præɡˈmætɪk/; [or]sat;
homage: [n]敬意;尊敬;效忠; [a]/ˈhɑːmɪdʒ/; [or]sat;
splice: [n]接合,衔接处; [v]接头,捻接(线头等); [a]/splaɪs/; [or]sat;
query: [n]质问,询问,怀疑; [v]询问,表示怀疑; [a]/ˈkwɪri/; [or]sat;
rummage: [n]杂物,翻寻; [v]彻底搜查,翻箱倒柜; [a]/ˈrʌmɪdʒ/; [or]sat;
unseemly: [adj]不适宜的;不得体的; [adv]不适当地; [a]/ʌnˈsiːmli/; [or]sat;
demur: [n]异议; [v]异议,反对,拒绝; [a]/dɪˈmɜːr/; [or]sat;
acclaim: [n]欢呼,赞扬,称赞; [v]欢呼,喝彩,鼓掌欢迎; [vt]鼓掌欢迎,向.欢呼,为.喝彩;推选; [a]/əˈkleɪm/; [or]sat;
vindictive: [adj]报复性的,怀恨的,惩罚的; [a]/vɪnˈdɪktɪv/; [or]sat;
prolong: [v]延长;拉长;拖延; [a]/prəˈlɔːŋ/; [or]sat;
collage: [n]抽象拚贴画(用报纸,布,压平的花等碎片拼合而成的); [a]/kəˈlɑːʒ/; [or]sat;
pensive: [adj]沉思的,心事重重的,忧郁的; [a]/ˈpensɪv/; [or]sat;
migrant: [n]候鸟;移民; [a]/ˈmaɪɡrənt/; [or]sat;
truism: [n]自明之理,真理,不言而喻的道理; [a]/ˈtruːɪzəm/; [or]sat;
euphoria: [n]幸福愉快感; [a]/juːˈfɔːriə/; [or]sat;
penchant: [n]倾向,爱好; [a]/ˈpentʃənt/; [or]sat;
flinch: [v]畏缩,退缩; [n]退缩,畏惧; [a]/flɪntʃ/; [or]sat;
oaf: [n]愚蠢的人; [a]/oʊf/; [or]sat;
tensile: [adj]可拉长的,可伸长的,[物]张力的,拉力的; [a]/ˈtensl/; [or]sat;
frigid: [adj]寒冷的,冷淡的,死板的,呆板的,性冷淡的; [a]/ˈfrɪdʒɪd/; [or]sat;
quip: [n]妙语,嘲弄,讽刺语; [v]嘲弄,讥讽; [a]/kwɪp/; [or]sat;
germinate: [v]发芽,发展,生长; [a]/ˈdʒɜːrmɪneɪt/; [or]sat;
lurid: [adj](暴力,性爱等)耸人听闻的; [a]/ˈlʊrɪd/; [or]sat;
application: [n]运用;申请(书);应用程序; [a]/ˌæplɪˈkeɪʃn/; [or]sat;
inevitable: [adj]不可避免的,必然的; [n]必然发生的事; [a]/ɪnˈevɪtəbl/; [or]sat;
aquiline: [adj]鹰的,似鹰的;钩状的; [a]/ˈækwɪlaɪn/; [or]sat;
snicker: [vi]偷笑,窃笑; [vt]窃笑着说; [n]窃笑; [a]/ˈsnɪkər/; [or]sat;
check: [v]检查;阻止; [n]支票;阻止;检查;阻止物; [a]/tʃek/; [or]sat;
parry: [v]挡开,避开(武器,问题等); [a]/ˈpæri/; [or]sat;
expiate: [v]赎罪,补偿; [a]/ˈekspieɪt/; [or]sat;
benediction: [n]祝福,祈祷; [a]/ˌbenɪˈdɪkʃn/; [or]sat;
probe: [v]探测,探索; [n]探索,调查;探针,探测器; [a]/proʊb/; [or]sat;
rehabilitate: [v]使康复,使恢复名誉,使恢复原状; [a]/ˌriːəˈbɪlɪteɪt/; [or]sat;
perspicacious: [adj]独具慧眼的,聪颖的; [a]/ˌpɜːrspɪˈkeɪʃəs/; [or]sat;
abridge: [v]删节;削减; [a]/əˈbrɪdʒ/; [or]sat;
holster: [n]手枪皮套; [a]/ˈhoʊlstər/; [or]sat;
incumbent: [n]在职者,现任者; [adj]现任的;依靠的;负有职责的; [a]/ɪnˈkʌmbənt/; [or]sat;
nip: [v]咬;捏;剪断;冻伤;阻止; [n]夹;捏;刺骨;小饮; [a]/nɪp/; [or]sat;
vex: [v]使烦恼,使苦恼,使恼怒; [a]/veks/; [or]sat;
encumber: [v]阻塞,妨害,拖累; [a]/ɪnˈkʌmbər/; [or]sat;
proscribe: [v]剥夺..的公权,禁止; [a]/proʊˈskraɪb/; [or]sat;
natty: [adj]整洁的,干净的,潇洒的; [a]/ˈnæti/; [or]sat;
camouflage: [n]伪装;掩饰; [v]使改头换面,伪装,掩饰;欺瞒; [a]/ˈkæməflɑːʒ/; [or]sat;
purveyor: [n]承办者;供应粮食者; [a]/pərˈveɪər/; [or]sat;
pachyderm: [n]迟钝的人;厚脸皮的人;厚皮类动物; [a]/ˈpækidɜːrm/; [or]sat;
fauna: [n]动物区系,动物群; [a]/ˈfɔːnə/; [or]sat;
militant: [adj]好战的,好暴力的; [n]激进分子,斗士; [a]/ˈmɪlɪtənt/; [or]sat;
precept: [n]箴言,格言; [a]/ˈpriːsept/; [or]sat;
fruition: [n]享有;最后完成,实现,取得成果; [a]/fruˈɪʃn/; [or]sat;
proponent: [n]支持者;提议者;主张者;提出认证遗嘱者; [adj]建议的;支持的;辩护的; [a]/prəˈpoʊnənt/; [or]sat;
platitude: [n]陈词滥调,老生常谈;单调; [a]/ˈplætɪtuːd/; [or]sat;
Catholic: [adj](兴趣等)广泛的,(C大写)天主教的; [n](C大写)天主教徒; [a]/ˈkæθlɪk/; [or]sat;
interminable: [adj]没完没了的,无穷无尽的,冗长的; [a]/ɪnˈtɜːrmɪnəbl/; [or]sat;
seclusion: [n]隐遁,隐蔽的地方; [a]/sɪˈkluːʒn/; [or]sat;
nutrient: [n]营养物;滋养物; [adj]营养的;滋养的; [a]/ˈnuːtriənt/; [or]sat;
opalescent: [adj]乳白色的;发乳白光的; [a]/ˌoʊpəˈlesnt/; [or]sat;
sublime: [adj]雄伟的,崇高的,极端的,超群的;(行为,态度)极端的,漠不关心的; [n]顶峰,崇高; [v]使.纯化,使.升华,变高尚; [a]/səˈblaɪm/; [or]sat;
monolithic: [adj]巨石的,庞大的;千篇一律的; [a]/ˌmɑːnəˈlɪθɪk/; [or]sat;
anathema: [n](基督教的)咒诅,被诅咒者,令人厌恶的人; [a]/əˈnæθəmə/; [or]sat;
lunge: [n]突然刺(入);突然向前冲〔扑等);套马索; [v](用剑等)刺,戳;猛向前冲,猛扑; [a]/lʌndʒ/; [or]sat;
sate: [v]使心满意足,使厌足; [a]/seɪt/; [or]sat;
raze: [v]夷为平地,破坏,消除;拆毁; [a]/reɪz/; [or]sat;
purchase: [v]购买; [n]购买;所购之物; [a]/ˈpɜːrtʃəs/; [or]sat;
benevolent: [adj]慈爱的,仁慈的;乐善好施的;慈善的; [a]/bəˈnevələnt/; [or]sat;
dabble: [v]涉足;浅赏,溅湿;浸入水中; [a]/ˈdæbl/; [or]sat;
enterprising: [adj]有事业心的,有进取心的,有魅力的,有胆量的;有魄力的; [a]/ˈentərpraɪzɪŋ/; [or]sat;
proliferation: [n]增殖;增加; [a]/prəˌlɪfəˈreɪʃn/; [or]sat;
coercion: [n]胁迫,威压; [a]/koʊˈɜːrʒn/; [or]sat;
ceremonious: [adj]隆重的;讲究仪式的;正式的; [a]/ˌserəˈmoʊniəs/; [or]sat;
integral: [adj](用于构成整体)必需的,不可缺少的,必不可少的;基本的,作为组成部分的,内置的;整体的,完整的; [a]/ˈɪntɪɡrəl/; [or]sat;
malign: [v]诽谤,中伤; [adj]邪恶的;有害的; [a]/məˈlaɪn/; [or]sat;
savory: [adj]口感好的,味道好的,令人愉悦的; [a]/ˈseɪvəri/; [or]sat;
desecrate: [v]亵渎,玷污; [a]/ˈdesɪkreɪt/; [or]sat;
inhibit: [v]阻碍;阻止,防止;抑制,约束; [a]/ɪnˈhɪbɪt/; [or]sat;
valid: [adj]有效的,正式认可的;合理的,有根据的; [a]/ˈvælɪd/; [or]sat;
rant: [n]咆哮,痛骂; [v]咆哮,痛骂,大声责骂; [a]/rænt/; [or]sat;
anarchist: [n]无政府主义者; [a]/ˈænərkɪst/; [or]sat;
implacable: [adj]难以满足的,难平息的; [a]/ɪmˈplækəbl/; [or]sat;
temperament: [n]气质,性格,喜怒无常; [a]/ˈtemprəmənt/; [or]sat;
gruff: [adj]粗暴的,粗哑的,脾气坏的; [vt]粗鲁地说,生硬地说; [vi]粗鲁地说,生硬地说话; [a]/ɡrʌf/; [or]sat;
deify: [v]奉为神;崇拜; [a]/ˈdeɪɪfaɪ/; [or]sat;
appreciate: [v]赏识;为..表示感激;领会;使增值;增值; [a]/əˈpriːʃieɪt/; [or]sat;
seep: [v](液体等)渗漏,(观念等)渗入,(疾病恐惧等)扩散; [n]小泉,水陆两用的吉普车; [a]/siːp/; [or]sat;
subsequent: [adj]随后的; [a]/ˈsʌbsɪkwənt/; [or]sat;
impair: [v]损害;削弱; [a]/ɪmˈper/; [or]sat;
ogle: [v]送秋波,施媚眼; [n]秋波,媚眼; [a]/ˈoʊɡl/; [or]sat;
salient: [adj]显著的;突出的;跳跃的; [n]凸角;突出部分; [a]/ˈseɪliənt/; [or]sat;
instigate: [v]发起,煽动; [a]/ˈɪnstɪɡeɪt/; [or]sat;
recurrent: [adj]复发的;周期性的,经常发生的; [a]/rɪˈkɜːrənt/; [or]sat;
slovenly: [adj]不整洁的,马虎的; [a]/ˈslʌvnli/; [or]sat;
zealot: [n]狂热份子,犹太教狂热信徒; [a]/ˈzelət/; [or]sat;
collusion: [n]勾结;共谋; [a]/kəˈluːʒn/; [or]sat;
flick: [n]轻弹,轻打;轻弹声; [v]轻弹;轻轻拂去;(翅)拍动;(旗)飘扬; [a]/flɪk/; [or]sat;
expunge: [v]删除; [a]/ɪkˈspʌndʒ/; [or]sat;
idiosyncrasy: [n]特殊癖性或行为; [a]/ˌɪdiəˈsɪŋkrəsi/; [or]sat;
maternal: [adj]母亲的,母性的;母方的,母系的; [a]/məˈtɜːrnl/; [or]sat;
affable: [adj]易于交谈的,和蔼的; [a]/ˈæfəbl/; [or]sat;
optimist: [n]乐天派,乐观者; [a]/ˈɑːptɪmɪst/; [or]sat;
burlesque: [adj]滑稽的,可笑的; [v]讥笑; [n]脱衣舞,打油诗,滑稽戏,笑剧,杂耍,漫画; [a]/bɜːrˈlesk/; [or]sat;
cogitate: [v]慎重思考,思索; [a]/ˈkɑːdʒɪteɪt/; [or]sat;
oblivious: [adj]不在意的;忘却的,健忘的; [a]/əˈblɪviəs/; [or]sat;
grotesque: [adj]奇形怪状的,奇异的; [n]奇形怪状的人(或物,图案等);奇异风格; [a]/ɡroʊˈtesk/; [or]sat;
daub: [v]涂抹,乱画; [n]涂抹,涂料,拙劣的画; [a]/dɔːb/; [or]sat;
lilliputian: [adj]小人国的,气量小的; [n]侏儒,小人国居民; [a]/ˌlɪlɪˈpjuːʃn/; [or]sat;
atone: [v]赎罪,补偿; [a]/əˈtoʊn/; [or]sat;
liability: [n]责任;债务;倾向;可能性;不利因素;惹麻烦的人(或事); [a]/ˌlaɪəˈbɪləti/; [or]sat;
prattle: [v]闲聊;胡说;小孩般说话; [n]无聊话;咿咿呀呀声; [a]/ˈprætl/; [or]sat;
proclivity: [n]倾向,怪癖; [a]/prəˈklɪvəti/; [or]sat;
tactile: [adj]有触觉的;能触知的; [a]/ˈtæktl/; [or]sat;
haggard: [adj]憔悴的,消瘦的; [n]哈格德;未驯服的鹰;悍鹰; [a]/ˈhæɡərd/; [or]sat;
neophyte: [n]新信徒;新入教者;初学者; [a]/ˈniːəfaɪt/; [or]sat;
pundit: [n]博学者,评论家; [a]/ˈpʌndɪt/; [or]sat;
manifest: [adj]显然的,明白无误的,明了的; [v]使显现,使显露,表明; [n]货单,旅客名单; [a]/ˈmænɪfest/; [or]sat;
remonstrance: [n]抗议,抱怨,谏书; [a]/rɪˈmɑːnstrəns/; [or]sat;
strew: [vt]撒;把.撒在.上;散播,点缀; [a]/struː/; [or]sat;
multifaceted: [adj]多层面的; [a]/ˌmʌltiˈfæsɪtɪd/; [or]sat;
obfuscate: [v]使复杂;使迷乱,使模糊;弄暗; [a]/ˈɑːbfʌskeɪt/; [or]sat;
maladroit: [adj]笨拙的; [a]/ˌmæləˈdrɔɪt/; [or]sat;
polyglot: [n]通晓数种语言的人;用通晓数种语言记载的书; [adj]通数国语言,数国语言的; [a]/ˈpɑːliɡlɑːt/; [or]sat;
potential: [n]潜力,潜能; [adj]潜在的,可能的; [a]/pəˈtenʃl/; [or]sat;
jargon: [n]行话,术语;黄锆石; [a]/ˈdʒɑːrɡən/; [or]sat;
iniquitous: [adj]邪恶的;不公正的; [a]/ɪˈnɪkwɪtəs/; [or]sat;
avarice: [n]贪财,贪婪; [a]/ˈævərɪs/; [or]sat;
livid: [adj]气急败坏的,铅色的; [a]/ˈlɪvɪd/; [or]sat;
laud: [v]赞美,称赞; [a]/lɔːd/; [or]sat;
detached: [adj]孤立的,分开的,超然公平的; [a]/dɪˈtætʃt/; [or]sat;
outmoded: [adj]不再流行的,过时的; [a]/ˌaʊtˈmoʊdɪd/; [or]sat;
predator: [n]掠夺者,食肉动物; [a]/ˈpredətər/; [or]sat;
irremediable: [adj]不能挽回的,不能补救的; [a]/ˌɪrɪˈmiːdiəbl/; [or]sat;
abstinence: [n]节制,禁欲; [a]/ˈæbstɪnəns/; [or]sat;
allegory: [n]讽喻;寓意;寓言; [a]/ˈæləɡɔːri/; [or]sat;
allure: [v]吸引;诱使; [n]诱惑力; [a]/əˈlʊr/; [or]sat;
lout: [n]粗人,笨拙的人; [a]/laʊt/; [or]sat;
abortive: [adj]无结果的,失败的; [a]/əˈbɔːrtɪv/; [or]sat;
narrative: [n]叙述; [adj]叙述的; [a]/ˈnærətɪv/; [or]sat;
allocate: [v]分配,配给; [a]/ˈæləkeɪt/; [or]sat;
piquant: [adj]辛辣的,开胃的;活泼有趣的; [a]/ˈpiːkənt/; [or]sat;
itinerant: [n]巡回工作者; [adj]巡回的;流动的; [a]/aɪˈtɪnərənt/; [or]sat;
rectify: [v]纠正;修复; [a]/ˈrektɪfaɪ/; [or]sat;
outspoken: [adj]直言的,坦率的; [a]/aʊtˈspoʊkən/; [or]sat;
shrewd: [adj]精明的;机灵的; [n]精明;精明者; [a]/ʃruːd/; [or]sat;
numismatist: [n]钱币学家,钱币收藏家; [a]/nuːˈmɪzmətɪst/; [or]sat;
browse: [v]浏览;随意翻阅;(牛,羊等)吃草; [a]/braʊz/; [or]sat;
canto: [n](长诗的)分篇; [a]/ˈkæntoʊ/; [or]sat;
arbitrary: [adj]随意的,任性的,随心所欲的;霸道的,专制的,专横的;主观的,武断的; [a]/ˈɑːrbətreri/; [or]sat;
contrived: [adj]人为的;做作的;不自然的; [a]/kənˈtraɪvd/; [or]sat;
comprise: [v]包含,包括;构成; [a]/kəmˈpraɪz/; [or]sat;
transcribe: [v]抄写,转录; [a]/trænˈskraɪb/; [or]sat;
excerpt: [n]摘录,节选; [v]摘,选;引用; [a]/ˈeksɜːrpt/; [or]sat;
collateral: [adj]间接的,旁系的; [n]抵押品; [a]/kəˈlætərəl/; [or]sat;
expatriate: [v](使)移居国外;(使)放弃国籍;流放,放逐; [n]被流放者;移居国外者; [adj]移居国外的;被流放的; [a]/ˌeksˈpeɪtriət/; [or]sat;
arsenal: [n]兵工厂,军械库;储藏; [a]/ˈɑːrsənl/; [or]sat;
espouse: [v]支持,拥护; [a]/ɪˈspaʊz/; [or]sat;
rectitude: [n]正直,公正,正确; [a]/ˈrektɪtuːd/; [or]sat;
hoary: [adj]年纪高迈的;(头发等)灰白的;古老的; [a]/ˈhɔːri/; [or]sat;
intractable: [adj]棘手的;难治的;倔强的;不听话的; [a]/ɪnˈtræktəbl/; [or]sat;
gusto: [n]由衷的高兴;爱好,嗜好; [a]/ˈɡʌstoʊ/; [or]sat;
lexicon: [n]词典,语言,文字; [a]/ˈleksɪkən/; [or]sat;
insomnia: [n]失眠; [a]/ɪnˈsɑːmniə/; [or]sat;
debacle: [n]解冻,崩溃;灾害; [a]/dɪˈbɑːkl/; [or]sat;
sustenance: [n]生计;食物,粮食; [a]/ˈsʌstənəns/; [or]sat;
spurn: [v]轻蔑地拒绝,摒弃,唾弃,一脚踢开; [a]/spɜːrn/; [or]sat;
engaging: [adj]迷人的; [a]/ɪnˈɡeɪdʒɪŋ/; [or]sat;
stem: [n]茎,(树)干; [v]阻止;起源于;遏制,抑制; [a]/stem/; [or]sat;
ostentatious: [adj]浮华的,虚饰的,外观美丽的; [a]/ˌɑːstenˈteɪʃəs/; [or]sat;
stagnant: [adj]不流动的;停滞的;萧条的; [a]/ˈstæɡnənt/; [or]sat;
obstreperous: [adj]吵闹的,喧嚣的;难驾驭的; [a]/əbˈstrepərəs/; [or]sat;
irony: [n]反语;冷嘲;具有讽刺意味的事; [a]/ˈaɪrəni/; [or]sat;
lurk: [n]潜伏,潜行; [vi]潜伏;潜藏;鬼鬼祟祟地走; [a]/lɜːrk/; [or]sat;
stupor: [n]恍惚,昏迷,不醒人事; [a]/ˈstuːpər/; [or]sat;
deviate: [v]偏离;背离; [adj]脱离常轨的; [n]脱离常轨的人; [a]/ˈdiːvieɪt/; [or]sat;
savor: [n]味道,气味,特点,趣味; [v]调味,品尝,欣赏,玩味; [a]/ˈseɪvər/; [or]sat;
opaque: [adj]不透明的;难懂的; [a]/oʊˈpeɪk/; [or]sat;
misrepresent: [vi]作虚假陈述; [vt]歪曲;误传; [a]/ˌmɪsˌreprɪˈzent/; [or]sat;
monochromatic: [adj][物]单色的; [a]/ˌmɑːnəkroʊˈmætɪk/; [or]sat;
equanimity: [n]平静,镇定,沉着; [a]/ˌekwəˈnɪməti/; [or]sat;
tenuous: [adj]纤细的;稀薄的;贫乏的;脆弱的; [a]/ˈtenjuəs/; [or]sat;
flippant: [adj]无礼的,轻率的,随意的; [a]/ˈflɪpənt/; [or]sat;
summit: [n]山顶,顶点;(政府间的)峰会; [a]/ˈsʌmɪt/; [or]sat;
munificent: [adj]慷慨的,大方的; [a]/mjuːˈnɪfɪsnt/; [or]sat;
stratum: [n]层次;薄层;地层;阶层; [a]/ˈstreɪtəm/; [or]sat;
satirical: [adj]讽刺性的,讥讽的,爱挖苦人的; [a]/səˈtɪrɪkl/; [or]sat;
ostensible: [adj]表面上的,伪装的; [a]/ɑːˈstensəbl/; [or]sat;
myriad: [n]无数;极大数量; [adj]无数的; [a]/ˈmɪriəd/; [or]sat;
quiver: [n]颤抖;箭袋; [vi]颤抖; [a]/ˈkwɪvər/; [or]sat;
importunate: [adj]讨厌的,急切的,缠扰不休的; [a]/ɪmˈpɔːrtʃənət/; [or]sat;
levy: [v]征收(税等); [n]征税;税款; [a]/ˈlevi/; [or]sat;
elliptical: [adj]椭圆的;省略的; [a]/ɪˈlɪptɪkl/; [or]sat;
pliable: [adj]易弯的;柔韧的;圆滑的; [a]/ˈplaɪəbl/; [or]sat;
predecessor: [n]前辈;(被取代的)原有事物; [a]/ˈpredəsesər/; [or]sat;
dearth: [n]缺乏,供应不足; [a]/dɜːrθ/; [or]sat;
gentility: [n]上流阶层;文雅;有教养; [a]/dʒenˈtɪləti/; [or]sat;
ruminate: [v]反刍,再嚼,深思; [a]/ˈruːmɪneɪt/; [or]sat;
charlatan: [n]骗子;假内行; [a]/ˈʃɑːrlətən/; [or]sat;
bauble: [n]廉价珠宝;小玩意; [a]/ˈbɔːbl/; [or]sat;
reputable: [adj]声誉好的;受尊敬的;卓越的; [a]/ˈrepjətəbl/; [or]sat;
plumage: [n]全身羽毛; [a]/ˈpluːmɪdʒ/; [or]sat;
concession: [n]让步;特许,特许权;承认; [a]/kənˈseʃn/; [or]sat;
wane: [n]衰退(期);月亏(期);减少; [v](月)缺损;(光,势力,治理等)衰落;减少; [a]/weɪn/; [or]sat;
patronize: [v]惠顾;赞助,资助; [a]/ˈpeɪtrənaɪz/; [or]sat;
authenticate: [v]鉴定;证明.是真实的; [a]/ɔːˈθentɪkeɪt/; [or]sat;
ethos: [n]民族精神,气质,社会思潮; [a]/ˈiːθɑːs/; [or]sat;
commodious: [adj]宽敞的; [a]/kəˈmoʊdiəs/; [or]sat;
glacial: [adj]冰的;冰冷的;冰河时代的; [a]/ˈɡleɪʃl/; [or]sat;
anthem: [n]国歌,赞美诗,圣歌; [a]/ˈænθəm/; [or]sat;
palliate: [v]减轻,掩饰,辩解; [a]/ˈpælieɪt/; [or]sat;
detrimental: [adj]有害的,不利的; [a]/ˌdetrɪˈmentl/; [or]sat;
mobile: [n]风铃,悬挂饰物;手机,移动电话; [adj]可移动的;行动方便的; [a]/ˈmoʊbl/; [or]sat;
quandary: [n]困惑;窘境;为难; [a]/ˈkwɑːndəri/; [or]sat;
boon: [n]恩惠,福利,利益; [adj]愉快的; [a]/buːn/; [or]sat;
debonair: [adj]温文尔雅的; [a]/ˌdebəˈner/; [or]sat;
foreshadow: [v]预示; [n]预兆; [a]/fɔːrˈʃædoʊ/; [or]sat;
effigy: [n]肖像,模拟像; [a]/ˈefɪdʒi/; [or]sat;
shroud: [n]寿衣,覆盖物; [v]覆盖,包以尸衣; [a]/ʃraʊd/; [or]sat;
curtail: [vt]截短;削减;剥夺.特权; [a]/kɜːrˈteɪl/; [or]sat;
posterity: [n]子孙,后裔,后代; [a]/pɑːˈsterəti/; [or]sat;
succor: [n]救援,援助者,救援人员; [v]援助,救援; [a]/ˈsʌkər/; [or]sat;
lewd: [adj]好色的,淫荡的,猥亵的; [a]/luːd/; [or]sat;
initiate: [v]开始,发动; [n]新加入组织的人; [a]/ɪˈnɪʃieɪt/; [or]sat;
laconic: [adj](用词)简洁的;简明的; [adv]简短地,简洁地; [a]/ləˈkɑːnɪk/; [or]sat;
infamous: [adj]声名狼藉的,无耻的; [a]/ˈɪnfəməs/; [or]sat;
convene: [v]集合,召集,召唤; [a]/kənˈviːn/; [or]sat;
patina: [n]绿锈,光亮的外表,神态,圣餐盘; [a]/pəˈtiːnə/; [or]sat;
arrogance: [n]自大;傲慢态度; [a]/ˈærəɡəns/; [or]sat;
fusion: [n]融合,合并,核聚变; [a]/ˈfjuːʒn/; [or]sat;
gambit: [n](常指带风险的)策略,弃兵局(指国际象棋开局弃一卒以取得优势),话题,开始,开场白; [a]/ˈɡæmbɪt/; [or]sat;
augment: [v]增加;助长; [a]/ɔːɡˈment/; [or]sat;
inclement: [adj]险恶的;气候严酷的;狂风暴雨的; [a]/ɪnˈklemənt/; [or]sat;
fathom: [n]英寻(=6英尺); [vi]测量深度; [vt]彻底了解,测深; [a]/ˈfæðəm/; [or]sat;
bountiful: [adj]充足的,慷慨的,丰裕的; [a]/ˈbaʊntɪfl/; [or]sat;
genre: [n]类型,流派; [adj]风俗画的,以日常情景为主题的; [a]/ˈʒɑːnrə/; [or]sat;
aggregate: [n]合计;总数;混凝料;总计; [v]集合;聚集;合计; [adj]总的,总数的;集合的; [a]/ˈæɡrɪɡət/; [or]sat;
synthesis: [n]合成; [a]/ˈsɪnθəsɪs/; [or]sat;
dwindle: [v]日渐减少,变小,缩小; [a]/ˈdwɪndl/; [or]sat;
surmise: [v]猜测,推测,认为; [n]推测,猜度; [a]/sərˈmaɪz/; [or]sat;
dauntless: [adj]勇敢的,无畏的;不屈不挠的; [a]/ˈdɔːntləs/; [or]sat;
uncouth: [adj]笨拙的;粗野的;不舒适的;陌生的; [a]/ʌnˈkuːθ/; [or]sat;
turncoat: [n]叛徒; [a]/ˈtɜːrnkoʊt/; [or]sat;
ratiocination: [n]推理,推论; [a]/ˌreɪʃioʊsɪˈneɪʃn/; [or]sat;
mischance: [n]不幸,灾难; [a]/ˌmɪsˈtʃæns/; [or]sat;
precise: [adj]精确的;恰好的; [a]/prɪˈsaɪs/; [or]sat;
ambidextrous: [adj]双手都灵巧; [a]/ˌæmbiˈdekstrəs/; [or]sat;
engage: [vt]吸引住(注意力,兴趣);雇,聘; [vi]使加入,使融入;订婚; [v](军队)交战;啮合; [a]/ɪnˈɡeɪdʒ/; [or]sat;
pact: [n]合同;协约; [a]/pækt/; [or]sat;
scanty: [adj]少的,小的,缺乏的; [a]/ˈskænti/; [or]sat;
ominous: [adj]不祥的,不吉利的; [a]/ˈɑːmɪnəs/; [or]sat;
intangible: [adj]不可捉摸的,无形的; [n]无形的东西; [a]/ɪnˈtændʒəbl/; [or]sat;
invidious: [adj]惹人反感的,招人嫉妒的,令人厌恶的,诽谤的,不公平的; [a]/ɪnˈvɪdiəs/; [or]sat;
bullion: [n](造币用)金块;纯金,纯银;条形金属; [a]/ˈbʊliən/; [or]sat;
foresight: [n]先见,预见;远见,深谋远虑; [a]/ˈfɔːrsaɪt/; [or]sat;
latent: [adj]潜在的,隐伏的,不易察觉的; [a]/ˈleɪtnt/; [or]sat;
pedagogy: [n]教育学,教学法; [a]/ˈpedəɡɑːdʒi/; [or]sat;
practicable: [adj]能实行的,行得通的;适用的,能用的;可通行的; [a]/ˈpræktɪkəbl/; [or]sat;
beneficial: [adj]有益的,有利的; [a]/ˌbenɪˈfɪʃl/; [or]sat;
fervid: [adj]热的;热心的; [a]/ˈfɜːrvɪd/; [or]sat;
scale: [n]天平,磅秤;刻度,尺度,标度;等级,级别, 等级体系;鳞片,鳞状物;规模;水垢,牙垢; [v]攀登;按比例决定;称重;刮鳞,剥落; [a]/skeɪl/; [or]sat;
trifling: [adj]细微的,不重要的; [a]/ˈtraɪflɪŋ/; [or]sat;
sinister: [adj]不吉祥的,险恶的; [a]/ˈsɪnɪstər/; [or]sat;
precocious: [adj]早慧的;早熟的;过早发育的; [a]/prɪˈkoʊʃəs/; [or]sat;
prodigious: [adj]异常的,奇妙的;巨大的; [a]/prəˈdɪdʒəs/; [or]sat;
loom: [n]织布机; [v]阴森地逼近;隐现;即将来临; [a]/luːm/; [or]sat;
incompatible: [adj]不兼容的,矛盾的,不调和的; [a]/ˌɪnkəmˈpætəbl/; [or]sat;
tether: [n]范围,系链,拴绳; [v]用绳或链拴住; [a]/ˈteðər/; [or]sat;
slacken: [v](使)慢下来,放松,松懈; [a]/ˈslækən/; [or]sat;
browbeat: [v]恫吓,吓唬;欺侮; [a]/ˈbraʊbiːt/; [or]sat;
depict: [v]描绘,描写; [a]/dɪˈpɪkt/; [or]sat;
circumspect: [adj]慎重的,仔细的; [a]/ˈsɜːrkəmspekt/; [or]sat;
erotic: [adj]性爱的,性欲的,色情的; [n]好色之徒; [adv]引起性欲地; [a]/ɪˈrɑːtɪk/; [or]sat;
flamboyant: [adj]辉耀的;华丽的,艳丽的;火焰似的; [a]/flæmˈbɔɪənt/; [or]sat;
saga: [n]传奇故事;冒险故事;一连串的事件(或经历); [a]/ˈsɑːɡə/; [or]sat;
parable: [n]寓言,比喻; [a]/ˈpærəbl/; [or]sat;
implication: [n]暗示;含意;牵连;卷入;可能的后果; [a]/ˌɪmplɪˈkeɪʃn/; [or]sat;
addiction: [n]沉溺,上瘾; [a]/əˈdɪkʃn/; [or]sat;
membrane: [n]膜;薄膜;羊皮纸; [a]/ˈmembreɪn/; [or]sat;
perceptive: [adj]感知的,知觉的;有知觉力的; [a]/pərˈseptɪv/; [or]sat;
illusion: [n]假象,幻象;幻想;错误观念; [a]/ɪˈluːʒn/; [or]sat;
ordeal: [n]严峻考验,苦难的经历,折磨; [a]/ɔːrˈdiːl/; [or]sat;
colossal: [adj]巨像(似)的;巨大的,庞大的; [a]/kəˈlɑːsl/; [or]sat;
avocation: [n]业余爱好;副业;嗜好; [a]/ˌævoʊˈkeɪʃn/; [or]sat;
absorb: [vt]吸收;汲取;吸引..的注意;理解,掌握;承受; [a]/əbˈzɔːrb/; [or]sat;
somnambulist: [n]梦游症患者; [a]/sɑːmˈnæmbjəlɪst/; [or]sat;
rave: [n]热切赞扬,喧闹的宴会;胡言乱语; [v]咆哮;胡言乱语;语无伦次地说; [adj]赞扬的; [a]/reɪv/; [or]sat;
superfluous: [adj]多余的,过剩的;不必要的; [a]/suːˈpɜːrfluəs/; [or]sat;
embezzlement: [n]贪污;侵占;挪用; [a]/ɪmˈbezlmənt/; [or]sat;
facsimile: [n]复制本,摹本; [adj]复制的; [v]传真;临摹; [a]/fækˈsɪməli/; [or]sat;
somber: [adj]忧郁的;昏暗的,阴天的; [a]/'sɒmbə/; [or]sat;
decorum: [n]礼节,礼貌,端庄,正派; [a]/dɪˈkɔːrəm/; [or]sat;
scapegoat: [n]替罪羊; [a]/ˈskeɪpɡoʊt/; [or]sat;
arduous: [adj]艰巨的;努力的;陡峭的; [a]/ˈɑːrdʒuəs/; [or]sat;
comely: [adj]动人的,美丽的; [a]/ˈkʌmli/; [or]sat;
patrician: [n]贵族; [adj]贵族的;显贵的;(相貌等)贵族似的; [a]/pəˈtrɪʃn/; [or]sat;
dawdle: [v]闲荡,浪费时间; [a]/ˈdɔːdl/; [or]sat;
treatise: [n]论述;论文;专著; [a]/ˈtriːtɪs/; [or]sat;
dormant: [adj]睡眠的,休眠的;静止的,隐伏的; [a]/ˈdɔːrmənt/; [or]sat;
noncommittal: [adj]态度不明朗的;不承担义务的;无明确意义的; [a]/ˌnɒnkə'mɪtəl/; [or]sat;
irascible: [adj]易怒的,性情暴躁的; [a]/ɪˈræsəbl/; [or]sat;
amulet: [n]护身符; [a]/ˈæmjʊlət/; [or]sat;
reprehensible: [adj]应受谴责的; [a]/ˌreprɪˈhensəbl/; [or]sat;
incubate: [v]孵卵; [a]/ˈɪŋkjubeɪt/; [or]sat;
porous: [adj]可渗透的,多孔的,可穿越的; [a]/ˈpɔːrəs/; [or]sat;
causal: [adj]因果关系的,有原因的; [n]表示原因的连词; [a]/ˈkɔːzl/; [or]sat;
conversant: [adj]熟悉的;精通的;亲近的; [a]/kənˈvɜːrsnt/; [or]sat;
artisan: [n]工匠,手艺人; [a]/ˈɑːrtəzn/; [or]sat;
mercurial: [adj](情绪)善变的; [a]/mɜːrˈkjʊriəl/; [or]sat;
pontifical: [adj]罗马教宗的,主教的; [a]/pɑːnˈtɪfɪkl/; [or]sat;
propensity: [n]嗜好,习性;倾向; [a]/prəˈpensəti/; [or]sat;
sordid: [adj]卑鄙的,肮脏的,色彩死气沉沉暗淡的; [a]/ˈsɔːrdɪd/; [or]sat;
preternatural: [adj]超自然的;不可思议的; [a]/ˌpriːtərˈnætʃrəl/; [or]sat;
filament: [n]灯丝,细丝; [a]/ˈfɪləmənt/; [or]sat;
prosaic: [adj]平凡的,乏味的,散文体的; [a]/prəˈzeɪɪk/; [or]sat;
intuition: [n]直觉;感觉; [a]/ˌɪntuˈɪʃn/; [or]sat;
aria: [n]独唱曲,咏叹调; [a]/ˈɑːriə/; [or]sat;
chary: [adj]小心的,谨慎的; [a]/ˈtʃeri/; [or]sat;
infantile: [adj]婴儿的,幼稚的,初期的; [a]/ˈɪnfəntaɪl/; [or]sat;
ancestry: [n]祖先;血统; [a]/ˈænsestri/; [or]sat;
ironic: [adj]讽刺的; [a]/aɪˈrɑːnɪk/; [or]sat;
wither: [v]枯萎;凋谢; [vt]使枯萎,使凋谢,萎缩;使人感觉羞惭或迷惑; [a]/ˈwɪðər/; [or]sat;
opiate: [n]鸦片制剂,麻醉剂,镇静剂; [adj]含鸦片的,安眠的; [v]用鸦片麻醉,使缓和; [a]/ˈoʊpiət/; [or]sat;
hardy: [adj](植物)耐寒的;能吃苦耐劳的;勇敢的; [n]强壮的人; [a]/ˈhɑːrdi/; [or]sat;
maudlin: [adj]感情脆弱的;容易流泪的;酒后伤感的; [a]/ˈmɔːdlɪn/; [or]sat;
therapeutic: [adj]治疗的;治疗学的;有益于健康的; [n]治疗剂;治疗学家; [a]/ˌθerəˈpjuːtɪk/; [or]sat;
nomadic: [adj]游牧的;流浪的;游动的; [a]/noʊˈmædɪk/; [or]sat;
smolder: [v]无火焰地闷烧,(仇恨,嫉妒,愤怒等)在心里郁积; [n]焖烧,文火,冒烟; [a]/ˈsmoʊldər/; [or]sat;
elated: [adj]得意洋洋的;振奋的; [a]/iˈleɪtɪd/; [or]sat;
portend: [v]预兆,预示; [a]/pɔːrˈtend/; [or]sat;
defunct: [adj]已故的,不复存在的;不再使用的; [a]/dɪˈfʌŋkt/; [or]sat;
heresy: [n]异端邪说;异教; [a]/ˈherəsi/; [or]sat;
halting: [adj]犹豫的,蹒跚的,迟缓的; [v]停止;蹒跚,犹豫; [a]/ˈhɔːltɪŋ/; [or]sat;
breadth: [n]宽度;广度; [a]/bredθ/; [or]sat;
correlation: [n]相互关系,相关(性); [a]/ˌkɔːrəˈleɪʃn/; [or]sat;
rote: [n]死记硬背,机械的做法,生搬硬套; [a]/roʊt/; [or]sat;
disconsolate: [adj]郁郁不乐的,孤独的,前途黯淡的; [a]/dɪsˈkɑːnsələt/; [or]sat;
brevity: [n]简短,短小,精炼; [a]/ˈbrevəti/; [or]sat;
bumptious: [adj]专横傲慢的,自以为是的; [a]/ˈbʌmpʃəs/; [or]sat;
belated: [adj]迟来的;误期的; [a]/bɪˈleɪtɪd/; [or]sat;
ingenious: [adj]聪明的;有发明天才的;有独创性的,别出心裁的; [a]/ɪnˈdʒiːniəs/; [or]sat;
stalemate: [n]和棋局面,僵局; [v]使陷入僵局; [a]/ˈsteɪlmeɪt/; [or]sat;
strident: [adj]尖声的,刺耳的; [a]/ˈstraɪdnt/; [or]sat;
depreciate: [v]贬低,轻视;贬值;折旧; [a]/dɪˈpriːʃieɪt/; [or]sat;
arbiter: [n][法]仲裁者;裁决人; [a]/ˈɑːrbɪtər/; [or]sat;
annuity: [n]年金,养老金;年金保险;年金享受权; [a]/əˈnuːəti/; [or]sat;
mesmerize: [v]施催眠术;吸引,使神魂颠倒; [a]/ˈmezməraɪz/; [or]sat;
foolhardy: [adj]莽撞的,有勇无谋的; [a]/ˈfuːlhɑːrdi/; [or]sat;
marquee: [n]选取框;大天幕;华盖; [adj]〈美〉最重要的; [a]/mɑːrˈkiː/; [or]sat;
dupe: [n]受骗的人,上当者; [v]欺骗,愚弄; [a]/duːp/; [or]sat;
solvent: [adj]有偿付能力的;有溶解力的; [n]溶剂;解决方法; [a]/ˈsɑːlvənt/; [or]sat;
subliminal: [adj]潜意识的,下意识的; [a]/ˌsʌbˈlɪmɪnl/; [or]sat;
extort: [vt]敲诈,勒索; [a]/ɪkˈstɔːrt/; [or]sat;
antiseptic: [n]杀菌剂; [adj]防腐的,抗菌的; [a]/ˌæntiˈseptɪk/; [or]sat;
incapacitate: [v]使不能;使瘫痪;使无能力;使不适合; [a]/ˌɪnkəˈpæsɪteɪt/; [or]sat;
terrestrial: [adj]地球的,陆地的; [n]陆地生物;地球上的人; [a]/təˈrestriəl/; [or]sat;
cognate: [adj]同词源的,同类的; [a]/ˈkɑːɡneɪt/; [or]sat;
analogous: [adj]类似的,可比拟的;[昆]同功的; [a]/əˈnæləɡəs/; [or]sat;
nettle: [v]刺激;惹恼;用荨麻刺; [n]荨麻; [a]/ˈnetl/; [or]sat;
malleable: [adj](金属)可锻的;有延展性的;(性格)可训练的;易适应的; [a]/ˈmæliəbl/; [or]sat;
prod: [n]刺针;刺棒;签子; [v]刺;戳;刺激; [a]/prɑːd/; [or]sat;
garner: [v]收藏,积累,储存; [n]积蓄,积累物; [a]/ˈɡɑːrnər/; [or]sat;
sluggish: [adj]行动迟缓的,迟钝的;偷懒的; [a]/ˈslʌɡɪʃ/; [or]sat;
bemoan: [v]哀悼;为..恸哭;哀叹,对..表示惋惜; [a]/bɪˈmoʊn/; [or]sat;
fleck: [n]斑点,斑纹;雀斑;微粒,小片; [v]使起斑点;使有斑纹; [a]/flek/; [or]sat;
immune: [adj]免疫的,有免疫力的;不受影响的;免除的; [a]/ɪˈmjuːn/; [or]sat;
piecemeal: [n]片;块; [v]粉碎; [adv]零碎地;逐个地; [adj]零碎的;逐渐的; [a]/ˈpiːsmiːl/; [or]sat;
collate: [v]核对,校对;校勘; [a]/kəˈleɪt/; [or]sat;
rife: [adj]普遍的;流行的; [a]/raɪf/; [or]sat;
fabricate: [v]建造,制造,伪造(文件等),捏造,编造(谎言,借口等); [a]/ˈfæbrɪkeɪt/; [or]sat;
provoke: [v]激怒;对.挑衅;引起; [a]/prəˈvoʊk/; [or]sat;
offensive: [adj]冒犯的,进攻的,无礼的,令人不快的,得罪人的; [n]进攻; [a]/əˈfensɪv/; [or]sat;
gourmet: [n]美食家,讲究吃喝的人; [adj]菜肴精美的; [a]/ˈɡʊrmeɪ/; [or]sat;
ornithology: [n]鸟类学;鸟学论文; [a]/ˌɔːrnɪˈθɑːlədʒi/; [or]sat;
evince: [v]表明,表示,引起; [a]/ɪˈvɪns/; [or]sat;
rudimentary: [adj]基本的,初期的;发育不完全的;退化的; [a]/ˌruːdɪˈmentri/; [or]sat;
Utopia: [n]乌托邦(理想中最美好的社会),理想国; [a]/juːˈtoʊpiə/; [or]sat;
glossy: [adj]光泽的,光滑的; [a]/ˈɡlɑːsi/; [or]sat;
caulk: [v]填隙使不渗水,捻缝,凿密; [n]捻缝材料,填料; [a]/kɔːk/; [or]sat;
chronic: [adj](疾病)慢性的;长期的;(人)久病的;积习难改的;严重的; [a]/ˈkrɑːnɪk/; [or]sat;
finicky: [adj]苛求的,过份讲究的; [a]/ˈfɪnɪki/; [or]sat;
torpor: [n]麻木;无感觉;不活泼; [a]/ˈtɔːrpər/; [or]sat;
accolade: [n]同意,赞赏; [v]赞扬; [a]/ˈækəleɪd/; [or]sat;
archaeology: [n]考古学; [a]/ˌɑːrkiˈɑːlədʒi/; [or]sat;
dogged: [adj]顽强的;顽固的; [vt]跟踪;尾随; [a]/ˈdɔːɡɪd/; [or]sat;
implement: [n]工具;器具; [v]实施,执行;执行; [a]/ˈɪmplɪment/; [or]sat;
riveting: [adj]非常精彩的; [n]铆接(法; [a]/ˈrɪvɪtɪŋ/; [or]sat;
grate: [n]壁炉;格栅; [v]磨碎,使人烦燥; [a]/ɡreɪt/; [or]sat;
obstinate: [adj]顽固的;较难治愈的; [a]/ˈɑːbstɪnət/; [or]sat;
franchise: [n]特许(经营权),公民权,选举权; [v]赋予特权,赋予公民权; [a]/ˈfræntʃaɪz/; [or]sat;
flora: [n]植物群; [a]/ˈflɔːrə/; [or]sat;
perjury: [n]伪证,假誓; [a]/ˈpɜːrdʒəri/; [or]sat;
rancor: [n]深仇,怨恨; [a]/ˈræŋkər/; [or]sat;
marital: [adj]婚姻的; [a]/ˈmærɪtl/; [or]sat;
toady: [n]谄媚者,拍马屁的人; [v]谄媚,拍马屁; [a]/ˈtoʊdi/; [or]sat;
chafe: [v]擦破;擦热;擦痛;激怒; [n]急躁;摩擦,擦伤;(防止擦伤马的)马鞍环套皮; [a]/tʃeɪf/; [or]sat;
excise: [v]切除,删去; [n]消费税,货物税,国产税; [a]/ˈeksaɪz/; [or]sat;
admonish: [v]训诫,警告; [a]/ədˈmɑːnɪʃ/; [or]sat;
beneficiary: [n][金融]受益人,受惠者;封臣; [adj]拥有封地的;受圣俸的; [a]/ˌbenɪˈfɪʃieri/; [or]sat;
prodigal: [adj]挥霍的,十分慷慨的; [n]浪子,挥霍者; [a]/ˈprɑːdɪɡl/; [or]sat;
accretion: [n]自然的增加,增加物; [a]/əˈkriːʃn/; [or]sat;
quagmire: [n]沼泽地,困境; [a]/ˈkwæɡmaɪər/; [or]sat;
endemic: [adj]地方性的; [n]地方病; [a]/enˈdemɪk/; [or]sat;
rostrum: [n]讲坛,讲台; [a]/ˈrɑːstrəm/; [or]sat;
commensurate: [adj]相称的,相应的;同量的;同样大小的; [a]/kəˈmenʃərət/; [or]sat;
agitate: [v](尤指为法律,社会状况的改变而)激烈争论,鼓动,煽动;搅动(液体);激怒; [a]/ˈædʒɪteɪt/; [or]sat;
prestige: [n]威望,声望; [a]/preˈstiːʒ/; [or]sat;
draconian: [adj]严峻的,苛刻的; [a]/drəˈkoʊniən/; [or]sat;
inclined: [adj]倾向..的,有..意向的;斜着的; [a]/ɪnˈklaɪnd/; [or]sat;
deciduous: [adj]落叶性的,脱落性的;非永久性的; [a]/dɪˈsɪdʒuəs/; [or]sat;
deface: [v]损伤外观,丑化; [a]/dɪˈfeɪs/; [or]sat;
aperture: [n]孔,穴;(照相机,望远镜等的)光圈,孔径;缝隙; [a]/ˈæpərtʃər/; [or]sat;
appellation: [n]称呼,名称,名目; [a]/ˌæpəˈleɪʃn/; [or]sat;
convoke: [v]召集会议; [a]/kənˈvoʊk/; [or]sat;
cavil: [v]吹毛求疵,挑剔,无端指摘;挑毛病,无端抱怨; [n]吹毛求疵,苛责,无端的指责; [a]/ˈkævl/; [or]sat;
unprecedented: [adj]前所未有的,空前的,无前例的; [a]/ʌnˈpresɪdentɪd/; [or]sat;
replicate: [v]复制;重复,反复; [a]/ˈreplɪkeɪt/; [or]sat;
satire: [n]讽刺(作品); [a]/ˈsætaɪər/; [or]sat;
misapprehension: [n]错误的理解,错误的判断; [a]/ˌmɪsæprɪˈhenʃn/; [or]sat;
emollient: [n]润肤剂; [a]/iˈmɑːliənt/; [or]sat;
caricature: [n]讽刺画,滑稽模仿;扭曲,夸张的描述; [a]/ˈkærɪkətʃər/; [or]sat;
approbation: [n]称赞,认可;批准; [a]/ˌæprəˈbeɪʃn/; [or]sat;
random: [adj]随机的;任意的;胡乱的; [a]/ˈrændəm/; [or]sat;
miserly: [adj]贪财的,吝啬的; [a]/ˈmaɪzərli/; [or]sat;
subsidiary: [adj]辅助的,次要的,附属的; [n]子公司,附属机构; [a]/səbˈsɪdieri/; [or]sat;
trinket: [n]小装饰品,不值钱的珠宝; [a]/ˈtrɪŋkɪt/; [or]sat;
irreparable: [adj]不能修复的;不可弥补的; [a]/ɪˈrepərəbl/; [or]sat;
unbridled: [adj]无拘束的;激烈的;放纵的;放纵的,无约束的; [a]/ʌnˈbraɪdld/; [or]sat;
wrench: [n]扳手;痛苦,难受;猛扭,猛拉; [v]猛拧;挣脱;使扭伤; [a]/rentʃ/; [or]sat;
intimate: [adj]亲密的,密切的;详细的; [v]暗示;宣布,通知; [n]密友,知己; [a]/ˈɪntɪmət/; [or]sat;
nauseate: [v]使作呕,产生恶感; [a]/ˈnɔːzieɪt/; [or]sat;
retain: [v]保持,保留,保存;聘请; [a]/rɪˈteɪn/; [or]sat;
dehydrate: [v]除去水份,脱水; [a]/diːˈhaɪdreɪt/; [or]sat;
lap: [n]腰以下及大腿的前面部分;(跑道的)一圈; [v](赛跑中)比(某人)领先一圈;轻拍; [a]/læp/; [or]sat;
anoint: [v]神圣化; [a]/əˈnɔɪnt/; [or]sat;
patriarch: [n]家长;族长;创办人;最年长者; [a]/ˈpeɪtriɑːrk/; [or]sat;
detergent: [n]洗涤剂,清洁剂; [a]/dɪˈtɜːrdʒənt/; [or]sat;
levity: [n]轻率,轻浮,多变,不稳定; [a]/ˈlevəti/; [or]sat;
unwieldy: [adj]使用不便的,不灵巧的,难处理的;笨重的; [a]/ʌnˈwiːldi/; [or]sat;
libretto: [n]歌词,歌剧剧本,剧本,歌词集; [a]/lɪˈbretoʊ/; [or]sat;
adherent: [n]拥护者;党徒;提倡者; [a]/ədˈhɪrənt/; [or]sat;
petrify: [v]石化,使僵化,使惊呆; [a]/ˈpetrɪfaɪ/; [or]sat;
polygamist: [n]多配偶的人;多配偶论者; [a]/pəˈlɪɡəmɪst/; [or]sat;
dissident: [n]唱反调者;持不同政见者,意见不同的人; [adj]持不同政见的,意见不同的; [a]/ˈdɪsɪdənt/; [or]sat;
renounce: [vt]宣布放弃,与...断绝关系;抛弃; [vi]垫牌; [n]垫牌; [a]/rɪˈnaʊns/; [or]sat;
querulous: [adj]抱怨的,挑剔的; [a]/ˈkwerələs/; [or]sat;
sententious: [adj]好说教的,简要的,警句的; [a]/senˈtenʃəs/; [or]sat;
imbibe: [v]喝,饮;吸收,接受; [a]/ɪmˈbaɪb/; [or]sat;
acme: [n]顶点,极点; [a]/ˈækmi/; [or]sat;
increment: [n]增长;增值; [a]/ˈɪŋkrəmənt/; [or]sat;
revile: [v]辱骂,诽谤,批判; [a]/rɪˈvaɪl/; [or]sat;
respite: [n]缓解;暂缓;暂时的休息;缓期执行; [v]使缓解;使暂缓;使延期;缓期执行; [a]/ˈrespɪt/; [or]sat;
inimical: [adj]敌意的,有害的; [a]/ɪˈnɪmɪkl/; [or]sat;
atrocity: [n]残暴,暴行; [a]/əˈtrɑːsəti/; [or]sat;
pillage: [n]掠夺;掠夺物; [vt]掠夺,抢劫; [a]/ˈpɪlɪdʒ/; [or]sat;
mite: [n]极小量,小虫; [a]/maɪt/; [or]sat;
puerile: [adj]幼稚的,孩子气的; [a]/ˈpjʊrəl/; [or]sat;
ramshackle: [adj]摇摇欲坠的; [a]/ˈræmʃækl/; [or]sat;
vortex: [n]旋涡,气旋;涡流; [a]/ˈvɔːrteks/; [or]sat;
boundless: [adj]无限的;无边无际的; [a]/ˈbaʊndləs/; [or]sat;
outlandish: [adj]稀奇古怪的,奇特的;异国风情的; [a]/aʊtˈlændɪʃ/; [or]sat;
orthodox: [adj]正统的;传统的;(Orthodox)东正教的; [a]/ˈɔːrθədɑːks/; [or]sat;
fledgling: [n]刚学飞的幼鸟,无经验的人; [adj]刚开始的;无经验的; [a]/ˈfledʒlɪŋ/; [or]sat;
subterfuge: [n]托词,借口,诡计; [a]/ˈsʌbtərfjuːdʒ/; [or]sat;
shambles: [n]混乱,废墟,屠宰场; [v]蹒跚而行,拖着脚走,踉跄地走; [a]/ˈʃæmblz/; [or]sat;
dappled: [adj]有斑点的,斑驳的; [a]/ˈdæpld/; [or]sat;
recumbent: [adj]斜倚的;休息的; [n]〈口〉座位斜靠式自行车; [a]/rɪˈkʌmbənt/; [or]sat;
aviary: [n]鸟类饲养场,大型鸟舍; [a]/ˈeɪvieri/; [or]sat;
conception: [n]怀孕,构想,设想,思想,观念; [a]/kənˈsepʃn/; [or]sat;
presentiment: [n]不祥的预感; [a]/prɪˈzentɪmənt/; [or]sat;
shackle: [n]枷锁,羁绊(物); [v]给..上手铐(脚镣),用钩链连结,束缚; [a]/ˈʃækl/; [or]sat;
pejorative: [n]轻蔑语; [adj]带有轻蔑意义的,贬低的; [a]/pɪˈdʒɔːrətɪv/; [or]sat;
compensatory: [adj]补偿的,赔偿的; [a]/kəmˈpensətɔːri/; [or]sat;
nondescript: [adj]没有特征的,难以形容的,难以归类的; [n]难以名状,不属任何型类的人; [a]/ˈnɑːndɪskrɪpt/; [or]sat;
stigma: [n][植]柱头,耻辱,污名,烙印,特征; [a]/ˈstɪɡmə/; [or]sat;
theoretical: [adj]理论(上)的; [a]/ˌθiːəˈretɪkl/; [or]sat;
unkempt: [adj](衣服,头发)不整洁的;蓬乱的; [a]/ˌʌnˈkempt/; [or]sat;
prompt: [v]提示;激起;促进,推动;敦促; [adj]迅速的,及时的; [n]提示; [a]/prɑːmpt/; [or]sat;
stanza: [n]诗节; [a]/ˈstænzə/; [or]sat;
surly: [adj]乖戾的;无礼的;阴沉的; [a]/ˈsɜːrli/; [or]sat;
pandemic: [adj]全国流行的;普遍的; [a]/pænˈdemɪk/; [or]sat;
mandate: [n]授权;命令,指令;委托管理;受命进行的工作; [v]授权;托管; [a]/ˈmændeɪt/; [or]sat;
alcove: [n]凹室,壁龛; [a]/ˈælkoʊv/; [or]sat;
perennial: [adj]终年的,永久的;四季不断的;反复的; [n]多年生植物; [a]/pəˈreniəl/; [or]sat;
skeptic: [n]怀疑论者;怀疑者;无神论者; [a]/ˈskeptɪk/; [or]sat;
pedestrian: [n]步行者,行人; [adj]步行的;平庸无奇的,无聊的; [a]/pəˈdestriən/; [or]sat;
deterrent: [n]威慑物; [v]威慑的; [a]/dɪˈtɜːrənt/; [or]sat;
fracas: [n]喧嚷,吵闹,争论,论战; [a]/ˈfreɪkəs/; [or]sat;
extent: [n]范围;程度;宽度;长度; [a]/ɪkˈstent/; [or]sat;
detonation: [n]爆炸;爆炸声;爆发; [a]/ˌdetəˈneɪʃn/; [or]sat;
transition: [n]转变,过渡时期; [v](从某一状态或活动)转变,过渡(到另一状态或活动); [a]/trænˈzɪʃn/; [or]sat;
dossier: [n]档案,卷宗;病历表册; [a]/ˈdɔːsieɪ/; [or]sat;
hoax: [n]骗局;恶作剧; [vt]愚弄;欺骗; [a]/hoʊks/; [or]sat;
oblique: [adj]斜的,非直角的,隐射的; [v]倾斜; [n][解]斜肌(尤指腹部的肌肉);倾斜物;[军]倾斜航空照片; [adv][军]以45度角; [a]/əˈbliːk/; [or]sat;
virtuoso: [n]艺术品鉴赏家,古董收藏家,艺术大师; [adj]行家里手的,艺术爱好者的; [a]/ˌvɜːrtʃuˈoʊsoʊ/; [or]sat;
autopsy: [n]验尸;[病理][特医]剖检; [a]/ˈɔːtɑːpsi/; [or]sat;
impermeable: [adj]不渗透的;(水等)不能渗透的; [a]/ɪmˈpɜːrmiəbl/; [or]sat;
stifle: [v]抑制,压制,使窒息; [a]/ˈstaɪfl/; [or]sat;
belie: [vt]与.不符;矛盾,误解; [a]/bɪˈlaɪ/; [or]sat;
aghast: [adj]惊骇的,吓呆的; [a]/əˈɡæst/; [or]sat;
quail: [n]鹌鹑; [v]畏缩;感到恐惧; [a]/kweɪl/; [or]sat;
thespian: [adj]悲剧的;戏剧的; [n]演员;悲剧演员; [a]/ˈθespiən/; [or]sat;
promiscuous: [adj]滥交的,杂乱的,混杂的; [a]/prəˈmɪskjuəs/; [or]sat;
burnish: [v]擦亮,磨光; [a]/ˈbɜːrnɪʃ/; [or]sat;
windfall: [n]风吹落果;意外的收获,意外幸运; [a]/ˈwɪndfɔːl/; [or]sat;
sojourn: [n]逗留,旅居; [vi]逗留,旅居; [a]/ˈsoʊdʒɜːrn/; [or]sat;
bucolic: [adj]乡村的;牧羊的; [a]/bjuːˈkɑːlɪk/; [or]sat;
facade: [n]建筑物的正面,外表; [a]/fəˈsɑːd/; [or]sat;
pittance: [n]微薄的收入,小额津贴,少量; [a]/ˈpɪtns/; [or]sat;
withdrawn: [adj]孤独的,孤僻的,内向的,离群的,沉默寡言的; [a]/wɪðˈdrɔːn/; [or]sat;
diversion: [n]绕行路;转移,改变方向;分心,消遣;分水渠; [a]/daɪˈvɜːrʒn/; [or]sat;
industrious: [adj]勤劳的,勤奋的; [a]/ɪnˈdʌstriəs/; [or]sat;
odious: [adj]可憎的,讨厌的; [adv]令人作呕地; [n]可憎,讨厌; [a]/ˈoʊdiəs/; [or]sat;
horde: [n]一大群,群,游牧部落; [v]成群;结成部落而居; [a]/hɔːrd/; [or]sat;
ignominy: [n]耻辱,不体面,丑行; [a]/ˈɪɡnəmɪni/; [or]sat;
filibuster: [n]冗长演说; [v]拖延议事; [a]/ˈfɪlɪbʌstər/; [or]sat;
impeach: [v]指摘,弹劾; [a]/ɪmˈpiːtʃ/; [or]sat;
vicissitude: [n]变迁,沧桑,兴衰; [a]/vɪˈsɪsɪtuːd/; [or]sat;
magnitude: [n]巨大;震级;重要性;[数]量值; [a]/ˈmæɡnɪtuːd/; [or]sat;
repellent: [adj]令人厌恶的; [n]消肿药,驱虫剂; [a]/rɪˈpelənt/; [or]sat;
vie: [v]竞争;使针锋相对;以..作较量; [a]/vaɪ/; [or]sat;
substantiate: [v]证实;使实体化; [a]/səbˈstænʃieɪt/; [or]sat;
restive: [adj]不耐烦的,焦躁不安的,倔强的; [a]/ˈrestɪv/; [or]sat;
virulent: [adj]剧毒的;恶性的;有恶意的; [a]/ˈvɪrələnt/; [or]sat;
peerless: [adj]无与伦比的;无可匹敌的; [a]/ˈpɪrləs/; [or]sat;
venal: [adj]唯利是图的;贪赃枉法; [a]/ˈviːnl/; [or]sat;
indentation: [n]空格,缩进;呈锯齿形;海岸线凹入处; [a]/ˌɪndenˈteɪʃn/; [or]sat;
prate: [v]大谈特谈,唠叨; [n]唠叨,多嘴,无聊话; [a]/preɪt/; [or]sat;
genealogy: [n]宗谱,血统,家系,系谱学; [a]/ˌdʒiːniˈælədʒi/; [or]sat;
subsistence: [n]存在,生存;生活; [adj]收成仅够自身口粮的; [a]/səbˈsɪstəns/; [or]sat;
orator: [n]演说者,演讲者,雄辩家,原告; [a]/ˈɔːrətər/; [or]sat;
atlas: [n]地图集; [a]/ˈætləs/; [or]sat;
categorical: [adj]绝对的;直接了当的;无条件的;属于某一范畴的; [a]/ˌkætəˈɡɔːrɪkl/; [or]sat;
ascribe: [v]把.归因于;把.归属于; [a]/əˈskraɪb/; [or]sat;
avuncular: [adj]伯父的;叔伯的;慈祥的; [a]/əˈvʌŋkjələr/; [or]sat;
finesse: [n]技巧,计谋,策略; [v]以技巧取胜; [a]/fɪˈnes/; [or]sat;
shear: [vt]剪羊毛;剪头发; [n](复数)大剪刀; [a]/ʃɪr/; [or]sat;
subjugate: [v]征服,使服从; [a]/ˈsʌbdʒuɡeɪt/; [or]sat;
amend: [v]改进;修订;修正; [a]/əˈmend/; [or]sat;
volatile: [adj]易气化的;爆炸性的;反复无常的;短暂的;不稳定的; [a]/ˈvɑːlətl/; [or]sat;
garrulous: [adj]唠叨的,喋喋不休的;聒噪的; [a]/ˈɡærələs/; [or]sat;
temper: [n]脾气,性情;调和剂; [v]锻炼,缓和; [a]/ˈtempər/; [or]sat;
eloquence: [n]雄辩,口才;文采; [a]/ˈeləkwəns/; [or]sat;
auditory: [adj]听觉的; [a]/ˈɔːdətɔːri/; [or]sat;
bogus: [adj]假的,假装的; [n]伪币;冒牌货; [a]/ˈboʊɡəs/; [or]sat;
malaise: [n]不舒服;心神不安; [a]/məˈleɪz/; [or]sat;
magnanimous: [adj]宽宏大量的,大度的;慷慨的; [a]/mæɡˈnænɪməs/; [or]sat;
inchoate: [adj]早期的;刚开始的;未充分发展的; [a]/ɪnˈkoʊət/; [or]sat;
adamant: [adj]强硬的,固执的; [n]坚硬的东西;坚石; [a]/ˈædəmənt/; [or]sat;
voluble: [adj]健谈的,缠绕的,易旋转的; [a]/ˈvɑːljəbl/; [or]sat;
relinquish: [v]放弃,让出(权利,财产等),撤回; [a]/rɪˈlɪŋkwɪʃ/; [or]sat;
zenith: [n]顶点,顶峰;全盛; [a]/ˈziːnɪθ/; [or]sat;
abdicate: [adj]放弃权力的;退位的; [n]放弃权力者;退位者; [vi]退位,辞职; [vt]辞;放弃; [a]/ˈæbdɪkeɪt/; [or]sat;
temperate: [adj]温和的;适度的,有节制的; [a]/ˈtempərət/; [or]sat;
panoramic: [adj]全景的; [a]/ˌpænəˈræmɪk/; [or]sat;
multilingual: [n]懂多种语言的人; [adj]使用多种语言的,懂几国文字的; [a]/ˌmʌltiˈlɪŋɡwəl/; [or]sat;
aloof: [adj]远离的;冷漠的,冷淡的; [adv]远离,避开; [a]/əˈluːf/; [or]sat;
anonymity: [n]匿名,作者不明(或不详),无名之辈; [a]/ˌænəˈnɪməti/; [or]sat;
addle: [v]使腐坏,使昏乱; [adj]腐坏的;糊涂的,昏乱的; [a]/ˈædl/; [or]sat;
transparent: [adj]透明的,清澈的,明净的;易识破的,显而易见的; [a]/trænsˈpærənt/; [or]sat;
accessible: [adj]可使用的;可到达的;可进入的;易懂的; [a]/əkˈsesəbl/; [or]sat;
sardonic: [adj]讽刺的,嘲笑的; [a]/sɑːrˈdɑːnɪk/; [or]sat;
venom: [n]毒液;恶意;怨恨; [vt]使有毒;放毒; [a]/ˈvenəm/; [or]sat;
defer: [v]使推迟,使延期;听从,顺从; [vi]延期; [a]/dɪˈfɜːr/; [or]sat;
foil: [n]箔;锡箔纸;衬托; [v]挫败;使受挫折; [a]/fɔɪl/; [or]sat;
erode: [v]腐蚀;遭侵蚀,腐蚀,侵蚀;削弱; [vt]损害; [a]/ɪˈroʊd/; [or]sat;
engross: [v]独占;正式誊写;使全神贯注于;用大字体书写; [a]/ɪnˈɡroʊs/; [or]sat;
transient: [adj]短暂的,路过的;转瞬即逝的; [n]过客; [a]/ˈtrænʃnt/; [or]sat;
robust: [adj]健壮的,强壮的;精力充沛的;坚固的;粗鲁的; [a]/roʊˈbʌst/; [or]sat;
rift: [n]裂缝,裂口; [a]/rɪft/; [or]sat;
sham: [n]假货;虚假;欺诈; [v]假装; [adj]虚假的,假装的; [a]/ʃæm/; [or]sat;
oscillate: [v]摆动,犹豫; [a]/ˈɑːsɪleɪt/; [or]sat;
figment: [n]空想;虚构的理论,故事等; [a]/ˈfɪɡmənt/; [or]sat;
slake: [v]解渴,消渴; [a]/sleɪk/; [or]sat;
disconcert: [v]使仓皇失措;使困惑;破坏; [a]/ˌdɪskənˈsɜːrt/; [or]sat;
spatial: [adj]空间的,关于空间的; [a]/ˈspeɪʃl/; [or]sat;
extol: [v]赞美,称赞,颂扬; [a]/ɪkˈstoʊl/; [or]sat;
distend: [v]膨胀;胀大;扩张; [a]/dɪˈstend/; [or]sat;
mortician: [n]丧事承办人; [a]/mɔːrˈtɪʃn/; [or]sat;
virtual: [adj](计算机)虚拟的;十分接近的;实质上的; [a]/ˈvɜːrtʃuəl/; [or]sat;
intimacy: [n]亲密,亲近;亲昵行为;<婉>性行为;[婉辞]私通; [a]/ˈɪntɪməsi/; [or]sat;
monumental: [adj]纪念碑的;不朽的;非常的; [a]/ˌmɑːnjuˈmentl/; [or]sat;
sluggard: [n]懒鬼;游手好闲的人; [a]/ˈslʌɡərd/; [or]sat;
thermal: [adj]保暖的;温泉的;热的; [n]保暖内衣裤; [a]/ˈθɜːrml/; [or]sat;
improvident: [adj]浪费的,无远见的,无先见之明的; [a]/ɪmˈprɑːvɪdənt/; [or]sat;
repast: [n]宴;就餐; [vi]就餐,设宴; [a]/rɪˈpæst/; [or]sat;
dissuade: [v]劝阻,阻止; [a]/dɪˈsweɪd/; [or]sat;
ubiquitous: [adj]普遍存在的;无所不在的; [a]/juːˈbɪkwɪtəs/; [or]sat;
sibling: [n]兄弟姊妹;同胞;(生物)同科,同属; [a]/ˈsɪblɪŋ/; [or]sat;
clump: [n]土块; [v]丛生; [a]/klʌmp/; [or]sat;
exasperate: [vt]激怒;加剧; [a]/ɪɡˈzæspəreɪt/; [or]sat;
predicament: [n]困境,穷境,尴尬的处境; [a]/prɪˈdɪkəmənt/; [or]sat;
pandemonium: [n]地狱,混乱; [a]/ˌpændəˈmoʊniəm/; [or]sat;
inalienable: [adj]不可分割的; [a]/ɪnˈeɪliənəbl/; [or]sat;
esteem: [n]尊敬;尊重; [vt]尊敬;认为;考虑;估计; [a]/ɪˈstiːm/; [or]sat;
thrive: [v]茁壮成长;繁荣,兴旺; [a]/θraɪv/; [or]sat;
gaunt: [adj]憔悴的,瘦削的; [n]憔悴,荒凉; [a]/ɡɔːnt/; [or]sat;
buoyant: [adj]有浮力的;愉快的;(股市)保持高价的; [a]/ˈbɔɪənt/; [or]sat;
hermetic: [adj]密封的;与外界隔绝的;不透气的;炼金术的; [a]/hɜːrˈmetɪk/; [or]sat;
Titanic: [adj]巨人的,力大无比的; [n]泰坦尼克号; [a]/taɪˈtænɪk/; [or]sat;
analogy: [n]比拟,比喻;类比;相似;类似; [a]/əˈnælədʒi/; [or]sat;
ensconce: [v]安置;安顿下来;使.隐藏; [a]/ɪnˈskɑːns/; [or]sat;
rebuke: [v]指责; [n]谴责; [a]/rɪˈbjuːk/; [or]sat;
expertise: [n]专门知识,专门技能; [a]/ˌekspɜːrˈtiːz/; [or]sat;
untenable: [adj]防守不住的,站不住脚的; [a]/ʌnˈtenəbl/; [or]sat;
obviate: [v]排除,避免,消除; [a]/ˈɑːbvieɪt/; [or]sat;
brochure: [n]手册,小册子; [a]/broʊˈʃʊr/; [or]sat;
mutinous: [adj]加入叛变的,反抗的; [a]/ˈmjuːtənəs/; [or]sat;
totter: [n]蹒跚,踉跄; [vi]蹒跚,踉跄,动摇,摇摇欲坠; [a]/ˈtɑːtər/; [or]sat;
warble: [n]鸟啭鸣,颤声; [v]鸟鸣,用柔和的颤声唱; [a]/ˈwɔːrbl/; [or]sat;
apocalyptic: [adj]预示灾祸的,启示的; [a]/əˌpɑːkəˈlɪptɪk/; [or]sat;
arid: [adj](土地或气候)干燥的,干旱的,贫瘠的,荒芜的;无创见的,无新意的; [a]/ˈærɪd/; [or]sat;
incipient: [adj]初期的;刚出现的; [a]/ɪnˈsɪpiənt/; [or]sat;
exhort: [vt]敦促,劝告; [vi]规劝,劝告; [a]/ɪɡˈzɔːrt/; [or]sat;
infuriate: [v]使(人)极为愤怒; [a]/ɪnˈfjʊrieɪt/; [or]sat;
veer: [n]方向的转变; [v]转向,改变(话题等),放松(绳,缆等); [a]/vɪr/; [or]sat;
regimen: [n]养生法,生活规则; [a]/ˈredʒɪmən/; [or]sat;
informal: [adj]非正式的;不拘礼节的;通俗的; [a]/ɪnˈfɔːrml/; [or]sat;
caustic: [adj]腐蚀性的;苛性的;刻薄的;焦散的; [n]腐蚀剂;苛性钠;焦散曲线; [a]/ˈkɔːstɪk/; [or]sat;
prerogative: [n]权利;特权; [a]/prɪˈrɑːɡətɪv/; [or]sat;
furor: [n]狂热;激怒;喧闹;感动; [a]/ˈfjʊˌrɔr/; [or]sat;
monastic: [n]僧侣; [adj]修道院的,寺院的;僧侣的;克己的; [a]/məˈnæstɪk/; [or]sat;
minuscule: [adj]极小的,微型的; [a]/ˈmɪnəskjuːl/; [or]sat;
distill: [v]抽出..的精华;蒸馏; [a]/dɪˈstɪl/; [or]sat;
dross: [n]废料,浮渣,渣滓; [vt]除去.上的浮渣; [a]/drɔːs/; [or]sat;
plasticity: [n]可塑性;适应性;柔软性; [a]/plæˈstɪsəti/; [or]sat;
defile: [v]污损,弄脏;以纵队前进; [n]狭谷;隘路; [a]/dɪˈfaɪl/; [or]sat;
partisan: [adj]党派的;效忠的;偏袒的;盲目推崇的; [n]党羽;虔诚信徒;游击队; [a]/ˈpɑːrtəzn/; [or]sat;
arousal: [n]觉醒,激励,唤起; [a]/əˈraʊzl/; [or]sat;
inert: [adj]不动的,惰性的;行动迟钝的;无生气的; [a]/ɪˈnɜːrt/; [or]sat;
optimum: [adj]最适宜的;最佳的; [n]最适条件;最适宜; [a]/ˈɑːptɪməm/; [or]sat;
tome: [n]册,卷,本,大本书; [a]/toʊm/; [or]sat;
bacchanalian: [adj]狂欢的,行为放纵的; [a]/ˌbækəˈneɪliən/; [or]sat;
heed: [vt]注意;留心; [v]注意; [vi]留心; [n]注意;留心; [a]/hiːd/; [or]sat;
wan: [adj]虚弱的,病态的; [a]/wɑːn/; [or]sat;
disengage: [v]分开; [a]/ˌdɪsɪnˈɡeɪdʒ/; [or]sat;
assiduous: [adj]勤勉的,刻苦的; [a]/əˈsɪdʒuəs/; [or]sat;
plagiarize: [v]剽窃,抄袭(别人学说,著作); [a]/ˈpleɪdʒəraɪz/; [or]sat;
polarize: [v](使)极化,(使)偏振,(使)两极分化; [a]/ˈpoʊləraɪz/; [or]sat;
wean: [v]断奶,戒掉(off/from),(从早年开始)使用; [n]〈英〉婴儿;小儿; [a]/wiːn/; [or]sat;
perquisite: [n]固定津贴,福利; [a]/ˈpɜːrkwɪzɪt/; [or]sat;
ghastly: [adj]苍白的,可怕的,令人不快的; [adv]恐怖地,惨白地; [a]/ˈɡæstli/; [or]sat;
pellucid: [adj]透明的,清晰的,明了的; [a]/pəˈluːsɪd/; [or]sat;
concise: [adj]简明的,简要的;简洁的,简要的; [a]/kənˈsaɪs/; [or]sat;
novice: [n]生手,新手; [a]/ˈnɑːvɪs/; [or]sat;
jaunt: [v]远足;做短程游览; [n]短途游览; [a]/dʒɔːnt/; [or]sat;
variegated: [n]使富有变化,使成为杂色; [adj]斑驳的,多色的,富于变化的; [a]/ˈverɪɡeɪtɪd/; [or]sat;
epoch: [n]时期;新时代; [a]/ˈepək/; [or]sat;
cynical: [adj]愤世嫉俗的;恶意的;悲观的; [a]/ˈsɪnɪkl/; [or]sat;
attenuate: [v]变薄,变弱,变纤细; [adj]稀薄的;细小的;减弱的;减少的; [a]/əˈtenjueɪt/; [or]sat;
plummet: [v]垂直或突然地堕下,骤然下降; [n]测锤(钓丝的)坠子;线锤;铅锤线;锤规; [a]/ˈplʌmɪt/; [or]sat;
levitate: [v](使)轻轻浮起,(使)飘浮空中; [a]/ˈlevɪteɪt/; [or]sat;
vogue: [n]时髦,时尚; [adj]流行的; [a]/voʊɡ/; [or]sat;
incandescent: [adj]白热的,热烈的; [a]/ˌɪnkænˈdesnt/; [or]sat;
glutton: [n]贪吃者,对..贪婪的人; [a]/ˈɡlʌtn/; [or]sat;
gravity: [n]重力,引力;严重性;庄重,严肃; [a]/ˈɡrævəti/; [or]sat;
unravel: [v]解开;拆开;阐明;解释; [a]/ʌnˈrævl/; [or]sat;
renege: [v]食言,否认; [a]/rɪˈniːɡ/; [or]sat;
solicitous: [adj]热切期望的;热心的;挂念的; [a]/səˈlɪsɪtəs/; [or]sat;
cavalier: [n]骑士,武士; [adj]满不在乎的,无忧无虑的,漫不经心的,目中无人的; [a]/ˌkævəˈlɪr/; [or]sat;
mettle: [n]勇气,毅力,耐力; [a]/ˈmetl/; [or]sat;
disdain: [n]蔑视,鄙视; [vt]鄙视;不屑; [a]/dɪsˈdeɪn/; [or]sat;
tycoon: [n]有钱有势的企业家,大亨; [a]/taɪˈkuːn/; [or]sat;
discordant: [adj]不和谐的,刺耳的,不一致的; [a]/dɪsˈkɔːrdənt/; [or]sat;
unrequited: [adj]无回报的;无报酬的; [a]/ˌʌnrɪˈkwaɪtɪd/; [or]sat;
ordination: [n]神职授任; [a]/ˌɔːrdnˈeɪʃn/; [or]sat;
venial: [adj]可原谅的,(罪过)轻微的,可宽恕的; [a]/ˈviːniəl/; [or]sat;
erroneous: [adj]错误的; [a]/ɪˈroʊniəs/; [or]sat;
avid: [adj]渴望的,贪婪的;热心的; [a]/ˈævɪd/; [or]sat;
palpitate: [v](心脏)悸动,发抖; [a]/ˈpælpɪteɪt/; [or]sat;
reiterate: [vt]反复讲,重申,反复做; [a]/riˈɪtəreɪt/; [or]sat;
omnipresent: [adj]无所不在的; [a]/ˌɑːmnɪˈpreznt/; [or]sat;
commiserate: [v]同情,怜悯; [a]/kəˈmɪzəreɪt/; [or]sat;
woe: [n]悲哀;痛苦; int. 唉(表示痛苦,悲伤或悔恨);咳; [a]/woʊ/; [or]sat;
behemoth: [n]怪物;怪兽; [a]/bɪˈhiːmɔːθ/; [or]sat;
intermittent: [adj]断断续续的,间歇的; [a]/ˌɪntərˈmɪtənt/; [or]sat;
extrude: [v]挤压出;伸出;逐出; [a]/ɪkˈstruːd/; [or]sat;
sleight: [n]巧妙手法,巧计,灵巧; [a]/slaɪt/; [or]sat;
susceptible: [adj]易受感染的;易受影响的;多情的; [a]/səˈseptəbl/; [or]sat;
amble: [v]漫步,缓行; [n]缓行,漫步; [a]/ˈæmbl/; [or]sat;
whet: [v]刺激;磨快;促进; [n]磨;开胃物;刺激物; [a]/wet/; [or]sat;
forswear: [v]誓绝,放弃; [a]/fɔːrˈswer/; [or]sat;
disquiet: [n]担心,焦虑; [v]使不安,使忧虑; [a]/dɪsˈkwaɪət/; [or]sat;
voluptuous: [adj]撩人的,沉溺酒色的,骄奢淫逸的; [a]/vəˈlʌptʃuəs/; [or]sat;
amenable: [adj]愿意的,顺从的,服从的;经得起检验的; [a]/əˈmiːnəbl/; [or]sat;
chastise: [v]严厉惩罚,遣责; [a]/tʃæˈstaɪz/; [or]sat;
fret: [v]使烦恼,使焦急;使腐蚀;使磨损; [n](斑卓琴,吉他,曼陀林琴等弦乐器指板上定音的)档;侵蚀; [a]/fret/; [or]sat;
agrarian: [adj]耕地的; [a]/əˈɡreriən/; [or]sat;
fulcrum: [n][机]支点,(植)叶附属物; [a]/ˈfʊlkrəm/; [or]sat;
auxiliary: [adj]备用的,辅助的,协助的; [a]/ɔːɡˈzɪliəri/; [or]sat;
lithe: [adj]轻盈的(等于lithesome);柔软的;易弯曲的; [a]/laɪð/; [or]sat;
alloy: [n]合金; [v]使成合金; [a]/ˈælɔɪ/; [or]sat;
jeopardize: [v]危及,损害(也作jeopardise); [a]/ˈdʒepərdaɪz/; [or]sat;
imperious: [adj]傲慢的,专横的; [a]/ɪmˈpɪriəs/; [or]sat;
infinitesimal: [adj]无穷小的,无限小的,极小的; [adv]无限小地; [n]无限小;极微量;极小量; [a]/ˌɪnfɪnɪˈtesɪml/; [or]sat;
bilious: [adj]多胆汁的,坏脾气的; [a]/ˈbɪliəs/; [or]sat;
pitfall: [n]陷阱,未料到的危险或困难; [a]/ˈpɪtfɔːl/; [or]sat;
reconcile: [v]和解;调解;调和; [a]/ˈrekənsaɪl/; [or]sat;
eulogy: [n]颂词,赞美词; [a]/ˈjuːlədʒi/; [or]sat;
prurient: [adj]好色的;淫乱的;渴望的; [a]/ˈprʊriənt/; [or]sat;
betray: [v]背叛;失信于;泄露(秘密等);(非故意地)暴露; [a]/bɪˈtreɪ/; [or]sat;
phoenix: [n]凤凰;死而复生的人; [a]/ˈfiːnɪks/; [or]sat;
heyday: [n]全盛期; int. 嘿(表喜悦或惊奇等); [a]/ˈheɪdeɪ/; [or]sat;
motley: [adj]混杂的,杂色的; [n]混杂;杂色衣服;小丑; [a]/ˈmɑːtli/; [or]sat;
rapport: [n]密切关系,交往;和谐一致;意见一致; [a]/ræˈpɔːr/; [or]sat;
infirmity: [n]虚弱; [a]/ɪnˈfɜːrməti/; [or]sat;
lethal: [adj]致命的,致死的;杀伤性的; [n]致死因子; [a]/ˈliːθl/; [or]sat;
despise: [vt]轻视,蔑视,看不起; [a]/dɪˈspaɪz/; [or]sat;
lustrous: [adj]有光泽的;光辉的; [a]/ˈlʌstrəs/; [or]sat;
beset: [v]困扰;镶嵌;围绕; [a]/bɪˈset/; [or]sat;
gnome: [n]地下宝藏的守护神,土地神;格言;侏儒; [a]/noʊm/; [or]sat;
modulate: [v]调整(音调);变调;调节(使平衡); [a]/ˈmɑːdʒəleɪt/; [or]sat;
abysmal: [adj]极低的或极可怜的,(程度)很深的,极端的; [a]/əˈbɪzməl/; [or]sat;
requisite: [n]必需品; [adj]需要的,必不可少的,必备的; [a]/ˈrekwɪzɪt/; [or]sat;
doodle: [v](无目的地)乱画,漫无目的地打发时光; [n]涂鸦; [a]/ˈduːdl/; [or]sat;
haphazard: [adj]偶然的;随意的;凑合的;胡乱的; [a]/hæpˈhæzərd/; [or]sat;
prune: [n]梅干; [v]修剪;削减; [a]/pruːn/; [or]sat;
refurbish: [v]刷新,再磨光; [a]/ˌriːˈfɜːrbɪʃ/; [or]sat;
ponderous: [adj]笨重的,笨拙的,沉闷的; [a]/ˈpɑːndərəs/; [or]sat;
deliberate: [adj]故意的;深思熟虑的;从容不迫的; [v]仔细考虑;研讨; [a]/dɪˈlɪbərət/; [or]sat;
Armada: [n](西班牙的)无敌舰队; [a]/ɑːrˈmɑːdə/; [or]sat;
gainsay: [v]否认,否定,反驳; [n]否认,反驳; [a]/ˌɡeɪnˈseɪ/; [or]sat;
ephemeral: [adj]短暂的,短命的; [n]生存极短时间的事物; [a]/ɪˈfemərəl/; [or]sat;
luster: [n]光泽,光彩; [v](使)有光泽;发亮; [a]/ˈlʌstər/; [or]sat;
putrid: [adj]腐臭的;讨人厌的; [a]/ˈpjuːtrɪd/; [or]sat;
dissipate: [v]消散,消失;浪费; [a]/ˈdɪsɪpeɪt/; [or]sat;
cogent: [adj]有说服力的; [a]/ˈkoʊdʒənt/; [or]sat;
asteroid: [n]小行星; [adj]星状的; [a]/ˈæstərɔɪd/; [or]sat;
alliteration: [n]头韵; [a]/əˌlɪtəˈreɪʃn/; [or]sat;
yoke: [n]牛轭;枷锁;纽带; [v]结合;连结; [a]/joʊk/; [or]sat;
asunder: [adv]分离;化为碎片; [a]/əˈsʌndər/; [or]sat;
rend: [v]撕碎;分裂;强夺; [a]/rend/; [or]sat;
burgeon: [v]发芽,迅速成长; [n]嫩枝; [a]/ˈbɜːrdʒən/; [or]sat;
tremor: [n](小)地震;[医]震颤,战栗,发抖; [a]/ˈtremər/; [or]sat;
ford: [v]涉水,渡河; [n]浅滩; [a]/fɔːrd/; [or]sat;
mode: [n]模式;方式; [a]/moʊd/; [or]sat;
amiss: [adj]有毛病的,有缺陷的;出差错的; [adv]错误地; [a]/əˈmɪs/; [or]sat;
allude: [v]间接提到,暗指,暗示; [a]/əˈluːd/; [or]sat;
fanfare: [n]夸耀,嘹亮的喇叭声; [v]热闹地介绍[宣布]; [a]/ˈfænfer/; [or]sat;
muse: [v]沉思;冥想; [n][希神]缪斯女神,灵感; [a]/mjuːz/; [or]sat;
assumption: [n]假定,设想;采取;承担; [a]/əˈsʌmpʃn/; [or]sat;
snivel: [v]流鼻涕;啜泣; [a]/ˈsnɪvl/; [or]sat;
waggish: [adj]诙谐的,滑稽的; [a]/ˈwæɡɪʃ/; [or]sat;
fortuitous: [adj]偶然的;幸运的; [a]/fɔːrˈtuːɪtəs/; [or]sat;
tumult: [n]骚动;骚乱;吵闹;激动; [a]/ˈtuːmʌlt/; [or]sat;
squalor: [n]肮脏,邋遢,(道德品质等的)卑劣; [a]/ˈskwɑːlər/; [or]sat;
quell: [v]镇压,消除,减轻(激动,恐惧等); [n]镇压,平息,减轻; [a]/kwel/; [or]sat;
paucity: [n]小量,缺乏; [a]/ˈpɔːsəti/; [or]sat;
laggard: [adj]缓慢的,落后的; [n]落后者;迟钝者; [a]/ˈlæɡərd/; [or]sat;
bestow: [v]给予; [a]/bɪˈstoʊ/; [or]sat;
gingerly: [adv]小心翼翼地,慎重地; [adj]小心翼翼的;兢兢业业的; [a]/ˈdʒɪndʒərli/; [or]sat;
retrograde: [vi]倒退,退步; [adj]后退的,退步的,退化的; [vt]使倒退; [a]/ˈretrəɡreɪd/; [or]sat;
kindred: [n]亲戚,家族,亲属关系,相似; [adj]有血缘关系的,同宗的,同源的,类似的; [a]/ˈkɪndrəd/; [or]sat;
allay: [v]减轻;使缓和;使平静; [a]/əˈleɪ/; [or]sat;
seminary: [n]神学院,学校,发源地,高级中学; [a]/ˈsemɪneri/; [or]sat;
tempo: [n][音]节奏,拍子;行进速度; [a]/ˈtempoʊ/; [or]sat;
doleful: [adj]寂寞的;悲哀的;阴沉的; [a]/ˈdoʊlfl/; [or]sat;
pallid: [adj]苍白的,病态的,无生气的; [a]/ˈpælɪd/; [or]sat;
reek: [v]散发;冒烟;放出臭气; [n]恶臭;水蒸汽;雾;烟; [a]/riːk/; [or]sat;
grouse: [v]埋怨; [n]松鸡;雷鸟科的猎鸟;怨言; [a]/ɡraʊs/; [or]sat;
arrears: [n]债,欠债; [a]/əˈrɪrz/; [or]sat;
recourse: [n]求援(对象),求助(对象,[商][律]追索权; [a]/ˈriːkɔːrs/; [or]sat;
acclivity: [n]向上的陡坡; [a]/ə'klɪvətɪ/; [or]sat;
complacency: [n]自满,自鸣得意;满足; [a]/kəmˈpleɪsnsi/; [or]sat;
omnipotent: [adj]全能的,万能的; [n]全能者; [a]/ɑːmˈnɪpətənt/; [or]sat;
solace: [n]慰藉,给予安慰的人或事物; [v]安慰,缓和,使开心; [a]/ˈsɑːləs/; [or]sat;
affix: [v]粘上;署名;将罪责加之于; [n]词缀;附加物; [a]/əˈfɪks/; [or]sat;
bolster: [n]枕垫; [v]支持,鼓励,增强; [a]/ˈboʊlstər/; [or]sat;
delete: [v]删除; [a]/dɪˈliːt/; [or]sat;
biased: [adj]有偏见的,结果偏倚的,有偏的; [a]/ˈbaɪəst/; [or]sat;
refractory: [adj]难治的,难熔的,不听话的; [a]/rɪˈfræktəri/; [or]sat;
resolution: [n]决心,决定,解决,决议,分辨率; [a]/ˌrezəˈluːʃn/; [or]sat;
admonition: [n]告诫,劝告,警告; [a]/ˌædməˈnɪʃn/; [or]sat;
concede: [v]承认;承认失败;让给,让与;让步; [a]/kənˈsiːd/; [or]sat;
demean: [v]贬抑,降低; [a]/dɪˈmiːn/; [or]sat;
illusory: [adj]错觉的,幻影的,虚假的,产生幻觉的; [a]/ɪˈluːsəri/; [or]sat;
loath: [adj]不愿意的; [a]/loʊθ/; [or]sat;
coincidence: [n]一致;巧合,巧事;同时发生; [a]/koʊˈɪnsɪdəns/; [or]sat;
laborious: [adj]费时费力的,辛苦的;艰苦的; [a]/ləˈbɔːriəs/; [or]sat;
fitful: [adj]发作的,间歇的,不定的; [a]/ˈfɪtfl/; [or]sat;
subversive: [n]颠覆分子,破坏分子; [adj]颠覆性的,破坏性的; [a]/səbˈvɜːrsɪv/; [or]sat;
deprecate: [v]反对;轻视; [a]/ˈdeprəkeɪt/; [or]sat;
defiance: [n]蔑视;反抗;挑战; [a]/dɪˈfaɪəns/; [or]sat;
annotate: [v]注释,评注; [n]注释者; [a]/ˈænəteɪt/; [or]sat;
cloister: [n]修道院; [adj]隐居的;躲开尘世纷争的; [a]/ˈklɔɪstər/; [or]sat;
dissemble: [v]掩饰;假装;隐藏,掩饰; [a]/dɪˈsembl/; [or]sat;
cascade: [n]层叠;小瀑布;喷流; [v]像瀑布般冲下或倾泻; [a]/kæˈskeɪd/; [or]sat;
autonomous: [adj]自动驾驶的;自治的,独立自主的;自主的; [a]/ɔːˈtɑːnəməs/; [or]sat;
postulate: [v]假定.是真的; [n]假定; [a]/ˈpɑːstʃəleɪt/; [or]sat;
alienate: [v]疏远;挑拨; [a]/ˈeɪliəneɪt/; [or]sat;
hover: [v](鸟,直升机)盘旋,翱翔;(人)逗留在附近,徘徊; [a]/ˈhʌvər/; [or]sat;
relic: [n]遗迹;神圣的遗物;纪念物; [a]/ˈrelɪk/; [or]sat;
egregious: [adj]非常恶劣的,过分的;恶名昭彰的;惊人的; [a]/ɪˈɡriːdʒiəs/; [or]sat;
exacerbate: [v]加重;恶化;激怒; [a]/ɪɡˈzæsərbeɪt/; [or]sat;
humid: [adj]潮湿的;湿润的;多湿气的; [a]/ˈhjuːmɪd/; [or]sat;
superficial: [adj]肤浅的;表面的;微不足道的; [n]表面文章; [a]/ˌsuːpərˈfɪʃl/; [or]sat;
parched: [adj]干旱的,干渴的; [a]/pɑːrtʃt/; [or]sat;
infidel: [n]不信教者,异教徒; [a]/ˈɪnfɪdəl/; [or]sat;
latitude: [n]纬度;地区;(言论,行动的)自由; [a]/ˈlætɪtuːd/; [or]sat;
obsolete: [adj]已过时的;已废弃的; [v]使过时;使作废; [n]废词;被废弃的事物; [a]/ˌɑːbsəˈliːt/; [or]sat;
escapade: [n]越轨行为,恶作剧; [a]/ˌeskəˈpeɪd/; [or]sat;
amphitheater: [n]竞技场,圆形露天剧场,古罗马剧场; [a]/ˈæmfɪˌθiətər/; [or]sat;
cede: [v]放弃;割让(领土); [a]/siːd/; [or]sat;
destitute: [adj]贫穷的,缺乏的; [a]/ˈdestɪtuːt/; [or]sat;
rhetoric: [n]修辞学,浮夸的言语;雄辩术; [a]/ˈretərɪk/; [or]sat;
misconception: [n]误解;错误想法; [a]/ˌmɪskənˈsepʃn/; [or]sat;
foreboding: [n]预感,预兆; [adj]预感的,不祥之兆的; [a]/fɔːrˈboʊdɪŋ/; [or]sat;
dispirited: [adj]沮丧的;消沉的;情绪低落的;灰心的; [a]/dɪˈspɪrɪtɪd/; [or]sat;
refrain: [v]抑制,避免; [n]歌曲的反复句,叠句; [a]/rɪˈfreɪn/; [or]sat;
forensic: [adj]科学手段的,法庭的,辩论的; [n]辩论练习;辩论学,辩论术; [a]/fəˈrensɪk/; [or]sat;
embed: [v]把.嵌入;使嵌入; [a]/ɪmˈbed/; [or]sat;
abrogate: [v]废止,废除; [n]取消,废除; [a]/ˈæbrəɡeɪt/; [or]sat;
receptive: [adj]善于接受的;能容纳的; [a]/rɪˈseptɪv/; [or]sat;
maxim: [n]格言;准则;座右铭; [a]/ˈmæksɪm/; [or]sat;
gusty: [adj]多阵风的,起大风的,迸发的; [a]/ˈɡʌsti/; [or]sat;
misanthrope: [n]愤世嫉俗者;厌世者;厌恶人类的人; [a]/ˈmɪsənθroʊp/; [or]sat;
placebo: [n]安慰剂;为死者所诵的晚祷词; [a]/pləˈsiːboʊ/; [or]sat;
inanimate: [adj]无生命的;无生气的; [a]/ɪnˈænɪmət/; [or]sat;
circumlocution: [n]婉转曲折的说法,累赘的陈述,遁辞; [a]/ˌsɜːrkəmləˈkjuːʃn/; [or]sat;
ratify: [vt]批准,认可,签署生效; [a]/ˈrætɪfaɪ/; [or]sat;
superimpose: [v]添加;重叠;附加;安装; [a]/ˌsuːpərɪmˈpoʊz/; [or]sat;
unanimity: [n]一致同意; [a]/ˌjuːnəˈnɪməti/; [or]sat;
molt: [v]脱毛,换毛; [n]换羽期,脱毛期; [a]/moʊlt/; [or]sat;
fissure: [v]裂开,龟裂; [n]裂缝,裂隙; [a]/ˈfɪʃər/; [or]sat;
belligerent: [adj](国家等)交战的,挑斗的; [n]交战国,交战者;参加斗殴的人或集团; [a]/bəˈlɪdʒərənt/; [or]sat;
boisterous: [adj]喧闹的,欢闹的; [a]/ˈbɔɪstərəs/; [or]sat;
sparse: [adj]稀少的;稀疏的; [a]/spɑːrs/; [or]sat;
retiring: [adj]退休的,不善社交的,过隐居生活的; [v]退休; [a]/rɪˈtaɪərɪŋ/; [or]sat;
skimp: [vt]少给,克扣,不足量地供给;对.草率从事; [vi]克俭,节省; [adj]少的,不足的; [a]/skɪmp/; [or]sat;
residue: [n]剩余物;残渣;渣;残数; [a]/ˈrezɪduː/; [or]sat;
tyro: [n]新手; [a]/ˈtaɪroʊ/; [or]sat;
gorge: [n]峡谷;胃;暴食;咽喉;障碍物; [v]拼命吃;吞下,狼吞虎咽;塞满,填满; [a]/ɡɔːrdʒ/; [or]sat;
impervious: [adj]不能渗透的,不为所动的; [a]/ɪmˈpɜːrviəs/; [or]sat;
ambivalence: [n]矛盾心理; [a]/æmˈbɪvələns/; [or]sat;
captivate: [v]吸引,迷惑; [a]/ˈkæptɪveɪt/; [or]sat;
stratagem: [n]谋略,策略; [a]/ˈstrætədʒəm/; [or]sat;
fluster: [n]慌乱,狼狈,混乱; [v]使困惑,慌乱; [a]/ˈflʌstər/; [or]sat;
intemperate: [adj]放纵的;酗酒的;酷烈的; [a]/ɪnˈtempərət/; [or]sat;
obsessive: [adj]强迫性的;着迷的;分神的; [n]强迫症患者; [a]/əbˈsesɪv/; [or]sat;
sully: [v]玷污,污染; [a]/ˈsʌli/; [or]sat;
exemplify: [v]举例说明;例示,是..的典范; [a]/ɪɡˈzemplɪfaɪ/; [or]sat;
depredation: [n]掠夺,破坏; [a]/ˌdeprəˈdeɪʃn/; [or]sat;
acerbity: [n]苦涩,刻薄; [a]/əˈsɜːrbəti/; [or]sat;
arboretum: [n]植物园; [a]/ˌɑːrbəˈriːtəm/; [or]sat;
title: [n]标题;头衔;权利; [vt]加标题于;授予.称号; [adj]标题的,题目的;称呼的; [a]/ˈtaɪtl/; [or]sat;
impostor: [n]骗子;冒充者; [a]/ɪmˈpɑːstər/; [or]sat;
undermine: [v]暗中破坏;逐渐削弱;侵蚀.的基础;在...下挖坑道,从根基处损害; [a]/ˌʌndərˈmaɪn/; [or]sat;
furtive: [adj]偷偷的,秘密的,鬼鬼祟祟的,; [a]/ˈfɜːrtɪv/; [or]sat;
indiscretion: [n]轻率;言行失检; [a]/ˌɪndɪˈskreʃn/; [or]sat;
fraudulent: [adj]欺诈的,欺骗性的,骗得的; [a]/ˈfrɔːdʒələnt/; [or]sat;
turpitude: [n]邪恶,卑鄙(行为); [a]/ˈtɜːrpətuːd/; [or]sat;
pinnacle: [n](哥德式建筑的)小尖塔,顶峰; [v]置于尖顶上,置于高处; [a]/ˈpɪnəkl/; [or]sat;
withstand: [v]忍受;抵挡; [a]/wɪðˈstænd/; [or]sat;
articulate: [adj]善于表达的;发音清晰的; [v]清晰地发音;清楚地讲话;连接,接合;与.合成整体 ,使相互连贯; [a]/ɑːrˈtɪkjuleɪt/; [or]sat;
anemia: [n]贫血,贫血症; [a]/ə'niːmiːə/; [or]sat;
rhetorical: [adj]语言上的,文字上的,言辞华丽(却往往无内涵的); [a]/rɪˈtɔːrɪkl/; [or]sat;
sanctimonious: [adj]伪装虔诚的;道貌岸然的; [a]/ˌsæŋktɪˈmoʊniəs/; [or]sat;
pernicious: [adj]有害的,恶性的,致命的; [a]/pərˈnɪʃəs/; [or]sat;
viscous: [adj]黏的;黏稠的;黏滞的;有黏性的; [a]/ˈvɪskəs/; [or]sat;
intricate: [adj]错综复杂的; [a]/ˈɪntrɪkət/; [or]sat;
apparition: [n]幽灵,神奇的现象; [a]/ˌæpəˈrɪʃn/; [or]sat;
frugality: [n]节约,节俭; [a]/fruˈɡæləti/; [or]sat;
diva: [n]著名女歌唱家,歌剧女主角; [a]/ˈdiːvə/; [or]sat;
forthright: [adj]直接的,直率的,坦白的,豪爽的; [adv]马上,立即; [n]直路; [a]/ˈfɔːrθraɪt/; [or]sat;
trepidation: [n]恐惧,惶恐; [a]/ˌtrepɪˈdeɪʃn/; [or]sat;
empathy: [n]共鸣,同感;移情作用; [a]/ˈempəθi/; [or]sat;
serendipity: [n]机缘巧合; [a]/ˌserənˈdɪpəti/; [or]sat;
angular: [adj]消瘦的;有角的;笨拙的; [a]/ˈæŋɡjələr/; [or]sat;
ameliorate: [v]改善,减轻(痛苦等),改良; [a]/əˈmiːliəreɪt/; [or]sat;
impenetrable: [adj]难以渗透的,坚不可摧的; [a]/ɪmˈpenɪtrəbl/; [or]sat;
wily: [adj]狡猾的; [a]/ˈwaɪli/; [or]sat;
material: [n]材料,原料,资料; [adj]物质的,实体的; [a]/məˈtɪriəl/; [or]sat;
voluminous: [adj]大量的;长篇的,多产的;庞大的; [adv]宽松地;容量大地;篇幅长地; [n]宽松;容量大,篇幅长; [a]/vəˈluːmɪnəs/; [or]sat;
tawdry: [adj]非常华丽的,廉价而俗丽的; [n]俗丽的东西,廉价而俗丽之物; [adv]俗丽地,华而不实地; [a]/ˈtɔːdri/; [or]sat;
potentate: [n]统治者,君主;有权势的人; [a]/ˈpoʊtnteɪt/; [or]sat;
pendant: [n]吊坠,下垂物; [a]/ˈpendənt/; [or]sat;
embark: [v]上船或飞机;开始,着手,从事; [a]/ɪmˈbɑːrk/; [or]sat;
peripheral: [adj]外围的; [n]外围设备; [a]/pəˈrɪfərəl/; [or]sat;
relevant: [adj]有关的;恰当的;贴切的; [a]/ˈreləvənt/; [or]sat;
dais: [n]主席台,嘉宾席; [a]/ˈdeɪɪs/; [or]sat;
secrete: [v]藏匿;私下侵吞;分泌; [a]/sɪˈkriːt/; [or]sat;
morose: [adj]脾气坏的,乖戾的,不高兴的; [a]/məˈroʊs/; [or]sat;
adapt: [vi]适应不同情况; [vt]使适合;改编; [a]/əˈdæpt/; [or]sat;
percussion: [n]撞击,敲击;敲打乐器; [a]/pərˈkʌʃn/; [or]sat;
linguistic: [adj]语言的,语言上的; [a]/lɪŋˈɡwɪstɪk/; [or]sat;
pretext: [n]借口,托词; [a]/ˈpriːtekst/; [or]sat;
maverick: [n]独行者,想法与众不同的人; [adj]行为不合常规的; [v]用不正当手段获取;迷路; [a]/ˈmævərɪk/; [or]sat;
espionage: [n]间谍活动,侦查,监视; [a]/ˈespiənɑːʒ/; [or]sat;
doggerel: [n]糟糕的诗歌; [a]/ˈdɔːɡərəl/; [or]sat;
wax: [n]蜡;蜡状物; [v]给.上蜡;给.打蜡,给.上蜡;渐渐变大;变为;(月亮)渐圆,渐盈; [adj]蜡制的; [a]/wæks/; [or]sat;
neologism: [n]新生词; [a]/niˈɑːlədʒɪzəm/; [or]sat;
termination: [n]终端;结果;结束,终止; [a]/ˌtɜːrmɪˈneɪʃn/; [or]sat;
belittle: [v]轻视,贬抑; [a]/bɪˈlɪtl/; [or]sat;
pedant: [n]学究式人物,书呆子,卖弄学问的人; [a]/ˈpednt/; [or]sat;
languid: [adj]没精打采的,倦怠的; [a]/ˈlæŋɡwɪd/; [or]sat;
reciprocal: [adj]相互的,互惠的; [n]倒数;互相关联的事物; [a]/rɪˈsɪprəkl/; [or]sat;
prognosis: [n][医]预后;预知; [a]/prɑːɡˈnoʊsɪs/; [or]sat;
anachronistic: [adj]时代错误的; [a]/əˌnækrəˈnɪstɪk/; [or]sat;
ebb: [n]退潮;退潮期;衰退; [v]退潮;衰退; [a]/eb/; [or]sat;
academic: [adj]学术的;学院的,大学的;理论的; [n]学者; [a]/ˌækəˈdemɪk/; [or]sat;
fickle: [adj](在感情等方面)反复无常的,轻浮的,善变的; [a]/ˈfɪkl/; [or]sat;
nurture: [v]养育,培育;培植; [n]养育,培养;教养;营养物; [a]/ˈnɜːrtʃər/; [or]sat;
replete: [adj]充满的,装满的; [n][昆]贮蜜蚁; [a]/rɪˈpliːt/; [or]sat;
inept: [adj]无能的;不称职的;笨拙的; [a]/ɪˈnept/; [or]sat;
novelty: [n]新奇;新奇的事物;新颖小巧而廉价的小物品; [adj]新奇的;风格独特的; [a]/ˈnɑːvlti/; [or]sat;
hurtle: [v]猛冲,猛烈碰撞,使冲向; [n]碰撞;碰撞声;猛冲; [a]/ˈhɜːrtl/; [or]sat;
buxom: [adj]体态丰满的; [a]/ˈbʌksəm/; [or]sat;
lumber: [v]缓慢地移动;拖累,迫使担负;伐木;杂乱地堆积;隆隆地行进; [n]木材;废旧家具,不用的大件物品;无用的杂物;隆隆声; [a]/ˈlʌmbər/; [or]sat;
heckler: [n]激烈质问者; [a]/ˈheklər/; [or]sat;
fancy: [adj]华丽装饰的,别致的,引人注目的;昂贵的,阔气的; [n]喜爱,幻想,想像力; [vt]想象,幻想;迷恋; [a]/ˈfænsi/; [or]sat;
grandiose: [adj]浮夸的,夸大的,宏伟的; [a]/ˈɡrændioʊs/; [or]sat;
zeal: [n]热情,热心; [a]/ziːl/; [or]sat;
augury: [n]预言,征兆,占卜; [a]/ˈɔːɡjʊri/; [or]sat;
absolute: [adj]完全的;绝对的;纯粹的; [a]/ˈæbsəluːt/; [or]sat;
adjunct: [n]附属物,配件,添加剂;助手,部下; [adj]附加的,辅助的,下级的; [a]/ˈædʒʌŋkt/; [or]sat;
rustic: [n]乡巴佬,庄稼汉,粗人; [adj]乡村的;质朴的;不精致的; [a]/ˈrʌstɪk/; [or]sat;
suppress: [v]镇压;禁止发表;抑制(感情等);阻止.的生长; [a]/səˈpres/; [or]sat;
mirage: [n]幻影,海市蜃楼; [a]/məˈrɑːʒ/; [or]sat;
faze: [v]打扰,折磨,使狼狈,使担忧; [a]/feɪz/; [or]sat;
chaff: [n]谷物的皮壳,米糠;草料,干草;小玩笑; [v]开玩笑; [a]/tʃæf/; [or]sat;
pretentious: [adj]做作的,自命不凡的,炫耀的; [a]/prɪˈtenʃəs/; [or]sat;
fractious: [adj]易怒的;难以对待的;倔强的;好争吵的; [a]/ˈfrækʃəs/; [or]sat;
avert: [v]转移(目光,注意力等);防止;避开; [a]/əˈvɜːrt/; [or]sat;
pathetic: [adj]可怜的;不足的; [a]/pəˈθetɪk/; [or]sat;
molecule: [n]分子,微粒; [a]/ˈmɑːlɪkjuːl/; [or]sat;
terse: [adj]简洁的,简明的; [a]/tɜːrs/; [or]sat;
exude: [v]慢慢流出,四溢,渗出,散发; [a]/ɪɡˈzuːd/; [or]sat;
headstrong: [adj]任性的;顽固的; [a]/ˈhedstrɔːŋ/; [or]sat;
supplant: [v]代替;排挤掉; [a]/səˈplænt/; [or]sat;
booming: [adj]快速增长的,欣欣向荣;深刻的; [a]/ˈbuːmɪŋ/; [or]sat;
grisly: [adj]恐怖的;令人震惊的;厉害的; [a]/ˈɡrɪzli/; [or]sat;
slag: [n]炉渣,矿渣; [a]/slæɡ/; [or]sat;
mundane: [adj]普通的,平凡的;单调的;现世的,世俗的; [a]/mʌnˈdeɪn/; [or]sat;
invigorate: [v]鼓舞;提神,使精力充沛; [adj]生气勃勃的,精力充沛的,健壮的; [n]滋补;鼓舞; [a]/ɪnˈvɪɡəreɪt/; [or]sat;
gavel: [n]小木槌; [v]敲小槌(催促通过议案,要求注意等);要求(注意); [a]/ˈɡævl/; [or]sat;
convivial: [adj]欢乐的;欢宴的;酒宴的; [a]/kənˈvɪviəl/; [or]sat;
malicious: [adj]怀恶意的,恶毒的; [a]/məˈlɪʃəs/; [or]sat;
exonerate: [v]使免罪; [a]/ɪɡˈzɑːnəreɪt/; [or]sat;
torrent: [n]湍流,洪流,奔流;迸发,连发,爆发;倾盆大雨; [a]/ˈtɔːrənt/; [or]sat;
annex: [n]附加物;附属的建筑物; [vt]附加;并吞,强行占取;获得; [a]/əˈneks/; [or]sat;
acoustics: [n]声学; [a]/əˈkuːstɪks/; [or]sat;
indiscriminate: [adj]任意的;不加区别的,不加选择的; [a]/ˌɪndɪˈskrɪmɪnət/; [or]sat;
warrant: [n]逮捕证;正当理由;凭证; [v]使正当; [a]/ˈwɔːrənt/; [or]sat;
portly: [n]肥胖的人;特大号服装; [adj]肥胖的;魁伟的; [a]/ˈpɔːrtli/; [or]sat;
mammoth: [n]长毛象,猛犸象,庞然大物; [adj]巨大的,庞大的,猛犸似的; [a]/ˈmæməθ/; [or]sat;
fresco: [n]壁画;壁画法; [v]在..上做壁画;用壁画法画出; [a]/ˈfreskoʊ/; [or]sat;
fidelity: [n]忠诚;逼真度,保真度; [a]/fɪˈdeləti/; [or]sat;
encompass: [vt]环绕,包围;包含;完成; [a]/ɪnˈkʌmpəs/; [or]sat;
adversary: [n]对手,敌手; [a]/ˈædvərseri/; [or]sat;
obituary: [n]讣告; [adj]关于死者的,讣告的; [a]/oʊˈbɪtʃueri/; [or]sat;
meditation: [n]沉思,冥想; [a]/ˌmedɪˈteɪʃn/; [or]sat;
astringent: [adj]止血的,收敛性的;涩的;严厉的; [n]收缩剂,止血药; [a]/əˈstrɪndʒənt/; [or]sat;
reverent: [adj]虔诚的,恭敬的; [a]/ˈrevərənt/; [or]sat;
materialism: [n]唯物主义,物质主义; [a]/məˈtɪriəlɪzəm/; [or]sat;
irreverence: [n]无礼;不敬的行为; [adj]不尊敬的; [a]/ɪˈrevərəns/; [or]sat;
pugnacity: [n]好斗,好战; [a]/pʌɡˈnæsəti/; [or]sat;
protege: [n]被保护人,门徒,门生; [a]/ˈproʊtəʒeɪ/; [or]sat;
carnivorous: [adj]食肉的,肉食性的; [a]/kɑːrˈnɪvərəs/; [or]sat;
deplete: [v]使大大减少;耗尽,用尽; [a]/dɪˈpliːt/; [or]sat;
impromptu: [adj]一触即发的;即席的,即兴的; [adv]即席地,即兴地; [n]即兴之作; [a]/ɪmˈprɑːmptuː/; [or]sat;
archetype: [n]原型,典型; [a]/ˈɑːrkitaɪp/; [or]sat;
bloated: [adj]浮肿的,发胀的,傲慢的; [a]/ˈbloʊtɪd/; [or]sat;
execute: [v]处决;完成(动作);实行;执行(计划); [a]/ˈeksɪkjuːt/; [or]sat;
cordial: [adj]热情友好的,衷心的; [a]/ˈkɔːrdʒəl/; [or]sat;
protocol: [n]外交礼节;草案;外交议定书; [vi]拟定议定书; [vt]把.写入议定书; [a]/ˈproʊtəkɔːl/; [or]sat;
commemorate: [v]纪念,庆祝; [a]/kəˈmeməreɪt/; [or]sat;
entrepreneur: [n]企业家,演出承包人; [a]/ˌɑːntrəprəˈnɜːr/; [or]sat;
stratify: [v]分层,成层,阶层化; [a]/ˈstrætɪfaɪ/; [or]sat;
circumscribe: [v]限制;在.周围画线;[数]使外接,使外切; [a]/ˈsɜːrkəmskraɪb/; [or]sat;
gouge: [n]半圆凿,洞; [v]挖洞,敲竹杠; [a]/ɡaʊdʒ/; [or]sat;
docile: [adj]驯服的,温顺的; [a]/ˈdɑːsl/; [or]sat;
bombardment: [n]炮轰; [a]/bɑːmˈbɑːrdmənt/; [or]sat;
replica: [n]复制品; [a]/ˈreplɪkə/; [or]sat;
emancipate: [v]解放;释放; [a]/ɪˈmænsɪpeɪt/; [or]sat;
reimburse: [v]偿还;赔偿;退还(钱),付还; [a]/ˌriːɪmˈbɜːrs/; [or]sat;
devious: [adj]迂回弯曲的,狡猾的; [a]/ˈdiːviəs/; [or]sat;
genteel: [adj]有教养的,文雅的;高雅的;假斯文的,装作体面的; [a]/dʒenˈtiːl/; [or]sat;
martinet: [n]纪律严明之人; [a]/ˌmɑːrtnˈet/; [or]sat;
elixir: [n]不老长寿药;万能药;炼金药; [a]/ɪˈlɪksər/; [or]sat;
complementary: [adj]补足的,补充的,互补的; [a]/ˌkɑːmplɪˈmentri/; [or]sat;
pied: [adj]杂色的;斑驳的;穿花衣服的; [a]/paɪd/; [or]sat;
remnant: [n]遗迹;边角剩料; [a]/ˈremnənt/; [or]sat;
supple: [adj]柔软的;柔顺的; [a]/ˈsʌpl/; [or]sat;
abrasive: [adj]粗糙的;有研磨作用的;伤人感情的; [n]研磨料; [a]/əˈbreɪsɪv/; [or]sat;
hermitage: [n]隐士生活;隐士住处; [a]/ˈhɜːrmɪtɪdʒ/; [or]sat;
hone: [n]细磨刀石; [v]磨刀; [a]/hoʊn/; [or]sat;
indefatigable: [adj]不知疲倦的;不屈不挠的;有耐性的; [a]/ˌɪndɪˈfætɪɡəbl/; [or]sat;
adhere: [v]遵守;坚持;粘附;附着,粘在..上; [a]/ədˈhɪr/; [or]sat;
debauch: [v]诱骗;使堕落; [n]放荡; [a]/dɪ'bɔːtʃ/; [or]sat;
reprieve: [v]暂缓处罚,免罪,维持运行; [n][法]死缓,缓刑,暂缓; [a]/rɪˈpriːv/; [or]sat;
antithesis: [n]对立面,对照; [a]/ænˈtɪθəsɪs/; [or]sat;
perturb: [vt]使不安;烦扰;使紊乱; [a]/pərˈtɜːrb/; [or]sat;
fluctuate: [v]波动;起伏;涨落; [a]/ˈflʌktʃueɪt/; [or]sat;
dissonance: [n]不一致;不调和;不和谐音; [a]/ˈdɪsənəns/; [or]sat;
etymology: [n]语源,语源学; [a]/ˌetɪˈmɑːlədʒi/; [or]sat;
invasive: [adj]扩散性的;[医]开刀的; [a]/ɪnˈveɪsɪv/; [or]sat;
florid: [adj]涨红的,华丽的,红润的; [a]/ˈflɔːrɪd/; [or]sat;
jettison: [v]向外抛弃,投弃(船舶遇难时投弃货物以为减轻负载); [n]抛弃的货物; [a]/ˈdʒetɪsn/; [or]sat;
recluse: [n]隐士; [adj]隐士的,隐遁的; [a]/ˈrekluːs/; [or]sat;
manifesto: [n]宣言,声明;告示; [v]发表宣言; [a]/ˌmænɪˈfestoʊ/; [or]sat;
viable: [adj]可行的;能养活的;能生育的; [a]/ˈvaɪəbl/; [or]sat;
petty: [adj]价值不大的;小的;器量小的;琐碎的; [a]/ˈpeti/; [or]sat;
erratic: [adj]古怪的;反复无常的,不稳定的; [a]/ɪˈrætɪk/; [or]sat;
grievance: [n]牢骚,委屈,抱怨; [a]/ˈɡriːvəns/; [or]sat;
unobtrusive: [adj]不唐突的,谦虚的,不引人注目的; [a]/ˌʌnəbˈtruːsɪv/; [or]sat;
parody: [n]嘲弄文章,拙劣的模仿; [v]拙劣模仿; [a]/ˈpærədi/; [or]sat;
stultify: [v]使显得愚蠢,愚弄,使无效,使无价值; [a]/ˈstʌltɪfaɪ/; [or]sat;
revoke: [v]撤回,取消;废除; [n]有牌不跟; [a]/rɪˈvoʊk/; [or]sat;
swerve: [v]转弯,突然改变方向; [n]转向;滑出;逸出;背离; [a]/swɜːrv/; [or]sat;
address: [n]地址;致词; [v]致函;写姓名地址;向..讲话;处理; [a]/əˈdres/; [or]sat;
composure: [n]镇静,沉着; [a]/kəmˈpoʊʒər/; [or]sat;
explicit: [adj]充分表达清楚的,明确的;直率的,直截了当的;〔描绘性或暴力的语言或画面〕清晰露骨的; [a]/ɪkˈsplɪsɪt/; [or]sat;
talisman: [n]护身符,避邪物; [a]/ˈtælɪzmən/; [or]sat;
nefarious: [adj]违法的,邪恶的; [a]/nɪˈferiəs/; [or]sat;
engender: [v]产生; [a]/ɪnˈdʒendər/; [or]sat;
apprise: [v]通知,报告; [a]/əˈpraɪz/; [or]sat;
stamina: [n]耐力,持久力; [a]/ˈstæmɪnə/; [or]sat;
sybarite: [n]沉于奢侈逸乐者,酒色之徒; [a]/'sɪbəˌraɪt/; [or]sat;
expedient: [n]权宜之计,手段; [adj]有利的,方便的;权宜之计的; [a]/ɪkˈspiːdiənt/; [or]sat;
waive: [v]放弃;不坚持;推迟;搁置; [vt]抑制;搁置; [a]/weɪv/; [or]sat;
harbinger: [n]先驱,先兆; [vt]预告;充做.的前驱; [a]/ˈhɑːrbɪndʒər/; [or]sat;
calumny: [n]诽谤,中伤; [a]/ˈkæləmni/; [or]sat;
cosmopolitan: [n]游历四方的人; [adj]见多识广的;多元的;广泛分布的; [a]/ˌkɑːzməˈpɑːlɪtən/; [or]sat;
beseech: [v]恳求,哀求; [adj]恳求的;哀求的;乞求的; [a]/bɪˈsiːtʃ/; [or]sat;
expedite: [v]加快;促进;发出; [adj]畅通的;迅速的;方便的; [a]/ˈekspədaɪt/; [or]sat;
epicure: [n]美食家;享乐主义者; [a]/ˈepɪkjʊr/; [or]sat;
allusion: [n]暗示;提及; [a]/əˈluːʒn/; [or]sat;
spontaneity: [n]自发性,自然行为;自然发生; [a]/ˌspɑːntəˈneɪəti/; [or]sat;
microcosm: [n]微观世界,缩影; [a]/ˈmaɪkroʊkɑːzəm/; [or]sat;
incendiary: [n]放火者,纵火者,燃烧弹,煽动者; [adj]放火的,纵火的,能燃烧的,煽动性的; [a]/ɪnˈsendieri/; [or]sat;
cataract: [n][眼科]白内障,大瀑布,暴雨,洪水,奔流; [v]倾注; [a]/ˈkætərækt/; [or]sat;
prevaricate: [v]支吾,搪塞,说谎; [a]/prɪˈværɪkeɪt/; [or]sat;
abundant: [adj]丰富的;大量的; [a]/əˈbʌndənt/; [or]sat;
watershed: [n](美)流域;分水岭;集水区;转折点;重要关头; [adj]标志转折点的; [a]/ˈwɔːtərʃed/; [or]sat;
paranoia: [n](心理)偏执狂,多疑症; [a]/ˌpærəˈnɔɪə/; [or]sat;
jabber: [v]急急忙忙地说,急促不清地说; [n]急促不清地话,无意义的话; [a]/ˈdʒæbər/; [or]sat;
aggressor: [n]侵略者,侵略国,挑衅者; [a]/əˈɡresər/; [or]sat;
emaciated: [adj]瘦弱的;憔悴的; [a]/ɪˈmeɪʃieɪtɪd/; [or]sat;
aversion: [n]厌恶;讨厌的人,(或东西); [a]/əˈvɜːrʒn/; [or]sat;
pious: [adj]虔诚的;难以实现的;尽责的; [a]/ˈpaɪəs/; [or]sat;
amiable: [adj]和蔼的,亲切的;温和的; [a]/ˈeɪmiəbl/; [or]sat;
degradation: [n]降级,降格;退化;恶化; [a]/ˌdeɡrəˈdeɪʃn/; [or]sat;
profusion: [n]丰富; [a]/prəˈfjuːʒn/; [or]sat;
ordinance: [n]法令;条例;条例;圣餐式; [a]/ˈɔːrdɪnəns/; [or]sat;
flux: [n]流动,不断的变动; [a]/flʌks/; [or]sat;
chortle: [v]咯咯笑; [n]得意的高笑; [a]/ˈtʃɔːrtl/; [or]sat;
stereotype: [n]老套的模式,陈规,成见; [v]对..产生成见; [a]/ˈsteriətaɪp/; [or]sat;
azure: [adj]天蓝色的; [n]碧空; [v]使成天蓝色; [a]/ˈæʒər/; [or]sat;
interrogate: [v]审问,审讯; [a]/ɪnˈterəɡeɪt/; [or]sat;
refraction: [n]折射;折光; [a]/rɪˈfrækʃn/; [or]sat;
impetus: [n]推动力;促进; [a]/ˈɪmpɪtəs/; [or]sat;
paragon: [n]模范;完美之物;优秀之人; [adj]完美的; [a]/ˈpærəɡɑːn/; [or]sat;
bellicose: [adj]好战的,好斗的; [a]/ˈbelɪkoʊs/; [or]sat;
anonymous: [adj]匿名的;无名的;不具名的;无特色的;无个性特征; [a]/əˈnɑːnɪməs/; [or]sat;
patent: [n]专利; [adj]显然的,明显的;专利的;独创的; [v]取得.的专利权; [a]/ˈpætnt/; [or]sat;
festive: [adj]庆祝的,喜庆的,欢乐的,节日似的; [a]/ˈfestɪv/; [or]sat;
invocation: [n]祈祷;咒语;(法权的)行驶; [a]/ˌɪnvəˈkeɪʃn/; [or]sat;
unwarranted: [adj]未经保证的,无根据的,不合适的; [a]/ʌnˈwɔːrəntɪd/; [or]sat;
vicarious: [adj]代替别人做的;代理的,代替的;发同感的; [a]/vaɪˈkeriəs/; [or]sat;
cameo: [n]石雕,贝雕;浮雕玉石;文学小品; [a]/ˈkæmioʊ/; [or]sat;
thwart: [n][船]横坐板; [v]阻挠,阻碍,横过; [adj]横放的; [adv]横过; prep. 〈古〉横跨,横过; [a]/θwɔːrt/; [or]sat;
felicity: [n]幸福,快乐,幸运; [a]/fəˈlɪsəti/; [or]sat;
memento: [n]纪念品; [a]/məˈmentoʊ/; [or]sat;
wary: [adj]谨慎的,小心的,提防的;考虑周到的; [a]/ˈweri/; [or]sat;
gamut: [n]全音阶,长音域,整个领域,全体; [a]/'ɡæmət/; [or]sat;
vestige: [n]遗迹,(生)退化的器官,残余,微量(一般用于否定句); [a]/ˈvestɪdʒ/; [or]sat;
mottled: [adj]有杂色的,斑驳的; [a]/ˈmɑːtld/; [or]sat;
generate: [v]产生(热,电等能量),创造; [a]/ˈdʒenəreɪt/; [or]sat;
enumerate: [v]列举; [a]/ɪˈnuːməreɪt/; [or]sat;
sodden: [adj]浑身湿透的;浸透的;浸过酒的; [a]/ˈsɑːdn/; [or]sat;
arable: [adj]可耕的,适合种植的; [n]耕地; [a]/ˈærəbl/; [or]sat;
smelt: [v]熔解,熔炼; [n]香鱼;胡瓜鱼; [a]/smelt/; [or]sat;
callous: [adj]无情的,铁石心肠的,硬结的; [vt](使)变硬,(使)起茧;(使)冷酷无情; [a]/ˈkæləs/; [or]sat;
equivocate: [v]模棱两可地说,支吾其词; [a]/ɪˈkwɪvəkeɪt/; [or]sat;
promote: [v]提升;促进;发扬;促销; [a]/prəˈmoʊt/; [or]sat;
prim: [adj]拘谨的,呆板的;端庄的;整洁的; [adv]循规蹈矩地,整洁地; [v](使)一本正经;使整洁; [a]/prɪm/; [or]sat;
scintillate: [v]闪烁,(淡吐)流露机智; [a]/'sɪntlˌeɪt/; [or]sat;
beam: [n]光线;(房屋等)大梁;(横)梁; [v]发光;照射;发射,播送;微笑;用梁支撑; [a]/biːm/; [or]sat;
grandeur: [n]壮观,宏伟,庄严; [a]/ˈɡrændʒər/; [or]sat;
subsidy: [n]补助金,津贴; [a]/ˈsʌbsədi/; [or]sat;
incite: [v]刺激;煽动; [a]/ɪnˈsaɪt/; [or]sat;
denigrate: [v]抹黑,贬低; [a]/ˈdenɪɡreɪt/; [or]sat;
efface: [v]擦掉,抹去;消去; [a]/ɪˈfeɪs/; [or]sat;
devise: [v]设计,想出;密谋;遗赠(不动产); [n]设计,发明,遗赠; [a]/dɪˈvaɪz/; [or]sat;
shyster: [n]奸诈的人(尤指政客),讼棍; [a]/ˈʃaɪstər/; [or]sat;
plutocracy: [n]富豪,财阀统治; [a]/pluːˈtɑːkrəsi/; [or]sat;
alleviate: [v]减轻;缓解;缓和; [a]/əˈliːvieɪt/; [or]sat;
ideology: [n]意识形态,思想(体系); [a]/ˌaɪdiˈɑːlədʒi/; [or]sat;
astronomical: [adj]天文学的; [a]/ˌæstrəˈnɑːmɪkl/; [or]sat;
miscellany: [n]混合物,混杂; [a]/ˈmɪsəleɪni/; [or]sat;
negate: [vt]取消,使无效;否定,否认; [n]反面,对立面; [vi]否定,否认; [a]/nɪˈɡeɪt/; [or]sat;
doctrine: [n]教条,学说,信条,原则; [a]/ˈdɑːktrɪn/; [or]sat;
recipient: [n]接受者;容器;间接宾语; [adj]接受的;善于接受的;接受能力强的; [a]/rɪˈsɪpiənt/; [or]sat;
potable: [adj]适于饮用的; [n]饮料; [a]/ˈpoʊtəbl/; [or]sat;
artifice: [n]诡计;欺骗;巧妙的办法; [a]/ˈɑːrtɪfɪs/; [or]sat;
bolt: [n]门栓,螺栓;闪电;弩箭; [v]闩门;(马受惊)脱缰; [adv]突然地;像箭似地;直立地; [a]/boʊlt/; [or]sat;
scourge: [n]鞭笞,磨难,带来灾难的事物或人(祸害); [v]鞭笞,折磨,使苦恼; [a]/skɜːrdʒ/; [or]sat;
lull: [v]使平静,使安静,哄骗; [n]间歇,暂停,暂时平静; [a]/lʌl/; [or]sat;
spurious: [adj]假的,伪造的,欺骗的; [a]/ˈspjʊriəs/; [or]sat;
agility: [n]敏捷;灵活; [a]/əˈdʒɪləti/; [or]sat;
presumptuous: [adj]专横的,自以为是的,冒昧的; [adv]自以为是地,专横地,冒失地; [n]自以为是,专横,冒失; [a]/prɪˈzʌmptʃuəs/; [or]sat;
parochial: [adj]教区的;地方范围的; [a]/pəˈroʊkiəl/; [or]sat;
devout: [adj]虔诚的,真挚的,诚恳的; [n]虔诚;真挚,诚恳; [a]/dɪˈvaʊt/; [or]sat;
portent: [n]征兆,预兆;迹象; [a]/ˈpɔːrtent/; [or]sat;
compromise: [n]妥协;折中; [v]妥协;使遭受危害; [a]/ˈkɑːmprəmaɪz/; [or]sat;
terminology: [n]术语,术语学; [a]/ˌtɜːrməˈnɑːlədʒi/; [or]sat;
timidity: [n]胆怯; [a]/tɪˈmɪdəti/; [or]sat;
comeuppance: [n]应得的惩罚,因果报应; [a]/kʌmˈʌpəns/; [or]sat;
disseminate: [v]宣传,传播;散布; [a]/dɪˈsemɪneɪt/; [or]sat;
saunter: [n]漫步,闲逛; [v]闲逛,漫步; [a]/ˈsɔːntər/; [or]sat;
impending: [adj]即将到来的;迫在眉睫的,紧急的; [a]/ɪmˈpendɪŋ/; [or]sat;
exhaustive: [adj]详尽的;彻底的;消耗的; [a]/ɪɡˈzɔːstɪv/; [or]sat;
eddy: [n]漩涡; [v]旋转;起漩涡; [a]/ˈedi/; [or]sat;
stipend: [n]奖学金;固定薪金;定期津贴;养老金; [a]/ˈstaɪpend/; [or]sat;
reminiscence: [n]回忆,怀旧,引起联想的相似事物; [a]/ˌremɪˈnɪsns/; [or]sat;
sheer: [adj]陡峭的;纯粹的; [v](off)急转向,偏离; [n]透明薄纱,透明布料的衣服; [adv]完全地,全然;垂直地,陡峭地; [a]/ʃɪr/; [or]sat;
slur: [n]含糊的发音,藐视,污点,连线符; [vi]含糊地说; [vt]对.忽略,含糊不清地说出,贬低; [a]/slɜːr/; [or]sat;
ostracize: [v]放逐,排斥,(古希腊)按贝壳流放法放逐; [a]/ˈɑːstrəsaɪz/; [or]sat;
embroil: [v]使卷入;使混乱; [a]/ɪmˈbrɔɪl/; [or]sat;
reprobate: [n]混蛋,恶棍; [adj]邪恶的;堕落的; [v]谴责,指责; [a]/ˈreprəbeɪt/; [or]sat;
anguish: [n]痛苦;苦恼; [v]感到极度痛苦; [a]/ˈæŋɡwɪʃ/; [or]sat;
erudite: [adj]博学的,有学问的; [n]饱学之士,有学问的人; [a]/ˈerudaɪt/; [or]sat;
nomenclature: [n]术语,命名系统; [a]/ˈnoʊmənkleɪtʃər/; [or]sat;
hoodwink: [v]欺骗,遮眼,蒙蔽; [a]/ˈhʊdwɪŋk/; [or]sat;
potent: [adj]强有力的;有权势的;有说服力的; [a]/ˈpoʊtnt/; [or]sat;
transitory: [adj]短暂的,暂时的,瞬息的; [a]/ˈtrænsətɔːri/; [or]sat;
decipher: [n]密电译文; [vt]解释;破译; [a]/dɪˈsaɪfər/; [or]sat;
acute: [adj](疼痛,妒忌等)剧烈的,严重的;敏锐的;急性的;尖声的; [a]/əˈkjut/; [or]sat;
anthology: [n](诗,文,曲,画等的)选集; [a]/ænˈθɑːlədʒi/; [or]sat;
clairvoyant: [n]千里眼,透视眼;有洞察力的人; [adj]千里眼的;有洞察力的;透视的;有洞察力的; [a]/klerˈvɔɪənt/; [or]sat;
practical: [adj]实际的,实用的,实践的,切合实际的;〔人〕注重实际的,务实的;〔计划,方法等〕有效的,切实可行的;心灵手巧的; [n]实习课;实践课;实验考核; [a]/ˈpræktɪkl/; [or]sat;
insuperable: [adj]难以克服的,无敌的; [a]/ɪnˈsuːpərəbl/; [or]sat;
badger: [n]獾;獾皮毛; [v]纠缠;烦扰(反复提提出问题或要求); [a]/ˈbædʒər/; [or]sat;
epic: [adj]史诗的,叙事诗的;壮丽的,宏大的; [n]史诗;叙事诗;史诗般的作品; [a]/ˈepɪk/; [or]sat;
rile: [v]刺激,惹怒; [a]/raɪl/; [or]sat;
rejoinder: [n]回答,反驳,第二次答辩; [a]/rɪˈdʒɔɪndər/; [or]sat;
discredit: [v]使不相信,使怀疑;败坏.的名声; [n]丧失信誉,丧失名誉;败坏名声的人或事,耻辱; [a]/dɪsˈkredɪt/; [or]sat;
virus: [n]病毒;(计算机) 病毒;病毒性疾病; [a]/ˈvaɪrəs/; [or]sat;
ascertain: [v]探知,弄清,查明(真相等); [a]/ˌæsərˈteɪn/; [or]sat;
malefactor: [n]罪犯,犯人; [a]/ˈmælɪfæktər/; [or]sat;
harbor: [n]海港;港口;避风港; [v]庇护;藏匿;心怀(怨恨等); [a]/'hɑːbə/; [or]sat;
mediocre: [adj]普通的;平凡的;中等的; [a]/ˌmiːdiˈoʊkər/; [or]sat;
compliance: [n]遵守,依从;承诺,答应; [a]/kəmˈplaɪəns/; [or]sat;
vilify: [v]辱骂,诽谤; [a]/ˈvɪlɪfaɪ/; [or]sat;
suture: [n]缝合; [v]缝合; [a]/ˈsuːtʃər/; [or]sat;
transmute: [v]使改变,使变形; [a]/trænzˈmjuːt/; [or]sat;
recast: [v]重建; [a]/ˌriːˈkæst/; [or]sat;
slough: [n](蛇等)蜕皮,要脱落或抛弃的东西,绝境; [v](蛇等)蜕皮,陷入泥沼,顽强地前进; [a]/slʌf/; [or]sat;
passive: [adj]被动的;消极的; [n]被动语态; [a]/ˈpæsɪv/; [or]sat;
aptitude: [n]天资;自然倾向;适宜; [a]/ˈæptɪtuːd/; [or]sat;
acumen: [n]聪明,敏锐; [a]/ˈækjəmən/; [or]sat;
ferret: [n]雪貂;白鼬;侦探; [v]搜寻;查获;驱出;用雪貂猎取; [adj]雪貂似的;搜索者般的;爱窥探的; [a]/ˈferɪt/; [or]sat;
cadaverous: [adj]像尸体的,(形容)枯槁的; [a]/kəˈdævərəs/; [or]sat;
shirk: [v]逃避;规避(义务,责任等); [n]偷懒者; [a]/ʃɜːrk/; [or]sat;
topography: [n]地形学;地形,地貌;局部解剖学;地形图,地势图; [a]/təˈpɑːɡrəfi/; [or]sat;
amorous: [adj]容易动情的,情爱的; [a]/ˈæmərəs/; [or]sat;
paraphrase: [v]解释,释义; [n]转述,释义; [a]/ˈpærəfreɪz/; [or]sat;
farce: [n]闹剧;胡闹;笑剧; [a]/fɑːrs/; [or]sat;
shun: [v](有意或习惯性地)避开,躲开; [a]/ʃʌn/; [or]sat;
nirvana: [n]涅槃,心灵的平静,极乐; [a]/nɪrˈvɑːnə/; [or]sat;
clasp: [v]握紧;扣紧;扣住;抱紧; [n]扣子;钩子;紧抱;紧握; [a]/klæsp/; [or]sat;
infer: [vt]做出推论,推断;推理;暗示; [vi]推断; [a]/ɪnˈfɜːr/; [or]sat;
brunt: [n]冲击,主要冲力; [a]/brʌnt/; [or]sat;
figurine: [n]小塑像,小雕像; [a]/ˌfɪɡjəˈriːn/; [or]sat;
spendthrift: [adj]挥霍无度的;浪费的; [n]挥霍无度的人;浪费的人; [a]/ˈspendθrɪft/; [or]sat;
practitioner: [n](医生或律师等)开业者;实践者,从事者; [a]/prækˈtɪʃənər/; [or]sat;
ravenous: [adj]贪婪的;渴望的,极饿的;狼吞虎咽的; [a]/ˈrævənəs/; [or]sat;
ungainly: [adj]笨拙的,不雅的; [adv]笨拙地;不雅地; [a]/ʌnˈɡeɪnli/; [or]sat;
claustrophobia: [n]幽闭恐怖症; [a]/ˌklɔːstrəˈfoʊbiə/; [or]sat;
Spartan: [adj]斯巴达式的,简朴的,刻苦的; [n]斯巴达人;勇士; [a]/ˈspɑːrtn/; [or]sat;
impotent: [adj]无力的,无能的,阳痿的; [n]虚弱者;阳痿者; [a]/ˈɪmpətənt/; [or]sat;
limpid: [adj]清澈的,透明的,平静的; [a]/ˈlɪmpɪd/; [or]sat;
sustain: [v]维持;支撑,承受;供养;忍受;遭受,蒙受; [a]/səˈsteɪn/; [or]sat;
retrench: [v]节省,削减;紧缩; [a]/rɪˈtrentʃ/; [or]sat;
censure: [v]责难,责备; [n]责难,责备; [a]/ˈsenʃər/; [or]sat;
expansive: [adj]广阔的,扩张的,豪爽的; [a]/ɪkˈspænsɪv/; [or]sat;
artifact: [n]人工制品;手工艺品; [a]/ˈɑːrtɪfækt/; [or]sat;
pummel: [v]击;打;用拳头连续揍; [a]/ˈpʌml/; [or]sat;
deadpan: [adj]面无表情的; [adv]面无表情地; [a]/ˈdedpæn/; [or]sat;
plumb: [n]铅锤,测锤; [vi]垂直悬挂; [adj]垂直的; [vt]用铅锤测量; [adv]垂直地; [a]/plʌm/; [or]sat;
generic: [n]无注册商标产品;通名; [adj]一般的;非商标的;属的,类的; [a]/dʒəˈnerɪk/; [or]sat;
dispatch: [v]派遣,调遣;发送(信件,电报等);结束,摆脱掉;匆匆办完; [vt]处决; [n]派遣,调遣;发送;快信,急件;迅速,敏捷; [a]/dɪˈspætʃ/; [or]sat;
giddy: [adj]眼花缭乱的,头晕的,轻率的; [v](使)眼花,(使)眩晕; [a]/ˈɡɪdi/; [or]sat;
pediatrician: [n]儿科医师(等于pediatrist); [a]/ˌpiːdiəˈtrɪʃn/; [or]sat;
trek: [n]艰苦跋涉; [v]拉(货车),搬运; [a]/trek/; [or]sat;
charisma: [n]魅力; [a]/kəˈrɪzmə/; [or]sat;
seamy: [adj]丑恶的,露出线缝的; [a]/ˈsiːmi/; [or]sat;
kernel: [n]子粒,谷粒;核心; [a]/ˈkɜːrnl/; [or]sat;
foment: [v]煽动,助长(坏事); [a]/foʊˈment/; [or]sat;
centigrade: [adj]百分度的;摄氏的; [n]摄氏度; [a]/ˈsentɪɡreɪd/; [or]sat;
sever: [vt]割断,断绝;分开;使分离; [vi]断;裂开;分离; [a]/ˈsevər/; [or]sat;
anesthetic: [n]麻醉剂,麻药; [adj]麻醉的,感觉缺失的; [a]/ˌænəs'θetɪk/; [or]sat;
pauper: [n]贫民,乞丐; [a]/ˈpɔːpər/; [or]sat;
warranty: [n]授权;根据;保证书;担保书,保单; [a]/ˈwɔːrənti/; [or]sat;
itinerary: [n]旅程,路线;旅行计划; [a]/aɪˈtɪnəreri/; [or]sat;
economy: [n]经济,经济制度;节约; [a]/ɪˈkɑːnəmi/; [or]sat;
gaffe: [n](社交上令人不快的)失言,失态,失礼; [a]/ɡæf/; [or]sat;
migratory: [adj]迁移的;流浪的; [a]/ˈmaɪɡrətɔːri/; [or]sat;
meager: [adj]瘦的;贫乏的;粗劣的;少量的; [a]/ˈmiːɡər/; [or]sat;
autocratic: [adj]独裁的,专断的; [a]/ˌɔːtəˈkrætɪk/; [or]sat;
Baroque: [adj]巴洛克式的,结构复杂的,形式怪样的; [n]巴洛克风格,巴洛克艺术; [a]/bəˈroʊk/; [or]sat;
preamble: [n]序文,电报报头,先兆; [v]作序言[绪论]; [a]/priˈæmbl/; [or]sat;
rig: [n]钻井架;装备;帆具;成套器械; [v]操纵;装配;欺骗; [a]/rɪɡ/; [or]sat;
cosmic: [adj]宇宙的;广大无边的; [a]/ˈkɑːzmɪk/; [or]sat;
rent: [n]租金; [v]租用,出租; [a]/rent/; [or]sat;
impious: [adj]不敬神的,不虔诚的,不孝的; [a]/ɪmˈpaɪəs/; [or]sat;
irreproachable: [adj]不可指责的;无过失的;无缺点的; [a]/ˌɪrɪˈproʊtʃəbl/; [or]sat;
canvass: [v]仔细检查或详尽地讨论;审查,游说; [n]讨论;细查;劝诱; [a]/ˈkænvəs/; [or]sat;
sinecure: [n]闲职,挂名职务; [a]/ˈsaɪnɪkjʊr/; [or]sat;
predilection: [n]偏好; [a]/ˌpredlˈekʃn/; [or]sat;
lexicographer: [n]词典编纂人; [a]/ˌleksɪˈkɑːɡrəfər/; [or]sat;
panegyric: [n]颂词,赞词; [a]/ˌpænəˈdʒɪrɪk/; [or]sat;
strut: [n]高视阔步,抗压装置; [v]昂首阔步地走,趾高气昂地走; [a]/strʌt/; [or]sat;
ordain: [v]注定;规定;任命(牧师);颁布命令; [a]/ɔːrˈdeɪn/; [or]sat;
appease: [v]抚慰;平息; [a]/əˈpiːz/; [or]sat;
corrosive: [adj]腐蚀的;腐蚀性的;蚀坏的; [n]腐蚀剂; [a]/kəˈroʊsɪv/; [or]sat;
disinter: [v]掘出;发掘;显露; [a]/ˌdɪsɪnˈtɜːr/; [or]sat;
archives: [n]档案室,档案; [a]/ˈɑːrkaɪvz/; [or]sat;
protract: [v]绘制;延长;伸展; [a]/proʊ'trækt/; [or]sat;
ruthless: [adj]无情的;残忍的; [a]/ˈruːθləs/; [or]sat;
acrimonious: [adj]严厉的;辛辣的;刻薄的; [a]/ˌækrɪˈmoʊniəs/; [or]sat;
peremptory: [adj]专横的,不容反抗的; [a]/pəˈremptəri/; [or]sat;
impale: [v]刺穿,刺住; [a]/ɪmˈpeɪl/; [or]sat;
automaton: [n]自动机;机器人; [a]/ɔːˈtɑːmətən/; [or]sat;
acquittal: [n]宣告无罪,开释; [a]/əˈkwɪtl/; [or]sat;
missive: [n]公文,公函; [adj]送出的; [a]/ˈmɪsɪv/; [or]sat;
zephyr: [n]和风,西风; [a]/ˈzefər/; [or]sat;
mawkish: [adj]令人厌恶的,伤感的; [a]/ˈmɔːkɪʃ/; [or]sat;
symmetry: [n]对称;均衡; [a]/ˈsɪmətri/; [or]sat;
marshal: [v]整理,排列,集结; [n]元帅;司仪,主持人; [a]/ˈmɑːrʃl/; [or]sat;
importune: [v]强求,胡搅蛮缠; [adj]同"importunate"; [a]/ˌɪmpɔːrˈtuːn/; [or]sat;
nonentity: [n]不存在,虚无;无能力之人,无足轻重的人; [a]/nɑːˈnentəti/; [or]sat;
impugn: [v]指责,对.表示怀疑; [a]/ɪmˈpjuːn/; [or]sat;
skiff: [n]小艇;小型帆船;轻舟; [a]/skɪf/; [or]sat;
repulsion: [n]排斥;厌恶;反驳; [a]/rɪˈpʌlʃn/; [or]sat;
exigency: [n]紧急(状态);危急(关头);事变; [a]/ˈeksɪdʒənsi/; [or]sat;
host: [n]东道主,主持人;大量; [v]主持,主办; [a]/hoʊst/; [or]sat;
dulcet: [adj]美妙的;悦耳的;怡人的; [a]/ˈdʌlsɪt/; [or]sat;
malady: [n]疾病,弊病; [a]/ˈmælədi/; [or]sat;
rout: [v]击溃;搜寻; [n]溃败;暴动; [a]/raʊt/; [or]sat;
apprehend: [vt]理解,领会;逮捕;对.忧虑;把.视作; [vi]忧虑; [a]/ˌæprɪˈhend/; [or]sat;
arcane: [adj]神秘的;秘传的;晦涩难解的; [a]/ɑːrˈkeɪn/; [or]sat;
impasse: [n]僵局;死路; [a]/ˈɪmpæs/; [or]sat;
flaunt: [n]招摇;飘扬;藐视; [vi]炫耀;飘扬; [vt]炫耀; [a]/flɔːnt/; [or]sat;
quarantine: [v]检疫;隔离;使隔离; [n]检疫;隔离;检疫期;封锁; [a]/ˈkwɔːrəntiːn/; [or]sat;
propitiate: [v]讨好,抚慰; [a]/prəˈpɪʃieɪt/; [or]sat;
nepotism: [n]偏袒的人(亲戚); [a]/ˈnepətɪzəm/; [or]sat;
diurnal: [adj]白天的;每日的;日间活动的; [a]/daɪˈɜːrnl/; [or]sat;
intrinsic: [adj]固有的; [a]/ɪnˈtrɪnsɪk/; [or]sat;
dwarf: [n]侏儒; [v]变矮;发育不全; [adj]矮生动物或植物的;矮小的;发育不全的; [vt]使矮小;阻碍.的发育; [a]/dwɔːrf/; [or]sat;
demise: [n]死亡,终结; [a]/dɪˈmaɪz/; [or]sat;
rivulet: [n]小溪,小河; [a]/ˈrɪvjələt/; [or]sat;
inclusive: [adj]包含..在内的,包罗广泛的; [a]/ɪnˈkluːsɪv/; [or]sat;
valor: [n]勇猛,英勇; [a]/'vælə/; [or]sat;
hazy: [adj]朦胧的,烟雾弥漫的,模糊的; [a]/ˈheɪzi/; [or]sat;
garish: [adj]炫耀的;过分装饰的;过分鲜艳的; [a]/ˈɡerɪʃ/; [or]sat;
execrable: [adj]极坏的; [a]/ˈeksɪkrəbl/; [or]sat;
impertinent: [adj]不恰当的,粗鲁的; [a]/ɪmˈpɜːrtnənt/; [or]sat;
threadbare: [adj]磨破的,衣衫褴褛的,乏味的,俗套的; [a]/ˈθredber/; [or]sat;
arcade: [n]拱廊;有拱廊的街道;游乐场所,游戏厅; [a]/ɑːrˈkeɪd/; [or]sat;
indignation: [n]愤慨; [a]/ˌɪndɪɡˈneɪʃn/; [or]sat;
inter: [v]埋葬; prep. 在内; [a]/ɪnˈtɜːr/; [or]sat;
muddle: [n]混乱,杂乱,(头脑的)糊涂; [v](使)混乱,(使)迷惑,混淆; [adj]引起困惑的;使人糊涂的;难以理解的; [a]/ˈmʌdl/; [or]sat;
pulverize: [v]粉碎;使成粉末;彻底击败;彻底毁坏; [a]/ˈpʌlvəraɪz/; [or]sat;
affirmation: [n]肯定;断言;主张; [a]/ˌæfərˈmeɪʃn/; [or]sat;
marked: [adj]有记号的;显著的;被监视的;引人注目的; [v]作记号; [a]/mɑːrkt/; [or]sat;
physiological: [adj]生理的,生理学的; [a]/ˌfɪziəˈlɑːdʒɪkl/; [or]sat;
fatuous: [adj]愚昧而不自知的; [a]/ˈfætʃuəs/; [or]sat;
accentuate: [v]强调;重读; [a]/əkˈsentʃueɪt/; [or]sat;
problematic: [adj]问题的;有疑问的;不确定的; [a]/ˌprɑːbləˈmætɪk/; [or]sat;
primp: [v]精心打扮;装饰; [a]/prɪmp/; [or]sat;
restitution: [n]归还,赔偿; [a]/ˌrestɪˈtuːʃn/; [or]sat;
grudging: [adj]勉强的,吝啬的; [a]/ˈɡrʌdʒɪŋ/; [or]sat;
complaisant: [adj]彬彬有礼的,殷勤的,柔顺的; [a]/kəmˈpleɪzənt/; [or]sat;
frolicsome: [adj]快活的;爱闹着玩的; [a]/ˈfrɑːlɪksəm/; [or]sat;
convex: [adj]中凸的;凸圆的;凸面的; [n]凸面体;凸状; [a]/ˈkɑːnveks/; [or]sat;
vagabond: [n]流浪者; [v]漂泊,流浪; [adj]流浪的,流浪者的,漂泊的; [a]/ˈvæɡəbɑːnd/; [or]sat;
dissent: [v]不同意;不信奉国教; [n]异议;(大写)不信奉国教; [a]/dɪˈsent/; [or]sat;
caprice: [n]任性,反复无常,随想曲; [a]/kəˈpriːs/; [or]sat;
incriminate: [v]控告,暗示..有罪; [a]/ɪnˈkrɪmɪneɪt/; [or]sat;
agent: [n]政府特工;代理商,代理人; [a]/ˈeɪdʒənt/; [or]sat;
plight: [n]困境; [v]宣誓,保证; [a]/plaɪt/; [or]sat;
allege: [v]断言;硬说; [a]/əˈledʒ/; [or]sat;
improvise: [v]即席创作,临时凑成; [a]/ˈɪmprəvaɪz/; [or]sat;
renegade: [n]叛教者,脱党者,叛徒; [v]背叛,背教,变节; [adj]叛教的,背叛的,变节的; [a]/ˈrenɪɡeɪd/; [or]sat;
innovative: [adj]创新的,革新的; [a]/ˈɪnəveɪtɪv/; [or]sat;
entomology: [n]昆虫学; [a]/ˌentəˈmɑːlədʒi/; [or]sat;
papyrus: [n]纸莎草;纸莎草纸; [a]/pəˈpaɪrəs/; [or]sat;
prude: [n]过分守礼的人,故作正经的人; [a]/pruːd/; [or]sat;
redolent: [adj]气味强烈的,芬芳的,令人想起..的; [a]/ˈredələnt/; [or]sat;
enunciate: [v]发音,阐明,宣布; [a]/əˈnʌnsieɪt/; [or]sat;
aloft: [adv]在空中,在高处,在上面; prep. 在 ... 上; [a]/əˈlɔːft/; [or]sat;
corollary: [n]推论;必然的结果; [a]/ˈkɔːrəleri/; [or]sat;
inviolable: [adj]神圣的;不可侵犯的,不可亵渎的;不可违背的; [a]/ɪnˈvaɪələbl/; [or]sat;
saturate: [v]使充满,使饱和,使湿透; [a]/ˈsætʃəreɪt/; [or]sat;
cumbersome: [adj]笨重的;麻烦的; [a]/ˈkʌmbərsəm/; [or]sat;
muggy: [adj](天气)闷热而潮湿的; [a]/ˈmʌɡi/; [or]sat;
realm: [n]王国;领域;国土; [a]/relm/; [or]sat;
anomaly: [n]异常,不规则,反常事物; [a]/əˈnɑːməli/; [or]sat;
retaliation: [n]反击;回敬;报复; [a]/rɪˌtæliˈeɪʃn/; [or]sat;
nominal: [adj]名义上的;象征性的,很少的;名词性的; [a]/ˈnɑːmɪnl/; [or]sat;
eschew: [v]避开;戒绝; [a]/ɪsˈtʃuː/; [or]sat;
enfranchise: [v]给予选举权,释放(奴隶); [a]/ɪnˈfræntʃaɪz/; [or]sat;
recrimination: [n]反责,反控,揭丑; [a]/rɪˌkrɪmɪˈneɪʃn/; [or]sat;
retort: [v]反驳; [n]反驳,反击,回嘴; [a]/rɪˈtɔːrt/; [or]sat;
array: [n]一系列;陈列;编队; [v]排列;部署; [a]/əˈreɪ/; [or]sat;
annul: [v]取消,废除,宣告无效; [a]/əˈnʌl/; [or]sat;
amorphous: [adj]无定形的;无组织的;[物]非晶形的; [a]/əˈmɔːrfəs/; [or]sat;
assert: [v]断言;肯定地说;坚持;维护; [a]/əˈsɜːrt/; [or]sat;
gregarious: [adj]群居的,爱社交的; [a]/ɡrɪˈɡeriəs/; [or]sat;
indignity: [n]侮辱,有伤尊严,无礼举动; [a]/ɪnˈdɪɡnəti/; [or]sat;
nascent: [adj]初生的,萌芽的;发生中的; [a]/ˈnæsnt/; [or]sat;
elegy: [n]挽歌,哀歌; [a]/ˈelədʒi/; [or]sat;
aphasia: [n]失语症; [a]/əˈfeɪziə/; [or]sat;
convoluted: [adj]旋绕的,费解的; [a]/ˈkɑːnvəluːtɪd/; [or]sat;
slither: [v](蛇)滑动,滑行; [n]滑动;滑行; [a]/ˈslɪðər/; [or]sat;
galvanize: [v]镀锌,通电,刺激; [a]/ˈɡælvənaɪz/; [or]sat;
affluence: [n]丰富,富裕,流入; [a]/ˈæfluəns/; [or]sat;
expletive: [n]填补物;咒骂语; [adj]附加的;填补的; [a]/ˈeksplətɪv/; [or]sat;
merger: [n](企业等的)合并;并购;吸收(如刑法中重罪吸收轻罪); [a]/ˈmɜːrdʒər/; [or]sat;
dowdy: [adj]懒散的,过时的,寒酸的; [n]邋遢女人; [a]/ˈdaʊdi/; [or]sat;
loathe: [v]憎恨,厌恶; [a]/loʊð/; [or]sat;
sinewy: [adj]多腱的,强壮有力的; [a]/ˈsɪnjuːi/; [or]sat;
cessation: [n]停止,中止,中断; [a]/seˈseɪʃn/; [or]sat;
interim: [n]中间时期,过渡时期; [adj]暂时的; [a]/ˈɪntərɪm/; [or]sat;
humdrum: [adj]单调的;乏味的; [n]平凡;单调; [vi]单调乏味地进行; [a]/ˈhʌmdrʌm/; [or]sat;
raucous: [adj](声音)沙哑的,刺耳的,吵闹的; [a]/ˈrɔːkəs/; [or]sat;
balm: [n]香油,止痛膏,安慰物,香气; [a]/bɑːm/; [or]sat;
graft: [n]嫁接;嫁接株;移植; [vi]接枝; [vt]将.嫁接;移植(器官); [a]/ɡræft/; [or]sat;
retrospective: [adj]回顾的;怀旧的;可追溯的; [n]作品回顾展出; [a]/ˌretrəˈspektɪv/; [or]sat;
converge: [v](向某一点)相交,会合;汇集,聚集,集中; [a]/kənˈvɜːrdʒ/; [or]sat;
indigenous: [adj]土生土长的,本土的; [a]/ɪnˈdɪdʒənəs/; [or]sat;
retinue: [n]侍从,随员; [a]/ˈretənuː/; [or]sat;
universal: [adj]普遍存在的;全体的;通用的;宇宙的; [n]普遍原则; [a]/ˌjuːnɪˈvɜːrsl/; [or]sat;
smirk: [n]傻笑;假笑;得意的笑; [vi]傻笑;假笑; [vt]以假笑表示;以傻笑表示; [a]/smɜːrk/; [or]sat;
deride: [v]嘲弄,愚弄; [a]/dɪˈraɪd/; [or]sat;
quaint: [adj]精巧的;古雅的; [a]/kweɪnt/; [or]sat;
prowess: [n]勇敢,不凡的能力;超凡技术; [a]/ˈpraʊəs/; [or]sat;
bask: [vi]晒太阳(享受温暖),感到温暖,愉快或舒适; [n]晒太阳,取暖;沉浸于; [a]/bæsk/; [or]sat;
demolition: [n]拆除(等于demolishment);破坏,毁坏; [a]/ˌdeməˈlɪʃn/; [or]sat;
allegiance: [n]忠诚,拥护; [a]/əˈliːdʒəns/; [or]sat;
winsome: [adj]迷人的;可爱的;漂亮的; [a]/ˈwɪnsəm/; [or]sat;
waffle: [n]华夫饼干;动听而无意义的话;无聊话; [v]胡扯,含糊其辞; [a]/ˈwɑːfl/; [or]sat;
reaper: [n]收割者;收割机; [a]/ˈriːpər/; [or]sat;
acquire: [v](尤指靠自己的努力或行动或经过一个过程)获得;学到;取得; [a]/əˈkwaɪər/; [or]sat;
accelerate: [v]加速,增长;使增速,促进; [a]/əkˈseləreɪt/; [or]sat;
civil: [adj]公民的,民用的;国内的;有礼貌的,客气的; [a]/ˈsɪvl/; [or]sat;
concentric: [adj]同中心的; [adv]同一中心地;同轴地; [a]/kənˈsentrɪk/; [or]sat;
despondent: [adj]失望的,意气消沉的,没有精神的; [a]/dɪˈspɑːndənt/; [or]sat;
frantic: [adj]疯狂的;狂乱的;慌乱的; [a]/ˈfræntɪk/; [or]sat;
marsupial: [n]有袋哺乳动物(袋鼠,袋熊,袋狼); [a]/mɑːrˈsuːpiəl/; [or]sat;
jovial: [adj]天性快活的,主神朱庇特的; [n]左威尔牌手表; [a]/ˈdʒoʊviəl/; [or]sat;
lugubrious: [adj]闷闷不乐的;郁郁寡欢的,悲哀的; [a]/ləˈɡuːbriəs/; [or]sat;
distant: [adj]遥远的;远方的;疏远的; [a]/ˈdɪstənt/; [or]sat;
prevalent: [adj]普遍的,流行的; [a]/ˈprevələnt/; [or]sat;
unequivocal: [adj]明确的,不含糊的; [a]/ˌʌnɪˈkwɪvəkl/; [or]sat;
elucidate: [v]阐明,说明; [a]/iˈluːsɪdeɪt/; [or]sat;
gale: [n]狂风,一阵(笑声); [a]/ɡeɪl/; [or]sat;
sinuous: [adj]弯曲的,蜿蜒的; [a]/ˈsɪnjuəs/; [or]sat;
noxious: [adj]有害的,有毒的; [a]/ˈnɑːkʃəs/; [or]sat;
periphery: [n]外围,不重要的部份; [a]/pəˈrɪfəri/; [or]sat;
wake: [v]醒来,使觉醒;激发,引起; [n]守灵,守夜;(船航过时的)尾波;年度假期; [a]/weɪk/; [or]sat;
impenitent: [adj]不悔悟的; [a]/ɪmˈpenɪtənt/; [or]sat;
cartographer: [n]制图师;地图制作者; [a]/kɑːrˈtɑːɡrəfər/; [or]sat;
adept: [n]专家,能手; [adj]熟练的;巧妙的; [a]/əˈdept/; [or]sat;
depose: [v]免职,废黜,作证; [a]/dɪˈpoʊz/; [or]sat;
permeable: [adj]可渗透的;可穿透的; [a]/ˈpɜːrmiəbl/; [or]sat;
dispassionate: [adj]平心静气的,不带感情的; [a]/dɪsˈpæʃənət/; [or]sat;
grandiloquent: [adj](语言等)夸张的,夸大的; [a]/ɡrænˈdɪləkwənt/; [or]sat;
obese: [adj]肥胖的;过胖的; [a]/oʊˈbiːs/; [or]sat;
tortuous: [adj]弯弯曲曲的,蜿蜒的; [a]/ˈtɔːrtʃuəs/; [or]sat;
cohesion: [n]凝聚,凝聚力;结合;[力]内聚力; [a]/koʊˈhiːʒn/; [or]sat;
lethargic: [adj]困倦的,无力的,无兴趣的; [a]/ləˈθɑːrdʒɪk/; [or]sat;
invert: [v]倒置;倒转;颠倒; [a]/ɪnˈvɜːrt/; [or]sat;
labyrinth: [n]迷宫; [a]/ˈlæbərɪnθ/; [or]sat;
humility: [n]谦逊,谦恭; [a]/hjuːˈmɪləti/; [or]sat;
shoddy: [adj]劣等的;假的;冒充的;虚有其表的; [n]赝品,不值钱的东西; [a]/ˈʃɑːdi/; [or]sat;
nadir: [n]最低点,无底; [a]/ˈneɪdɪr/; [or]sat;
iridescent: [adj]彩虹色的;闪光的,闪色的; [a]/ˌɪrɪˈdesnt/; [or]sat;
fray: [n]吵架,打斗,磨损处; [v]磨损,摩擦,使关系紧张; [a]/freɪ/; [or]sat;
equitable: [adj]公正的,公平的; [a]/ˈekwɪtəbl/; [or]sat;
resigned: [adj]逆来顺受的;已辞职的;已放弃的; [a]/rɪˈzaɪnd/; [or]sat;
knoll: [n]小圆丘,小山;土墩; [a]/noʊl/; [or]sat;
abstain: [v]戒掉(烟\酒等);避开;弃权; [a]/əbˈsteɪn/; [or]sat;
ambience: [n]气氛,环境,氛围; [a]/ˈæmbiəns/; [or]sat;
monotony: [n]单调乏味,无聊;无变化; [a]/məˈnɑːtəni/; [or]sat;
decapitate: [vt]将.斩首;把.强行解雇;使无效; [n]斩首,杀头;刽子手; [a]/dɪˈkæpɪteɪt/; [or]sat;
exorcise: [v]驱邪;除怪; [a]/ˈeksɔːrsaɪz/; [or]sat;
partition: [n]划分;隔开物,隔墙,隔板; [v]隔开; [vt]瓜分;分割; [a]/pɑːrˈtɪʃn/; [or]sat;
recuperate: [x] [v]恢复(健康),重新得到,复兴; [a]/rɪˈkuːpəreɪt/; [or]sat;
jurisprudence: [x] [n]法律学,法学,法律体系,法学分支; [a]/ˌdʒʊrɪsˈpruːdns/; [or]sat;
exhilarating: [x] [adj]令人高兴的; [v]使高兴;使兴奋; [a]/ɪɡˈzɪləreɪtɪŋ/; [or]sat;
subordinate: [x] [n]部下;下属; [adj]次要的;从属的;下级的; [v]使从属于;使处于次要地位; [a]/səˈbɔːrdɪnət/; [or]sat;
preen: [x] [v]打扮;用嘴整理;赞扬; [a]/priːn/; [or]sat;
discursive: [x] [adj](谈话内容)杂乱的,东拉西扯的,无层次的; [a]/dɪsˈkɜːrsɪv/; [or]sat;
colloquial: [x] [adj]口语的,白话的,通俗的,口语体; [a]/kəˈloʊkwiəl/; [or]sat;
cataclysm: [x] [n]灾难(常指大洪水或地震),剧变; [a]/ˈkætəklɪzəm/; [or]sat;
cavalcade: [x] [n]行列,队伍,骑兵队; [a]/ˌkævlˈkeɪd/; [or]sat;
tundra: [x] [n]冻土地带; [a]/ˈtʌndrə/; [or]sat;
substantive: [x] [adj]有实质的;大量的;真实的;独立存在的; [n]实词,名词,名词性词组; [a]/səbˈstæntɪv/; [or]sat;
protrude: [x] [v]伸出,突出,凸出; [a]/proʊˈtruːd/; [or]sat;
insolvent: [x] [n]无力清偿债务者,破产者; [adj]无清偿能力的,破产的; [a]/ɪnˈsɑːlvənt/; [or]sat;
amplify: [x] [v]放大(声音等);扩大;增强;详述;进一步阐述; [a]/ˈæmplɪfaɪ/; [or]sat;
murky: [x] [adj]黑暗的,朦胧的; [adv]阴暗地,混浊地,可疑地; [n]阴暗;昏暗;混浊;可疑; [a]/ˈmɜːrki/; [or]sat;
abbreviate: [x] [v]缩写,使省略,使用缩写词; [n]使用缩写词的人;缩短,缩写(词,短语,名字,名称); [a]/əˈbriːvieɪt/; [or]sat;
furlough: [x] [n](军人,官吏的)休假;暂时解雇;放假; [v]准假;暂时解雇; [a]/ˈfɜːrloʊ/; [or]sat;
sultry: [x] [adj]闷热的,狂暴的,淫荡的; [a]/ˈsʌltri/; [or]sat;
sedate: [x] [adj]沉着的,镇定的,平和的; [v]使服镇静剂而安静下来; [a]/sɪˈdeɪt/; [or]sat;
inimitable: [x] [adj]独特的,无比的,无法仿效的; [a]/ɪˈnɪmɪtəbl/; [or]sat;
mannered: [x] [adj]装模作样的,矫揉造作的,墨守成规的,中规中矩的; [a]/ˈmænərd/; [or]sat;
sagacious: [x] [adj]有洞察力的,有远见的,精明的,敏锐的; [a]/səˈɡeɪʃəs/; [or]sat;
abyss: [x] [n]深渊;深不可测的事物,绝境;深海;深邃;炼狱; [a]/əˈbɪs/; [or]sat;
supplicate: [x] [v]恳求,乞求; [a]/'sʌplɪˌkeɪt/; [or]sat;
galaxy: [x] [n]星系; [a]/ˈɡæləksi/; [or]sat;
phenomena: [x] [n]现象; [a]/fə'nɒmɪnə/; [or]sat;
exorbitant: [x] [adj]要价过高的,过分的; [a]/ɪɡˈzɔːrbɪtənt/; [or]sat;
equine: [x] [adj]马的;似马的;马科的; [n]马;马科动物; [a]/ˈiːkwaɪn/; [or]sat;
reserve: [x] [n]储备;保留;保护区; [v]保留;预定;储备; [a]/rɪˈzɜːrv/; [or]sat;
gruesome: [x] [adj]阴森的;可怕的; [a]/ˈɡruːsəm/; [or]sat;
foible: [x] [n]弱点,小缺点,癖好; [a]/ˈfɔɪbl/; [or]sat;
raspy: [x] [adj]声音沙哑的,容易生气的; [a]/ˈræspi/; [or]sat;
bane: [x] [n]祸根; [a]/beɪn/; [or]sat;
pantomime: [x] [n]哑剧,〈英〉(圣诞节上演的)童话剧; [vi]打手势,演哑剧; [a]/ˈpæntəmaɪm/; [or]sat;
posthumous: [x] [adj]遗腹的;著作者死后出版的;死后的; [a]/ˈpɑːstʃəməs/; [or]sat;
maim: [x] [v]使残废; [a]/meɪm/; [or]sat;
ventriloquist: [x] [n]口技表演者; [a]/venˈtrɪləkwɪst/; [or]sat;
travesty: [x] [n]滑稽模仿;拙劣的模仿作品;歪曲; [vt]滑稽地模仿;歪曲; [a]/ˈtrævəsti/; [or]sat;
denizen: [x] [n]居民,外籍居民; [a]/ˈdenɪzn/; [or]sat;
pecuniary: [x] [adj]金钱(上)的; [a]/pɪˈkjuːnieri/; [or]sat;
notable: [x] [n]著名人士; [adj]值得注意的,显著的,显要的; [a]/ˈnoʊtəbl/; [or]sat;
demoniac: [x] [n]着魔的人; [adj]魔鬼的;着魔的; [a]/dɪˈmoʊnɪæk/; [or]sat;
glimmer: [x] [n]微光;闪光;少许; [v]闪烁;发微光; [a]/ˈɡlɪmər/; [or]sat;
buttress: [x] [n]扶墙,拱壁; [v]支持; [a]/ˈbʌtrəs/; [or]sat;
maelstrom: [x] [n]大漩涡;灾祸;不可抗的破坏力; [a]/ˈmeɪlstrɑːm/; [or]sat;
indicative: [x] [adj]指示的;暗示的;陈述的; [n]陈述语气; [a]/ɪnˈdɪkətɪv/; [or]sat;
renovate: [x] [v]更新,修复; [adj]恢复的,革新的,翻新的; [a]/ˈrenəveɪt/; [or]sat;
incense: [x] [n]焚香时的烟,香味; [v]激怒; [a]/ˈɪnsens/; [or]sat;
ductile: [x] [adj](某些金属)有延展性的;可塑的;易受影响的; [a]/ˈdʌktaɪl/; [or]sat;
legacy: [x] [n]遗赠(物);遗产; [a]/ˈleɡəsi/; [or]sat;
euphonious: [x] [adj]悦耳的;好听的;声音和谐的; [a]/juːˈfoʊniəs/; [or]sat;
cadence: [x] [n](声音的)抑扬顿挫;韵律; [vt]使有节奏; [a]/ˈkeɪdns/; [or]sat;
animus: [x] [n]憎恨,敌意; [a]/ˈænɪməs/; [or]sat;
amicable: [x] [adj]友善的,温和的,平心静气的; [a]/ˈæmɪkəbl/; [or]sat;
faction: [x] [n]派别,小集团,小派系;派系斗争,内讧; [a]/ˈfækʃn/; [or]sat;
inflated: [x] [adj]通货膨胀的,充了气的,价格飞涨的,(植物)肿胀的; [a]/ɪnˈfleɪtɪd/; [or]sat;
demure: [x] [adj]严肃的;端庄的,娴静的;假装正直的; [a]/dɪˈmjʊr/; [or]sat;
tyranny: [x] [n]暴政,苛政,虐待; [a]/ˈtɪrəni/; [or]sat;
rue: [x] [v]后悔,遗憾; [a]/ruː/; [or]sat;
decelerate: [x] [v](使)减速; [a]/ˌdiːˈseləreɪt/; [or]sat;
invective: [x] [n]猛烈抨击,恶言漫骂; [adj]谩骂的;恶言的;诽谤的; [a]/ɪnˈvektɪv/; [or]sat;
salvage: [x] [n]抢救;从灾难中抢救出的物资; [vt]拯救;打捞; [a]/ˈsælvɪdʒ/; [or]sat;
guile: [x] [n]狡猾,诡计,欺诈; [a]/ɡaɪl/; [or]sat;
fallow: [x] [adj]休耕的;不活跃的;休闲地,休闲的; [n]休耕地;休耕; [v]使(翻耕后的土地)休闲; [a]/ˈfæloʊ/; [or]sat;
prominent: [x] [adj]突起的,显眼的;突出的,杰出的; [a]/ˈprɑːmɪnənt/; [or]sat;
inexorable: [x] [adj]不为所动的,坚决不变的; [n]坚定不移的人; [a]/ɪnˈeksərəbl/; [or]sat;
affidavit: [x] [n][法律]宣誓书,书面陈述; [a]/ˌæfəˈdeɪvɪt/; [or]sat;
intellect: [x] [n]智力,理解力;非凡的才智;才华出众的人; [a]/ˈɪntəlekt/; [or]sat;
resonant: [x] [adj]洪亮的,共振的,共鸣的; [a]/ˈrezənənt/; [or]sat;
rationale: [x] [n]基本原理;原理的阐述; [a]/ˌræʃəˈnæl/; [or]sat;
resentment: [x] [n]憎恨; [a]/rɪˈzentmənt/; [or]sat;
orientation: [x] [n]信仰;倾向;[计]定向;(学生)迎新会;定向,方向;(任职,上学等之前的) 情况介绍;训练; [a]/ˌɔːriənˈteɪʃn/; [or]sat;
entrance: [x] [n]入口,通道,大门口;出场,登场;进入权; [v]使出神,使入迷; [a]/ˈentrəns/; [or]sat;
debris: [x] [n]废墟,残骸; [a]/dəˈbriː/; [or]sat;
opportunist: [x] [n]机会主义者;投机取巧者; [adj]机会主义的;投机的;见风转舵的; [a]/ˌɑːpərˈtuːnɪst/; [or]sat;
scrutinize: [x] [v]仔细检查,细看; [a]/ˈskruːtənaɪz/; [or]sat;
equilibrium: [x] [n](心态情感等)平静;平衡; [a]/ˌiːkwɪˈlɪbriəm/; [or]sat;
kudos: [x] [n]荣誉;名望;称赞; [a]/ˈkuːdəʊs/; [or]sat;
sentinel: [x] [n]哨兵,看守; [v]守卫,放哨; [a]/ˈsentɪnl/; [or]sat;
progeny: [x] [n]子孙,后代,成果; [a]/ˈprɑːdʒəni/; [or]sat;
negligence: [x] [n]疏忽; [a]/ˈneɡlɪdʒəns/; [or]sat;
lionize: [x] [v]崇拜,把..奉为名人; [a]/ˈlaɪənaɪz/; [or]sat;
perforate: [x] [vt]穿孔于,打孔穿透;在.上打齿孔; [vi]穿过,贯穿;穿孔; [a]/ˈpɜːrfəreɪt/; [or]sat;
actuate: [x] [v]开动(机器);激励,驱使; [a]/ˈæktʃueɪt/; [or]sat;
peruse: [x] [v]详细考察;精读; [a]/pəˈruːz/; [or]sat;
skinflint: [x] [n]吝啬鬼; [a]/ˈskɪnflɪnt/; [or]sat;
adorn: [x] [v]装饰; [a]/əˈdɔːrn/; [or]sat;
rankle: [x] [v]怨恨,使痛苦,化脓; [a]/ˈræŋkl/; [or]sat;
incursion: [x] [n]入侵,侵犯; [a]/ɪnˈkɜːrʒn/; [or]sat;
grueling: [x] [n]惩罚,劳累; [adj]累垮人的,折磨人的; [a]/'gruːəlɪŋ/; [or]sat;
transport: [x] [v]运输;使狂喜;流放; [n]运输;运输工具;流放犯; [a]/ˈtrænspɔːrt/; [or]sat;
meticulous: [x] [adj]谨小慎微的;一丝不苟的; [a]/məˈtɪkjələs/; [or]sat;
swarm: [x] [n]蜂群;一群,一批人; [v]蜂拥;密集; [vt]蜂拥;挤满; [a]/swɔːrm/; [or]sat;
saccharine: [x] [adj]像糖一样的,有甜味的,做作的,矫情的; [a]/ˈsækəriːn/; [or]sat;
accrue: [x] [v](利息等)增大,增多; [a]/əˈkruː/; [or]sat;
entreat: [x] [v]恳求,请求; [a]/ɪnˈtriːt/; [or]sat;
vigor: [x] [n]生命力,活力; [a]/ˈvɪɡər/; [or]sat;
decadence: [x] [n]堕落,颓废;衰落; [a]/ˈdekədəns/; [or]sat;
larceny: [x] [n]盗窃; [a]/ˈlɑːrsəni/; [or]sat;
roster: [x] [n]值勤表,花名册; [v]将(姓名)列入值勤名单; [a]/ˈrɑːstər/; [or]sat;
penitent: [x] [adj]后悔的,忏悔的; [n]改过迁善的人;忏悔的人;悔罪者; [a]/ˈpenɪtənt/; [or]sat;
analgesic: [x] [n]镇痛药; [adj]止痛的; [a]/ˌænəlˈdʒiːzɪk/; [or]sat;
disinclination: [x] [n]不感兴趣,厌恶; [a]/ˌdɪsˌɪnklɪˈneɪʃn/; [or]sat;
onus: [x] [n]义务,责任,负担; [a]/ˈoʊnəs/; [or]sat;
pacifist: [x] [n]和平主义者; [adj]非战主义的; [a]/ˈpæsɪfɪst/; [or]sat;
temporal: [x] [adj]现世的,世俗的;当时的,暂时的;[解]颞的;时间的; [n]世间万物;教会财产; [a]/ˈtempərəl/; [or]sat;
spangle: [x] [n](缝在衣服上的)金属亮片;闪光装饰; [v]是闪烁发光;用闪光饰物装饰; [a]/ˈspæŋɡl/; [or]sat;
metaphor: [x] [n]暗喻,隐喻; [a]/ˈmetəfər/; [or]sat;
despoil: [x] [v]掠夺,剥夺;夺取; [a]/dɪˈspɔɪl/; [or]sat;
malodorous: [x] [adj]有恶臭的;令人极为反感的;不合法的; [a]/ˌmælˈoʊdərəs/; [or]sat;
aboriginal: [x] [adj]土著的,原来的; [n]土著居民; [a]/ˌæbəˈrɪdʒənl/; [or]sat;
prolific: [x] [adj]多育的,多产的;丰富的,富饶的; [a]/prəˈlɪfɪk/; [or]sat;
irrelevant: [x] [adj]不相关的; [a]/ɪˈreləvənt/; [or]sat;
countenance: [x] [n]面容,表情,气色; [v]支持,赞成; [a]/ˈkaʊntənəns/; [or]sat;
outskirts: [x] [n](尤指城市)郊区; [a]/ˈaʊtskɜːrts/; [or]sat;
epilogue: [x] [n]收场白;尾声; [a]/ˈepɪlɔːɡ/; [or]sat;
abjure: [x] [v]发誓放弃,公开放弃,避免; [a]/əbˈdʒʊr/; [or]sat;
conventional: [x] [adj]普通的,常规的;依照惯例的,依照传统的; [a]/kənˈvenʃənl/; [or]sat;
revulsion: [x] [n]剧变,厌恶,强烈反感; [a]/rɪˈvʌlʃn/; [or]sat;
affliction: [x] [n]苦恼,折磨;痛苦; [a]/əˈflɪkʃn/; [or]sat;
cleft: [x] [n]裂缝; [adj]分裂的;劈开的; [a]/kleft/; [or]sat;
enhance: [x] [v]提高(强度,力量,数量等);增加,加强; [a]/ɪnˈhæns/; [or]sat;
explicate: [x] [v]详细解说; [a]/ˈeksplɪkeɪt/; [or]sat;
verve: [x] [n]热情,神韵,活力,气魄; [a]/vɜːrv/; [or]sat;
presage: [x] [v]预示; [n]预感,不祥感,前兆,预言; [a]/ˈpresɪdʒ/; [or]sat;
ludicrous: [x] [adj]荒谬的,可笑的,滑稽的; [a]/ˈluːdɪkrəs/; [or]sat;
viscid: [x] [adj]黏的,黏质的; [a]/ˈvɪsɪd/; [or]sat;
pathos: [x] [n]悲怆,哀婉;痛苦; [a]/ˈpeɪθɑːs/; [or]sat;
abnegation: [x] [n]克制,自我克制,放弃; [a]/ˌæbnɪˈɡeɪʃn/; [or]sat;
bawdy: [x] [adj]说黄色笑话的;淫猥的,下流的; [a]/ˈbɔːdi/; [or]sat;
altercation: [x] [n]争吵,争论; [a]/ˌɔːltərˈkeɪʃn/; [or]sat;
coalition: [x] [n]结合;联盟;联合; [a]/ˌkoʊəˈlɪʃn/; [or]sat;
dynamic: [x] [adj]有活力的,有生气的;不断变化的;动态的; [n]活力,动力; [a]/daɪˈnæmɪk/; [or]sat;
bereft: [x] [adj]丧失的;被剥夺的;失去亲人的; [a]/bɪˈreft/; [or]sat;
oracular: [x] [adj]神谕的,意义模糊的,玄妙深奥的; [a]/əˈrækjələr/; [or]sat;
chide: [x] [v]叱责,指责; [a]/tʃaɪd/; [or]sat;
edict: [x] [n]法令,布告; [a]/ˈiːdɪkt/; [or]sat;
fetter: [x] [n]脚镣;束缚; [vt]给.上脚镣;束缚; [a]/ˈfetər/; [or]sat;
gadfly: [x] [n]牛虻,令人生厌的人; [a]/ˈɡædflaɪ/; [or]sat;
convert: [x] [v]可转变为,可变换成;改变,转变,转化;使改变信仰; [n]皈依者;改变宗教信仰者; [a]/kənˈvɜːrt/; [or]sat;
lackadaisical: [x] [adj]懒散的,无精打采的;无兴趣的;伤感的; [a]/ˌlækəˈdeɪzɪkl/; [or]sat;
advocacy: [x] [n]主张;拥护;辩护; [a]/ˈædvəkəsi/; [or]sat;
delve: [x] [v]钻研;探究;挖; [n]穴;洞; [a]/delv/; [or]sat;
sumptuous: [x] [adj]奢侈的;华丽的; [a]/ˈsʌmptʃuəs/; [or]sat;
tenure: [x] [n]任期;终身职位; [a]/ˈtenjər/; [or]sat;
plagiarism: [x] [n]剽窃,抄袭; [a]/ˈpleɪdʒərɪzəm/; [or]sat;
glib: [x] [adj]口齿伶俐的;油嘴滑舌的; [a]/ɡlɪb/; [or]sat;
slight: [x] [adj]轻微的,微小的;纤细的,瘦弱的;少量的; [n]轻视,蔑视; [vt]轻视,忽略; [a]/slaɪt/; [or]sat;
proselytize: [x] [v]使皈依; [a]/ˈprɑːsələtaɪz/; [or]sat;
theocracy: [x] [n]神权政治; [a]/θiˈɑːkrəsi/; [or]sat;
affected: [x] [adj]受到影响的,受(疾病)侵袭的;假装的,做作的; [a]/əˈfektɪd/; [or]sat;
methodical: [x] [adj]有系统的,有方法的; [a]/məˈθɑːdɪkl/; [or]sat;
puny: [x] [adj]弱小的,微不足道的; [a]/ˈpjuːni/; [or]sat;
retroactive: [x] [adj]追溯的;有追溯效力的;反动的; [a]/ˌretroʊˈæktɪv/; [or]sat;
ovation: [x] [n]热烈欢迎,欢呼; [a]/oʊˈveɪʃn/; [or]sat;
compress: [x] [v]压紧,压缩,压榨; [a]/kəmˈpres/; [or]sat;
celerity: [x] [n]快速,敏捷; [a]/sə'lerətɪ/; [or]sat;
cursive: [x] [n]草书;草书原稿; [adj]草书的;草书体的; [a]/ˈkɜːrsɪv/; [or]sat;
exacting: [x] [adj]苛求的,要求严格的,强索的; [a]/ɪɡˈzæktɪŋ/; [or]sat;
equivocal: [x] [adj]模棱两可的,不明确的,可疑的; [a]/ɪˈkwɪvəkl/; [or]sat;
forlorn: [x] [adj]被遗弃的; [a]/fərˈlɔːrn/; [or]sat;
perfunctory: [x] [adj]草率的,敷衍搪塞的; [a]/pərˈfʌŋktəri/; [or]sat;
chaste: [x] [adj]贞洁的;纯洁的;朴素的; [a]/tʃeɪst/; [or]sat;
preclude: [x] [v]阻止;排除; [a]/prɪˈkluːd/; [or]sat;
timorous: [x] [adj]胆小的,胆怯的,羞怯的; [a]/ˈtɪmərəs/; [or]sat;
malevolent: [x] [adj]有恶意的,恶毒的; [a]/məˈlevələnt/; [or]sat;
diversity: [x] [n]多样性,差异,分集; [a]/daɪˈvɜːrsəti/; [or]sat;
decrepit: [x] [adj]衰老的,破旧的; [a]/dɪˈkrepɪt/; [or]sat;
martyr: [x] [n]烈士;受难者;乞怜者; [v]迫害,折磨; [a]/ˈmɑːrtər/; [or]sat;
apprenticeship: [x] [n]学徒期;学徒身份;学徒期;学徒身份; [a]/əˈprentɪʃɪp/; [or]sat;
descry: [x] [v]远远看到,望见; [a]/dɪˈskraɪ/; [or]sat;
denouement: [x] [n]结局,终场; [a]/ˌdeɪnuːˈmɑ̃ː/; [or]sat;
psyche: [x] [n]灵魂;心智; [a]/ˈsaɪki/; [or]sat;
exploit: [x] [v]剥削,利用;开发,开拓; [n]辉煌功绩; [a]/ɪkˈsplɔɪt/; [or]sat;
precinct: [x] [n]管理区,管辖区;选区;界限,范围; [a]/ˈpriːsɪŋkt/; [or]sat;
brandish: [x] [v]挥舞;炫耀的挥舞(武器); [n]挥舞; [a]/ˈbrændɪʃ/; [or]sat;
perpetuate: [x] [adj]长存的; [vt]使永久存在,使不朽; [a]/pərˈpetʃueɪt/; [or]sat;
assent: [x] [v]同意,赞成; [n]同意;赞成; [a]/əˈsent/; [or]sat;
winnow: [x] [v]把(谷物)的杂质吹掉;簸;精选;扬谷; [a]/ˈwɪnoʊ/; [or]sat;
brindled: [x] [adj]有斑纹的; [a]/ˈbrɪnd(ə)ld/; [or]sat;
beguile: [x] [v]欺骗,迷住,吸引; [a]/bɪˈɡaɪl/; [or]sat;
blare: [x] [v]高声鸣叫,发嘟嘟声; [n]嘟嘟声,号声,巨响; [a]/bler/; [or]sat;
capacity: [x] [n]产能;容量;本领;才能;负载量;职位; [a]/kəˈpæsəti/; [or]sat;
sovereign: [x] [adj]至高无上的,具有独立主权的,有最高统治权的; [n]最高统治者,君主,元首; [a]/ˈsɑːvrən/; [or]sat;
imperturbable: [x] [adj]冷静的,沉着的; [a]/ˌɪmpərˈtɜːrbəbl/; [or]sat;
sportive: [x] [adj]运动的;嬉戏的;适合运动穿戴的; [a]/'spɔːtɪv/; [or]sat;
assimilate: [x] [v]使同化;吸收;消化; [a]/əˈsɪməleɪt/; [or]sat;
dishearten: [x] [v]使灰心,使沮丧; [a]/dɪsˈhɑːrtn/; [or]sat;
kindle: [x] [v]点燃,激起;着火;照亮;煽动; [a]/ˈkɪndl/; [or]sat;
secession: [x] [n]脱离,退出; [a]/sɪˈseʃn/; [or]sat;
ineffable: [x] [adj]不可言喻的,不应说出的,难以形容的; [a]/ɪnˈefəbl/; [or]sat;
ruffian: [x] [n]流氓,无赖,恶棍; [adj]凶狠的,残暴的,无法无天的; [a]/ˈrʌfiən/; [or]sat;
apiary: [x] [n]蜂房;养蜂场; [a]/ˈeɪpieri/; [or]sat;
writhe: [x] [v]扭动(身体);扭曲变形;缠绕打结; [n]扭动;翻腾;苦恼; [a]/raɪð/; [or]sat;
liberator: [x] [n]解放者;释放者; [a]/ˈlɪbəreɪtər/; [or]sat;
typhoon: [x] [n]台风,强热带风暴; [a]/taɪˈfuːn/; [or]sat;
desolate: [x] [adj]荒凉的;孤单寂寞的; [a]/ˈdesələt/; [or]sat;
scuffle: [x] [v]混战,扭打,拖着脚步快速行走; [n]混战,扭打; [a]/ˈskʌfl/; [or]sat;
reproach: [x] [v]责备,指责; [n]指责; [a]/rɪˈproʊtʃ/; [or]sat;
accede: [x] [v]同意,就任,加入; [a]/əkˈsiːd/; [or]sat;
cleave: [x] [v]劈开,分裂; [a]/kliːv/; [or]sat;
opportune: [x] [adj]适当的,恰好的,合时宜的; [a]/ˌɑːpərˈtuːn/; [or]sat;
icon: [x] [n]图标,肖像,偶像; [a]/ˈaɪkɑːn/; [or]sat;
invincible: [x] [adj]无敌的;不能征服的; [a]/ɪnˈvɪnsəbl/; [or]sat;
deducible: [x] [adj]可推论的; [a]/dɪˈduːsəbl/; [or]sat;
wallow: [x] [v]打滚;沉迷,沉溺;颠簸; [n]打滚;堕落;泥坑; [a]/ˈwɑːloʊ/; [or]sat;
don: [x] [n]指导教师,大学教师;先生,阁下; [vt]穿上; [a]/dɑːn/; [or]sat;
induce: [x] [v]引导,劝诱,诱导; [a]/ɪnˈduːs/; [or]sat;
recant: [x] [v]宣布放弃,公开认错; [a]/rɪˈkænt/; [or]sat;
premonition: [x] [n]预告,征兆,预感; [a]/ˌpriːməˈnɪʃn/; [or]sat;
humane: [x] [adj]人道的;仁慈的; [a]/hjuːˈmeɪn/; [or]sat;
edify: [x] [vt]教诲,启发,熏陶; [a]/ˈedɪfaɪ/; [or]sat;
grovel: [x] [v]摇尾乞怜;奴颜婢膝;匍匐; [a]/ˈɡrɑːvl/; [or]sat;
perfidious: [x] [adj]不忠的,背信弃义的; [a]/pərˈfɪdiəs/; [or]sat;
yield: [x] [v]出产;屈服;弯曲;让行; [n]收益; [a]/jiːld/; [or]sat;
excoriate: [x] [v]严厉批评,擦伤(皮肤等); [a]/ˌeksˈkɔːrieɪt/; [or]sat;
hedonist: [x] [n]享乐主义者,［心］欢乐主义者; [adj]享乐主义者的; [a]/ˈhiːdənɪst/; [or]sat;
bureaucracy: [x] [n]官僚主义;政府机构; [a]/bjʊˈrɑːkrəsi/; [or]sat;
repeal: [x] [n]撤销; [v]废除;废止; [a]/rɪˈpiːl/; [or]sat;
bequeath: [x] [v]遗赠(留); [a]/bɪˈkwiːð/; [or]sat;
expenditure: [x] [n](时间,金钱等的)花费,支出,消耗; [a]/ɪkˈspendɪtʃər/; [or]sat;
communal: [x] [adj]公社的;公共的; [a]/kəˈmjuːnl/; [or]sat;
bravado: [x] [n]故作勇敢,逞能; [a]/brəˈvɑːdoʊ/; [or]sat;
valedictory: [x] [n]告别辞; [adj]告别的; [a]/ˌvælɪˈdɪktəri/; [or]sat;
tenacious: [x] [adj]坚忍不拔的,固执的,顽强的; [a]/təˈneɪʃəs/; [or]sat;
whiff: [x] [n]一吹,一吸,一阵香气,一点点,香烟的一口; [v]轻轻地吹,喷气,[棒]三击出局; [a]/wɪf/; [or]sat;
discomposure: [x] [n]不安,心乱,狼狈; [a]/ˌdɪskəmˈpoʊʒər/; [or]sat;
equinox: [x] [n]春分;秋分;昼夜平分点; [a]/ˈiːkwɪnɑːks/; [or]sat;
abrade: [x] [v]磨损,擦伤; [a]/əˈbreɪd/; [or]sat;
defame: [x] [v]诽谤,中伤; [a]/dɪˈfeɪm/; [or]sat;
incongruous: [x] [adj]不调和的,不相称的; [a]/ɪnˈkɑːŋɡruəs/; [or]sat;
forte: [x] [n]长处,特长; [adj]强音的;响的; [adv]响亮地; [a]/fɔːrt/; [or]sat;
reconnaissance: [x] [n]侦察,勘测,搜索,事先考查; [a]/rɪˈkɑːnɪsns/; [or]sat;
vapid: [x] [adj]索然无味的;无生气的; [adv]乏味地;无滋味地;无趣味地;无生气地; [a]/ˈvæpɪd/; [or]sat;
sarcasm: [x] [n]讽刺,挖苦,嘲笑; [a]/ˈsɑːrkæzəm/; [or]sat;
dispel: [x] [v]驱散,驱逐;消除(烦恼等); [a]/dɪˈspel/; [or]sat;
mosaic: [x] [n]镶嵌细工,马赛克; [adj]摩西的;拼花的; [vt]镶嵌;用马赛克装饰; [a]/moʊˈzeɪɪk/; [or]sat;
scenario: [x] [n]剧情梗概;情况,情节;设想; [a]/səˈnærioʊ/; [or]sat;
promontory: [x] [n]岬,海角,隆突; [a]/ˈprɑːməntɔːri/; [or]sat;
devotee: [x] [n]爱好者;信徒; [a]/ˌdevəˈtiː/; [or]sat;
proximity: [x] [n]接近;邻近; [a]/prɑːkˈsɪməti/; [or]sat;
liaison: [x] [n]联系,暧昧关系; [a]/ˈliːəzɑːn/; [or]sat;
aristocracy: [x] [n]贵族;贵族统治;贵族政治;贵族品质; [a]/ˌærɪˈstɑːkrəsi/; [or]sat;
judicious: [x] [adj]有判断力的;明智的; [a]/dʒuˈdɪʃəs/; [or]sat;
jaunty: [x] [adj]愉快的,满足的;斯文的;时髦的; [adv]心满意足地,洋洋得意地; [n]心满意足;洋洋得意; [a]/ˈdʒɔːnti/; [or]sat;
hypochondriac: [x] [n]疑病患者,忧郁症患者; [a]/ˌhaɪpəˌkɑːnˈdraɪəkl/; [or]sat;
homogeneous: [x] [adj]同类的,同质的,有相同特征的; [a]/ˌhoʊməˈdʒiːniəs/; [or]sat;
desultory: [x] [adj]散漫的,无目的的,断断续续的; [a]/ˈdesəltɔːri/; [or]sat;
centrifugal: [x] [adj]离心的;远中的; [n]离心机; [a]/ˌsentrɪˈfjuːɡl/; [or]sat;
gloat: [x] [v]幸灾乐祸地看,窃喜; [a]/ɡloʊt/; [or]sat;
appraise: [x] [v]评价,鉴定;估价; [a]/əˈpreɪz/; [or]sat;
touchy: [x] [adj](人或话题)敏感的,易发脾气的; [adv]易动气地,过分敏感地,小心眼地; [n]易动气,过分敏感; [a]/ˈtʌtʃi/; [or]sat;
recidivism: [x] [n]再犯,累犯; [a]/rɪˈsɪdɪvɪzəm/; [or]sat;
arraign: [x] [v]指责,控告; [a]/əˈreɪn/; [or]sat;
callow: [x] [adj](鸟)未生羽毛的;年轻而无经验的; [a]/ˈkæloʊ/; [or]sat;
innocuous: [x] [adj]无伤大雅的;无害的; [a]/ɪˈnɑːkjuəs/; [or]sat;
sedulous: [x] [adj]聚精会神的,勤勉的; [a]/ˈsedʒələs/; [or]sat;
exposure: [x] [n]暴露,受寒;揭露,揭发;亮相,报道;曝光,曝光时间; [a]/ɪkˈspoʊʒər/; [or]sat;
advent: [x] [n]来临;到来;出现; [a]/ˈædvent/; [or]sat;
gawk: [x] [v]张着嘴呆看; [a]/ɡɔːk/; [or]sat;
rubble: [x] [n]碎石,瓦砾; [a]/ˈrʌbl/; [or]sat;
capacious: [x] [adj]宽敞的;广阔的;容积大的; [a]/kəˈpeɪʃəs/; [or]sat;
overbearing: [x] [adj]专横的,独断的,傲慢的; [a]/ˌoʊvərˈberɪŋ/; [or]sat;
travail: [x] [n]分娩的痛苦,艰苦劳动; [v]辛勤努力,经受分娩的阵痛; [a]/trəˈveɪl/; [or]sat;
barrage: [x] [n]大量;阻塞;齐射式攻击;[水利]拦河坝; [v]以密集火力阻击; [a]/bəˈrɑːʒ/; [or]sat;
energize: [x] [v]使活跃;给予精力;使兴奋; [a]/ˈenərdʒaɪz/; [or]sat;
insatiable: [x] [adj]不能满足的,贪得无厌的; [a]/ɪnˈseɪʃəbl/; [or]sat;
expurgate: [x] [v]净化,删去; [a]/ˈekspərɡeɪt/; [or]sat;
concave: [x] [adj]凹面的; [n]凹面; [vt]使成凹形; [a]/kɑːnˈkeɪv/; [or]sat;
perverse: [x] [adj]邪恶的;堕落的;倔强的;违反常情的; [a]/pərˈvɜːrs/; [or]sat;
meek: [x] [adj]温顺的,逆来顺受的;谦恭的; [n]温顺的人;谦恭的人; [a]/miːk/; [or]sat;
cerebration: [x] [n]思考,精神活动,脑髓作用; [a]/ˌserə'breɪʃən/; [or]sat;
decry: [x] [v]谴责,责难,诽谤; [a]/dɪˈkraɪ/; [or]sat;
archipelago: [x] [n]群岛; [a]/ˌɑːrkɪˈpeləɡoʊ/; [or]sat;
nautical: [x] [adj]航海的;海上的;海员的; [a]/ˈnɔːtɪkl/; [or]sat;
delude: [x] [v]欺骗,哄骗; [a]/dɪˈluːd/; [or]sat;
geniality: [x] [n]和蔼,温和,亲切; [a]/ˌdʒiːniˈæləti/; [or]sat;
alimony: [x] [n](法)赡养费,生活费; [a]/ˈælɪmoʊni/; [or]sat;
adroit: [x] [adj]熟练的,灵巧的; [a]/əˈdrɔɪt/; [or]sat;
mimicry: [x] [n]模仿;拟态; [a]/ˈmɪmɪkri/; [or]sat;
tribute: [x] [n]致敬;悼念;贡品;称赞; [a]/ˈtrɪbjuːt/; [or]sat;
impart: [x] [v]传授,给予,将(某性质)给予或赋予某事物; [a]/ɪmˈpɑːrt/; [or]sat;
decoy: [x] [n]诱饵;诱骗; [v]诱骗; [a]/dɪˈkɔɪ/; [or]sat;
injurious: [x] [adj]有害的,造成伤害的; [a]/ɪnˈdʒʊriəs/; [or]sat;
dismay: [x] [n]失望;沮丧;惊愕; [v]使惊恐; [a]/dɪsˈmeɪ/; [or]sat;
poseur: [x] [n]装模作样的人; [a]/poʊˈzɜːr/; [or]sat;
indoctrinate: [x] [v]灌输思想; [a]/ɪnˈdɑːktrɪneɪt/; [or]sat;
deflect: [x] [v](使)偏斜,(使)偏转; [a]/dɪˈflekt/; [or]sat;
seedy: [x] [adj]多种子的,结籽的,破旧的,褴褛的; [a]/ˈsiːdi/; [or]sat;
cerebral: [x] [adj]大脑的,深思的; [a]/səˈriːbrəl/; [or]sat;
graphic: [x] [adj]形象的;图表的; [n]图,图表; [a]/ˈɡræfɪk/; [or]sat;
mandatory: [x] [adj]命令的,强制性的; [a]/ˈmændətɔːri/; [or]sat;
salvo: [x] [n]齐射,齐鸣,齐声欢呼喝彩,保留条款,遁辞; [v]齐鸣; [a]/ˈsælvoʊ/; [or]sat;
asinine: [x] [adj]愚笨的;固执的; [a]/ˈæsɪnaɪn/; [or]sat;
delirium: [x] [n]神志不清,极度兴奋; [a]/dɪˈlɪriəm/; [or]sat;
tenacity: [x] [n]坚韧不拔,顽强精神; [a]/təˈnæsəti/; [or]sat;
celestial: [x] [adj]天体的,天上的; [n]天人,神仙;(指封建时代的)中国人,天朝之人; [a]/səˈlestʃl/; [or]sat;
obscure: [x] [v]隐藏,使.模糊;使变暗;遮掩; [adj]不清楚的;难以理解的; [n]某种模糊的或不清楚的东西; [a]/əbˈskjʊr/; [or]sat;
discretion: [x] [n]自由裁量权;谨慎;判断力;判定;考虑周到; [a]/dɪˈskreʃn/; [or]sat;
surveillance: [x] [n]监视;检查; [a]/sɜːrˈveɪləns/; [or]sat;
bluster: [x] [v]咆哮;狂吹;夸口;威吓;气势汹汹地说; [n]怒号;吓唬; [a]/ˈblʌstər/; [or]sat;
mores: [x] [n]风俗习惯,道德观念; [a]/ˈmɔːreɪz/; [or]sat;
accord: [x] [n]协议; [v]授予; [a]/əˈkɔːrd/; [or]sat;
haughtiness: [x] [n]傲慢; [a]/ˈhɔːtinəs/; [or]sat;
delusion: [x] [n]错觉; [a]/dɪˈluːʒn/; [or]sat;
legend: [x] [n]传说,传奇人物;(奖章纪念牌等的)铭文;地图的图例,插图的说明; [a]/ˈledʒənd/; [or]sat;
rigor: [x] [n]严厉;精确;困难境地; [a]/'rɪgə/; [or]sat;
lateral: [x] [n]侧面部分;支线; [adj]侧面的;横向的; [a]/ˈlætərəl/; [or]sat;
stigmatize: [x] [v]诬蔑,玷污; [a]/ˈstɪɡmətaɪz/; [or]sat;
defuse: [x] [vi]平息,变弱; [vt]拆除;使消除危险性,平息; [a]/ˌdiːˈfjuːz/; [or]sat;
squabble: [x] [v]发生口角,大声争吵; [n]争吵,口角; [a]/ˈskwɑːbl/; [or]sat;
colander: [x] [n]滤器,漏勺; [a]/ˈkɑːləndər/; [or]sat;
clamor: [x] [n]喧闹;强烈的要求; [v]喧嚷;强烈的要求; [a]/ˈklæmər/; [or]sat;
buffet: [x] [n]自助餐,(火车内)餐室,冷餐桌; [v]反复敲打,打击,重击; [a]/bəˈfeɪ/; [or]sat;
pungent: [x] [adj]刺激性的;刺鼻的;尖锐的; [a]/ˈpʌndʒənt/; [or]sat;
affront: [x] [v]冒犯,有意冒犯,公开侮辱;面对; [n]轻蔑;公开侮辱; [a]/əˈfrʌnt/; [or]sat;
advocate: [x] [v]提倡;主张;为.辩护; [n]辩护者;提倡者;律师; [a]/ˈædvəkeɪt/; [or]sat;
oust: [x] [v]罢免,驱逐,剥夺,取代; [a]/aʊst/; [or]sat;
rigorous: [x] [adj]严厉的,严格的; [a]/ˈrɪɡərəs/; [or]sat;
misconstrue: [x] [v]误解,曲解; [a]/ˌmɪskənˈstruː/; [or]sat;
xenophobia: [x] [n]仇外,对外国人的恐惧或憎恨; [a]/ˌzenəˈfoʊbiə/; [or]sat;
onset: [x] [n]开始;攻击,袭击; [a]/ˈɑːnset/; [or]sat;
accomplice: [x] [n]同谋者,帮凶; [a]/əˈkɑːmplɪs/; [or]sat;
visionary: [x] [n]有远见的人;幻想家; [adj]有远见的;爱幻想的; [a]/ˈvɪʒəneri/; [or]sat;
abase: [x] [v]贬抑;使卑下;降低.的地位; [n]贬低;屈辱;贬低别人的人; [a]/əˈbeɪs/; [or]sat;
persona: [x] [n]人物,角色; [a]/pərˈsoʊnə/; [or]sat;
countermand: [x] [vt]撤回,取消; [a]/ˈkaʊntərmænd/; [or]sat;
grapple: [x] [v]抓住;格斗; [n]抓住;格斗; [a]/ˈɡræpl/; [or]sat;
pacify: [x] [v]使平静,安慰,抚慰; [a]/ˈpæsɪfaɪ/; [or]sat;
implicate: [x] [vt]使牵连其中,暗示,含有.的意思; [n]包含的东西; [a]/ˈɪmplɪkeɪt/; [or]sat;
obstetrician: [x] [n]产科医师; [a]/ˌɑːbstəˈtrɪʃn/; [or]sat;
aftermath: [x] [n]不幸事件之后果,余波; [a]/ˈæftərmæθ/; [or]sat;
cite: [x] [v]引用,引证;传唤,传讯;表彰,嘉奖; [a]/saɪt/; [or]sat;
embargo: [x] [v]禁止出入港口;禁止或限制贸易;征用或扣押; [n]禁令;禁止;封港令; [a]/ɪmˈbɑːrɡoʊ/; [or]sat;
innovation: [x] [n]创新,革新,新设施,新发明; [a]/ˌɪnəˈveɪʃn/; [or]sat;
vindicate: [x] [vt]证明.无辜;维护,辩护; [a]/ˈvɪndɪkeɪt/; [or]sat;
vantage: [x] [n]优势;有利情况; [a]/'vɑːntɪdʒ/; [or]sat;
inaugurate: [x] [v]为..揭幕;为.举行就职典礼;开展; [a]/ɪˈnɔːɡjəreɪt/; [or]sat;
urbane: [x] [adj]温文尔雅的,懂礼的;都[城]市气派的; [a]/ɜːrˈbeɪn/; [or]sat;
lachrymose: [x] [adj]落泪的,好哭的;催泪的;悲哀的; [a]/ˈlækrɪmoʊs/; [or]sat;
verbalize: [x] [v]唠叨;以言语表述;使.变成动词; [a]/ˈvɜːrbəlaɪz/; [or]sat;
audacious: [x] [adj]大胆的,鲁莽的,大胆创新的; [a]/ɔːˈdeɪʃəs/; [or]sat;
stoic: [x] [n]斯多葛学派哲学家;禁欲主义者;坚守克己之人; [adj]斯多葛派的;禁欲主义的; [a]/ˈstoʊɪkl/; [or]sat;
comparable: [x] [adj]类似的,比得上的,可比较的; [a]/ˈkɑːmpərəbl/; [or]sat;
riddle: [x] [n]谜,谜语; [v]解谜,出谜题,满是弹孔; [a]/ˈrɪdl/; [or]sat;
aromatic: [x] [adj]芳香的; [n]芳香植物;芳香族化合物; [a]/ˌærəˈmætɪk/; [or]sat;
deign: [x] [v]屈尊,惠允(做某事); [a]/deɪn/; [or]sat;
rapacious: [x] [adj]贪婪的;掠夺的; [a]/rəˈpeɪʃəs/; [or]sat;
irreconcilable: [x] [adj]不能妥协的,不能和解的,不能协调的; [n]不能和解的人,(政治上的)死硬派; [a]/ɪˈrekənsaɪləbl/; [or]sat;
fastidious: [x] [adj]难讨好的,爱挑剔的; [a]/fæˈstɪdiəs/; [or]sat;
velocity: [x] [n]速度;迅速,快速; [a]/vəˈlɑːsəti/; [or]sat;
milieu: [x] [n]周围环境;背景;周围;出身背景; [a]/mɪlˈjuː/; [or]sat;
malcontent: [x] [n]不满分子,反抗者; [adj]不满的,不服的; [a]/ˌmælkənˈtent/; [or]sat;
sporadic: [x] [adj]不定时发生的;零星的;分散的; [a]/spəˈrædɪk/; [or]sat;
begrudge: [x] [v]嫉妒,吝惜,舍不得给; [a]/bɪˈɡrʌdʒ/; [or]sat;
inkling: [x] [n]轻微暗示,小提示,略知; [a]/ˈɪŋklɪŋ/; [or]sat;
impeccable: [x] [adj]无瑕疵的,没有缺点的; [a]/ɪmˈpekəbl/; [or]sat;
disperse: [x] [v]使散开;分散,散开; [a]/dɪˈspɜːrs/; [or]sat;
brazen: [x] [adj]厚脸皮的,厚颜无耻的;黄铜(制)的; [v]厚着脸皮干,使变得无耻; [a]/ˈbreɪzn/; [or]sat;
capitulate: [x] [vi]有条件投降,认输,屈服,让步,停止抵抗; [a]/kəˈpɪtʃuleɪt/; [or]sat;
antediluvian: [x] [adj]史前的,陈旧的; [n]大洪水以前的人;年迈的人;不合时宜的人; [a]/ˌæntidɪˈluːviən/; [or]sat;
fervor: [x] [n]强烈感情,激情,热情; [a]/ˈfɜrvər/; [or]sat;
scavenge: [x] [v](在废物中)寻觅;(动物)食腐肉;打扫;排除废气; [a]/ˈskævɪndʒ/; [or]sat;
deleterious: [x] [adj]有害的;有毒的; [a]/ˌdeləˈtɪriəs/; [or]sat;
inconsequential: [x] [adj]不重要的,不合理的,不合逻辑的; [a]/ɪnˌkɑːnsɪˈkwenʃl/; [or]sat;
leery: [x] [adj]机警的,狡猾的; [a]/ˈlɪri/; [or]sat;
tantalize: [x] [v]逗弄,挑逗,使(看到拿不到而)焦急; [a]/ˈtæntəlaɪz/; [or]sat;
precarious: [x] [adj]不稳定的;危险的;可疑的;说不定的; [a]/prɪˈkeriəs/; [or]sat;
animosity: [x] [n]憎恶,仇恨; [a]/ˌænɪˈmɑːsəti/; [or]sat;
panache: [x] [n]羽饰,神气十足; [a]/pəˈnæʃ/; [or]sat;
gibe: [x] [n]嘲弄,讥笑; [v]嘲笑; [a]/dʒaɪb/; [or]sat;
fallible: [x] [adj]会犯错的,易犯错的; [a]/ˈfæləbl/; [or]sat;
immobility: [x] [n]不动,固定; [a]/ˌɪməˈbɪləti/; [or]sat;
impel: [x] [v]推进,驱使; [a]/ɪmˈpel/; [or]sat;
slothful: [x] [adj]偷懒的,懒惰的; [a]/ˈsloʊθfl/; [or]sat;
feasible: [x] [adj]可行的,行得通的; [a]/ˈfiːzəbl/; [or]sat;
eerie: [x] [adj]胆怯的,引起恐惧的; [a]/ˈɪri/; [or]sat;
rescind: [x] [v]废除;取消;撤回; [a]/rɪˈsɪnd/; [or]sat;
falter: [x] [v]蹒跚,摇摆;踌躇;畏缩; [n]踌躇;支吾;颤抖; [a]/ˈfɔːltər/; [or]sat;
glossary: [x] [n]词汇表,术语汇编; [a]/ˈɡlɑːsəri/; [or]sat;
apolitical: [x] [adj]不问政治的; [a]/ˌeɪpəˈlɪtɪkl/; [or]sat;
schematic: [x] [adj]图示的,扼要的; [n]简图; [a]/skiːˈmætɪk/; [or]sat;
corporeal: [x] [adj]物质的,有形的,肉体的; [a]/kɔːrˈpɔːriəl/; [or]sat;
exceptionable: [x] [adj]引起反感的,可反对的,会引起抗议的; [a]/ɪk'sepʃənəbəl/; [or]sat;
malignant: [x] [adj]恶性的,恶毒的,充满恨意的; [n]怀有恶意的人;保王党员; [a]/məˈlɪɡnənt/; [or]sat;
calamity: [x] [n]大灾祸,不幸之事; [a]/kəˈlæməti/; [or]sat;
centurion: [x] [n]百夫长;百人队队长; [a]/senˈtʃʊriən/; [or]sat;
unruly: [x] [adj]不守规矩的;任性的;难驾驭的; [a]/ʌnˈruːli/; [or]sat;
careen: [x] [n](船的)倾侧; [v](船)倾斜,使倾斜; [a]/kəˈriːn/; [or]sat;
catalyst: [x] [n]催化剂;造成变化的人或事; [a]/ˈkætəlɪst/; [or]sat;
sleeper: [x] [n]睡眠者;卧车,卧铺;枕木; [a]/ˈsliːpər/; [or]sat;
plausible: [x] [adj]似乎有理的;巧嘴的; [a]/ˈplɔːzəbl/; [or]sat;
bait: [x] [n]饵,诱惑物; [v]装饵;辱骂,欺侮; [a]/beɪt/; [or]sat;
haggle: [x] [n]讨价还价; [v]争论,讨价还价; [a]/ˈhæɡl/; [or]sat;
blunder: [x] [n]愚蠢之举;大错; [vi]犯大错; [v]失策;绊倒; [a]/ˈblʌndər/; [or]sat;
prevail: [x] [v]流行,盛行;战胜,压倒; [a]/prɪˈveɪl/; [or]sat;
antiquated: [x] [adj]陈旧的,过时的; [v]使古旧,废弃; [a]/ˈæntɪkweɪtɪd/; [or]sat;
attain: [x] [v]获得;达到(某个年纪,水平,条件);实现; [n]成就; [a]/əˈteɪn/; [or]sat;
premise: [x] [n]前提;房屋地基; [v]假定; [a]/ˈpremɪs/; [or]sat;
solitude: [x] [n]孤独; [a]/ˈsɑːlətuːd/; [or]sat;
opulence: [x] [n]富裕,丰富; [a]/ˈɑːpjələns/; [or]sat;
abominable: [x] [adj]讨厌的,令人憎恶的,糟透的; [n]讨厌,可恶; [adv]恶劣地,令人厌恶地; [a]/əˈbɑːmɪnəbl/; [or]sat;
vehement: [x] [adj]猛烈的,强烈的; [a]/ˈviːəmənt/; [or]sat;
sadistic: [x] [adj]虐待狂的;残忍成性的; [a]/səˈdɪstɪk/; [or]sat;
overt: [x] [adj]明显的;公开的;公然的; [a]/oʊˈvɜːrt/; [or]sat;
metaphysical: [x] [adj]形而上学的;超自然的;玄学派诗歌的; [a]/ˌmetəˈfɪzɪkl/; [or]sat;
validate: [x] [v]使.生效,使合法化;证明正确; [a]/ˈvælɪdeɪt/; [or]sat;
turmoil: [x] [n]骚动,骚乱; [a]/ˈtɜːrmɔɪl/; [or]sat;
auspicious: [x] [adj]吉兆的,幸运的; [a]/ɔːˈspɪʃəs/; [or]sat;
antecede: [x] [v]胜过,居前; [a]/ˌæntɪ'siːd/; [or]sat;
innuendo: [x] [n]暗讽,讽刺,影射; [vt]暗示,旁敲侧击地表达; [vi]影射,说讽刺话; [a]/ˌɪnjuˈendoʊ/; [or]sat;
carnage: [x] [n]大屠杀,残杀,大量绝灭; [a]/ˈkɑːrnɪdʒ/; [or]sat;
gibberish: [x] [n]乱语;快速而不清楚的言语; [a]/ˈdʒɪbərɪʃ/; [or]sat;
kinetic: [x] [adj]运动的; [a]/kɪˈnetɪk/; [or]sat;
gullible: [x] [adj]易受骗的;轻信的; [a]/ˈɡʌləbl/; [or]sat;
scaffold: [x] [n]支架;断头台;脚手架;脚手架材料; [vt]给.搭脚手架; [a]/ˈskæfoʊld/; [or]sat;
mollify: [x] [v]安慰,安抚; [a]/ˈmɑːlɪfaɪ/; [or]sat;
liquidate: [x] [vt]清理,清算,停业清理;清偿,清理,清算(破产的公司等),变卖,杀戮,废除; [a]/ˈlɪkwɪdeɪt/; [or]sat;
indolent: [x] [adj]懒惰的,懒洋洋的; [a]/ˈɪndələnt/; [or]sat;
remorse: [x] [n]懊悔,自责,同情,怜悯; [a]/rɪˈmɔːrs/; [or]sat;
vent: [x] [n]发泄;通风口,排气口;(上衣背部或两侧的)开衩;(小型动物的)排泄口; [v]发泄(情绪),开孔,泄露; [a]/vent/; [or]sat;
exemplary: [x] [adj]模范的,可仿效的; [a]/ɪɡˈzempləri/; [or]sat;
dissolute: [x] [adj]无节制的;放荡的; [a]/ˈdɪsəluːt/; [or]sat;
verbose: [x] [adj]冗长的,啰嗦的; [a]/vɜːrˈboʊs/; [or]sat;
bizarre: [x] [adj]稀奇古怪的; [a]/bɪˈzɑːr/; [or]sat;
choleric: [x] [adj]易怒的,暴躁的,胆汁质的; [a]/ˈkɑːlərɪk/; [or]sat;
enmity: [x] [n]敌意,憎恨; [a]/ˈenməti/; [or]sat;
juncture: [x] [n]连接;交接处,交界;关键时刻;形势; [a]/ˈdʒʌŋktʃər/; [or]sat;
shard: [x] [n](陶器等)碎片,破片; [a]/ʃɑːrd/; [or]sat;
abstruse: [x] [adj]难懂的,深奥的; [a]/əbˈstruːs/; [or]sat;
respiration: [x] [n]呼吸; [a]/ˌrespəˈreɪʃn/; [or]sat;
mercenary: [x] [n]外国雇佣兵;唯利是图者; [adj]唯利是图的;雇佣的; [a]/ˈmɜːrsəneri/; [or]sat;
vital: [x] [adj]生命所必需的;必不可少的;至关重要的;有活力的;生命攸关的; [n]要害;重要部分; [a]/ˈvaɪtl/; [or]sat;
bicameral: [x] [adj]两院制的; [a]/ˌbaɪˈkæmərəl/; [or]sat;
punitive: [x] [adj]给予惩罚,刑罚的; [a]/ˈpjuːnətɪv/; [or]sat;
debase: [x] [v]贬值,降低; [a]/dɪˈbeɪs/; [or]sat;
jocular: [x] [adj]搞笑的,欢乐的; [a]/ˈdʒɑːkjələr/; [or]sat;
guffaw: [x] [n]哄笑;大笑; [v]哄笑;大笑; [a]/ɡəˈfɔː/; [or]sat;
enigmatic: [x] [adj]神秘的,高深莫测的,谜一般的; [a]/ˌenɪɡˈmætɪk/; [or]sat;
precedent: [x] [n]先例,范例;惯例; [adj]在前的,前面的; [a]/ˈpresɪdənt/; [or]sat;
fodder: [x] [n]饲料,草料;(创作的)素材;弹药; [v]喂; [a]/ˈfɑːdər/; [or]sat;
bode: [x] [v]预示,为.的兆头,停留,继续,遭到; [a]/boʊd/; [or]sat;
forbearance: [x] [n]自制,忍耐;宽容; [a]/fɔːrˈberəns/; [or]sat;
longevity: [x] [n]长寿,长命;寿命; [a]/lɔːnˈdʒevəti/; [or]sat;
insurgent: [x] [n]叛乱分子; [adj]叛乱的,起事的; [a]/ɪnˈsɜːrdʒənt/; [or]sat;
impoverished: [x] [adj]穷困的,用尽了的,无创造性的; [a]/ɪmˈpɑːvərɪʃt/; [or]sat;
anarchy: [x] [n]无政府状态,政治混乱; [a]/ˈænərki/; [or]sat;
succinct: [x] [adj]简明的,简洁的,没有废话的; [a]/səkˈsɪŋkt/; [or]sat;
abet: [x] [vt]唆使,怂恿;支持; [a]/əˈbet/; [or]sat;
impetuous: [x] [adj]冲动的,鲁莽的; [a]/ɪmˈpetʃuəs/; [or]sat;
harangue: [x] [n]长篇大论; [v]高谈阔论;大声训斥; [a]/həˈræŋ/; [or]sat;
celebrated: [x] [adj]著名的,有名望的; [v]庆祝; [a]/ˈselɪbreɪtɪd/; [or]sat;
drudgery: [x] [n]苦工;苦差事;单调乏味的工作; [a]/ˈdrʌdʒəri/; [or]sat;
severity: [x] [n]严格,严肃; [a]/sɪˈverəti/; [or]sat;
bent: [x] [adj]弯曲的,决心的,不诚实的; [v]弯腰,弯曲(bend过去式); [n]爱好,癖好; [a]/bent/; [or]sat;
pique: [x] [v]引起(好奇心,兴趣等),不悦,愤怒; [n]不悦,生气; [a]/piːk/; [or]sat;
infiltrate: [x] [v]渗入,潜入 (某地方或组织);(气,液)渗透; [n]渗透物; [a]/ˈɪnfɪltreɪt/; [or]sat;
nuptial: [x] [adj]婚姻的,婚礼的; [n]婚礼; [a]/ˈnʌpʃl/; [or]sat;
apprehension: [x] [n]忧虑,担心,疑惧;逮捕;理解; [a]/ˌæprɪˈhenʃn/; [or]sat;
mortify: [x] [v]使屈辱;抑制;苦修;约束; [a]/ˈmɔːrtɪfaɪ/; [or]sat;
amass: [x] [vi]聚集; [vt]收集;积累,积聚; [a]/əˈmæs/; [or]sat;
repress: [x] [vt]抑制;镇压;约束; [a]/rɪˈpres/; [or]sat;
synoptic: [x] [adj]天气的,概要的,一览无余的; [a]/sɪˈnɑːptɪk/; [or]sat;
delectable: [x] [adj]令人愉快的;美味的; [a]/dɪˈlektəbl/; [or]sat;
gratify: [x] [v]使高兴,使满足; [a]/ˈɡrætɪfaɪ/; [or]sat;
illicit: [x] [adj]违法的,违禁的; [a]/ɪˈlɪsɪt/; [or]sat;
succumb: [x] [v]屈从,屈服,因.死亡(to); [a]/səˈkʌm/; [or]sat;
citadel: [x] [n]堡垒;避难所; [a]/ˈsɪtədəl/; [or]sat;
hue: [x] [n]色彩;色度,颜色;叫声; [a]/hjuː/; [or]sat;
fortitude: [x] [n]坚强意志(精神),坚忍,刚毅; [a]/ˈfɔːrtətuːd/; [or]sat;
swagger: [x] [n]傲慢的态度,大摇大摆; [v]大摇大摆地走,吹牛,傲慢; [adj]豪华时髦的; [a]/ˈswæɡər/; [or]sat;
derivative: [x] [n]派生物;[化学]衍生物; [adj]被引申出的,被诱导的;衍生的;第二手的; [a]/dɪˈrɪvətɪv/; [or]sat;
impediment: [x] [n]妨碍,阻碍;障碍物;(言语)障碍;口吃; [a]/ɪmˈpedɪmənt/; [or]sat;
dogmatic: [x] [adj]教条的,武断的; [a]/dɔːɡˈmætɪk/; [or]sat;
apparatus: [x] [n]装置,仪器;设备;组织,机构; [a]/ˌæpəˈrætəs/; [or]sat;
lineage: [x] [n]血统,世系,门第,宗族;传承; [a]/ˈlɪniɪdʒ/; [or]sat;
elusive: [x] [adj]难懂的;难捉摸的;难找的;难懂的;易忘的;逃避的;难捉摸的; [a]/iˈluːsɪv/; [or]sat;
trough: [x] [n]水槽,水槽;低谷期;饲料槽;低气压; [a]/trɔːf/; [or]sat;
benefactor: [x] [n]恩人;捐助者;施主; [a]/ˈbenɪfæktər/; [or]sat;
plethora: [x] [n]过多,过剩,多血症; [a]/ˈpleθərə/; [or]sat;
recession: [x] [n](经济)衰退,不景气;后退,撤回;凹处; [a]/rɪˈseʃn/; [or]sat;
antagonism: [x] [n]对抗,敌对;敌意; [a]/ænˈtæɡənɪzəm/; [or]sat;
integrity: [x] [n]正直,真诚;完整; [a]/ɪnˈteɡrəti/; [or]sat;
coddle: [x] [v]溺爱;用文火煮; [n]〈口〉娇生惯养的人; [a]/ˈkɑːdl/; [or]sat;
profane: [x] [adj]亵渎神圣的,不敬的,粗俗的,污秽的; [v]亵渎,玷污(神圣),滥用; [n]未受秘传的人; [a]/prəˈfeɪn/; [or]sat;
philology: [x] [n]语言学; [a]/fɪˈlɑːlədʒi/; [or]sat;
knit: [x] [v]编结,针织; [n]编织的衣服;针织衫; [a]/nɪt/; [or]sat;
pessimism: [x] [n]悲观,悲观主义; [a]/ˈpesɪmɪzəm/; [or]sat;
imbalance: [x] [n]不平衡,不均衡;失调; [a]/ɪmˈbæləns/; [or]sat;
sage: [x] [adj]贤明的,审慎的; [n]圣人,年高望重的人; [a]/seɪdʒ/; [or]sat;
incredulous: [x] [adj]怀疑的,不轻信的; [a]/ɪnˈkredʒələs/; [or]sat;
assurance: [x] [n]信心,自信;保证;保险; [a]/əˈʃʊrəns/; [or]sat;
luxuriant: [x] [adj]繁茂的;多产的;绚烂的;奢华的; [a]/lʌɡˈʒʊriənt/; [or]sat;
bland: [x] [vi]变得平淡无奇,变得枯燥无味; [adj]温和的;(食物等)清淡的;漠不关心的; [vt]使变得淡而无味,使变得枯燥无味;除掉.的特性; [a]/blænd/; [or]sat;
embellish: [x] [vt]装饰; [v]吹嘘;润色(文章); [vi]装饰起来;加以润色;添加细节,对...添枝加叶; [a]/ɪmˈbelɪʃ/; [or]sat;
capricious: [x] [adj]变化无常的,任性的; [a]/kəˈprɪʃəs/; [or]sat;
inception: [x] [n]起初;获得学位; [a]/ɪnˈsepʃn/; [or]sat;
scabbard: [x] [n](刀,剑)鞘,枪套; [v]把.插入鞘中; [a]/ˈskæbərd/; [or]sat;
imminent: [x] [adj]迫近的,紧迫的,即将来临的; [a]/ˈɪmɪnənt/; [or]sat;
listless: [x] [adj]无精打采的,倦怠的,情绪低落的;冷漠的; [a]/ˈlɪstləs/; [or]sat;
swill: [x] [n]泔水;冲洗;痛饮; [v]冲洗,痛饮; [a]/swɪl/; [or]sat;
mediate: [x] [v]调解,调停,斡旋; [a]/ˈmiːdieɪt/; [or]sat;
hyperbole: [x] [n]夸张的语句;夸张法; [a]/haɪˈpɜːrbəli/; [or]sat;
omniscient: [x] [adj]无所不知的,博识的; [n]无所不知者,上帝; [a]/ɑːmˈnɪsiənt/; [or]sat;
adulation: [x] [n]奉承,恭维; [a]/ˌædʒəˈleɪʃn/; [or]sat;
scurvy: [x] [n]坏血病; [adj]卑鄙的,下流的; [a]/ˈskɜːrvi/; [or]sat;
surmount: [x] [v]克服,战胜,越过; [a]/sərˈmaʊnt/; [or]sat;
monarchy: [x] [n]君主,最高统治者;君主政体;君主国; [a]/ˈmɑːnərki/; [or]sat;
flout: [x] [n]表示轻蔑的言行;嘲弄;嘲笑; [vi]藐视;嘲弄;嘲笑; [vt]嘲弄;嘲笑;藐视; [a]/flaʊt/; [or]sat;
propriety: [x] [n]正当(的行为);礼节;适当; [a]/prəˈpraɪəti/; [or]sat;
obnoxious: [x] [adj]非常讨厌的;可憎的; [a]/əbˈnɑːkʃəs/; [or]sat;
cardinal: [x] [adj]主要的;基本的; [n][天主教]枢机主教,红衣主教;基数; [a]/ˈkɑːrdɪnl/; [or]sat;
jubilation: [x] [n]喜悦,欢呼,庆祝; [a]/ˌdʒuːbɪˈleɪʃn/; [or]sat;
formality: [x] [n]得体;程序;拘谨;礼节;一丝不苟;单纯为形式而做的事; [a]/fɔːrˈmæləti/; [or]sat;
promulgate: [x] [v]公布;传播;发表; [a]/ˈprɑːmlɡeɪt/; [or]sat;
foliage: [x] [n]叶子(总称); [a]/ˈfoʊliɪdʒ/; [or]sat;
hiatus: [x] [n]空隙,裂缝,中断; [a]/haɪˈeɪtəs/; [or]sat;
ape: [x] [n]无尾猿,类人猿;模仿者;粗野的大汉; [adj]〈俚〉疯狂的; [v]模仿; [a]/eɪp/; [or]sat;
metropolis: [x] [n]大城市; [a]/məˈtrɑːpəlɪs/; [or]sat;
frail: [x] [adj]脆弱的,不坚实的; [n]少妇;灯心草篓;灯心草篓的容量; [a]/freɪl/; [or]sat;
influx: [x] [n]流入,涌入;河口; [a]/ˈɪnflʌks/; [or]sat;
duration: [x] [n]持续;持续期间;持续的时间; [a]/duˈreɪʃn/; [or]sat;
disparate: [x] [adj]迥然不同的; [a]/ˈdɪspərət/; [or]sat;
harass: [x] [v]使困扰,使烦恼,反复袭击; [a]/həˈræs/; [or]sat;
alias: [x] [n]别名,化名; [adv]别名为,化名为; [a]/ˈeɪliəs/; [or]sat;
junta: [x] [n]团体,派别; [a]/ˈhʊntə/; [or]sat;
hackneyed: [x] [adj]陈腐的,平常的; [a]/ˈhæknid/; [or]sat;
litigation: [x] [n]诉讼;起诉; [a]/ˌlɪtɪˈɡeɪʃn/; [or]sat;
esoteric: [x] [adj]秘传的,神秘的,限于少数人的; [n]受秘传的人; [a]/ˌesəˈterɪk/; [or]sat;
codicil: [x] [n]遗嘱的附录,附加条款; [a]/ˈkɑːdəsl/; [or]sat;
coagulate: [x] [v]凝结,使凝结; [a]/koʊˈæɡjuleɪt/; [or]sat;
imperial: [x] [adj]帝王的,壮丽的,至尊的; [n]帝国,皇家; [a]/ɪmˈpɪriəl/; [or]sat;
imperative: [x] [adj]必要的;祈使的;急需的; [n]命令;必要的事;义务;驱使; [a]/ɪmˈperətɪv/; [or]sat;
scruple: [x] [n]顾虑,不安; [vi]有顾虑,良心上感到不安; [a]/ˈskruːpl/; [or]sat;
alchemy: [x] [n]炼金术;魔力; [a]/ˈælkəmi/; [or]sat;
intervene: [x] [v]干涉;介入;调停;干预,阻挠; [a]/ˌɪntərˈviːn/; [or]sat;
prelate: [x] [n]高级教士;高位神职者; [a]/ˈprelət/; [or]sat;
salubrious: [x] [adj]清爽的;气候有益健康的; [a]/səˈluːbriəs/; [or]sat;
incentive: [x] [n]刺激,激励;鼓励; [a]/ɪnˈsentɪv/; [or]sat;
immaculate: [x] [adj]完美的,无瑕疵的;洁净的; [a]/ɪˈmækjələt/; [or]sat;
quiescent: [x] [adj]静止的,沉寂的,不活动的; [a]/kwaɪˈesnt/; [or]sat;
demagogue: [x] [n]煽动者; [a]/ˈdeməɡɑːɡ/; [or]sat;
sophisticated: [x] [adj](仪器)精密的,复杂的;老于世故的,老练的,富有经验的;高雅的,精致的; [a]/səˈfɪstɪkeɪtɪd/; [or]sat;
rigid: [x] [adj]坚硬的;僵硬的;死板的; [a]/ˈrɪdʒɪd/; [or]sat;
figurative: [x] [adj]比喻的,修饰丰富的,形容多的; [a]/ˈfɪɡərətɪv/; [or]sat;
quack: [x] [n]庸医;鸭叫声; [v]嘎嘎叫;吹嘘;大声闲聊; [adj]骗人的,江湖医生的; [a]/kwæk/; [or]sat;
drone: [x] [n]无人机,无人驾驶飞机;雄蜂;单调的低音; [v]嗡嗡地响; [vi]混日子; [a]/droʊn/; [or]sat;
unscathed: [x] [adj]未受损伤的;未遭伤害的; [a]/ʌnˈskeɪðd/; [or]sat;
dank: [x] [adj]潮湿的,阴湿的;透水的; [a]/dæŋk/; [or]sat;
tantrum: [x] [n](孩子气的)脾气发作; [a]/ˈtæntrəm/; [or]sat;
cloying: [x] [adj]甜得发腻的;厌烦的;倒胃口的; [a]/ˈklɔɪɪŋ/; [or]sat;
rejuvenate: [x] [v]使..年轻;使..恢复精神;变年轻; [vi]返老还童,恢复活力,复原; [a]/rɪˈdʒuːvəneɪt/; [or]sat;
prelude: [x] [n]序幕,前奏; [a]/ˈpreljuːd/; [or]sat;
pastoral: [x] [adj]田园生活的,牧师的; [n]牧歌;田园诗;田园景色;牧师写给教区居民的公开信; [a]/ˈpæstərəl/; [or]sat;
heinous: [x] [adj]可憎的;极凶恶的; [a]/ˈheɪnəs/; [or]sat;
myopic: [x] [n]近视; [adj]近视的;目光短浅的; [a]/maɪˈɑːpɪk/; [or]sat;
clamber: [x] [v]攀登,爬上; [n]攀登,攀爬; [a]/ˈklæmbər/; [or]sat;
defoliate: [x] [v]落叶; [adj]〈罕〉落了叶的; [a]/ˌdiːˈfoʊlieɪt/; [or]sat;
momentum: [x] [n](物理)动量;势头;动力; [a]/moʊˈmentəm/; [or]sat;
amity: [x] [n]友好,亲善关系,友好关系; [a]/ˈæməti/; [or]sat;
serrated: [x] [adj]呈锯齿状的; [a]/səˈreɪtɪd/; [or]sat;
unpalatable: [x] [adj]不可口的,不好吃的;令人不愉快的; 使人难以接受的; [a]/ʌnˈpælətəbl/; [or]sat;
lax: [x] [adj]松懈的;松弛的;[语]松弛元音的; [n]松元音;泻肚; [a]/læks/; [or]sat;
sonorous: [x] [adj]响亮的,作响的,能发出响亮声音的; [adv]圆润低沉地;感人地,堂皇地; [n]感人,堂皇; [a]/ˈsɑːnərəs/; [or]sat;
canine: [x] [adj]犬的,似犬的,犬科的,犬齿的; [n][解剖]犬齿; [a]/ˈkeɪnaɪn/; [or]sat;
knave: [x] [n]不诚实的人;无赖;<古>仆人;(纸牌中的)杰克; [a]/neɪv/; [or]sat;
ensemble: [x] [n]合唱团,表演团体;总效果;全套服装;全套家具; [a]/ɑːnˈsɑːmbl/; [or]sat;
gall: [x] [n]粗鲁,无礼; [v]使恼怒; [a]/ɡɔːl/; [or]sat;
waft: [x] [v]使飘荡;吹送; [n]飘荡;吹拂; [a]/wɑːft/; [or]sat;
complicity: [x] [n]同谋关系,共犯关系; [a]/kəmˈplɪsəti/; [or]sat;
emanate: [x] [v]发出;放射; [a]/ˈeməneɪt/; [or]sat;
belabor: [x] [v]抨击;反复讨论,啰啰嗦嗦地说明; [a]/bɪˈleɪbər/; [or]sat;
ample: [x] [adj]富足的,丰满的,宽敞的; [a]/ˈæmpl/; [or]sat;
invalidate: [x] [v]使无效;使无价值; [a]/ɪnˈvælɪdeɪt/; [or]sat;
introspective: [x] [adj]内省的,反省的; [a]/ˌɪntrəˈspektɪv/; [or]sat;
ramble: [x] [vi]瞎扯;溜达;漫步于; [n]漫步; [a]/ˈræmbl/; [or]sat;
succulent: [x] [n]肉质植物; [adj]多汁鲜美的;丰富多彩的; [a]/ˈsʌkjələnt/; [or]sat;
exertion: [x] [n]用力;运用; [a]/ɪɡˈzɜːrʃn/; [or]sat;
delineate: [x] [v]描画;画出..轮廓; [a]/dɪˈlɪnieɪt/; [or]sat;
hazardous: [x] [adj]有危险的;碰运气的; [adv]冒险地,有危险地; [n]冒险,危险; [a]/ˈhæzərdəs/; [or]sat;
amoral: [x] [adj]不知是非的; [a]/ˌeɪˈmɔːrəl/; [or]sat;
chaotic: [x] [adj]混沌的,混乱的;混乱的;无秩序的; [a]/keɪˈɑːtɪk/; [or]sat;
debunk: [x] [v]揭穿真面目,证明为假; [a]/ˌdiːˈbʌŋk/; [or]sat;
submissive: [x] [adj]顺从的,惟命是从的,谦恭的; [a]/səbˈmɪsɪv/; [or]sat;
reciprocate: [x] [v]互给;酬答;互换;报答; [a]/rɪˈsɪprəkeɪt/; [or]sat;
flaccid: [x] [adj]软弱的,无活力的,没气力的,松弛的; [a]/ˈflæsɪd/; [or]sat;
boorish: [x] [adj]粗野的;乡土气的;笨拙的; [a]/ˈbʊrɪʃ/; [or]sat;
statute: [x] [n]法令,法规,条例; [a]/ˈstætʃuːt/; [or]sat;
antidote: [x] [n][药]解毒剂,解药;矫正方法; [a]/ˈæntidoʊt/; [or]sat;
phlegmatic: [x] [adj]冷淡的;迟钝的; [a]/fleɡˈmætɪk/; [or]sat;
traverse: [x] [v]横越;穿过; [n]横越; [a]/trəˈvɜːrs/; [or]sat;
oligarchy: [x] [n]寡头政治; [a]/ˈɑːləɡɑːrki/; [or]sat;
cumulative: [x] [adj]渐增的;累积的; [a]/ˈkjuːmjəleɪtɪv/; [or]sat;
abhor: [x] [v]痛恨;憎恶; [a]/əbˈhɔːr/; [or]sat;
precursor: [x] [n]先兆,先驱,前体; [a]/priːˈkɜːrsər/; [or]sat;
insinuate: [x] [v]暗指,暗示; [a]/ɪnˈsɪnjueɪt/; [or]sat;
apathy: [x] [n]冷漠,无兴趣;漠不关心,无感情; [a]/ˈæpəθi/; [or]sat;
apex: [x] [n]顶点;尖端; [a]/ˈeɪpeks/; [or]sat;
seemly: [x] [adj]适当的,有礼的,好看的; [adv]适当地; [a]/ˈsiːmli/; [or]sat;
unassailable: [x] [adj]无可争辩的,无懈可击的,不可亵渎的; [a]/ˌʌnəˈseɪləbl/; [or]sat;
determination: [x] [n]决定;确定;决心; [a]/dɪˌtɜːrmɪˈneɪʃn/; [or]sat;
coalesce: [x] [v]联合,合并,结合; [a]/ˌkoʊəˈles/; [or]sat;
placate: [x] [vt]安抚,抚慰; [a]/ˈpleɪkeɪt/; [or]sat;
whimsical: [x] [adj]古怪的,异想天开的; [a]/ˈwɪmzɪkl/; [or]sat;
perimeter: [x] [n]周长;周界; [a]/pəˈrɪmɪtər/; [or]sat;
formidable: [x] [adj]令人畏惧的;可怕的;难以克服的;难应付的; [a]/ˈfɔːrmɪdəbl/; [or]sat;
wry: [x] [adj]歪斜的,扭歪的,歪曲的; [v]歪曲,扭曲;扭转; [a]/raɪ/; [or]sat;
vendor: [x] [n]小贩,卖主,供应商; [a]/ˈvendər/; [or]sat;
cursory: [x] [adj]匆忙的,不注意细节的;草率地;粗略地; [a]/ˈkɜːrsəri/; [or]sat;
stringent: [x] [adj]严厉的;迫切的;银根紧的; [a]/ˈstrɪndʒənt/; [or]sat;
baleful: [x] [adj]邪恶的,恶意的; [adv]凶恶地,有害地; [a]/ˈbeɪlfl/; [or]sat;
regal: [x] [adj]帝王的,豪华的,帝王般的; [a]/ˈriːɡl/; [or]sat;
diabolical: [x] [adj]恶毒的,狠毒的; [a]/ˌdaɪəˈbɑːlɪkl/; [or]sat;
discrepancy: [x] [n]不一致,差异,不符; [a]/dɪsˈkrepənsi/; [or]sat;
blithe: [x] [adj]愉快的;快乐无忧的; [a]/blaɪð/; [or]sat;
parity: [x] [n]相等;同等;平价; [a]/ˈpærəti/; [or]sat;
copious: [x] [adj]丰富的,多产的; [a]/ˈkoʊpiəs/; [or]sat;
wispy: [x] [adj]象小束状的,纤细的;脆弱的; [a]/ˈwɪspi/; [or]sat;
avenge: [x] [v]报复,报仇; [a]/əˈvendʒ/; [or]sat;
acrophobia: [x] [n]恐高症; [a]/ˌækrə'foʊbɪə/; [or]sat;
dermatologist: [x] [n]皮肤科; [a]/ˌdɜːrməˈtɑːlədʒɪst/; [or]sat;
gentry: [x] [n]人们(多用贬义),贵族们,(英)上流社会人士; [a]/ˈdʒentri/; [or]sat;
optician: [x] [n]光学仪器商,眼镜商; [a]/ɑːpˈtɪʃn/; [or]sat;
guise: [x] [n]外观,姿态,装束,伪装; [v]伪装; [a]/ɡaɪz/; [or]sat;
rabid: [x] [adj]激烈的;狂暴的;偏激的;患狂犬病的; [a]/ˈræbɪd/; [or]sat;
medley: [x] [adj]大杂烩,混合物; [n]混合;混杂;混合物; [a]/ˈmedli/; [or]sat;
reverie: [x] [n]幻想,沉思,幻想曲; [a]/ˈrevəri/; [or]sat;
inequity: [x] [n]不公平; [a]/ɪnˈekwəti/; [or]sat;
chicanery: [x] [n]诡计,诈骗,欺骗; [a]/ʃɪˈkeɪnəri/; [or]sat;
camaraderie: [x] [n]友情; [a]/ˌkɑːməˈrɑːdəri/; [or]sat;
awe: [x] [n]敬畏;畏怯;(壮观等引起的)惊叹,惊奇; [vt]使敬畏,令人敬畏,使充满畏惧; [a]/ɔː/; [or]sat;
assuage: [x] [v]缓和,减轻; [n]缓和,减轻;减轻.的人; [a]/əˈsweɪdʒ/; [or]sat;
accost: [x] [v]搭讪;引诱;面对;勾引; [a]/əˈkɔːst/; [or]sat;
inordinate: [x] [adj]过度的,无节制的;紊乱的; [a]/ɪnˈɔːrdɪnət/; [or]sat;
histrionic: [x] [adj]戏剧的,装腔作势的,作戏的; [n]演员;戏剧表演;舞台艺术;戏剧似的言行; [a]/ˌhɪstriˈɑːnɪk/; [or]sat;
rancid: [x] [adj]腐臭的;令人作呕的,讨厌的; [a]/ˈrænsɪd/; [or]sat;
taut: [x] [adj]拉紧的;紧张的;整洁的; [a]/tɔːt/; [or]sat;
quibble: [x] [n]谬论;双关语;遁辞; [v]诡辩;挑剔;说模棱两可的话; [a]/ˈkwɪbl/; [or]sat;
disheveled: [x] [adj]不整洁的;凌乱的; [v]使(头发等)蓬松; [a]/dɪ'ʃevəld/; [or]sat;
misdemeanor: [x] [n]轻罪,品行不端; [a]/ˌmɪsdɪ'miːnə/; [or]sat;
inadvertently: [x] [adv]不经意地;不经意的; [a]/ˌɪnədˈvɜːrtəntli/; [or]sat;
prophetic: [x] [adj]预言的,预示的; [a]/prəˈfetɪk/; [or]sat;
swindler: [x] [n]骗子; [a]/ˈswɪndlər/; [or]sat;
bastion: [x] [n]堡垒;棱堡; [a]/ˈbæstiən/; [or]sat;
catapult: [x] [n]弹弓;石弩;飞机弹射器;(飞机上的)座椅弹射器; [v]用弹弓射;用弹射器发射;猛投;快速移动; [a]/ˈkætəpʌlt/; [or]sat;
annals: [x] [n]年报;年鉴; [a]/ˈænlz/; [or]sat;
nonplus: [x] [v]使窘困;使迷惑;狼狈不堪; [n]迷惑,困惑; [a]/ˌnɒn'plʌs/; [or]sat;
canny: [x] [adj]精明的,谨慎的,节约的; [adv]<苏格兰>仔细地; [a]/ˈkæni/; [or]sat;
blatant: [x] [adj]喧哗的;露骨的;公然的;明目张胆的; [a]/ˈbleɪtnt/; [or]sat;
taciturn: [x] [adj]沉默寡言的; [a]/ˈtæsɪtɜːrn/; [or]sat;
torso: [x] [n](人体的)躯干,躯干像; [a]/ˈtɔːrsoʊ/; [or]sat;
chronicle: [x] [n]编年史,年代记,记录; [v]记录,把.载入编年史; [a]/ˈkrɑːnɪkl/; [or]sat;
enamored: [x] [adj]迷恋的;倾心的; [a]/ɪˈnæmə(r)d/; [or]sat;
rebuff: [x] [n]断然拒绝,回绝,漠不关心; [v]断然拒绝; [a]/rɪˈbʌf/; [or]sat;
jaded: [x] [adj]疲倦的,精疲力竭的;厌倦的; [a]/ˈdʒeɪdɪd/; [or]sat;
fluency: [x] [n]流畅,流利; [a]/ˈfluːənsi/; [or]sat;
invulnerable: [x] [adj]无法伤害的;无懈可击的; [a]/ɪnˈvʌlnərəbl/; [or]sat;
simian: [x] [n]类人猴,猴子; [adj]猿的,猴的; [a]/ˈsɪmiən/; [or]sat;
lampoon: [x] [n]讽刺文章; [v]讽刺,写文章讽刺; [a]/læmˈpuːn/; [or]sat;
paean: [x] [n]欢乐颂,赞美歌; [a]/ˈpiːən/; [or]sat;
pertinacious: [x] [adj]顽固的,执拗的; [a]/ˌpɜːrtnˈeɪʃəs/; [or]sat;
palpable: [x] [adj]明显的,易觉察的,可触知的; [a]/ˈpælpəbl/; [or]sat;
hoard: [x] [v]贮藏,秘藏; [n]贮藏物; [a]/hɔːrd/; [or]sat;
unctuous: [x] [adj]油腔滑调的,虚情假意的; [a]/ˈʌŋktʃuəs/; [or]sat;
impassive: [x] [adj]无动于衷的,冷漠的; [a]/ɪmˈpæsɪv/; [or]sat;
deploy: [x] [v]部署,设置;展开,散开; [a]/dɪˈplɔɪ/; [or]sat;
coronation: [x] [n]加冕,加冕礼; [a]/ˌkɔːrəˈneɪʃn/; [or]sat;
reprisal: [x] [n]报复;报复性劫掠; [a]/rɪˈpraɪzl/; [or]sat;
blighted: [x] [adj]完蛋了的,生病了的; [a]/ˈblaɪtɪd/; [or]sat;
definitive: [x] [adj]可靠的,明确的,权威的;决定性的; [a]/dɪˈfɪnətɪv/; [or]sat;
stanch: [x] [v]制止(血液),止住; [adj]坚固的;坚定的;可靠的;不漏水的; [a]/stɔːntʃ/; [or]sat;
swarthy: [x] [adj](皮肤等)黝黑的; [a]/ˈswɔːrði/; [or]sat;
remission: [x] [n]缓解;宽恕;豁免; [a]/rɪˈmɪʃn/; [or]sat;
uncanny: [x] [adj]神秘的,不可思议的; [a]/ʌnˈkæni/; [or]sat;
regale: [x] [v]盛情款待,享用,享受; [n]盛宴,佳肴,款待; [a]/rɪˈɡeɪl/; [or]sat;
prank: [x] [n]恶作剧,玩笑; [a]/præŋk/; [or]sat;
domicile: [x] [n]住宅;永久居住地;期票支付场所; [v]居住;使在指定的场所支付(期票等; [adj]定居;在固定住所生活; [a]/ˈdɑːmɪsaɪl/; [or]sat;
menial: [x] [adj]仆人的,乏味的; [n]家仆; [a]/ˈmiːniəl/; [or]sat;
dregs: [x] [n]渣滓;少量;沉淀物; [a]/dreɡz/; [or]sat;
gnarled: [x] [adj]多节的,粗糙的;多瘤的;弯曲的; [a]/nɑːrld/; [or]sat;
abject: [x] [adj]糟糕透顶的;可怜的,不幸的; [a]/ˈæbdʒekt/; [or]sat;
reactionary: [x] [adj]保守的,反动的; [n]反动分子; [a]/riˈækʃəneri/; [or]sat;
supercilious: [x] [adj]目中无人的,高傲的; [a]/ˌsuːpərˈsɪliəs/; [or]sat;
effrontery: [x] [n]厚颜无耻; [a]/ɪˈfrʌntəri/; [or]sat;
dapper: [x] [adj]干净利落的,衣冠楚楚的; [a]/ˈdæpər/; [or]sat;
bilk: [x] [v]骗; [a]/bɪlk/; [or]sat;
chassis: [x] [n]底盘; [a]/ˈʃæsi/; [or]sat;
sunder: [x] [v]切开;分裂,分离; [a]/ˈsʌndər/; [or]sat;
paroxysm: [x] [n]突发,阵发; [adj]发作性的,爆发性的; [a]/ˈpærəksɪzəm/; [or]sat;
ecstasy: [x] [n]狂喜,心醉神怡; [a]/ˈekstəsi/; [or]sat;
indigent: [x] [adj]贫困的,贫穷的; [a]/ˈɪndɪdʒənt/; [or]sat;
temerity: [x] [n]鲁莽,大胆,蛮勇; [a]/təˈmerəti/; [or]sat;
loiter: [x] [v]虚度,闲荡,徘徊,走走停停; [a]/ˈlɔɪtər/; [or]sat;
extrovert: [x] [v]变成外向性格;使成外向性格; [n]性格外向者; [adj]性格外向的; [a]/ˈekstrəvɜːrt/; [or]sat;
feint: [x] [v]佯攻,虚击; [n]佯攻; [adj]虚假的; [a]/feɪnt/; [or]sat;
adulterate: [x] [v]掺假; [adj]通奸的;搀杂的; [n]掺假; [a]/əˈdʌltəreɪt/; [or]sat;
moribund: [x] [adj]濒临失败的,垂死的; [n]垂死的人; [a]/ˈmɔːrɪbʌnd/; [or]sat;
downcast: [x] [adj]意志消沉的,垂头丧气的,朝下的; [n]没落;俯视;[地]下落;[矿]通风井; [a]/ˈdaʊnkæst/; [or]sat;
derelict: [x] [adj]渎职的,荒废的,被弃置的; [n]失业贫穷的无家可归者; [a]/ˈderəlɪkt/; [or]sat;
assay: [x] [n]化验,试验; [v]分析,化验,鉴定; [a]/əˈseɪ/; [or]sat;
amnesty: [x] [n]赦免; [v]对.实行大赦; [a]/ˈæmnəsti/; [or]sat;
fiasco: [x] [n]大失败,惨败; [a]/fiˈæskoʊ/; [or]sat;
piebald: [x] [adj]花斑的;杂色的; [a]/ˈpaɪbɔːld/; [or]sat;
verdant: [x] [adj]青葱的,翠绿的; [a]/ˈvɜːrdnt/; [or]sat;
mystify: [x] [v]使神秘化,使迷惑,使困惑; [a]/ˈmɪstɪfaɪ/; [or]sat;
kaleidoscope: [x] [n]万花筒;千变万化; [a]/kəˈlaɪdəskoʊp/; [or]sat;
prescience: [x] [n]先见;预知; [a]/ˈpresiəns/; [or]sat;
acquiesce: [x] [v]默许;勉强同意; [adj]默认的; [a]/ˌækwiˈes/; [or]sat;
desiccate: [x] [v](使)完全干涸,脱水; [a]/'desɪˌkeɪt/; [or]sat;
grimace: [x] [v]做鬼脸,面部歪扭; [n]愁眉苦脸,怪相,鬼脸; [a]/ˈɡrɪməs/; [or]sat;
immutable: [x] [adj]永远不变的,永恒的; [a]/ɪˈmjuːtəbl/; [or]sat;
incarnation: [x] [n]赋与肉体,具人形,化身; [a]/ˌɪnkɑːrˈneɪʃn/; [or]sat;
pithy: [x] [adj]精练的,简洁有力的,多髓的; [a]/ˈpɪθi/; [or]sat;
orgy: [x] [n]狂欢;放荡; [a]/ˈɔːrdʒi/; [or]sat;
gist: [x] [n]主旨,要点;依据; [a]/dʒɪst/; [or]sat;
clientele: [x] [n]顾客,常客; [a]/ˌklaɪənˈtel/; [or]sat;
garnish: [x] [v]装饰(于食品上); [n]为增加色香味而添加的配菜;装饰品; [a]/ˈɡɑːrnɪʃ/; [or]sat;
servile: [x] [adj]奴颜婢膝的,卑屈的,隶属的; [n]奴隶; [a]/ˈsɜːrvl/; [or]sat;
bemused: [x] [adj]困惑的,发呆的; [a]/bɪˈmjuːzd/; [or]sat;
personable: [x] [adj]英俊的,风度好的; [a]/ˈpɜːrsənəbl/; [or]sat;
discomfit: [x] [v]挫败,扰乱,破坏,使.为难; [a]/dɪsˈkʌmfɪt/; [or]sat;
obsequious: [x] [adj]逢迎的,谄媚的; [a]/əbˈsiːkwiəs/; [or]sat;
inscrutable: [x] [adj]高深莫测的,神秘的; [a]/ɪnˈskruːtəbl/; [or]sat;
resilient: [x] [adj]能复原的,弹回的,有弹性的; [a]/rɪˈzɪliənt/; [or]sat;
ancillary: [x] [adj]辅助的,副的; [n]助手;辅助设备; [a]/ˈænsəleri/; [or]sat;
cherubic: [x] [adj]可爱的;天使的;无邪的; [a]/tʃəˈruːbɪk/; [or]sat;
traumatic: [x] [adj](精神)受创伤的,外伤的; [a]/traʊˈmætɪk/; [or]sat;
profligate: [x] [adj]放荡的;不检点的;恣意挥霍的; [n]放荡的人,浪子,肆意挥霍者; [a]/ˈprɑːflɪɡət/; [or]sat;
betroth: [x] [v]同.订婚,许配; [a]/bɪ'trɔːθ/; [or]sat;
temporize: [x] [v]拖延,妥协,顺应时势,迎合潮流; [a]/ˈtempəraɪz/; [or]sat;
ebullient: [x] [adj]热情洋溢的,沸腾的; [a]/ɪˈbʌliənt/; [or]sat;
tutelage: [x] [n]监护,指导; [a]/ˈtuːtəlɪdʒ/; [or]sat;
gauche: [x] [adj]笨拙的,不会社交的,偏转的; [a]/ɡoʊʃ/; [or]sat;
enervate: [x] [v]使虚弱;使无力; [a]/ˈenərveɪt/; [or]sat;
churlish: [x] [adj]脾气暴躁的;没有礼貌的; [a]/ˈtʃɜːrlɪʃ/; [or]sat;
vampire: [x] [n]吸血鬼; [a]/ˈvæmpaɪər/; [or]sat;
axiom: [x] [n]公理,定理; [a]/ˈæksiəm/; [or]sat;
servitude: [x] [n]劳役,奴役; [a]/ˈsɜːrvətuːd/; [or]sat;
turgid: [x] [adj]肿胀的;浮夸的;浮肿的; [a]/ˈtɜːrdʒɪd/; [or]sat;
pall: [x] [n]幕;棺罩;遮盖物; [v]覆盖;使乏味;走味; [a]/pɔːl/; [or]sat;
emissary: [x] [n]代理,信使,使者; [a]/ˈemɪseri/; [or]sat;
caption: [x] [n](报刊的)标题;(插图,照片等的)说明文字; [v]给(图片,照片等)加说明文字; [a]/ˈkæpʃn/; [or]sat;
prehensile: [x] [adj]适于抓握的;善于领会的; [a]/prɪˈhensl/; [or]sat;
testy: [x] [adj]性急的,暴躁的; [a]/ˈtesti/; [or]sat;
bevy: [x] [n]一群(少女或鸟); [a]/ˈbevi/; [or]sat;
anomalous: [x] [adj]反常的,不规则的,不恰当的; [a]/əˈnɑːmələs/; [or]sat;
imprudent: [x] [adj]轻率的,鲁莽的; [a]/ɪmˈpruːdnt/; [or]sat;
encomium: [x] [n]赞美; [a]/enˈkoʊmiəm/; [or]sat;
debilitate: [x] [v]使衰弱; [a]/dɪˈbɪlɪteɪt/; [or]sat;
outwit: [x] [v]以机智胜过; [a]/ˌaʊtˈwɪt/; [or]sat;
ballast: [x] [n](船等)压舱物;稳定因素;<比喻>沉着; [vt]给某物装上压舱物;给.铺道渣;使稳定;使沉着; [a]/ˈbæləst/; [or]sat;
insurrection: [x] [n]造反,叛乱; [a]/ˌɪnsəˈrekʃn/; [or]sat;
petulant: [x] [adj]性急的,易怒的,爱闹气的; [a]/ˈpetʃələnt/; [or]sat;
adventitious: [x] [adj]外来的,偶然的; [a]/ˌædvenˈtɪʃəs/; [or]sat;
blurt: [x] [v]突然说出,冲动地说; [a]/blɜːrt/; [or]sat;
depravity: [x] [n][n]恶劣行为;堕落,腐败,邪恶;腐败;邪恶;恶劣行为,腐化堕落的行为; [a]/dɪˈprævəti/; [or]sat;
enormity: [x] [n]巨大;暴行;极恶; [a]/ɪˈnɔːrməti/; [or]sat;
epitaph: [x] [n]碑文,墓志铭; [a]/ˈepɪtæf/; [or]sat;
meddlesome: [x] [adj]爱管闲事的,好事的,好插手的; [a]/ˈmedlsəm/; [or]sat;
disfigure: [x] [v]损伤外貌,使变丑; [a]/dɪsˈfɪɡjər/; [or]sat;
ossify: [x] [v]硬化,骨化; [a]/ˈɑːsɪfaɪ/; [or]sat;
cornucopia: [x] [n]象征丰收的羊角;装满花果及谷穗表丰饶的羊角状物;丰饶的象征; [a]/ˌkɔːrnjuˈkoʊpiə/; [or]sat;
welter: [x] [n]混乱;滚浪;翻滚;起伏; [v]翻滚;沉溺;起伏; [adj]负重赛马的; [a]/ˈweltər/; [or]sat;
alacrity: [x] [n]反应迅速,乐意; [a]/əˈlækrəti/; [or]sat;
pseudonym: [x] [n]笔名,假名; [a]/ˈsuːdənɪm/; [or]sat;
billowing: [x] [adj]波涛翻滚; [a]/ˈbɪloʊɪŋ/; [or]sat;
stricture: [x] [n]谴责;严厉;束缚; [a]/ˈstrɪktʃər/; [or]sat;
certitude: [x] [n]确实;确信;必然性; [a]/ˈsɜːrtɪtuːd/; [or]sat;
protean: [x] [adj]变化多端的,能够变化的; [a]/ˈproʊtiən/; [or]sat;
tremulous: [x] [adj]胆小的,颤动的,不安的; [a]/ˈtremjələs/; [or]sat;
simile: [x] [n]直喻,明喻; [a]/ˈsɪməli/; [or]sat;
volition: [x] [n]决定;自主;意志力;下决心;意志力; [a]/voʊˈlɪʃn/; [or]sat;
torrid: [x] [adj]酷热的,热烈; [a]/ˈtɔːrɪd/; [or]sat;
nonchalance: [x] [n]无动于衷,冷淡; [a]/ˌnɑːnʃəˈlɑːns/; [or]sat;
mentor: [x] [n]导师,指导; [vt]做.的良师;指导; [a]/ˈmentɔːr/; [or]sat;
celibate: [x] [n]独身者,独身主义者; [adj]独身的,未婚的,禁欲的; [a]/ˈselɪbət/; [or]sat;
upbraid: [x] [v]斥责,责骂; [a]/ʌpˈbreɪd/; [or]sat;
omnivorous: [x] [adj]杂食的,兴趣广泛的; [a]/ɑːmˈnɪvərəs/; [or]sat;
solemnity: [x] [n]庄严,肃穆,庄严的仪式; [a]/səˈlemnəti/; [or]sat;
painstaking: [x] [adj](不辞)劳苦的,辛勤的; [n]辛劳,煞费苦心; [a]/ˈpeɪnzteɪkɪŋ/; [or]sat;
quizzical: [x] [adj]困惑的,引人发笑的,嘲弄的,探询的; [adv]疑问地,戏弄地; [a]/ˈkwɪzɪkl/; [or]sat;
doctrinaire: [x] [adj]教条主义的,空谈理论的; [n]空论家,纯理论家; [a]/ˌdɑːktrəˈner/; [or]sat;
extenuate: [x] [v]减轻,低估,为.找借口,使人原谅; [a]/ɪk'stenjʊˌeɪt/; [or]sat;
incontrovertible: [x] [adj]无可争议的; [a]/ˌɪnkɑːntrəˈvɜːrtəbl/; [or]sat;
amalgamate: [x] [v]合并,混合; [a]/əˈmælɡəmeɪt/; [or]sat;
fallacious: [x] [adj]谬误的,易误解的,虚妄的; [a]/fəˈleɪʃəs/; [or]sat;
altruistic: [x] [adj]利他的;无私心的; [a]/ˌæltruˈɪstɪk/; [or]sat;
bard: [x] [n]吟游诗人; [a]/bɑːrd/; [or]sat;
vignette: [x] [n]装饰图案;小插图; [v]把..印放为虚光照,晕映; [a]/vɪnˈjet/; [or]sat;
mendacious: [x] [adj]撒谎的,虚假的; [a]/menˈdeɪʃəs/; [or]sat;
abscond: [x] [v]逃匿,潜逃;避债; [a]/əbˈskɑːnd/; [or]sat;
fluke: [x] [n]侥幸成功;意外的挫折; [v]侥幸做成;意外受挫; [a]/fluːk/; [or]sat;
sartorial: [x] [adj]裁缝匠的,裁缝的;缝纫的; [a]/sɑːrˈtɔːriəl/; [or]sat;
askew: [x] [adj]歪斜的; [adv]歪斜地,斜地; [a]/əˈskjuː/; [or]sat;
lackluster: [x] [n]无光泽;暗淡; [adj]无光泽的;平凡的; [a]/ˈlækˌlʌstər/; [or]sat;
stupefy: [x] [v](使)茫然,吓呆; [a]/ˈstuːpɪfaɪ/; [or]sat;
fetid: [x] [adj]有恶臭的; [a]/ˈfetɪd/; [or]sat;
tempestuous: [x] [adj]有暴风雨的,暴乱的,剧烈的; [a]/temˈpestʃuəs/; [or]sat;
beleaguer: [x] [v]围攻; [a]/bɪ'liːgə/; [or]sat;
cajole: [x] [v]以甜言蜜语哄骗,勾引; [a]/kəˈdʒoʊl/; [or]sat;
demented: [x] [adj]发狂的,精神错乱的; [v]精神错乱;变得痴呆; [a]/dɪˈmentɪd/; [or]sat;
indisputable: [x] [adj]没有争论余地,非常清楚的; [a]/ˌɪndɪˈspjuːtəbl/; [or]sat;
astigmatism: [x] [n]散光; [a]/əˈstɪɡmətɪzəm/; [or]sat;
acclimate: [x] [v]服水土,适应新环境; [a]/ˈækləmeɪt/; [or]sat;
flagrant: [x] [adj]罪恶昭彰的,残暴的,丑恶可耻的,明目张胆的; [a]/ˈfleɪɡrənt/; [or]sat;
piety: [x] [n]虔诚,虔诚的行为或语言; [a]/ˈpaɪəti/; [or]sat;
euphemism: [x] [n]婉言,委婉的说法; [a]/ˈjuːfəmɪzəm/; [or]sat;
mellifluous: [x] [adj](曲调)优美的;流畅的;如蜜般的; [a]/meˈlɪfluəs/; [or]sat;
raiment: [x] [n]衣服; [a]/ˈreɪmənt/; [or]sat;
unsightly: [x] [adj]难看的; [a]/ʌnˈsaɪtli/; [or]sat;
singular: [x] [adj]单独的,单个的;奇怪的;非凡的,卓越的,显著的; [n]单数;单数形式; [a]/ˈsɪŋɡjələr/; [or]sat;
surreptitious: [x] [adj]鬼鬼祟祟的,暗中的,秘密的; [a]/ˌsɜːrəpˈtɪʃəs/; [or]sat;
sensual: [x] [adj]感官的;色情的,肉欲的; [a]/ˈsenʃuəl/; [or]sat;
rapt: [x] [adj]全神贯注的,着迷的;狂喜的; [a]/ræpt/; [or]sat;
tendentious: [x] [adj]有偏见的,有倾向的;宣传性的; [adv]宣传性地,不公平地,有倾向性地; [n]倾向性小说; [a]/tenˈdenʃəs/; [or]sat;
imperceptible: [x] [adj]极细微的,觉察不到的,感觉不到的,; [a]/ˌɪmpərˈseptəbl/; [or]sat;
antipathy: [x] [n]反感,厌恶,憎恶; [a]/ænˈtɪpəθi/; [or]sat;
epigram: [x] [n]机智的言语; [a]/ˈepɪɡræm/; [or]sat;
queasy: [x] [adj]呕吐的;不稳定的; [a]/ˈkwiːzi/; [or]sat;
bludgeon: [x] [v]用棍棒击打;恫吓; [n]大头狼牙棒; [a]/ˈblʌdʒən/; [or]sat;
repugnant: [x] [adj]令人厌恶的; [a]/rɪˈpʌɡnənt/; [or]sat;
soliloquy: [x] [n]自言自语,独白; [a]/səˈlɪləkwi/; [or]sat;
aplomb: [x] [n]沉着,镇静; [a]/əˈplɑːm/; [or]sat;
hallowed: [x] [adj]神圣的; [a]/ˈhæloʊd/; [or]sat;
vacuous: [x] [adj]空的,空虚的,空洞的,无意义的; [a]/ˈvækjuəs/; [or]sat;
forsake: [x] [v]放弃;抛弃,离开; [a]/fərˈseɪk/; [or]sat;
politic: [x] [adj]策略性的,政治上的,国家的; [a]/ˈpɑːlətɪk/; [or]sat;
retribution: [x] [n]报应,惩罚,报答,报偿; [a]/ˌretrɪˈbjuːʃn/; [or]sat;
blanch: [x] [v]变白;漂白; [n]铅矿石; [adj]漂白的;银白色的; [a]/blæntʃ/; [or]sat;
gait: [x] [n]步态,步法,速度; [a]/ɡeɪt/; [or]sat;
exculpate: [x] [v]声明无罪,开脱,使无罪; [a]/ˈekskʌlpeɪt/; [or]sat;
candor: [x] [n]坦白,直率,诚挚; [a]/'kændə/; [or]sat;
abstemious: [x] [adj](吃喝等)有节制的,节俭的; [a]/əbˈstiːmiəs/; [or]sat;
scurry: [x] [v]快速疾走,急跑,急躁不安地来回走动; [n]快步急跑;疾走;仓皇奔跑声;骤雨; [a]/ˈskɜːri/; [or]sat;
recalcitrant: [x] [adj]顽抗的,不顺从的; [a]/rɪˈkælsɪtrənt/; [or]sat;
unassuming: [x] [adj]谦逊的,不装腔作势的; [a]/ˌʌnəˈsuːmɪŋ/; [or]sat;
incorrigible: [x] [adj]积习难改的,不可救药的; [a]/ɪnˈkɔːrɪdʒəbl/; [or]sat;
disparage: [x] [v]蔑视;贬损; [a]/dɪˈspærɪdʒ/; [or]sat;
obdurate: [x] [adj]固执的,冷酷无情的; [a]/ˈɑːbdərət/; [or]sat;
punctilious: [x] [adj]一丝不苟的,精密细心的,拘泥形式的; [a]/pʌŋkˈtɪliəs/; [or]sat;
abash: [x] [v]使局促不安;使羞愧; [adj]窘迫的,尴尬的; [adv]窘迫地,尴尬地; [n]窘迫,尴尬; [a]/ə'bæʃ/; [or]sat;
repercussion: [x] [n]反响;弹回;反射; [a]/ˌriːpərˈkʌʃn/; [or]sat;
serenity: [x] [n]平静; [a]/səˈrenəti/; [or]sat;
truncate: [x] [adj]截短的;被删节的; [v]把(某物)截短,去尾; [a]/ˈtrʌŋkeɪt/; [or]sat;
perpetrate: [x] [vt]犯罪,作恶;干坏事; [a]/ˈpɜːrpətreɪt/; [or]sat;
luminary: [x] [n]杰出人物,发光体; [a]/ˈluːmɪneri/; [or]sat;
verbatim: [x] [adj]逐字的; [adv]逐字地; [a]/vɜːrˈbeɪtɪm/; [or]sat;
cognitive: [x] [adj]认识能力的;认知的; [a]/ˈkɑːɡnətɪv/; [or]sat;
jingoist: [x] [n]沙文主义者,侵略主义者; [a]/dʒɪŋɡə'ʊɪst/; [or]sat;
entourage: [x] [n]随从,周围,环境; [a]/ˈɑːnturɑːʒ/; [or]sat;
disjointed: [x] [adj]杂乱的,无逻辑的,脱节的; [a]/dɪsˈdʒɔɪntɪd/; [or]sat;
disembark: [x] [vi]上岸,登陆,下车,下飞机; [vt]使上岸;使登陆; [a]/ˌdɪsɪmˈbɑːrk/; [or]sat;
swathe: [x] [n]带子,绷带;包装品; [vt]包围;紧绑;裹; [a]/sweɪð/; [or]sat;
preempt: [x] [v]制止,以先买权取得,取代; [n]〔经〕优先占有; [a]/priː'empt/; [or]sat;
impropriety: [x] [n]不当行为;不适当;不正确; [a]/ˌɪmprəˈpraɪəti/; [or]sat;
brusque: [x] [adj]唐突的,直率的,无礼的; [a]/brʌsk/; [or]sat;
waylay: [x] [v]埋伏,伏击; [a]/weɪˈleɪ/; [or]sat;
apocryphal: [x] [adj]伪的;可疑; [a]/əˈpɑːkrɪfl/; [or]sat;
despot: [x] [n]专制君主,暴君;独裁者; [a]/ˈdespɑːt/; [or]sat;
obtuse: [x] [adj]迟钝的;圆头的;不锋利的; [a]/əbˈtuːs/; [or]sat;
menagerie: [x] [n]形形色色,动物园,野生动物(总称); [a]/məˈnædʒəri/; [or]sat;
bungle: [x] [v]办糟,失败; [n]粗劣,失败,笨拙; [a]/ˈbʌŋɡl/; [or]sat;
evanescent: [x] [adj]短暂的,容易消散的,(印象等)逐渐消失的,会凋零的; [a]/ˌevəˈnesnt/; [or]sat;
staccato: [x] [adj](音乐)断音的,不连贯的; [n]断奏;断续的一段音乐;不连贯的东西(如说话,发动机的声音等); [adv]断音地;不连接地; [a]/stəˈkɑːtoʊ/; [or]sat;
willful: [x] [adj]有意的,任性的,故意的; [a]/ˈwɪlfl/; [or]sat;
hodgepodge: [x] [n]大杂烩,混煮,一团糟; [a]/ˈhɑːdʒpɑːdʒ/; [or]sat;
impregnable: [x] [adj]攻不破的,征服不了的; [a]/ɪmˈpreɡnəbl/; [or]sat;
cantankerous: [x] [adj]脾气坏的,好争吵的; [a]/kænˈtæŋkərəs/; [or]sat;
luscious: [x] [adj]美味的;满足感官的; [a]/ˈlʌʃəs/; [or]sat;
apotheosis: [x] [n]神化,典范,崇拜,颂扬; [a]/əˌpɑːθiˈoʊsɪs/; [or]sat;
ellipsis: [x] [n]省略,省略符号; [a]/ɪˈlɪpsɪs/; [or]sat;
[kk9: sat/2947]