hang on: 稍等一下(不要挂电话);坚持住;  
previously on + ..(剧名): ..的前情回顾
heart beat: 心跳(声)
birth/biological father: 生父
foster father: 养父
Lady Justice: 正义女神
Your Majesty: 陛下
a lightning rod: 一根避雷针
pay the price: 付出代价
wake up: 醒来
glow stick: 荧光棒
go through: 通过(考试),挺过(艰难的时期)
slow suicide: 慢性自杀
stir things up: 挑拨是非
mid-life crisis: 中年危机
drop sb off: 让某人下车
flip a coin: 抛硬币(决定某事)
crossword puzzle: 纵横字谜游戏
side effect: 副作用
Walt junior: 小Walt(大Walt的儿子)
hair loss: 脱发
shopping list: 购物清单
take it out on sb: 把气出在..身上
big time: 历史性时刻
one true love: 唯一的爱
money laundering: 洗钱
put sb in jail: 把某人送进监狱
put sth away: 把..收起来
tough guy: 硬汉
walk away: 走开
boarding school: 寄宿学校 
formal invitation: 正式邀请
take a day off: 请一天假
drive sb crazy: 把某人逼疯
set sb up: 设计陷害某人
vice present: 副总统
work ethic: 职业道德
give a hand to sb: 帮助某人
check my balance: 检查我的收支(账户)
hobo: 流浪汉
anesthetic: 麻醉剂


