Antarctica: 南极洲  
Arctic: 北极的  
Christian: 基督教徒
Darwinism: 达尔文学说  
Jupiter: 木星
Mars: 火星;战神
Mercury: 水星 
Mercury: 水星  
Mesolithic: 中石器时代的  
Neolithic: 新石器时代的  
Neptune: 海王星
Paleolithic: 旧石器时代的  
Pluto: 冥王星
Saturn: 土星
Senate: 参议院  
Uranus: 天王星
Venus: 金星
abacus: 算盘
abdicate: 放弃权力
abide: 遵守  
able:
abolish: 废除  
aboriginal: 土著 
about:
abridge: 缩短
absolve: 赦免  
absorb: 吞并  
abstain: 戒绝  
abstinence: 禁戒;节制   
abstract: 提炼
abstraction: 摘要
accelerate: 加速
account:
account: 账目  
accusation: 控告  
accuse: 控告  
acid:
acquit: 宣告无罪  
across:
act:
acting: 代理的  
action: 作用  
acute: 急性的
adage: 格言
adaptadaptable: 可修改的
adaptation: 改写
addict: 瘾君子  
addition:
adherent: 信奉者  
adhesive: 粘合剂  
adjustment:
administer: 管理  
administration: 行政
adult: 成人  
advertisement:
advocate: 拥护者 
aesthetic: 美学的
affiliate: 加盟 
affirm: 证实  
after:
again:
against:
aggregate: 合计
agreement:
agricultural: 农业的  
agriculture: 农业学  
air:
alchemy: 炼金术  
all:
almost:
altitude: 海拔高度  
aluminum: 铝  
alumni:男校友  
amendment: 改善 
ammonia: 氨水  
among: 在..之中
amount: 数量;等于
amphibian: 两栖类的;水陆两用的  
amplifier: 扩音器;放大器
amusement:
anarchism: 无政府主义
anatomy: 解剖
ancestor: 祖先 
and:
angle:
angle: 角度
angry:
animal:
answer:
ant:
antarctic: 南极的  
antenna: 触须  
anthropologist: 人类学家  
anthropology: 人类学  
antique: 古董  
antiquity: 古老是遗物  
any:
apparatus: [ˌæpəˈreɪtəs]仪器;器官
appetite: 食欲  
apple:
apprentice: 学徒 
approval:
aquaculture: 水产业 
aquatic: 水生的  % ~ plants  
arable: 适于耕种的 
arbitration: 调停;仲裁  
arbitrator: 仲裁者  
arch:
archaic: 古的  
archeologist: 考古学家  
archeology: 考古学  
area: 面积;地区
argument:
arid: 干旱的  
aristocrat: 贵族  
arithmetic: 算数
arm:
armament: 兵力  
armor: 装甲  
army:
array: 队列  
art:
artifact: 人造物品  
artificial: 人造的  
as:
ascend: 追溯  
assassin: 刺客 
assault: 袭击  
assess: 估计  
asset: 资产 
assimilate: 吸收  
assure: 是...确信;向...保证  
asteroid: 小行星
astrology: 占星术
astronaut: 宇航员  
astronomer: 天文学家  
astronomical: 天文学的(因庞大而无法估计的);天文
astronomy: 天文学
astrophysics: 天体物理学
at:
atheism: 无神论
athlete: 运动员  
atmosphere: 大气层  
attack:
attempt:
attendant: 侍者;护理人员
attention:
attorney: 辩护律师;检察官  
attraction:
attrition: 磨损
audience: 观众  
audit: 查账  
auditor: 审计人员  
authoritative: 权威性的  
authority:
authority: 权威  
authorize: 授权  
autocrat: 独裁者  
automatic:
autonomy: 自治权 
avant-garde: 先锋派;前卫  
aviator: 飞行家  
awake:
baboon: 狒狒  
baby:
bachelor: 学士;单身汉  
back:
bad:
bag:
balance:
balance: 平衡  
ball:
ballot: 选票 
balmy: 温和的  
ban: 禁止  
band:
band: 乐队
band: 波段
bandit: 强盗  
banish: 驱逐入境  
bankruptcy: 破产  
bar: 法院  
barbarian: 野蛮人 
bark: 树皮
barn: 谷仓;畜舍  
barometer: 气压计  
barter: 易货  
base:
basin:
basin: 盆地  
basket:
bat: 蝙蝠;棒球  
bath:
be:
beak: 鸟嘴  
beast: 兽;畜生  
beautiful:
beaver: 海狸  
because:
bed:
bee:
before:
behaviour:
belief:
believer: 信徒 
bell:
benefactor: 喜欢帮助他人的人;恩人  
benificiary: 受益者  
benifit: 利益 
bent:
berry:
beset: 包围  
besiege: 围  
between:
bidding: 投标  
bill: 法案  
bill: 账单  
bill: 鸟嘴  
biochemistry: 生物化学  
biograhper: 传记作者  
bird:
birth:
bit:
bite:
bitter:
black:
blade: 刀片;叶片(螺旋桨;风扇等的轮片)
blast: 一阵风  % a ~ of wind  
blast: 爆破  
bleach: 漂白 
blend: 混合  
blessed: 受祝福的  
blizzard: 大风雪  
blood:
blow:
blue:
board:
board: 委员会  
boat:
body:
boiling:
bonanza: 富矿带  
bond: 债券  
bone:
bonus: 红利  
book:
boot: 靴子;踢;启动
borehole: 钻孔  
botanical: 植物学的
botanist: 植物学家  
botany: 植物学 
bottle:
bough: 大树枝 
bound: 有义务的  
boundary: 边界
boundless: 无限的
box:
boy:
brain:
brake: 刹车;阻碍(物)
branch:
branch: 分枝  
brass: 黄铜
bread:
breath:
breed: 抚养;繁殖  
breed: 饲养 
breeze: 微风  
brick:
bridge:
bright:
brim: (杯,碗)边
brink: 边缘
broken:
brother:
brown:
bruise: 打伤fester 
brush:
bucket:
bud: 发芽  
budget: 预算 
buffalo: 水牛  
building:
bulb:
bulk: 容积
bunch: 串;束  
burglar: 窃贼   
burn:
burning: 燃烧的  
burst:
business:
but:
butter:
button:
by:
byword: 谚语
cake:
calcium: 钙  
calculate: 计算
calculation: 计算
calculator: 计算器
calculus: 微积分学
caliber: 口径
calorie: 卡路里  
camera:
camouflage: 伪装  
canary: 淡黄色;金丝雀  
candidate: 候选人  
canvas:
canyon: 峡谷
captivity: 囚禁;拘留  
carbohydrate: 碳水化合物 
carbon: 碳  
card:
care:
carnal: 肉体的  
carnivore: 食肉动物  
carnivorous: 食肉类的  
carriage:
cart: 二轮运货马车
cat:
cataclysm: 大灾难  
catalysis: 催化作用  
catalyst: 催化剂  
catching: 传染的
caterpillar: 毛虫  
cattle: 牛  
cause: n. 原因;事业;目标 vt. 引起;使遭受
cause: 事业  
caustic: (具有)腐蚀性的  
cavern: 大洞穴  
celebrity: 名人 
celestial: 天体的
cell: 单元
censor: 检查员  
centigrade: 摄氏的 
cereal: 粮食/谷类食品
certain:
chafe: 擦热
chain:
chalk: 粉笔; 白垩底层
chameleon: 变色龙  
champion: 冠军  
chance:
change:
channel: 渠道;频道  
character: 文字
character: 角色  
charge: 收费;费用  
charge: 猛攻  
cheap:
check: 支票  
check: 检查
cheese:
chemical:
chemistry: 化学  
chest:
chief:
chill: 寒冷  
chilly: 寒冷的  
chimpanzee: 黑猩猩  
chin:
chip: 芯片
chirp: (虫子或鸟)发出喳喳声  
choice: 选择 
chondrite: 球粒状陨石
choose: 选择 
choreography: 舞蹈设计师 
chorus: 合唱团
chromosphere: 色球
chronological: 按年代顺序的  
church:
cipher: 暗号  
circle:
circle: 圆周;派系
circuitous: 迂回的
circular: 循环的
circulate: 使循环
circulation: 循环
circumference: 圆周
civilian: 平民  
clam: 蛤  
clan: 部落;宗族;党派  
clandestine: 秘密的  
class: 纲  
clause: 分句
clause: 条款  
clean:
clear:
cleft: 裂缝  
clergy: 神职人员  
climate: 气候  
clinic: 门诊所
clock:
clot: 凝块
cloth:
cloud:
cluster: 丛
cluster: 星团
clutter: 混乱
coal: 燃烧着的木炭或者煤块
coastland: 沿海岸地区  
coat:
coelenterate: 腔肠动物  
cogent: 强有力的
cohesion: 凝聚力
cohesive: 有凝聚力的
coin: 创造
coin: 硬币  
cold:
collar:
collateral: 抵押品  
colonize: 殖民
colour:
column: 圆柱
comb:
combination: 组合  
come:
comet: 彗星
comfort:
commander: 司令官;指挥员  
commentator: 评论家  
commerce: 商业  
commission: 佣金  
commission: 委员会  
committee:
committee: 委员  
common:
community: 社区  
company:
company: 伙伴 
comparison:
compatible: 兼容的 
compensation: 补偿  
competition:
compile: 编纂;收集
complaint: 控告  
complete:
complex:
compound: 化合物  
compulsory: 义务的;必修的  
concert: 音乐会
concise: 简明的
condense: 使浓缩  
condition:
condition: 健康情形
condone: 赦免  
conduct: 引导 
cone: 圆周
confederate: 同盟
confer: 协商  
confidential: 机密的  
confirm: 证实;确认  
confiscate: 没收;充公  
congress: 国会  
congressman: 国会议员  
conjure: (用魔术)变出
connection:
connoisseur: 鉴赏家  
conscious:
consecrate: 奉为神圣
conservative: 保守的人 
conservatory: 温室 
conservatory: 音乐学校
consolidate: 合并  
constellation: 星座
constituent: 成分
constitute: 构成;组成
constitution: 宪法   
consume: 消耗  
consumer: 消费者  
contagious: 传染的
contaminate: 污染  
continent: 大陆  
contour: 轮廓  
contract: 契约   
contract: 感染
control:
convention: 传统  
conventional: 传统的  
convict: 判罪;证明  
cook:
copper: 铜  
copper: 铜;铜币
copy:
coral: 珊瑚  
cord: 绳索;捆绑
core: 果核;核心  
cork: 瓶塞
corona: 日冕
corps: 军团  
corpse: 尸体
corrode: 腐蚀  
cosmic: 宇宙的
cosmology: 宇宙论
cosmopolitan: 世界性的 % ~ city  
cosmos: 宇宙
cotton:
cotton: 棉花 
cough:
counsel: 律师 
country:
court: 法庭  
cover:
cow:
cowshed: 牛舍  
crab: 螃蟹  
crack:
cranial: 头盖形的  
crater: 弹坑  
creature: 生物  
credential: 凭证  
credit:
creed: 信仰;信条
creek: 小溪
crevice: 裂缝; 破口  
crew: 船员  
crime:
critic: 评论家  
crossbreed: 杂交
cruel:
crush: 压碎,压扁;将..塞进(狭小的空间内)
crust: 地壳;硬外皮 % the ~ of the pie
cry:
crystal: 晶体  
cube: 立方体
cult: 崇拜;邪教 % the ~ leader
cult: 崇拜者;邪教  
cultivate: 耕种;培养  
cultivation: 耕种;培养   
cup:
currency: 货币  
current:
current: (气体,液体)流
current: 气流;电流  
curriculum: 课程  
curtain:
curve:
cushion:
custom: 进口税  
cut:
dagger: 短剑  
damage:
damp: 潮湿的  
danger:
dank: 阴湿的
dark:
daughter:
day:
dead:
deal: 交易  
dear:
death:
debt:
debt: 债务  
debtor: 欠债的一方;债务人  
decay: 使腐败  
decelerate: 减速
decibel: 分贝  
decimal: 十进制的
decision:
declivity: 下倾的斜面
decomposition: 分解  
decree: 颁布;法令  
deduction: 演绎(推论)
deep:
default: 拖欠;不履行责任  
defend: 辩护  
deficit: 赤字  
degree:
degree: 度数
dehydrate: 脱水
deity: 神
delegate: 代表 
delicate: 精美的
democracy: 民主 
democrat: 民主党人  
denounce: 告发  
dependent:
deport: 放逐  
deposit: 存款 
depreciate: 贬值  
depression: 萧条  
deputy: 代理人 
descent: 血统  
deserve: 应得  
design:
design: 设计
desire:
despoil: 夺取   
destine: 命中注定
destiny: 命运
destruction:
detail:
detain: 拘留;阻止  
development:
devout: 虔诚的
dew: 露水 
diagnose: 诊断
diagnosis: 诊断
diagram: 图标
dialect: 方言
diameter: 直径 
diamond: 钻石;菱形  
dictatorial: 独裁的
didactic: 说教的  
different:
diffuse: 扩散;传播
digestion:
digit: 数字
dilute: 稀释
dimension: 尺度
dinosaur: 恐龙  
diplomacy: 外交  
diplomatic: 外交的
direct: 引导  
direction:
dirty:
disarm: 缴械投降  
disarming: 消除敌意的  
disburse: 支付  
discharge: 释放
disciple: 门徒  
discipline: 学科 
discount: 折扣  
discovery:
discrete: 离散的
discussion:
disease:
disgust:
dispersion: 离差
dissect: 解剖
dissimulate: 掩饰  
dissolve: 溶解  
distance:
distillation: 蒸馏
distribution:
divide: 除;分割  
division:
do:
doctrine: 主义
doctrine: 教义
dog:
dogma: 教条
dolphin: 海豚  
domain: 领土;领域 
domestic: 国内的
domesticate: 驯养  
dominate: 统治 
domineering: 专权的  
donor: 捐助者  
doomed: 命中注定的
door:
dormant: 休眠的  % a ~ volcano  
doubt:
doughnut: 甜甜圈  
down:
downpour: 倾盆大雨  
drain: 下水道;排水
draw: 画
drawback: 退款  
drawer:
dress:
drink:
driving:
drizzle: 下毛毛细雨  
drop:
droplet: 小滴  
drought: 干旱  
dry:
dual: 二重的
dust:
dwarf: 白矮星
dye: 染色  
dynamics: 动力学
ear:
early:
earth:
earthquake: 地震  
east:
ebb: 退潮  
echo: 回声
ecologist: 生态学家  
economic: 经济的  
economics: 经济学  
ecosystem: 生态系统  
edge:
edge: 边
edify: 教化  
education:
educator: 教育学家  
effect:
egg:
eggplant: 茄子 
egoist: 自我主义者  
eject: 喷出
elastic:
elasticity: 弹性
election: 选举 
electric:
electricity: 电流;电学
electromagnet: 电磁石
electromagnetism: 电磁学
electron: 电子 
electronics: 电子学
element: 元素  
elevation: 高度;高地(upland); 正面图; 晋级; 提升 
ellipse: 椭圆  
embroider: 绣花  
emend: 修订
emerald: 绿宝石(翡翠等)  
emigrate: 移民 
emission: (光,热)散发;喷射
emit: 放射
employee: 员工  
employer: 雇主;老板  
empower: 授权  
enable: 使能够
enact: 制定法律  
enact: 扮演
enchant: 施魔法于
encroach: 蚕食;侵占  
end:
endemic: 地方的 % ~ diseases  
endless: 无止境的
engine:
enlighten: 启发  
enlist: 招募 
enough:
enslave: 奴役  
enterprise: 事业  
entitle: 给...权利
entitle: 题目为
entrepreneur: 企业家  
enumerate: 计数;枚举(列出集合中的成员)
envelope: 包围   
envoy: 使者  
episode: 插曲
equal:
equation: 等式
equator: 赤道  
equilibrium: 平衡状态
erode: 腐蚀  
erosion: 腐蚀  
error:
erupt: 爆发  
eruption: 爆发; 火山灰  
estimate: 估计
ethics: 伦理学  
ethnic: 种族的  
ethnology: 人种学  
euphonious: 悦耳的 
evaluate: 评估
evaporate: 蒸发
even:
even: 偶数的;平的
event:
ever:
every:
evidence: 证据  
evolutionary: 进化的  
evolve: 使进化  
example:
excavate: 挖掘  
excavation: 出土文物  
excerpt: 摘录
exchange:
exchange: 兑换  
exempt: 免除  
exhume: 掘出  
exile: 流放
exile: 被流放者 
exist: 生存 
existence:
exodus: 大批离去
exotic: 外来的;有异国风味的  
expansion:
expedite: 加速
expedition: 远征  
experience:
expert:
explode: 使爆炸  
exploit: 剥削 
explosive: 爆炸的   
exponent: 指数  
exponent: 解释者 % a staunch ~ of civil rights  
extenuate: 使(罪过等)显得轻微  
exterminate: 消灭 
extinct: 灭绝的  
extinction: 灭绝  
extinguish: 消灭  
eye:
eyewitness: 目击者  
fable: 寓言
face:
facet: 平面
fact:
factious: 党派的  
faculty: 全体教员  
faithful: 信徒 
fall:
false:
family:
family: 科  
fanatic: 盲信者 
far:
farce: 闹剧
farm:
fat:
fatalism: 宿命论  
father:
fault: 断层  % ~ plane  
fauna: 动物群  
fear:
feather:
feeble: 虚弱无力的
feeling:
female:
feminist: 女权者 
fermentation: 发酵  % during ~  
fern: 蕨类植物  
fertile:
fertile: 肥沃的;多产的 % the ~ couple
fertilize: 使受精  
fertilizer: 肥料  
feverish: 发烧的
fiction:
fiction: 小说
field:
fieldstone: (建筑用)散石;大软石  
fight:
figure: 图形
figurehead: 名义领袖  
finance: 财政;资助  
finch: 鸣禽  
fine: 罚金  
finger:
fire:
first:
fish:
fixed:
flag:
flame: 火焰;热情
flat:
flaw: 缺陷; 裂隙  
flee: 逃跑  
flight:
flock: (禽,畜等的)群  
floor:
flora: 植物界
flower:
flower: 花
fluent: 流畅的
fluffy: 松软的  
fly:
foam: 泡沫
fodder: 饲料 
foe: 敌人
fog: 烟雾  
fold:
foliage: 树叶;植物
follow: 跟随;遵循  
food:
foolish:
foot:
for:
forbid: 禁止   
force:
force: 力
forerunner: 先驱  
fork:
form:
formation: 形成  
fort: 要塞  
fortress: 要塞  
fortune: 财富  
forward:
fossil: 化石  
fowl:
fowl: 家禽  
fracture: 骨折
fragile: 体质弱的
frame: 框架;结构
free:
frequent:
friction: 摩擦
friend:
frigid: 寒冷的  
from:
front:
frost: 结霜  
fruit:
full:
fume: (浓烈或难闻的)烟;气体  
functional: 起作用的  
fund: 基金  
funnel: 漏斗云  
fusion: 熔合
future:
fuzzy: 毛茸茸的  
galaxy: 银河;星系
gale: 大风
gallery: 画廊
gap: 裂口; 分歧 % generation ~  
garden:
garlic: 大蒜 
garner: 储存  
gash: 深的切口
gasoline: 汽油  
gasp: 喘息  
gem: 宝石  
general:
genre: 题材;风格
genteel: 上流社会的  
gentry: 贵族  
genus: 种;类  
geographer: 地理学者  
geography: 地理学  
geologist: 地质学者  
geology: 地质学  
geometry: 几何学
geothermy: 地热  
germinate: 发芽
get:
girl:
give:
glacial: 冰河的 % glacial period  
glacier: 冰川  
glass:
glossary: 词汇表
glove:
glucose: 葡萄糖  
go:
goat:
gold:
good:
goods: 货物  
gorge: 峡谷
gorilla: 大猩猩  
govern: 决定;支配;控制  
government:
grain:
granary: 谷仓  
granite: 花岗岩  
grass:
gravitation: 地心引力 
graze: 放养 % This feild  will ~ 30 head of cattle.  
greasy: 动物脂  % ~ monkey  
great:
green:
greenhouse: 温室;花房 
gregarious: (喜欢)群居的  
grey:
grip: 紧紧地抓住
group:
growth:
guide:
gun:
habitat: 栖息地  
hackneyed: 陈腐的  
hail: 冰雹 
hair:
hammer:
hand:
hanging: 帘子;悬挂;绞刑
happy:
harbour: 港口;避难所
hard:
harmony:
harsh: 刺耳的
harvest: 收获  
hat:
hatch: 破壳孵出;(飞机或宇宙飞船的)舱门;   
hatchet: 短柄斧 
hate:
have:
hay: 干草 
haystack: 干草堆  
he:
head:
heal: 治愈
healthful: 有益健康的
healthy:
hearing: 听力;审讯
heart:
heat:
heirship: 继承权  
helium: 氦  
help:
hemisphere: 半球  
herb: 药草 
herbivorous: 食草类的  
herd: 兽群;牧群  
here:
heresy: 异端邪说
hermit: 隐居者  
hibernate: 冬眠  
hide: 兽皮  
high:
history:
hole:
hollow:
hominid: 原始人类  
homotherm: 恒温动物  
hook:
hope:
hordes: 昆虫群  
horizon: 地平线  
horizontal: 水平的
horn:
horse:
horticulture: 园艺  
hospital:
hour:
house:
household: 一家人;家喻户晓的  
how:
human: 人类的  
humanitarian: 人道主义者  
humid: 潮湿的  
humidity: 潮湿  
humour:
hump: 驼峰  
hurricane: 飓风  
husbandry: 耕种;管理 
husk: (果类或谷物)外壳;皮
hustle: 驱赶
hybrid: 杂交 
hydrocarbon: 碳氢化合物  
hydronic: 液体循环加热的  
hydroponics: 水栽培  
hygiene: 卫生
ice:
iceberg: 冰山 
idea:
ideology: 意识形态
idiocy: 白痴 
idol: 偶像 % American Idol  
if:
ignite: 使燃着  
ill:
illegitimate: 非法的;私生的  
illicit: 违法的  
illiterate: 文盲  
imagist: 印象派诗人  
immerse: 给...洗礼
immigrant: (从外国)移来的  
immigrate: 移民入境  
immune: 免疫的  
immunity: 免疫性  
impeach: 控告  
impel: 驱使 
impetus: 推动力
implicit: 含蓄的
important:
impressionism: 印象派
imprisonment: 监禁;关押  
impulse:
impunity: 免罚  
impurity: 杂质  
in:
increase:
incriminate: 控告  
indemnity: 赔偿  
independent: 中立派;无党派者  
indictment: 起诉  
indigenous: 当地的;土产的  
indigent: 平穷的  
induction: 归纳;感应
industry:
inertia: 惯性  
infect: 感染
infectious: 传染的
inference: 推论
inferior: 下级;晚辈  
infinite: 无穷的
inflation: 通货膨胀  
influential: 有影响的
infringe: 侵犯 % Your book infringes on my copy right.  
inhabitant: 居民  
initiate: 启蒙  
inject: 注射
ink:
insect:
insect: 昆虫  
insecticide: 杀虫剂  
inspect: 检查
instill: 灌输  
institute: 建立  
institutionalize: 使制度化  
instruct: 教  
instrument:
instrument: 乐器
insular: 海岛的 % ~ culture  
insulator: 绝缘体 
insurance:
intellectual: 有智力的  
intelligence: 智力   
interest:
interest: 利息  
interferometer: 干涉仪
intergalactic: 银河间的
intermediary: 媒介物 
interplanetary:行星间的;太阳系内的
interrogate: 审问  
intersect: 相交
interstellar: 星际的
intoxicate: 使中毒
invade: 侵略  
invalid: 有病的
invalidate: 使无效  
invaluable: 无价的  
invention:
inventor: 发明家 
inventory: 物品清单  
invertebrate: 无脊椎动物  
invocation: 祈祷
invoke: 恳求;祈求
iodine: 碘  
ion: 离子
ion: 离子  
iron:
irrigate: 灌溉 
island:
island: 岛  
islet: 小岛  
jar: 震动
jazz: 爵士乐
jelly: 果冻;胶状物
jellyfish: 水母  
jewel:
join:
journey:
judge:
judgment: 盘踞  
jump:
jungle: 丛林
jurisdiction: 司法权  
justify: 证明...是正当的  
juvenile: 青少年的  
keep:
kettle: 壶;反应釜
key:
kick:
kind:
kindle: 燃起  
kingdom: 王国  
kiss:
knee:
knife:
knot:
knowledge:
land:
land: 降落
language:
larva: 幼虫  
last:
late:
latitude: 纬度  
laugh:
laurel: 月桂树
lava: 熔岩  
law:
lawn: 草场
lawsuit: 诉讼  
layer: 层;阶层  
lead:
lead: 引导 
lead: 铅  
leading: 指导的  
leaf:
leaflet: 小叶;传单  
leafstalk: 叶柄  
league: 同盟  
learning:
lease: 出租 
leather:
ledge: 暗礁  
left:
leg:
legislate: 立法  
lens: 透镜
let:
letter:
level:
levy: 征收  
liberate: 释放  
library:
licensed: 被许可的  
lift:
light:
like:
limestone: 石灰石  
limit:
limpid: 清澈的
line:
linen: 亚麻布
linguistics: 语言学
lip:
liquid:
list:
lithogenous: 岩成的  
lithosphere: 岩石圈  
little:
livestock: 家畜   
living:
lizard: 蜥蜴  
loan: 贷款  
lobster: 龙虾  
lock:
log: 圆木 
long:
longitude: 经度  
look:
loop: 环
loose:
loss:
lottery: 抽奖 
loud:
love:
low:
lowland: 底地
lunar: 月亮的
luxuriant: 繁茂的;多产的
lyric: 抒情诗
lyric: 歌词
machine:
magma: 岩浆;稀糊  
magnet: 磁铁
magnetism: 磁学;磁力
magnifier: 放大镜;放大器
magnitude: 震级  
make:
malady: 疾病
malcontent: 不满者 
male:
malnourished: 营养不良的
mammal: 哺乳动物  
man:
manager:
mandate: 命令  
mandatory: 命令的;强制的  
maneuver: 调遣  
mantle: 地幔  
manure: 施肥 % ~ the field  
map:
marble: 大理石  
marine: 海洋的 % ~ mammals  
marital: 婚姻的  
maritime: 海上的 % ~ silk road  
mark:
market:
married:
mass:
match:
material:
mathematician: 数学家 
mathematics: 数学
maxim: 格言
may:
meadow: 草地
meal:
means: 钱  
measure:
meat:
mechanic: 机修工  
mechanics: 力学
mechanics: 力学,机械学;技巧;结构
medical:
meeting:
memory:
mental: 精神的;智力的
merchandise: 商品  
merge: 合并  
meridian: 子午线;正午 % Meridian Gate(午门)  
metabolism: 新陈代谢  
metal:
meteor: 流星
meteorologist: 气象学家  
meteorology: 气象学  
methane: 甲烷  
metropolitan: 大城市的  
microbe: 微生物; 细菌  
microscope: 显微镜  
middle:
migrate: 迁徙  % ~ to  
military:
military: 军用的  
milk:
mimicry: 模仿  
mind:
mine:
mineral: 矿石  
minority: 少数;少数名族  
minus: 负的;减去
minute:
miser: 守财奴  
mist:
mixed:
moist: 湿润的  
moisture: 潮湿 
mold: 塑造  
molecule: 分子
molecule: 分子  
mollusk: 软体动物  
monarch: 君主  
monarchy: 君主制;王朝  
money:
monkey:
monogamous: 一雌一雄的  
month:
moon:
morale: 士气  
morbid: 病态的
morning:
moron: 白痴 
morphology: 形态学  
mortal: 凡人  
moth: 蛾子;蛀虫  
mother:
motion:
mountain:
mouth:
move:
movement: 乐章
much:
multiplication: 乘法;增加
multiply: 乘;增加
municipal: 市政的
muscle:
music:
nail:
name:
narrow:
nation:
nationality: 国籍  
natural:
natural: 自然的
naval: 海军的  
navigation: 导航  
near:
nebula: 星云
necessary:
neck:
necrosis: 坏疽
need:
needle:
nerve:
nervous: 神经的  
nest: 巢;窝  
net:
neutralize: 中和  
neutron: 中子
new:
news:
niche: 壁龛;小生态环境;合适的职业;商机;  
nickel: 镍  
night:
nitrogen: 氮  
no:
noise:
normal:
north:
nose:
not:
note:
note: 音符
novice: 生手;新信徒  
now:
noxius: 有害的  
nuclear: 原子的
nucleus: 核子
numb: 麻木的
number:
numeral: 数字
nut:
nutrition: 营养学
oasis: 绿洲  
oath: 誓言  
obligatory: 义务的;必须的  
oblige: 强迫  
observance: 遵守  
observation:
observe: 遵守  
of:
off:
offer:
office:
offspring: 子孙后代  
oil:
old:
omnivorous: 杂食的  
on:
only:
onset: 攻击  
opaque: 不透明的
open:
opera: 歌剧
operation:
operator: 接线员  
opinion:
opponent: 敌人;对手  
opportunity: 机会  
opposite:
optical: 光学的;视力的
optics: 光学
option: 选择  
opulence: 财富  
or:
oracle: 神谕
orange:
orator: 演讲者  
orbit: 轨道
orchard: 果园  
orchestra: 管弦乐队 
orchid: 兰花  
order:
order: 目  
ore: 矿石  
organ: 器官  
organism: 生物;有机物  
organization:
origin: 起源  
originate: 发源于 
ornament:
oscillation: 摆动
other:
oust: 驱逐
out:
outburst: (火山,情感等)爆发  
output: 产量  
outskirts: 郊区;外边 % the ~ of Beijing(campus)  
oven: 炉;灶;烤炉
over:
owner:
oxygen: 氧  
oyster: 牡蛎  
ozonosphere: 臭氧层  
page:
pain:
paint:
paleoanthropologist: 古人类学家  
paper:
parade: 游行  
parallel:
parallel: 平行的
paraphrase: (用更容易理解的文字)解释
parasite: 寄生虫  
parasitic: 寄生的  
parcel: 包裹;打包
part:
particle: 颗粒  
partisan: 党派的;派系感强的  
past:
paste:
pasture: 牧场  
patriarchal: 家长制的 
patronage: 资助  
payment:
peace:
peck: 啄  
peel: 皮
pen:
penal: 受刑罚的  
pencil:
peninsula: 半岛  
penury: 贫穷  
percentage: 百分数
percussion: 打击乐器
person:
personnel: 职员  
persuasive: 有说服力
pest: 害虫  
pesticide: 杀虫剂   
petal: 花瓣
petition: 请愿
petrify: 变为化石 % be ~ied with fear  
petroleum: 石油  
philanthropist: 慈善家 
phonetics: 语音学
photosphere: 光球
photosynthesis: 光合作用  
physical:
physical: 身体的;物质的
physician: 医师  
picture:
picturesque: 如画般的
pig:
pigpen: 猪舍 
pigsty: 猪舍 
pilot: 飞行员  
pin:
pious: 虔诚的
pipe:
pit: 煤矿;地坑  
place:
plain: 平原;草原  
plaintiff: 原告  
plane:
planeroid: 位面
planet: 行星
plankton: 浮游生物  
plant:
plant: 植物;庄稼  
plantation: 耕地;种植园;人造林 
plastic: 塑料  
plate:
plate: 板块;盘子  
plateau: 高原  
platinum: 铂  
play:
playwright: 剧作家  
plea: 恳求  
plead: 抗辩;恳求  
please:
pleasure:
pledge: 使发誓  
plough: 犁;耕
plumb: 垂直的
pocket: 口袋
poikilotherm: 变温动物;冷些动物  
point:
poison:
polish:
political:
pollen: 花粉
pollinate: 对...授粉 
pollination: 授粉
pollutant: 污染物质  
pollute: 污染  
pollution: 污染  
polyandrous: 一雌多雄的  
polygamous: 一夫多妻或一妻多夫制的  
polygon: 多边形
polymerization: 聚合  
poor:
porcelain: 瓷器 
porpoise: 鼠海豚  
porter: 行李搬运工;守门人
portrait: 肖像  
portray: 绘制
pose: 摆姿势;构成 
position:
possible:
posterity: 后代  
pot:
potato:
potent: 强有力的
poultry: 家禽
powder:
power:
prairie: 牧场  
prawn: 大虾  
preach: 说教;鼓吹;布道
precious: 宝贵的  
precipitate: 凝结成雨或雪    
precipitate: 向下投掷
precipitation: 降水  
precursor: 先驱 
predator: 食肉类;掠夺者  
predatory: 食肉的;掠夺的  
pregnant: 怀孕的  
prelude: 序幕  
prescribe: 规定;指示  
prescription: 药方
present:
prey: 被掠食者  
price:
primate: 灵长类的动物  
primitive: 原始的;最初的  
principal: 校长 
print:
prison:
private:
privilege: 特权  
probability: 概率;可能性
probable:
process:
produce:
profile: 外形;轮廓  
profit:
proliferate: 繁衍  
prolific: 多产的 % the ~ author  
propagate: 繁殖;传播  
property:
proprietor: 所有者;经营者  
proscribe: 禁止   
prose: 散文;乏味的
prosecute: 起诉  
prosperity: 繁荣  
prosperous: 繁荣的  
protein: 蛋白质  
protest:
proton: 质子
proxy: 代理人  
pseudoscience: 伪科学
public:
puddle: 小水洼
pull:
pump:
punishment:
purchase: 购买  
purpose:
push:
put:
qualitative: 定性的;性质上的
quality:
quarter: 四分之一
quartz: 石英  
quasar: 类星体
query: 质问  
question:
quick:
quiet:
quite:
quiver: 振动
quota: 限额 
radiate: 射出
radiation: 辐射
radius: 半径
raid: 袭击 
rail:
rain:
ranch: 大农场  
range:
ranges: 射程表尺数  
rank: 排序;等级
ransom: 赔偿金  
rare: 稀少的  
rat:
rate:
ratio: 比率
ration: 配给 
ray:
ray: 光线
reaction:
reading:
ready:
realm: 王国;领域  
reason:
rebate: 折扣  
rebel: 叛徒  
receipt:
recipient: 接受者  
recluse: 隐士  
record:
record: 档案;唱片;记录;录音
recruit: 招募 
rectangle: 长方形
recur: 复发
red:
redress: 补偿  
reform: 改革
refund: 退还;偿还  
regeneration: 再生;重建  
regimen: 政权  
region: 地区 % the Asia-Pacific ~  
regret:
regular:
rehearse: 排练
reign: 统治
reimburse: 偿还  
relapse: 复发
relation:
relativity: 相对论;相关性
release: 释放
release: 释放  
religion:
religion: 宗教
remedy: 治疗
remit: 赦免  
remnant: 遗迹  
renaissance: 文艺复兴
representative:
reproduce: 再生;繁殖  
reproduction: 繁殖;复制品  
reptile: 爬行动物  
republican: 共和国的;共和政体的
repulse: 击退  
request:
resident: 居民  
resonance: 回声
respect:
respiration: 呼吸  
responsible:
responsible: 有责任的  
rest:
revenue: 收入  
revise: 修订  
revolve: 旋转
reward:
rhinoceros: 犀牛  
rhythm:
rice:
rich: 肥沃的  
ridge: 起皱;翻土做垄;岭  
right:
rim: 边缘
ring:
ripe: 成熟的  
rita: 宗教仪式
rival: 对手 
river:
road:
rod:
rodent: 啮齿动物  
role: 角色  
roll:
romantic: 浪漫的
roof: 屋顶
room:
root:
rosette: 玫瑰型饰物
rot: 腐烂  
rough:
round:
rub: 擦
ruby: 红宝石  
rule:
run:
rust: 生锈  
rustic: 乡村的 
sacred: 神圣的
sad:
saddle: 使负担  
safe:
sail:
salinity: 盐分  
salt:
same:
sand:
sanitation: 卫生设施
satire: 讽刺文学
satirist: 讽刺作家  
saturate: 使饱和 
saving: 储蓄  
say:
scale:
scale: 鳞片  
scandal: 丑闻
scavenger: 清道夫;食腐动物  
scenery: 景色
scenic: 风景优美的
school:
science:
scissors:
scoop: 挖掘  
scorch: 使褪色  
score: 乐谱
scout: 侦查 
scout: 侦查员;童子军  
screw:
sculpture: 雕刻家  
sculpture: 雕塑品
sea:
sear: 烧灼  
seat:
second:
secret:
secretary:
secrete: 分泌  
secretion: 分泌物  
sediment: 沉淀物  
see:
seed:
seedbed: 苗床  
seeds: 中子形;雏形  
seem:
seism: 地震  
seismic: 地震的 % ~ wave  
seismology: 地震学  
selection:
selection: 选择  
self:
send:
sense:
separate:
sequence: 序列
sequoia: 美洲杉树
serene: 晴朗的  
serious:
sermon: 说教  
servant:
set: 规定  
sewage: 下水道  
sex:
shade:
shade: 荫
shake:
shame:
sharp:
sheep:
sheepfold: 羊圈  
shelf:
shell: 去壳  
ship:
shipment: 出货  
shirt:
shock:
shoe:
shoot: 发芽 
short:
shower: 阵雨;淋浴  
shrimp: 小虾  
shrink: 收缩
shrub: 灌木丛
shrub: 灌木丛 
shut:
side:
siege: 围攻 
sign:
silica: 硅土  
silicon: 硅  
silk:
silt: 泥沙  
silver:
silver: 银  
simple:
sister:
size:
skeptic: 怀疑者  
skin:
skirt: 裙子
skull: 头骨  
sky:
sleep:
slip: 滑倒;犯错
slogan: 标语;口号
slope:
slow:
small:
smash: 粉碎
smell:
smile:
smog: 烟雾  
smoke:
smooth:
snake:
sneeze:
snow:
so:
soap:
society:
sock: 短袜
sodium: 钠  
soft:
solar: 太阳的
solid:
solubility: 溶解度  
solution: 溶剂  
some:
son:
sonar: 声呐
song:
sorghum: 高粱 
sort:
sound:
soup:
south:
sovereignty: 主权  
sow: 播种;大母猪 
space:
spacecraft: 太空船
spaceship: 太空船
spade: 铲子
spawn: 产卵  
special:
species: 物种  
spectacle: 奇观;景象
spectator: 旁观者  
spectrum: 光谱 
sphere: 球
spine: 脊骨;刺;图框  
spineless: 无脊椎的  
spiritual: 心灵的
spleen: 脾脏  
sponge: 海绵
sponge: 海绵  
spoon:
spouse: 配偶 
spring:
spring: 泉水
sprout: 萌芽  
squad: 小队i 
square:
square: 正方形
squash: 南瓜  
squeak: (老鼠或动物)发出吱吱声  
squirt: 喷出  
staff: 职员  
stage:
stale: 陈腐的  
stalk: 柄;秆  
stamp:
standard: 标准  
star:
starch: 淀粉  
starfish: 水星  
start:
statement:
statics: 静电学
station:
statistics: 统计学
statue: 雕像
status: 状态;地位  
steam:
steel:
stellar: 恒星的
stem:
stem: 径;词干
step:
sterile: 消过毒的
stick:
sticky:
stiff:
still: n. 寂静;剧照;蒸馏室 conj. 仍然;但是;尽管如此 vt. 蒸馏;使.静止;使.平静下来
stipulate: 约定  
stitch: 针脚;缝合
stocking: 长筒袜
stodgy: 难消化的 
stomach:
stone:
stop:
store:
story:
straight:
strain: (动物昆虫的的)种;血统  
strait: 狭长地带/地峡海峡  
strange:
stratum: 岩层;阶层 % new social ~  
street:
stretch:
strike: 罢工
string: 弦乐
strong:
structure:
sublimate: 升华 
suborder: 亚目  
subsidiary: 支流  
subsist: 生存 
substance:
substance: 物质  
substantiate: 证实  
subterranean: 地下的 % ~ cavern  
subtract: 减去
succinct: 简洁的
such:
sudden:
sugar:
suggestion:
sulfur: 硫  
sum: 和
summer:
summit: 山顶
sun:
superintendent: ;主管  
support:
surplus: 残余   
surprise:
survive: 幸免于难
susceptible: 易受感染的
sustenance: 营养物
swarm: (蜜蜂,蚂蚁等的)群
sweet:
swim:
symbiosis: 共生  
symbiotic: 共生的    
symmetry: 对称
symptom: 症状
synopsis: 大纲;梗概
synthetic: 合成的  
system:
table:
taboo: 禁忌  
tactics: 战术  
tag: 标签
tail:
take:
talk:
tall:
tariff: 关税  
taste:
tax:
teaching:
telescope: 望远镜  
temperate: (气候)温和的  
temperature: 温度
tempest: 暴风雨  
tenant: 租他人房子的人;租客  
tendency:
tense: 时态
tentacle: 触须;腺毛(植物)  
tepid: 微温的  
term: 术语
term: 条款  
terrain: 地形  
terrestrial: 陆地的 % ~ ecosystem 
territorial: 领土的  
territory: 领土;版图  
test:
testify: 证明  
testimony: 证言  
than:
that:
thaw: 融化
the:
then:
theory:
there:
thermometer: 温度计 
thick:
thin:
thing:
this:
though:
thought:
thread: 针线;穿过
throat:
throng: 群众  
through:
thumb: 拇指
thunder:
ticket:
tide: 潮汐  
tight:
till:
timber: 木材
time:
tin:
tin: 锡  
tingle: 刺痛
tint: 上色  
tired:
tissue: 组织
to:
toe:
toe: 脚趾  
together:
toll: 费  
toll: 鸣钟;费用  
tomorrow:
tongue:
tooth:
top:
topography: 地形学  
tornado: 龙卷风  
touch:
town:
tractor: 拖拉机 
trade:
tragedy: 悲剧
train:
traitor: 叛徒;卖国贼  
transaction: 交易  
transistor: 晶体管
translucent: 半透明的
transparent: 透明的
transpire: 发散
transport:
trapper: 陷阱设置者  
tray: 托盘;文件盒
treasurer: 财务人员  
treatment: 治疗
tree:
tremor: 颤动  
trial: 审判  
triangle: 三角形
tribe: 部落 
trick:
trickle: 滴;淌
tropical: 热带的  
tropics: 热带地区;回归线 % the Tropic of Cancer(北回归线)  
troposphere: 对流层  
trot: 慢跑  
trouble:
trough: 水槽  
trousers: 长裤
true:
trunk: 树干  
turn:
turtle: 海龟  
twig: 小树枝
twist:
tycoon: 企业大亨
typhoon: 台风 
ultrasonics: 超音波学
ultraviolet: 紫外线的
umbrella:
unconscious: 失去知觉的 
unconventional: 自由的
under:
underestimate: 低估  
unearth: 发掘  
unit:
universal: 宇宙的
unruly: 不守法的  
up:
upland: 高地  
upright: 垂直的
urban: 城市的   
use:
utility: 效用  
valley: 山谷  
value:
vapor: 水蒸气  
variant: 变量
vegetable: 蔬菜 
vein: 血管;静脉;矿脉  
velocity: 速率 
ventilation: 通风
verdict: 判决  
verify: 验证  
verse:
verse: 韵文
version: 版本
vertebrate: 脊椎动物  
vertical: 垂直的
very:
vessel:
veteran: 老兵;水手  
veto: 否决  
vibration: 震动 
view:
violate: 违犯 % ~ the laws of physics  
violation: 违犯  
violent:
vital: 至关重要的  
vitamin: 维生素
vivid: 生动的
voice:
volcanic: 火山的  % ~ ash  
volcano: 火山  
vote: 投票
waiting:
walk:
wall:
war:
warm:
wash:
waste:
waste: 废物  
watch:
water:
wave:
wavelength: 波长
wax:
way:
weather:
weed: 杂草  
week:
weight:
welfare: 福利
well:
west:
wet:
whale: 鲸  
wheel:
when:
where:
while:
whip: 鞭子;抽打
whirlwind: 旋风  
whistle:
white:
who:
why:
wide:
wiikite: 杂铌矿  
will:
wind:
wind: 管乐
window:
wine:
wing:
wing: 翅膀  
winter:
wire:
wise:
with:
woman:
wood:
wool: 羊毛;毛线;毛织品
word:
work:
worm:
worm: 虫子  
wound:
writing:
wrong:
year:
yellow:
yen: 日元;渴望  
yes:
yesterday:
you:
young:
zealot: 狂热信徒;发烧友 
zinc: 锌  
zone: 区 % time ~  
