Baroque: [a]/bəˈroʊk/; [adj]巴洛克式的,结构复杂的,形式怪样的; [n]巴洛克风格,巴洛克艺术; [or]gre3k;
Canon: [a]/ˈkænən/; [n]标准,教规,正典圣经,教士; [or]gre3k;
Catholic: [a]/ˈkæθlɪk/; [adj](兴趣等)广泛的,(C大写)天主教的; [n](C大写)天主教徒; [or]gre3k;
Spartan: [a]/ˈspɑːrtn/; [adj]斯巴达式的,简朴的,刻苦的; [n]斯巴达人;勇士; [or]gre3k;
abandon: [a]/əˈbændən/; [v]抛弃;放弃;放纵; [or]gre3k;
abase: [a]/əˈbeɪs/; [v]贬抑;使卑下;降低.的地位; [n]贬低;屈辱;贬低别人的人; [or]gre3k;
abash: [a]/ə'bæʃ/; [v]使局促不安;使羞愧; [adj]窘迫的,尴尬的; [adv]窘迫地,尴尬地; [n]窘迫,尴尬; [or]gre3k;
abbreviate: [a]/əˈbriːvieɪt/; [v]缩写,使省略,使用缩写词; [n]使用缩写词的人;缩短,缩写(词,短语,名字,名称); [or]gre3k;
abdicate: [a]/ˈæbdɪkeɪt/; [adj]放弃权力的;退位的; [n]放弃权力者;退位者; [vi]退位,辞职; [vt]辞;放弃; [or]gre3k;
aberrant: [a]/æˈberənt/; [n]离开正路的人,反常的人; [adj]偏离正轨的;异常的,畸变的; [or]gre3k;
abet: [a]/əˈbet/; [vt]唆使,怂恿;支持; [or]gre3k;
abeyance: [a]/əˈbeɪəns/; [n]中止,搁置; [or]gre3k;
abhor: [a]/əbˈhɔːr/; [v]痛恨;憎恶; [or]gre3k;
abiding: [a]/əˈbaɪdɪŋ/; [adj]持久的;永久的,不变的; [or]gre3k;
abject: [a]/ˈæbdʒekt/; [adj]糟糕透顶的;可怜的,不幸的; [or]gre3k;
abjure: [a]/əbˈdʒʊr/; [v]发誓放弃,公开放弃,避免; [or]gre3k;
abnegate: [a]/'æbnɪɡeɪt/; [v]放弃,舍弃,禁忌; [or]gre3k;
abominate: [a]/əˈbɑːmɪneɪt/; [v]痛恨,痛恶; [n]憎恶者,厌恶者; [or]gre3k;
abrade: [a]/əˈbreɪd/; [v]磨损,擦伤; [or]gre3k;
abreast: [a]/əˈbrest/; [adv]并肩地,并列; [adj]并排的;并肩的; [or]gre3k;
abridge: [a]/əˈbrɪdʒ/; [v]删节;削减; [or]gre3k;
abrogate: [a]/ˈæbrəɡeɪt/; [v]废止,废除; [n]取消,废除; [or]gre3k;
abscond: [a]/əbˈskɑːnd/; [v]逃匿,潜逃;避债; [or]gre3k;
absent: [a]/ˈæbsənt/; [adj]缺席的,不在的;心不在焉的,出神的; [v]缺席;使缺席; prep. 缺乏; [or]gre3k;
absolute: [a]/ˈæbsəluːt/; [adj]完全的;绝对的;纯粹的; [or]gre3k;
absolve: [a]/əbˈzɑːlv/; [v]赦免,宽恕;免除,解除; [or]gre3k;
abstain: [a]/əbˈsteɪn/; [v]戒掉(烟\酒等);避开;弃权; [or]gre3k;
abstemious: [a]/əbˈstiːmiəs/; [adj](吃喝等)有节制的,节俭的; [or]gre3k;
abstract: [a]/ˈæbstrækt/; [adj]抽象的; [n]摘要,抽象; [v]提取; [or]gre3k;
abstruse: [a]/əbˈstruːs/; [adj]难懂的,深奥的; [or]gre3k;
absurd: [a]/əbˈsɜːrd/; [adj]荒唐的;可笑的;不合理的; [n]荒唐; [or]gre3k;
abundant: [a]/əˈbʌndənt/; [adj]丰富的;大量的; [or]gre3k;
abuse: [a]/əˈbjuːs/; [v]虐待;辱骂;(对麻醉毒品,兴奋剂等的)非法服用;滥用; [n]滥用;虐待;辱骂; [or]gre3k;
abut: [a]/əˈbʌt/; [v]紧靠; [or]gre3k;
abysmal: [a]/əˈbɪzməl/; [adj]极低的或极可怜的,(程度)很深的,极端的; [or]gre3k;
accede: [a]/əkˈsiːd/; [v]同意,就任,加入; [or]gre3k;
accelerate: [a]/əkˈseləreɪt/; [v]加速,增长;使增速,促进; [or]gre3k;
accessible: [a]/əkˈsesəbl/; [adj]可使用的;可到达的;可进入的;易懂的; [or]gre3k;
accessory: [a]/əkˈsesəri/; [n](妇女的)装饰品;附件;附属物;同谋; [adj]附属的;辅助的;同谋的; [or]gre3k;
accidental: [a]/ˌæksɪˈdentl/; [adj]偶然的,意外的;非本质的; [or]gre3k;
acclaim: [a]/əˈkleɪm/; [n]欢呼,赞扬,称赞; [v]欢呼,喝彩,鼓掌欢迎; [vt]鼓掌欢迎,向.欢呼,为.喝彩;推选; [or]gre3k;
acclimate: [a]/ˈækləmeɪt/; [v]服水土,适应新环境; [or]gre3k;
accolade: [a]/ˈækəleɪd/; [n]同意,赞赏; [v]赞扬; [or]gre3k;
accommodate: [a]/əˈkɑːmədeɪt/; [v]向.提供住处(或膳宿);给.提供方便;容纳;使适应,顺应; [or]gre3k;
accomplish: [a]/əˈkɑːmplɪʃ/; [v]完成,做到;实现; [or]gre3k;
accord: [a]/əˈkɔːrd/; [n]协议; [v]授予; [or]gre3k;
accost: [a]/əˈkɔːst/; [v]搭讪;引诱;面对;勾引; [or]gre3k;
accrete: [a]/ə'kriːt/; [v]逐渐增长,依附,合生,连接; [adj]合生的,增积的; [or]gre3k;
accumulate: [a]/əˈkjuːmjəleɪt/; [vi]聚积,堆积; [vt]积攒,积累; [or]gre3k;
acerbic: [a]/əˈsɜːrbɪk/; [adj]尖刻的;酸涩的心情,心境或者语调,酸涩的; [or]gre3k;
acknowledge: [a]/əkˈnɑːlɪdʒ/; [v]告知收到;对(人)打招呼,招呼(某人)以示相识,致意;就..表示谢忱,鸣谢,感谢,感激,答谢,对..表示感谢;承认(属实),承认(权威,地位); [or]gre3k;
acme: [a]/ˈækmi/; [n]顶点,极点; [or]gre3k;
acquiesce: [a]/ˌækwiˈes/; [v]默许;勉强同意; [adj]默认的; [or]gre3k;
acquire: [a]/əˈkwaɪər/; [v](尤指靠自己的努力或行动或经过一个过程)获得;学到;取得; [or]gre3k;
acquisitive: [a]/əˈkwɪzətɪv/; [adj]贪得的,物欲重的;可学到的; [or]gre3k;
acrid: [a]/ˈækrɪd/; [adj]辛辣的,(言语或语调)刻薄的; [or]gre3k;
acrimonious: [a]/ˌækrɪˈmoʊniəs/; [adj]严厉的;辛辣的;刻薄的; [or]gre3k;
acumen: [a]/ˈækjəmən/; [n]聪明,敏锐; [or]gre3k;
acute: [a]/əˈkjut/; [adj](疼痛,妒忌等)剧烈的,严重的;敏锐的;急性的;尖声的; [or]gre3k;
adamant: [a]/ˈædəmənt/; [adj]强硬的,固执的; [n]坚硬的东西;坚石; [or]gre3k;
adapt: [a]/əˈdæpt/; [vi]适应不同情况; [vt]使适合;改编; [or]gre3k;
addict: [a]/ˈædɪkt/; [n]上瘾的人;入迷的人; [v]使沉迷,使上瘾; [or]gre3k;
adhere: [a]/ədˈhɪr/; [v]遵守;坚持;粘附;附着,粘在..上; [or]gre3k;
adjourn: [a]/əˈdʒɜːrn/; [v]延期,休会,推迟对.采取行动; [vi]休会; [or]gre3k;
adjudicate: [a]/əˈdʒuːdɪkeɪt/; [v]充当裁判,判决; [n]判决,宣判;裁判员; [or]gre3k;
adjunct: [a]/ˈædʒʌŋkt/; [n]附属物,配件,添加剂;助手,部下; [adj]附加的,辅助的,下级的; [or]gre3k;
admonish: [a]/ədˈmɑːnɪʃ/; [v]训诫,警告; [or]gre3k;
adore: [a]/əˈdɔːr/; [v]很喜欢,极喜爱;崇拜;爱慕; [or]gre3k;
adulate: [a]/'ædʒəˌleɪt/; [v]谄媚,奉承; [or]gre3k;
adulterate: [a]/əˈdʌltəreɪt/; [v]掺假; [adj]通奸的;搀杂的; [n]掺假; [or]gre3k;
adventitious: [a]/ˌædvenˈtɪʃəs/; [adj]外来的,偶然的; [or]gre3k;
adversary: [a]/ˈædvərseri/; [n]对手,敌手; [or]gre3k;
adversity: [a]/ədˈvɜːrsəti/; [n]逆境,不幸,灾难; [or]gre3k;
advert: [a]/ˈædvɜːrt/; [n]广告; [v]注意,留意; [or]gre3k;
advocate: [a]/ˈædvəkeɪt/; [v]提倡;主张;为.辩护; [n]辩护者;提倡者;律师; [or]gre3k;
affable: [a]/ˈæfəbl/; [adj]易于交谈的,和蔼的; [or]gre3k;
affectation: [a]/ˌæfekˈteɪʃn/; [n]假装,做作;假装;装模作样; [or]gre3k;
affinity: [a]/əˈfɪnəti/; [n]姻亲关系;密切关系;近似,类似关系;亲近; [or]gre3k;
affirm: [a]/əˈfɜːrm/; [v]肯定;断定;坚持声称; [or]gre3k;
affix: [a]/əˈfɪks/; [v]粘上;署名;将罪责加之于; [n]词缀;附加物; [or]gre3k;
affliction: [a]/əˈflɪkʃn/; [n]苦恼,折磨;痛苦; [or]gre3k;
affluent: [a]/ˈæfluənt/; [adj]富裕的,丰富的; [or]gre3k;
agape: [a]/əˈɡeɪp/; [adj]张口结舌,目瞪口呆;张大着; [or]gre3k;
aggrandize: [a]/ə'grænˌdaɪz/; [v]增大;夸大;吹捧; [or]gre3k;
aggravate: [a]/ˈæɡrəveɪt/; [v]使恶化,加重;使气恼,激怒; [or]gre3k;
aggregate: [a]/ˈæɡrɪɡət/; [n]合计;总数;混凝料;总计; [v]集合;聚集;合计; [adj]总的,总数的;集合的; [or]gre3k;
aggressive: [a]/əˈɡresɪv/; [adj]好斗的,挑衅性的;有闯劲的,积极进取的; [or]gre3k;
aggrieve: [a]/ə'griːv/; [v]使悲痛;冒犯;侵害.的合法权利; [or]gre3k;
agility: [a]/əˈdʒɪləti/; [n]敏捷;灵活; [or]gre3k;
agitate: [a]/ˈædʒɪteɪt/; [v](尤指为法律,社会状况的改变而)激烈争论,鼓动,煽动;搅动(液体);激怒; [or]gre3k;
agog: [a]/əˈɡɑːɡ/; [adj]兴奋的,有强烈兴趣的; [adv]渴望;极度兴奋; [or]gre3k;
agonize: [a]/ˈæɡənaɪz/; [v]感到极度痛苦,挣扎,折磨; [or]gre3k;
agreeable: [a]/əˈɡriːəbl/; [adj](欣然)同意的;愉快的;可以接受的; [or]gre3k;
airtight: [a]/ˈertaɪt/; [adj]不透气的,密封的; [or]gre3k;
alacrity: [a]/əˈlækrəti/; [n]反应迅速,乐意; [or]gre3k;
alienate: [a]/ˈeɪliəneɪt/; [v]疏远;挑拨; [or]gre3k;
align: [a]/əˈlaɪn/; [vi]排队,排成一行; [vt]使成一直线; [or]gre3k;
allay: [a]/əˈleɪ/; [v]减轻;使缓和;使平静; [or]gre3k;
allegiance: [a]/əˈliːdʒəns/; [n]忠诚,拥护; [or]gre3k;
alleviate: [a]/əˈliːvieɪt/; [v]减轻;缓解;缓和; [or]gre3k;
alloy: [a]/ˈælɔɪ/; [n]合金; [v]使成合金; [or]gre3k;
allude: [a]/əˈluːd/; [v]间接提到,暗指,暗示; [or]gre3k;
allure: [a]/əˈlʊr/; [v]吸引;诱使; [n]诱惑力; [or]gre3k;
ally: [a]/ˈælaɪ/; [n]盟友;同盟国;(二战时的) 同盟国; [v]结盟; [or]gre3k;
aloft: [a]/əˈlɔːft/; [adv]在空中,在高处,在上面; prep. 在 ... 上; [or]gre3k;
aloof: [a]/əˈluːf/; [adj]远离的;冷漠的,冷淡的; [adv]远离,避开; [or]gre3k;
altruism: [a]/ˈæltruɪzəm/; [n]利他主义,不自私; [or]gre3k;
amalgamate: [a]/əˈmælɡəmeɪt/; [v]合并,混合; [or]gre3k;
ambiguous: [a]/æmˈbɪɡjuəs/; [adj]含糊不清的,引起歧义的,模棱两可的; [or]gre3k;
ambivalent: [a]/æmˈbɪvələnt/; [adj]矛盾的;摇摆不定的;好恶相克的; [n]两性人; [or]gre3k;
amble: [a]/ˈæmbl/; [v]漫步,缓行; [n]缓行,漫步; [or]gre3k;
ambrosial: [a]/æm'broʊʒɪəl/; [adj](食物或者气味)特别美味的; [or]gre3k;
ameliorate: [a]/əˈmiːliəreɪt/; [v]改善,减轻(痛苦等),改良; [or]gre3k;
amenable: [a]/əˈmiːnəbl/; [adj]愿意的,顺从的,服从的;经得起检验的; [or]gre3k;
amenity: [a]/əˈmenəti/; [n]适意;舒适;便利设施;舒适,愉快;礼仪; [or]gre3k;
amiable: [a]/ˈeɪmiəbl/; [adj]和蔼的,亲切的;温和的; [or]gre3k;
amicable: [a]/ˈæmɪkəbl/; [adj]友善的,温和的,平心静气的; [or]gre3k;
amity: [a]/ˈæməti/; [n]友好,亲善关系,友好关系; [or]gre3k;
amorphous: [a]/əˈmɔːrfəs/; [adj]无定形的;无组织的;<物>非晶形的; [or]gre3k;
anachronistic: [a]/əˌnækrəˈnɪstɪk/; [adj]时代错误的; [or]gre3k;
analgesic: [a]/ˌænəlˈdʒiːzɪk/; [n]镇痛药; [adj]止痛的; [or]gre3k;
analogous: [a]/əˈnæləɡəs/; [adj]类似的,可比拟的;<昆>同功的; [or]gre3k;
anarchist: [a]/ˈænərkɪst/; [n]无政府主义者; [or]gre3k;
anathema: [a]/əˈnæθəmə/; [n](基督教的)咒诅,被诅咒者,令人厌恶的人; [or]gre3k;
ancillary: [a]/ˈænsəleri/; [adj]辅助的,副的; [n]助手;辅助设备; [or]gre3k;
anecdote: [a]/ˈænɪkdoʊt/; [n]轶事,趣闻; [or]gre3k;
anemic: [a]/ə'niːmɪk/; [adj]贫血的,缺乏力量,活力,精神的; [or]gre3k;
anesthetic: [a]/ˌænəs'θetɪk/; [n]麻醉剂,麻药; [adj]麻醉的,感觉缺失的; [or]gre3k;
animate: [a]/ˈænɪmeɪt/; [v]使有生气,使活泼;鼓舞,推动; [adj]有生命的; [or]gre3k;
animus: [a]/ˈænɪməs/; [n]憎恨,敌意; [or]gre3k;
annex: [a]/əˈneks/; [n]附加物;附属的建筑物; [vt]附加;并吞,强行占取;获得; [or]gre3k;
annotate: [a]/ˈænəteɪt/; [v]注释,评注; [n]注释者; [or]gre3k;
annoy: [a]/əˈnɔɪ/; [v]使烦恼,使生气; [n]烦恼(等于annoyance); [or]gre3k;
annul: [a]/əˈnʌl/; [v]取消,废除,宣告无效; [or]gre3k;
anomalous: [a]/əˈnɑːmələs/; [adj]反常的,不规则的,不恰当的; [or]gre3k;
anonymous: [a]/əˈnɑːnɪməs/; [adj]匿名的;无名的;不具名的;无特色的;无个性特征; [or]gre3k;
antagonize: [a]/ænˈtæɡənaɪz/; [v]使.敌对,使.对抗,引起反抗; [or]gre3k;
antedate: [a]/ˌæntiˈdeɪt/; [n]比实际提前的日期; [vt]在.上写上早于实际的日期;发生于.以前;使提前发生;使回到过去; [or]gre3k;
antediluvian: [a]/ˌæntidɪˈluːviən/; [adj]史前的,陈旧的; [n]大洪水以前的人;年迈的人;不合时宜的人; [or]gre3k;
anterior: [a]/ænˈtɪriər/; [adj]前面的,先前的; [or]gre3k;
antic: [a]/'æntɪk/; [adj]古怪的;滑稽可笑的; [n]滑稽动作;丑角; [v]扮小旦;做滑稽动作; [or]gre3k;
antipathy: [a]/ænˈtɪpəθi/; [n]反感,厌恶,憎恶; [or]gre3k;
antiquated: [a]/ˈæntɪkweɪtɪd/; [adj]陈旧的,过时的; [v]使古旧,废弃; [or]gre3k;
antithetical: [a]/ˌæntɪˈθetɪkl/; [adj]完全对立的,相反的; [or]gre3k;
apathy: [a]/ˈæpəθi/; [n]冷漠,无兴趣;漠不关心,无感情; [or]gre3k;
aphorism: [a]/ˈæfərɪzəm/; [n]格言,警句; [or]gre3k;
apocalyptic: [a]/əˌpɑːkəˈlɪptɪk/; [adj]预示灾祸的,启示的; [or]gre3k;
apocryphal: [a]/əˈpɑːkrɪfl/; [adj]伪的;可疑; [or]gre3k;
apoplectic: [a]/ˌæpəˈplektɪk/; [adj]中风的,易怒的; [n]中风患者; [or]gre3k;
apostasy: [a]/əˈpɑːstəsi/; [n]放弃宗教信仰,变节,背叛; [or]gre3k;
apparition: [a]/ˌæpəˈrɪʃn/; [n]幽灵,神奇的现象; [or]gre3k;
appeal: [a]/əˈpiːl/; [vi]呼吁,请求;申诉;有吸引力; [n]呼吁;恳求;(为慈善或好的事业所做的) 筹款努力;(人或物的)吸引力; [or]gre3k;
appealing: [a]/əˈpiːlɪŋ/; [adj]吸引人的,打动人心的; [or]gre3k;
applause: [a]/əˈplɔːz/; [n]鼓掌,掌声; [or]gre3k;
appreciable: [a]/əˈpriːʃəbl/; [adj]很可观的;可感知的;可察觉的;可评估的; [or]gre3k;
apprehension: [a]/ˌæprɪˈhenʃn/; [n]忧虑,担心,疑惧;逮捕;理解; [or]gre3k;
apprehensive: [a]/ˌæprɪˈhensɪv/; [adj]忧虑的,不安的,敏悟的,知晓的; [or]gre3k;
apprise: [a]/əˈpraɪz/; [v]通知,报告; [or]gre3k;
approbation: [a]/ˌæprəˈbeɪʃn/; [n]称赞,认可;批准; [or]gre3k;
appropriate: [a]/əˈproʊpriət/; [adj]合适的;适当的; [v]挪用;拨款;私占; [or]gre3k;
apt: [a]/æpt/; [adj]恰当的;有(做某事的)倾向; [or]gre3k;
arable: [a]/ˈærəbl/; [adj]可耕的,适合种植的; [n]耕地; [or]gre3k;
arbitrary: [a]/ˈɑːrbətreri/; [adj]随意的,任性的,随心所欲的;霸道的,专制的,专横的;主观的,武断的; [or]gre3k;
arcane: [a]/ɑːrˈkeɪn/; [adj]神秘的;秘传的;晦涩难解的; [or]gre3k;
archaic: [a]/ɑːrˈkeɪɪk/; [adj]古代的;陈旧的,过时的,老式的;已不通用的; [or]gre3k;
archetype: [a]/ˈɑːrkitaɪp/; [n]原型,典型; [or]gre3k;
ardor: [a]/'ɑːdə/; [n]热情,狂热; [or]gre3k;
arduous: [a]/ˈɑːrdʒuəs/; [adj]艰巨的;努力的;陡峭的; [or]gre3k;
argument: [a]/ˈɑːrɡjumənt/; [n]争吵,争论,辩论;论据,论点; [or]gre3k;
arid: [a]/ˈærɪd/; [adj](土地或气候)干燥的,干旱的,贫瘠的,荒芜的;无创见的,无新意的; [or]gre3k;
array: [a]/əˈreɪ/; [n]一系列;陈列;编队; [v]排列;部署; [or]gre3k;
arrest: [a]/əˈrest/; [v]逮捕,拘留;吸引; [n]逮捕,拘留; [or]gre3k;
arresting: [a]/əˈrestɪŋ/; [adj]引人注目的,醒目的,有趣的; [or]gre3k;
arrhythmic: [a]/əˈrɪθmɪk/; [adj]无节奏的;心律不齐的; [or]gre3k;
arrogance: [a]/ˈærəɡəns/; [n]自大;傲慢态度; [or]gre3k;
articulate: [a]/ɑːrˈtɪkjuleɪt/; [adj]善于表达的;发音清晰的; [v]清晰地发音;清楚地讲话;连接,接合;与.合成整体 ,使相互连贯; [or]gre3k;
ascendant: [a]/əˈsendənt/; [n]优势,支配地位; [adj]上升的,优越的; [or]gre3k;
ascetic: [a]/əˈsetɪk/; [adj]禁欲的;苦行的; [n]禁欲者;苦行者; [or]gre3k;
aseptic: [a]/ˌeɪˈseptɪk/; [adj]无菌的,洁净的; [or]gre3k;
askew: [a]/əˈskjuː/; [adj]歪斜的; [adv]歪斜地,斜地; [or]gre3k;
aspect: [a]/ˈæspekt/; [n]外表,面貌;(问题等的)方面; [or]gre3k;
asperity: [a]/æˈsperəti/; [n](表面的)粗糙;(气候等的)严酷;艰苦的条件;(性格)粗暴; [or]gre3k;
aspersion: [a]/ə'spɜːʒən/; [n]诽谤,中伤; [or]gre3k;
aspirant: [a]/əˈspaɪərənt/; [n]有抱负的人,野心家; [adj]上进的,有野心的; [or]gre3k;
assail: [a]/əˈseɪl/; [v]攻击;质问;着手解决; [or]gre3k;
assent: [a]/əˈsent/; [v]同意,赞成; [n]同意;赞成; [or]gre3k;
assert: [a]/əˈsɜːrt/; [v]断言;肯定地说;坚持;维护; [or]gre3k;
assertive: [a]/əˈsɜːrtɪv/; [adj]肯定的;决断的;坚定而自信的;独断的; [or]gre3k;
assess: [a]/əˈses/; [v]评估;估值; [or]gre3k;
assiduous: [a]/əˈsɪdʒuəs/; [adj]勤勉的,刻苦的; [or]gre3k;
assuage: [a]/əˈsweɪdʒ/; [v]缓和,减轻; [n]缓和,减轻;减轻.的人; [or]gre3k;
astounding: [a]/əˈstaʊndɪŋ/; [adj]使人惊骇的; [or]gre3k;
astute: [a]/əˈstuːt/; [adj]机敏的,精明的,狡猾的; [or]gre3k;
asunder: [a]/əˈsʌndər/; [adv]分离;化为碎片; [or]gre3k;
asylum: [a]/əˈsaɪləm/; [n]精神病院,疯人院;避难所; [or]gre3k;
asymmetrical: [a]/ˌeɪsɪˈmetrɪk(ə)l/; [adj]<数>非对称的; [or]gre3k;
asymmetry: [a]/ˌeɪˈsɪmətri/; [n]不对称,不均匀; [adj]不对称的,不对等的; [or]gre3k;
atone: [a]/əˈtoʊn/; [v]赎罪,补偿; [or]gre3k;
atrocious: [a]/əˈtroʊʃəs/; [adj]糟透的,残暴的,骇人听闻的; [or]gre3k;
atrophy: [a]/ˈætrəfi/; [v]萎缩;衰退;虚脱; [n]萎缩;衰退;萎缩症; [or]gre3k;
attenuate: [a]/əˈtenjueɪt/; [v]变薄,变弱,变纤细; [adj]稀薄的;细小的;减弱的;减少的; [or]gre3k;
attest: [a]/əˈtest/; [vt]证明;证实;为.作证; [vi]证明;作证; [or]gre3k;
attune: [a]/ə'tjuːn/; [v]使协调,为.调音; [or]gre3k;
audacious: [a]/ɔːˈdeɪʃəs/; [adj]大胆的,鲁莽的,大胆创新的; [or]gre3k;
augur: [a]/ˈɔːɡər/; [n]预言者; [v]预言,占卜; [or]gre3k;
auspicious: [a]/ɔːˈspɪʃəs/; [adj]吉兆的,幸运的; [or]gre3k;
austere: [a]/ɔːˈstɪr/; [adj]严峻的;简朴的;苦行的;无装饰的; [or]gre3k;
authentic: [a]/ɔːˈθentɪk/; [adj]真实的;真正的;可靠的; [or]gre3k;
authority: [a]/əˈθɔːrəti/; [n]权威;威信;当局,官方;权力,职权; [or]gre3k;
autocracy: [a]/ɔːˈtɑːkrəsi/; [n]独裁政治;专制政治;独裁政府;独裁统治的国家; [or]gre3k;
automatic: [a]/ˌɔːtəˈmætɪk/; [adj]无意识的;自动的;自发的; [n]自动手枪;自动工具; [or]gre3k;
autonomy: [a]/ɔːˈtɑːnəmi/; [n]人身自由;自治;自治权; [or]gre3k;
avarice: [a]/ˈævərɪs/; [n]贪财,贪婪; [or]gre3k;
aver: [a]/əˈvɜːr/; [v]极力声明,断言; [or]gre3k;
aversion: [a]/əˈvɜːrʒn/; [n]厌恶;讨厌的人,(或东西); [or]gre3k;
avid: [a]/ˈævɪd/; [adj]渴望的,贪婪的;热心的; [or]gre3k;
avowal: [a]/əˈvaʊəl/; [n]公开承认,声明; [or]gre3k;
awe: [a]/ɔː/; [n]敬畏;畏怯;(壮观等引起的)惊叹,惊奇; [vt]使敬畏,令人敬畏,使充满畏惧; [or]gre3k;
awkward: [a]/ˈɔːkwərd/; [adj]尴尬的;笨拙的;棘手的;不雅观的;不方便的;困难的,危险的; [or]gre3k;
awning: [a]/ˈɔːnɪŋ/; [n]雨篷,遮阳篷; [or]gre3k;
awry: [a]/əˈraɪ/; [adj]扭曲的,走样的; [adv]歪曲地;歪斜地;错误地; [or]gre3k;
axiomatic: [a]/ˌæksiəˈmætɪk/; [adj]公理的,自明的; [or]gre3k;
babble: [a]/ˈbæbl/; [v]呀呀学语,喋喋不休,作潺潺声;泄露(秘密); [n]儿语,胡言乱语,潺潺声; [or]gre3k;
backfire: [a]/ˌbækˈfaɪər/; [v]放出逆火,产生出乎意料及事与愿违的结果; [n]逆火;后爆的巨大响声; [or]gre3k;
backslide: [a]/'bækslaɪd/; [v](情况等)倒退,故态复萌; [n]倒退; [or]gre3k;
badger: [a]/ˈbædʒər/; [n]獾;獾皮毛; [v]纠缠;烦扰(反复提提出问题或要求); [or]gre3k;
badinage: [a]/ˌbædənˈɑːʒ/; [n]开玩笑,嘲弄,揶揄; [or]gre3k;
baffle: [a]/ˈbæfl/; [v]使困惑;难住;阻碍; [n]挡板; [or]gre3k;
baffling: [a]/ˈbæflɪŋ/; [adj]令人困惑的; [v]使困难,使为难; [or]gre3k;
bait: [a]/beɪt/; [n]饵,诱惑物; [v]装饵;辱骂,欺侮; [or]gre3k;
bale: [a]/beɪl/; [n]大包裹,灾祸,不幸; [vt]将某物打成包或包装成捆; [or]gre3k;
baleful: [a]/ˈbeɪlfl/; [adj]邪恶的,恶意的; [adv]凶恶地,有害地; [or]gre3k;
balk: [a]/bɔːk/; [v]畏缩;阻止;停止; [n]障碍;错误; [or]gre3k;
balky: [a]/ˈbɔːlki/; [adj]停蹄不前的;倔强的;不愿干的; [or]gre3k;
ballad: [a]/ˈbæləd/; [n]歌谣;小曲; [or]gre3k;
balm: [a]/bɑːm/; [n]香油,止痛膏,安慰物,香气; [or]gre3k;
banal: [a]/bəˈnɑːl/; [adj]陈腐的;平庸的;老一套的; [or]gre3k;
bane: [a]/beɪn/; [n]祸根; [or]gre3k;
banish: [a]/ˈbænɪʃ/; [v]放逐;摒弃; [or]gre3k;
banter: [a]/ˈbæntər/; [n]善意地取笑,逗弄; [v]善意的与人开玩笑; [or]gre3k;
barb: [a]/bɑːrb/; [n]箭头鱼钩等的倒钩;伤人的话; [v]装倒钩于; [adj]具倒刺的;(话)带刺的; [or]gre3k;
barbarous: [a]/ˈbɑːrbərəs/; [adj]野蛮的,残暴的; [or]gre3k;
bargain: [a]/ˈbɑːrɡən/; [n]交易,特价商品;便宜货;契约; [vi]讨价还价,讲价;成交; [vt]经讨价还价成交;用.交换; [adj](价格),低廉的; [or]gre3k;
barrage: [a]/bəˈrɑːʒ/; [n]大量;阻塞;齐射式攻击;<水利>拦河坝; [v]以密集火力阻击; [or]gre3k;
barren: [a]/ˈbærən/; [adj]贫瘠的,不孕的; [n]荒原,不毛之地; [or]gre3k;
barricade: [a]/ˌbærɪˈkeɪd/; [n]路障;障碍物;栅栏; [v]设路障;挡住; [or]gre3k;
barter: [a]/ˈbɑːrtər/; [v]物物交换;以货易货; [n]物物交换;实物交易; [or]gre3k;
bash: [a]/bæʃ/; [v]猛击,痛击;怒殴; [n]猛烈的一击,痛击; [or]gre3k;
bask: [a]/bæsk/; [vi]晒太阳(享受温暖),感到温暖,愉快或舒适; [n]晒太阳,取暖;沉浸于; [or]gre3k;
batch: [a]/bætʃ/; [n]一批(人或物);一批生产量; [or]gre3k;
bathetic: [a]/bə'θetɪk/; [adj]平凡的,陈腐的,假装感伤的; [or]gre3k;
bawdy: [a]/ˈbɔːdi/; [adj]说黄色笑话的;淫猥的,下流的; [or]gre3k;
bedeck: [a]/bɪˈdek/; [v]装饰,点缀; [or]gre3k;
beholden: [a]/bɪˈhoʊldən/; [adj]蒙恩的,受惠的,感激的,负有义务的,依靠的; [or]gre3k;
behoove: [a]/bɪ'huːv/; [v]理应,对.有此必要; [n]适宜; [or]gre3k;
beige: [a]/beɪʒ/; [n]米黄色; [adj]浅褐色的,米黄色的; [or]gre3k;
belabor: [a]/bɪˈleɪbər/; [v]抨击;反复讨论,啰啰嗦嗦地说明; [or]gre3k;
beleaguer: [a]/bɪ'liːgə/; [v]围攻; [or]gre3k;
belie: [a]/bɪˈlaɪ/; [vt]与.不符;矛盾,误解; [or]gre3k;
belligerence: [a]/bəˈlɪdʒərəns/; [n]好战,交战; [or]gre3k;
belligerent: [a]/bəˈlɪdʒərənt/; [adj](国家等)交战的,挑斗的; [n]交战国,交战者;参加斗殴的人或集团; [or]gre3k;
beneficent: [a]/bɪˈnefɪsnt/; [adj]慈善的;善行的; [or]gre3k;
benign: [a]/bɪˈnaɪn/; [adj]仁慈的;慈祥的;(病)良性的; [or]gre3k;
berate: [a]/bɪˈreɪt/; [v]猛烈责骂; [or]gre3k;
beseech: [a]/bɪˈsiːtʃ/; [v]恳求,哀求; [adj]恳求的;哀求的;乞求的; [or]gre3k;
beset: [a]/bɪˈset/; [v]困扰;镶嵌;围绕; [or]gre3k;
besmirch: [a]/bɪˈsmɜːrtʃ/; [v]诽谤,玷污; [or]gre3k;
bewitching: [a]/bɪˈwɪtʃɪŋ/; [adj]迷人的,令人着迷的; [or]gre3k;
bifurcate: [a]/ˈbaɪfərkeɪt/; [v]分为二支,分叉; [adj]分叉的; [or]gre3k;
bigot: [a]/ˈbɪɡət/; [n](宗教,种族,政治等的)偏执者,盲信者; [or]gre3k;
blackmail: [a]/ˈblækmeɪl/; [n]敲诈,勒索;保护费; [vt]向.敲诈; [or]gre3k;
bland: [a]/blænd/; [vi]变得平淡无奇,变得枯燥无味; [adj]温和的;(食物等)清淡的;漠不关心的; [vt]使变得淡而无味,使变得枯燥无味;除掉.的特性; [or]gre3k;
blandishment: [a]/ˈblændɪʃmənt/; [n]甜言蜜语,奉承;谄媚;哄诱; [or]gre3k;
blase: [a]/blɑːˈzeɪ/; [adj]玩厌了的,厌烦于享乐的; [or]gre3k;
blast: [a]/blæst/; [n]一阵(疾风等);爆炸;冲击波; [v](用炸药)炸,摧毁; [or]gre3k;
blatant: [a]/ˈbleɪtnt/; [adj]喧哗的;露骨的;公然的;明目张胆的; [or]gre3k;
blazon: [a]/ˈbleɪzn/; [v]宣布,装饰; [n]纹章,描绘; [or]gre3k;
blemish: [a]/ˈblemɪʃ/; [v]损害,玷污; [n]瑕疵,缺点; [or]gre3k;
blight: [a]/blaɪt/; [n]植物枯萎病; [v]使.枯萎; [or]gre3k;
bliss: [a]/blɪs/; [n]福佑,天赐的福; [vt]使欣喜若狂,使狂喜; [vi]欣喜若狂,狂喜; [or]gre3k;
blithe: [a]/blaɪð/; [adj]愉快的;快乐无忧的; [or]gre3k;
blueprint: [a]/ˈbluːprɪnt/; [n]蓝图,设计图,计划; [vt]制成蓝图,计划; [or]gre3k;
bluff: [a]/blʌf/; [adj]直率的; [v]虚张声势,吓唬; [n]虚张声势;吓唬;断崖,绝壁; [or]gre3k;
blunder: [a]/ˈblʌndər/; [n]愚蠢之举;大错; [vi]犯大错; [v]失策;绊倒; [or]gre3k;
blunt: [a]/blʌnt/; [adj]钝的;直率的; [v]使情感,感觉,需求减弱;变钝; [or]gre3k;
blur: [a]/blɜːr/; [n]污点,模糊; [v]使.模糊;弄脏;变模糊; [or]gre3k;
blurt: [a]/blɜːrt/; [v]突然说出,冲动地说; [or]gre3k;
bluster: [a]/ˈblʌstər/; [v]咆哮;狂吹;夸口;威吓;气势汹汹地说; [n]怒号;吓唬; [or]gre3k;
boggle: [a]/ˈbɑːɡl/; [v]畏缩不前;惊恐;使..困惑; [or]gre3k;
bogus: [a]/ˈboʊɡəs/; [adj]假的,假装的; [n]伪币;冒牌货; [or]gre3k;
boisterous: [a]/ˈbɔɪstərəs/; [adj]喧闹的,欢闹的; [or]gre3k;
bolster: [a]/ˈboʊlstər/; [n]枕垫; [v]支持,鼓励,增强; [or]gre3k;
bombast: [a]/ˈbɑːmbæst/; [n]高调,夸大之辞; [or]gre3k;
bonhomie: [a]/ˌbɑːnəˈmiː/; [n]欢乐友好的氛围; [or]gre3k;
boo: [a]/buː/; [n]嘘声; [v]嘘(以表示不满或嘲笑); [or]gre3k;
boon: [a]/buːn/; [n]恩惠,福利,利益; [adj]愉快的; [or]gre3k;
boor: [a]/bʊr/; [n]举止粗野的人,乡下人; [or]gre3k;
bootless: [a]/'buːtlɪs/; [adj]无用的,无益的,无利可图的,没穿鞋的; [or]gre3k;
bound: [a]/baʊnd/; [adj]受约束的;有义务的;一定的; [v]束缚;跳跃着前行; [n]跳跃;范围;界限; [or]gre3k;
boycott: [a]/ˈbɔɪkɑːt/; [vt]抵制; [n]抵制; [or]gre3k;
bracing: [a]/ˈbreɪsɪŋ/; [adj]振奋精神的; [or]gre3k;
brake: [a]/breɪk/; [v]刹车; [n]刹车,制动器,闸; [or]gre3k;
brandish: [a]/ˈbrændɪʃ/; [v]挥舞;炫耀的挥舞(武器); [n]挥舞; [or]gre3k;
brash: [a]/bræʃ/; [adj]无礼的,傲慢的;仓促的,性急的; [n]骤雨;碎片;<医>胃灼热; [or]gre3k;
brassy: [a]/ˈbræsi/; [adj]似黄铜的,刺耳的,厚脸皮的; [n]铜头高尔夫球棍; [or]gre3k;
bravado: [a]/brəˈvɑːdoʊ/; [n]故作勇敢,逞能; [or]gre3k;
brazen: [a]/ˈbreɪzn/; [adj]厚脸皮的,厚颜无耻的;黄铜(制)的; [v]厚着脸皮干,使变得无耻; [or]gre3k;
breach: [a]/briːtʃ/; [n]破裂;裂痕;冲击;违反; [v]使有裂口;破坏; [or]gre3k;
brevity: [a]/ˈbrevəti/; [n]简短,短小,精炼; [or]gre3k;
bribe: [a]/braɪb/; [v]向.行贿;买通; [n]贿赂;行贿物; [or]gre3k;
bridle: [a]/ˈbraɪdl/; [n]马笼头,缰绳; [v]上笼头;昂首(表傲慢,愤怒等);抑制,控制; [or]gre3k;
brim: [a]/brɪm/; [n]边;边缘; [v]充满,注满; [vt]注满; [or]gre3k;
brisk: [a]/brɪsk/; [adj]轻快的;活跃的;寒冷而清新的; [or]gre3k;
brittle: [a]/ˈbrɪtl/; [adj]易碎的;脆弱的;靠不住的; [n]薄片脆糖; [or]gre3k;
broach: [a]/broʊtʃ/; [v]提出;钻孔;开始讨论;给.开口; [or]gre3k;
bromide: [a]/ˈbroʊmaɪd/; [n]<无化>溴化物,庸俗的人,陈词滥调; [or]gre3k;
brook: [a]/brʊk/; [v](常用于否定句或疑问句)容忍;忍受;容忍; [n]小溪;小河; [or]gre3k;
browbeat: [a]/ˈbraʊbiːt/; [v]恫吓,吓唬;欺侮; [or]gre3k;
bruit: [a]/bruːt/; [v](未经证实地)散播消息; [n]谣传; [or]gre3k;
buck: [a]/bʌk/; [n]雄鹿;年轻男士;美元; [v]反对;马弓背踢后腿挑起; [or]gre3k;
budge: [a]/bʌdʒ/; [v]移动一点;妥协; [or]gre3k;
bulge: [a]/bʌldʒ/; [n]凸出部分; [v]凸出,膨胀; [or]gre3k;
bully: [a]/ˈbʊli/; [n]恃强欺弱者; [v]欺负; [or]gre3k;
bumble: [a]/ˈbʌmbl/; [v]嗡嗡叫,营营响;说话含糊,结结巴巴地讲话;笨拙地行动,踉跄前行;弄糟; [n]〈英〉骄横的小官吏; [or]gre3k;
bumptious: [a]/ˈbʌmpʃəs/; [adj]专横傲慢的,自以为是的; [or]gre3k;
bungle: [a]/ˈbʌŋɡl/; [v]办糟,失败; [n]粗劣,失败,笨拙; [or]gre3k;
buoy: [a]/ˈbuːi/; [n]浮标;浮筒;救生圈;航标; [v]使浮起;支撑;鼓励; [or]gre3k;
buoyant: [a]/ˈbɔɪənt/; [adj]有浮力的;愉快的;(股市)保持高价的; [or]gre3k;
burgeon: [a]/ˈbɜːrdʒən/; [v]发芽,迅速成长; [n]嫩枝; [or]gre3k;
burlesque: [a]/bɜːrˈlesk/; [adj]滑稽的,可笑的; [v]讥笑; [n]脱衣舞,打油诗,滑稽戏,笑剧,杂耍,漫画; [or]gre3k;
burnish: [a]/ˈbɜːrnɪʃ/; [v]擦亮,磨光; [or]gre3k;
bustle: [a]/ˈbʌsl/; [n]喧闹,熙攘;腰垫;奔走,奔忙; [v]喧闹;忙乱,奔忙; [or]gre3k;
buttress: [a]/ˈbʌtrəs/; [n]扶墙,拱壁; [v]支持; [or]gre3k;
cache: [a]/kæʃ/; [n]隐藏处所,隐藏的粮食或物资,贮藏物; [vt]贮藏; [vi]躲藏; [or]gre3k;
cachet: [a]/kæˈʃeɪ/; [n](证明品质的)优良标志,公务印章,私人印戳,威望,纪念邮戳; [or]gre3k;
cacophony: [a]/kəˈkɑːfəni/; [n]刺耳的音调;不和谐音; [or]gre3k;
cadge: [a]/kædʒ/; [v]行乞,乞求,贩卖; [or]gre3k;
cajole: [a]/kəˈdʒoʊl/; [v]以甜言蜜语哄骗,勾引; [or]gre3k;
calamity: [a]/kəˈlæməti/; [n]大灾祸,不幸之事; [or]gre3k;
calibrate: [a]/ˈkælɪbreɪt/; [vt]测定(或测量).的口径;校准(或校正);调整; [or]gre3k;
calligraphy: [a]/kəˈlɪɡrəfi/; [n]笔迹,墨宝,书法; [or]gre3k;
callous: [a]/ˈkæləs/; [adj]无情的,铁石心肠的,硬结的; [vt](使)变硬,(使)起茧;(使)冷酷无情; [or]gre3k;
callow: [a]/ˈkæloʊ/; [adj](鸟)未生羽毛的;年轻而无经验的; [or]gre3k;
calumniate: [a]/kə'lʌmnɪˌeɪt/; [v]诽谤,中伤,诬蔑; [or]gre3k;
camaraderie: [a]/ˌkɑːməˈrɑːdəri/; [n]友情; [or]gre3k;
cameo: [a]/ˈkæmioʊ/; [n]石雕,贝雕;浮雕玉石;文学小品; [or]gre3k;
camouflage: [a]/ˈkæməflɑːʒ/; [n]伪装;掩饰; [v]使改头换面,伪装,掩饰;欺瞒; [or]gre3k;
canard: [a]/kəˈnɑːrd/; [n]误传,谬传;谣言; [or]gre3k;
candor: [a]/'kændə/; [n]坦白,直率,诚挚; [or]gre3k;
canny: [a]/ˈkæni/; [adj]精明的,谨慎的,节约的; [adv]<苏格兰>仔细地; [or]gre3k;
canonize: [a]/ˈkænənaɪz/; [v]使加入圣徒之列,推崇,褒扬,将.封为圣徒; [or]gre3k;
canvass: [a]/ˈkænvəs/; [v]仔细检查或详尽地讨论;审查,游说; [n]讨论;细查;劝诱; [or]gre3k;
capitulate: [a]/kəˈpɪtʃuleɪt/; [vi]有条件投降,认输,屈服,让步,停止抵抗; [or]gre3k;
caprice: [a]/kəˈpriːs/; [n]任性,反复无常,随想曲; [or]gre3k;
captious: [a]/'kæpʃəs/; [adj]挑剔的,吹毛求疵的; [or]gre3k;
captivate: [a]/ˈkæptɪveɪt/; [v]吸引,迷惑; [or]gre3k;
cardinal: [a]/ˈkɑːrdɪnl/; [adj]主要的;基本的; [n]<天主教>枢机主教,红衣主教;基数; [or]gre3k;
careen: [a]/kəˈriːn/; [n](船的)倾侧; [v](船)倾斜,使倾斜; [or]gre3k;
carefree: [a]/ˈkerfriː/; [adj]无忧无虑的,轻松愉快的;不负责的; [or]gre3k;
careworn: [a]/ˈkerwɔːrn/; [adj]伤心焦虑的;饱经忧患的;疲倦的; [or]gre3k;
caricature: [a]/ˈkærɪkətʃər/; [n]讽刺画,滑稽模仿;扭曲,夸张的描述; [or]gre3k;
carnal: [a]/ˈkɑːrnl/; [adj]肉体的,肉欲的,性欲的,色欲的,淫荡的; [or]gre3k;
carouse: [a]/kəˈraʊz/; [v]畅饮,欢宴; [or]gre3k;
carp: [a]/kɑːrp/; [n]鲤鱼; [v]吹毛求疵; [or]gre3k;
carve: [a]/kɑːrv/; [v]雕刻;(把肉等)切成片;开创,开拓; [or]gre3k;
cascade: [a]/kæˈskeɪd/; [n]层叠;小瀑布;喷流; [v]像瀑布般冲下或倾泻; [or]gre3k;
cast: [a]/kæst/; [v]投;抛下,投射(光线和阴影);瞥,飞快看(一眼),扫视;掷;放钓;投票;选定演员; [n]投掷物;铸件;演员表,演员阵容; [or]gre3k;
castigate: [a]/ˈkæstɪɡeɪt/; [v]严惩;苛评;矫正;修订; [or]gre3k;
catalyze: [a]/'kætəˌlaɪz/; [v]催化;刺激,促进; [or]gre3k;
catastrophe: [a]/kəˈtæstrəfi/; [n]大灾难; [or]gre3k;
categorical: [a]/ˌkætəˈɡɔːrɪkl/; [adj]绝对的;直接了当的;无条件的;属于某一范畴的; [or]gre3k;
caustic: [a]/ˈkɔːstɪk/; [adj]腐蚀性的;苛性的;刻薄的;焦散的; [n]腐蚀剂;苛性钠;焦散曲线; [or]gre3k;
caveat: [a]/ˈkæviæt/; [n]警告;防止误解的说明; [or]gre3k;
cavil: [a]/ˈkævl/; [v]吹毛求疵,挑剔,无端指摘;挑毛病,无端抱怨; [n]吹毛求疵,苛责,无端的指责; [or]gre3k;
cavort: [a]/kəˈvɔːrt/; [v]欢快地蹦跳或行走,雀跃; [or]gre3k;
cede: [a]/siːd/; [v]放弃;割让(领土); [or]gre3k;
cellular: [a]/ˈseljələr/; [adj]细胞的,无线的;蜂窝式的; [or]gre3k;
cement: [a]/sɪˈment/; [n]水泥,混凝土;胶合剂; [vt]巩固,加强;用水泥涂;接合; [vi]粘牢; [or]gre3k;
censor: [a]/ˈsensər/; [n]检查员; [vt]审查,检查;修改; [or]gre3k;
censorious: [a]/senˈsɔːriəs/; [adj]爱挑剔的,吹毛求疵的,严厉批评的; [or]gre3k;
censure: [a]/ˈsenʃər/; [v]责难,责备; [n]责难,责备; [or]gre3k;
census: [a]/ˈsensəs/; [n]人口普查,人口调查;统计; [v]调查(某地区等的)人口数字;统计.的数字; [or]gre3k;
ceremonious: [a]/ˌserəˈmoʊniəs/; [adj]隆重的;讲究仪式的;正式的; [or]gre3k;
certitude: [a]/ˈsɜːrtɪtuːd/; [n]确实;确信;必然性; [or]gre3k;
cessation: [a]/seˈseɪʃn/; [n]停止,中止,中断; [or]gre3k;
chaff: [a]/tʃæf/; [n]谷物的皮壳,米糠;草料,干草;小玩笑; [v]开玩笑; [or]gre3k;
chagrin: [a]/ʃəˈɡrɪn/; [n]懊恼;委屈;气愤; [v]使.懊恼; [or]gre3k;
chameleon: [a]/kəˈmiːliən/; [n]蜥蜴;变色龙;善变的人; [or]gre3k;
champion: [a]/ˈtʃæmpiən/; [n]冠军;拥护者,战士; [v]拥护;保卫;为..而斗争; [adj]夺得第一名的;优胜的; [or]gre3k;
channel: [a]/ˈtʃænl/; [n]频道;渠道,方法;海峡; [v]引导;经沟槽输送; [or]gre3k;
chaos: [a]/ˈkeɪɑːs/; [n]混沌;混乱,纷乱; [or]gre3k;
charade: [a]/ʃəˈreɪd/; [n]看手势猜字谜游戏; [or]gre3k;
charisma: [a]/kəˈrɪzmə/; [n]魅力; [or]gre3k;
charlatan: [a]/ˈʃɑːrlətən/; [n]骗子;假内行; [or]gre3k;
chary: [a]/ˈtʃeri/; [adj]小心的,谨慎的; [or]gre3k;
chase: [a]/tʃeɪs/; [v]追赶;驱逐;追求; [n]追逐;追求; [or]gre3k;
chasm: [a]/ˈkæzəm/; [n](地壳,冰上的)隐窟,深坑,峡谷;显著差距,巨大分歧; [or]gre3k;
chauvinistic: [a]/ˌʃoʊvɪˈnɪstɪk/; [adj]盲目爱国的;大男子主义的; [or]gre3k;
check: [a]/tʃek/; [v]检查;阻止; [n]支票;阻止;检查;阻止物; [or]gre3k;
cherished: [a]/ˈtʃerɪʃt/; [adj]受喜爱的,珍爱的; [or]gre3k;
cherubic: [a]/tʃəˈruːbɪk/; [adj]可爱的;天使的;无邪的; [or]gre3k;
chicanery: [a]/ʃɪˈkeɪnəri/; [n]诡计,诈骗,欺骗; [or]gre3k;
chide: [a]/tʃaɪd/; [v]叱责,指责; [or]gre3k;
chivalrous: [a]/ˈʃɪvəlrəs/; [adj]像骑士的,侠义的,大侠的; [or]gre3k;
choleric: [a]/ˈkɑːlərɪk/; [adj]易怒的,暴躁的,胆汁质的; [or]gre3k;
chord: [a]/kɔːrd/; [n]和弦;和音;心弦;(数学)弦; [or]gre3k;
chromatic: [a]/krəˈmætɪk/; [adj]彩色的,五彩的; [or]gre3k;
chronic: [a]/ˈkrɑːnɪk/; [adj](疾病)慢性的;长期的;(人)久病的;积习难改的;严重的; [or]gre3k;
churl: [a]/tʃɜːrl/; [n]吝啬鬼,乡下人,粗暴的人; [or]gre3k;
cipher: [a]/ˈsaɪfər/; [n]密码,暗号,不重要的人; [or]gre3k;
circuitous: [a]/sərˈkjuːɪtəs/; [adj]迂回的,绕圈子的; [or]gre3k;
circumlocution: [a]/ˌsɜːrkəmləˈkjuːʃn/; [n]婉转曲折的说法,累赘的陈述,遁辞; [or]gre3k;
circumscribe: [a]/ˈsɜːrkəmskraɪb/; [v]限制;在.周围画线;<数>使外接,使外切; [or]gre3k;
circumspect: [a]/ˈsɜːrkəmspekt/; [adj]慎重的,仔细的; [or]gre3k;
circumvent: [a]/ˌsɜːrkəmˈvent/; [v]用计避免,规避; [or]gre3k;
civility: [a]/səˈvɪləti/; [n]谦恭;礼貌;端庄; [or]gre3k;
claim: [a]/kleɪm/; [v]声称;要求;断言;主张;认领;索赔; [n]索赔;主张;声称;断言;要求; [or]gre3k;
clamor: [a]/ˈklæmər/; [n]喧闹;强烈的要求; [v]喧嚷;强烈的要求; [or]gre3k;
clan: [a]/klæn/; [n]家族;氏族;部落;宗派;亲族; [or]gre3k;
clandestine: [a]/klænˈdestɪn/; [adj]秘密的,私下的,暗中的; [or]gre3k;
clarion: [a]/'klærɪən/; [n]号角; [adj]清澈响亮的; [or]gre3k;
clarity: [a]/ˈklærəti/; [n]清楚;清澈; [or]gre3k;
clasp: [a]/klæsp/; [v]握紧;扣紧;扣住;抱紧; [n]扣子;钩子;紧抱;紧握; [or]gre3k;
cleave: [a]/kliːv/; [v]劈开,分裂; [or]gre3k;
clement: [a]/ˈklemənt/; [adj](天气)温和的;仁慈的; [or]gre3k;
cliche: [a]/klɪˈʃeɪ/; [n]陈腐思想,陈词滥调; [adj]陈腐的; [or]gre3k;
cling: [a]/klɪŋ/; [v]紧紧抓住;黏着,挨近;依恋,依附;坚持,墨守,忠实于; [or]gre3k;
clog: [a]/klɑːɡ/; [v]阻塞,阻碍; [n]障碍;木底鞋; [or]gre3k;
clot: [a]/klɑːt/; [v]使凝成块; [n]凝块; [or]gre3k;
cloudburst: [a]/ˈklaʊdbɜːrst/; [n]大暴雨,豪雨; [or]gre3k;
cloying: [a]/ˈklɔɪɪŋ/; [adj]甜得发腻的;厌烦的;倒胃口的; [or]gre3k;
clumsy: [a]/ˈklʌmzi/; [adj]笨拙的,不灵活的;拙劣的,不得体的; [or]gre3k;
coagulate: [a]/koʊˈæɡjuleɪt/; [v]凝结,使凝结; [or]gre3k;
coalesce: [a]/ˌkoʊəˈles/; [v]联合,合并,结合; [or]gre3k;
coarse: [a]/kɔːrs/; [adj]粗糙的;粗俗的;粗鲁的; [or]gre3k;
coax: [a]/koʊks/; [v]哄,哄诱; [or]gre3k;
coda: [a]/ˈkoʊdə/; [n]［音］结尾,符尾; [or]gre3k;
coerce: [a]/koʊˈɜːrs/; [v]强迫,压制; [or]gre3k;
coeval: [a]/koʊˈiːvl/; [adj]同时代的; [n]同时代的人; [or]gre3k;
cogent: [a]/ˈkoʊdʒənt/; [adj]有说服力的; [or]gre3k;
cognizant: [a]/ˈkɑːɡnɪzənt/; [adj]审理的,已认知的; [or]gre3k;
cohesive: [a]/koʊˈhiːsɪv/; [adj]团结的;紧密结合的;有黏着力的; [or]gre3k;
collaborate: [a]/kəˈlæbəreɪt/; [v]合作; [or]gre3k;
collapse: [a]/kəˈlæps/; [v](使)倒塌,(使)崩溃,(使)瓦解; [n]倒塌,崩溃,暴跌; [or]gre3k;
collude: [a]/kəˈluːd/; [v]串通,共谋; [or]gre3k;
colossal: [a]/kəˈlɑːsl/; [adj]巨像(似)的;巨大的,庞大的; [or]gre3k;
coltish: [a]/ˈkoʊltɪʃ/; [adj]放浪不拘的,似小马的; [or]gre3k;
coma: [a]/ˈkoʊmə/; [n]昏迷状态; [or]gre3k;
combustible: [a]/kəmˈbʌstəbl/; [adj]易燃的;易激动的; [n]可燃物;易燃物; [or]gre3k;
comely: [a]/ˈkʌmli/; [adj]动人的,美丽的; [or]gre3k;
comity: [a]/'kɒmətɪ/; [n]友好,社会和谐;礼让; [or]gre3k;
commencement: [a]/kəˈmensmənt/; [n]开始,发端;毕业典礼; [or]gre3k;
commend: [a]/kəˈmend/; [v]称赞;推荐;委托保管; [or]gre3k;
commensurate: [a]/kəˈmenʃərət/; [adj]相称的,相应的;同量的;同样大小的; [or]gre3k;
commingle: [a]/kəˈmɪŋɡl/; [vi]混合; [vt]使混合;掺和; [or]gre3k;
commiserate: [a]/kəˈmɪzəreɪt/; [v]同情,怜悯; [or]gre3k;
commitment: [a]/kəˈmɪtmənt/; [n]承诺;许诺;委任;承担的义务;献身;赞助;委托;犯罪;罪行;信奉; [or]gre3k;
committed: [a]/kəˈmɪtɪd/; [adj]效忠的;忠于.的;坚信的; [or]gre3k;
commodious: [a]/kəˈmoʊdiəs/; [adj]宽敞的; [or]gre3k;
commotion: [a]/kəˈmoʊʃn/; [n]骚动,动乱; [or]gre3k;
compatible: [a]/kəmˈpætəbl/; [adj]可和谐共存的;兼容的; [or]gre3k;
compelling: [a]/kəmˈpelɪŋ/; [adj]引人注目的;紧迫的;令人信服的; [or]gre3k;
compendium: [a]/kəmˈpendiəm/; [n]纲要,概略; [or]gre3k;
complacency: [a]/kəmˈpleɪsnsi/; [n]自满,自鸣得意;满足; [or]gre3k;
complacent: [a]/kəmˈpleɪsnt/; [adj]自满的,得意的; [or]gre3k;
complaisance: [a]/kəmˈpleɪzəns/; [n]迁就,奉承,彬彬有礼; [or]gre3k;
complementary: [a]/ˌkɑːmplɪˈmentri/; [adj]补足的,补充的,互补的; [or]gre3k;
compliant: [a]/kəmˈplaɪənt/; [adj]顺从的,服从的,应允的; [or]gre3k;
complicate: [a]/ˈkɑːmplɪkeɪt/; [v](使)变复杂; [or]gre3k;
compliment: [a]/ˈkɑːmplɪmənt/; [n]恭维,问候; [v]赞美,祝贺; [or]gre3k;
comply: [a]/kəmˈplaɪ/; [vi]依从,服从,遵守; [or]gre3k;
compose: [a]/kəmˈpoʊz/; [v]创作,作曲,形成,构成; [or]gre3k;
compound: [a]/ˈkɑːmpaʊnd/; [n]复合物;<化学>化合物; [adj]合成的;复合的;多功能的; [vi]妥协;和解; [vt]混合;调和;调停;使恶化; [or]gre3k;
comprehend: [a]/ˌkɑːmprɪˈhend/; [v]由.组成;了解;领会;包含; [or]gre3k;
compress: [a]/kəmˈpres/; [v]压紧,压缩,压榨; [or]gre3k;
compromise: [a]/ˈkɑːmprəmaɪz/; [n]妥协;折中; [v]妥协;使遭受危害; [or]gre3k;
compunction: [a]/kəmˈpʌŋkʃn/; [n]懊悔,良心不安; [or]gre3k;
concatenate: [a]/kɑnˈkæt(ə)ˌneɪt/; [v]连结,连锁; [adj]连结的;连锁的; [or]gre3k;
concave: [a]/kɑːnˈkeɪv/; [adj]凹面的; [n]凹面; [vt]使成凹形; [or]gre3k;
conceal: [a]/kənˈsiːl/; [v]隐藏,隐瞒,掩盖; [or]gre3k;
concede: [a]/kənˈsiːd/; [v]承认;承认失败;让给,让与;让步; [or]gre3k;
concentrate: [a]/ˈkɑːnsntreɪt/; [v]全神贯注于,集中于;浓缩; [n]浓缩物; [or]gre3k;
concerted: [a]/kənˈsɜːrtɪd/; [adj]一致的,商定的; [or]gre3k;
conciliate: [a]/kənˈsɪlieɪt/; [v]调和,安抚; [or]gre3k;
concise: [a]/kənˈsaɪs/; [adj]简明的,简要的;简洁的,简要的; [or]gre3k;
concord: [a]/ˈkɑːŋkɔːrd/; [n]和睦,公约; [or]gre3k;
concrete: [a]/ˈkɑːŋkriːt/; [n]混凝土; [adj]具体的,实质性的; [v]给 (道路等) 浇混凝土; [or]gre3k;
concur: [a]/kənˈkɜːr/; [v]同意;一致; [or]gre3k;
condemn: [a]/kənˈdem/; [v]谴责,责备;判(某人某罪); [or]gre3k;
condescending: [a]/ˌkɑːndɪˈsendɪŋ/; [adj]贬低的;有优越感的; [or]gre3k;
conditional: [a]/kənˈdɪʃənl/; [adj]有条件的,假定的; [n]条件句,条件语; [or]gre3k;
condole: [a]/kən'doʊl/; [v]慰问,哀悼; [or]gre3k;
condone: [a]/kənˈdoʊn/; [v]宽恕;赦免; [or]gre3k;
conducive: [a]/kənˈduːsɪv/; [adj]有益的,有助于.的; [or]gre3k;
confident: [a]/ˈkɑːnfɪdənt/; [adj]自信的;确信的,深信的; [or]gre3k;
confine: [a]/kənˈfaɪn/; [v]限制;监禁; [n]范围,界限,约束,限制; [or]gre3k;
conflagration: [a]/ˌkɑːnfləˈɡreɪʃn/; [n]建筑物或森林大火; [or]gre3k;
conflate: [a]/kənˈfleɪt/; [v]合并; [or]gre3k;
confluence: [a]/ˈkɑːnfluəns/; [n](河流的)汇合,汇流点;(人或物的)聚集; [or]gre3k;
conform: [a]/kənˈfɔːrm/; [vi]一致;遵照,顺从;符合; [vt]使一致;使遵照; [adj]一致的; [or]gre3k;
confound: [a]/kənˈfaʊnd/; [v]使混淆,使混乱;挫败;讨厌; [or]gre3k;
confront: [a]/kənˈfrʌnt/; [v]与某人对峙;与..对抗;正视; [or]gre3k;
congeal: [a]/kənˈdʒiːl/; [v]凝结;凝固; [or]gre3k;
congenial: [a]/kənˈdʒiːniəl/; [adj]意气相投的,令人愉快的,意气相投的,协调的; [or]gre3k;
congruent: [a]/ˈkɑːŋɡruənt/; [adj]和谐一致的,全等的; [or]gre3k;
conjecture: [a]/kənˈdʒektʃər/; [n]推测;猜想; [v]推测;揣摩; [or]gre3k;
conjure: [a]/ˈkʌndʒər/; [v]变魔术;使...变戏法般地出现(或消失);使想起;使...呈现于脑际;(a name to conjure with)大名鼎鼎的人;影响巨大的事物;恳求; [or]gre3k;
connive: [a]/kəˈnaɪv/; [v]默许,共谋; [or]gre3k;
connoisseur: [a]/ˌkɑːnəˈsɜːr/; [n](艺术品等的)鉴赏家,鉴定家,行家; [or]gre3k;
conscientious: [a]/ˌkɑːnʃiˈenʃəs/; [adj]勤勤恳恳的;认真的; [or]gre3k;
consensus: [a]/kənˈsensəs/; [n]一致同意,合意; [or]gre3k;
consent: [a]/kənˈsent/; [n]同意,准许;赞成; [v]同意; [or]gre3k;
consequence: [a]/ˈkɑːnsɪkwens/; [n]结果,后果;重要性; [or]gre3k;
conservative: [a]/kənˈsɜːrvətɪv/; [adj]保守的;保守估计的;保守党的; [n]保守主义者;保守党党员; [or]gre3k;
conservatory: [a]/kənˈsɜːrvətɔːri/; [n]温室;音乐学校; [adj]有保存力的;保存性的; [or]gre3k;
conserve: [a]/kənˈsɜːrv/; [v]保藏,保存;节约; [n]蜜饯,果酱; [or]gre3k;
considerable: [a]/kənˈsɪdərəbl/; [adj]相当大的;重要的;可观的; [or]gre3k;
consign: [a]/kənˈsaɪn/; [v]托运,托卖,寄存; [or]gre3k;
console: [a]/kənˈsoʊl/; [v]安慰,慰问; [n]控制台,仪表板;落地柜; [or]gre3k;
consolidate: [a]/kənˈsɑːlɪdeɪt/; [v]巩固,加强;把.合为一体; [or]gre3k;
consonant: [a]/ˈkɑːnsənənt/; [adj]辅音的;一致的,和谐的; [n]辅音;辅音字母; [or]gre3k;
conspicuous: [a]/kənˈspɪkjuəs/; [adj]显眼的;显著的;显而易见的; [or]gre3k;
conspire: [a]/kənˈspaɪər/; [v]密谋策划;共谋,串通一气; [or]gre3k;
consternation: [a]/ˌkɑːnstərˈneɪʃn/; [n]惊愕,恐怖,惊惶失措; [or]gre3k;
constitute: [a]/ˈkɑːnstətuːt/; [v]构成,组成;任命; [or]gre3k;
constrain: [a]/kənˈstreɪn/; [v]约束;限制;强迫; [or]gre3k;
constrict: [a]/kənˈstrɪkt/; [v]约束,收缩,妨碍; [or]gre3k;
construct: [a]/kənˈstrʌkt/; [v]建造;作(图);构筑; [n]概念;构筑物;结构体;建造物; [or]gre3k;
consummate: [a]/ˈkɑːnsəmət/; [adj]至上的,完美的; [v]完成,使达到极点; [or]gre3k;
contagious: [a]/kənˈteɪdʒəs/; [adj](病)有传染性的;(人)患传染病的;有感染力的; [or]gre3k;
contaminate: [a]/kənˈtæmɪneɪt/; [v]弄脏,污染; [or]gre3k;
contemplate: [a]/ˈkɑːntəmpleɪt/; [v]沉思;对..周密考虑;注视; [or]gre3k;
contempt: [a]/kənˈtempt/; [n]轻视,鄙视; [or]gre3k;
contend: [a]/kənˈtend/; [v]争辩;坚决主张;搏斗; [or]gre3k;
content: [a]/ˈkɑːntent/; [n]内容,目录;满足; [adj]满足的; [v]使满意; [or]gre3k;
contentious: [a]/kənˈtenʃəs/; [adj]好辩的,爱争论的; [or]gre3k;
contiguous: [a]/kənˈtɪɡjuəs/; [adj]相接的;邻近的,附近的; [or]gre3k;
contort: [a]/kənˈtɔːrt/; [v]扭曲,歪曲; [or]gre3k;
contract: [a]/ˈkɑːntrækt/; [n]合同,契约; [v]感染(疾病);招致;订合同;订立(婚约);缩减; [or]gre3k;
contradict: [a]/ˌkɑːntrəˈdɪkt/; [v]与..发生矛盾,与..抵触,与..对立; [or]gre3k;
contravene: [a]/ˌkɑːntrəˈviːn/; [v]抵触,违反,反驳,否认; [or]gre3k;
contrite: [a]/kənˈtraɪt/; [adj]悔罪的;痛悔的; [or]gre3k;
contrived: [a]/kənˈtraɪvd/; [adj]人为的;做作的;不自然的; [or]gre3k;
contumacious: [a]/ˌkɑːntuˈmeɪʃəs/; [adj]违抗的,顽固的,反抗法院命令的; [or]gre3k;
conundrum: [a]/kəˈnʌndrəm/; [n](答案有双关意义的)谜语;机智问答;难题; [or]gre3k;
convalesce: [a]/ˌkɑːnvəˈles/; [v]渐愈,渐渐康复; [or]gre3k;
convene: [a]/kənˈviːn/; [v]集合,召集,召唤; [or]gre3k;
convenience: [a]/kənˈviːniəns/; [n]方便;便利设施; [or]gre3k;
convention: [a]/kənˈvenʃn/; [n]会议;习俗;惯例; [or]gre3k;
converge: [a]/kənˈvɜːrdʒ/; [v](向某一点)相交,会合;汇集,聚集,集中; [or]gre3k;
conversant: [a]/kənˈvɜːrsnt/; [adj]熟悉的;精通的;亲近的; [or]gre3k;
convert: [a]/kənˈvɜːrt/; [v]可转变为,可变换成;改变,转变,转化;使改变信仰; [n]皈依者;改变宗教信仰者; [or]gre3k;
convex: [a]/ˈkɑːnveks/; [adj]中凸的;凸圆的;凸面的; [n]凸面体;凸状; [or]gre3k;
convey: [a]/kənˈveɪ/; [v]传送,运送;表达,传达; [or]gre3k;
conviction: [a]/kənˈvɪkʃn/; [n]定罪;信服;坚强信念; [or]gre3k;
convoke: [a]/kənˈvoʊk/; [v]召集会议; [or]gre3k;
convoluted: [a]/ˈkɑːnvəluːtɪd/; [adj]旋绕的,费解的; [or]gre3k;
convulsion: [a]/kənˈvʌlʃn/; [n]惊厥,动乱,震撼,震动; [or]gre3k;
coop: [a]/kuːp/; [v]把.关进笼子里;限制;拘禁; [n]鸡笼;小屋;捕鱼篓; [or]gre3k;
copious: [a]/ˈkoʊpiəs/; [adj]丰富的,多产的; [or]gre3k;
coquette: [a]/koʊˈket/; [n]调情的女子; [v]不认真对待; [or]gre3k;
cordon: [a]/ˈkɔːrdn/; [n]哨兵线,警戒线;饰带; [v]布设警戒线;封锁交通; [or]gre3k;
cornucopia: [a]/ˌkɔːrnjuˈkoʊpiə/; [n]象征丰收的羊角;装满花果及谷穗表丰饶的羊角状物;丰饶的象征; [or]gre3k;
coronation: [a]/ˌkɔːrəˈneɪʃn/; [n]加冕,加冕礼; [or]gre3k;
corporeal: [a]/kɔːrˈpɔːriəl/; [adj]物质的,有形的,肉体的; [or]gre3k;
correlate: [a]/ˈkɔːrələt/; [v](使)相关联; [n]相关物; [or]gre3k;
corroborate: [a]/kəˈrɑːbəreɪt/; [v]支持或证实,强化; [n]确证者,证物; [or]gre3k;
corrosive: [a]/kəˈroʊsɪv/; [adj]腐蚀的;腐蚀性的;蚀坏的; [n]腐蚀剂; [or]gre3k;
corrugated: [a]/ˈkɔːrəɡeɪtɪd/; [adj]褶皱的; [or]gre3k;
cosmopolitan: [a]/ˌkɑːzməˈpɑːlɪtən/; [n]游历四方的人; [adj]见多识广的;多元的;广泛分布的; [or]gre3k;
cosset: [a]/ˈkɑːsɪt/; [v]宠爱,娇养; [n]宠儿,爱畜;宠物; [or]gre3k;
countenance: [a]/ˈkaʊntənəns/; [n]面容,表情,气色; [v]支持,赞成; [or]gre3k;
counterfeit: [a]/ˈkaʊntərfɪt/; [n]仿制品,伪造物; [adj]仿造的.假冒的; [v]伪造,仿造; [or]gre3k;
countermand: [a]/ˈkaʊntərmænd/; [vt]撤回,取消; [or]gre3k;
counterpart: [a]/ˈkaʊntərpɑːrt/; [n]对应的人(物);副本;对手; [or]gre3k;
counterproductive: [a]/ˌkaʊntərprəˈdʌktɪv/; [adj]反效果的,阻碍预期目标的; [or]gre3k;
court: [a]/kɔːrt/; [n]法院,法庭;庭院;球场;宫廷; [v]讨好,取悦;招致危险;追求; [or]gre3k;
courteous: [a]/ˈkɜːrtiəs/; [adj]有礼貌的,谦恭有礼的; [or]gre3k;
covert: [a]/ˈkoʊvɜːrt/; [adj]隐蔽的,偷偷摸摸的,<律>在丈夫保护下的; [n]掩蔽处,隐藏处; [or]gre3k;
covetous: [a]/ˈkʌvətəs/; [adj]贪婪的,贪心的; [or]gre3k;
cow: [a]/kaʊ/; [n]母牛,奶牛;母兽; [v]恐吓,吓倒; [or]gre3k;
cowardice: [a]/ˈkaʊərdɪs/; [n]胆小,懦弱; [or]gre3k;
cower: [a]/ˈkaʊər/; [v]畏缩,退缩,蜷缩; [or]gre3k;
coy: [a]/kɔɪ/; [adj]腼腆的,怕羞的;卖弄风情的; [or]gre3k;
cramped: [a]/kræmpt/; [adj]狭窄的,挤在一起的; [or]gre3k;
crass: [a]/kræs/; [adj]粗鲁的,粗俗的,愚钝的; [or]gre3k;
crave: [a]/kreɪv/; [v]渴望;恳求; [or]gre3k;
craven: [a]/ˈkreɪvn/; [adj]懦弱的,畏缩的; [or]gre3k;
crease: [a]/kriːs/; [n]折缝,皱痕; [v]起折痕; [or]gre3k;
credence: [a]/ˈkriːdns/; [n]信任,相信; [or]gre3k;
credible: [a]/ˈkredəbl/; [adj]可信任的,可靠的,出色的; [or]gre3k;
credit: [a]/ˈkredɪt/; [n]信用;荣誉;学分;信贷;称赞;债权; [v]信赖;归因于;记学分; [or]gre3k;
credulous: [a]/ˈkredʒələs/; [adj]轻信的,因轻信而产生的; [or]gre3k;
creek: [a]/kriːk/; [n]小溪;小湾; [or]gre3k;
creep: [a]/kriːp/; [vi]爬行;潜入;蔓延;变形;毛发直竖; [n]卑鄙小人;爬行;变形;毛骨悚然的感觉; [or]gre3k;
crescendo: [a]/krəˈʃendoʊ/; [n](音乐)渐强;高潮; [or]gre3k;
crest: [a]/krest/; [n]鸟冠,盔上的装饰(如羽毛),顶部,顶峰; [v]到达绝顶,加以顶饰; [or]gre3k;
crestfallen: [a]/ˈkrestfɔːlən/; [adj]垂头丧气的,气馁的; [or]gre3k;
cronyism: [a]/ˈkroʊniɪzəm/; [n]任人唯亲;任用亲信; [or]gre3k;
crook: [a]/krʊk/; [n]骗子;弯曲处;钩;河弯;诡计; [v]使弯曲; [adj]不正当的;骗人的; [or]gre3k;
croon: [a]/kruːn/; [v]低声歌唱或说话; [or]gre3k;
crouch: [a]/kraʊtʃ/; [v]蹲;弯腰; [or]gre3k;
crow: [a]/kroʊ/; [n]乌鸦;欢呼声; [v]啼;报晓;(儿童)欢笑; [or]gre3k;
crucial: [a]/ˈkruːʃl/; [adj]关键的;决定性的; [or]gre3k;
crumple: [a]/ˈkrʌmpl/; [v]把.揉作一团,弄皱;压碎; [or]gre3k;
crutch: [a]/krʌtʃ/; [n]拐杖,支柱; [v]支撑; [or]gre3k;
crux: [a]/krʌks/; [n]关键,难题,十字架形,坩埚; [or]gre3k;
cryptic: [a]/ˈkrɪptɪk/; [adj]秘密的,含义模糊的,神秘的,隐藏的; [or]gre3k;
culpable: [a]/ˈkʌlpəbl/; [adj]有罪的;该责备的;不周到的;应受处罚的; [or]gre3k;
cultivate: [a]/ˈkʌltɪveɪt/; [v]耕作,养植,栽培;培养,陶冶,发展; [or]gre3k;
cumbersome: [a]/ˈkʌmbərsəm/; [adj]笨重的;麻烦的; [or]gre3k;
cunning: [a]/ˈkʌnɪŋ/; [n]狡猾,精巧; [adj]狡猾的,精巧的; [or]gre3k;
curmudgeon: [a]/kɜːrˈmʌdʒən/; [n]脾气暴躁之人; [or]gre3k;
cursory: [a]/ˈkɜːrsəri/; [adj]匆忙的,不注意细节的;草率地;粗略地; [or]gre3k;
curt: [a]/kɜːrt/; [adj]简略的; [or]gre3k;
curtail: [a]/kɜːrˈteɪl/; [vt]截短;削减;剥夺.特权; [or]gre3k;
cynic: [a]/ˈsɪnɪk/; [n]愤世嫉俗者;犬儒学派的人; [adj]犬儒学派的; [or]gre3k;
dabble: [a]/ˈdæbl/; [v]涉足;浅赏,溅湿;浸入水中; [or]gre3k;
daft: [a]/dæft/; [adj]愚蠢的; [or]gre3k;
dais: [a]/ˈdeɪɪs/; [n]主席台,嘉宾席; [or]gre3k;
dally: [a]/ˈdæli/; [v]闲荡,嬉戏;浪费(时间); [or]gre3k;
damn: [a]/dæm/; [int]该死,讨厌; [v]诅咒; [n]诅咒; [adj]该死的;完全的; [adv](表示厌烦)该死;非常; [or]gre3k;
dampen: [a]/ˈdæmpən/; [v]变潮湿; [vi]沮丧; [vt]使潮湿;抑制,使扫兴; [or]gre3k;
dandy: [a]/ˈdændi/; [n]花花公子; [adj]服装华丽的,极好的,上等的; [or]gre3k;
dank: [a]/dæŋk/; [adj]潮湿的,阴湿的;透水的; [or]gre3k;
dapper: [a]/ˈdæpər/; [adj]干净利落的,衣冠楚楚的; [or]gre3k;
dappled: [a]/ˈdæpld/; [adj]有斑点的,斑驳的; [or]gre3k;
daredevil: [a]/ˈderdevl/; [n]铤而走险的人,蛮勇的人; [adj]蛮勇的,不怕死的; [or]gre3k;
dart: [a]/dɑːrt/; [n]飞镖;猛冲;标枪; [v]快速投掷;突然移动; [or]gre3k;
dashing: [a]/ˈdæʃɪŋ/; [adj]时髦的,华丽的;雄纠纠的;劲头十足的; [or]gre3k;
dated: [a]/ˈdeɪtɪd/; [adj]注有(或注明)日期的;过时的,旧式的; [or]gre3k;
daunt: [a]/dɔːnt/; [v]使气馁,使畏缩,威吓; [or]gre3k;
dawdle: [a]/ˈdɔːdl/; [v]闲荡,浪费时间; [or]gre3k;
deadlock: [a]/ˈdedlɑːk/; [vt](使)相持不下; [vi]僵持; [n]僵局;不分胜负; [or]gre3k;
deadpan: [a]/ˈdedpæn/; [adj]面无表情的; [adv]面无表情地; [or]gre3k;
dearth: [a]/dɜːrθ/; [n]缺乏,供应不足; [or]gre3k;
debacle: [a]/dɪˈbɑːkl/; [n]解冻,崩溃;灾害; [or]gre3k;
debark: [a]/dɪ'bɑːk/; [v]下船,登陆; [or]gre3k;
debase: [a]/dɪˈbeɪs/; [v]贬值,降低; [or]gre3k;
debilitate: [a]/dɪˈbɪlɪteɪt/; [v]使衰弱; [or]gre3k;
debonair: [a]/ˌdebəˈner/; [adj]温文尔雅的; [or]gre3k;
debris: [a]/dəˈbriː/; [n]废墟,残骸; [or]gre3k;
debunk: [a]/ˌdiːˈbʌŋk/; [v]揭穿真面目,证明为假; [or]gre3k;
debut: [a]/deɪˈbjuː/; [n]初次登台,在社交场合的初次露脸; [v]初次露面,初次表演;首次推出; [adj]首张的,首场的,首次的; [or]gre3k;
decadence: [a]/ˈdekədəns/; [n]堕落,颓废;衰落; [or]gre3k;
decadent: [a]/ˈdekədənt/; [adj]颓废的;衰退的; [or]gre3k;
decant: [a]/dɪˈkænt/; [vt]轻轻倒出; [or]gre3k;
decipher: [a]/dɪˈsaɪfər/; [n]密电译文; [vt]解释;破译; [or]gre3k;
decode: [a]/ˌdiːˈkoʊd/; [v]译解;解码; [or]gre3k;
decorum: [a]/dɪˈkɔːrəm/; [n]礼节,礼貌,端庄,正派; [or]gre3k;
decrepit: [a]/dɪˈkrepɪt/; [adj]衰老的,破旧的; [or]gre3k;
decry: [a]/dɪˈkraɪ/; [v]谴责,责难,诽谤; [or]gre3k;
default: [a]/dɪˈfɔːlt/; [n]违约;缺席;缺乏;默认; [vi]不履行义务;拖欠; [vt]不履行;不参加; [or]gre3k;
defer: [a]/dɪˈfɜːr/; [v]使推迟,使延期;听从,顺从; [vi]延期; [or]gre3k;
deference: [a]/ˈdefərəns/; [n]尊敬,尊重;顺从; [or]gre3k;
deficiency: [a]/dɪˈfɪʃnsi/; [n]缺乏,不足;缺陷; [or]gre3k;
defile: [a]/dɪˈfaɪl/; [v]污损,弄脏;以纵队前进; [n]狭谷;隘路; [or]gre3k;
deflect: [a]/dɪˈflekt/; [v](使)偏斜,(使)偏转; [or]gre3k;
defray: [a]/dɪˈfreɪ/; [v]支出;支付; [or]gre3k;
deft: [a]/deft/; [adj]灵巧的,敏捷的,熟练的; [or]gre3k;
defuse: [a]/ˌdiːˈfjuːz/; [vi]平息,变弱; [vt]拆除;使消除危险性,平息; [or]gre3k;
defy: [a]/dɪˈfaɪ/; [v]违抗,藐视;使不可能 (理解或解释);违背;赌.也不能; [n]挑战;对抗; [or]gre3k;
dehydrate: [a]/diːˈhaɪdreɪt/; [v]除去水份,脱水; [or]gre3k;
deify: [a]/ˈdeɪɪfaɪ/; [v]奉为神;崇拜; [or]gre3k;
deign: [a]/deɪn/; [v]屈尊,惠允(做某事); [or]gre3k;
deject: [a]/dɪ'dʒekt/; [v]使.灰心; [adj]沮丧的,气馁的; [or]gre3k;
delegate: [a]/ˈdelɪɡət/; [n]代表; [v]委派..为代表,授权; [or]gre3k;
deleterious: [a]/ˌdeləˈtɪriəs/; [adj]有害的;有毒的; [or]gre3k;
deliberate: [a]/dɪˈlɪbərət/; [adj]故意的;深思熟虑的;从容不迫的; [v]仔细考虑;研讨; [or]gre3k;
delicacy: [a]/ˈdelɪkəsi/; [n]精致;柔弱;佳肴;优雅;谨慎; [or]gre3k;
delineate: [a]/dɪˈlɪnieɪt/; [v]描画;画出..轮廓; [or]gre3k;
delirium: [a]/dɪˈlɪriəm/; [n]神志不清,极度兴奋; [or]gre3k;
deluge: [a]/ˈdeljuːdʒ/; [n]洪水;暴雨;泛滥; [v]使泛滥;压倒; [or]gre3k;
delusion: [a]/dɪˈluːʒn/; [n]错觉; [or]gre3k;
delve: [a]/delv/; [v]钻研;探究;挖; [n]穴;洞; [or]gre3k;
demagogue: [a]/ˈdeməɡɑːɡ/; [n]煽动者; [or]gre3k;
demanding: [a]/dɪˈmændɪŋ/; [adj]苛求的,难取悦的;费力的; [or]gre3k;
demolition: [a]/ˌdeməˈlɪʃn/; [n]拆除(等于demolishment);破坏,毁坏; [or]gre3k;
demonstrate: [a]/ˈdemənstreɪt/; [vt](用实例,实验)论证;演示,展示;示范; [vi]示威; [or]gre3k;
demoralize: [a]/dɪˈmɔːrəlaɪz/; [v]使低落,使沮丧;使道德败坏;使士气低落; [or]gre3k;
demote: [a]/ˌdiːˈmoʊt/; [v]降级,降职; [or]gre3k;
demotic: [a]/dɪˈmɑːtɪk/; [adj]通俗的,民众的; [or]gre3k;
demotion: [a]/ˌdiːˈmoʊʃn/; [n]降级,降职; [or]gre3k;
demur: [a]/dɪˈmɜːr/; [n]异议; [v]异议,反对,拒绝; [or]gre3k;
denigrate: [a]/ˈdenɪɡreɪt/; [v]抹黑,贬低; [or]gre3k;
denouement: [a]/ˌdeɪnuːˈmɑ̃ː/; [n]结局,终场; [or]gre3k;
denounce: [a]/dɪˈnaʊns/; [v]谴责,斥责; [or]gre3k;
dent: [a]/dent/; [n]缺口,凹痕; [v]使凹下,凹进,削弱; [or]gre3k;
denude: [a]/dɪˈnuːd/; [v]脱去,剥蚀,剥夺; [or]gre3k;
dependable: [a]/dɪˈpendəbl/; [adj]可靠的;可信赖的; [or]gre3k;
deplete: [a]/dɪˈpliːt/; [v]使大大减少;耗尽,用尽; [or]gre3k;
deplorable: [a]/dɪˈplɔːrəbl/; [adj]可叹的;凄惨的; [or]gre3k;
deplore: [a]/dɪˈplɔːr/; [v]谴责;对...深感遗憾;悲悼;痛惜; [or]gre3k;
deploy: [a]/dɪˈplɔɪ/; [v]部署,设置;展开,散开; [or]gre3k;
deportation: [a]/ˌdiːpɔːrˈteɪʃn/; [n]驱逐出境,放逐; [or]gre3k;
depose: [a]/dɪˈpoʊz/; [v]免职,废黜,作证; [or]gre3k;
deposit: [a]/dɪˈpɑːzɪt/; [v]存款,存放;沉淀; [n]存款,定金;沉积物,矿床; [or]gre3k;
depravity: [a]/dɪˈprævəti/; [n][n]恶劣行为;堕落,腐败,邪恶;腐败;邪恶;恶劣行为,腐化堕落的行为; [or]gre3k;
deprecate: [a]/ˈdeprəkeɪt/; [v]反对;轻视; [or]gre3k;
depreciate: [a]/dɪˈpriːʃieɪt/; [v]贬低,轻视;贬值;折旧; [or]gre3k;
depressed: [a]/dɪˈprest/; [adj]沮丧的;萧条的;低迷的; [or]gre3k;
deprivation: [a]/ˌdeprɪˈveɪʃn/; [n]剥夺;免职;匮乏;丧失;损失;免职; [or]gre3k;
deracinate: [a]/ˌdiːˈræsɪneɪt/; [v]根除,使孤立; [or]gre3k;
derelict: [a]/ˈderəlɪkt/; [adj]渎职的,荒废的,被弃置的; [n]失业贫穷的无家可归者; [or]gre3k;
deride: [a]/dɪˈraɪd/; [v]嘲弄,愚弄; [or]gre3k;
derivative: [a]/dɪˈrɪvətɪv/; [n]派生物;<化学>衍生物; [adj]被引申出的,被诱导的;衍生的;第二手的; [or]gre3k;
descend: [a]/dɪˈsend/; [vi]走下;降临; [v]下降,下来;突然访问;下移,下降; [or]gre3k;
descendant: [a]/dɪˈsendənt/; [n]后代,后裔;派生物; [or]gre3k;
desecrate: [a]/ˈdesɪkreɪt/; [v]亵渎,玷污; [or]gre3k;
desiccate: [a]/'desɪˌkeɪt/; [v](使)完全干涸,脱水; [or]gre3k;
designate: [a]/ˈdezɪɡneɪt/; [adj]已受委派而尚未上任的; [v]标出,说出;委任,任命,提名;指定; [or]gre3k;
desperate: [a]/ˈdespərət/; [adj]绝望的;孤注一掷的;极需要的,渴望的;(情况) 极严重的;极危险的;很危急的; [or]gre3k;
despicable: [a]/dɪˈspɪkəbl/; [adj]可鄙的,卑劣的; [or]gre3k;
despise: [a]/dɪˈspaɪz/; [vt]轻视,蔑视,看不起; [or]gre3k;
despotic: [a]/dɪˈspɑːtɪk/; [adj]专政的,专横的,暴虐的; [or]gre3k;
desultory: [a]/ˈdesəltɔːri/; [adj]散漫的,无目的的,断断续续的; [or]gre3k;
detach: [a]/dɪˈtætʃ/; [v]使分开,拆卸;派遣; [or]gre3k;
detain: [a]/dɪˈteɪn/; [v]拘留,使延迟; [or]gre3k;
deter: [a]/dɪˈtɜːr/; [v]防止,阻止,使踌躇; [or]gre3k;
deterioration: [a]/dɪˌtɪriəˈreɪʃn/; [n]变坏,退化,恶化;堕落; [or]gre3k;
detour: [a]/ˈdiːtʊr/; [n]弯路,绕行之路; [v]绕道,迂回; [or]gre3k;
detritus: [a]/dɪˈtraɪtəs/; [n]岩屑,碎石; [or]gre3k;
devoted: [a]/dɪˈvoʊtɪd/; [adj]虔诚的,投入的; [or]gre3k;
devout: [a]/dɪˈvaʊt/; [adj]虔诚的,真挚的,诚恳的; [n]虔诚;真挚,诚恳; [or]gre3k;
dexterous: [a]/ˈdekstrəs/; [adj]灵巧的,熟练的; [or]gre3k;
diabolic: [a]/ˌdaɪə'bɑːlɪk/; [adj]恶魔的;恶魔似的;残忍的; [or]gre3k;
diaphanous: [a]/daɪˈæfənəs/; [adj]透明的;精致的;模糊的; [or]gre3k;
diatribe: [a]/ˈdaɪətraɪb/; [n]诽谤,恶骂; [or]gre3k;
dichotomy: [a]/daɪˈkɑːtəmi/; [n]二分,本质对立; [or]gre3k;
dictate: [a]/ˈdɪkteɪt/; [v]规定;命令;口授;听写; [n]命令;指令; [or]gre3k;
didactic: [a]/daɪˈdæktɪk/; [adj]说教的;教诲的; [or]gre3k;
diehard: [a]/ˈdaɪhɑːrd/; [n]顽固分子,保守分子; [adj]顽固的,执拗的; [or]gre3k;
diffident: [a]/ˈdɪfɪdənt/; [adj]羞怯的,缺乏自信的,谦虚谨慎的; [or]gre3k;
diffuse: [a]/dɪˈfjuːz/; [v]传播;扩散,弥漫;漫射; [adj]四散的,散开的;不清楚的; [or]gre3k;
digress: [a]/daɪˈɡres/; [v]离题;走向岔道; [or]gre3k;
dike: [a]/daɪk/; [n]堤防,堤坝;障碍物;(英)壕沟; [v]筑堤防护;开沟排水; [or]gre3k;
dilapidate: [a]/də'læpəˌdeɪt/; [v]毁坏,荒废,浪费; [or]gre3k;
dilate: [a]/daɪˈleɪt/; [v]使膨胀,扩张,膨胀;详述; [or]gre3k;
dilatory: [a]/ˈdɪlətɔːri/; [adj]拖拉的,缓慢的,不慌不忙的; [or]gre3k;
dilettante: [a]/ˌdɪləˈtænti/; [n]半吊子; [or]gre3k;
diligent: [a]/ˈdɪlɪdʒənt/; [adj]勤奋的;用功的; [or]gre3k;
dilute: [a]/daɪˈluːt/; [v]使变淡,稀释;使病弱; [or]gre3k;
diminish: [a]/dɪˈmɪnɪʃ/; [v]减少;失势,削弱.的权势, 减弱.的权势; [or]gre3k;
din: [a]/dɪn/; [n]喧闹声,嘈杂声; [v]喧闹,喋喋不休地说; [or]gre3k;
dingy: [a]/ˈdɪndʒi/; [adj]昏暗的,肮脏的;褴褛的; [n]同"dingey"; [or]gre3k;
diocesan: [a]/daɪˈɑːsɪsn/; [adj]主教管区的; [n]教区主教; [or]gre3k;
diplomatic: [a]/ˌdɪpləˈmætɪk/; [adj]外交的,从事外交的;老练的,圆滑的; [or]gre3k;
dire: [a]/ˈdaɪər/; [adj]可怕的;悲惨的;极端的; [or]gre3k;
dirge: [a]/dɜːrdʒ/; [n]挽歌;哀悼歌; [or]gre3k;
disabuse: [a]/ˌdɪsəˈbjuːz/; [v]使省悟,解迷惑,释疑,矫正; [or]gre3k;
disaffected: [a]/ˌdɪsəˈfektɪd/; [adj]不满的,有叛意的,愤愤不平的; [or]gre3k;
disarm: [a]/dɪsˈɑːrm/; [vt]放下武器;使人消除敌意; [vi]解除武装; [or]gre3k;
disarray: [a]/ˌdɪsəˈreɪ/; [n]混乱,漫无秩序; [or]gre3k;
disavow: [a]/ˌdɪsəˈvaʊ/; [v]不承认,抵赖,拒绝对..承担责任; [or]gre3k;
discern: [a]/dɪˈsɜːrn/; [v]辨别;识别;看出; [or]gre3k;
discharge: [a]/dɪsˈtʃɑːrdʒ/; [n]发射;释放;解雇;放电; [v]卸掉负担;发射;放电;卸(货);使爆炸;履行;解雇;允许.离开;排出,放出;清偿(债务); [or]gre3k;
disciple: [a]/dɪˈsaɪpl/; [n]信徒,门徒;耶稣的信徒(或门徒,使徒); [or]gre3k;
discombobulate: [a]/ˌdɪskəmˈbɑːbjuleɪt/; [vt]使混乱,使困惑,挫败; [or]gre3k;
discomfit: [a]/dɪsˈkʌmfɪt/; [v]挫败,扰乱,破坏,使.为难; [or]gre3k;
discommode: [a]/ˌdɪskə'moʊd/; [v]使不方便,使为难,使不自由; [or]gre3k;
discompose: [a]/ˌdɪskəmˈpoʊz/; [v]使失态,使烦恼,慌张; [or]gre3k;
disconcert: [a]/ˌdɪskənˈsɜːrt/; [v]使仓皇失措;使困惑;破坏; [or]gre3k;
discord: [a]/ˈdɪskɔːrd/; [n]不和,争吵;(声音)不和谐; [or]gre3k;
discredit: [a]/dɪsˈkredɪt/; [v]使不相信,使怀疑;败坏.的名声; [n]丧失信誉,丧失名誉;败坏名声的人或事,耻辱; [or]gre3k;
discreet: [a]/dɪˈskriːt/; [adj]谨慎的;思虑周全的,小心的; [or]gre3k;
discrepancy: [a]/dɪsˈkrepənsi/; [n]不一致,差异,不符; [or]gre3k;
discrete: [a]/dɪˈskriːt/; [adj]分开的;不连续的; [or]gre3k;
discretion: [a]/dɪˈskreʃn/; [n]自由裁量权;谨慎;判断力;判定;考虑周到; [or]gre3k;
discretionary: [a]/dɪˈskreʃəneri/; [adj]分立的,自理自由的;任意的; [or]gre3k;
discriminate: [a]/dɪˈskrɪmɪneɪt/; [v]区别,辨别;歧视; [or]gre3k;
discursive: [a]/dɪsˈkɜːrsɪv/; [adj](谈话内容)杂乱的,东拉西扯的,无层次的; [or]gre3k;
disdain: [a]/dɪsˈdeɪn/; [n]蔑视,鄙视; [vt]鄙视;不屑; [or]gre3k;
disenchant: [a]/ˌdɪsɪn'tʃænt/; [v]使觉悟,使摆脱幻想; [or]gre3k;
disengage: [a]/ˌdɪsɪnˈɡeɪdʒ/; [v]分开; [or]gre3k;
disgorge: [a]/dɪsˈɡɔːrdʒ/; [v]涌出,流出;吐出; [or]gre3k;
disguise: [a]/dɪsˈɡaɪz/; [v]伪装;掩饰; [n]伪装物;伪装; [or]gre3k;
dishearten: [a]/dɪsˈhɑːrtn/; [v]使灰心,使沮丧; [or]gre3k;
disinclination: [a]/ˌdɪsˌɪnklɪˈneɪʃn/; [n]不感兴趣,厌恶; [or]gre3k;
disinfect: [a]/ˌdɪsɪnˈfekt/; [v]消毒; [or]gre3k;
disinter: [a]/ˌdɪsɪnˈtɜːr/; [v]掘出;发掘;显露; [or]gre3k;
disinterested: [a]/dɪsˈɪntrəstɪd/; [adj]公正的;不感兴趣的;无私的;廉洁的; [or]gre3k;
disjointed: [a]/dɪsˈdʒɔɪntɪd/; [adj]杂乱的,无逻辑的,脱节的; [or]gre3k;
dismantle: [a]/dɪsˈmæntl/; [v]拆开;拆除; [or]gre3k;
dismay: [a]/dɪsˈmeɪ/; [n]失望;沮丧;惊愕; [v]使惊恐; [or]gre3k;
disparage: [a]/dɪˈspærɪdʒ/; [v]蔑视;贬损; [or]gre3k;
disparate: [a]/ˈdɪspərət/; [adj]迥然不同的; [or]gre3k;
dispassionate: [a]/dɪsˈpæʃənət/; [adj]平心静气的,不带感情的; [or]gre3k;
dispatch: [a]/dɪˈspætʃ/; [v]派遣,调遣;发送(信件,电报等);结束,摆脱掉;匆匆办完; [vt]处决; [n]派遣,调遣;发送;快信,急件;迅速,敏捷; [or]gre3k;
dispose: [a]/dɪˈspoʊz/; [v]处理,处置,除去;使愿意; [or]gre3k;
disprove: [a]/ˌdɪsˈpruːv/; [v]反驳,证明.是虚假的; [or]gre3k;
disregard: [a]/ˌdɪsrɪˈɡɑːrd/; [v]不理会;漠视; [n]忽视,漠视; [or]gre3k;
dissect: [a]/dɪˈsekt/; [v]解剖(动植物等);仔细研究;切开; [or]gre3k;
dissemble: [a]/dɪˈsembl/; [v]掩饰;假装;隐藏,掩饰; [or]gre3k;
disseminate: [a]/dɪˈsemɪneɪt/; [v]宣传,传播;散布; [or]gre3k;
dissension: [a]/dɪˈsenʃn/; [n]意见分歧;纷争;倾轧; [or]gre3k;
dissent: [a]/dɪˈsent/; [v]不同意;不信奉国教; [n]异议;(大写)不信奉国教; [or]gre3k;
dissipate: [a]/ˈdɪsɪpeɪt/; [v]消散,消失;浪费; [or]gre3k;
dissolute: [a]/ˈdɪsəluːt/; [adj]无节制的;放荡的; [or]gre3k;
dissolve: [a]/dɪˈzɑːlv/; [v]使溶解;废除,使解散; [or]gre3k;
dissonance: [a]/ˈdɪsənəns/; [n]不一致;不调和;不和谐音; [or]gre3k;
dissuade: [a]/dɪˈsweɪd/; [v]劝阻,阻止; [or]gre3k;
distal: [a]/ˈdɪstl/; [adj]<解剖>末梢的,末端的; [or]gre3k;
distend: [a]/dɪˈstend/; [v]膨胀;胀大;扩张; [or]gre3k;
distill: [a]/dɪˈstɪl/; [v]抽出..的精华;蒸馏; [or]gre3k;
distinctive: [a]/dɪˈstɪŋktɪv/; [adj]有特色的,与众不同的; [or]gre3k;
distort: [a]/dɪˈstɔːrt/; [v]扭曲,使变形;歪曲,曲解; [or]gre3k;
distortion: [a]/dɪˈstɔːrʃn/; [n]扭曲,变形;曲解;失真; [or]gre3k;
distract: [a]/dɪˈstrækt/; [v]使分心,转移(注意力),分散(思想); [or]gre3k;
distraught: [a]/dɪˈstrɔːt/; [adj]发狂的;心烦意乱的; [or]gre3k;
diurnal: [a]/daɪˈɜːrnl/; [adj]白天的;每日的;日间活动的; [or]gre3k;
diverge: [a]/daɪˈvɜːrdʒ/; [v]分歧,分开; [or]gre3k;
diversity: [a]/daɪˈvɜːrsəti/; [n]多样性,差异,分集; [or]gre3k;
divert: [a]/daɪˈvɜːrt/; [v]使转向,使改道(或绕道);转移,转移.的注意力;使娱乐,使消遣; [or]gre3k;
divestiture: [a]/də'vestətʃə/; [n]剥夺,脱衣,拆分; [or]gre3k;
divulge: [a]/daɪˈvʌldʒ/; [v]泄露,透露; [or]gre3k;
doctrinaire: [a]/ˌdɑːktrəˈner/; [adj]教条主义的,空谈理论的; [n]空论家,纯理论家; [or]gre3k;
dodder: [a]/ˈdɑdər/; [v]蹒跚,颤巍巍地行进; [n]<植>菟丝子; [or]gre3k;
dodge: [a]/dɑːdʒ/; [n]托词;躲闪,躲避; [v]回避,规避;躲避,避开; [or]gre3k;
doff: [a]/dɑːf/; [v]脱掉(外衣,帽子); [or]gre3k;
dogged: [a]/ˈdɔːɡɪd/; [adj]顽强的;顽固的; [vt]跟踪;尾随; [or]gre3k;
dogma: [a]/ˈdɔːɡmə/; [n]教条;武断的意见; [adj]教义的,教条的,信条的; [or]gre3k;
doldrums: [a]/ˈdoʊldrəmz/; [n](海洋上的)无风带,情绪低沉; [or]gre3k;
dolorous: [a]/ˈdoʊlərəs/; [adj]忧伤的,悲痛的; [or]gre3k;
dolt: [a]/doʊlt/; [n]笨蛋,傻瓜; [or]gre3k;
domicile: [a]/ˈdɑːmɪsaɪl/; [n]住宅;永久居住地;期票支付场所; [v]居住;使在指定的场所支付(期票等; [adj]定居;在固定住所生活; [or]gre3k;
dominant: [a]/ˈdɑːmɪnənt/; [adj]主要的,占优势的,支配的,统治的;显性基因的; [or]gre3k;
don: [a]/dɑːn/; [n]指导教师,大学教师;先生,阁下; [vt]穿上; [or]gre3k;
donor: [a]/ˈdoʊnər/; [n]捐献者; [or]gre3k;
doodle: [a]/ˈduːdl/; [v](无目的地)乱画,漫无目的地打发时光; [n]涂鸦; [or]gre3k;
dormant: [a]/ˈdɔːrmənt/; [adj]睡眠的,休眠的;静止的,隐伏的; [or]gre3k;
dour: [a]/dʊr/; [adj]严厉的,顽强的,阴沉的,不爱讲话的; [or]gre3k;
douse: [a]/daʊs/; [v]把.浸入水中,用水泼; [or]gre3k;
downpour: [a]/ˈdaʊnpɔːr/; [n]倾盆大雨; [or]gre3k;
doze: [a]/doʊz/; [vi]瞌睡,假寐; [n]瞌睡; [or]gre3k;
drab: [a]/dræb/; [adj]枯黄色的,无聊的,单调的; [n]单调;淡褐色;[印,纺]淡褐色厚呢;邋遢女人; [or]gre3k;
draconian: [a]/drəˈkoʊniən/; [adj]严峻的,苛刻的; [or]gre3k;
dramatic: [a]/drəˈmætɪk/; [adj]戏剧的,戏剧性的;引人注目的;逼真的,刺激的; [or]gre3k;
dread: [a]/dred/; [v]惧怕,害怕; [n]畏惧,恐惧; [adj]恐怖的,使人敬畏的; [or]gre3k;
dreary: [a]/ˈdrɪri/; [adj]沉闷的;乏味的;凄凉的; [or]gre3k;
drench: [a]/drentʃ/; [v]使淋透;使湿透; [n]淋透;雨淋;浸渍液;(制革时浸泡熟皮的)脱灰水; [or]gre3k;
drivel: [a]/ˈdrɪvl/; [n]胡言乱语; [v]胡言乱语,说傻话; [or]gre3k;
drizzle: [a]/ˈdrɪzl/; [v]下毛毛雨; [n]细雨,毛毛雨; [or]gre3k;
droll: [a]/droʊl/; [adj]滑稽的;好笑的;逗趣的; [n]逗人发笑的人;滑稽演员;小丑; [v]开玩笑; [adv]古里古怪地,滑稽地; [or]gre3k;
drone: [a]/droʊn/; [n]无人机,无人驾驶飞机;雄蜂;单调的低音; [v]嗡嗡地响; [vi]混日子; [or]gre3k;
drudgery: [a]/ˈdrʌdʒəri/; [n]苦工;苦差事;单调乏味的工作; [or]gre3k;
dubious: [a]/ˈduːbiəs/; [adj]可疑的;怀疑的;无把握的; [or]gre3k;
ductile: [a]/ˈdʌktaɪl/; [adj](某些金属)有延展性的;可塑的;易受影响的; [or]gre3k;
dulcet: [a]/ˈdʌlsɪt/; [adj]美妙的;悦耳的;怡人的; [or]gre3k;
dupe: [a]/duːp/; [n]受骗的人,上当者; [v]欺骗,愚弄; [or]gre3k;
duplicate: [a]/ˈduːplɪkeɪt/; [n]复制品; [v]复制;重复; [adj]完全一样的; [or]gre3k;
duplicity: [a]/duːˈplɪsəti/; [n]口是心非;表里不一;不诚实; [or]gre3k;
dwindle: [a]/ˈdwɪndl/; [v]日渐减少,变小,缩小; [or]gre3k;
dynamic: [a]/daɪˈnæmɪk/; [adj]有活力的,有生气的;不断变化的;动态的; [n]活力,动力; [or]gre3k;
dyspeptic: [a]/dɪsˈpeptɪk/; [n]消化不良者; [adj]消化不良的;患胃病的; [or]gre3k;
earnest: [a]/ˈɜːrnɪst/; [adj]真诚的,诚挚的,认真的; [n]认真,严肃; [or]gre3k;
earshot: [a]/ˈɪrʃɑːt/; [n]听力所及的范围; [or]gre3k;
earsplitting: [a]/'ɪəˌsplɪtɪŋ/; [adj]震耳欲聋的; [or]gre3k;
eavesdrop: [a]/ˈiːvzdrɑːp/; [v]偷听,窃听; [n]屋檐水; [or]gre3k;
ebullient: [a]/ɪˈbʌliənt/; [adj]热情洋溢的,沸腾的; [or]gre3k;
eclat: [a]/eɪ'klaː/; [n]辉煌成就,喝采; [or]gre3k;
eclectic: [a]/ɪˈklektɪk/; [adj]折衷主义的;选择的; [n]折衷主义者,折衷派的人; [or]gre3k;
eclipse: [a]/ɪˈklɪps/; [n](日,月)食;黯然失色; [v]掩盖..的重要性;使暗淡; [or]gre3k;
ecstasy: [a]/ˈekstəsi/; [n]狂喜,心醉神怡; [or]gre3k;
edible: [a]/ˈedəbl/; [adj]可食的; [or]gre3k;
edifice: [a]/ˈedɪfɪs/; [n]宏伟的建筑物;大厦;(知识的)体系,结构; [or]gre3k;
efface: [a]/ɪˈfeɪs/; [v]擦掉,抹去;消去; [or]gre3k;
effervesce: [a]/ˌefə'ves/; [v]冒泡,热情洋溢; [or]gre3k;
effete: [a]/ɪˈfiːt/; [adj]软弱的;娘娘腔的;颓废的; [or]gre3k;
effluvium: [a]/e'fluːvɪəm/; [n]难闻的气味,没用的副产品,废品; [or]gre3k;
effrontery: [a]/ɪˈfrʌntəri/; [n]厚颜无耻; [or]gre3k;
effulgent: [a]/ɪˈfʌldʒənt/; [adj]光辉的,灿烂的; [or]gre3k;
effusive: [a]/ɪˈfjuːsɪv/; [adj]流出的;感情奔放的; [or]gre3k;
egoistic: [a]/ˌeɡoʊˈɪstɪk/; [adj]自私自利的,自我中心的; [n]自我主义者; [or]gre3k;
elaborate: [a]/ɪˈlæbəreɪt/; [adj]精心设计的,精巧的;复杂的; [v]详细说明,详尽阐述; [vt]变得复杂; [or]gre3k;
elastic: [a]/ɪˈlæstɪk/; [adj]有弹性的;可伸缩的,(系统或计划)灵活的;弹力材料制成的; [n]松紧带,橡皮圈; [or]gre3k;
eleemosynary: [a]/ˌelə'mɒsənˌerɪ/; [adj]施舍的,慈善的,接受接济的; [or]gre3k;
elegy: [a]/ˈelədʒi/; [n]挽歌,哀歌; [or]gre3k;
elephantine: [a]/ˌelɪˈfæntiːn/; [adj]笨拙的;巨大的; [or]gre3k;
elevate: [a]/ˈelɪveɪt/; [v]上升;提高;举起;提拔; [or]gre3k;
elicit: [a]/iˈlɪsɪt/; [v]引出;诱出;探出; [or]gre3k;
elliptical: [a]/ɪˈlɪptɪkl/; [adj]椭圆的;省略的; [or]gre3k;
elucidate: [a]/iˈluːsɪdeɪt/; [v]阐明,说明; [or]gre3k;
elude: [a]/iˈluːd/; [v]逃避,躲避;使.错过,使.找不到;使.不记得;把.难住; [or]gre3k;
emaciate: [a]/ɪ'meɪʃɪˌeɪt/; [v]使消瘦,使衰弱,使贫瘠; [or]gre3k;
emancipate: [a]/ɪˈmænsɪpeɪt/; [v]解放;释放; [or]gre3k;
embargo: [a]/ɪmˈbɑːrɡoʊ/; [v]禁止出入港口;禁止或限制贸易;征用或扣押; [n]禁令;禁止;封港令; [or]gre3k;
embark: [a]/ɪmˈbɑːrk/; [v]上船或飞机;开始,着手,从事; [or]gre3k;
embarrass: [a]/ɪmˈbærəs/; [vt]使窘迫,使尴尬(尤指在社交场合);困窘,困扰; [or]gre3k;
embed: [a]/ɪmˈbed/; [v]把.嵌入;使嵌入; [or]gre3k;
embezzle: [a]/ɪmˈbezl/; [v]盗用,挪用,贪污; [or]gre3k;
embolden: [a]/ɪmˈboʊldən/; [vt]鼓励,使勇敢,使有胆量; [or]gre3k;
emboss: [a]/ɪmˈbɔːs/; [v]加浮雕花纹于;使凸出;装饰; [or]gre3k;
embrace: [a]/ɪmˈbreɪs/; [v]拥抱;包含;欣然接受,乐意采纳; [n]拥抱;接受;领会; [or]gre3k;
embroider: [a]/ɪmˈbrɔɪdər/; [v]刺绣,绣花;润色,渲染; [or]gre3k;
emigrate: [a]/ˈemɪɡreɪt/; [v]移居国外(或外地); [or]gre3k;
eminent: [a]/ˈemɪnənt/; [adj]显赫的;杰出的;有名的;(品质)优良的; [or]gre3k;
emollient: [a]/iˈmɑːliənt/; [n]润肤剂; [or]gre3k;
emulate: [a]/ˈemjuleɪt/; [v]努力赶上(超过),仿效; [n]仿真; [or]gre3k;
enact: [a]/ɪˈnækt/; [v]颁布;制定法律;扮演; [or]gre3k;
enamel: [a]/ɪˈnæml/; [n]搪瓷;珐琅;瓷釉;指甲油; [v]彩饰;涂以瓷釉; [or]gre3k;
enamored: [a]/ɪˈnæmə(r)d/; [adj]迷恋的;倾心的; [or]gre3k;
encomium: [a]/enˈkoʊmiəm/; [n]赞美; [or]gre3k;
encompass: [a]/ɪnˈkʌmpəs/; [vt]环绕,包围;包含;完成; [or]gre3k;
encumber: [a]/ɪnˈkʌmbər/; [v]阻塞,妨害,拖累; [or]gre3k;
endeavor: [a]/ɪnˈdevər/; [n]尝试,努力,尽力; [v]努力,尽力; [or]gre3k;
endemic: [a]/enˈdemɪk/; [adj]地方性的; [n]地方病; [or]gre3k;
endorse: [a]/ɪnˈdɔːrs/; [v]赞同,认可;签注(文件); [or]gre3k;
enervate: [a]/ˈenərveɪt/; [v]使虚弱;使无力; [or]gre3k;
enfranchise: [a]/ɪnˈfræntʃaɪz/; [v]给予选举权,释放(奴隶); [or]gre3k;
engender: [a]/ɪnˈdʒendər/; [v]产生; [or]gre3k;
engross: [a]/ɪnˈɡroʊs/; [v]独占;正式誊写;使全神贯注于;用大字体书写; [or]gre3k;
enigma: [a]/ɪˈnɪɡmə/; [n]谜,哑谜;闷葫芦; [or]gre3k;
enlighten: [a]/ɪnˈlaɪtn/; [v]启发,开导; [or]gre3k;
enmity: [a]/ˈenməti/; [n]敌意,憎恨; [or]gre3k;
entangle: [a]/ɪnˈtæŋɡl/; [v]使纠缠,卷入; [or]gre3k;
enthrall: [a]/ɪnˈθrɔl/; [v]迷惑,迷住; [or]gre3k;
enthusiasm: [a]/ɪnˈθuːziæzəm/; [n]热情,热心,热忱;热衷的活动,热爱的事物; [or]gre3k;
entice: [a]/ɪnˈtaɪs/; [v]怂恿,引诱; [or]gre3k;
entrance: [a]/ˈentrəns/; [n]入口,通道,大门口;出场,登场;进入权; [v]使出神,使入迷; [or]gre3k;
entrap: [a]/ɪnˈtræp/; [v]诱骗; [or]gre3k;
entreat: [a]/ɪnˈtriːt/; [v]恳求,请求; [or]gre3k;
enunciate: [a]/əˈnʌnsieɪt/; [v]发音,阐明,宣布; [or]gre3k;
ephemeral: [a]/ɪˈfemərəl/; [adj]短暂的,短命的; [n]生存极短时间的事物; [or]gre3k;
epic: [a]/ˈepɪk/; [adj]史诗的,叙事诗的;壮丽的,宏大的; [n]史诗;叙事诗;史诗般的作品; [or]gre3k;
epicure: [a]/ˈepɪkjʊr/; [n]美食家;享乐主义者; [or]gre3k;
epigram: [a]/ˈepɪɡræm/; [n]机智的言语; [or]gre3k;
epilogue: [a]/ˈepɪlɔːɡ/; [n]收场白;尾声; [or]gre3k;
epithet: [a]/ˈepɪθet/; [n]外号,绰号; [or]gre3k;
epitomize: [a]/ɪˈpɪtəmaɪz/; [v]摘要;化身;成为.的缩影; [or]gre3k;
equable: [a]/ˈekwəbl/; [adj]温和,平均,稳定的,不变的,(脾气)温和的; [or]gre3k;
equilibrium: [a]/ˌiːkwɪˈlɪbriəm/; [n](心态情感等)平静;平衡; [or]gre3k;
equity: [a]/ˈekwəti/; [n]公平,公正;衡平法;普通股;抵押资产的净值; [or]gre3k;
equivalent: [a]/ɪˈkwɪvələnt/; [adj]相等的;等值的; [n]同义词;等价物; [or]gre3k;
equivocate: [a]/ɪˈkwɪvəkeɪt/; [v]模棱两可地说,支吾其词; [or]gre3k;
erode: [a]/ɪˈroʊd/; [v]腐蚀;遭侵蚀,腐蚀,侵蚀;削弱; [vt]损害; [or]gre3k;
errant: [a]/ˈerənt/; [adj]错误的,脱离正途的,迷路的;周游的,漂泊的;无定的; [n]游侠; [or]gre3k;
erratic: [a]/ɪˈrætɪk/; [adj]古怪的;反复无常的,不稳定的; [or]gre3k;
erroneous: [a]/ɪˈroʊniəs/; [adj]错误的; [or]gre3k;
erudite: [a]/ˈerudaɪt/; [adj]博学的,有学问的; [n]饱学之士,有学问的人; [or]gre3k;
escalate: [a]/ˈeskəleɪt/; [v]逐步升高,逐步增强,加剧恶化; [or]gre3k;
eschew: [a]/ɪsˈtʃuː/; [v]避开;戒绝; [or]gre3k;
escort: [a]/ˈeskɔːrt/; [n]护送者; [v]护送; [or]gre3k;
esoteric: [a]/ˌesəˈterɪk/; [adj]秘传的,神秘的,限于少数人的; [n]受秘传的人; [or]gre3k;
espouse: [a]/ɪˈspaʊz/; [v]支持,拥护; [or]gre3k;
esteem: [a]/ɪˈstiːm/; [n]尊敬;尊重; [vt]尊敬;认为;考虑;估计; [or]gre3k;
estimable: [a]/ˈestɪməbl/; [adj]可估计的;可尊敬的;有价值的; [or]gre3k;
estrange: [a]/ɪ'streɪndʒ/; [v]使疏远,离间; [or]gre3k;
etch: [a]/etʃ/; [n]蚀刻; [vi]蚀刻; [vt]蚀镂,蚀刻,描述,铭记; [or]gre3k;
eternal: [a]/ɪˈtɜːrnl/; [adj]永恒的,永不改变的; [or]gre3k;
ethereal: [a]/iˈθɪriəl/; [adj]太空的,轻巧的,像空气的; [or]gre3k;
ethics: [a]/'eθɪks/; [n]行为准则;道德规范; [or]gre3k;
ethos: [a]/ˈiːθɑːs/; [n]民族精神,气质,社会思潮; [or]gre3k;
euphemism: [a]/ˈjuːfəmɪzəm/; [n]婉言,委婉的说法; [or]gre3k;
euphonious: [a]/juːˈfoʊniəs/; [adj]悦耳的;好听的;声音和谐的; [or]gre3k;
euphoria: [a]/juːˈfɔːriə/; [n]幸福愉快感; [or]gre3k;
evacuate: [a]/ɪˈvækjueɪt/; [v]撤离,疏散,排清; [or]gre3k;
evanescent: [a]/ˌevəˈnesnt/; [adj]短暂的,容易消散的,(印象等)逐渐消失的,会凋零的; [or]gre3k;
evasive: [a]/ɪˈveɪsɪv/; [adj]逃避的;托辞的,推托的; [or]gre3k;
everlasting: [a]/ˌevərˈlæstɪŋ/; [adj]永恒的,持久的;无止境的;耐用的; [or]gre3k;
evict: [a]/ɪˈvɪkt/; [v]驱逐,逐出; [or]gre3k;
evince: [a]/ɪˈvɪns/; [v]表明,表示,引起; [or]gre3k;
evoke: [a]/ɪˈvoʊk/; [v]唤起;引起;使人想起; [or]gre3k;
exacerbate: [a]/ɪɡˈzæsərbeɪt/; [v]加重;恶化;激怒; [or]gre3k;
exacting: [a]/ɪɡˈzæktɪŋ/; [adj]苛求的,要求严格的,强索的; [or]gre3k;
exalt: [a]/ɪɡˈzɔːlt/; [v]提升,提拔,赞扬,使得意; [or]gre3k;
exasperate: [a]/ɪɡˈzæspəreɪt/; [vt]激怒;加剧; [or]gre3k;
excavate: [a]/ˈekskəveɪt/; [v]挖掘,挖出;挖(空),挖(洞); [or]gre3k;
exceptional: [a]/ɪkˈsepʃənl/; [adj]优越的,杰出的;异常的; [or]gre3k;
excoriate: [a]/ˌeksˈkɔːrieɪt/; [v]严厉批评,擦伤(皮肤等); [or]gre3k;
excrete: [a]/ɪkˈskriːt/; [v]排泄,分泌; [or]gre3k;
exculpate: [a]/ˈekskʌlpeɪt/; [v]声明无罪,开脱,使无罪; [or]gre3k;
execrate: [a]/'eksɪˌkreɪt/; [v]谴责,痛恨; [or]gre3k;
exemplary: [a]/ɪɡˈzempləri/; [adj]模范的,可仿效的; [or]gre3k;
exhaust: [a]/ɪɡˈzɔːst/; [v]使筋疲力尽;耗尽;详尽论述; [n]排气装置;废气; [or]gre3k;
exhilarate: [a]/ɪɡˈzɪləreɪt/; [v]使高兴;使兴奋; [adj]使人高兴的,令人兴奋的; [or]gre3k;
exhort: [a]/ɪɡˈzɔːrt/; [vt]敦促,劝告; [vi]规劝,劝告; [or]gre3k;
exigent: [a]/'eksədʒənt/; [adj]迫切的;紧急的;苛求的; [or]gre3k;
exodus: [a]/ˈeksədəs/; [n]大批离去,成群外出; [or]gre3k;
exonerate: [a]/ɪɡˈzɑːnəreɪt/; [v]使免罪; [or]gre3k;
exorbitant: [a]/ɪɡˈzɔːrbɪtənt/; [adj]要价过高的,过分的; [or]gre3k;
exorcise: [a]/ˈeksɔːrsaɪz/; [v]驱邪;除怪; [or]gre3k;
exotic: [a]/ɪɡˈzɑːtɪk/; [adj]奇异的,珍奇的,来自异国的; [or]gre3k;
expansive: [a]/ɪkˈspænsɪv/; [adj]广阔的,扩张的,豪爽的; [or]gre3k;
expedite: [a]/ˈekspədaɪt/; [v]加快;促进;发出; [adj]畅通的;迅速的;方便的; [or]gre3k;
expedition: [a]/ˌekspəˈdɪʃn/; [n]远征队;探险;短途旅行;迅速; [or]gre3k;
expiate: [a]/ˈekspieɪt/; [v]赎罪,补偿; [or]gre3k;
expire: [a]/ɪkˈspaɪər/; [v]期满,(期限)终止;断气,死亡; [or]gre3k;
explicate: [a]/ˈeksplɪkeɪt/; [v]详细解说; [or]gre3k;
explicit: [a]/ɪkˈsplɪsɪt/; [adj]充分表达清楚的,明确的;直率的,直截了当的;〔描绘性或暴力的语言或画面〕清晰露骨的; [or]gre3k;
exploit: [a]/ɪkˈsplɔɪt/; [v]剥削,利用;开发,开拓; [n]辉煌功绩; [or]gre3k;
exponent: [a]/ɪkˈspoʊnənt/; [n]<数>指数;典型;说明者,说明物; [adj]说明的; [or]gre3k;
expurgate: [a]/ˈekspərɡeɪt/; [v]净化,删去; [or]gre3k;
exquisite: [a]/ɪkˈskwɪzɪt/; [adj]精致的,精选的;细腻的;强烈的; [n]过分讲究穿戴的人; [or]gre3k;
extant: [a]/ekˈstænt/; [adj]现存的;显著的; [or]gre3k;
extemporize: [a]/ɪkˈstempəraɪz/; [v]即席演说; [or]gre3k;
extenuate: [a]/ɪk'stenjʊˌeɪt/; [v]减轻,低估,为.找借口,使人原谅; [or]gre3k;
exterminate: [a]/ɪkˈstɜːrmɪneɪt/; [v]消灭,灭绝;根除; [or]gre3k;
extinct: [a]/ɪkˈstɪŋkt/; [adj]灭绝的;破灭了的,消亡了的; [or]gre3k;
extinguish: [a]/ɪkˈstɪŋɡwɪʃ/; [v]熄灭,扑灭;根除,消灭; [or]gre3k;
extol: [a]/ɪkˈstoʊl/; [v]赞美,称赞,颂扬; [or]gre3k;
extort: [a]/ɪkˈstɔːrt/; [vt]敲诈,勒索; [or]gre3k;
extract: [a]/ɪkˈstrækt/; [v]取出;提取;摘录;设法得到;索取; [n]摘录;提出物; [or]gre3k;
extraction: [a]/ɪkˈstrækʃn/; [n]抽出,取出;家世,出身;抽出物; [or]gre3k;
extrapolate: [a]/ɪkˈstræpəleɪt/; [v]进行推断; [or]gre3k;
extravagant: [a]/ɪkˈstrævəɡənt/; [adj]奢侈的,无节制的; [or]gre3k;
extricate: [a]/ˈekstrɪkeɪt/; [v]拯救,救出; [n]解脱;解脱者; [or]gre3k;
exuberant: [a]/ɪɡˈzuːbərənt/; [adj](植物)茂盛的,(人)充满活力的; [or]gre3k;
exude: [a]/ɪɡˈzuːd/; [v]慢慢流出,四溢,渗出,散发; [or]gre3k;
exult: [a]/ɪɡˈzʌlt/; [v]狂喜,欢欣鼓舞; [or]gre3k;
fable: [a]/ˈfeɪbl/; [n]寓言,童话;无稽之谈; [v]虚构,杜撰;煞有介事地讲; [or]gre3k;
fabricate: [a]/ˈfæbrɪkeɪt/; [v]建造,制造,伪造(文件等),捏造,编造(谎言,借口等); [or]gre3k;
fabulous: [a]/ˈfæbjələs/; [adj]极好的;极妙的;极为巨大的;寓言中的;传说中的; [or]gre3k;
facetious: [a]/fəˈsiːʃəs/; [adj]滑稽的,诙谐的,开玩笑的; [or]gre3k;
facilitate: [a]/fəˈsɪlɪteɪt/; [v]为他人提供方便;使便利; [vt]促进; [or]gre3k;
faction: [a]/ˈfækʃn/; [n]派别,小集团,小派系;派系斗争,内讧; [or]gre3k;
fad: [a]/fæd/; [n]风尚,风行一时的东西; [adj]极好的; [or]gre3k;
fail-safe: [a]/ˈfeɪl seɪf/; [n]保险措施; [adj]万无一失的; [or]gre3k;
fallacious: [a]/fəˈleɪʃəs/; [adj]谬误的,易误解的,虚妄的; [or]gre3k;
fallible: [a]/ˈfæləbl/; [adj]会犯错的,易犯错的; [or]gre3k;
fallow: [a]/ˈfæloʊ/; [adj]休耕的;不活跃的;休闲地,休闲的; [n]休耕地;休耕; [v]使(翻耕后的土地)休闲; [or]gre3k;
falsehood: [a]/ˈfɔːlshʊd/; [n]谬误,不真实,谎言,虚假; [or]gre3k;
falter: [a]/ˈfɔːltər/; [v]蹒跚,摇摆;踌躇;畏缩; [n]踌躇;支吾;颤抖; [or]gre3k;
fanatic: [a]/fəˈnætɪk/; [n]狂热者,盲信者; [adj]狂热的,入迷的,盲信的; [or]gre3k;
fanciful: [a]/ˈfænsɪfl/; [adj]异想天开的;别出心裁的; [or]gre3k;
fantasy: [a]/ˈfæntəsi/; [n]幻想,想象;幻想作品; [vi]奏幻想曲; [vt]想像;幻想; [adj]虚幻的; [or]gre3k;
farce: [a]/fɑːrs/; [n]闹剧;胡闹;笑剧; [or]gre3k;
fascinate: [a]/ˈfæsɪneɪt/; [v]使着迷;使神魂颠倒;吸引注意; [or]gre3k;
fastidious: [a]/fæˈstɪdiəs/; [adj]难讨好的,爱挑剔的; [or]gre3k;
fateful: [a]/ˈfeɪtfl/; [adj]重大的;决定性的;宿命的; [or]gre3k;
fathom: [a]/ˈfæðəm/; [n]英寻(=6英尺); [vi]测量深度; [vt]彻底了解,测深; [or]gre3k;
fatigue: [a]/fəˈtiːɡ/; [n]疲乏,劳累; [or]gre3k;
fatuous: [a]/ˈfætʃuəs/; [adj]愚昧而不自知的; [or]gre3k;
faultfinder: [a]/fɔːlt'faɪndə/; [n]吹毛求疵的人; [or]gre3k;
favorable: [a]/ˈfeɪvərəbl/; [adj]赞同的,称赞的;有利的,顺利的; [or]gre3k;
favoritism: [a]/'feɪvərɪtˌɪzəm/; [n]偏爱,偏袒; [or]gre3k;
fawn: [a]/fɔːn/; [v]奉承;生(小鹿或小动物); [n]小鹿;浅黄褐色; [or]gre3k;
faze: [a]/feɪz/; [v]打扰,折磨,使狼狈,使担忧; [or]gre3k;
featureless: [a]/ˈfiːtʃərləs/; [adj]缺乏特征的,没有标记的; [or]gre3k;
feckless: [a]/ˈfekləs/; [adj]不负责任的,无目标无计划的,无效的; [adv]没有价值地;没有长远目标地;不负责任地; [n]没有价值,没有长远目标,不负责任; [or]gre3k;
fecund: [a]/ˈfiːkənd/; [adj]肥沃的;多产的;丰饶的;生殖力旺盛的; [or]gre3k;
feeble: [a]/ˈfiːbl/; [adj]虚弱的; [or]gre3k;
feign: [a]/feɪn/; [v]假装,装作; [or]gre3k;
feisty: [a]/ˈfaɪsti/; [adj]好斗的,好争论的;活跃的,充满生气的;烦躁不安的,坐立不安的; [or]gre3k;
felony: [a]/ˈfeləni/; [n]重罪; [or]gre3k;
fender: [a]/ˈfendər/; [n]火炉围栏;挡泥板,防护板;(汽车的)保险杠; [or]gre3k;
feral: [a]/ˈferəl/; [adj]未驯服的,野生的;凶猛的; [or]gre3k;
ferocious: [a]/fəˈroʊʃəs/; [adj]凶猛的;强烈的,严重的; [or]gre3k;
fertilize: [a]/ˈfɜːrtəlaɪz/; [v]施肥,使肥沃,使多产;使受精; [or]gre3k;
fervent: [a]/ˈfɜːrvənt/; [adj]热烈的,满怀热情的;狂热的; [or]gre3k;
fervid: [a]/ˈfɜːrvɪd/; [adj]热的;热心的; [or]gre3k;
fervor: [a]/ˈfɜrvər/; [n]强烈感情,激情,热情; [or]gre3k;
fester: [a]/ˈfestər/; [v]溃烂;化脓;使..痛苦;使..恶化; [n]溃烂;脓疮,脓疱; [or]gre3k;
fetid: [a]/ˈfetɪd/; [adj]有恶臭的; [or]gre3k;
fetter: [a]/ˈfetər/; [n]脚镣;束缚; [vt]给.上脚镣;束缚; [or]gre3k;
fiasco: [a]/fiˈæskoʊ/; [n]大失败,惨败; [or]gre3k;
fickle: [a]/ˈfɪkl/; [adj](在感情等方面)反复无常的,轻浮的,善变的; [or]gre3k;
fictitious: [a]/fɪkˈtɪʃəs/; [adj]虚构的; [or]gre3k;
fidelity: [a]/fɪˈdeləti/; [n]忠诚;逼真度,保真度; [or]gre3k;
figment: [a]/ˈfɪɡmənt/; [n]空想;虚构的理论,故事等; [or]gre3k;
figurative: [a]/ˈfɪɡərətɪv/; [adj]比喻的,修饰丰富的,形容多的; [or]gre3k;
figurine: [a]/ˌfɪɡjəˈriːn/; [n]小塑像,小雕像; [or]gre3k;
filibuster: [a]/ˈfɪlɪbʌstər/; [n]冗长演说; [v]拖延议事; [or]gre3k;
filter: [a]/ˈfɪltər/; [n]过滤器,滤纸; [v]过滤,渗透; [or]gre3k;
finesse: [a]/fɪˈnes/; [n]技巧,计谋,策略; [v]以技巧取胜; [or]gre3k;
finicky: [a]/ˈfɪnɪki/; [adj]苛求的,过份讲究的; [or]gre3k;
fitful: [a]/ˈfɪtfl/; [adj]发作的,间歇的,不定的; [or]gre3k;
flaccid: [a]/ˈflæsɪd/; [adj]软弱的,无活力的,没气力的,松弛的; [or]gre3k;
flamboyant: [a]/flæmˈbɔɪənt/; [adj]辉耀的;华丽的,艳丽的;火焰似的; [or]gre3k;
flatter: [a]/ˈflætər/; [v]阿谀,使高兴;(肖像等)胜过(真人真物);自鸣得意,自以为是; [or]gre3k;
flaw: [a]/flɔː/; [n]瑕疵;缺点; [v]使有缺陷;使不完美;有瑕疵; [or]gre3k;
fledgling: [a]/ˈfledʒlɪŋ/; [n]刚学飞的幼鸟,无经验的人; [adj]刚开始的;无经验的; [or]gre3k;
fleet: [a]/fliːt/; [n]舰队,船队;车队; [adj]迅速的; [or]gre3k;
fleeting: [a]/ˈfliːtɪŋ/; [adj]短暂的,飞逝的; [or]gre3k;
flexible: [a]/ˈfleksəbl/; [adj]易曲的,柔软的,灵活的; [or]gre3k;
flinch: [a]/flɪntʃ/; [v]畏缩,退缩; [n]退缩,畏惧; [or]gre3k;
flippancy: [a]/ˈflɪpənsi/; [n]轻率;无礼; [or]gre3k;
flirt: [a]/flɜːrt/; [n]急扔;调情者; [vi]卖弄风情,调情;戏弄,不认真地对待;摆动; [vt]急速摆动,挥动; [or]gre3k;
flit: [a]/flɪt/; [n]轻快的飞行;迁移; [vi]掠过;轻快地飞过;偷偷溜走;去世; [or]gre3k;
flock: [a]/flɑːk/; [n](鸟兽)群;一群人;(对牧师而言的)教徒; [v]聚集,成群而行; [or]gre3k;
florid: [a]/ˈflɔːrɪd/; [adj]涨红的,华丽的,红润的; [or]gre3k;
flounder: [a]/ˈflaʊndər/; [n]比目鱼;踉跄前进; [v]踉跄前行;(在水或泥浆中)挣扎,陷入困境; [or]gre3k;
flourish: [a]/ˈflɜːrɪʃ/; [vi]繁荣,茂盛,兴旺; [vt]挥舞;夸耀; [n]兴旺;茂盛;炫耀;挥舞; [or]gre3k;
flout: [a]/flaʊt/; [n]表示轻蔑的言行;嘲弄;嘲笑; [vi]藐视;嘲弄;嘲笑; [vt]嘲弄;嘲笑;藐视; [or]gre3k;
fluctuate: [a]/ˈflʌktʃueɪt/; [v]波动;起伏;涨落; [or]gre3k;
fluent: [a]/ˈfluːənt/; [adj]流畅的,(说话)流利的;顺畅的,流畅熟练的; [or]gre3k;
fluky: [a]/ˈfluːki/; [adj]侥幸的,偶然的; [or]gre3k;
flush: [a]/flʌʃ/; [v]脸红;清除;赶出;冲掉; [n]发红;冲掉;脸红; [adj]挥霍的,浪费的;富有的;完全齐平的; [or]gre3k;
fluster: [a]/ˈflʌstər/; [n]慌乱,狼狈,混乱; [v]使困惑,慌乱; [or]gre3k;
foible: [a]/ˈfɔɪbl/; [n]弱点,小缺点,癖好; [or]gre3k;
foil: [a]/fɔɪl/; [n]箔;锡箔纸;衬托; [v]挫败;使受挫折; [or]gre3k;
foment: [a]/foʊˈment/; [v]煽动,助长(坏事); [or]gre3k;
foolproof: [a]/ˈfuːlpruːf/; [adj]万无一失的,简单的,肯定成功的; [or]gre3k;
footloose: [a]/ˈfʊtluːs/; [adj]自由自在的,无拘束的,到处走动的; [or]gre3k;
forage: [a]/ˈfɔːrɪdʒ/; [v]搜寻,翻寻,觅食; [n](牛马的)饲料,粮草; [or]gre3k;
forbearance: [a]/fɔːrˈberəns/; [n]自制,忍耐;宽容; [or]gre3k;
forebear: [a]/ˈfɔːrber/; [n]祖先,祖宗; [v]忍住; [or]gre3k;
forebode: [a]/foʊr'boʊd/; [v]预示,预兆,预言; [or]gre3k;
foreground: [a]/ˈfɔːrɡraʊnd/; [n]前景,最显著的位置; [v]强调; [or]gre3k;
forestall: [a]/fɔːrˈstɔːl/; [v]领先;占先一步;先发制人,阻止,妨碍;垄断;占先一步; [or]gre3k;
foreword: [a]/ˈfɔːrwɜːrd/; [n]序,前言; [or]gre3k;
forge: [a]/fɔːrdʒ/; [n]熔炉;锻工车间;铁匠店; [v]锻造;经锻炼而形成;伪造;推进,加强; [or]gre3k;
formidable: [a]/ˈfɔːrmɪdəbl/; [adj]令人畏惧的;可怕的;难以克服的;难应付的; [or]gre3k;
forsake: [a]/fərˈseɪk/; [v]放弃;抛弃,离开; [or]gre3k;
forthright: [a]/ˈfɔːrθraɪt/; [adj]直接的,直率的,坦白的,豪爽的; [adv]马上,立即; [n]直路; [or]gre3k;
fortify: [a]/ˈfɔːrtɪfaɪ/; [v]设防于;增强; [or]gre3k;
foster: [a]/ˈfɔːstər/; [adj]收养的; [vt]养育;培养,促进; [or]gre3k;
founder: [a]/ˈfaʊndər/; [n]奠基者;创始人; [v](船)沉没,浸水而沉没;(计划等)失败,受挫折; [or]gre3k;
fracas: [a]/ˈfreɪkəs/; [n]喧嚷,吵闹,争论,论战; [or]gre3k;
fracture: [a]/ˈfræktʃər/; [n]骨折;折断;裂口; [v]使折断;使骨折; [or]gre3k;
fragile: [a]/ˈfrædʒl/; [adj]易碎的;易损坏的;虚弱的;脆弱的; [or]gre3k;
frail: [a]/freɪl/; [adj]脆弱的,不坚实的; [n]少妇;灯心草篓;灯心草篓的容量; [or]gre3k;
fraudulent: [a]/ˈfrɔːdʒələnt/; [adj]欺诈的,欺骗性的,骗得的; [or]gre3k;
fraught: [a]/frɔːt/; [adj]担心的,忧虑的;充满.的; [n]货物,装载物; [vt]装货于; [or]gre3k;
frenzy: [a]/ˈfrenzi/; [n]狂暴;狂怒,暴怒;疯狂,迷乱; [v]使发狂,使狂怒; [or]gre3k;
frequent: [a]/ˈfriːkwənt/; [adj]时常的,频繁的; [v]常去,常到; [or]gre3k;
fretful: [a]/ˈfretfl/; [adj]烦躁的,焦躁的,(水面)起波纹的; [or]gre3k;
friable: [a]/ˈfraɪəbl/; [adj]易碎的;脆的; [or]gre3k;
friction: [a]/ˈfrɪkʃn/; [n]摩擦,摩擦力;争执,冲突; [or]gre3k;
frigid: [a]/ˈfrɪdʒɪd/; [adj]寒冷的,冷淡的,死板的,呆板的,性冷淡的; [or]gre3k;
fringe: [a]/frɪndʒ/; [n]刘海;一排;边缘;穗,流苏; [v]形成.的边缘; [or]gre3k;
frivolous: [a]/ˈfrɪvələs/; [adj]轻佻的,不重要的,缺乏基础的; [or]gre3k;
frosty: [a]/ˈfrɔːsti/; [adj]结霜的,严寒的;冷淡的;灰白的; [or]gre3k;
frothy: [a]/ˈfrɔːθi/; [adj]起泡的,多泡的,空洞的; [or]gre3k;
frugal: [a]/ˈfruːɡl/; [adj]节俭的,俭朴的;不昂贵的,廉价的,花钱少的,不充足的; [or]gre3k;
frustrate: [a]/ˈfrʌstreɪt/; [v]使灰心;挫败;阻挠; [or]gre3k;
full-bodied: [a]/ˌfʊl ˈbɑːdid/; [adj]浓郁的,意味深长的;魁梧的,躯体大的; [or]gre3k;
fulminate: [a]/ˈfʊlmɪneɪt/; [v]猛烈抨击,严厉谴责;怒骂; [n]雷酸盐;烈性炸药; [or]gre3k;
fumble: [a]/ˈfʌmbl/; [v]摸索,笨拙地做,漏球; [n]摸索,笨拙的处理,漏球; [adj]笨拙的;迟疑的; [or]gre3k;
furor: [a]/ˈfjʊˌrɔr/; [n]狂热;激怒;喧闹;感动; [or]gre3k;
furtive: [a]/ˈfɜːrtɪv/; [adj]偷偷的,秘密的,鬼鬼祟祟的,; [or]gre3k;
fury: [a]/ˈfjʊri/; [n]狂怒,暴怒; [or]gre3k;
fussy: [a]/ˈfʌsi/; [adj]爱挑剔的,难取悦的,易烦恼的; [or]gre3k;
fusty: [a]/ˈfʌsti/; [adj]过时的,腐臭的;发霉的; [or]gre3k;
futile: [a]/ˈfjuːtl/; [adj]无益的,无用的; [or]gre3k;
gadfly: [a]/ˈɡædflaɪ/; [n]牛虻,令人生厌的人; [or]gre3k;
gaffe: [a]/ɡæf/; [n](社交上令人不快的)失言,失态,失礼; [or]gre3k;
gainsay: [a]/ˌɡeɪnˈseɪ/; [v]否认,否定,反驳; [n]否认,反驳; [or]gre3k;
gall: [a]/ɡɔːl/; [n]粗鲁,无礼; [v]使恼怒; [or]gre3k;
gallant: [a]/ˈɡælənt/; [adj]勇敢的;(男子对女子)殷勤的; [v]向(女子)献殷勤;护卫;求爱; [n](尤指对女子殷勤的)时髦男子; [or]gre3k;
galvanize: [a]/ˈɡælvənaɪz/; [v]镀锌,通电,刺激; [or]gre3k;
gamble: [a]/ˈɡæmbl/; [v]赌博;投机;打赌; [n]赌博;冒险; [vt]赌输; [or]gre3k;
gambol: [a]/ˈɡæmbl/; [n]雀跃,嬉戏; [v]欢跃,嬉戏; [or]gre3k;
gangly: [a]/ˈɡæŋɡli/; [adj]身材痩长的; [or]gre3k;
garble: [a]/'gɑːbəl/; [v]使错乱,混淆;歪曲,断章取义; [or]gre3k;
gargantuan: [a]/ɡɑːrˈɡæntʃuən/; [adj]巨大的,庞大的; [or]gre3k;
garish: [a]/ˈɡerɪʃ/; [adj]炫耀的;过分装饰的;过分鲜艳的; [or]gre3k;
garment: [a]/ˈɡɑːrmənt/; [n]服装; [vt]给 ... 披上衣服;覆上...; [or]gre3k;
garrulous: [a]/ˈɡærələs/; [adj]唠叨的,喋喋不休的;聒噪的; [or]gre3k;
gash: [a]/ɡæʃ/; [n]深长的伤口,切痕;裂缝;裂痕; [v]在..上划口;砍; [adj]衣冠楚楚的;聪明伶俐的; [or]gre3k;
gauche: [a]/ɡoʊʃ/; [adj]笨拙的,不会社交的,偏转的; [or]gre3k;
gaudy: [a]/ˈɡɔːdi/; [n]华丽而俗气的廉价饰物; [adj](服饰,装饰,文风等)华丽而俗气的;浮华的;过分显眼的; [or]gre3k;
gauge: [a]/ɡeɪdʒ/; [n]测量仪;尺度,标准; [v]估计,判断;计量; [or]gre3k;
gawky: [a]/ˈɡɔːki/; [adj](举止)笨拙的; [n]笨拙的人; [or]gre3k;
gear: [a]/ɡɪr/; [n]档位;齿轮;装备;衣物; [v]使适合; [or]gre3k;
genial: [a]/ˈdʒiːniəl/; [adj]愉快的,脾气好的,友好的; [or]gre3k;
genteel: [a]/dʒenˈtiːl/; [adj]有教养的,文雅的;高雅的;假斯文的,装作体面的; [or]gre3k;
germane: [a]/dʒɜːrˈmeɪn/; [adj]有密切关系的;贴切的;恰当的; [or]gre3k;
germinate: [a]/ˈdʒɜːrmɪneɪt/; [v]发芽,发展,生长; [or]gre3k;
gibe: [a]/dʒaɪb/; [n]嘲弄,讥笑; [v]嘲笑; [or]gre3k;
giddy: [a]/ˈɡɪdi/; [adj]眼花缭乱的,头晕的,轻率的; [v](使)眼花,(使)眩晕; [or]gre3k;
gild: [a]/ɡɪld/; [v]镀金; [n]协会,行会(同guild);同业公会;<植>依赖植物集团; [or]gre3k;
gist: [a]/dʒɪst/; [n]主旨,要点;依据; [or]gre3k;
glacial: [a]/ˈɡleɪʃl/; [adj]冰的;冰冷的;冰河时代的; [or]gre3k;
gladiator: [a]/ˈɡlædieɪtər/; [n]职业格斗者;角斗士,斗剑者; [or]gre3k;
glaze: [a]/ɡleɪz/; [n](浇在糕点上的)糖浆,蛋浆,釉;<气>雨淞; [v](眼睛)变呆滞;浇浆汁于 (食物) 表面;给.安装玻璃; [or]gre3k;
glib: [a]/ɡlɪb/; [adj]口齿伶俐的;油嘴滑舌的; [or]gre3k;
glide: [a]/ɡlaɪd/; [v]滑翔;滑动; [n]滑音,延音;滑行; [or]gre3k;
glisten: [a]/ˈɡlɪsn/; [v]闪烁,闪耀; [or]gre3k;
glitch: [a]/ɡlɪtʃ/; [n]小故障; [or]gre3k;
gloat: [a]/ɡloʊt/; [v]幸灾乐祸地看,窃喜; [or]gre3k;
gloomy: [a]/ˈɡluːmi/; [adj]愁容满面的,阴暗的,没有希望的; [or]gre3k;
gloss: [a]/ɡlɑːs/; [n]光泽;假象;唇膏; [vt]使有光彩;掩盖; [or]gre3k;
glossy: [a]/ˈɡlɑːsi/; [adj]光泽的,光滑的; [or]gre3k;
glower: [a]/ˈɡlaʊər/; [v]怒目而视; [or]gre3k;
glut: [a]/ɡlʌt/; [n]供过于求,过多; [vt]使吃饱;使充斥; [vi]过量地吃; [or]gre3k;
glutinous: [a]/ˈɡluːtənəs/; [adj]粘的,胶状的; [or]gre3k;
glutton: [a]/ˈɡlʌtn/; [n]贪吃者,对..贪婪的人; [or]gre3k;
goad: [a]/ɡoʊd/; [vt]驱赶;刺激;鼓励; [n](赶牛用的)刺棒; [or]gre3k;
gobble: [a]/ˈɡɑːbl/; [v]狼吞虎咽;急急抓住,任意花完;如饥似渴地阅读;发出雄火鸡般的咯咯叫声; [n](火鸡的)咯咯声; [or]gre3k;
goggle: [a]/ˈɡɑːɡl/; [n]眼睛睁视,风镜,护目镜; [adj]睁眼的,瞪眼的; [v]眼珠转动,瞪眼看,使瞪眼; [or]gre3k;
goldbrick: [a]/ˈɡoʊldbrɪk/; [n]懒汉,假金砖,赝品; [v]称病,欺诈,偷懒; [or]gre3k;
gorge: [a]/ɡɔːrdʒ/; [n]峡谷;胃;暴食;咽喉;障碍物; [v]拼命吃;吞下,狼吞虎咽;塞满,填满; [or]gre3k;
gossamer: [a]/ˈɡɑːsəmər/; [n]蛛丝,小蜘蛛网;薄纱,纤细的东西; [adj]轻而薄的; [or]gre3k;
gourmand: [a]/ˈɡʊrmɑːnd/; [n]贪食者; [adj]贪食的; [or]gre3k;
gourmet: [a]/ˈɡʊrmeɪ/; [n]美食家,讲究吃喝的人; [adj]菜肴精美的; [or]gre3k;
graft: [a]/ɡræft/; [n]嫁接;嫁接株;移植; [vi]接枝; [vt]将.嫁接;移植(器官); [or]gre3k;
grandeur: [a]/ˈɡrændʒər/; [n]壮观,宏伟,庄严; [or]gre3k;
grandiloquent: [a]/ɡrænˈdɪləkwənt/; [adj](语言等)夸张的,夸大的; [or]gre3k;
grandiose: [a]/ˈɡrændioʊs/; [adj]浮夸的,夸大的,宏伟的; [or]gre3k;
grandstand: [a]/ˈɡrænstænd/; [n]正面看台;看台席上的观众;哗众取宠的表演; [adj]哗众取宠的;看台上的; [v]哗众取宠;卖弄技巧; [or]gre3k;
grate: [a]/ɡreɪt/; [n]壁炉;格栅; [v]磨碎,使人烦燥; [or]gre3k;
gratify: [a]/ˈɡrætɪfaɪ/; [v]使高兴,使满足; [or]gre3k;
gratuitous: [a]/ɡrəˈtuːɪtəs/; [adj]无根据的,无理由的,无报酬的,免费的,多余的; [or]gre3k;
green: [a]/ɡriːn/; [adj]绿色的,青的,草绿色的;缺乏经验的;嫉妒的,眼红的;(赞成)环境保护的;生的,未熟的; [n]绿色;草地,草坪,公共绿地;绿色蔬菜,绿叶蔬菜; [v]使成为绿色,成为绿色,变绿;使..恢复活力; [or]gre3k;
gregarious: [a]/ɡrɪˈɡeriəs/; [adj]群居的,爱社交的; [or]gre3k;
grieve: [a]/ɡriːv/; [v]伤心,悲痛; [vi]使悲伤,使伤心; [or]gre3k;
grimace: [a]/ˈɡrɪməs/; [v]做鬼脸,面部歪扭; [n]愁眉苦脸,怪相,鬼脸; [or]gre3k;
grin: [a]/ɡrɪn/; [v]露齿而笑,咧嘴一笑; [n]龇牙笑; [or]gre3k;
gripe: [a]/ɡraɪp/; [n]控制,发牢骚,肠绞痛; [v]抱怨,发牢骚; [or]gre3k;
grisly: [a]/ˈɡrɪzli/; [adj]恐怖的;令人震惊的;厉害的; [or]gre3k;
grit: [a]/ɡrɪt/; [n]沙粒;决心,勇气; [v]研磨;在.上铺砂砾;下定决心,咬紧牙关; [or]gre3k;
groggy: [a]/ˈɡrɑːɡi/; [adj]体弱的;摇摇晃晃的,踉踉跄跄的;头昏眼花的; [or]gre3k;
groove: [a]/ɡruːv/; [n]<建>凹槽;最佳状态;槽;惯例; [v]开槽于;形成沟槽; [or]gre3k;
grotesque: [a]/ɡroʊˈtesk/; [adj]奇形怪状的,奇异的; [n]奇形怪状的人(或物,图案等);奇异风格; [or]gre3k;
grovel: [a]/ˈɡrɑːvl/; [v]摇尾乞怜;奴颜婢膝;匍匐; [or]gre3k;
grudge: [a]/ɡrʌdʒ/; [n]怨恨;妒嫉;恶意;忿忿不平; [v]怨恨;嫉妒;不情愿做; [or]gre3k;
grueling: [a]/'gruːəlɪŋ/; [n]惩罚,劳累; [adj]累垮人的,折磨人的; [or]gre3k;
grumble: [a]/ˈɡrʌmbl/; [v]埋怨;发牢骚;咕哝; [n]隆隆响声;抱怨,怨言; [or]gre3k;
guile: [a]/ɡaɪl/; [n]狡猾,诡计,欺诈; [or]gre3k;
guilt: [a]/ɡɪlt/; [n]内疚;罪行;罪恶感; [or]gre3k;
gull: [a]/ɡʌl/; [n]鸥;笨人;易受骗之人; [v]骗;欺诈; [or]gre3k;
gullible: [a]/ˈɡʌləbl/; [adj]易受骗的;轻信的; [or]gre3k;
gush: [a]/ɡʌʃ/; [v]涌出;滔滔不绝地说,洋洋洒洒地写; [n]迸发; [or]gre3k;
gust: [a]/ɡʌst/; [n]阵风,(感情的)迸发,汹涌; [v]猛吹; [or]gre3k;
guzzle: [a]/ˈɡʌzl/; [v]狂饮暴食,大吃大喝; [or]gre3k;
hack: [a]/hæk/; [n]砍,劈;出租马车;出租车; [vt]砍,乱劈;胡乱删改;<计算机>(熟练地编辑或修改)程序;非法侵入(他人计算机系统); [adj]出租的;用旧了的;(文人等)被雇佣的;雇佣文人做的; [or]gre3k;
hackneyed: [a]/ˈhæknid/; [adj]陈腐的,平常的; [or]gre3k;
halcyon: [a]/ˈhælsiən/; [adj]平静的,愉快的,幸福的; [n]翡翠鸟;传说中的太平鸟; [or]gre3k;
hale: [a]/heɪl/; [adj]矍铄的(尤指老人);强壮的; [adv]完全地; [v]迫使;猛拉;不断流出; [or]gre3k;
half-baked: [a]/ˌhæf ˈbeɪkt/; [adj]不完整的;未完成的;半熟的; [or]gre3k;
halfhearted: [a]/'hɑːf'hɑːtɪd/; [adj]不感兴趣的,不热情的; [or]gre3k;
hallmark: [a]/ˈhɔːlmɑːrk/; [n]特点;品质证明; [v]给.盖上品质证明印记;使具有.标志; [or]gre3k;
hallow: [a]/'hæloʊ/; [v]把.视为神圣,尊敬; [or]gre3k;
hallucination: [a]/həˌluːsɪˈneɪʃn/; [n]幻觉,幻想; [or]gre3k;
hammer: [a]/ˈhæmər/; [n]锤; [v]锤击; [or]gre3k;
hamper: [a]/ˈhæmpər/; [v]阻碍,妨碍,牵制; [n](有盖的)大篮子; [or]gre3k;
hamstring: [a]/ˈhæmstrɪŋ/; [n]腿筋; [v]切断腿筋使成跛腿;使无效; [or]gre3k;
hangdog: [a]/ˈhæŋdɔːɡ/; [adj]伤心的,沮丧的;鬼鬼祟祟的; [n]卑鄙的人;卑微的人; [or]gre3k;
hanker: [a]/ˈhæŋkər/; [vi]渴望,追求; [or]gre3k;
haphazard: [a]/hæpˈhæzərd/; [adj]偶然的;随意的;凑合的;胡乱的; [or]gre3k;
harangue: [a]/həˈræŋ/; [n]长篇大论; [v]高谈阔论;大声训斥; [or]gre3k;
harass: [a]/həˈræs/; [v]使困扰,使烦恼,反复袭击; [or]gre3k;
harbinger: [a]/ˈhɑːrbɪndʒər/; [n]先驱,先兆; [vt]预告;充做.的前驱; [or]gre3k;
harbor: [a]/'hɑːbə/; [n]海港;港口;避风港; [v]庇护;藏匿;心怀(怨恨等); [or]gre3k;
hard-bitten: [a]/ˌhɑːrd ˈbɪtn/; [adj]顽强的;不屈服的; [or]gre3k;
hardy: [a]/ˈhɑːrdi/; [adj](植物)耐寒的;能吃苦耐劳的;勇敢的; [n]强壮的人; [or]gre3k;
harmonious: [a]/hɑːrˈmoʊniəs/; [adj]和谐的,协调的;和睦的;悦耳的; [or]gre3k;
harness: [a]/ˈhɑːrnɪs/; [n]挽具,马具,降落伞背带; [v]上挽具;治理(河流等);利用; [or]gre3k;
harrow: [a]/ˈhæroʊ/; [n]耙; [v]耙地,使苦恼,被耙松; [or]gre3k;
harry: [a]/ˈhæri/; [v]折磨,掠夺,骚扰; [n]恶魔,恶鬼;胡闹的青年人;伦敦佬;(人名)哈里; [or]gre3k;
harsh: [a]/hɑːrʃ/; [adj]严厉的;刺耳的;条件艰苦的; [or]gre3k;
hasten: [a]/ˈheɪsn/; [v]赶快,急忙;加速;催促; [or]gre3k;
hasty: [a]/ˈheɪsti/; [adj]匆忙的;仓促完成的;草率的; [or]gre3k;
haunt: [a]/hɔːnt/; [v]常去,萦绕于..;(鬼,魂)常出没于;(思想)萦绕; [n]常去的地方; [or]gre3k;
hauteur: [a]/hɔːˈtɜːr/; [n]傲慢; [or]gre3k;
haven: [a]/ˈheɪvn/; [n]港湾;避难所; [vt]为.提供庇护所; [or]gre3k;
havoc: [a]/ˈhævək/; [n](天灾,战争等造成的)大破坏,大毁灭; [vi]损毁; [vt]严重破坏; [or]gre3k;
hearten: [a]/ˈhɑːrtn/; [v]激励,鼓励,(使)振作; [or]gre3k;
heckle: [a]/ˈhekl/; [v]诘问,困扰; [n]麻梳;梳理;<印>针排; [or]gre3k;
hedonism: [a]/ˈhiːdənɪzəm/; [n]享乐主义; [or]gre3k;
hegemony: [a]/hɪˈdʒemoʊni/; [n]霸权,领导权; [or]gre3k;
heinous: [a]/ˈheɪnəs/; [adj]可憎的;极凶恶的; [or]gre3k;
herald: [a]/ˈherəld/; [n]使者;预兆; [v]预告;为.欢呼; [or]gre3k;
heresy: [a]/ˈherəsi/; [n]异端邪说;异教; [or]gre3k;
heretical: [a]/həˈretɪkl/; [adj]异端的,异教的; [or]gre3k;
hermetic: [a]/hɜːrˈmetɪk/; [adj]密封的;与外界隔绝的;不透气的;炼金术的; [or]gre3k;
hesitance: [a]/'hezətəns/; [n]犹豫,不情愿; [or]gre3k;
hew: [a]/hjuː/; [v]砍伐;劈;遵守,坚持; [or]gre3k;
hidebound: [a]/ˈhaɪdbaʊnd/; [adj]死板的,顽固的,墨守成规的; [or]gre3k;
hideous: [a]/ˈhɪdiəs/; [adj]讨厌的,丑恶的; [or]gre3k;
hie: [a]/haɪ/; [v]催促,使赶紧; [or]gre3k;
hierarchical: [a]/ˌhaɪəˈrɑːrkɪkl/; [adj]分等级的; [or]gre3k;
hike: [a]/haɪk/; [n]远足,徒步旅行;(数量,价格等)增加,上升; [v]作长途徒步旅行;使高涨,提高(价格); [or]gre3k;
hilarious: [a]/hɪˈleriəs/; [adj]有趣的;令人捧腹的;滑稽的;欢闹的; [or]gre3k;
histrionic: [a]/ˌhɪstriˈɑːnɪk/; [adj]戏剧的,装腔作势的,作戏的; [n]演员;戏剧表演;舞台艺术;戏剧似的言行; [or]gre3k;
hive: [a]/haɪv/; [n]蜂房,忙碌之地; [v]分开,隔开; [or]gre3k;
hoard: [a]/hɔːrd/; [v]贮藏,秘藏; [n]贮藏物; [or]gre3k;
hoary: [a]/ˈhɔːri/; [adj]年纪高迈的;(头发等)灰白的;古老的; [or]gre3k;
hoax: [a]/hoʊks/; [n]骗局;恶作剧; [vt]愚弄;欺骗; [or]gre3k;
hobble: [a]/ˈhɑːbl/; [v]蹒跚,跛行; [n]跛行;韵律不全的诗;马的脚绊;〈口,方〉困境; [or]gre3k;
hodgepodge: [a]/ˈhɑːdʒpɑːdʒ/; [n]大杂烩,混煮,一团糟; [or]gre3k;
homage: [a]/ˈhɑːmɪdʒ/; [n]敬意;尊敬;效忠; [or]gre3k;
homely: [a]/ˈhoʊmli/; [adj]不好看的,相貌平平的;朴素的;(如在家一般)舒适自在,家庭的;(女士)热情友好的,和蔼的; [or]gre3k;
homogenize: [a]/həˈmɑdʒəˌnaɪz/; [vi]变均匀; [vt]使均匀,使类同; [or]gre3k;
hone: [a]/hoʊn/; [n]细磨刀石; [v]磨刀; [or]gre3k;
hoodwink: [a]/ˈhʊdwɪŋk/; [v]欺骗,遮眼,蒙蔽; [or]gre3k;
hortative: [a]/'hɔːtətɪv/; [adj]激励的; [or]gre3k;
hovel: [a]/ˈhʌvl/; [n]茅舍,肮脏的小屋; [or]gre3k;
hubris: [a]/ˈhjuːbrɪs/; [n]傲慢;狂妄自大; [or]gre3k;
humble: [a]/ˈhʌmbl/; [adj]卑微的;(级别或地位)低下的,简陋的;谦逊的; [v]使⋯谦逊,使⋯卑下;轻松打败(尤指强大的对手); [or]gre3k;
humdrum: [a]/ˈhʌmdrʌm/; [adj]单调的;乏味的; [n]平凡;单调; [vi]单调乏味地进行; [or]gre3k;
humiliate: [a]/hjuːˈmɪlieɪt/; [vt]使蒙耻;使丢脸;羞辱; [or]gre3k;
humility: [a]/hjuːˈmɪləti/; [n]谦逊,谦恭; [or]gre3k;
humor: [a]/ˈhjuːmər/; [n]幽默,诙谐; [or]gre3k;
hurricane: [a]/ˈhɜːrəkeɪn/; [n]飓风; [or]gre3k;
husk: [a]/hʌsk/; [n]外壳,皮;无价值之物; [v]削皮;以粗哑的嗓音说; [or]gre3k;
hybrid: [a]/ˈhaɪbrɪd/; [n]杂种,混血儿,混合物; [adj]混合的;杂种的; [or]gre3k;
hymn: [a]/hɪm/; [n]赞美诗,圣歌;歌颂某事物的电影; [or]gre3k;
hyperbole: [a]/haɪˈpɜːrbəli/; [n]夸张的语句;夸张法; [or]gre3k;
hypnotic: [a]/hɪpˈnɑːtɪk/; [n]安眠药; [adj]催眠的,令人着迷的; [or]gre3k;
hypocritical: [a]/ˌhɪpəˈkrɪtɪkl/; [adj]虚伪的;伪善的; [or]gre3k;
hypothetical: [a]/ˌhaɪpəˈθetɪkl/; [adj]假设的,假定的; [or]gre3k;
iconoclast: [a]/aɪˈkɑːnəklæst/; [n]攻击传统观念或风俗的人; [or]gre3k;
idiosyncrasy: [a]/ˌɪdiəˈsɪŋkrəsi/; [n]特殊癖性或行为; [or]gre3k;
idle: [a]/ˈaɪdl/; [adj]空闲的;懒散的; [v]无所事事;虚度;空转;使空转; [vt]虚度; [or]gre3k;
idyll: [a]/ˈaɪdl/; [n]田园诗,牧歌; [or]gre3k;
ignite: [a]/ɪɡˈnaɪt/; [v]点燃,发光,燃烧; [or]gre3k;
ignominy: [a]/ˈɪɡnəmɪni/; [n]耻辱,不体面,丑行; [or]gre3k;
ill-bred: [a]/ˌɪl ˈbred/; [adj]没有教养的,没有礼貌的; [or]gre3k;
illiteracy: [a]/ɪˈlɪtərəsi/; [n]文盲,无知; [or]gre3k;
illuminate: [a]/ɪˈluːmɪneɪt/; [vt]照亮;阐释;说明; [or]gre3k;
illusory: [a]/ɪˈluːsəri/; [adj]错觉的,幻影的,虚假的,产生幻觉的; [or]gre3k;
illustrious: [a]/ɪˈlʌstriəs/; [adj]著名的,杰出的;辉煌的; [or]gre3k;
imbibe: [a]/ɪmˈbaɪb/; [v]喝,饮;吸收,接受; [or]gre3k;
imbroglio: [a]/ɪmˈbroʊlioʊ/; [n]纠纷,纠葛; [or]gre3k;
imitation: [a]/ˌɪmɪˈteɪʃn/; [n]模仿;仿制品;赝品; [adj]伪造的;仿制的; [or]gre3k;
immaculate: [a]/ɪˈmækjələt/; [adj]完美的,无瑕疵的;洁净的; [or]gre3k;
immanent: [a]/ˈɪmənənt/; [adj]内在的,固有的; [n]天生,固有; [or]gre3k;
immaterial: [a]/ˌɪməˈtɪriəl/; [adj]非实体的,无关紧要的; [or]gre3k;
immature: [a]/ˌɪməˈtʃʊr/; [adj]幼年的;未成熟的; [or]gre3k;
immemorial: [a]/ˌɪməˈmɔːriəl/; [adj]太古的,极古的; [or]gre3k;
immune: [a]/ɪˈmjuːn/; [adj]免疫的,有免疫力的;不受影响的;免除的; [or]gre3k;
immure: [a]/ɪˈmjʊr/; [v]监禁; [or]gre3k;
immutable: [a]/ɪˈmjuːtəbl/; [adj]永远不变的,永恒的; [or]gre3k;
impassive: [a]/ɪmˈpæsɪv/; [adj]无动于衷的,冷漠的; [or]gre3k;
impeccable: [a]/ɪmˈpekəbl/; [adj]无瑕疵的,没有缺点的; [or]gre3k;
impecunious: [a]/ˌɪmpɪˈkjuːniəs/; [adj]贫困的,一文不名的; [or]gre3k;
impede: [a]/ɪmˈpiːd/; [v]妨碍,阻碍; [or]gre3k;
impending: [a]/ɪmˈpendɪŋ/; [adj]即将到来的;迫在眉睫的,紧急的; [or]gre3k;
impenetrable: [a]/ɪmˈpenɪtrəbl/; [adj]难以渗透的,坚不可摧的; [or]gre3k;
impenitent: [a]/ɪmˈpenɪtənt/; [adj]不悔悟的; [or]gre3k;
imperative: [a]/ɪmˈperətɪv/; [adj]必要的;祈使的;急需的; [n]命令;必要的事;义务;驱使; [or]gre3k;
imperial: [a]/ɪmˈpɪriəl/; [adj]帝王的,壮丽的,至尊的; [n]帝国,皇家; [or]gre3k;
imperious: [a]/ɪmˈpɪriəs/; [adj]傲慢的,专横的; [or]gre3k;
imperishable: [a]/ɪmˈperɪʃəbl/; [adj]不能被摧毁的,不朽的,永恒的; [or]gre3k;
impertinent: [a]/ɪmˈpɜːrtnənt/; [adj]不恰当的,粗鲁的; [or]gre3k;
imperturbable: [a]/ˌɪmpərˈtɜːrbəbl/; [adj]冷静的,沉着的; [or]gre3k;
impervious: [a]/ɪmˈpɜːrviəs/; [adj]不能渗透的,不为所动的; [or]gre3k;
impetuous: [a]/ɪmˈpetʃuəs/; [adj]冲动的,鲁莽的; [or]gre3k;
impious: [a]/ɪmˈpaɪəs/; [adj]不敬神的,不虔诚的,不孝的; [or]gre3k;
implacable: [a]/ɪmˈplækəbl/; [adj]难以满足的,难平息的; [or]gre3k;
implement: [a]/ˈɪmplɪment/; [n]工具;器具; [v]实施,执行;执行; [or]gre3k;
implicit: [a]/ɪmˈplɪsɪt/; [adj]隐含的;盲目的;完全的,绝对的;成为一部分的; [or]gre3k;
implode: [a]/ɪmˈploʊd/; [vi]内向爆炸,内向崩溃; [vt]使爆裂; [or]gre3k;
importune: [a]/ˌɪmpɔːrˈtuːn/; [v]强求,胡搅蛮缠; [adj]同"importunate"; [or]gre3k;
imposing: [a]/ɪmˈpoʊzɪŋ/; [adj]壮观的,壮丽的; [or]gre3k;
impostor: [a]/ɪmˈpɑːstər/; [n]骗子;冒充者; [or]gre3k;
impotent: [a]/ˈɪmpətənt/; [adj]无力的,无能的,阳痿的; [n]虚弱者;阳痿者; [or]gre3k;
imprecise: [a]/ˌɪmprɪˈsaɪs/; [adj]不精确的,不严密的; [or]gre3k;
impromptu: [a]/ɪmˈprɑːmptuː/; [adj]一触即发的;即席的,即兴的; [adv]即席地,即兴地; [n]即兴之作; [or]gre3k;
improvise: [a]/ˈɪmprəvaɪz/; [v]即席创作,临时凑成; [or]gre3k;
imprudent: [a]/ɪmˈpruːdnt/; [adj]轻率的,鲁莽的; [or]gre3k;
impudent: [a]/ˈɪmpjədənt/; [adj]鲁莽的,冒失的,无礼的; [or]gre3k;
impugn: [a]/ɪmˈpjuːn/; [v]指责,对.表示怀疑; [or]gre3k;
impunity: [a]/ɪmˈpjuːnəti/; [n]不受惩罚;无患; [or]gre3k;
inadvertent: [a]/ˌɪnədˈvɜːrtənt/; [adj]疏忽的,漫不经心的,无意中的; [or]gre3k;
inalienable: [a]/ɪnˈeɪliənəbl/; [adj]不可分割的; [or]gre3k;
inane: [a]/ɪˈneɪn/; [adj]无意义的,空洞的;愚蠢的; [or]gre3k;
inanimate: [a]/ɪnˈænɪmət/; [adj]无生命的;无生气的; [or]gre3k;
inaugurate: [a]/ɪˈnɔːɡjəreɪt/; [v]为..揭幕;为.举行就职典礼;开展; [or]gre3k;
incandescent: [a]/ˌɪnkænˈdesnt/; [adj]白热的,热烈的; [or]gre3k;
incantation: [a]/ˌɪnkænˈteɪʃn/; [n]咒语; [or]gre3k;
incarnate: [a]/ɪnˈkɑːrnət/; [adj]化身的,人体化的,肉色的; [v]体现,使.具体化,使实体化; [or]gre3k;
incendiary: [a]/ɪnˈsendieri/; [n]放火者,纵火者,燃烧弹,煽动者; [adj]放火的,纵火的,能燃烧的,煽动性的; [or]gre3k;
incense: [a]/ˈɪnsens/; [n]焚香时的烟,香味; [v]激怒; [or]gre3k;
incentive: [a]/ɪnˈsentɪv/; [n]刺激,激励;鼓励; [or]gre3k;
inception: [a]/ɪnˈsepʃn/; [n]起初;获得学位; [or]gre3k;
incessant: [a]/ɪnˈsesnt/; [adj]无间断的,连续的; [or]gre3k;
inchoate: [a]/ɪnˈkoʊət/; [adj]早期的;刚开始的;未充分发展的; [or]gre3k;
incinerate: [a]/ɪnˈsɪnəreɪt/; [v]焚化,毁弃; [or]gre3k;
incipient: [a]/ɪnˈsɪpiənt/; [adj]初期的;刚出现的; [or]gre3k;
incite: [a]/ɪnˈsaɪt/; [v]刺激;煽动; [or]gre3k;
inclement: [a]/ɪnˈklemənt/; [adj]险恶的;气候严酷的;狂风暴雨的; [or]gre3k;
inconsequential: [a]/ɪnˌkɑːnsɪˈkwenʃl/; [adj]不重要的,不合理的,不合逻辑的; [or]gre3k;
incontrovertible: [a]/ˌɪnkɑːntrəˈvɜːrtəbl/; [adj]无可争议的; [or]gre3k;
incorrigible: [a]/ɪnˈkɔːrɪdʒəbl/; [adj]积习难改的,不可救药的; [or]gre3k;
incriminate: [a]/ɪnˈkrɪmɪneɪt/; [v]控告,暗示..有罪; [or]gre3k;
incubate: [a]/ˈɪŋkjubeɪt/; [v]孵卵; [or]gre3k;
inculpate: [a]/'ɪnkʌlˌpeɪt/; [v]连累;使负罪;控告; [or]gre3k;
incumbent: [a]/ɪnˈkʌmbənt/; [n]在职者,现任者; [adj]现任的;依靠的;负有职责的; [or]gre3k;
incursion: [a]/ɪnˈkɜːrʒn/; [n]入侵,侵犯; [or]gre3k;
indecorous: [a]/ɪnˈdekərəs/; [adj]不合乎礼节的,不得体的; [or]gre3k;
indelible: [a]/ɪnˈdeləbl/; [adj](印记等)无法擦除的,无法忘怀的; [or]gre3k;
indemnity: [a]/ɪnˈdemnəti/; [n]赔偿物;补偿,赔偿;保障; [or]gre3k;
indict: [a]/ɪnˈdaɪt/; [v]控诉,起诉; [or]gre3k;
indifferent: [a]/ɪnˈdɪfrənt/; [adj]不感兴趣的,不关心的;平庸的;冷漠的; [or]gre3k;
indigenous: [a]/ɪnˈdɪdʒənəs/; [adj]土生土长的,本土的; [or]gre3k;
indigent: [a]/ˈɪndɪdʒənt/; [adj]贫困的,贫穷的; [or]gre3k;
indispensable: [a]/ˌɪndɪˈspensəbl/; [adj]必不可少的;必需的; [or]gre3k;
indoctrinate: [a]/ɪnˈdɑːktrɪneɪt/; [v]灌输思想; [or]gre3k;
indolent: [a]/ˈɪndələnt/; [adj]懒惰的,懒洋洋的; [or]gre3k;
inducement: [a]/ɪnˈduːsmənt/; [n]诱因;刺激物;犯罪动因; [or]gre3k;
indulgent: [a]/ɪnˈdʌldʒənt/; [adj]放纵的;宽容的;任性的; [or]gre3k;
indurate: [a]/'ɪndjʊˌreɪt/; [v]变坚固,使冷酷; [adj]冷酷的,硬化的; [or]gre3k;
industrious: [a]/ɪnˈdʌstriəs/; [adj]勤劳的,勤奋的; [or]gre3k;
ineffable: [a]/ɪnˈefəbl/; [adj]不可言喻的,不应说出的,难以形容的; [or]gre3k;
ineluctable: [a]/ˌɪnɪˈlʌktəbl/; [adj]不可改变的,无法逃避的; [or]gre3k;
inept: [a]/ɪˈnept/; [adj]无能的;不称职的;笨拙的; [or]gre3k;
inert: [a]/ɪˈnɜːrt/; [adj]不动的,惰性的;行动迟钝的;无生气的; [or]gre3k;
inevitable: [a]/ɪnˈevɪtəbl/; [adj]不可避免的,必然的; [n]必然发生的事; [or]gre3k;
inexorable: [a]/ɪnˈeksərəbl/; [adj]不为所动的,坚决不变的; [n]坚定不移的人; [or]gre3k;
infamous: [a]/ˈɪnfəməs/; [adj]声名狼藉的,无耻的; [or]gre3k;
infatuate: [a]/ɪn'fætʃʊˌeɪt/; [v]使迷恋;使糊涂,使冲昏头脑; [adj]着迷的; [or]gre3k;
infelicitous: [a]/ˌɪnfə'lɪsətəs/; [adj]不妥当的,不得体的,不吉利的; [or]gre3k;
inferno: [a]/ɪnˈfɜːrnoʊ/; [n]火海,地狱般的场所; [or]gre3k;
infiltrate: [a]/ˈɪnfɪltreɪt/; [v]渗入,潜入 (某地方或组织);(气,液)渗透; [n]渗透物; [or]gre3k;
infinite: [a]/ˈɪnfɪnət/; [adj]无限的,无穷的;无数的; [n]无穷,无限大; [or]gre3k;
infirm: [a]/ɪnˈfɜːrm/; [adj]衰弱的;意志薄弱的;不坚固的; [or]gre3k;
inflame: [a]/ɪnˈfleɪm/; [v]使燃烧,激怒(某人); [or]gre3k;
influx: [a]/ˈɪnflʌks/; [n]流入,涌入;河口; [or]gre3k;
infraction: [a]/ɪnˈfrækʃn/; [n]违法; [or]gre3k;
infuriate: [a]/ɪnˈfjʊrieɪt/; [v]使(人)极为愤怒; [or]gre3k;
infuse: [a]/ɪnˈfjuːz/; [v]沏(茶),泡(草药);灌输;使充满; [or]gre3k;
ingenious: [a]/ɪnˈdʒiːniəs/; [adj]聪明的;有发明天才的;有独创性的,别出心裁的; [or]gre3k;
ingenuity: [a]/ˌɪndʒəˈnuːəti/; [n]机灵,心灵手巧,富于创造天赋; [or]gre3k;
ingest: [a]/ɪnˈdʒest/; [v]咽下;摄取;吸收;接待; [or]gre3k;
ingratiating: [a]/ɪnˈɡreɪʃieɪtɪŋ/; [adj]讨好的,谄媚的; [or]gre3k;
inherent: [a]/ɪnˈhɪrənt/; [adj]内在的,固有的;生来就有的; [or]gre3k;
inimical: [a]/ɪˈnɪmɪkl/; [adj]敌意的,有害的; [or]gre3k;
inimitable: [a]/ɪˈnɪmɪtəbl/; [adj]独特的,无比的,无法仿效的; [or]gre3k;
iniquity: [a]/ɪˈnɪkwəti/; [n]邪恶,不公正; [or]gre3k;
initiate: [a]/ɪˈnɪʃieɪt/; [v]开始,发动; [n]新加入组织的人; [or]gre3k;
inkling: [a]/ˈɪŋklɪŋ/; [n]轻微暗示,小提示,略知; [or]gre3k;
innocuous: [a]/ɪˈnɑːkjuəs/; [adj]无伤大雅的;无害的; [or]gre3k;
innovative: [a]/ˈɪnəveɪtɪv/; [adj]创新的,革新的; [or]gre3k;
inquisitive: [a]/ɪnˈkwɪzətɪv/; [adj]好奇的,好打听的; [or]gre3k;
insensible: [a]/ɪnˈsensəbl/; [adj]昏迷的,无知觉的,麻木不仁的; [or]gre3k;
insensitive: [a]/ɪnˈsensətɪv/; [adj]感觉迟钝的,对.没有感觉的; [or]gre3k;
insight: [a]/ˈɪnsaɪt/; [n]深刻的理解,洞察力,见识; [or]gre3k;
insipid: [a]/ɪnˈsɪpɪd/; [adj]淡而无味的;枯燥乏味的; [or]gre3k;
insolent: [a]/ˈɪnsələnt/; [adj]傲慢的,粗鲁的,无礼的; [or]gre3k;
instigate: [a]/ˈɪnstɪɡeɪt/; [v]发起,煽动; [or]gre3k;
institute: [a]/ˈɪnstɪtuːt/; [n]学会;学院,专科学院,研究院; [vt]建立,设立,制定; [or]gre3k;
insubordinate: [a]/ˌɪnsəˈbɔːrdɪnət/; [adj]不服从的,反抗的; [or]gre3k;
insular: [a]/ˈɪnsələr/; [adj]岛屿的,与世隔绝的; [or]gre3k;
insulate: [a]/ˈɪnsəleɪt/; [v]隔离,使隔绝(以免受到影响);使隔热; [or]gre3k;
insurgent: [a]/ɪnˈsɜːrdʒənt/; [n]叛乱分子; [adj]叛乱的,起事的; [or]gre3k;
intangible: [a]/ɪnˈtændʒəbl/; [adj]不可捉摸的,无形的; [n]无形的东西; [or]gre3k;
integral: [a]/ˈɪntɪɡrəl/; [adj](用于构成整体)必需的,不可缺少的,必不可少的;基本的,作为组成部分的,内置的;整体的,完整的; [or]gre3k;
integrity: [a]/ɪnˈteɡrəti/; [n]正直,真诚;完整; [or]gre3k;
intelligible: [a]/ɪnˈtelɪdʒəbl/; [adj]可理解的,明白易懂的; [or]gre3k;
intemperate: [a]/ɪnˈtempərət/; [adj]放纵的;酗酒的;酷烈的; [or]gre3k;
intensify: [a]/ɪnˈtensɪfaɪ/; [v]增强;加剧; [or]gre3k;
inter: [a]/ɪnˈtɜːr/; [v]埋葬; prep. 在内; [or]gre3k;
interdict: [a]/ˈɪntərdɪkt/; [n]禁令;禁止,制止; [v]禁止,制止;闭锁,阻断(敌人通路);<宗教>停止教权; [or]gre3k;
interim: [a]/ˈɪntərɪm/; [n]中间时期,过渡时期; [adj]暂时的; [or]gre3k;
interlock: [a]/ˌɪntərˈlɑːk/; [v]连锁,连串; [n]〔电信〕结合;联锁装置;相关;联动; [or]gre3k;
interminable: [a]/ɪnˈtɜːrmɪnəbl/; [adj]没完没了的,无穷无尽的,冗长的; [or]gre3k;
intermittent: [a]/ˌɪntərˈmɪtənt/; [adj]断断续续的,间歇的; [or]gre3k;
interrogate: [a]/ɪnˈterəɡeɪt/; [v]审问,审讯; [or]gre3k;
intimate: [a]/ˈɪntɪmət/; [adj]亲密的,密切的;详细的; [v]暗示;宣布,通知; [n]密友,知己; [or]gre3k;
intimidate: [a]/ɪnˈtɪmɪdeɪt/; [v]恫吓,威胁; [or]gre3k;
intoxicant: [a]/ɪnˈtɑːksɪkənt/; [adj]醉人的,麻醉的,沉醉的; [n]酒精饮料,麻醉品; [or]gre3k;
intransigent: [a]/ɪnˈtrænzɪdʒənt/; [adj]固执的,不妥协的,不让步的; [n]不妥协,不妥协的人; [or]gre3k;
intrepid: [a]/ɪnˈtrepɪd/; [adj]无畏的;刚毅的,勇敢的; [or]gre3k;
intrigue: [a]/ɪnˈtriːɡ/; [n]阴谋;诡计; [v]密谋;欺骗;引起极大兴趣; [or]gre3k;
intrinsic: [a]/ɪnˈtrɪnsɪk/; [adj]固有的; [or]gre3k;
intuitive: [a]/ɪnˈtuːɪtɪv/; [adj]直觉的,凭直觉获知的; [or]gre3k;
inundate: [a]/ˈɪnʌndeɪt/; [v]淹没,泛滥; [or]gre3k;
inure: [a]/ɪˈnjʊr/; [v]使.习惯,使.适应,起作用,有助于; [or]gre3k;
invective: [a]/ɪnˈvektɪv/; [n]猛烈抨击,恶言漫骂; [adj]谩骂的;恶言的;诽谤的; [or]gre3k;
inveigh: [a]/ɪnˈveɪ/; [v]激烈抗议,表示强烈不满;痛骂; [or]gre3k;
inveigle: [a]/ɪnˈveɪɡl/; [v]诱骗,诱使,诱惑; [or]gre3k;
inventory: [a]/ˈɪnvəntɔːri/; [n]详细目录;存货清单; [or]gre3k;
inveterate: [a]/ɪnˈvetərət/; [adj]积习已深的,根深蒂固的,长期形成的; [or]gre3k;
invidious: [a]/ɪnˈvɪdiəs/; [adj]惹人反感的,招人嫉妒的,令人厌恶的,诽谤的,不公平的; [or]gre3k;
invigorate: [a]/ɪnˈvɪɡəreɪt/; [v]鼓舞;提神,使精力充沛; [adj]生气勃勃的,精力充沛的,健壮的; [n]滋补;鼓舞; [or]gre3k;
invincible: [a]/ɪnˈvɪnsəbl/; [adj]无敌的;不能征服的; [or]gre3k;
invoke: [a]/ɪnˈvoʊk/; [v]调用,祈求,恳求,引起; [or]gre3k;
irascible: [a]/ɪˈræsəbl/; [adj]易怒的,性情暴躁的; [or]gre3k;
irate: [a]/aɪˈreɪt/; [adj]发怒的,愤怒的; [or]gre3k;
iridescent: [a]/ˌɪrɪˈdesnt/; [adj]彩虹色的;闪光的,闪色的; [or]gre3k;
irk: [a]/ɜːrk/; [v]使苦恼,使厌烦; [n]厌烦,厌倦; [or]gre3k;
ironclad: [a]/ˈaɪərnklæd/; [adj]坚固的,装铁甲的;无可推诿的; [n]装甲舰; [or]gre3k;
irrigate: [a]/ˈɪrɪɡeɪt/; [v]灌溉,冲洗; [or]gre3k;
irritate: [a]/ˈɪrɪteɪt/; [v]使烦躁;激怒;使难受; [or]gre3k;
issue: [a]/ˈɪʃuː/; [n]问题;议题;发行物;子女; [v]发行;发布;分配,分发,给; [or]gre3k;
jabber: [a]/ˈdʒæbər/; [v]急急忙忙地说,急促不清地说; [n]急促不清地话,无意义的话; [or]gre3k;
jaded: [a]/ˈdʒeɪdɪd/; [adj]疲倦的,精疲力竭的;厌倦的; [or]gre3k;
jape: [a]/dʒeɪp/; [n]嘲弄;玩笑; [vi]开玩笑; [vt]嘲弄; [or]gre3k;
jargon: [a]/ˈdʒɑːrɡən/; [n]行话,术语;黄锆石; [or]gre3k;
jarring: [a]/ˈdʒɑːrɪŋ/; [adj]剌耳的,震惊的; [n]辗轧声,冲突,震动; [v]受震动而疼痛; [or]gre3k;
jaunty: [a]/ˈdʒɔːnti/; [adj]愉快的,满足的;斯文的;时髦的; [adv]心满意足地,洋洋得意地; [n]心满意足;洋洋得意; [or]gre3k;
jejune: [a]/dʒɪˈdʒuːn/; [adj]空洞的,枯燥无味的;不成熟的;缺乏营养的; [or]gre3k;
jeopardy: [a]/ˈdʒepərdi/; [n]危险;(被告处于被判罪或受处罚的)危险境地; [or]gre3k;
jest: [a]/dʒest/; [n]笑话,俏皮话;玩笑; [v]开玩笑;嘲笑; [or]gre3k;
jettison: [a]/ˈdʒetɪsn/; [v]向外抛弃,投弃(船舶遇难时投弃货物以为减轻负载); [n]抛弃的货物; [or]gre3k;
jibe: [a]/dʒaɪb/; [v]与.一致,嘲笑,调转方向,改变航道; [n]嘲笑,嘲弄; [or]gre3k;
jingoist: [a]/dʒɪŋɡə'ʊɪst/; [n]沙文主义者,侵略主义者; [or]gre3k;
jitters: [a]/ˈdʒɪtərz/; [n]紧张,激动; [v]紧张不安;使激动;抖动(jitter的三单形式);神经过敏地说; [or]gre3k;
jocular: [a]/ˈdʒɑːkjələr/; [adj]搞笑的,欢乐的; [or]gre3k;
jocund: [a]/ˈdʒɑːkənd/; [adj]快活的;高兴的; [or]gre3k;
jog: [a]/dʒɑːɡ/; [v]慢跑;轻碰; [n]轻推,慢跑,漫步; [or]gre3k;
jolt: [a]/dʒoʊlt/; [n]猛的一击,摇晃,震惊; [v](使)颠簸,摇晃;使震惊; [or]gre3k;
jot: [a]/dʒɑːt/; [n]最少量,微不足道的量; [vt]草草记下;匆匆记下; [or]gre3k;
jovial: [a]/ˈdʒoʊviəl/; [adj]天性快活的,主神朱庇特的; [n]左威尔牌手表; [or]gre3k;
jubilant: [a]/ˈdʒuːbɪlənt/; [adj]喜悦的,欢呼的; [or]gre3k;
judicious: [a]/dʒuˈdɪʃəs/; [adj]有判断力的;明智的; [or]gre3k;
juggernaut: [a]/ˈdʒʌɡərnɔːt/; [n]摧毁一切的强大力量,不可抗拒的力量;大型重卡车; [or]gre3k;
kidnap: [a]/ˈkɪdnæp/; [v]诱拐;绑架; [or]gre3k;
kindle: [a]/ˈkɪndl/; [v]点燃,激起;着火;照亮;煽动; [or]gre3k;
kindred: [a]/ˈkɪndrəd/; [n]亲戚,家族,亲属关系,相似; [adj]有血缘关系的,同宗的,同源的,类似的; [or]gre3k;
knack: [a]/næk/; [n]诀窍;本领;熟练技术;巧妙手法; [or]gre3k;
knead: [a]/niːd/; [v]揉捏,塑造; [or]gre3k;
knit: [a]/nɪt/; [v]编结,针织; [n]编织的衣服;针织衫; [or]gre3k;
knotty: [a]/ˈnɑːti/; [adj]有节疤的,有结的;棘手的; [or]gre3k;
kudos: [a]/ˈkuːdəʊs/; [n]荣誉;名望;称赞; [or]gre3k;
labile: [a]/'leɪbəl/; [adj]易变化的,不稳定的,不安定; [n]心境不定; [or]gre3k;
laborious: [a]/ləˈbɔːriəs/; [adj]费时费力的,辛苦的;艰苦的; [or]gre3k;
lacerate: [a]/ˈlæsəreɪt/; [v]划破,撕裂;伤害;使..痛心; [adj]撕碎的;精神深受创伤的;受折磨的; [or]gre3k;
lachrymose: [a]/ˈlækrɪmoʊs/; [adj]落泪的,好哭的;催泪的;悲哀的; [or]gre3k;
lackluster: [a]/ˈlækˌlʌstər/; [n]无光泽;暗淡; [adj]无光泽的;平凡的; [or]gre3k;
laconic: [a]/ləˈkɑːnɪk/; [adj](用词)简洁的;简明的; [adv]简短地,简洁地; [or]gre3k;
lag: [a]/læɡ/; [n]落后,延迟; [v]落后;缓慢进行,减退; [or]gre3k;
lambaste: [a]/læmˈbæst/; [v]痛打;痛骂;严责; [or]gre3k;
lament: [a]/ləˈment/; [v]哀悼;惋惜;悲叹; [n]悲叹;悼词; [or]gre3k;
lamentable: [a]/ˈlæməntəbl/; [adj]可悲的,可怜的,哀伤的; [or]gre3k;
lampoon: [a]/læmˈpuːn/; [n]讽刺文章; [v]讽刺,写文章讽刺; [or]gre3k;
lance: [a]/læns/; [n]长矛; [v]以长矛攻击; [or]gre3k;
languid: [a]/ˈlæŋɡwɪd/; [adj]没精打采的,倦怠的; [or]gre3k;
languish: [a]/ˈlæŋɡwɪʃ/; [v]凋萎,衰弱,变得消瘦; [or]gre3k;
languor: [a]/ˈlæŋɡər/; [n]身心疲惫;柔情;呆滞; [or]gre3k;
lank: [a]/læŋk/; [adj]瘦削的;稀疏的;平直的;细长的; [or]gre3k;
lapse: [a]/læps/; [n]失误,过失;行为失检;(时间)流逝; [v]退步,倒退,衰退;失效;背弃,放弃(宗教信仰); [or]gre3k;
largesse: [a]/lɑːrˈdʒes/; [n]慷慨援助,施舍; [or]gre3k;
lash: [a]/læʃ/; [v]鞭打;猛烈抨击;捆绑;摆动;猛击; [n]鞭梢;鞭打; [or]gre3k;
lassitude: [a]/ˈlæsɪtuːd/; [n]困乏,厌倦,无精打采; [or]gre3k;
latent: [a]/ˈleɪtnt/; [adj]潜在的,隐伏的,不易察觉的; [or]gre3k;
latitude: [a]/ˈlætɪtuːd/; [n]纬度;地区;(言论,行动的)自由; [or]gre3k;
laudatory: [a]/ˈlɔːdətɔːri/; [adj]表扬的,赞扬的; [or]gre3k;
lavish: [a]/ˈlævɪʃ/; [adj]奢华的;铺张浪费的; [v]浪费;慷慨给予; [or]gre3k;
lax: [a]/læks/; [adj]松懈的;松弛的;<语>松弛元音的; [n]松元音;泻肚; [or]gre3k;
leaven: [a]/ˈlevn/; [n]发酵剂,影响力; [v]发酵,影响,渐变; [or]gre3k;
leer: [a]/lɪr/; [v]斜眼看,睨视;抛媚眼; [n]媚眼;恶意的瞥视; [or]gre3k;
leery: [a]/ˈlɪri/; [adj]机警的,狡猾的; [or]gre3k;
legacy: [a]/ˈleɡəsi/; [n]遗赠(物);遗产; [or]gre3k;
legend: [a]/ˈledʒənd/; [n]传说,传奇人物;(奖章纪念牌等的)铭文;地图的图例,插图的说明; [or]gre3k;
legion: [a]/ˈliːdʒən/; [n](古罗马)军团,众多,军队; [adj]众多的,大量的; [or]gre3k;
lenient: [a]/ˈliːniənt/; [adj]宽大的,宽容的,仁慈的; [or]gre3k;
lethal: [a]/ˈliːθl/; [adj]致命的,致死的;杀伤性的; [n]致死因子; [or]gre3k;
lethargic: [a]/ləˈθɑːrdʒɪk/; [adj]困倦的,无力的,无兴趣的; [or]gre3k;
levelheaded: [a]/'levəl'hedɪd/; [adj]稳健的,头脑冷静的,明智的; [or]gre3k;
levity: [a]/ˈlevəti/; [n]轻率,轻浮,多变,不稳定; [or]gre3k;
liability: [a]/ˌlaɪəˈbɪləti/; [n]责任;债务;倾向;可能性;不利因素;惹麻烦的人(或事); [or]gre3k;
liberal: [a]/ˈlɪbərəl/; [n]开明的人,自由主义者; [adj]慷慨的;心胸宽阔的;自由主义的; [or]gre3k;
libertine: [a]/ˈlɪbərtiːn/; [n]性行为放纵者,浪荡子;自由思想家; [adj]放荡的; [or]gre3k;
license: [a]/ˈlaɪsns/; [n]许可;执照; [v]许可,准许;发许可证; [or]gre3k;
licentious: [a]/laɪˈsenʃəs/; [adj]纵欲的,放肆的; [or]gre3k;
liken: [a]/ˈlaɪkən/; [v]把..比作,比拟; [or]gre3k;
limber: [a]/ˈlɪmbər/; [adj]松软的,柔软的;可塑的; [n](炮车的)拖车; [or]gre3k;
limp: [a]/lɪmp/; [n]跛行; [vi]一瘸一拐地走,跛行;慢腾腾地进行; [adj]无力的,无生气的;柔软的,软弱的; [or]gre3k;
limpid: [a]/ˈlɪmpɪd/; [adj]清澈的,透明的,平静的; [or]gre3k;
linger: [a]/ˈlɪŋɡər/; [v]逗留,留恋; [or]gre3k;
lionize: [a]/ˈlaɪənaɪz/; [v]崇拜,把..奉为名人; [or]gre3k;
lissome: [a]/'lɪsəm/; [adj]柔软的,敏捷的,轻盈的; [or]gre3k;
lithe: [a]/laɪð/; [adj]轻盈的(等于lithesome);柔软的;易弯曲的; [or]gre3k;
loath: [a]/loʊθ/; [adj]不愿意的; [or]gre3k;
loathe: [a]/loʊð/; [v]憎恨,厌恶; [or]gre3k;
lofty: [a]/ˈlɔːfti/; [adj]极高的,巍峨的;崇高的;高傲的; [or]gre3k;
loll: [a]/lɑːl/; [vi]懒洋洋地倚靠;闲荡; [vt]懒洋洋地倚靠着;使悬垂; [or]gre3k;
lopsided: [a]/ˌlɑːpˈsaɪdɪd/; [adj]不平衡的,倾向一方的; [or]gre3k;
loquacious: [a]/ləˈkweɪʃəs/; [adj]多话的;饶舌的;冗长的;(水)潺潺不息的; [or]gre3k;
loutish: [a]/ˈlaʊtɪʃ/; [adj]粗野的,笨拙的,无礼的; [or]gre3k;
lubricate: [a]/ˈluːbrɪkeɪt/; [v]使.润滑;给.加润滑油; [or]gre3k;
lucid: [a]/ˈluːsɪd/; [adj]明晰的;透明的;易懂的;头脑清楚的; [or]gre3k;
ludicrous: [a]/ˈluːdɪkrəs/; [adj]荒谬的,可笑的,滑稽的; [or]gre3k;
lug: [a]/lʌɡ/; [n]耳状物;把手;笨家伙; [v]拖拉; [or]gre3k;
lugubrious: [a]/ləˈɡuːbriəs/; [adj]闷闷不乐的;郁郁寡欢的,悲哀的; [or]gre3k;
lull: [a]/lʌl/; [v]使平静,使安静,哄骗; [n]间歇,暂停,暂时平静; [or]gre3k;
lullaby: [a]/ˈlʌləbaɪ/; [n]催眠曲,摇篮曲,轻柔的声音; [v]唱催眠曲使入睡; [or]gre3k;
lumber: [a]/ˈlʌmbər/; [v]缓慢地移动;拖累,迫使担负;伐木;杂乱地堆积;隆隆地行进; [n]木材;废旧家具,不用的大件物品;无用的杂物;隆隆声; [or]gre3k;
luminary: [a]/ˈluːmɪneri/; [n]杰出人物,发光体; [or]gre3k;
luminous: [a]/ˈluːmɪnəs/; [adj]发光的;鲜艳的;明亮的;夜光的; [or]gre3k;
lurch: [a]/lɜːrtʃ/; [n]突然倾斜,挫折,举步蹒跚,徘徊,困境; [v]惨败,倾斜,徘徊,击败; [or]gre3k;
lurid: [a]/ˈlʊrɪd/; [adj](暴力,性爱等)耸人听闻的; [or]gre3k;
lurk: [a]/lɜːrk/; [n]潜伏,潜行; [vi]潜伏;潜藏;鬼鬼祟祟地走; [or]gre3k;
lush: [a]/lʌʃ/; [adj]草木茂盛的,多的,丰富豪华的; [n]酒;醉汉; [or]gre3k;
lustrous: [a]/ˈlʌstrəs/; [adj]有光泽的;光辉的; [or]gre3k;
luxurious: [a]/lʌɡˈʒʊriəs/; [adj]奢侈的,豪华的; [or]gre3k;
lyric: [a]/ˈlɪrɪk/; [n]抒情诗;歌词; [adj](供)吟唱的;抒情的; [or]gre3k;
macabre: [a]/məˈkɑːbrə/; [adj]骇人的,可怖的; [or]gre3k;
macerate: [a]/ˈmæsəreɪt/; [v]浸软,消瘦; [or]gre3k;
machination: [a]/ˌmækəˈneɪʃn/; [n]阴谋; [or]gre3k;
madcap: [a]/ˈmædkæp/; [n]热爱冒险的人; [adj]大胆的,鲁莽的; [or]gre3k;
maelstrom: [a]/ˈmeɪlstrɑːm/; [n]大漩涡;灾祸;不可抗的破坏力; [or]gre3k;
magnificent: [a]/mæɡˈnɪfɪsnt/; [adj]华丽的,宏伟的,壮丽的; [or]gre3k;
magnitude: [a]/ˈmæɡnɪtuːd/; [n]巨大;震级;重要性;<数>量值; [or]gre3k;
maladroit: [a]/ˌmæləˈdrɔɪt/; [adj]笨拙的; [or]gre3k;
malaise: [a]/məˈleɪz/; [n]不舒服;心神不安; [or]gre3k;
malcontent: [a]/ˌmælkənˈtent/; [n]不满分子,反抗者; [adj]不满的,不服的; [or]gre3k;
malevolent: [a]/məˈlevələnt/; [adj]有恶意的,恶毒的; [or]gre3k;
malicious: [a]/məˈlɪʃəs/; [adj]怀恶意的,恶毒的; [or]gre3k;
malign: [a]/məˈlaɪn/; [v]诽谤,中伤; [adj]邪恶的;有害的; [or]gre3k;
malignant: [a]/məˈlɪɡnənt/; [adj]恶性的,恶毒的,充满恨意的; [n]怀有恶意的人;保王党员; [or]gre3k;
malinger: [a]/məˈlɪŋɡər/; [v]装病以逃避工作; [or]gre3k;
malleable: [a]/ˈmæliəbl/; [adj](金属)可锻的;有延展性的;(性格)可训练的;易适应的; [or]gre3k;
malodorous: [a]/ˌmælˈoʊdərəs/; [adj]有恶臭的;令人极为反感的;不合法的; [or]gre3k;
mandatory: [a]/ˈmændətɔːri/; [adj]命令的,强制性的; [or]gre3k;
maneuver: [a]/məˈnʊvər/; [v]操纵; [n]操纵;花招;调遣;策略; [or]gre3k;
mangle: [a]/ˈmæŋɡl/; [v]损毁,使伤残,弄砸; [n]轧布机; [or]gre3k;
mangy: [a]/ˈmeɪndʒi/; [adj]污秽的;疥癣的;肮脏的; [or]gre3k;
mania: [a]/ˈmeɪniə/; [n]癫狂,狂热; [or]gre3k;
manifest: [a]/ˈmænɪfest/; [adj]显然的,明白无误的,明了的; [v]使显现,使显露,表明; [n]货单,旅客名单; [or]gre3k;
manipulate: [a]/məˈnɪpjuleɪt/; [v]操纵,影响;正骨; [or]gre3k;
mannered: [a]/ˈmænərd/; [adj]装模作样的,矫揉造作的,墨守成规的,中规中矩的; [or]gre3k;
manumit: [a]/ˌmænjə'mɪt/; [v]解放(奴隶); [or]gre3k;
manuscript: [a]/ˈmænjuskrɪpt/; [n]手稿;底稿;手抄本; [or]gre3k;
mar: [a]/mɑːr/; [v]毁坏,弄糟,玷污; [or]gre3k;
marginal: [a]/ˈmɑːrdʒɪnl/; [adj]微小的,不重要的;仅以微弱多数票获胜的; [n](议会或地方委员会的)边缘席位; [or]gre3k;
marsh: [a]/mɑːrʃ/; [n]湿地;沼泽; [or]gre3k;
martinet: [a]/ˌmɑːrtnˈet/; [n]纪律严明之人; [or]gre3k;
marvel: [a]/ˈmɑːrvl/; [n]奇迹,奇景;奇才; [v]惊叹,吃惊,诧异; [or]gre3k;
mash: [a]/mæʃ/; [v]捣碎; [n]糊状物; [or]gre3k;
masquerade: [a]/ˌmæskəˈreɪd/; [n]化装舞会;伪装,假扮; [vi]假扮; [or]gre3k;
mastery: [a]/ˈmæstəri/; [n]权力;优势;精通,掌握; [or]gre3k;
matriculate: [a]/məˈtrɪkjuleɪt/; [n]被录取者; [v]准许.入学; [or]gre3k;
maudlin: [a]/ˈmɔːdlɪn/; [adj]感情脆弱的;容易流泪的;酒后伤感的; [or]gre3k;
maverick: [a]/ˈmævərɪk/; [n]独行者,想法与众不同的人; [adj]行为不合常规的; [v]用不正当手段获取;迷路; [or]gre3k;
mawkish: [a]/ˈmɔːkɪʃ/; [adj]令人厌恶的,伤感的; [or]gre3k;
meager: [a]/ˈmiːɡər/; [adj]瘦的;贫乏的;粗劣的;少量的; [or]gre3k;
meander: [a]/miˈændər/; [n]蜿蜒曲折,迂回曲折的旅程;漫步; [v]迂回曲折;漫步;漫谈; [or]gre3k;
meddle: [a]/ˈmedl/; [vi]干预,多管闲事; [or]gre3k;
mediate: [a]/ˈmiːdieɪt/; [v]调解,调停,斡旋; [or]gre3k;
mediocre: [a]/ˌmiːdiˈoʊkər/; [adj]普通的;平凡的;中等的; [or]gre3k;
meditate: [a]/ˈmedɪteɪt/; [v]考虑,沉思,冥想; [or]gre3k;
medley: [a]/ˈmedli/; [adj]大杂烩,混合物; [n]混合;混杂;混合物; [or]gre3k;
meek: [a]/miːk/; [adj]温顺的,逆来顺受的;谦恭的; [n]温顺的人;谦恭的人; [or]gre3k;
mellifluous: [a]/meˈlɪfluəs/; [adj](曲调)优美的;流畅的;如蜜般的; [or]gre3k;
melodramatic: [a]/ˌmelədrəˈmætɪk/; [adj]夸张的,情节剧的,戏剧似的; [or]gre3k;
menace: [a]/ˈmenəs/; [v]威胁,威吓; [n]威胁;具有危险性的人(或物); [or]gre3k;
mendacious: [a]/menˈdeɪʃəs/; [adj]撒谎的,虚假的; [or]gre3k;
menial: [a]/ˈmiːniəl/; [adj]仆人的,乏味的; [n]家仆; [or]gre3k;
mentor: [a]/ˈmentɔːr/; [n]导师,指导; [vt]做.的良师;指导; [or]gre3k;
mercenary: [a]/ˈmɜːrsəneri/; [n]外国雇佣兵;唯利是图者; [adj]唯利是图的;雇佣的; [or]gre3k;
mercurial: [a]/mɜːrˈkjʊriəl/; [adj](情绪)善变的; [or]gre3k;
merited: [a]/ˈmerɪtɪd/; [adj]应得的,理所当然的; [or]gre3k;
mesh: [a]/meʃ/; [n]网,筛孔; [v]相啮合; [or]gre3k;
metamorphose: [a]/ˌmetəˈmɔːrfoʊz/; [v]使变形,使变质; [or]gre3k;
metaphysical: [a]/ˌmetəˈfɪzɪkl/; [adj]形而上学的;超自然的;玄学派诗歌的; [or]gre3k;
meteoric: [a]/ˌmiːtiˈɔːrɪk/; [adj]流星的,转瞬即逝的,突然的; [or]gre3k;
methodical: [a]/məˈθɑːdɪkl/; [adj]有系统的,有方法的; [or]gre3k;
meticulous: [a]/məˈtɪkjələs/; [adj]谨小慎微的;一丝不苟的; [or]gre3k;
mettle: [a]/ˈmetl/; [n]勇气,毅力,耐力; [or]gre3k;
miff: [a]/mɪf/; [n]微怒,小争执; [v]使..恼怒; [adj]有点恼火;有点不高兴; [or]gre3k;
migratory: [a]/ˈmaɪɡrətɔːri/; [adj]迁移的;流浪的; [or]gre3k;
milieu: [a]/mɪlˈjuː/; [n]周围环境;背景;周围;出身背景; [or]gre3k;
military: [a]/ˈmɪləteri/; [n]军队; [adj]军事的; [or]gre3k;
mime: [a]/maɪm/; [n]哑剧演员,小丑,笑剧,丑角; [v]作摹拟表演; [or]gre3k;
mimic: [a]/ˈmɪmɪk/; [v]模仿,戏弄; [n]模仿者; [adj]模拟的;假的,伪装的; [or]gre3k;
minatory: [a]/ˈmɪnətɔːri/; [adj]带来威胁的,有凶兆的; [or]gre3k;
mince: [a]/mɪns/; [v]切碎,小步走路; [n]切碎物; [or]gre3k;
mingle: [a]/ˈmɪŋɡl/; [v]使混合,使相混; [vi]相交往,相往来; [or]gre3k;
minimize: [a]/ˈmɪnɪmaɪz/; [v]使缩到最小;达到最低值; [or]gre3k;
miniscule: [a]/'mɪnəˌskjuːl/; [adj]极小的;草写小字的; [n](中世纪古抄本的)小书写体; [or]gre3k;
mint: [a]/mɪnt/; [n]薄荷,薄荷糖,造币厂; [v]铸造(硬币); [or]gre3k;
minutia: [a]/mɪ'njuːʃɪə/; [n]次要的细节,小事; [or]gre3k;
mirage: [a]/məˈrɑːʒ/; [n]幻影,海市蜃楼; [or]gre3k;
mire: [a]/ˈmaɪər/; [n]泥沼,困境; [or]gre3k;
mirth: [a]/mɜːrθ/; [n]欢乐,欢笑; [or]gre3k;
misanthropic: [a]/ˌmɪsənˈθrɑːpɪk/; [adj]厌恶人类的,不愿与人来往的; [or]gre3k;
misapprehension: [a]/ˌmɪsæprɪˈhenʃn/; [n]错误的理解,错误的判断; [or]gre3k;
misbehaving: [a]/ˌmɪsbɪˈheɪvɪŋ/; [adj]调皮的,行为不端的; [or]gre3k;
mischievous: [a]/ˈmɪstʃɪvəs/; [adj]狡猾的;调皮的;有害的; [or]gre3k;
misconstrue: [a]/ˌmɪskənˈstruː/; [v]误解,曲解; [or]gre3k;
miscreant: [a]/ˈmɪskriənt/; [n]恶棍,歹徒; [or]gre3k;
misdemeanor: [a]/ˌmɪsdɪ'miːnə/; [n]轻罪,品行不端; [or]gre3k;
miserly: [a]/ˈmaɪzərli/; [adj]贪财的,吝啬的; [or]gre3k;
misfortune: [a]/ˌmɪsˈfɔːrtʃuːn/; [n]不幸,灾祸; [or]gre3k;
misgiving: [a]/ˌmɪsˈɡɪvɪŋ/; [n]疑虑; [vt]担忧;使.疑虑;害怕(misgive的变形); [or]gre3k;
mishap: [a]/ˈmɪshæp/; [n]不幸的事,灾祸;晦气; [or]gre3k;
misrepresent: [a]/ˌmɪsˌreprɪˈzent/; [vi]作虚假陈述; [vt]歪曲;误传; [or]gre3k;
mite: [a]/maɪt/; [n]极小量,小虫; [or]gre3k;
mitigate: [a]/ˈmɪtɪɡeɪt/; [v]减轻,缓和; [or]gre3k;
mobile: [a]/ˈmoʊbl/; [n]风铃,悬挂饰物;手机,移动电话; [adj]可移动的;行动方便的; [or]gre3k;
mockery: [a]/ˈmɑːkəri/; [n]嘲弄;笑柄;徒劳无功;拙劣可笑的模仿或歪曲; [or]gre3k;
moderate: [a]/ˈmɑːdərət/; [adj]适度的,适中的,温和的,稳健的,中等的; [v]使减轻,使缓和; [n]温和主义者;稳健的人; [or]gre3k;
mollify: [a]/ˈmɑːlɪfaɪ/; [v]安慰,安抚; [or]gre3k;
mollycoddle: [a]/ˈmɑːlikɑːdl/; [v]溺爱,娇惯; [n]娇生惯养的人; [or]gre3k;
molt: [a]/moʊlt/; [v]脱毛,换毛; [n]换羽期,脱毛期; [or]gre3k;
momentum: [a]/moʊˈmentəm/; [n](物理)动量;势头;动力; [or]gre3k;
monarch: [a]/ˈmɑːnərk/; [n]君主;帝王;统治者; [or]gre3k;
mongrel: [a]/ˈmʌŋɡrəl/; [n]杂种动物,混血儿; [adj]杂种的;杂交的;混血的; [or]gre3k;
monochromatic: [a]/ˌmɑːnəkroʊˈmætɪk/; [adj]<物>单色的; [or]gre3k;
monologue: [a]/ˈmɑːnəlɔːɡ/; [n]独白,个人长篇演说; [or]gre3k;
monopolize: [a]/məˈnɑːpəlaɪz/; [vt]垄断;独占,全部占有; [or]gre3k;
monotonous: [a]/məˈnɑːtənəs/; [adj]单调的,无聊的; [or]gre3k;
montage: [a]/ˌmɑːnˈtɑːʒ/; [n]蒙太奇(电影的基本结构手段和叙事方式),混合画,拼集的照片; [or]gre3k;
moratorium: [a]/ˌmɔːrəˈtɔːriəm/; [n]暂停,中止;<金融>延期偿付; [or]gre3k;
morbid: [a]/ˈmɔːrbɪd/; [adj]疾病的;(精神等)病态的;恐怖的; [or]gre3k;
moribund: [a]/ˈmɔːrɪbʌnd/; [adj]濒临失败的,垂死的; [n]垂死的人; [or]gre3k;
morose: [a]/məˈroʊs/; [adj]脾气坏的,乖戾的,不高兴的; [or]gre3k;
mosaic: [a]/moʊˈzeɪɪk/; [n]镶嵌细工,马赛克; [adj]摩西的;拼花的; [vt]镶嵌;用马赛克装饰; [or]gre3k;
mosque: [a]/mɑːsk/; [n]伊斯兰教寺院;清真寺; [or]gre3k;
motile: [a]/'moʊtɪl/; [adj]<生理>能动的,显示活力的; [n]运动型; [or]gre3k;
motivate: [a]/ˈmoʊtɪveɪt/; [vt]激励;使有动机;促进;促动;激发..的积极性; [or]gre3k;
motley: [a]/ˈmɑːtli/; [adj]混杂的,杂色的; [n]混杂;杂色衣服;小丑; [or]gre3k;
mottle: [a]/'mɒtəl/; [n]斑点,杂色,斑驳; [v]使呈杂色,使显得斑驳陆离; [or]gre3k;
motto: [a]/ˈmɑːtoʊ/; [n]座右铭;格言;箴言;口号; [or]gre3k;
mournful: [a]/ˈmɔːrnfl/; [adj]悲哀的; [or]gre3k;
movement: [a]/ˈmuːvmənt/; [n]动作,移动;运动;(交响乐)乐章; [or]gre3k;
muddy: [a]/ˈmʌdi/; [adj]泥泞的;暗淡的;浑浊的; [v]使粘上烂泥;显得扑朔迷离; [or]gre3k;
muffle: [a]/ˈmʌfl/; [v]蒙住,裹住,抑制,发低沉的声音; [n]低沉的声音,消声器,包裹物(如头巾,围巾等),唇鼻部; [or]gre3k;
mumble: [a]/ˈmʌmbl/; [v]含糊地说;抿着嘴嚼; [n]含糊的话;咕噜; [or]gre3k;
mundane: [a]/mʌnˈdeɪn/; [adj]普通的,平凡的;单调的;现世的,世俗的; [or]gre3k;
munificent: [a]/mjuːˈnɪfɪsnt/; [adj]慷慨的,大方的; [or]gre3k;
murky: [a]/ˈmɜːrki/; [adj]黑暗的,朦胧的; [adv]阴暗地,混浊地,可疑地; [n]阴暗;昏暗;混浊;可疑; [or]gre3k;
murmur: [a]/ˈmɜːrmər/; [v]低声说,低语;低声抱怨; [n]低语;喃喃说话声; [or]gre3k;
mutate: [a]/ˈmjuːteɪt/; [v]变异; [or]gre3k;
mute: [a]/mjuːt/; [n]弱音器; [adj]缄默的;哑的; [vt]减弱.的声音; [or]gre3k;
mutter: [a]/ˈmʌtər/; [n]低语;小声抱怨; [v]低声说;小声抱怨; [vt]低声说;抱怨地说; [or]gre3k;
myopic: [a]/maɪˈɑːpɪk/; [n]近视; [adj]近视的;目光短浅的; [or]gre3k;
myriad: [a]/ˈmɪriəd/; [n]无数;极大数量; [adj]无数的; [or]gre3k;
nadir: [a]/ˈneɪdɪr/; [n]最低点,无底; [or]gre3k;
naive: [a]/naɪˈiːv/; [adj]天真的; [n]天真的人; [or]gre3k;
narcissism: [a]/ˈnɑːrsɪsɪzəm/; [n]自恋,自爱; [or]gre3k;
nascent: [a]/ˈnæsnt/; [adj]初生的,萌芽的;发生中的; [or]gre3k;
natty: [a]/ˈnæti/; [adj]整洁的,干净的,潇洒的; [or]gre3k;
nauseate: [a]/ˈnɔːzieɪt/; [v]使作呕,产生恶感; [or]gre3k;
nautical: [a]/ˈnɔːtɪkl/; [adj]航海的;海上的;海员的; [or]gre3k;
nebulous: [a]/ˈnebjələs/; [adj]朦胧的,星云的,星云状的; [or]gre3k;
needy: [a]/ˈniːdi/; [adj]贫困的;贫穷的;生活艰苦的; [or]gre3k;
nefarious: [a]/nɪˈferiəs/; [adj]违法的,邪恶的; [or]gre3k;
negation: [a]/nɪˈɡeɪʃn/; [n]否定,拒绝;反面; 对立面; [or]gre3k;
negligent: [a]/ˈneɡlɪdʒənt/; [adj]疏忽的,粗心大意的;随意的; [or]gre3k;
negotiate: [a]/nɪˈɡoʊʃieɪt/; [v]谈判,交涉,商议;成功越过,渡过; [or]gre3k;
neophyte: [a]/ˈniːəfaɪt/; [n]新信徒;新入教者;初学者; [or]gre3k;
nerve: [a]/nɜːrv/; [n]神经;胆量,勇气; [v]给.以力量,使振作; [or]gre3k;
nettle: [a]/ˈnetl/; [v]刺激;惹恼;用荨麻刺; [n]荨麻; [or]gre3k;
neutralize: [a]/ˈnuːtrəlaɪz/; [v]宣布中立,使中立化;使无效;中和; [or]gre3k;
nexus: [a]/ˈneksəs/; [n]关系;连结; [or]gre3k;
nibble: [a]/ˈnɪbl/; [v]一点点地咬,慢慢啃,吹毛求疵; [n]细咬,轻咬,啃; [or]gre3k;
nicety: [a]/ˈnaɪsəti/; [n]细节,讲究; [or]gre3k;
nil: [a]/nɪl/; [n]零;无; [or]gre3k;
nip: [a]/nɪp/; [v]咬;捏;剪断;冻伤;阻止; [n]夹;捏;刺骨;小饮; [or]gre3k;
nirvana: [a]/nɪrˈvɑːnə/; [n]涅槃,心灵的平静,极乐; [or]gre3k;
nitpick: [a]/'nɪtpɪk/; [v]挑剔,吹毛求疵; [or]gre3k;
nocturnal: [a]/nɑːkˈtɜːrnl/; [adj]夜晚的,夜间发生的; [or]gre3k;
noisome: [a]/ˈnɔɪsəm/; [adj]恶臭的;令人不快的; [or]gre3k;
nomad: [a]/ˈnoʊmæd/; [n]流浪者,游牧民; [adj]游牧的;流浪的; [or]gre3k;
nominal: [a]/ˈnɑːmɪnl/; [adj]名义上的;象征性的,很少的;名词性的; [or]gre3k;
nonchalant: [a]/ˌnɑːnʃəˈlɑːnt/; [adj]若无其事的;满不在乎的;冷静的;冷漠的; [or]gre3k;
nondescript: [a]/ˈnɑːndɪskrɪpt/; [adj]没有特征的,难以形容的,难以归类的; [n]难以名状,不属任何型类的人; [or]gre3k;
nonentity: [a]/nɑːˈnentəti/; [n]不存在,虚无;无能力之人,无足轻重的人; [or]gre3k;
nonplus: [a]/ˌnɒn'plʌs/; [v]使窘困;使迷惑;狼狈不堪; [n]迷惑,困惑; [or]gre3k;
nonsense: [a]/ˈnɑːnsens/; [n]胡说,废话; [or]gre3k;
nostalgia: [a]/nəˈstældʒə/; [n]怀旧之情,思乡病; [or]gre3k;
notch: [a]/nɑːtʃ/; [n]刻痕,凹口;等级;峡谷; [v]赢得;用刻痕计算;在.上刻凹痕; [or]gre3k;
nourish: [a]/ˈnɜːrɪʃ/; [v]养育;培育(希望);增强(希望); [or]gre3k;
novel: [a]/ˈnɑːvl/; [n]小说,长篇故事; [adj]新奇的,新颖的,不同的; [or]gre3k;
novice: [a]/ˈnɑːvɪs/; [n]生手,新手; [or]gre3k;
noxious: [a]/ˈnɑːkʃəs/; [adj]有害的,有毒的; [or]gre3k;
nuance: [a]/ˈnuːɑːns/; [n]细微差别; [or]gre3k;
nudge: [a]/nʌdʒ/; [v](用臂肘)轻推(促其注意),鼓动,接近; [n]推动,用肘轻推; [or]gre3k;
nugatory: [a]/ˈnuːɡətɔːri/; [adj]无价值的,琐碎的,无效的,无法律效力的; [or]gre3k;
nullification: [a]/ˌnʌləfə'keɪʃən/; [n]废弃,取消,(美)州对联邦法令的拒绝执行或承认; [or]gre3k;
numb: [a]/nʌm/; [adj]麻木的,失去知觉的; [vt]使麻木,使失去知觉; [or]gre3k;
nurture: [a]/ˈnɜːrtʃər/; [v]养育,培育;培植; [n]养育,培养;教养;营养物; [or]gre3k;
oaf: [a]/oʊf/; [n]愚蠢的人; [or]gre3k;
oath: [a]/oʊθ/; [n]誓言;誓约;咒骂;咒语; [or]gre3k;
obdurate: [a]/ˈɑːbdərət/; [adj]固执的,冷酷无情的; [or]gre3k;
obedient: [a]/oʊˈbiːdiənt/; [adj]服从的,顺从的;孝顺的; [or]gre3k;
obeisance: [a]/oʊˈbiːsns/; [n]鞠躬,敬礼;尊敬; [or]gre3k;
obfuscate: [a]/ˈɑːbfʌskeɪt/; [v]使复杂;使迷乱,使模糊;弄暗; [or]gre3k;
obligatory: [a]/əˈblɪɡətɔːri/; [adj]强制性的;义务的;必须的; [or]gre3k;
obliging: [a]/əˈblaɪdʒɪŋ/; [adj]乐于助人的;有礼貌的;体贴的;亲切的; [or]gre3k;
oblique: [a]/əˈbliːk/; [adj]斜的,非直角的,隐射的; [v]倾斜; [n]<解>斜肌(尤指腹部的肌肉);倾斜物;<军>倾斜航空照片; [adv]<军>以45度角; [or]gre3k;
obliterate: [a]/əˈblɪtəreɪt/; [v]消灭;涂去;冲刷;忘掉; [or]gre3k;
oblivious: [a]/əˈblɪviəs/; [adj]不在意的;忘却的,健忘的; [or]gre3k;
obloquy: [a]/ˈɑːbləkwi/; [n]毁谤;耻辱;漫骂; [or]gre3k;
obscure: [a]/əbˈskjʊr/; [v]隐藏,使.模糊;使变暗;遮掩; [adj]不清楚的;难以理解的; [n]某种模糊的或不清楚的东西; [or]gre3k;
obsequious: [a]/əbˈsiːkwiəs/; [adj]逢迎的,谄媚的; [or]gre3k;
observant: [a]/əbˈzɜːrvənt/; [adj]机警的;严格遵守的;善于观察的; [or]gre3k;
obsess: [a]/əbˈses/; [vt]迷住,使着迷,使烦扰; [or]gre3k;
obsolete: [a]/ˌɑːbsəˈliːt/; [adj]已过时的;已废弃的; [v]使过时;使作废; [n]废词;被废弃的事物; [or]gre3k;
obstinate: [a]/ˈɑːbstɪnət/; [adj]顽固的;较难治愈的; [or]gre3k;
obstreperous: [a]/əbˈstrepərəs/; [adj]吵闹的,喧嚣的;难驾驭的; [or]gre3k;
obstruct: [a]/əbˈstrʌkt/; [v]阻碍,妨碍,阻塞,堵塞; [or]gre3k;
obtuse: [a]/əbˈtuːs/; [adj]迟钝的;圆头的;不锋利的; [or]gre3k;
obviate: [a]/ˈɑːbvieɪt/; [v]排除,避免,消除; [or]gre3k;
occult: [a]/əˈkʌlt/; [adj]秘密的,神秘的,玄妙的; [n]神秘学; [vt]隐蔽;<天>(使)掩(星); [vi]定时隐蔽; [or]gre3k;
odium: [a]/ˈoʊdiəm/; [n]憎恶,反感; [or]gre3k;
off-key: [a]/ˌɔːf ˈkiː/; [adj]不和谐的;走音的;不恰当的; [or]gre3k;
offbeat: [a]/ˌɔːfˈbiːt/; [adj]离奇的;标新立异的;<乐>弱拍的;离奇的;标新立异的; [or]gre3k;
officious: [a]/əˈfɪʃəs/; [adj]多管闲事的,非官方的; [adv]过分殷勤地; [n]过分殷勤,爱管闲事; [or]gre3k;
offish: [a]/'ɔːfɪʃ/; [adj]冷淡的,疏远的; [or]gre3k;
ominous: [a]/ˈɑːmɪnəs/; [adj]不祥的,不吉利的; [or]gre3k;
omniscient: [a]/ɑːmˈnɪsiənt/; [adj]无所不知的,博识的; [n]无所不知者,上帝; [or]gre3k;
onerous: [a]/ˈɑːnərəs/; [adj]繁重的,麻烦的;负有义务的;负有法律责任的; [or]gre3k;
onset: [a]/ˈɑːnset/; [n]开始;攻击,袭击; [or]gre3k;
opaque: [a]/oʊˈpeɪk/; [adj]不透明的;难懂的; [or]gre3k;
opine: [a]/oʊˈpaɪn/; [v]以为;想; [or]gre3k;
opportune: [a]/ˌɑːpərˈtuːn/; [adj]适当的,恰好的,合时宜的; [or]gre3k;
opprobrious: [a]/əˈproʊbriəs/; [adj]辱骂的;无礼的;可耻的; [or]gre3k;
oration: [a]/ɔːˈreɪʃn/; [n]演说;致辞;叙述法; [or]gre3k;
ordeal: [a]/ɔːrˈdiːl/; [n]严峻考验,苦难的经历,折磨; [or]gre3k;
orient: [a]/ˈɔːrient/; [n][the Orient]东方; [v]定..的方位; [adj]东方的;(太阳等)上升的,新生的;闪闪发光的; [or]gre3k;
original: [a]/əˈrɪdʒənl/; [adj]有独创性的,原始的,最初的,新颖的; [n]原件;怪人; [or]gre3k;
orthodox: [a]/ˈɔːrθədɑːks/; [adj]正统的;传统的;(Orthodox)东正教的; [or]gre3k;
oscillate: [a]/ˈɑːsɪleɪt/; [v]摆动,犹豫; [or]gre3k;
ossify: [a]/ˈɑːsɪfaɪ/; [v]硬化,骨化; [or]gre3k;
ostensible: [a]/ɑːˈstensəbl/; [adj]表面上的,伪装的; [or]gre3k;
ostentatious: [a]/ˌɑːstenˈteɪʃəs/; [adj]浮华的,虚饰的,外观美丽的; [or]gre3k;
ostracize: [a]/ˈɑːstrəsaɪz/; [v]放逐,排斥,(古希腊)按贝壳流放法放逐; [or]gre3k;
oust: [a]/aʊst/; [v]罢免,驱逐,剥夺,取代; [or]gre3k;
outgoing: [a]/ˈaʊtɡoʊɪŋ/; [adj]外向的;外出的;乐于助人的;即将离职的,卸任的; [n]流出;开支; [or]gre3k;
outgrowth: [a]/ˈaʊtɡroʊθ/; [n]结果;副产物;自然的发展;分枝; [or]gre3k;
outlandish: [a]/aʊtˈlændɪʃ/; [adj]稀奇古怪的,奇特的;异国风情的; [or]gre3k;
outmaneuver: [a]/ˌaʊtməˈnuvər/; [v]以计谋胜过;运用策略击败; [or]gre3k;
outmoded: [a]/ˌaʊtˈmoʊdɪd/; [adj]不再流行的,过时的; [or]gre3k;
outset: [a]/ˈaʊtset/; [n]开始,开端; [or]gre3k;
outwit: [a]/ˌaʊtˈwɪt/; [v]以机智胜过; [or]gre3k;
overbearing: [a]/ˌoʊvərˈberɪŋ/; [adj]专横的,独断的,傲慢的; [or]gre3k;
overlap: [a]/ˌoʊvərˈlæp/; [n]重叠,重复; [v](部分地)重叠; [or]gre3k;
overshadow: [a]/ˌoʊvərˈʃædoʊ/; [v]遮蔽,使显得不重要; [or]gre3k;
overt: [a]/oʊˈvɜːrt/; [adj]明显的;公开的;公然的; [or]gre3k;
overture: [a]/ˈoʊvərtʃər/; [n]主动表示,姿态;前奏曲;序言,事件的开端;提出问题; [vt]作为一种主动姿态提出;向.提出建议; [or]gre3k;
overwhelm: [a]/ˌoʊvərˈwelm/; [v]压垮;不知所措;淹没;打败,压倒; [or]gre3k;
overwrought: [a]/ˌoʊvərˈrɔːt/; [adj]过分紧张的,过度兴奋的; [or]gre3k;
pacify: [a]/ˈpæsɪfaɪ/; [v]使平静,安慰,抚慰; [or]gre3k;
padding: [a]/ˈpædɪŋ/; [n]衬垫,填料;夸张;废话; [v]给.装衬垫,加垫子; [or]gre3k;
paean: [a]/ˈpiːən/; [n]欢乐颂,赞美歌; [or]gre3k;
painstaking: [a]/ˈpeɪnzteɪkɪŋ/; [adj](不辞)劳苦的,辛勤的; [n]辛劳,煞费苦心; [or]gre3k;
palatable: [a]/ˈpælətəbl/; [adj]美味的,合口味的,合心意的; [or]gre3k;
palatial: [a]/pəˈleɪʃl/; [adj]宫殿般的;宏伟的; [or]gre3k;
palaver: [a]/pəˈlɑːvər/; [n]废话;奉承;诱骗;谈判; [v]闲谈;哄骗,笼络; [or]gre3k;
pall: [a]/pɔːl/; [n]幕;棺罩;遮盖物; [v]覆盖;使乏味;走味; [or]gre3k;
palliate: [a]/ˈpælieɪt/; [v]减轻,掩饰,辩解; [or]gre3k;
pallid: [a]/ˈpælɪd/; [adj]苍白的,病态的,无生气的; [or]gre3k;
palpable: [a]/ˈpælpəbl/; [adj]明显的,易觉察的,可触知的; [or]gre3k;
palpitation: [a]/ˌpælpə'teɪʃən/; [n]<内科>心悸;跳动;颤动; [or]gre3k;
palter: [a]/'pɔːltə/; [v]含糊其词;玩弄;讨价还价,争论不休; [or]gre3k;
paltry: [a]/ˈpɔːltri/; [adj]不足取的,无价值的,琐碎的,卑鄙的; [or]gre3k;
pan: [a]/pæn/; [n]平底锅; [v]严厉批评;淘金; [or]gre3k;
panacea: [a]/ˌpænəˈsiːə/; [n]灵丹妙药,万能药; [or]gre3k;
panache: [a]/pəˈnæʃ/; [n]羽饰,神气十足; [or]gre3k;
pandemic: [a]/pænˈdemɪk/; [adj]全国流行的;普遍的; [or]gre3k;
pandemonium: [a]/ˌpændəˈmoʊniəm/; [n]地狱,混乱; [or]gre3k;
panegyric: [a]/ˌpænəˈdʒɪrɪk/; [n]颂词,赞词; [or]gre3k;
panoramic: [a]/ˌpænəˈræmɪk/; [adj]全景的; [or]gre3k;
parable: [a]/ˈpærəbl/; [n]寓言,比喻; [or]gre3k;
paradigm: [a]/ˈpærədaɪm/; [n]范例,示范; [or]gre3k;
paradise: [a]/ˈpærədaɪs/; [n]天国;天堂;极乐世界; [or]gre3k;
paradox: [a]/ˈpærədɑːks/; [n]矛盾;似矛盾而正确的说法; [or]gre3k;
paragon: [a]/ˈpærəɡɑːn/; [n]模范;完美之物;优秀之人; [adj]完美的; [or]gre3k;
paramount: [a]/ˈpærəmaʊnt/; [n]元首;最高; [adj]最高的,至上的,首要的; [or]gre3k;
paranoid: [a]/ˈpærənɔɪd/; [adj]偏执狂的,过分怀疑的; [or]gre3k;
paraphrase: [a]/ˈpærəfreɪz/; [v]解释,释义; [n]转述,释义; [or]gre3k;
parch: [a]/pɑːrtʃ/; [v]焦干,烤干,使干透; [or]gre3k;
parenthesis: [a]/pəˈrenθəsɪs/; [n]圆括号;插入语,插入成分;间歇,插曲; [or]gre3k;
pariah: [a]/pəˈraɪə/; [n]被排斥或鄙视的人; [or]gre3k;
parity: [a]/ˈpærəti/; [n]相等;同等;平价; [or]gre3k;
parody: [a]/ˈpærədi/; [n]嘲弄文章,拙劣的模仿; [v]拙劣模仿; [or]gre3k;
paroxysm: [a]/ˈpærəksɪzəm/; [n]突发,阵发; [adj]发作性的,爆发性的; [or]gre3k;
parrot: [a]/ˈpærət/; [n]鹦鹉,盲目重复或模仿他人行为的人; [vt]学舌,盲目重复或模仿; [or]gre3k;
parry: [a]/ˈpæri/; [v]挡开,避开(武器,问题等); [or]gre3k;
parsimonious: [a]/ˌpɑːrsəˈmoʊniəs/; [adj]太节省的,小气的; [or]gre3k;
partial: [a]/ˈpɑːrʃl/; [adj]偏爱的,特别喜欢的;偏袒的,不公平的,有偏见的;部分的;不完全的; [n]<数学>偏微商; [or]gre3k;
particularize: [a]/pərˈtɪkjələraɪz/; [v]列举,详细说明; [or]gre3k;
partisan: [a]/ˈpɑːrtəzn/; [adj]党派的;效忠的;偏袒的;盲目推崇的; [n]党羽;虔诚信徒;游击队; [or]gre3k;
partition: [a]/pɑːrˈtɪʃn/; [n]划分;隔开物,隔墙,隔板; [v]隔开; [vt]瓜分;分割; [or]gre3k;
patent: [a]/ˈpætnt/; [n]专利; [adj]显然的,明显的;专利的;独创的; [v]取得.的专利权; [or]gre3k;
pathological: [a]/ˌpæθəˈlɑːdʒɪkl/; [adj]病理学的;病态的;由疾病引起的(等于pathologic); [or]gre3k;
patina: [a]/pəˈtiːnə/; [n]绿锈,光亮的外表,神态,圣餐盘; [or]gre3k;
patrician: [a]/pəˈtrɪʃn/; [n]贵族; [adj]贵族的;显贵的;(相貌等)贵族似的; [or]gre3k;
patriot: [a]/ˈpeɪtriət/; [n]爱国者; [or]gre3k;
patronize: [a]/ˈpeɪtrənaɪz/; [v]惠顾;赞助,资助; [or]gre3k;
paucity: [a]/ˈpɔːsəti/; [n]小量,缺乏; [or]gre3k;
paunchy: [a]/ˈpɔːntʃi/; [adj]大腹便便,大肚子的; [or]gre3k;
peck: [a]/pek/; [n]啄;轻吻;喙; [v]啄; [vt]轻吻; [or]gre3k;
peculiarity: [a]/pɪˌkjuːliˈærəti/; [n]怪癖;独特性; [or]gre3k;
pedagogical: [a]/ˌpedəˈɡɑdʒɪk(ə)l/; [adj]教育的;教学法的; [or]gre3k;
pedagogue: [a]/ˈpedəɡɑːɡ/; [n]教师,卖弄学问者; [or]gre3k;
pedant: [a]/ˈpednt/; [n]学究式人物,书呆子,卖弄学问的人; [or]gre3k;
pedestrian: [a]/pəˈdestriən/; [n]步行者,行人; [adj]步行的;平庸无奇的,无聊的; [or]gre3k;
peel: [a]/piːl/; [v]剥皮,削皮,去壳; [n]果皮,外皮; [or]gre3k;
peep: [a]/piːp/; [n]窥看,隐约看见; [v]窥视,偷看; [or]gre3k;
peer: [a]/pɪr/; [n]同龄人,同等地位的人;贵族; [v]仔细看,费力地看; [or]gre3k;
peeve: [a]/piːv/; [v]打扰,惹恼; [n]怨恨;麻烦的事物;触怒; [or]gre3k;
pejorative: [a]/pɪˈdʒɔːrətɪv/; [n]轻蔑语; [adj]带有轻蔑意义的,贬低的; [or]gre3k;
pellucid: [a]/pəˈluːsɪd/; [adj]透明的,清晰的,明了的; [or]gre3k;
pen: [a]/pen/; [n]笔,钢笔;围栏,畜栏; [v]书写;关押,监禁; [or]gre3k;
penalty: [a]/ˈpenəlti/; [n]惩罚,处罚,不利,罚球; [adj]处罚的; [or]gre3k;
penchant: [a]/ˈpentʃənt/; [n]倾向,爱好; [or]gre3k;
penitent: [a]/ˈpenɪtənt/; [adj]后悔的,忏悔的; [n]改过迁善的人;忏悔的人;悔罪者; [or]gre3k;
pensive: [a]/ˈpensɪv/; [adj]沉思的,心事重重的,忧郁的; [or]gre3k;
penury: [a]/ˈpenjəri/; [n]贫穷; [or]gre3k;
perambulate: [a]/pəˈræmbjuleɪt/; [v]巡行,巡视,漫步; [or]gre3k;
perceptible: [a]/pərˈseptəbl/; [adj]可察觉的,可注意到的; [or]gre3k;
perceptive: [a]/pərˈseptɪv/; [adj]感知的,知觉的;有知觉力的; [or]gre3k;
peremptory: [a]/pəˈremptəri/; [adj]专横的,不容反抗的; [or]gre3k;
perfidy: [a]/ˈpɜːrfədi/; [n]不忠,背叛; [or]gre3k;
perforate: [a]/ˈpɜːrfəreɪt/; [vt]穿孔于,打孔穿透;在.上打齿孔; [vi]穿过,贯穿;穿孔; [or]gre3k;
perfunctory: [a]/pərˈfʌŋktəri/; [adj]草率的,敷衍搪塞的; [or]gre3k;
perilous: [a]/ˈperələs/; [adj]危险的; [or]gre3k;
perimeter: [a]/pəˈrɪmɪtər/; [n]周长;周界; [or]gre3k;
periodical: [a]/ˌpɪriˈɑːdɪkl/; [n]期刊;杂志; [or]gre3k;
peripatetic: [a]/ˌperipəˈtetɪk/; [adj]漫游的,逍遥学派的; [n]走来走去的人,逍遥学派的人; [or]gre3k;
peripheral: [a]/pəˈrɪfərəl/; [adj]外围的; [n]外围设备; [or]gre3k;
perish: [a]/ˈperɪʃ/; [vi]死去;毁灭,灭亡; [v]脆裂,老化,腐烂; [or]gre3k;
permanent: [a]/ˈpɜːrmənənt/; [adj]永久的,持久的; [n]电烫发; [or]gre3k;
permeable: [a]/ˈpɜːrmiəbl/; [adj]可渗透的;可穿透的; [or]gre3k;
pernicious: [a]/pərˈnɪʃəs/; [adj]有害的,恶性的,致命的; [or]gre3k;
peroration: [a]/ˌperəˈreɪʃn/; [n]结尾,结论,长篇大论; [or]gre3k;
perpetual: [a]/pərˈpetʃuəl/; [adj]永远的,永恒的;不断的; [or]gre3k;
perquisite: [a]/ˈpɜːrkwɪzɪt/; [n]固定津贴,福利; [or]gre3k;
persecute: [a]/ˈpɜːrsɪkjuːt/; [v](尤指因宗教或政治信仰不同)迫害;烦扰,纠缠; [or]gre3k;
persevere: [a]/ˌpɜːrsəˈvɪr/; [v]坚持,不屈不挠; [or]gre3k;
persiflage: [a]/ˈpɜːrsɪflɑːʒ/; [n]挖苦;嘲弄;戏谑; [or]gre3k;
persistence: [a]/pərˈsɪstəns/; [n]坚持不懈,持续; [or]gre3k;
personable: [a]/ˈpɜːrsənəbl/; [adj]英俊的,风度好的; [or]gre3k;
perspicacious: [a]/ˌpɜːrspɪˈkeɪʃəs/; [adj]独具慧眼的,聪颖的; [or]gre3k;
pertain: [a]/pərˈteɪn/; [vi]属于;适合;有关; [or]gre3k;
pertinacious: [a]/ˌpɜːrtnˈeɪʃəs/; [adj]顽固的,执拗的; [or]gre3k;
pertinent: [a]/ˈpɜːrtnənt/; [adj]有关的;适当的;中肯的; [n]附属物;参考; [or]gre3k;
perturb: [a]/pərˈtɜːrb/; [vt]使不安;烦扰;使紊乱; [or]gre3k;
peruse: [a]/pəˈruːz/; [v]详细考察;精读; [or]gre3k;
pervade: [a]/pərˈveɪd/; [vt]普及;渗透;弥漫; [vi]弥漫;渗透; [or]gre3k;
pessimistic: [a]/ˌpesɪˈmɪstɪk/; [adj]悲观(主义)的; [or]gre3k;
petition: [a]/pəˈtɪʃn/; [n]请愿;请愿书;祈求; [v]请愿; [or]gre3k;
petrify: [a]/ˈpetrɪfaɪ/; [v]石化,使僵化,使惊呆; [or]gre3k;
petty: [a]/ˈpeti/; [adj]价值不大的;小的;器量小的;琐碎的; [or]gre3k;
petulant: [a]/ˈpetʃələnt/; [adj]性急的,易怒的,爱闹气的; [or]gre3k;
phenomenal: [a]/fəˈnɑːmɪnl/; [adj]非凡的;现象的;显著的; [or]gre3k;
philanthropic: [a]/ˌfɪlənˈθrɑːpɪk/; [adj]博爱的,为他人着想的; [or]gre3k;
phlegmatic: [a]/fleɡˈmætɪk/; [adj]冷淡的;迟钝的; [or]gre3k;
piddling: [a]/ˈpɪdlɪŋ/; [adj]琐屑的,无用的,不重要的; [or]gre3k;
piebald: [a]/ˈpaɪbɔːld/; [adj]花斑的;杂色的; [or]gre3k;
pigment: [a]/ˈpɪɡmənt/; [n]天然色素,颜料; [or]gre3k;
pilfer: [a]/ˈpɪlfər/; [v]偷窃(公司财产),小偷小摸; [or]gre3k;
pillar: [a]/ˈpɪlər/; [n]柱,台柱,栋梁; [or]gre3k;
pillory: [a]/ˈpɪləri/; [v]给.上颈手枷;使.惹人嘲笑; [n]示众;颈手枷;使惹人嘲笑; [or]gre3k;
pilot: [a]/ˈpaɪlət/; [n]领航员;飞行员; [adj]试验性的; [v]给..领航,驾驶;试验; [or]gre3k;
pine: [a]/paɪn/; [n]松树; [v](因死亡,离别等)难过,悲伤; [or]gre3k;
pinnacle: [a]/ˈpɪnəkl/; [n](哥德式建筑的)小尖塔,顶峰; [v]置于尖顶上,置于高处; [or]gre3k;
pinpoint: [a]/ˈpɪnpɔɪnt/; [v]准确地解释或说明; [adj]精确的; [n]针尖,极小之物,极不重要的事物; [or]gre3k;
pioneer: [a]/ˌpaɪəˈnɪr/; [n]先驱,先锋,开拓者; [v]开辟,首倡; [or]gre3k;
pious: [a]/ˈpaɪəs/; [adj]虔诚的;难以实现的;尽责的; [or]gre3k;
piquant: [a]/ˈpiːkənt/; [adj]辛辣的,开胃的;活泼有趣的; [or]gre3k;
pique: [a]/piːk/; [v]引起(好奇心,兴趣等),不悦,愤怒; [n]不悦,生气; [or]gre3k;
pirate: [a]/ˈpaɪrət/; [n]海盗;剽窃者; [v]剽窃; [or]gre3k;
pitfall: [a]/ˈpɪtfɔːl/; [n]陷阱,未料到的危险或困难; [or]gre3k;
pithy: [a]/ˈpɪθi/; [adj]精练的,简洁有力的,多髓的; [or]gre3k;
pitiless: [a]/ˈpɪtiləs/; [adj]冷酷的,无情的,无同情心的; [or]gre3k;
pittance: [a]/ˈpɪtns/; [n]微薄的收入,小额津贴,少量; [or]gre3k;
pivotal: [a]/ˈpɪvətl/; [adj]关键的,枢轴的; [or]gre3k;
placate: [a]/ˈpleɪkeɪt/; [vt]安抚,抚慰; [or]gre3k;
placebo: [a]/pləˈsiːboʊ/; [n]安慰剂;为死者所诵的晚祷词; [or]gre3k;
placid: [a]/ˈplæsɪd/; [adj]安静的,平和的; [or]gre3k;
plagiarize: [a]/ˈpleɪdʒəraɪz/; [v]剽窃,抄袭(别人学说,著作); [or]gre3k;
plangent: [a]/ˈplændʒənt/; [adj]轰鸣的,凄切的; [or]gre3k;
plateau: [a]/plæˈtoʊ/; [n]高原; [vi]到达平稳阶段; [or]gre3k;
platitude: [a]/ˈplætɪtuːd/; [n]陈词滥调,老生常谈;单调; [or]gre3k;
plausible: [a]/ˈplɔːzəbl/; [adj]似乎有理的;巧嘴的; [or]gre3k;
playful: [a]/ˈpleɪfl/; [adj]好玩的,嬉戏的,十分有趣的; [or]gre3k;
pleat: [a]/pliːt/; [n]褶,褶状物; [or]gre3k;
plebeian: [a]/pləˈbiːən/; [adj]平民的,普通的,粗俗的; [n]平民,百姓,粗俗的人; [or]gre3k;
plenitude: [a]/ˈplenɪtuːd/; [n]充分;丰富;大量; [or]gre3k;
plethora: [a]/ˈpleθərə/; [n]过多,过剩,多血症; [or]gre3k;
pliable: [a]/ˈplaɪəbl/; [adj]易弯的;柔韧的;圆滑的; [or]gre3k;
pliant: [a]/ˈplaɪənt/; [adj]易弯的,柔软的; [n]顺从; [or]gre3k;
plight: [a]/plaɪt/; [n]困境; [v]宣誓,保证; [or]gre3k;
plod: [a]/plɑːd/; [v]沉重地走,吃力干,拖沓冗长; [n]辛勤工作,沉重的步伐; [or]gre3k;
pluck: [a]/plʌk/; [v]拔去(毛发等);拽开;选; [n]勇气; [or]gre3k;
plumb: [a]/plʌm/; [n]铅锤,测锤; [vi]垂直悬挂; [adj]垂直的; [vt]用铅锤测量; [adv]垂直地; [or]gre3k;
plummet: [a]/ˈplʌmɪt/; [v]垂直或突然地堕下,骤然下降; [n]测锤(钓丝的)坠子;线锤;铅锤线;锤规; [or]gre3k;
plump: [a]/plʌmp/; [adj]颇胖的,丰满的; [v]拍打使鼓起,突然坐下,倒下,; [or]gre3k;
plunge: [a]/plʌndʒ/; [v]跳进,(使)投入;使陷入;暴跌; [n]卷入,参与;暴跌,骤减; [or]gre3k;
plush: [a]/plʌʃ/; [n]长毛绒; [adj]豪华的,长毛绒做的,舒服的; [or]gre3k;
poach: [a]/poʊtʃ/; [v]水煮;小火煮;偷猎;窃取; [or]gre3k;
pointer: [a]/ˈpɔɪntər/; [n]一种短毛猎犬,暗示,指示,指针,指示器; [or]gre3k;
polarize: [a]/ˈpoʊləraɪz/; [v](使)极化,(使)偏振,(使)两极分化; [or]gre3k;
polemic: [a]/pəˈlemɪk/; [n]争论,论战,驳斥; [adj]论战的;喜欢争论的; [or]gre3k;
polished: [a]/ˈpɑːlɪʃt/; [adj]擦亮的;磨光的;优美的;处世圆滑的; [or]gre3k;
politic: [a]/ˈpɑːlətɪk/; [adj]策略性的,政治上的,国家的; [or]gre3k;
pompous: [a]/ˈpɑːmpəs/; [adj]傲慢的,浮华的; [or]gre3k;
ponderous: [a]/ˈpɑːndərəs/; [adj]笨重的,笨拙的,沉闷的; [or]gre3k;
pore: [a]/pɔːr/; [n]毛孔,细孔; [v]深思熟虑,仔细阅读,审视; [or]gre3k;
porous: [a]/ˈpɔːrəs/; [adj]可渗透的,多孔的,可穿越的; [or]gre3k;
portentous: [a]/pɔːrˈtentəs/; [adj]不祥的;预兆的;令人惊讶的; [or]gre3k;
poseur: [a]/poʊˈzɜːr/; [n]装模作样的人; [or]gre3k;
posit: [a]/ˈpɑːzɪt/; [v]假定; [n]安置;论断; [or]gre3k;
postulate: [a]/ˈpɑːstʃəleɪt/; [v]假定.是真的; [n]假定; [or]gre3k;
posture: [a]/ˈpɑːstʃər/; [n]姿势;看法;态度; [v]装模作样; [or]gre3k;
potable: [a]/ˈpoʊtəbl/; [adj]适于饮用的; [n]饮料; [or]gre3k;
potentate: [a]/ˈpoʊtnteɪt/; [n]统治者,君主;有权势的人; [or]gre3k;
pout: [a]/paʊt/; [n]撅嘴,板脸,生气; [v]撅嘴,绷脸; [or]gre3k;
practitioner: [a]/prækˈtɪʃənər/; [n](医生或律师等)开业者;实践者,从事者; [or]gre3k;
pragmatic: [a]/præɡˈmætɪk/; [adj]国事的,团体事务的;实际的,注重实效的; [n]爱管闲事的人;专断的人;国事诏书;实际家; [or]gre3k;
prairie: [a]/ˈpreri/; [n]大草原,(尤指)北美大草原;草原地带; [or]gre3k;
prate: [a]/preɪt/; [v]大谈特谈,唠叨; [n]唠叨,多嘴,无聊话; [or]gre3k;
preach: [a]/priːtʃ/; [v]传教,布道;说教;宣扬; [or]gre3k;
precarious: [a]/prɪˈkeriəs/; [adj]不稳定的;危险的;可疑的;说不定的; [or]gre3k;
precedent: [a]/ˈpresɪdənt/; [n]先例,范例;惯例; [adj]在前的,前面的; [or]gre3k;
precipice: [a]/ˈpresəpɪs/; [n]危险的处境,灾难的边缘,濒危点;悬崖; [or]gre3k;
precipitate: [a]/prɪˈsɪpɪteɪt/; [v]促成,使..沉淀,猛摔;<气象>凝结; [n]沉淀物,冷凝物; [adj]突如其来的,仓促的,迅猛的;感情用事的; [or]gre3k;
precipitation: [a]/prɪˌsɪpɪˈteɪʃn/; [n]猛然摔下;促使;急促;沉淀;降水; [or]gre3k;
precipitous: [a]/prɪˈsɪpɪtəs/; [adj]险峻的;急躁的,鲁莽的; [or]gre3k;
preclude: [a]/prɪˈkluːd/; [v]阻止;排除; [or]gre3k;
precursor: [a]/priːˈkɜːrsər/; [n]先兆,先驱,前体; [or]gre3k;
predecessor: [a]/ˈpredəsesər/; [n]前辈;(被取代的)原有事物; [or]gre3k;
predestine: [a]/priː'destɪn/; [v]注定; [or]gre3k;
predilection: [a]/ˌpredlˈekʃn/; [n]偏好; [or]gre3k;
preeminent: [a]/priˈemɪnənt/; [adj]卓越的,超群的; [adv]卓越地,杰出地; [or]gre3k;
preempt: [a]/priː'empt/; [v]制止,以先买权取得,取代; [n]〔经〕优先占有; [or]gre3k;
preen: [a]/priːn/; [v]打扮;用嘴整理;赞扬; [or]gre3k;
preface: [a]/ˈprefəs/; [n]序言,前言,开端; [or]gre3k;
pregnant: [a]/ˈpreɡnənt/; [adj]怀孕的;充满的,意味深长的; [or]gre3k;
preoccupation: [a]/priˌɑːkjuˈpeɪʃn/; [n]抢先占据;全神贯注;首先要做的事,急务; [or]gre3k;
preponderant: [a]/prɪˈpɑːndərənt/; [adj]占优势的,压倒性的; [or]gre3k;
prepossessing: [a]/ˌpriːpəˈzesɪŋ/; [adj]给人好感的;有魅力的;引人注意的; [or]gre3k;
preposterous: [a]/prɪˈpɑːstərəs/; [adj]荒谬的,可笑的; [or]gre3k;
prerequisite: [a]/ˌpriːˈrekwəzɪt/; [n]先决条件,必要条件; [adj]必须先具备的,必要的; [or]gre3k;
prerogative: [a]/prɪˈrɑːɡətɪv/; [n]权利;特权; [or]gre3k;
presage: [a]/ˈpresɪdʒ/; [v]预示; [n]预感,不祥感,前兆,预言; [or]gre3k;
prescience: [a]/ˈpresiəns/; [n]先见;预知; [or]gre3k;
prescription: [a]/prɪˈskrɪpʃn/; [n]处方,药方;(医生开)的药;开处方,开药方; [or]gre3k;
preservative: [a]/prɪˈzɜːrvətɪv/; [n]防腐剂;预防法;防护层; [adj]有保存力的;防腐的;有保存力的;有保护性的; [or]gre3k;
prestige: [a]/preˈstiːʒ/; [n]威望,声望; [or]gre3k;
presumptuous: [a]/prɪˈzʌmptʃuəs/; [adj]专横的,自以为是的,冒昧的; [adv]自以为是地,专横地,冒失地; [n]自以为是,专横,冒失; [or]gre3k;
pretense: [a]/ˈpriːtens/; [n]虚假;伪装;自吹;炫耀;借口;做作; [or]gre3k;
preternatural: [a]/ˌpriːtərˈnætʃrəl/; [adj]超自然的;不可思议的; [or]gre3k;
prevail: [a]/prɪˈveɪl/; [v]流行,盛行;战胜,压倒; [or]gre3k;
prevalent: [a]/ˈprevələnt/; [adj]普遍的,流行的; [or]gre3k;
prevaricate: [a]/prɪˈværɪkeɪt/; [v]支吾,搪塞,说谎; [or]gre3k;
primordial: [a]/praɪˈmɔːrdiəl/; [adj]原始的;根本的;原生的; [or]gre3k;
primp: [a]/prɪmp/; [v]精心打扮;装饰; [or]gre3k;
principal: [a]/ˈprɪnsəpl/; [n]校长,负责人;本金,资本; [adj]主要的,首要的; [or]gre3k;
pristine: [a]/ˈprɪstiːn/; [adj]原始的;古时的;纯朴的;崭新的; [or]gre3k;
privation: [a]/praɪˈveɪʃn/; [n]缺乏,贫困,丧失,被剥夺了某物的状态; [or]gre3k;
probe: [a]/proʊb/; [v]探测,探索; [n]探索,调查;探针,探测器; [or]gre3k;
probity: [a]/ˈproʊbəti/; [n]正直,诚实; [or]gre3k;
proclaim: [a]/prəˈkleɪm/; [v]声明,声称;宣告;表明; [or]gre3k;
proclivity: [a]/prəˈklɪvəti/; [n]倾向,怪癖; [or]gre3k;
procrastinate: [a]/proʊˈkræstɪneɪt/; [v](因不愿意做或习惯性地)耽搁,拖延; [or]gre3k;
procure: [a]/prəˈkjʊr/; [vt](努力)取得;获得;导致;完成; [vi]介绍娼妓;拉皮条; [or]gre3k;
prod: [a]/prɑːd/; [n]刺针;刺棒;签子; [v]刺;戳;刺激; [or]gre3k;
prodigal: [a]/ˈprɑːdɪɡl/; [adj]挥霍的,十分慷慨的; [n]浪子,挥霍者; [or]gre3k;
prodigious: [a]/prəˈdɪdʒəs/; [adj]异常的,奇妙的;巨大的; [or]gre3k;
profane: [a]/prəˈfeɪn/; [adj]亵渎神圣的,不敬的,粗俗的,污秽的; [v]亵渎,玷污(神圣),滥用; [n]未受秘传的人; [or]gre3k;
proffer: [a]/ˈprɑːfər/; [v]提出(建议),提供,赠送; [n]提议,建议,赠送; [or]gre3k;
proficient: [a]/prəˈfɪʃnt/; [adj]精通的,熟练的; [or]gre3k;
profligate: [a]/ˈprɑːflɪɡət/; [adj]放荡的;不检点的;恣意挥霍的; [n]放荡的人,浪子,肆意挥霍者; [or]gre3k;
profundity: [a]/prəˈfʌndəti/; [n]深奥,深厚,深刻; [or]gre3k;
profusion: [a]/prəˈfjuːʒn/; [n]丰富; [or]gre3k;
prohibitive: [a]/prəˈhɪbətɪv/; [adj]禁止性的,阻止的;(费用,价格等)过高的;类同禁止的; [or]gre3k;
project: [a]/ˈprɑːdʒekt/; [n]项目,工程;专题研究;课题方案; [v]映射,放映;计划,设计,打算,拟订方案;投掷,发射,喷射;表明..的特性,使呈现特性;阐述;突出,伸出;估计,预估; [or]gre3k;
proliferate: [a]/prəˈlɪfəreɪt/; [v]激增,繁殖,增殖; [or]gre3k;
prolix: [a]/ˈproʊlɪks/; [adj]冗长的,说话啰嗦的; [or]gre3k;
prologue: [a]/ˈproʊlɔːɡ/; [n]开场白,序幕; [or]gre3k;
prolong: [a]/prəˈlɔːŋ/; [v]延长;拉长;拖延; [or]gre3k;
promulgate: [a]/ˈprɑːmlɡeɪt/; [v]公布;传播;发表; [or]gre3k;
proofread: [a]/ˈpruːfriːd/; [v]校正,校对; [or]gre3k;
propagate: [a]/ˈprɑːpəɡeɪt/; [v]繁殖,增殖; [vt]传播,宣传; [or]gre3k;
propensity: [a]/prəˈpensəti/; [n]嗜好,习性;倾向; [or]gre3k;
prophetic: [a]/prəˈfetɪk/; [adj]预言的,预示的; [or]gre3k;
propitiate: [a]/prəˈpɪʃieɪt/; [v]讨好,抚慰; [or]gre3k;
propitious: [a]/prəˈpɪʃəs/; [adj]适合的;吉利的;顺利的; [or]gre3k;
proponent: [a]/prəˈpoʊnənt/; [n]支持者;提议者;主张者;提出认证遗嘱者; [adj]建议的;支持的;辩护的; [or]gre3k;
proprietary: [a]/prəˈpraɪəteri/; [adj]所有的;专利的;私人拥有的; [n]所有权;所有物;所有人; [or]gre3k;
propriety: [a]/prəˈpraɪəti/; [n]正当(的行为);礼节;适当; [or]gre3k;
prosaic: [a]/prəˈzeɪɪk/; [adj]平凡的,乏味的,散文体的; [or]gre3k;
proscribe: [a]/proʊˈskraɪb/; [v]剥夺..的公权,禁止; [or]gre3k;
prosecution: [a]/ˌprɑːsɪˈkjuːʃn/; [n](+the)起诉方,原告;起诉;经营; [or]gre3k;
proselytize: [a]/ˈprɑːsələtaɪz/; [v]使皈依; [or]gre3k;
prospect: [a]/ˈprɑːspekt/; [n]前景,展望;视野;景象; [v]勘察;有前途;勘探;对..进行仔细调查; [or]gre3k;
prosperous: [a]/ˈprɑːspərəs/; [adj]富裕的;繁荣的;茂盛的;茁壮生长的; [or]gre3k;
prostrate: [a]/ˈprɑːstreɪt/; [adj]降伏的,沮丧的,衰竭的,俯卧的; [v]弄倒,使屈服; [or]gre3k;
protean: [a]/ˈproʊtiən/; [adj]变化多端的,能够变化的; [or]gre3k;
protocol: [a]/ˈproʊtəkɔːl/; [n]外交礼节;草案;外交议定书; [vi]拟定议定书; [vt]把.写入议定书; [or]gre3k;
prototype: [a]/ˈproʊtətaɪp/; [n]原型,典型,样本; [or]gre3k;
protract: [a]/proʊ'trækt/; [v]绘制;延长;伸展; [or]gre3k;
protrude: [a]/proʊˈtruːd/; [v]伸出,突出,凸出; [or]gre3k;
protuberant: [a]/proʊˈtuːbərənt/; [adj]突出的,隆起的; [or]gre3k;
provident: [a]/ˈprɑːvɪdənt/; [adj]节俭的,深谋远虑的,顾及未来的; [or]gre3k;
providential: [a]/ˌprɑːvɪˈdenʃl/; [adj]天佑的;神意的; [or]gre3k;
provincial: [a]/prəˈvɪnʃl/; [adj]省的;地方性的;偏狭的; [n]地方人民;乡下人;外地人; [or]gre3k;
provisional: [a]/prəˈvɪʒənl/; [n]临时邮票; [adj]临时的,暂时的,暂定的; [or]gre3k;
provisory: [a]/prə'vaɪzərɪ/; [adj]有附带条件的,临时的; [or]gre3k;
provoke: [a]/prəˈvoʊk/; [v]激怒;对.挑衅;引起; [or]gre3k;
prowess: [a]/ˈpraʊəs/; [n]勇敢,不凡的能力;超凡技术; [or]gre3k;
prowl: [a]/praʊl/; [n](鬼鬼祟祟)徘徊,觅食,游荡; [vi]徘徊,潜行; [vt]在.搜寻;潜行于; [or]gre3k;
prude: [a]/pruːd/; [n]过分守礼的人,故作正经的人; [or]gre3k;
prudent: [a]/ˈpruːdnt/; [adj]谨慎的,精明的; [or]gre3k;
prudish: [a]/ˈpruːdɪʃ/; [adj]装正经的,故作拘谨的; [or]gre3k;
prune: [a]/pruːn/; [n]梅干; [v]修剪;削减; [or]gre3k;
pry: [a]/praɪ/; [v]刺探,打听,撬开; [n]窥探;杠杆;爱打探的人; [or]gre3k;
pseudonym: [a]/ˈsuːdənɪm/; [n]笔名,假名; [or]gre3k;
psychology: [a]/saɪˈkɑːlədʒi/; [n]心理学;心理状态;心理; [or]gre3k;
pucker: [a]/ˈpʌkər/; [v]折叠;缩拢;皱起; [or]gre3k;
puerile: [a]/ˈpjʊrəl/; [adj]幼稚的,孩子气的; [or]gre3k;
puissance: [a]/ˈpwɪsəns/; [n]权力,权势,影响; [or]gre3k;
pulchritude: [a]/ˈpʌlkrɪtjuːd/; [n]漂亮,标致; [or]gre3k;
pulverize: [a]/ˈpʌlvəraɪz/; [v]粉碎;使成粉末;彻底击败;彻底毁坏; [or]gre3k;
pun: [a]/pʌn/; [n]双关语; [v]说双关语,用双关语; [or]gre3k;
punctilious: [a]/pʌŋkˈtɪliəs/; [adj]一丝不苟的,精密细心的,拘泥形式的; [or]gre3k;
pundit: [a]/ˈpʌndɪt/; [n]博学者,评论家; [or]gre3k;
pungent: [a]/ˈpʌndʒənt/; [adj]刺激性的;刺鼻的;尖锐的; [or]gre3k;
puny: [a]/ˈpjuːni/; [adj]弱小的,微不足道的; [or]gre3k;
purity: [a]/ˈpjʊrəti/; [n]纯洁;纯净;纯正;纯粹; [or]gre3k;
purloin: [a]/pɜːrˈlɔɪn/; [v]偷窃; [or]gre3k;
purvey: [a]/pərˈveɪ/; [v](大量)供给,供应; [or]gre3k;
pusillanimous: [a]/ˌpjuːsɪˈlænɪməs/; [adj]懦弱的,胆小的;优柔寡断的; [or]gre3k;
quack: [a]/kwæk/; [n]庸医;鸭叫声; [v]嘎嘎叫;吹嘘;大声闲聊; [adj]骗人的,江湖医生的; [or]gre3k;
quaff: [a]/kwæf/; [v]痛饮; [or]gre3k;
quail: [a]/kweɪl/; [n]鹌鹑; [v]畏缩;感到恐惧; [or]gre3k;
qualify: [a]/ˈkwɑːlɪfaɪ/; [v]胜任,使具有资格;描述,形容; [or]gre3k;
quandary: [a]/ˈkwɑːndəri/; [n]困惑;窘境;为难; [or]gre3k;
quarantine: [a]/ˈkwɔːrəntiːn/; [v]检疫;隔离;使隔离; [n]检疫;隔离;检疫期;封锁; [or]gre3k;
quarry: [a]/ˈkwɔːri/; [n]采石场;猎物;来源; [v]挖出;努力挖掘; [or]gre3k;
quash: [a]/kwɔːʃ/; [v]镇压,平息,废除,使无效; [or]gre3k;
quaver: [a]/ˈkweɪvər/; [v]颤抖,发颤音; [n]八分音符,颤音; [or]gre3k;
quell: [a]/kwel/; [v]镇压,消除,减轻(激动,恐惧等); [n]镇压,平息,减轻; [or]gre3k;
quench: [a]/kwentʃ/; [v]扑灭(火);止渴; [or]gre3k;
querulous: [a]/ˈkwerələs/; [adj]抱怨的,挑剔的; [or]gre3k;
quibble: [a]/ˈkwɪbl/; [n]谬论;双关语;遁辞; [v]诡辩;挑剔;说模棱两可的话; [or]gre3k;
quiescent: [a]/kwaɪˈesnt/; [adj]静止的,沉寂的,不活动的; [or]gre3k;
quixotic: [a]/kwɪkˈsɑːtɪk/; [adj]空想的,堂吉诃德式的; [n]同"quixotism"; [or]gre3k;
quota: [a]/ˈkwoʊtə/; [n]配额;限额;定额; [or]gre3k;
quotidian: [a]/kwoʊˈtɪdiən/; [adj]每天的,司空见惯的; [or]gre3k;
rabble: [a]/ˈræbl/; [n]下层社会;乌合之众;暴民; [or]gre3k;
rabid: [a]/ˈræbɪd/; [adj]激烈的;狂暴的;偏激的;患狂犬病的; [or]gre3k;
racy: [a]/ˈreɪsi/; [adj]令人激动的;猥亵的; [or]gre3k;
raffish: [a]/ˈræfɪʃ/; [adj]轻浮的,艳丽而俗气的; [or]gre3k;
raffle: [a]/ˈræfl/; [n]废物;抽彩票; [v]抽彩票; [or]gre3k;
rage: [a]/reɪdʒ/; [n]极怒;盛怒; [v]迅速蔓延,快速扩散;(战争等)激烈地进行; [or]gre3k;
ragged: [a]/ˈræɡɪd/; [adj]破旧的;参差不齐的;未梳理的;粗糙的;精疲力竭的; [or]gre3k;
rail: [a]/reɪl/; [n]铁轨;扶手,栏杆; [v]咒骂; [or]gre3k;
ramble: [a]/ˈræmbl/; [vi]瞎扯;溜达;漫步于; [n]漫步; [or]gre3k;
rambunctious: [a]/ræmˈbʌŋkʃəs/; [adj]喧闹的;难控制的;粗暴的;骚乱的; [or]gre3k;
rampant: [a]/ˈræmpənt/; [adj]猖獗的,蔓生的; [or]gre3k;
ramshackle: [a]/ˈræmʃækl/; [adj]摇摇欲坠的; [or]gre3k;
rancor: [a]/ˈræŋkər/; [n]深仇,怨恨; [or]gre3k;
random: [a]/ˈrændəm/; [adj]随机的;任意的;胡乱的; [or]gre3k;
rankle: [a]/ˈræŋkl/; [v]怨恨,使痛苦,化脓; [or]gre3k;
rant: [a]/rænt/; [n]咆哮,痛骂; [v]咆哮,痛骂,大声责骂; [or]gre3k;
rapacious: [a]/rəˈpeɪʃəs/; [adj]贪婪的;掠夺的; [or]gre3k;
rapport: [a]/ræˈpɔːr/; [n]密切关系,交往;和谐一致;意见一致; [or]gre3k;
rapprochement: [a]/ˌræproʊʃˈmɑːn/; [n]和好,恢复邦交; [or]gre3k;
rapscallion: [a]/ræp'skæljən/; [n]流氓,恶棍; [or]gre3k;
rapt: [a]/ræpt/; [adj]全神贯注的,着迷的;狂喜的; [or]gre3k;
rarefy: [a]/'rerəˌfaɪ/; [v]变稀薄;使(人格,精神等)纯洁;精炼; [or]gre3k;
rash: [a]/ræʃ/; [adj]轻率的,鲁莽的; [n]疹,皮疹;(短时期内)爆发的一连串; [or]gre3k;
raspy: [a]/ˈræspi/; [adj]声音沙哑的,容易生气的; [or]gre3k;
ratify: [a]/ˈrætɪfaɪ/; [vt]批准,认可,签署生效; [or]gre3k;
ratiocination: [a]/ˌreɪʃioʊsɪˈneɪʃn/; [n]推理,推论; [or]gre3k;
ration: [a]/ˈræʃn/; [n]定量配给; [v]配给;定量供应; [or]gre3k;
rational: [a]/ˈræʃnəl/; [adj]理性的;理智的;合理的; [or]gre3k;
rave: [a]/reɪv/; [n]热切赞扬,喧闹的宴会;胡言乱语; [v]咆哮;胡言乱语;语无伦次地说; [adj]赞扬的; [or]gre3k;
ravenous: [a]/ˈrævənəs/; [adj]贪婪的;渴望的,极饿的;狼吞虎咽的; [or]gre3k;
ravish: [a]/ˈrævɪʃ/; [v]强夺,强奸,使着迷; [or]gre3k;
raze: [a]/reɪz/; [v]夷为平地,破坏,消除;拆毁; [or]gre3k;
react: [a]/riˈækt/; [v]起反应,有影响,对..做出反应;有不良反应;起化学反应; [or]gre3k;
reactionary: [a]/riˈækʃəneri/; [adj]保守的,反动的; [n]反动分子; [or]gre3k;
ream: [a]/riːm/; [v]榨取(果汁等);扩展;挖; [n]令(纸张的计数单位);大量; [or]gre3k;
reap: [a]/riːp/; [v]收割;获得;收获; [or]gre3k;
reassure: [a]/ˌriːəˈʃʊr/; [v]使放心,使消除疑虑; [or]gre3k;
rebuff: [a]/rɪˈbʌf/; [n]断然拒绝,回绝,漠不关心; [v]断然拒绝; [or]gre3k;
recalcitrant: [a]/rɪˈkælsɪtrənt/; [adj]顽抗的,不顺从的; [or]gre3k;
recant: [a]/rɪˈkænt/; [v]宣布放弃,公开认错; [or]gre3k;
recessive: [a]/rɪˈsesɪv/; [adj]隐性的,逆行的,后退的; [or]gre3k;
recidivate: [a]/rɪ'sɪdəˌveɪt/; [v]回到原先的习惯,尤指重新犯罪; [or]gre3k;
reciprocate: [a]/rɪˈsɪprəkeɪt/; [v]互给;酬答;互换;报答; [or]gre3k;
reckless: [a]/ˈrekləs/; [adj]不顾虑的;鲁莽的,不顾后果的; [or]gre3k;
recluse: [a]/ˈrekluːs/; [n]隐士; [adj]隐士的,隐遁的; [or]gre3k;
recoil: [a]/rɪˈkɔɪl/; [v]畏缩;弹回;报应; [n]畏缩;弹回;反作用; [or]gre3k;
reconcile: [a]/ˈrekənsaɪl/; [v]和解;调解;调和; [or]gre3k;
recondite: [a]/ˈrekəndaɪt/; [adj]深奥的,隐藏的,不为人知的; [or]gre3k;
reconnoiter: [a]/ˌrikəˈnɔɪtər/; [v]侦察,勘查; [or]gre3k;
reconstitute: [a]/ˌriːˈkɑːnstətuːt/; [v]重新设立,重新组成; [or]gre3k;
reconvene: [a]/ˌriːkənˈviːn/; [v]重新集合,重新召集; [or]gre3k;
rectitude: [a]/ˈrektɪtuːd/; [n]正直,公正,正确; [or]gre3k;
recumbent: [a]/rɪˈkʌmbənt/; [adj]斜倚的;休息的; [n]〈口〉座位斜靠式自行车; [or]gre3k;
recuperate: [a]/rɪˈkuːpəreɪt/; [v]恢复(健康),重新得到,复兴; [or]gre3k;
redeem: [a]/rɪˈdiːm/; [vt]赎回;挽回;恢复;偿还;弥补;履行;兑换; [or]gre3k;
redolent: [a]/ˈredələnt/; [adj]气味强烈的,芬芳的,令人想起..的; [or]gre3k;
redoubtable: [a]/rɪˈdaʊtəbl/; [adj]可敬畏的,可怕的; [or]gre3k;
redundant: [a]/rɪˈdʌndənt/; [adj]多余的,过剩的;被下岗的; [or]gre3k;
reel: [a]/riːl/; [n]卷盘; [v]旋转;感到震惊;眩晕; [or]gre3k;
referee: [a]/ˌrefəˈriː/; [n]裁判员,仲裁者; [v]裁判,仲裁; [or]gre3k;
refine: [a]/rɪˈfaɪn/; [v]精炼,改进; [or]gre3k;
reflect: [a]/rɪˈflekt/; [v]倒映;反映,反射;仔细思考;反省; [or]gre3k;
refractory: [a]/rɪˈfræktəri/; [adj]难治的,难熔的,不听话的; [or]gre3k;
refreshing: [a]/rɪˈfreʃɪŋ/; [adj]使精神振作的,使人清爽的;清新悦目的; [or]gre3k;
refulgent: [a]/rɪˈfʌldʒənt/; [adj]辉煌的,灿烂的; [or]gre3k;
regenerate: [a]/rɪˈdʒenəreɪt/; [v]新生,再生,使革新; [adj]改过自新的,新生的; [n]重生者;再生器官; [or]gre3k;
regimen: [a]/ˈredʒɪmən/; [n]养生法,生活规则; [or]gre3k;
regress: [a]/rɪˈɡres/; [v]后退,退化,恶化; [n]回归;退回; [or]gre3k;
rehabilitate: [a]/ˌriːəˈbɪlɪteɪt/; [v]使康复,使恢复名誉,使恢复原状; [or]gre3k;
rehearsal: [a]/rɪˈhɜːrsl/; [n]排演;叙述;详述;排练; [or]gre3k;
reign: [a]/reɪn/; [v]占主导地位,统治,当政; [n](君主)统治时期; [or]gre3k;
rein: [a]/reɪn/; [n]缰绳; [v]控制; [or]gre3k;
reiterate: [a]/riˈɪtəreɪt/; [vt]反复讲,重申,反复做; [or]gre3k;
rejoice: [a]/rɪˈdʒɔɪs/; [v]欣喜,高兴; [or]gre3k;
relapse: [a]/rɪˈlæps/; [n](旧病的)复发,重陷,回复; [vi]重新陷入,回复; [or]gre3k;
release: [a]/rɪˈliːs/; [v]释放;解放;发行; [n]解除;免除;发表; [or]gre3k;
relentless: [a]/rɪˈlentləs/; [adj]顽强的;持续的;坚定地;冷酷的; [or]gre3k;
relevant: [a]/ˈreləvənt/; [adj]有关的;恰当的;贴切的; [or]gre3k;
religion: [a]/rɪˈlɪdʒən/; [n]宗教;宗教信仰;宗教生活;虔诚的追求; [or]gre3k;
relinquish: [a]/rɪˈlɪŋkwɪʃ/; [v]放弃,让出(权利,财产等),撤回; [or]gre3k;
relish: [a]/ˈrelɪʃ/; [v]享受;享受.的味道;品味; [n]乐趣;调味品; [or]gre3k;
reluctant: [a]/rɪˈlʌktənt/; [adj]不情愿的;勉强的; [or]gre3k;
remiss: [a]/rɪˈmɪs/; [adj]疏忽的,怠慢的; [or]gre3k;
remnant: [a]/ˈremnənt/; [n]遗迹;边角剩料; [or]gre3k;
remodel: [a]/ˌriːˈmɑːdl/; [vt]重塑;改造,重建; [or]gre3k;
remonstrance: [a]/rɪˈmɑːnstrəns/; [n]抗议,抱怨,谏书; [or]gre3k;
remorse: [a]/rɪˈmɔːrs/; [n]懊悔,自责,同情,怜悯; [or]gre3k;
remunerate: [a]/rɪˈmjuːnəreɪt/; [v]酬劳;给与报酬;赔偿; [or]gre3k;
rend: [a]/rend/; [v]撕碎;分裂;强夺; [or]gre3k;
renegade: [a]/ˈrenɪɡeɪd/; [n]叛教者,脱党者,叛徒; [v]背叛,背教,变节; [adj]叛教的,背叛的,变节的; [or]gre3k;
renege: [a]/rɪˈniːɡ/; [v]食言,否认; [or]gre3k;
renounce: [a]/rɪˈnaʊns/; [vt]宣布放弃,与...断绝关系;抛弃; [vi]垫牌; [n]垫牌; [or]gre3k;
renovate: [a]/ˈrenəveɪt/; [v]更新,修复; [adj]恢复的,革新的,翻新的; [or]gre3k;
repartee: [a]/ˌrepɑːrˈtiː/; [n]机敏的应答,妙语,巧辩; [or]gre3k;
repatriate: [a]/ˌriːˈpeɪtrieɪt/; [v]遣返; [n]被遣返回国者; [or]gre3k;
repeal: [a]/rɪˈpiːl/; [n]撤销; [v]废除;废止; [or]gre3k;
repel: [a]/rɪˈpel/; [v]击退,驱逐;排斥,抵制;使厌恶,使反感;使恐惧; [or]gre3k;
repertoire: [a]/ˈrepərtwɑːr/; [n](剧团,演员等的)全部节目;全部才能; [or]gre3k;
repine: [a]/rɪ'paɪn/; [v]不满,心中抱怨; [or]gre3k;
replenish: [a]/rɪˈplenɪʃ/; [v]补充,再装满;把.装满;给.添加燃料; [or]gre3k;
replete: [a]/rɪˈpliːt/; [adj]充满的,装满的; [n]<昆>贮蜜蚁; [or]gre3k;
replicate: [a]/ˈreplɪkeɪt/; [v]复制;重复,反复; [or]gre3k;
repose: [a]/rɪˈpoʊz/; [n]休息,睡眠;静止; [vi]建立于.之上; [vt]使休息,使依靠; [or]gre3k;
reprehend: [a]/ˌreprɪ'hend/; [vt]申斥,指责,批评; [or]gre3k;
repress: [a]/rɪˈpres/; [vt]抑制;镇压;约束; [or]gre3k;
reprieve: [a]/rɪˈpriːv/; [v]暂缓处罚,免罪,维持运行; [n]<法>死缓,缓刑,暂缓; [or]gre3k;
reproach: [a]/rɪˈproʊtʃ/; [v]责备,指责; [n]指责; [or]gre3k;
reprobate: [a]/ˈreprəbeɪt/; [n]混蛋,恶棍; [adj]邪恶的;堕落的; [v]谴责,指责; [or]gre3k;
reproof: [a]/rɪˈpruːf/; [n]斥责,责备; [v]重新上防水胶;<印>重新打样; [or]gre3k;
reprove: [a]/rɪˈpruːv/; [v]责骂,申斥; [or]gre3k;
repudiate: [a]/rɪˈpjuːdieɪt/; [v]拒绝,否定,驳斥; [or]gre3k;
repugnant: [a]/rɪˈpʌɡnənt/; [adj]令人厌恶的; [or]gre3k;
repulse: [a]/rɪˈpʌls/; [n]击退;断然拒绝; [vt]击退;断然拒绝;憎恶; [v]使排斥,使厌恶; [or]gre3k;
repute: [a]/rɪˈpjuːt/; [n]名声,荣誉; [vt]被认为,被称为; [or]gre3k;
requisite: [a]/ˈrekwɪzɪt/; [n]必需品; [adj]需要的,必不可少的,必备的; [or]gre3k;
requite: [a]/rɪˈkwaɪt/; [v]报答,酬谢,回报,补偿;报复; [or]gre3k;
rescind: [a]/rɪˈsɪnd/; [v]废除;取消;撤回; [or]gre3k;
reserved: [a]/rɪˈzɜːrvd/; [adj]保留的,留作专用的;矜持的,缄默的,有节制的; [or]gre3k;
residual: [a]/rɪˈzɪdʒuəl/; [adj]残余的,剩余的; [or]gre3k;
residue: [a]/ˈrezɪduː/; [n]剩余物;残渣;渣;残数; [or]gre3k;
resign: [a]/rɪˈzaɪn/; [v]辞职; [or]gre3k;
resilience: [a]/rɪˈzɪliəns/; [n]恢复力;弹力;顺应力; [or]gre3k;
resolute: [a]/ˈrezəluːt/; [adj]坚决的;果断的; [or]gre3k;
resonant: [a]/ˈrezənənt/; [adj]洪亮的,共振的,共鸣的; [or]gre3k;
resourceful: [a]/rɪˈsɔːrsfl/; [adj]足智多谋的;资源丰富的;机智的; [or]gre3k;
respire: [a]/rɪˈspaɪər/; [v]呼吸; [or]gre3k;
respite: [a]/ˈrespɪt/; [n]缓解;暂缓;暂时的休息;缓期执行; [v]使缓解;使暂缓;使延期;缓期执行; [or]gre3k;
resplendent: [a]/rɪˈsplendənt/; [adj]华丽的,辉煌的; [or]gre3k;
responsive: [a]/rɪˈspɑːnsɪv/; [adj]反应积极的,反应敏捷的;反应热烈的;响应的; [or]gre3k;
restitution: [a]/ˌrestɪˈtuːʃn/; [n]归还,赔偿; [or]gre3k;
restive: [a]/ˈrestɪv/; [adj]不耐烦的,焦躁不安的,倔强的; [or]gre3k;
restless: [a]/ˈrestləs/; [adj]烦躁不安的,焦虑的;得不到休息的;不安宁的; [or]gre3k;
restrain: [a]/rɪˈstreɪn/; [v]制止(做);抑制(愤怒等),控制;监禁; [or]gre3k;
resurgence: [a]/rɪˈsɜːrdʒəns/; [n]复活;再现;再起; [or]gre3k;
resurrect: [a]/ˌrezəˈrekt/; [v]复苏,复兴;使复活; [or]gre3k;
resuscitate: [a]/rɪˈsʌsɪteɪt/; [v]使复活,使苏醒,使复兴; [or]gre3k;
retainer: [a]/rɪˈteɪnər/; [n]保持器;家臣;保持者;<机>护圈;预付费用; [or]gre3k;
retaliate: [a]/rɪˈtælieɪt/; [v]报复,反击; [or]gre3k;
retard: [a]/rɪˈtɑːrd/; [v]延迟,使减速; [n]妨碍,阻碍; [or]gre3k;
retentive: [a]/rɪˈtentɪv/; [adj]保持的;吸(水)的; [adv]有记性地,记性强地; [n]保持力;〈物〉顽磁性; [or]gre3k;
reticent: [a]/ˈretɪsnt/; [adj]沉默不语的;有保留的;含蓄的; [or]gre3k;
retinue: [a]/ˈretənuː/; [n]侍从,随员; [or]gre3k;
retort: [a]/rɪˈtɔːrt/; [v]反驳; [n]反驳,反击,回嘴; [or]gre3k;
retouch: [a]/ˌriːˈtʌtʃ/; [n]润饰;修整部分; [vt]润饰;修整; [vi]润饰;修整; [or]gre3k;
retract: [a]/rɪˈtrækt/; [v]缩回;收回;取消; [n]收缩核; [or]gre3k;
retrench: [a]/rɪˈtrentʃ/; [v]节省,削减;紧缩; [or]gre3k;
retribution: [a]/ˌretrɪˈbjuːʃn/; [n]报应,惩罚,报答,报偿; [or]gre3k;
retrieve: [a]/rɪˈtriːv/; [v]取回,重新得到,挽回,检索; [or]gre3k;
retrograde: [a]/ˈretrəɡreɪd/; [vi]倒退,退步; [adj]后退的,退步的,退化的; [vt]使倒退; [or]gre3k;
retrospective: [a]/ˌretrəˈspektɪv/; [adj]回顾的;怀旧的;可追溯的; [n]作品回顾展出; [or]gre3k;
revelry: [a]/ˈrevlri/; [n]狂欢;欢宴; [or]gre3k;
revenge: [a]/rɪˈvendʒ/; [n]报仇;报复; [v]为.报仇,报.之仇; [or]gre3k;
reverberate: [a]/rɪˈvɜːrbəreɪt/; [v]弹回,起回声,使回荡在; [or]gre3k;
revere: [a]/rɪˈvɪr/; [v]敬畏;尊敬;崇敬; [or]gre3k;
revise: [a]/rɪˈvaɪz/; [v]修订;修改;温习(功课); [or]gre3k;
revive: [a]/rɪˈvaɪv/; [v](使)苏醒;(使)复苏;再兴起;重做; [or]gre3k;
revoke: [a]/rɪˈvoʊk/; [v]撤回,取消;废除; [n]有牌不跟; [or]gre3k;
revolt: [a]/rɪˈvoʊlt/; [v]反抗,叛乱,厌恶;造反;反抗;厌恶; [n]背叛;厌恶;反叛; [or]gre3k;
rhetorical: [a]/rɪˈtɔːrɪkl/; [adj]语言上的,文字上的,言辞华丽(却往往无内涵的); [or]gre3k;
rickety: [a]/ˈrɪkəti/; [adj]佝偻病的;摇晃的;蹒跚的;不结实的; [or]gre3k;
rider: [a]/ˈraɪdər/; [n]骑士;附件,附文;扶手; [or]gre3k;
ridicule: [a]/ˈrɪdɪkjuːl/; [v]嘲笑,愚弄; [n]嘲笑,愚弄; [or]gre3k;
rife: [a]/raɪf/; [adj]普遍的;流行的; [or]gre3k;
rift: [a]/rɪft/; [n]裂缝,裂口; [or]gre3k;
rigmarole: [a]/ˈrɪɡməroʊl/; [n]冗长无聊的废话; [or]gre3k;
rile: [a]/raɪl/; [v]刺激,惹怒; [or]gre3k;
riot: [a]/ˈraɪət/; [v]闹事; [n]骚乱;暴乱;骚动;放纵; [or]gre3k;
ripen: [a]/ˈraɪpən/; [vi]成熟; [vt]使.成熟;使成熟可以食用; [or]gre3k;
rite: [a]/raɪt/; [n]仪式;惯例;习俗; [or]gre3k;
riveting: [a]/ˈrɪvɪtɪŋ/; [adj]非常精彩的; [n]铆接(法; [or]gre3k;
rivulet: [a]/ˈrɪvjələt/; [n]小溪,小河; [or]gre3k;
robust: [a]/roʊˈbʌst/; [adj]健壮的,强壮的;精力充沛的;坚固的;粗鲁的; [or]gre3k;
roil: [a]/rɔɪl/; [v]搅浑,惹怒,动荡,喧闹; [n]小股汹涌的急流; [or]gre3k;
roisterer: [a]/'rɔɪstərər/; [n]摆架子的人,喝酒喧哗者; [or]gre3k;
rookie: [a]/ˈrʊki/; [n]新手,新兵,新球员; [or]gre3k;
roster: [a]/ˈrɑːstər/; [n]值勤表,花名册; [v]将(姓名)列入值勤名单; [or]gre3k;
rostrum: [a]/ˈrɑːstrəm/; [n]讲坛,讲台; [or]gre3k;
rouse: [a]/raʊz/; [vt]唤醒,唤起;激起; [or]gre3k;
royalty: [a]/ˈrɔɪəlti/; [n]皇家,王族,皇族;版税;专利费; [or]gre3k;
rubicund: [a]/ˈruːbɪkənd/; [adj]红润的;透红的; [or]gre3k;
rudimentary: [a]/ˌruːdɪˈmentri/; [adj]基本的,初期的;发育不完全的;退化的; [or]gre3k;
rue: [a]/ruː/; [v]后悔,遗憾; [or]gre3k;
ruffle: [a]/ˈrʌfl/; [vt]弄皱;使生气,扰乱;连续地轻敲;使起波浪; [n]皱纹;生气;混乱; [vi]起皱;愤怒; [or]gre3k;
ruminate: [a]/ˈruːmɪneɪt/; [v]反刍,再嚼,深思; [or]gre3k;
rumple: [a]/ˈrʌmpl/; [v]弄皱;弄得乱七八糟; [n]皱褶;皱纹; [or]gre3k;
runic: [a]/ˈruːnɪk/; [adj]神秘的;古代北欧文字的; [n]古代北欧文字; [or]gre3k;
rupture: [a]/ˈrʌptʃər/; [n]破裂;割裂; [v]使破裂;断绝(关系); [or]gre3k;
ruse: [a]/ruːz/; [n]诡计; [or]gre3k;
rustic: [a]/ˈrʌstɪk/; [n]乡巴佬,庄稼汉,粗人; [adj]乡村的;质朴的;不精致的; [or]gre3k;
rustle: [a]/ˈrʌsl/; [v]发出沙沙声,使沙沙作响,偷窃; [n]沙沙声; [or]gre3k;
ruthless: [a]/ˈruːθləs/; [adj]无情的;残忍的; [or]gre3k;
sabotage: [a]/ˈsæbətɑːʒ/; [n]怠工,蓄意破坏,妨碍; [v]怠工,从事破坏活动,故意阻挠; [or]gre3k;
saccharine: [a]/ˈsækəriːn/; [adj]像糖一样的,有甜味的,做作的,矫情的; [or]gre3k;
sacrilege: [a]/ˈsækrəlɪdʒ/; [n]亵渎圣物,悖理逆天的行为; [or]gre3k;
sacrosanct: [a]/ˈsækroʊsæŋkt/; [adj](因十分重要,神圣)不可改变,批判的; [or]gre3k;
saddle: [a]/ˈsædl/; [n]鞍;鞍部; [v]给马装鞍具;装鞍具;使负重担; [or]gre3k;
safeguard: [a]/ˈseɪfɡɑːrd/; [v]保护,维护; [n]防卫措施,防范措施; [or]gre3k;
sage: [a]/seɪdʒ/; [adj]贤明的,审慎的; [n]圣人,年高望重的人; [or]gre3k;
salient: [a]/ˈseɪliənt/; [adj]显著的;突出的;跳跃的; [n]凸角;突出部分; [or]gre3k;
salubrious: [a]/səˈluːbriəs/; [adj]清爽的;气候有益健康的; [or]gre3k;
salutary: [a]/ˈsæljəteri/; [adj]有益的,有益健康的; [or]gre3k;
salutation: [a]/ˌsæljuˈteɪʃn/; [n]称呼;招呼;寒喧; [or]gre3k;
salvage: [a]/ˈsælvɪdʒ/; [n]抢救;从灾难中抢救出的物资; [vt]拯救;打捞; [or]gre3k;
salve: [a]/sælv/; [n]药膏,安慰; [v]涂药膏;缓和; [or]gre3k;
sanctify: [a]/ˈsæŋktɪfaɪ/; [vt]使神圣化,使合法化; [or]gre3k;
sanctimonious: [a]/ˌsæŋktɪˈmoʊniəs/; [adj]伪装虔诚的;道貌岸然的; [or]gre3k;
sanction: [a]/ˈsæŋkʃn/; [n]批准;制裁,处罚; [v]批准,支持,对..实施制裁; [or]gre3k;
sanctuary: [a]/ˈsæŋktʃueri/; [n]圣堂,避难所; [or]gre3k;
sanguine: [a]/ˈsæŋɡwɪn/; [adj]乐观的,(脸色等)有血色的,多血质的; [n]血红色,乐观; [or]gre3k;
sanitary: [a]/ˈsænəteri/; [adj]卫生的;清洁的; [or]gre3k;
sap: [a]/sæp/; [n]树液,汁液;易上当的人; [v]削弱;逐渐耗竭; [vt]使伤元气; [vi]挖坑道进攻; [or]gre3k;
sapient: [a]/ˈseɪpiənt/; [adj]聪明的,伶俐的,装聪明样的,有见识的; [n](史前的)智人; [or]gre3k;
sarcasm: [a]/ˈsɑːrkæzəm/; [n]讽刺,挖苦,嘲笑; [or]gre3k;
sartorial: [a]/sɑːrˈtɔːriəl/; [adj]裁缝匠的,裁缝的;缝纫的; [or]gre3k;
sate: [a]/seɪt/; [v]使心满意足,使厌足; [or]gre3k;
satiate: [a]/ˈseɪʃieɪt/; [v]使饱足,生腻; [adj]饱足的;厌腻的; [or]gre3k;
satire: [a]/ˈsætaɪər/; [n]讽刺(作品); [or]gre3k;
saturate: [a]/ˈsætʃəreɪt/; [v]使充满,使饱和,使湿透; [or]gre3k;
saturnine: [a]/ˈsætərnaɪn/; [adj]忧郁的,阴沉的,讥讽的; [or]gre3k;
saunter: [a]/ˈsɔːntər/; [n]漫步,闲逛; [v]闲逛,漫步; [or]gre3k;
savant: [a]/sæˈvɑːnt/; [n]博学之士,大学士; [or]gre3k;
savory: [a]/ˈseɪvəri/; [adj]口感好的,味道好的,令人愉悦的; [or]gre3k;
savvy: [a]/ˈsævi/; [n]老练,机智; [v]明确了解; [adj]有见识,精明能干的; [or]gre3k;
scads: [a]/skædz/; [n]大量,巨额; [or]gre3k;
scant: [a]/skænt/; [adj]不足的,缺乏的;勉强够的; [v]减少;节省;限制; [or]gre3k;
scathing: [a]/ˈskeɪðɪŋ/; [adj]严厉的;损伤的; [v]损伤;伤害; [or]gre3k;
schism: [a]/ˈsɪzəm/; [n]分裂,(教派或政党的)分裂; [or]gre3k;
scintillate: [a]/'sɪntlˌeɪt/; [v]闪烁,(淡吐)流露机智; [or]gre3k;
scion: [a]/ˈsaɪən/; [n]<农学>接穗;子孙; [or]gre3k;
scoff: [a]/skɔːf/; [vi]讥笑; [v]嘲笑; [n]愚弄; [or]gre3k;
scorch: [a]/skɔːrtʃ/; [v]烧焦;枯萎; [vi]高速行驶,疾驰,飞驰; [or]gre3k;
scorn: [a]/skɔːrn/; [n]鄙视; [v]轻蔑;对.不屑一顾; [or]gre3k;
scotch: [a]/skɑːtʃ/; [n](产自苏格兰的一种)威士忌;刻痕,划痕; [v]阻止;平息;挫败; [or]gre3k;
scour: [a]/ˈskaʊər/; [v]搜查;洗涤,洗刷,擦洗;冲刷成,冲刷出; [or]gre3k;
scourge: [a]/skɜːrdʒ/; [n]鞭笞,磨难,带来灾难的事物或人; [v]鞭笞,折磨,使苦恼; [or]gre3k;
scowl: [a]/skaʊl/; [n]愁容,怒容,暴风雨前的阴沉晦暗; [v]皱眉头,怒目而视; [or]gre3k;
scrap: [a]/skræp/; [n]碎片;口角,吵架;小块,小片;废金属;残羹冷炙; [v]报废;舍弃;打架; [or]gre3k;
scrappy: [a]/ˈskræpi/; [adj]好斗的,不连贯的; [or]gre3k;
scrawl: [a]/skrɔːl/; [n]潦草的笔迹; [v]乱涂,乱写,潦草地写; [or]gre3k;
screen: [a]/skriːn/; [n]屏幕,荧光屏;纱窗; [v]遮蔽;放映;检查; [or]gre3k;
scribble: [a]/ˈskrɪbl/; [v]潦草地写,乱写,滥写; [n]潦草的写法,潦草写成的东西,杂文; [or]gre3k;
scrimp: [a]/skrɪmp/; [adj]不足的,吝啬的; [vt]过度缩减,克扣; [vi]节省或精打细算; [or]gre3k;
scruple: [a]/ˈskruːpl/; [n]顾虑,不安; [vi]有顾虑,良心上感到不安; [or]gre3k;
scrupulous: [a]/ˈskruːpjələs/; [adj]小心谨慎的;严谨的;细心的; [or]gre3k;
scrutable: [a]/'skruːtəbəl/; [adj]可理解的; [or]gre3k;
scrutinize: [a]/ˈskruːtənaɪz/; [v]仔细检查,细看; [or]gre3k;
scuff: [a]/skʌf/; [vt]使磨损;践踏;拖着脚走; [vi]磨损;拖着脚走; [n]拖着脚走,磨损,践踏; [or]gre3k;
scurrilous: [a]/ˈskɜːrələs/; [adj]下流的,恶言毁谤的; [or]gre3k;
scurvy: [a]/ˈskɜːrvi/; [n]坏血病; [adj]卑鄙的,下流的; [or]gre3k;
seamy: [a]/ˈsiːmi/; [adj]丑恶的,露出线缝的; [or]gre3k;
secluded: [a]/sɪˈkluːdɪd/; [adj]隐遁的,隔绝的; [or]gre3k;
secrete: [a]/sɪˈkriːt/; [v]藏匿;私下侵吞;分泌; [or]gre3k;
sedate: [a]/sɪˈdeɪt/; [adj]沉着的,镇定的,平和的; [v]使服镇静剂而安静下来; [or]gre3k;
sedentary: [a]/ˈsednteri/; [adj]久坐不动的;静止的;坐惯的,定栖的; [or]gre3k;
seduce: [a]/sɪˈduːs/; [v]引诱,诱使,诱惑,勾引;着迷; [or]gre3k;
sedulous: [a]/ˈsedʒələs/; [adj]聚精会神的,勤勉的; [or]gre3k;
seemly: [a]/ˈsiːmli/; [adj]适当的,有礼的,好看的; [adv]适当地; [or]gre3k;
segment: [a]/ˈseɡmənt/; [n]部分;片段;(橘子等的)瓣; [v]分割; [or]gre3k;
self-abasement: [a]/ˌselfə'beɪsmənt/; [n]自卑,自谦; [or]gre3k;
self-absorbed: [a]/ˌself əbˈzɔːrbd/; [adj]自恋的,自私的; [or]gre3k;
seminal: [a]/ˈsemɪnl/; [adj]重要的,精液的,种子的; [or]gre3k;
sensation: [a]/senˈseɪʃn/; [n]感觉;知觉;轰动; [or]gre3k;
sensitive: [a]/ˈsensətɪv/; [adj]敏感的,过敏的;灵敏的;善解人意的,体恤的; [or]gre3k;
sentinel: [a]/ˈsentɪnl/; [n]哨兵,看守; [v]守卫,放哨; [or]gre3k;
septic: [a]/ˈseptɪk/; [adj]受感染的,败血症的,腐败的; [n]引起腐败的东西;腐败物; [or]gre3k;
sepulchral: [a]/səˈpʌlkrəl/; [adj]坟墓的,阴深的; [or]gre3k;
sequel: [a]/ˈsiːkwəl/; [n]续集;结局;继续;后果; [or]gre3k;
sequela: [a]/sɪ'kwiːlə/; [n]<医>后遗症,结果,后继者; [or]gre3k;
sequester: [a]/sɪˈkwestər/; [v]使隔离,隔绝,使隐退,没收,扣押; [or]gre3k;
sere: [a]/sɪr/; [adj]干枯的,凋萎的; [or]gre3k;
serendipity: [a]/ˌserənˈdɪpəti/; [n]机缘巧合; [or]gre3k;
serene: [a]/səˈriːn/; [adj]宁静的,静谧的; [v]宁静;〈诗〉使(海,脸色等)平静;使(天空)明朗; [n]平静(的海);〈诗,古〉晴朗(天空); [or]gre3k;
sermon: [a]/ˈsɜːrmən/; [n]布道;训诫; [or]gre3k;
serpentine: [a]/ˈsɜːrpəntiːn/; [adj]似蛇般绕曲的,蜿蜒的; [or]gre3k;
serried: [a]/ˈserid/; [adj]密集的;林立的; [or]gre3k;
servile: [a]/ˈsɜːrvl/; [adj]奴颜婢膝的,卑屈的,隶属的; [n]奴隶; [or]gre3k;
severe: [a]/sɪˈvɪr/; [adj]严重的;严厉的;严酷的;剧烈的; [or]gre3k;
shackle: [a]/ˈʃækl/; [n]枷锁,羁绊(物); [v]给..上手铐(脚镣),用钩链连结,束缚; [or]gre3k;
shadow: [a]/ˈʃædoʊ/; [n]阴影;影子; [v]把影子投在..;盯梢; [or]gre3k;
shallow: [a]/ˈʃæloʊ/; [adj]浅的;肤浅的; [v]变浅;使变浅; [n]浅滩;浅处; [or]gre3k;
sham: [a]/ʃæm/; [n]假货;虚假;欺诈; [v]假装; [adj]虚假的,假装的; [or]gre3k;
shift: [a]/ʃɪft/; [n]转移;替换;轮值; [v]移动;售卖(难卖的物品);换挡;改换,替换; [or]gre3k;
shiftless: [a]/ˈʃɪftləs/; [adj]没有决断力的;无计谋的;偷懒的; [or]gre3k;
shifty: [a]/ˈʃɪfti/; [adj]变化的,诡诈的,机智的; [or]gre3k;
shipshape: [a]/ˈʃɪpʃeɪp/; [adj]井然有序的;整整齐齐的;整洁干净的; [or]gre3k;
shirk: [a]/ʃɜːrk/; [v]逃避;规避(义务,责任等); [n]偷懒者; [or]gre3k;
shoal: [a]/ʃoʊl/; [n]浅滩,沙洲,一群(鱼); [adj](水)浅的; [v]变成浅滩;驶入浅水的地方;(鱼)成群集聚; [or]gre3k;
shopworn: [a]/ˈʃɑːpwɔːrn/; [adj]陈旧的; [or]gre3k;
shred: [a]/ʃred/; [n]碎片,少量,毁灭; [v]切成细条,撕成碎片; [or]gre3k;
shrewd: [a]/ʃruːd/; [adj]精明的;机灵的; [n]精明;精明者; [or]gre3k;
shrink: [a]/ʃrɪŋk/; [v]收缩;缩小;退缩; [n](非正式用法)心理医生,精神病医生; [or]gre3k;
shroud: [a]/ʃraʊd/; [n]寿衣,覆盖物; [v]覆盖,包以尸衣; [or]gre3k;
shrug: [a]/ʃrʌɡ/; [n]耸肩; [v](为表示厌恶,轻漠,冷淡,怀疑等)耸肩;以耸肩表示(厌恶,轻蔑,冷淡,怀疑等); [or]gre3k;
shun: [a]/ʃʌn/; [v](有意或习惯性地)避开,躲开; [or]gre3k;
sidestep: [a]/ˈsaɪdstep/; [n](侧面)台阶;拳击等横跨一步躲避打击;［喻］回避(困难); [v]回避;横跨一步躲避; [or]gre3k;
signal: [a]/ˈsɪɡnəl/; [n]信号;预兆; [v]发信号;标志; [adj]显著的,优越的;暗号的,作信号用的; [or]gre3k;
simile: [a]/ˈsɪməli/; [n]直喻,明喻; [or]gre3k;
simpleton: [a]/ˈsɪmpltən/; [n]傻子;笨蛋; [or]gre3k;
simulate: [a]/ˈsɪmjuleɪt/; [v]假装;模仿;模拟; [or]gre3k;
sin: [a]/sɪn/; [n]罪;罪孽;错误; [v]违犯戒律;犯过失; [or]gre3k;
sincere: [a]/sɪnˈsɪr/; [adj]真诚的,诚恳的; [or]gre3k;
sinecure: [a]/ˈsaɪnɪkjʊr/; [n]闲职,挂名职务; [or]gre3k;
sinew: [a]/ˈsɪnjuː/; [n]腱,筋,中坚力量; [v]用腱连结,(好像使用肌筋似的)给..以力量,支持; [or]gre3k;
singe: [a]/sɪndʒ/; [n](轻微的)烧焦; [v](轻微地)烧焦,烫焦; [or]gre3k;
sinuous: [a]/ˈsɪnjuəs/; [adj]弯曲的,蜿蜒的; [or]gre3k;
sip: [a]/sɪp/; [v]啜饮; [n]一小口; [or]gre3k;
skeleton: [a]/ˈskelɪtn/; [n]骨骼,梗概;骨瘦如柴的人或动物; [or]gre3k;
skeptic: [a]/ˈskeptɪk/; [n]怀疑论者;怀疑者;无神论者; [or]gre3k;
skimp: [a]/skɪmp/; [vt]少给,克扣,不足量地供给;对.草率从事; [vi]克俭,节省; [adj]少的,不足的; [or]gre3k;
skirmish: [a]/ˈskɜːrmɪʃ/; [n]小战役,小争吵; [v]卷入战役(争论),搜索; [or]gre3k;
skittish: [a]/ˈskɪtɪʃ/; [adj]轻佻的;活泼的;胆小的; [or]gre3k;
slack: [a]/slæk/; [adj]松弛的;懈怠的;萧条的; [n]松弛的部分,松散; [v]变松弛,逃避工作; [or]gre3k;
slake: [a]/sleɪk/; [v]解渴,消渴; [or]gre3k;
slant: [a]/slænt/; [n]倾斜,倾向性,偏见; [v](使)倾斜,使带有某种色彩,歪曲; [adj]倾斜的;有偏见的; [or]gre3k;
slate: [a]/sleɪt/; [n]黑板,石板,候选人名单; [v]提名; [or]gre3k;
slew: [a]/sluː/; [n]大量,大批; [v]回转,旋转; [or]gre3k;
slight: [a]/slaɪt/; [adj]轻微的,微小的;纤细的,瘦弱的;少量的; [n]轻视,蔑视; [vt]轻视,忽略; [or]gre3k;
sling: [a]/slɪŋ/; [n]<机>吊索,投石器,弹弓,抛掷; [v]用投石器投掷,吊起; [or]gre3k;
slippery: [a]/ˈslɪpəri/; [adj]滑的;易滑脱的;不老实的;不稳定的; [or]gre3k;
sloppy: [a]/ˈslɑːpi/; [adj]泥泞的,(工作)草率的,粗心的; [or]gre3k;
sloth: [a]/slɑːθ/; [n]懒惰;树懒; [or]gre3k;
slouch: [a]/slaʊtʃ/; [v]耷拉,低垂,使低垂; [n](帽边等的)下垂,耷拉,萎靡不振的人; [or]gre3k;
slovenly: [a]/ˈslʌvnli/; [adj]不整洁的,马虎的; [or]gre3k;
sluggard: [a]/ˈslʌɡərd/; [n]懒鬼;游手好闲的人; [or]gre3k;
sluggish: [a]/ˈslʌɡɪʃ/; [adj]行动迟缓的,迟钝的;偷懒的; [or]gre3k;
slumber: [a]/ˈslʌmbər/; [n]睡眠;睡觉; [v]浅睡;打盹儿; [or]gre3k;
slur: [a]/slɜːr/; [n]含糊的发音,藐视,污点,连线符; [vi]含糊地说; [vt]对.忽略,含糊不清地说出,贬低; [or]gre3k;
sly: [a]/slaɪ/; [adj]狡猾的,奸诈的;会心的;淘气的;诡异的; [or]gre3k;
smarmy: [a]/ˈsmɑːrmi/; [adj]迎奉的,讨好的; [or]gre3k;
smart: [a]/smɑːrt/; [adj]时髦的,衣着讲究的;聪明的;干净的,整洁的; [v]剧痛,刺疼; [or]gre3k;
smattering: [a]/ˈsmætərɪŋ/; [n]浅薄的知识,少量; [adj]肤浅的;些许的;点滴的; [or]gre3k;
smirk: [a]/smɜːrk/; [n]傻笑;假笑;得意的笑; [vi]傻笑;假笑; [vt]以假笑表示;以傻笑表示; [or]gre3k;
smother: [a]/ˈsmʌðər/; [v]窒息; [or]gre3k;
smug: [a]/smʌɡ/; [adj]自鸣得意的; [or]gre3k;
smuggling: [a]/ˈsmʌɡlɪŋ/; [n]走私; [v]走私; [or]gre3k;
snare: [a]/sner/; [n]罗网;陷阱;圈套; [or]gre3k;
snarl: [a]/snɑːrl/; [v]缠结,混乱,吠,咆哮,怒骂; [n]咆哮,吼叫,怒骂,缠结,混乱; [or]gre3k;
sneer: [a]/snɪr/; [v]冷笑;嘲笑; [n]嘲笑; [or]gre3k;
snobbish: [a]/ˈsnɑːbɪʃ/; [adj]自命不凡的,势利的; [or]gre3k;
snub: [a]/snʌb/; [n]冷落,怠慢; [vt]冷落;断然拒绝;掐灭; [adj]故意冷落的,断然拒绝的,斥责的; [or]gre3k;
soak: [a]/soʊk/; [v]浸泡,渗透,吸入; [n]浸泡; [or]gre3k;
sober: [a]/ˈsoʊbər/; [vi]变得冷静; [adj]未饮醉的,清醒的;有节制的;严肃的; [v]使清醒;使冷静; [or]gre3k;
sodden: [a]/ˈsɑːdn/; [adj]浑身湿透的;浸透的;浸过酒的; [or]gre3k;
solace: [a]/ˈsɑːləs/; [n]慰藉,给予安慰的人或事物; [v]安慰,缓和,使开心; [or]gre3k;
solder: [a]/ˈsɑːdər/; [v]焊接;使联接在一起; [n]焊接;接合物; [or]gre3k;
solemnity: [a]/səˈlemnəti/; [n]庄严,肃穆,庄严的仪式; [or]gre3k;
solicitous: [a]/səˈlɪsɪtəs/; [adj]热切期望的;热心的;挂念的; [or]gre3k;
solid: [a]/ˈsɑːlɪd/; [adj]结实的;坚固的;固体的; [n]固体; [or]gre3k;
soliloquy: [a]/səˈlɪləkwi/; [n]自言自语,独白; [or]gre3k;
solitude: [a]/ˈsɑːlətuːd/; [n]孤独; [or]gre3k;
solvent: [a]/ˈsɑːlvənt/; [adj]有偿付能力的;有溶解力的; [n]溶剂;解决方法; [or]gre3k;
somatic: [a]/soʊ'mætɪk/; [adj]肉体的; [or]gre3k;
somber: [a]/'sɒmbə/; [adj]忧郁的;昏暗的,阴天的; [or]gre3k;
somnolence: [a]/ˈsɑːmnələns/; [n]困倦;想睡;嗜眠症; [or]gre3k;
sonnet: [a]/ˈsɑːnɪt/; [n]十四行诗; [or]gre3k;
soothe: [a]/suːð/; [v]使(某人,情绪)平静,安慰,使(痛苦,疼痛)缓和或减轻; [or]gre3k;
sop: [a]/sɑːp/; [n]安慰物,贿赂,回扣; [v]浸湿,湿透; [or]gre3k;
sophisticated: [a]/səˈfɪstɪkeɪtɪd/; [adj](仪器)精密的,复杂的;老于世故的,老练的,富有经验的;高雅的,精致的; [or]gre3k;
soporific: [a]/ˌsɑːpəˈrɪfɪk/; [adj]催眠的; [n]安眠药; [or]gre3k;
sordid: [a]/ˈsɔːrdɪd/; [adj]卑鄙的,肮脏的,色彩死气沉沉暗淡的; [or]gre3k;
sparing: [a]/ˈsperɪŋ/; [adj]节省的,节制的,少量使用的,保守的; [or]gre3k;
sparse: [a]/spɑːrs/; [adj]稀少的;稀疏的; [or]gre3k;
spat: [a]/spæt/; [n]口角,小争论; [v]轻轻拍打;发生小争吵; [or]gre3k;
spate: [a]/speɪt/; [n]洪水;一阵;大雨;突然迸发; [or]gre3k;
specific: [a]/spəˈsɪfɪk/; [adj]具体的,明确的;特定的;特殊的;针对..的; [n]详情;特性; [or]gre3k;
specious: [a]/ˈspiːʃəs/; [adj]外表美观,华而不实的,徒有其表的; [or]gre3k;
speck: [a]/spek/; [n]斑点,灰尘,污点,小颗粒; [or]gre3k;
spectator: [a]/ˈspekteɪtər/; [n]旁观者;观众;目击者; [or]gre3k;
spectrum: [a]/ˈspektrəm/; [n]光谱,范围,系列; [or]gre3k;
speculate: [a]/ˈspekjuleɪt/; [vi]推测,猜测;投机,做投机买卖; [vt]推测; [or]gre3k;
spendthrift: [a]/ˈspendθrɪft/; [adj]挥霍无度的;浪费的; [n]挥霍无度的人;浪费的人; [or]gre3k;
spent: [a]/spent/; [adj]精疲力竭的; [or]gre3k;
spindly: [a]/ˈspɪndli/; [adj]细长的;纺锤形的; [or]gre3k;
spiny: [a]/ˈspaɪni/; [adj]多刺的;长刺的;刺状的;棘手的; [n]多刺的东西; [or]gre3k;
spleen: [a]/spliːn/; [n]脾,脾气,怒气; [or]gre3k;
splice: [a]/splaɪs/; [n]接合,衔接处; [v]接头,捻接(线头等); [or]gre3k;
splinter: [a]/ˈsplɪntər/; [n]碎片;微小的东西;极瘦的人; [v]分裂;裂成碎片; [or]gre3k;
splutter: [a]/ˈsplʌtər/; [n]劈啪声,急忙说出的话,杂乱的声音; [v]喷溅,气急败坏地说; [or]gre3k;
spontaneous: [a]/spɑːnˈteɪniəs/; [adj]自发的,无意识的;自然的,天真率直的; [or]gre3k;
spoof: [a]/spuːf/; [n]滑稽模仿(对电影,电视节目等); [v]揶揄,嘲讽;哄骗,欺骗; [or]gre3k;
sporadic: [a]/spəˈrædɪk/; [adj]不定时发生的;零星的;分散的; [or]gre3k;
sprawl: [a]/sprɔːl/; [n]四肢伸开的躺卧姿势;蔓生; [v]四肢伸开地坐(或卧);爬行;蔓生; [or]gre3k;
sprightly: [a]/ˈspraɪtli/; [adj]活泼的;生气勃勃的;轻快的; [adv]活泼;生气勃勃;轻松地; [or]gre3k;
spur: [a]/spɜːr/; [v]策马,用踢马刺驱马前进;激励,鞭策;推动; [n]踢马刺,靴刺;刺激,鞭策,鼓励;尖坡; [or]gre3k;
spurious: [a]/ˈspjʊriəs/; [adj]假的,伪造的,欺骗的; [or]gre3k;
spurn: [a]/spɜːrn/; [v]轻蔑地拒绝,摒弃,唾弃,一脚踢开; [or]gre3k;
squabble: [a]/ˈskwɑːbl/; [v]发生口角,大声争吵; [n]争吵,口角; [or]gre3k;
squalid: [a]/ˈskwɑːlɪd/; [adj]污秽的,肮脏的,卑劣的; [or]gre3k;
squall: [a]/skwɔːl/; [n](通常伴随着雨或雪的)风暴,暴风雪; [v]尖叫; [or]gre3k;
squander: [a]/ˈskwɑːndər/; [n]浪费,挥霍; [v]浪费,挥霍; [or]gre3k;
squat: [a]/skwɑːt/; [adj]蹲着的; [v]蹲坐,蹲伏; [n]蹲坐; [or]gre3k;
squeamish: [a]/ˈskwiːmɪʃ/; [adj]害怕的,易受惊的,想呕吐的; [n]易心烦意乱的人;神经脆弱的人; [or]gre3k;
squelch: [a]/skweltʃ/; [n]吧唧声;压制,镇压; [v]吧唧作响;消除,镇压,不让说; [or]gre3k;
squint: [a]/skwɪnt/; [v]斜视,眯眼睛看; [adj]斜着眼的;斜视的;细眯着眼看的;倾斜的;偏移的; [n]斜视眼;斜视斜眼;趋势; [or]gre3k;
stabilize: [a]/ˈsteɪbəlaɪz/; [v]使稳定; [or]gre3k;
stalwart: [a]/ˈstɔːlwərt/; [n]坚定的成员;健壮的人; [adj]强壮的,坚定的,忠诚的; [or]gre3k;
stamina: [a]/ˈstæmɪnə/; [n]耐力,持久力; [or]gre3k;
stammer: [a]/ˈstæmər/; [v]口吃,结巴着说出; [n]口吃; [or]gre3k;
startle: [a]/ˈstɑːrtl/; [v]吃惊;惊吓; [or]gre3k;
stasis: [a]/ˈsteɪsɪs/; [n]平衡,停滞; [or]gre3k;
static: [a]/ˈstætɪk/; [adj]静电的,静态的,静止的; [n]静电,静电干扰; [or]gre3k;
stature: [a]/ˈstætʃər/; [n]身高,身材;(精神,道德等的)高度; [or]gre3k;
staunch: [a]/stɔːntʃ/; [adj]坚定的,可靠的; [vt]止住;止血; [or]gre3k;
steadfast: [a]/ˈstedfæst/; [adj]坚定的;不变的; [or]gre3k;
stealth: [a]/stelθ/; [n]隐秘,秘密; [or]gre3k;
steep: [a]/stiːp/; [v]沉浸于..; [adj]陡峭的;急剧的;过高的; [n]陡坡; [or]gre3k;
stench: [a]/stentʃ/; [n]臭气,恶臭; [vi](使)发恶臭; [vt]发恶臭; [or]gre3k;
stentorian: [a]/stenˈtɔːriən/; [adj](指声音)极响亮的; [or]gre3k;
stereotype: [a]/ˈsteriətaɪp/; [n]老套的模式,陈规,成见; [v]对..产生成见; [or]gre3k;
sterile: [a]/ˈsterəl/; [adj]不孕的,无细菌的,贫瘠的; [or]gre3k;
stickler: [a]/ˈstɪklər/; [n]坚持细节的人,顽固的人,费解的事物; [or]gre3k;
stiff: [a]/stɪf/; [adj]僵直的,酸痛的;硬的;困难的; [or]gre3k;
stifle: [a]/ˈstaɪfl/; [v]抑制,压制,使窒息; [or]gre3k;
stigma: [a]/ˈstɪɡmə/; [n]<植>柱头,耻辱,污名,烙印,特征; [or]gre3k;
stigmatize: [a]/ˈstɪɡmətaɪz/; [v]诬蔑,玷污; [or]gre3k;
stingy: [a]/ˈstɪndʒi/; [adj]吝啬的,小气的,少量的; [or]gre3k;
stint: [a]/stɪnt/; [n]节约;从事某工作的时间;固定; [v]节省;限制; [or]gre3k;
stipple: [a]/ˈstɪpl/; [v]点画,点描; [or]gre3k;
stipulate: [a]/ˈstɪpjuleɪt/; [v]规定;保证;保证;要求以.为条件; [or]gre3k;
stitch: [a]/stɪtʃ/; [v]缝,绣; [n]一针,线迹;缝法,编结法;(肋部的)突然剧痛;缝合(伤口); [or]gre3k;
stock: [a]/stɑːk/; [n]股票;股份;存货;储备;家畜; [v]给..装满;储存; [adj]储备的; [or]gre3k;
stockade: [a]/stɑːˈkeɪd/; [n]栅栏,围栏; [or]gre3k;
stodgy: [a]/ˈstɑːdʒi/; [adj]平凡的;塞满的;庸俗的; [or]gre3k;
stoic: [a]/ˈstoʊɪkl/; [n]斯多葛学派哲学家;禁欲主义者;坚守克己之人; [adj]斯多葛派的;禁欲主义的; [or]gre3k;
stoke: [a]/stoʊk/; [v]添加燃料,把(火)拨旺,狼吞虎咽吃; [n]斯托克;<物>沲; [or]gre3k;
stolid: [a]/ˈstɑːlɪd/; [adj]无动于衷的,感情麻木的; [or]gre3k;
stonewall: [a]/ˈstoʊnwɔːl/; [v]阻碍议事,妨碍; [or]gre3k;
stouthearted: [a]/ˌstaʊtˈhɑrtəd/; [adj]勇敢的; [or]gre3k;
strait: [a]/streɪt/; [n]海峡;窘迫; [or]gre3k;
strand: [a]/strænd/; [n](线等的)股,缕;一个组成部分;海滨,河岸,海滩,湖滨; [v]使陷入困境;使滞留,使搁浅; [or]gre3k;
stratagem: [a]/ˈstrætədʒəm/; [n]谋略,策略; [or]gre3k;
stratify: [a]/ˈstrætɪfaɪ/; [v]分层,成层,阶层化; [or]gre3k;
stray: [a]/streɪ/; [adj]走失的,迷路的;离了群的; [v]走失;分心,走神;有外遇,在别处拈花惹草; [n]流浪者;走失,迷路; [or]gre3k;
strength: [a]/streŋθ/; [n]体力,力气,力量;意志力;长处;兵力;实力;人手;浓度,效力;力度,速度; [or]gre3k;
striate: [a]/'straɪˌeɪt/; [adj]有条纹的; [v]加条纹,加条; [or]gre3k;
stricture: [a]/ˈstrɪktʃər/; [n]谴责;严厉;束缚; [or]gre3k;
stride: [a]/straɪd/; [v]大步走;越过;跨越; [vt]大步走过;跨骑在.上; [n]大步;阔步行走的姿势;一大步;跨越;正常的进展; [or]gre3k;
strident: [a]/ˈstraɪdnt/; [adj]尖声的,刺耳的; [or]gre3k;
strike: [a]/straɪk/; [v]击打;袭击;罢工; [n]罢工;打击;袭击; [or]gre3k;
stringent: [a]/ˈstrɪndʒənt/; [adj]严厉的;迫切的;银根紧的; [or]gre3k;
strip: [a]/strɪp/; [v]剥;夺去;脱衣服; [n]长条;长条形土地; [adj]脱衣舞的;被剥去外皮的; [or]gre3k;
strut: [a]/strʌt/; [n]高视阔步,抗压装置; [v]昂首阔步地走,趾高气昂地走; [or]gre3k;
studio: [a]/ˈstuːdioʊ/; [n]摄影棚;工作室;录音室;单间公寓(studio flat);制片公司; [or]gre3k;
stultify: [a]/ˈstʌltɪfaɪ/; [v]使显得愚蠢,愚弄,使无效,使无价值; [or]gre3k;
stunt: [a]/stʌnt/; [n]惊人表演,特技;矮小的人(或物); [v]阻碍..发育;作惊人表演;使绝招; [or]gre3k;
stupor: [a]/ˈstuːpər/; [n]恍惚,昏迷,不醒人事; [or]gre3k;
sturdy: [a]/ˈstɜːrdi/; [adj]结实的;坚固的;强壮的;健壮的; [n](羊的)晕倒病; [or]gre3k;
stymie: [a]/ˈstaɪmi/; [v]从中作梗,阻挠;妨碍; [n]妨碍球; [or]gre3k;
subdue: [a]/səbˈduː/; [v]征服,压制,减轻; [or]gre3k;
subject: [a]/ˈsʌbdʒɪkt/; [n]科目;主题;受试者;国民; [adj]易患的,服从的; [vt]使服从,使隶属,使遭遇; [or]gre3k;
subjugate: [a]/ˈsʌbdʒuɡeɪt/; [v]征服,使服从; [or]gre3k;
sublime: [a]/səˈblaɪm/; [adj]雄伟的,崇高的,极端的,超群的;(行为,态度)极端的,漠不关心的; [n]顶峰,崇高; [v]使.纯化,使.升华,变高尚; [or]gre3k;
subliminal: [a]/ˌsʌbˈlɪmɪnl/; [adj]潜意识的,下意识的; [or]gre3k;
submerge: [a]/səbˈmɜːrdʒ/; [v]沉没,淹没;遮掩; [or]gre3k;
submissive: [a]/səbˈmɪsɪv/; [adj]顺从的,惟命是从的,谦恭的; [or]gre3k;
subordinate: [a]/səˈbɔːrdɪnət/; [n]部下;下属; [adj]次要的;从属的;下级的; [v]使从属于;使处于次要地位; [or]gre3k;
subservient: [a]/səbˈsɜːrviənt/; [adj]屈从的;奉承的;有用的,有帮助的; [or]gre3k;
subside: [a]/səbˈsaɪd/; [vi]平息,减弱;减弱;(建筑)下陷;(尤指洪水的水位) 回落; [or]gre3k;
subsidiary: [a]/səbˈsɪdieri/; [adj]辅助的,次要的,附属的; [n]子公司,附属机构; [or]gre3k;
subsidy: [a]/ˈsʌbsədi/; [n]补助金,津贴; [or]gre3k;
substantiate: [a]/səbˈstænʃieɪt/; [v]证实;使实体化; [or]gre3k;
substantive: [a]/səbˈstæntɪv/; [adj]有实质的;大量的;真实的;独立存在的; [n]实词,名词,名词性词组; [or]gre3k;
substitute: [a]/ˈsʌbstɪtuːt/; [v]代替; [n]代替者,代用品,替补队员; [or]gre3k;
subterfuge: [a]/ˈsʌbtərfjuːdʒ/; [n]托词,借口,诡计; [or]gre3k;
subtle: [a]/ˈsʌtl/; [adj]微妙的;敏锐的;不明显的;精细的;狡猾的; [or]gre3k;
succinct: [a]/səkˈsɪŋkt/; [adj]简明的,简洁的,没有废话的; [or]gre3k;
succor: [a]/ˈsʌkər/; [n]救援,援助者,救援人员; [v]援助,救援; [or]gre3k;
succumb: [a]/səˈkʌm/; [v]屈从,屈服,因.死亡(to); [or]gre3k;
suffocate: [a]/ˈsʌfəkeɪt/; [v]使窒息,被闷死,受阻; [or]gre3k;
suffuse: [a]/səˈfjuːz/; [v](色彩等)弥漫,染遍; [or]gre3k;
sulk: [a]/sʌlk/; [n]生气,愠怒,愠怒的人; [v]生气,愠怒; [or]gre3k;
sullen: [a]/ˈsʌlən/; [adj]沮丧的,闷闷不乐的;阴沉的; [or]gre3k;
summary: [a]/ˈsʌməri/; [n]摘要,总结; [adj]简略的,概要的,即决的; [or]gre3k;
summit: [a]/ˈsʌmɪt/; [n]山顶,顶点;(政府间的)峰会; [or]gre3k;
summon: [a]/ˈsʌmən/; [v]召唤;召集;聚集; [or]gre3k;
sumptuous: [a]/ˈsʌmptʃuəs/; [adj]奢侈的;华丽的; [or]gre3k;
sunder: [a]/ˈsʌndər/; [v]切开;分裂,分离; [or]gre3k;
supercilious: [a]/ˌsuːpərˈsɪliəs/; [adj]目中无人的,高傲的; [or]gre3k;
superficial: [a]/ˌsuːpərˈfɪʃl/; [adj]肤浅的;表面的;微不足道的; [n]表面文章; [or]gre3k;
superfluous: [a]/suːˈpɜːrfluəs/; [adj]多余的,过剩的;不必要的; [or]gre3k;
superimpose: [a]/ˌsuːpərɪmˈpoʊz/; [v]添加;重叠;附加;安装; [or]gre3k;
supersede: [a]/ˌsuːpərˈsiːd/; [v]代替;紧接着而到来; [or]gre3k;
supine: [a]/ˈsuːpaɪn/; [adj]仰卧的;懒散的;向后靠的; [or]gre3k;
supplant: [a]/səˈplænt/; [v]代替;排挤掉; [or]gre3k;
supple: [a]/ˈsʌpl/; [adj]柔软的;柔顺的; [or]gre3k;
supplement: [a]/ˈsʌplɪmənt/; [n]增补,补充物,保健品;附录; [v]补充; [or]gre3k;
supplicate: [a]/'sʌplɪˌkeɪt/; [v]恳求,乞求; [or]gre3k;
suppress: [a]/səˈpres/; [v]镇压;禁止发表;抑制(感情等);阻止.的生长; [or]gre3k;
surcharge: [a]/ˈsɜːrtʃɑːrdʒ/; [n]额外费用,过高的要价; [v]追加罚款;使.装载过多;使.负担过重; [or]gre3k;
surfeit: [a]/ˈsɜːrfɪt/; [n]饮食过度,过量; [or]gre3k;
surly: [a]/ˈsɜːrli/; [adj]乖戾的;无礼的;阴沉的; [or]gre3k;
surmise: [a]/sərˈmaɪz/; [v]猜测,推测,认为; [n]推测,猜度; [or]gre3k;
surmount: [a]/sərˈmaʊnt/; [v]克服,战胜,越过; [or]gre3k;
surpass: [a]/sərˈpæs/; [v]胜过;超出; [or]gre3k;
surrender: [a]/səˈrendər/; [v]投降;屈服;放弃;交出;自首; [n]投降;放弃;屈服;(保险的)解约; [or]gre3k;
surreptitious: [a]/ˌsɜːrəpˈtɪʃəs/; [adj]鬼鬼祟祟的,暗中的,秘密的; [or]gre3k;
surrogate: [a]/ˈsɜːrəɡət/; [n]代替品,代理人,代孕妈妈; [adj]代理的,替代的; [v]代替,代理;指定为自己的代理人,接替; [or]gre3k;
surveillance: [a]/sɜːrˈveɪləns/; [n]监视;检查; [or]gre3k;
susceptibility: [a]/səˌseptəˈbɪləti/; [n]易感性的,敏感性,感情; [or]gre3k;
suspend: [a]/səˈspend/; [v]悬挂,吊;中止;推迟; [or]gre3k;
suture: [a]/ˈsuːtʃər/; [n]缝合; [v]缝合; [or]gre3k;
svelte: [a]/svelt/; [adj]体态苗条的;线条清晰的; [or]gre3k;
swagger: [a]/ˈswæɡər/; [n]傲慢的态度,大摇大摆; [v]大摇大摆地走,吹牛,傲慢; [adj]豪华时髦的; [or]gre3k;
swear: [a]/swer/; [v]发誓,郑重地说;咒骂; [or]gre3k;
sweltering: [a]/ˈsweltərɪŋ/; [adj]酷热的; [or]gre3k;
swerve: [a]/swɜːrv/; [v]转弯,突然改变方向; [n]转向;滑出;逸出;背离; [or]gre3k;
swill: [a]/swɪl/; [n]泔水;冲洗;痛饮; [v]冲洗,痛饮; [or]gre3k;
swindle: [a]/ˈswɪndl/; [n]诈骗;欺诈行为;骗局; [vi]欺骗,行骗; [vt]诈骗;骗取; [or]gre3k;
sybarite: [a]/'sɪbəˌraɪt/; [n]沉于奢侈逸乐者,酒色之徒; [or]gre3k;
sycophant: [a]/ˈsɪkəfænt/; [n]马屁精; [or]gre3k;
syllabus: [a]/ˈsɪləbəs/; [n]教学大纲,摘要,课程表; [or]gre3k;
symbiosis: [a]/ˌsɪmbɪˈoʊsɪs/; [n]共生,共栖; [or]gre3k;
symmetry: [a]/ˈsɪmətri/; [n]对称;均衡; [or]gre3k;
synchronous: [a]/ˈsɪŋkrənəs/; [adj]同时的,<物>同步的; [or]gre3k;
synonymous: [a]/sɪˈnɑːnɪməs/; [adj]同义的;同义词的;同义突变的; [or]gre3k;
synopsis: [a]/sɪˈnɑːpsɪs/; [n]摘要,概要; [or]gre3k;
synthesis: [a]/ˈsɪnθəsɪs/; [n]合成; [or]gre3k;
tacit: [a]/ˈtæsɪt/; [adj]心照不宣的,静默的; [or]gre3k;
taciturn: [a]/ˈtæsɪtɜːrn/; [adj]沉默寡言的; [or]gre3k;
tackle: [a]/ˈtækl/; [v]对付,处理;(足球等比赛中)阻截; [n]阻截;钓具;滑轮(组); [or]gre3k;
tact: [a]/tækt/; [n]机智,得体,老练,圆滑; [or]gre3k;
tactile: [a]/ˈtæktl/; [adj]有触觉的;能触知的; [or]gre3k;
tactless: [a]/ˈtæktləs/; [adj]不机智的,笨拙的; [adv]粗鲁地,笨拙地,不老练地; [n]粗鲁,笨拙; [or]gre3k;
taint: [a]/teɪnt/; [n]污点;感染;异味; [vi]腐败,腐烂; [vt]污染;玷污,使受不良影响; [or]gre3k;
talisman: [a]/ˈtælɪzmən/; [n]护身符,避邪物; [or]gre3k;
tame: [a]/teɪm/; [adj]驯服的,温顺的;顺从的;枯燥的; [v]驯服; [or]gre3k;
tamper: [a]/ˈtæmpər/; [v]篡改;玩弄;贿赂; [n]填塞者;捣棒; [or]gre3k;
tangent: [a]/ˈtændʒənt/; [n]切线; [adj]无关的; [or]gre3k;
tangle: [a]/ˈtæŋɡl/; [v](使)缠结;(使)乱作一团; [n]纠缠;纠结;复杂的问题;困惑; [or]gre3k;
tangy: [a]/ˈtæŋi/; [adj]扑鼻的,有刺激性的,强烈的; [or]gre3k;
tantalize: [a]/ˈtæntəlaɪz/; [v]逗弄,挑逗,使(看到拿不到而)焦急; [or]gre3k;
tantamount: [a]/ˈtæntəmaʊnt/; [adj]与.相等的; [or]gre3k;
tantrum: [a]/ˈtæntrəm/; [n](孩子气的)脾气发作; [or]gre3k;
taper: [a]/ˈteɪpər/; [v]逐渐变细; [n]锥形;渐弱;蜡芯,小蜡烛; [vi]变尖;逐渐减弱; [vt]变尖;逐渐减弱; [adj]渐细的;斜的;依次递减的; [or]gre3k;
tardy: [a]/ˈtɑːrdi/; [n]迟到,迟到记录; [adj]缓慢的,迟到的,磨蹭的; [or]gre3k;
tarnish: [a]/ˈtɑːrnɪʃ/; [n]弄脏;失去光泽,生锈; [v]变灰暗,失去光泽,破坏(形象等); [or]gre3k;
tasty: [a]/ˈteɪsti/; [adj]好吃的;(尤指女子)迷人的,性感的; [or]gre3k;
tatty: [a]/ˈtæti/; [adj]不整洁的;不值钱的;简陋的; [or]gre3k;
taunt: [a]/tɔːnt/; [n]辱骂,嘲弄; [vt]嘲弄,奚落; [adj]<海>(桅杆)很高的; [adv]扯满风帆; [or]gre3k;
taut: [a]/tɔːt/; [adj]拉紧的;紧张的;整洁的; [or]gre3k;
tawdry: [a]/ˈtɔːdri/; [adj]非常华丽的,廉价而俗丽的; [n]俗丽的东西,廉价而俗丽之物; [adv]俗丽地,华而不实地; [or]gre3k;
taxing: [a]/ˈtæksɪŋ/; [adj]繁重的,费力的; [or]gre3k;
tedious: [a]/ˈtiːdiəs/; [adj]沉闷的,冗长乏味的; [or]gre3k;
teeming: [a]/ˈtiːmɪŋ/; [adj]多产的,丰富的;热闹的; [or]gre3k;
teeter: [a]/ˈtiːtər/; [v]使..摇摆;使..上下晃动;蹒跚; [n]跷跷板;摇摆; [or]gre3k;
teetotalism: [a]/ˌtiːˈtoʊtəlɪzəm/; [n]禁酒; [or]gre3k;
telling: [a]/ˈtelɪŋ/; [adj]明显的;生动的; [n]叙述; [or]gre3k;
temerity: [a]/təˈmerəti/; [n]鲁莽,大胆,蛮勇; [or]gre3k;
temperate: [a]/ˈtempərət/; [adj]温和的;适度的,有节制的; [or]gre3k;
tempestuous: [a]/temˈpestʃuəs/; [adj]有暴风雨的,暴乱的,剧烈的; [or]gre3k;
temporal: [a]/ˈtempərəl/; [adj]现世的,世俗的;当时的,暂时的;<解>颞的;时间的; [n]世间万物;教会财产; [or]gre3k;
temporize: [a]/ˈtempəraɪz/; [v]拖延,妥协,顺应时势,迎合潮流; [or]gre3k;
tenable: [a]/ˈtenəbl/; [adj]站得住脚的;无懈可击的;合理的; [or]gre3k;
tenacious: [a]/təˈneɪʃəs/; [adj]坚忍不拔的,固执的,顽强的; [or]gre3k;
tendentious: [a]/tenˈdenʃəs/; [adj]有偏见的,有倾向的;宣传性的; [adv]宣传性地,不公平地,有倾向性地; [n]倾向性小说; [or]gre3k;
tender: [a]/ˈtendər/; [adj]温柔的;嫩的;柔弱的,脆弱的;痛的; [n]煤水车,附属船;投标; [v]提出(希望对方接受的意见等); [or]gre3k;
tentative: [a]/ˈtentətɪv/; [adj]试探性的;不确定的;暂时的;犹豫不决的; [or]gre3k;
tenuous: [a]/ˈtenjuəs/; [adj]纤细的;稀薄的;贫乏的;脆弱的; [or]gre3k;
tepid: [a]/ˈtepɪd/; [adj]微温的,不热烈的; [or]gre3k;
terminology: [a]/ˌtɜːrməˈnɑːlədʒi/; [n]术语,术语学; [or]gre3k;
terminus: [a]/ˈtɜːrmɪnəs/; [n](火车,汽车)终点站;界标; [or]gre3k;
terror: [a]/ˈterər/; [n]恐怖,惊骇; [or]gre3k;
terse: [a]/tɜːrs/; [adj]简洁的,简明的; [or]gre3k;
testimony: [a]/ˈtestɪmoʊni/; [n]证据,证词;表明,说明;见证,证明; [or]gre3k;
testy: [a]/ˈtesti/; [adj]性急的,暴躁的; [or]gre3k;
tether: [a]/ˈteðər/; [n]范围,系链,拴绳; [v]用绳或链拴住; [or]gre3k;
theatrical: [a]/θiˈætrɪkl/; [adj]戏剧的,矫揉造作的; [n]戏剧表演;戏剧演员;戏剧表演艺术;做戏似的动作; [or]gre3k;
therapeutic: [a]/ˌθerəˈpjuːtɪk/; [adj]治疗的;治疗学的;有益于健康的; [n]治疗剂;治疗学家; [or]gre3k;
thorny: [a]/ˈθɔːrni/; [adj]多刺的;痛苦的;令人苦恼的; [or]gre3k;
threadbare: [a]/ˈθredber/; [adj]磨破的,衣衫褴褛的,乏味的,俗套的; [or]gre3k;
thrill: [a]/θrɪl/; [n]兴奋,激动,引起激动的事物; [v](使)非常兴奋,(使)非常激动; [or]gre3k;
throng: [a]/θrɔːŋ/; [v]群集,蜂拥; [n]一大群人; [vt]挤向; [or]gre3k;
thwart: [a]/θwɔːrt/; [n]<船>横坐板; [v]阻挠,阻碍,横过; [adj]横放的; [adv]横过; prep. 〈古〉横跨,横过; [or]gre3k;
ticklish: [a]/ˈtɪklɪʃ/; [adj]不稳定的;难对付的;易倒的;易痒的;忌讳的; [adv]怕痒地; [n]怕痒,小心处理; [or]gre3k;
tiff: [a]/tɪf/; [n]淡酒;一口;口角;生气; [or]gre3k;
tightfisted: [a]/'taɪt'fɪstɪd/; [adj]吝啬的; [or]gre3k;
timely: [a]/ˈtaɪmli/; [adj]适时的,及时的; [adv]及时地; [or]gre3k;
timeworn: [a]/ˈtaɪmˌwɔrn/; [adj]陈腐的; [or]gre3k;
timid: [a]/ˈtɪmɪd/; [adj]胆怯的;腼腆的; [or]gre3k;
timorous: [a]/ˈtɪmərəs/; [adj]胆小的,胆怯的,羞怯的; [or]gre3k;
tinge: [a]/tɪndʒ/; [n]淡淡的(颜色,神色),轻微,少量; [v]给.染色,轻微地影响; [or]gre3k;
tinker: [a]/ˈtɪŋkər/; [n](流动的)补锅工人; [v]做拙劣修补; [or]gre3k;
tint: [a]/tɪnt/; [n]色彩;染发剂;染色; [v]染色,着色于.; [or]gre3k;
tirade: [a]/ˈtaɪreɪd/; [n]长篇的攻击性演说; [or]gre3k;
toady: [a]/ˈtoʊdi/; [n]谄媚者,拍马屁的人; [v]谄媚,拍马屁; [or]gre3k;
tonic: [a]/ˈtɑːnɪk/; [n]补药;主调音或基音; [adj]滋补的;声调的;使精神振作的; [or]gre3k;
topsy-turvy: [a]/ˌtɑːpsi ˈtɜːrvi/; [adj]混乱的,不整洁的; [n]颠倒,乱七八糟; [or]gre3k;
torpid: [a]/ˈtɔːrpɪd/; [adj]懒散的,死气沉沉的,不活泼的; [or]gre3k;
torpor: [a]/ˈtɔːrpər/; [n]麻木;无感觉;不活泼; [or]gre3k;
torrential: [a]/təˈrenʃl/; [adj]汹涌的;奔流的; [adv]似急流地; [or]gre3k;
torrid: [a]/ˈtɔːrɪd/; [adj]酷热的,热烈; [or]gre3k;
tortuous: [a]/ˈtɔːrtʃuəs/; [adj]弯弯曲曲的,蜿蜒的; [or]gre3k;
tout: [a]/taʊt/; [v]招徕顾客,极力赞扬; [or]gre3k;
toy: [a]/tɔɪ/; [n]玩具; [v]不认真考虑,玩弄; [adj]作为玩具的; [or]gre3k;
tractable: [a]/ˈtræktəbl/; [adj]易于管教的,易驾驭的,易处理的,驯良的; [or]gre3k;
tranquility: [a]/træŋ'kwɪlətɪ/; [n]安静,平静; [or]gre3k;
transcend: [a]/trænˈsend/; [v]超越(经验,理性,信念等)的范围,超过; [or]gre3k;
transfigure: [a]/trænsˈfɪɡjər/; [v]美观,改观; [or]gre3k;
transgress: [a]/trænzˈɡres/; [v]冒犯,违背;侵犯;越界; [or]gre3k;
transient: [a]/ˈtrænʃnt/; [adj]短暂的,路过的;转瞬即逝的; [n]过客; [or]gre3k;
transitory: [a]/ˈtrænsətɔːri/; [adj]短暂的,暂时的,瞬息的; [or]gre3k;
translucent: [a]/trænsˈluːsnt/; [adj]半透明的;透亮的,有光泽的;易懂的;真实的; [or]gre3k;
transparent: [a]/trænsˈpærənt/; [adj]透明的,清澈的,明净的;易识破的,显而易见的; [or]gre3k;
travail: [a]/trəˈveɪl/; [n]分娩的痛苦,艰苦劳动; [v]辛勤努力,经受分娩的阵痛; [or]gre3k;
traverse: [a]/trəˈvɜːrs/; [v]横越;穿过; [n]横越; [or]gre3k;
travesty: [a]/ˈtrævəsti/; [n]滑稽模仿;拙劣的模仿作品;歪曲; [vt]滑稽地模仿;歪曲; [or]gre3k;
treacherous: [a]/ˈtretʃərəs/; [adj]不牢靠的,危险的;奸诈的,叛逆的,背叛的; [adv]背信弃义地; [n]背信弃义,背叛; [or]gre3k;
trenchant: [a]/ˈtrentʃənt/; [adj]犀利的,锐利的,有力的,清晰的,一针见血的; [or]gre3k;
trepidation: [a]/ˌtrepɪˈdeɪʃn/; [n]恐惧,惶恐; [or]gre3k;
trespass: [a]/ˈtrespæs/; [v]侵入;犯罪; [n]罪过;非法侵入; [or]gre3k;
tribute: [a]/ˈtrɪbjuːt/; [n]致敬;悼念;贡品;称赞; [or]gre3k;
trickle: [a]/ˈtrɪkl/; [v]一滴滴地流;徐徐地流; [n]细流;徐徐地流;稀稀疏疏缓慢来往的东西; [or]gre3k;
trifle: [a]/ˈtraɪfl/; [n]蛋糕;琐事,小事,无价值的东西; [v]嘲笑,轻视; [or]gre3k;
trifling: [a]/ˈtraɪflɪŋ/; [adj]细微的,不重要的; [or]gre3k;
trite: [a]/traɪt/; [adj]陈腐的;平庸的;老一套的; [or]gre3k;
truant: [a]/ˈtruːənt/; [n]旷课者,懒惰的人; [adj]旷课的,偷懒的; [v]逃学,偷懒,逃避责任; [or]gre3k;
truce: [a]/truːs/; [n]停战;休战;休战协定; [or]gre3k;
truculent: [a]/ˈtrʌkjələnt/; [adj]好斗的;野蛮的;言词刻毒的; [or]gre3k;
trudge: [a]/trʌdʒ/; [n]长途跋涉,沉重的步伐; [v]跋涉,吃力地走; [or]gre3k;
trumpet: [a]/ˈtrʌmpɪt/; [n]喇叭,小号;小号声;小号手;传声筒; [v]吹喇叭;发出喇叭般的声音;用喇叭吹出;发喇叭似的声音;大声宣布;宣扬; [or]gre3k;
truncate: [a]/ˈtrʌŋkeɪt/; [adj]截短的;被删节的; [v]把(某物)截短,去尾; [or]gre3k;
truss: [a]/trʌs/; [n]束;构架;捆; [v]捆绑;用构架支撑; [or]gre3k;
tumult: [a]/ˈtuːmʌlt/; [n]骚动;骚乱;吵闹;激动; [or]gre3k;
turbid: [a]/ˈtɜːrbɪd/; [adj]混浊的,紊乱的; [or]gre3k;
turbulent: [a]/ˈtɜːrbjələnt/; [adj]湍急的;混乱的,动荡的;骚动的; [or]gre3k;
turgid: [a]/ˈtɜːrdʒɪd/; [adj]肿胀的;浮夸的;浮肿的; [or]gre3k;
turmoil: [a]/ˈtɜːrmɔɪl/; [n]骚动,骚乱; [or]gre3k;
turncoat: [a]/ˈtɜːrnkoʊt/; [n]叛徒; [or]gre3k;
turpitude: [a]/ˈtɜːrpətuːd/; [n]邪恶,卑鄙(行为); [or]gre3k;
twig: [a]/twɪɡ/; [n]细枝,嫩枝;末梢;桠枝; [or]gre3k;
tycoon: [a]/taɪˈkuːn/; [n]有钱有势的企业家,大亨; [or]gre3k;
typo: [a]/ˈtaɪpoʊ/; [n]排印错误;排字工;印刷工; [or]gre3k;
tyrant: [a]/ˈtaɪrənt/; [n]暴君; [or]gre3k;
tyro: [a]/ˈtaɪroʊ/; [n]新手; [or]gre3k;
ubiquitous: [a]/juːˈbɪkwɪtəs/; [adj]普遍存在的;无所不在的; [or]gre3k;
umbrage: [a]/ˈʌmbrɪdʒ/; [n]不快,愤怒; [or]gre3k;
unanimous: [a]/juˈnænɪməs/; [adj]全体一致的;一致同意的; [or]gre3k;
unassailable: [a]/ˌʌnəˈseɪləbl/; [adj]无可争辩的,无懈可击的,不可亵渎的; [or]gre3k;
unavailing: [a]/ˌʌnəˈveɪlɪŋ/; [adj]无效的,徒劳的; [or]gre3k;
uncanny: [a]/ʌnˈkæni/; [adj]神秘的,不可思议的; [or]gre3k;
uncouth: [a]/ʌnˈkuːθ/; [adj]笨拙的;粗野的;不舒适的;陌生的; [or]gre3k;
unctuous: [a]/ˈʌŋktʃuəs/; [adj]油腔滑调的,虚情假意的; [or]gre3k;
underdog: [a]/ˈʌndərdɔːɡ/; [n]弱势的一方,受害者,输家; [or]gre3k;
undergird: [a]/ˌʌndə'gɜːd/; [v]加强,巩固..的底部; [or]gre3k;
undermine: [a]/ˌʌndərˈmaɪn/; [v]暗中破坏;逐渐削弱;侵蚀.的基础;在...下挖坑道,从根基处损害; [or]gre3k;
underscore: [a]/ˌʌndərˈskɔːr/; [v]强调,加强,划线于.下; [n]底线; [or]gre3k;
unexceptionable: [a]/ˌʌnɪkˈsepʃənəbl/; [adj]无懈可击的,完美无缺的,极好的; [or]gre3k;
unflappable: [a]/ˌʌnˈflæpəbl/; [adj]镇定自若的;从容不迫的; [or]gre3k;
ungainly: [a]/ʌnˈɡeɪnli/; [adj]笨拙的,不雅的; [adv]笨拙地;不雅地; [or]gre3k;
unimpeachable: [a]/ˌʌnɪmˈpiːtʃəbl/; [adj]可信的,无可挑剔的; [or]gre3k;
unkempt: [a]/ˌʌnˈkempt/; [adj](衣服,头发)不整洁的;蓬乱的; [or]gre3k;
unlettered: [a]/ˌʌnˈletərd/; [adj]未受教育的,文盲的; [or]gre3k;
unproductive: [a]/ˌʌnprəˈdʌktɪv/; [adj]徒然的,无效的; [or]gre3k;
unrequited: [a]/ˌʌnrɪˈkwaɪtɪd/; [adj]无回报的;无报酬的; [or]gre3k;
unruly: [a]/ʌnˈruːli/; [adj]不守规矩的;任性的;难驾驭的; [or]gre3k;
untenable: [a]/ʌnˈtenəbl/; [adj]防守不住的,站不住脚的; [or]gre3k;
untold: [a]/ˌʌnˈtoʊld/; [adj]无数的,数不清的; [or]gre3k;
untoward: [a]/ʌnˈtɔːrd/; [adj](困难)出乎意料的; [or]gre3k;
unwitting: [a]/ʌnˈwɪtɪŋ/; [adj]不知情的;无意的; [or]gre3k;
upbraid: [a]/ʌpˈbreɪd/; [v]斥责,责骂; [or]gre3k;
uphold: [a]/ʌpˈhoʊld/; [v]维护,支持,举起; [or]gre3k;
urbane: [a]/ɜːrˈbeɪn/; [adj]温文尔雅的,懂礼的;都<城>市气派的; [or]gre3k;
usurp: [a]/juːˈzɜːrp/; [vi]篡夺,篡位; [vt]篡夺,强夺; [or]gre3k;
utter: [a]/ˈʌtər/; [v]说,发出;发射; [adj]完全的;彻底的;无条件的; [or]gre3k;
vaccinate: [a]/ˈvæksɪneɪt/; [v]进行预防接种; [n]被接种牛痘者; [or]gre3k;
vacillate: [a]/ˈvæsəleɪt/; [v]犹豫;踌躇;摇摆; [or]gre3k;
vacuous: [a]/ˈvækjuəs/; [adj]空的,空虚的,空洞的,无意义的; [or]gre3k;
vagary: [a]/'veɪgərɪ/; [n]奇想;奇特行为; [or]gre3k;
vague: [a]/veɪɡ/; [adj]含糊的,模糊的,不明确的,茫然的; [n]模糊不定状态; [or]gre3k;
valediction: [a]/ˌvælɪˈdɪkʃn/; [n]告别演说;告别词; [or]gre3k;
valiant: [a]/ˈvæliənt/; [n]勇士,勇敢的人; [adj]勇敢的,英勇的; [or]gre3k;
valid: [a]/ˈvælɪd/; [adj]有效的,正式认可的;合理的,有根据的; [or]gre3k;
vanquish: [a]/ˈvæŋkwɪʃ/; [v]征服,击败; [or]gre3k;
vapid: [a]/ˈvæpɪd/; [adj]索然无味的;无生气的; [adv]乏味地;无滋味地;无趣味地;无生气地; [or]gre3k;
vaporize: [a]/ˈveɪpəraɪz/; [v](使)蒸发;使.蒸发; [or]gre3k;
variance: [a]/ˈveriəns/; [n]变化;<数> 方差;不一致;分歧;变异; [or]gre3k;
variegated: [a]/ˈverɪɡeɪtɪd/; [n]使富有变化,使成为杂色; [adj]斑驳的,多色的,富于变化的; [or]gre3k;
varnish: [a]/ˈvɑːrnɪʃ/; [n]清漆;虚饰;光泽面; [v]涂上清漆;使.有光泽; [or]gre3k;
vault: [a]/vɔːlt/; [n]保险库,金库,拱顶,墓室; [v]越过,跳过; [or]gre3k;
vaunt: [a]/vɔːnt/; [v]吹嘘,炫耀; [or]gre3k;
veer: [a]/vɪr/; [n]方向的转变; [v]转向,改变(话题等),放松(绳,缆等); [or]gre3k;
vehement: [a]/ˈviːəmənt/; [adj]猛烈的,强烈的; [or]gre3k;
venal: [a]/ˈviːnl/; [adj]唯利是图的;贪赃枉法; [or]gre3k;
vendor: [a]/ˈvendər/; [n]小贩,卖主,供应商; [or]gre3k;
veneer: [a]/vəˈnɪr/; [n](镶于劣质东西上的)镶面板;掩饰; [v]虚饰;给.镶以饰片; [or]gre3k;
venerate: [a]/ˈvenəreɪt/; [v]崇敬,敬仰; [or]gre3k;
venial: [a]/ˈviːniəl/; [adj]可原谅的,(罪过)轻微的,可宽恕的; [or]gre3k;
venom: [a]/ˈvenəm/; [n]毒液;恶意;怨恨; [vt]使有毒;放毒; [or]gre3k;
veracious: [a]/və'reɪʃəs/; [adj]诚实的,说真话的; [or]gre3k;
verbatim: [a]/vɜːrˈbeɪtɪm/; [adj]逐字的; [adv]逐字地; [or]gre3k;
verbose: [a]/vɜːrˈboʊs/; [adj]冗长的,啰嗦的; [or]gre3k;
verdant: [a]/ˈvɜːrdnt/; [adj]青葱的,翠绿的; [or]gre3k;
verify: [a]/ˈverɪfaɪ/; [v]查证,证明,证实; [or]gre3k;
verisimilar: [a]/ˌverə'sɪmələ/; [adj]逼真的; [or]gre3k;
vernacular: [a]/vərˈnækjələr/; [adj]本国的,地方的,用本地语写成的; [n]方言;土语;(建筑的)民间风格; [or]gre3k;
versatile: [a]/ˈvɜːrsətl/; [adj]万能的,综合的,多才多艺的; [or]gre3k;
verse: [a]/vɜːrs/; [n]诗句,诗节,诗; [or]gre3k;
versed: [a]/vɜːrst/; [adj]熟练的,精通的; [or]gre3k;
vertigo: [a]/ˈvɜːrtɪɡoʊ/; [n]晕头转向;眩晕; [or]gre3k;
verve: [a]/vɜːrv/; [n]热情,神韵,活力,气魄; [or]gre3k;
vessel: [a]/ˈvesl/; [n]船,容器,血管; [or]gre3k;
vestige: [a]/ˈvestɪdʒ/; [n]遗迹,(生)退化的器官,残余,微量(一般用于否定句); [or]gre3k;
veteran: [a]/ˈvetərən/; [n]老兵;退役军人; [adj]经验丰富的;老练的; [or]gre3k;
veto: [a]/ˈviːtoʊ/; [v]否决;投反对票; [n]否决;否决权;禁止; [or]gre3k;
vex: [a]/veks/; [v]使烦恼,使苦恼,使恼怒; [or]gre3k;
viable: [a]/ˈvaɪəbl/; [adj]可行的;能养活的;能生育的; [or]gre3k;
vicarious: [a]/vaɪˈkeriəs/; [adj]代替别人做的;代理的,代替的;发同感的; [or]gre3k;
vicious: [a]/ˈvɪʃəs/; [adj]罪恶的;恶意的;凶猛的,残忍的; [or]gre3k;
vicissitude: [a]/vɪˈsɪsɪtuːd/; [n]变迁,沧桑,兴衰; [or]gre3k;
victimize: [a]/ˈvɪktɪmaɪz/; [v]使受害,使牺牲,欺骗; [or]gre3k;
vigilant: [a]/ˈvɪdʒɪlənt/; [adj]警戒的,警惕的; [or]gre3k;
vignette: [a]/vɪnˈjet/; [n]装饰图案;小插图; [v]把..印放为虚光照,晕映; [or]gre3k;
vigorous: [a]/ˈvɪɡərəs/; [adj]精力充沛的;强有力的,有活力的;强健的; [or]gre3k;
vile: [a]/vaɪl/; [adj]令人讨厌的,恶心的;可恨的;可耻的;简陋的; [or]gre3k;
vilify: [a]/ˈvɪlɪfaɪ/; [v]辱骂,诽谤; [or]gre3k;
vim: [a]/vɪm/; [n]精力,活力; [or]gre3k;
vindicate: [a]/ˈvɪndɪkeɪt/; [vt]证明.无辜;维护,辩护; [or]gre3k;
vindictive: [a]/vɪnˈdɪktɪv/; [adj]报复性的,怀恨的,惩罚的; [or]gre3k;
virtuoso: [a]/ˌvɜːrtʃuˈoʊsoʊ/; [n]艺术品鉴赏家,古董收藏家,艺术大师; [adj]行家里手的,艺术爱好者的; [or]gre3k;
virtuous: [a]/ˈvɜːrtʃuəs/; [adj]善良的,有德行的,贞洁的; [or]gre3k;
virulent: [a]/ˈvɪrələnt/; [adj]剧毒的;恶性的;有恶意的; [or]gre3k;
viscid: [a]/ˈvɪsɪd/; [adj]黏的,黏质的; [or]gre3k;
viscous: [a]/ˈvɪskəs/; [adj]黏的;黏稠的;黏滞的;有黏性的; [or]gre3k;
visionary: [a]/ˈvɪʒəneri/; [n]有远见的人;幻想家; [adj]有远见的;爱幻想的; [or]gre3k;
vitality: [a]/vaɪˈtæləti/; [n]活力;生气;生命力; [or]gre3k;
vitiate: [a]/ˈvɪʃieɪt/; [vt]污损,污染,使堕落,使(契约等)无效; [or]gre3k;
vitriolic: [a]/ˌvɪtriˈɑːlɪk/; [adj]刻薄的,强烈的,硫酸(盐)的,由硫酸制成的; [or]gre3k;
vituperate: [a]/vaɪ'tjuːpəˌreɪt/; [v]痛斥,辱骂; [or]gre3k;
vivacious: [a]/vɪˈveɪʃəs/; [adj]活泼的,快活的(多指女性); [or]gre3k;
vocation: [a]/voʊˈkeɪʃn/; [n]职业;行业;天职;使命; [or]gre3k;
vociferous: [a]/voʊˈsɪfərəs/; [adj](表达意见或感情等)大声的,有力的; [or]gre3k;
volatile: [a]/ˈvɑːlətl/; [adj]易气化的;爆炸性的;反复无常的;短暂的;不稳定的; [or]gre3k;
volition: [a]/voʊˈlɪʃn/; [n]决定;自主;意志力;下决心;意志力; [or]gre3k;
voluble: [a]/ˈvɑːljəbl/; [adj]健谈的,缠绕的,易旋转的; [or]gre3k;
voluminous: [a]/vəˈluːmɪnəs/; [adj]大量的;长篇的,多产的;庞大的; [adv]宽松地;容量大地;篇幅长地; [n]宽松;容量大,篇幅长; [or]gre3k;
voluptuous: [a]/vəˈlʌptʃuəs/; [adj]撩人的,沉溺酒色的,骄奢淫逸的; [or]gre3k;
voracious: [a]/vəˈreɪʃəs/; [adj]狼吞虎咽的,贪婪的; [adv]贪婪地; [n]贪婪,贪吃; [or]gre3k;
votary: [a]/ˈvoʊtəri/; [n]崇拜者,热心支持者; [or]gre3k;
vouch: [a]/vaʊtʃ/; [v]担保;证明;保证; [n]被担保者; [or]gre3k;
voyeur: [a]/vwaɪˈɜːr/; [n]窥淫狂者,窥隐私者; [or]gre3k;
vulgar: [a]/ˈvʌlɡər/; [adj]粗俗的;下流的;平民的;通俗的; [n]平民;方言; [or]gre3k;
vulnerable: [a]/ˈvʌlnərəbl/; [adj]易受伤的;脆弱的;易受攻击的; [or]gre3k;
waddle: [a]/ˈwɑːdl/; [v](鸭,矮胖子等)摇摇摆摆地走,蹒跚而行; [n]摇摆的步子; [or]gre3k;
waffle: [a]/ˈwɑːfl/; [n]华夫饼干;动听而无意义的话;无聊话; [v]胡扯,含糊其辞; [or]gre3k;
waft: [a]/wɑːft/; [v]使飘荡;吹送; [n]飘荡;吹拂; [or]gre3k;
wag: [a]/wæɡ/; [n]摇摆;爱说笑的人; [v]摇动; [or]gre3k;
wan: [a]/wɑːn/; [adj]虚弱的,病态的; [or]gre3k;
wanderlust: [a]/ˈwɑːndərlʌst/; [n]漫游癖;憧憬流浪; [or]gre3k;
wane: [a]/weɪn/; [n]衰退(期);月亏(期);减少; [v](月)缺损;(光,势力,治理等)衰落;减少; [or]gre3k;
wanting: [a]/ˈwɑːntɪŋ/; [adj]欠缺的,不足的,不够格的; prep. 缺; [or]gre3k;
warmonger: [a]/ˈwɔːrmʌŋɡər/; [n]战争贩子,好战者; [or]gre3k;
warp: [a]/wɔːrp/; [n]弯曲,歪曲,偏见; [v]使变形,使有偏见,曲解; [or]gre3k;
warrant: [a]/ˈwɔːrənt/; [n]逮捕证;正当理由;凭证; [v]使正当; [or]gre3k;
wary: [a]/ˈweri/; [adj]谨慎的,小心的,提防的;考虑周到的; [or]gre3k;
wastrel: [a]/ˈweɪstrəl/; [n]败家子,挥霍无度的人; [or]gre3k;
watershed: [a]/ˈwɔːtərʃed/; [n](美)流域;分水岭;集水区;转折点;重要关头; [adj]标志转折点的; [or]gre3k;
wax: [a]/wæks/; [n]蜡;蜡状物; [v]给.上蜡;给.打蜡,给.上蜡;渐渐变大;变为;(月亮)渐圆,渐盈; [adj]蜡制的; [or]gre3k;
waylay: [a]/weɪˈleɪ/; [v]埋伏,伏击; [or]gre3k;
wayward: [a]/ˈweɪwərd/; [adj]任性的,不规则的,刚愎的; [or]gre3k;
welter: [a]/ˈweltər/; [n]混乱;滚浪;翻滚;起伏; [v]翻滚;沉溺;起伏; [adj]负重赛马的; [or]gre3k;
wheedle: [a]/ˈwiːdl/; [v]以甜言蜜语诱惑,用甜言蜜语欺骗; [or]gre3k;
whet: [a]/wet/; [v]刺激;磨快;促进; [n]磨;开胃物;刺激物; [or]gre3k;
whiff: [a]/wɪf/; [n]一吹,一吸,一阵香气,一点点,香烟的一口; [v]轻轻地吹,喷气,<棒>三击出局; [or]gre3k;
whimsical: [a]/ˈwɪmzɪkl/; [adj]古怪的,异想天开的; [or]gre3k;
wholesome: [a]/ˈhoʊlsəm/; [adj]有益于健康的;有益的; [or]gre3k;
wicked: [a]/ˈwɪkɪd/; [adj]邪恶的,恶毒的;淘气的,恶作剧的; [n]恶人;邪恶的人; [adv]用作加强语气用; [or]gre3k;
willful: [a]/ˈwɪlfl/; [adj]有意的,任性的,故意的; [or]gre3k;
willy-nilly: [a]/ˌwɪli ˈnɪli/; [adj]犹豫不决的,不容分辨的,随意的; [adv]乱七八糟地,不管愿不愿意地; [or]gre3k;
wilt: [a]/wɪlt/; [v]使.凋谢,枯萎; [n]枯萎;憔悴; [or]gre3k;
wily: [a]/ˈwaɪli/; [adj]狡猾的; [or]gre3k;
wince: [a]/wɪns/; [v]避开,畏缩; [n]畏缩;脸部肌肉的抽搐; [or]gre3k;
windbag: [a]/ˈwɪndbæɡ/; [n]风囊,饶舌之人; [or]gre3k;
winsome: [a]/ˈwɪnsəm/; [adj]迷人的;可爱的;漂亮的; [or]gre3k;
wiretap: [a]/ˈwaɪərtæp/; [n]窃听装置;窃听; [v]偷听,窃听; [or]gre3k;
wistful: [a]/ˈwɪstfl/; [adj]渴望的,向往的;深思的;留恋的; [or]gre3k;
wit: [a]/wɪt/; [n]富有机智的人;智力,才智;机智;风趣,措辞巧妙的能力; [or]gre3k;
withdraw: [a]/wɪðˈdrɔː/; [v]取款;撤退,收回,撤离; [or]gre3k;
wither: [a]/ˈwɪðər/; [v]枯萎;凋谢; [vt]使枯萎,使凋谢,萎缩;使人感觉羞惭或迷惑; [or]gre3k;
withhold: [a]/wɪðˈhoʊld/; [v]抑制,拒绝给某事物; [or]gre3k;
wizen: [a]/'wɪzən/; [v](使)凋谢,(使)枯萎; [adj]凋谢的,枯萎的; [or]gre3k;
wobble: [a]/ˈwɑːbl/; [v]摇晃;摇摆;游移不定; [n]摆动;摇晃;不稳定; [or]gre3k;
worldly: [a]/ˈwɜːrldli/; [adj]世间的,尘世的;世俗的; [adv]世故地; [or]gre3k;
worship: [a]/ˈwɜːrʃɪp/; [v]崇拜,爱戴;做礼拜,拜神; [n]礼拜,礼拜仪式;崇拜,敬仰; [or]gre3k;
wrangle: [a]/ˈræŋɡl/; [n]争论,争吵; [vi]争论,争吵,口角; [vt]辩驳,放牧; [or]gre3k;
wrest: [a]/rest/; [n]扭,拧; [vt]用力拧;强夺;歪曲; [or]gre3k;
wretched: [a]/ˈretʃɪd/; [adj]可怜的;恶劣的;身心疲惫的; [or]gre3k;
wrongheaded: [a]/'rɒŋhedɪd/; [adj]固执己见的,坚持(错误观点)的; [or]gre3k;
wry: [a]/raɪ/; [adj]歪斜的,扭歪的,歪曲的; [v]歪曲,扭曲;扭转; [or]gre3k;
xenophobe: [a]/'zenəˌfoʊb/; [n]仇视(或畏惧)外国人(或外国事物)者; [or]gre3k;
yoke: [a]/joʊk/; [n]牛轭;枷锁;纽带; [v]结合;连结; [or]gre3k;
yokel: [a]/ˈjoʊkl/; [n]乡巴佬;庄稼汉; [or]gre3k;
zeal: [a]/ziːl/; [n]热情,热心; [or]gre3k;
zealot: [a]/ˈzelət/; [n]狂热份子,犹太教狂热信徒; [or]gre3k;
zenith: [a]/ˈziːnɪθ/; [n]顶点,顶峰;全盛; [or]gre3k;
zesty: [a]/ˈzesti/; [adj]刺激的,开胃的; [or]gre3k;
