Baroque: [a]/bəˈroʊk/; [adj]巴洛克式的,结构复杂的,形式怪样的; [n]巴洛克风格,巴洛克艺术; [or]gmat;
Canon: [a]/ˈkænən/; [n]标准,教规,正典圣经,教士; [or]gmat;
Catholic: [a]/ˈkæθlɪk/; [adj](兴趣等)广泛的,(C大写)天主教的; [n](C大写)天主教徒; [or]gmat;
Hispanic: [a]/hɪˈspænɪk/; [adj]拉丁美洲的;西班牙人的;西班牙的; [n]讲西班牙语的人;拉美裔美国人; [or]gmat;
Inuit: [a]/ˈɪnjuɪt/; [n]因纽特人; [adj]因纽特人的; [or]gmat;
Pleistocene: [a]/'plaistəusi:n/; [n]更新世,更新世岩; [or]gmat;
Puritan: [a]/ˈpjʊrɪtən/; [n]清教徒,极端拘谨的人; [adj]清教徒的; [or]gmat;
Quaker: [a]/ˈkweɪkər/; [n]夸克党,教友派信徒; [or]gmat;
Spaniard: [a]/ˈspænjərd/; [n]西班牙人; [or]gmat;
Titanic: [a]/taɪˈtænɪk/; [adj]巨人的,力大无比的; [n]泰坦尼克号; [or]gmat;
Wall Street: [a]/ˈwɔːl striːt/; [n]华尔街(美金融业集中之地); [or]gmat;
abdicate: [a]/ˈæbdɪkeɪt/; [adj]放弃权力的;退位的; [n]放弃权力者;退位者; [vi]退位,辞职; [vt]辞;放弃; [or]gmat;
abduct: [a]/æbˈdʌkt/; [v]绑架,拐走; [or]gmat;
abnormal: [a]/æbˈnɔːrml/; [adj]反常的;畸形的; [or]gmat;
abolish: [a]/əˈbɑːlɪʃ/; [v]废除,废止;取消,革除; [or]gmat;
abolitionist: [a]/ˌæbəˈlɪʃənɪst/; [n]废奴主义者; [or]gmat;
abruptly: [a]/əˈbrʌptli/; [adv]突然地,无礼地; [or]gmat;
abscissa: [a]/æbˈsɪsə/; [n]横座标,横线; [or]gmat;
absenteeism: [a]/ˌæbsənˈtiːɪzəm/; [n]旷工;旷课; [or]gmat;
absorb: [a]/əbˈzɔːrb/; [vt]吸收;汲取;吸引..的注意;理解,掌握;承受; [or]gmat;
abstinence: [a]/ˈæbstɪnəns/; [n]节制,禁欲; [or]gmat;
abstract: [a]/ˈæbstrækt/; [adj]抽象的; [n]摘要,抽象; [v]提取; [or]gmat;
absurd: [a]/əbˈsɜːrd/; [adj]荒唐的;可笑的;不合理的; [n]荒唐; [or]gmat;
absurdity: [a]/əbˈsɜːrdəti/; [n]荒谬,谬论,荒谬的言行; [or]gmat;
abundant: [a]/əˈbʌndənt/; [adj]丰富的;大量的; [or]gmat;
academic: [a]/ˌækəˈdemɪk/; [adj]学术的;学院的,大学的;理论的; [n]学者; [or]gmat;
accelerate: [a]/əkˈseləreɪt/; [v]加速,增长;使增速,促进; [or]gmat;
access: [a]/ˈækses/; [n]进入;使用权;通道; [v]进入;访问; [or]gmat;
accidental: [a]/ˌæksɪˈdentl/; [adj]偶然的,意外的;非本质的; [or]gmat;
accommodate: [a]/əˈkɑːmədeɪt/; [v]向.提供住处(或膳宿);给.提供方便;容纳;使适应,顺应; [or]gmat;
accommodation: [a]/əˌkɑːməˈdeɪʃn/; [n]住宿,食宿;调解;住处; [or]gmat;
accompaniment: [a]/əˈkʌmpənimənt/; [n]伴奏;伴随物; [or]gmat;
accord: [a]/əˈkɔːrd/; [n]协议; [v]授予; [or]gmat;
account for: [a]/əˈkaʊnt fɔr/; [phr]解释,说明;(在数量方面)占;对.负责;导致,引起; [or]gmat;
accountant: [a]/əˈkaʊntənt/; [n]会计人员,会计师; [or]gmat;
accretion: [a]/əˈkriːʃn/; [n]自然的增加,增加物; [or]gmat;
accrue: [a]/əˈkruː/; [v](利息等)增大,增多; [or]gmat;
accumulate: [a]/əˈkjuːmjəleɪt/; [vi]聚积,堆积; [vt]积攒,积累; [or]gmat;
accuracy: [a]/ˈækjərəsi/; [n]准确(性);准确度; [or]gmat;
accurate: [a]/ˈækjərət/; [adj]精确的;正确的;符合标准的; [or]gmat;
accustomed: [a]/əˈkʌstəmd/; [adj]通常的,惯常的;独特的;习惯的,适应了的(to); [or]gmat;
acquiesce: [a]/ˌækwiˈes/; [v]默许;勉强同意; [adj]默认的; [or]gmat;
acquire: [a]/əˈkwaɪər/; [v](尤指靠自己的努力或行动或经过一个过程)获得;学到;取得; [or]gmat;
acquisition: [a]/ˌækwɪˈzɪʃn/; [n]并购;获得;掌握;获得物;取得物; [or]gmat;
acquittal: [a]/əˈkwɪtl/; [n]宣告无罪,开释; [or]gmat;
acreage: [a]/ˈeɪkərɪdʒ/; [n]面积,英亩数; [or]gmat;
activate: [a]/ˈæktɪveɪt/; [v]使活动起来;使开始起作用; [or]gmat;
actuate: [a]/ˈæktʃueɪt/; [v]开动(机器);激励,驱使; [or]gmat;
acupuncture: [a]/ˈækjupʌŋktʃər/; [n]针刺(疗法); [vt]用针灸术治疗;用针刺法麻醉,对.施行针灸治疗; [or]gmat;
acute: [a]/əˈkjut/; [adj](疼痛,妒忌等)剧烈的,严重的;敏锐的;急性的;尖声的; [or]gmat;
adamant: [a]/ˈædəmənt/; [adj]强硬的,固执的; [n]坚硬的东西;坚石; [or]gmat;
adapt: [a]/əˈdæpt/; [vi]适应不同情况; [vt]使适合;改编; [or]gmat;
addict: [a]/ˈædɪkt/; [n]上瘾的人;入迷的人; [v]使沉迷,使上瘾; [or]gmat;
addition: [a]/əˈdɪʃn/; [n]加法;添加;附加物; [or]gmat;
additive: [a]/ˈædətɪv/; [n]添加剂,添加物; [adj]附加的;<数>加法的; [or]gmat;
adept: [a]/əˈdept/; [n]专家,能手; [adj]熟练的;巧妙的; [or]gmat;
adhere: [a]/ədˈhɪr/; [v]遵守;坚持;粘附;附着,粘在..上; [or]gmat;
adipose: [a]/ˈædɪpoʊs/; [adj]脂肪质的,脂肪多的; [n]动物脂肪; [or]gmat;
adjacent: [a]/əˈdʒeɪsnt/; [adj]邻接的,毗连的;邻近的; [or]gmat;
adjoining: [a]/əˈdʒɔɪnɪŋ/; [adj]毗邻的; [or]gmat;
adjust: [a]/əˈdʒʌst/; [v]调整,调节;校正;改变.以适应; [or]gmat;
administer: [a]/ədˈmɪnɪstər/; [v]管理;执行;实施;给予;用(药); [or]gmat;
admit: [a]/ədˈmɪt/; [v]承认;准许.进入,允许.加入;容许,可容纳; [or]gmat;
admonition: [a]/ˌædməˈnɪʃn/; [n]告诫,劝告,警告; [or]gmat;
adolescent: [a]/ˌædəˈlesnt/; [adj]青春期的;青少年的; [n]青少年; [or]gmat;
adopt: [a]/əˈdɑːpt/; [v]收养;采纳,采用; [or]gmat;
adoption: [a]/əˈdɑːpʃn/; [n]收养,采用,采纳; [or]gmat;
advent: [a]/ˈædvent/; [n]来临;到来;出现; [or]gmat;
adversarial: [a]/ˌædvərˈseriəl/; [adj]敌人的,对手的,对抗的; [or]gmat;
adverse: [a]/ˈædvɜːrs/; [adj]不利的;(方向上)逆的;在相反的方向上移动(或运转);相反的; [or]gmat;
advocate: [a]/ˈædvəkeɪt/; [v]提倡;主张;为.辩护; [n]辩护者;提倡者;律师; [or]gmat;
aerobic: [a]/eˈroʊbɪk/; [adj]需氧的;有氧健身法的; [or]gmat;
aeronautics: [a]/ˌerəˈnɔːtɪks/; [n]航空学; [adj]航空(学)的; [or]gmat;
aerosol: [a]/ˈerəsɔːl/; [n]烟雾,［化］气溶,烟雾剂; [adj]喷雾的,喷雾器的; [or]gmat;
affinity: [a]/əˈfɪnəti/; [n]姻亲关系;密切关系;近似,类似关系;亲近; [or]gmat;
affirmative: [a]/əˈfɜːrmətɪv/; [adj]肯定的,积极的; [n]肯定语,赞成的一方; [or]gmat;
afflict: [a]/əˈflɪkt/; [v]使痛苦;使苦恼; [or]gmat;
affluence: [a]/ˈæfluəns/; [n]丰富,富裕,流入; [or]gmat;
affluent: [a]/ˈæfluənt/; [adj]富裕的,丰富的; [or]gmat;
aftermath: [a]/ˈæftərmæθ/; [n]不幸事件之后果,余波; [or]gmat;
agenda: [a]/əˈdʒendə/; [n]议事日程; [or]gmat;
aggravate: [a]/ˈæɡrəveɪt/; [v]使恶化,加重;使气恼,激怒; [or]gmat;
aggregate: [a]/ˈæɡrɪɡət/; [n]合计;总数;混凝料;总计; [v]集合;聚集;合计; [adj]总的,总数的;集合的; [or]gmat;
aggregation: [a]/ˌæɡrɪˈɡeɪʃn/; [n]集合,集合体,聚合; [or]gmat;
aggression: [a]/əˈɡreʃn/; [n]侵略;侵犯行为;攻击行为,(挑衅)行为;攻击性; [or]gmat;
agrarian: [a]/əˈɡreriən/; [adj]耕地的; [or]gmat;
ailment: [a]/ˈeɪlmənt/; [n]疾病(尤指微恙),不宁,不安; [or]gmat;
airborne: [a]/ˈerbɔːrn/; [adj]空运的;在空中的; [or]gmat;
ale: [a]/eɪl/; [n]麦芽啤酒; [or]gmat;
alfalfa: [a]/ælˈfælfə/; [n]茴蓿,紫苜蓿; [or]gmat;
algae: [a]/ˈældʒiː/; [n]藻类; [or]gmat;
algebra: [a]/ˈældʒɪbrə/; [n]代数; [or]gmat;
alien: [a]/ˈeɪliən/; [n]外国人;外星人; [adj]陌生的;外国的,外星(人)的;异己的,不相容的; [or]gmat;
alienate: [a]/ˈeɪliəneɪt/; [v]疏远;挑拨; [or]gmat;
allay: [a]/əˈleɪ/; [v]减轻;使缓和;使平静; [or]gmat;
allege: [a]/əˈledʒ/; [v]断言;硬说; [or]gmat;
allegiance: [a]/əˈliːdʒəns/; [n]忠诚,拥护; [or]gmat;
allergy: [a]/ˈælərdʒi/; [n]过敏症,厌恶; [or]gmat;
alleviate: [a]/əˈliːvieɪt/; [v]减轻;缓解;缓和; [or]gmat;
alligator: [a]/ˈælɪɡeɪtər/; [n]短吻鳄(一种鳄鱼); [or]gmat;
allocate: [a]/ˈæləkeɪt/; [v]分配,配给; [or]gmat;
allowance: [a]/əˈlaʊəns/; [v]定量供应(食物,饮料等物品);配给; [n]零用钱;津贴,补贴;限额;免税额;允许,容忍,让步;考虑; [or]gmat;
allude: [a]/əˈluːd/; [v]间接提到,暗指,暗示; [or]gmat;
ally: [a]/ˈælaɪ/; [n]盟友;同盟国;(二战时的) 同盟国; [v]结盟; [or]gmat;
alter: [a]/ˈɔːltər/; [v]改变;改动,使变样;改做; [or]gmat;
alternate: [a]/ˈɔːltərnət/; [adj]交替的,轮流的,间隔的; [v](使)交替,(使)轮流; [n]代替者; [or]gmat;
alternative: [a]/ɔːlˈtɜːrnətɪv/; [adj]可供选择的;替代的;不寻常的; [n]可供选择的事物; [or]gmat;
altitude: [a]/ˈæltɪtuːd/; [n]海拔,高度; [or]gmat;
alto: [a]/ˈæltoʊ/; [n]女低音,男声最高音,中音乐器; [adj]中音部的; [or]gmat;
altruism: [a]/ˈæltruɪzəm/; [n]利他主义,不自私; [or]gmat;
aluminum: [a]/əˈluːmɪnəm/; [n]铝; [or]gmat;
alumna: [a]/əˈlʌmnə/; [n]女毕业生,女校友; [or]gmat;
alumnus: [a]/əˈlʌmnəs/; [n]男毕业生,男校友; [or]gmat;
amass: [a]/əˈmæs/; [vi]聚集; [vt]收集;积累,积聚; [or]gmat;
amateur: [a]/ˈæmətʃər/; [n]业余爱好者;外行; [adj]外行的;业余爱好的,业余(身份)的; [or]gmat;
amber: [a]/ˈæmbər/; [n]琥珀,琥珀色; [v]使呈琥珀色; [adj]琥珀色的,琥珀制的; [or]gmat;
ambiguity: [a]/ˌæmbɪˈɡjuːəti/; [n]模棱两可;歧义;误解; [or]gmat;
ambiguous: [a]/æmˈbɪɡjuəs/; [adj]含糊不清的,引起歧义的,模棱两可的; [or]gmat;
ambivalence: [a]/æmˈbɪvələns/; [n]矛盾心理; [or]gmat;
ambivalent: [a]/æmˈbɪvələnt/; [adj]矛盾的;摇摆不定的;好恶相克的; [n]两性人; [or]gmat;
amenable: [a]/əˈmiːnəbl/; [adj]愿意的,顺从的,服从的;经得起检验的; [or]gmat;
amend: [a]/əˈmend/; [v]改进;修订;修正; [or]gmat;
amenity: [a]/əˈmenəti/; [n]适意;舒适;便利设施;舒适,愉快;礼仪; [or]gmat;
amiable: [a]/ˈeɪmiəbl/; [adj]和蔼的,亲切的;温和的; [or]gmat;
amino acid: [a]/əˌmiːnoʊ ˈæsɪd/; [n]［生］氨基酸; [or]gmat;
amnesia: [a]/æmˈniːʒə/; [n]<医学>遗忘症; [or]gmat;
ample: [a]/ˈæmpl/; [adj]富足的,丰满的,宽敞的; [or]gmat;
amplify: [a]/ˈæmplɪfaɪ/; [v]放大(声音等);扩大;增强;详述;进一步阐述; [or]gmat;
amplitude: [a]/ˈæmplɪtuːd/; [n]振幅;广阔;幅度; [or]gmat;
analgesic: [a]/ˌænəlˈdʒiːzɪk/; [n]镇痛药; [adj]止痛的; [or]gmat;
analog: [a]/ˈænəlɑːɡ/; [adj]有长短针的;模拟的; [n]类似物;模拟; [or]gmat;
analogy: [a]/əˈnælədʒi/; [n]比拟,比喻;类比;相似;类似; [or]gmat;
analytic(al): [a]/ˌænə'lɪtɪkl/; [adj]分析的;分解的; [or]gmat;
anatomy: [a]/əˈnætəmi/; [n]人体;解剖学;剖析; [or]gmat;
ancestor: [a]/ˈænsestər/; [n]祖宗;祖先;原型; [or]gmat;
ancestry: [a]/ˈænsestri/; [n]祖先;血统; [or]gmat;
anecdotal: [a]/ˌænɪkˈdoʊtl/; [adj]轶事的,趣闻的;多逸事趣闻的;举例说明的; [or]gmat;
anemia: [a]/ə'niːmiːə/; [n]贫血,贫血症; [or]gmat;
anesthesia: [a]/ˌænəsˈθiʒə/; [n]麻醉;麻木(等于anaesthesia); [or]gmat;
anesthetic: [a]/ˌænəs'θetɪk/; [n]麻醉剂,麻药; [adj]麻醉的,感觉缺失的; [or]gmat;
animate: [a]/ˈænɪmeɪt/; [v]使有生气,使活泼;鼓舞,推动; [adj]有生命的; [or]gmat;
animosity: [a]/ˌænɪˈmɑːsəti/; [n]憎恶,仇恨; [or]gmat;
annuity: [a]/əˈnuːəti/; [n]年金,养老金;年金保险;年金享受权; [or]gmat;
anomaly: [a]/əˈnɑːməli/; [n]异常,不规则,反常事物; [or]gmat;
anonymous: [a]/əˈnɑːnɪməs/; [adj]匿名的;无名的;不具名的;无特色的;无个性特征; [or]gmat;
anopheles: [a]/ə'nɒfəˌlɪz/; [n](动)疟蚊属; [or]gmat;
antagonism: [a]/ænˈtæɡənɪzəm/; [n]对抗,敌对;敌意; [or]gmat;
antebellum: [a]/ˌæntiˈbeləm/; [adj](美国南北)战争前的; [or]gmat;
antedate: [a]/ˌæntiˈdeɪt/; [n]比实际提前的日期; [vt]在.上写上早于实际的日期;发生于.以前;使提前发生;使回到过去; [or]gmat;
anterior: [a]/ænˈtɪriər/; [adj]前面的,先前的; [or]gmat;
anthology: [a]/ænˈθɑːlədʒi/; [n](诗,文,曲,画等的)选集; [or]gmat;
anthropologist: [a]/ˌænθrəˈpɑːlədʒɪst/; [n]人类学家,人类学者; [or]gmat;
antibiotic: [a]/ˌæntibaɪˈɑːtɪk/; [n]抗生素; [adj]抗菌的; [or]gmat;
antibiotics: [a]/ˌæntɪbaɪ'ɒtɪks/; [n]抗生素; [or]gmat;
antibody: [a]/ˈæntibɑːdi/; [n]<免疫>抗体; [or]gmat;
anticipate: [a]/ænˈtɪsɪpeɪt/; [v]预测;期待;提早(做); [or]gmat;
antidote: [a]/ˈæntidoʊt/; [n]<药>解毒剂,解药;矫正方法; [or]gmat;
antifreeze: [a]/ˈæntifriːz/; [n]抗冻剂; [or]gmat;
antigen: [a]/ˈæntɪdʒən/; [n]<免疫>抗原; [or]gmat;
antipode: [a]/'æntɪˌpoʊd/; [n]恰恰相反的事物(of,to),相对极,对极; [or]gmat;
antipsychotic: [a]/ˌæntɪsaɪˈkɒtɪk/; [adj]抑制精神的; [n]安定药; [or]gmat;
antiquated: [a]/ˈæntɪkweɪtɪd/; [adj]陈旧的,过时的; [v]使古旧,废弃; [or]gmat;
antique: [a]/ænˈtiːk/; [n]古董;古玩;古物; [adj]古代的;古董的; [or]gmat;
antiquity: [a]/ænˈtɪkwəti/; [n]古代,古时候(尤指古希腊和古罗马时期);古代的遗物,古物; [or]gmat;
antithesis: [a]/ænˈtɪθəsɪs/; [n]对立面,对照; [or]gmat;
antitrust law: [a]/ˌæntiˈtrʌst lɔ/; [phr]反托拉斯法; [or]gmat;
ape: [a]/eɪp/; [n]无尾猿,类人猿;模仿者;粗野的大汉; [adj]〈俚〉疯狂的; [v]模仿; [or]gmat;
aperiodic: [a]/ˌeɪpɪrɪ'ɒdɪk/; [adj]非周期的; [or]gmat;
apiece: [a]/əˈpiːs/; [adv]每人;每个;各自地; [or]gmat;
apolitical: [a]/ˌeɪpəˈlɪtɪkl/; [adj]不问政治的; [or]gmat;
apothecary: [a]/əˈpɑːθəkeri/; [n]药剂师; [or]gmat;
apparatus: [a]/ˌæpəˈrætəs/; [n]装置,仪器;设备;组织,机构; [or]gmat;
apparel: [a]/əˈpærəl/; [n]服装,衣服; [vt]给.穿衣服(尤指华丽或特殊的服装); [or]gmat;
apparent: [a]/əˈpærənt/; [adj]显然的,明白的,清晰可见的;表面上的,貌似(真实)的; [or]gmat;
appeal: [a]/əˈpiːl/; [vi]呼吁,请求;申诉;有吸引力; [n]呼吁;恳求;(为慈善或好的事业所做的) 筹款努力;(人或物的)吸引力; [or]gmat;
appetite: [a]/ˈæpɪtaɪt/; [n]食欲,胃口;欲望; [or]gmat;
appliance: [a]/əˈplaɪəns/; [n]家用器具;家用电器;装置;应用; [or]gmat;
appoint: [a]/əˈpɔɪnt/; [v]委派,任命;约定;确定,指定; [or]gmat;
apportion: [a]/əˈpɔːrʃn/; [v]分配; [or]gmat;
apprehend: [a]/ˌæprɪˈhend/; [vt]理解,领会;逮捕;对.忧虑;把.视作; [vi]忧虑; [or]gmat;
apprentice: [a]/əˈprentɪs/; [v]使当学徒; [n]学徒; [or]gmat;
approbation: [a]/ˌæprəˈbeɪʃn/; [n]称赞,认可;批准; [or]gmat;
appropriate: [a]/əˈproʊpriət/; [adj]合适的;适当的; [v]挪用;拨款;私占; [or]gmat;
appropriation: [a]/əˌproʊpriˈeɪʃn/; [n]挪用,拨款; [or]gmat;
approve: [a]/əˈpruːv/; [v]称许,赞成,批准; [or]gmat;
approximate: [a]/əˈprɑːksɪmət/; [adj]近似的,约略的; [v]接近,近似; [or]gmat;
aquarium: [a]/əˈkweriəm/; [n]水族馆,水族箱,鱼缸; [or]gmat;
aquatic: [a]/əˈkwætɪk/; [adj]水生的,水栖的,水中的,水上的; [n]水生动物,水生植物;水上运动; [or]gmat;
arable: [a]/ˈærəbl/; [adj]可耕的,适合种植的; [n]耕地; [or]gmat;
arbitrary: [a]/ˈɑːrbətreri/; [adj]随意的,任性的,随心所欲的;霸道的,专制的,专横的;主观的,武断的; [or]gmat;
arbitrator: [a]/ˈɑːrbɪtreɪtər/; [n]公断人; [or]gmat;
arcane: [a]/ɑːrˈkeɪn/; [adj]神秘的;秘传的;晦涩难解的; [or]gmat;
arch: [a]/ɑːrtʃ/; [n]拱洞;拱门;拱起; [v]做成拱形; [adj]调皮的,淘气的; [or]gmat;
archaeologist: [a]/ˌɑːrkiˈɑːlədʒɪst/; [n]考古学家; [or]gmat;
archenemy: [a]/'ɑːtʃ'enəmɪ/; [n]天敌,主要敌人; [or]gmat;
architect: [a]/ˈɑːrkɪtekt/; [n]设计师;建筑师; [or]gmat;
archives: [a]/ˈɑːrkaɪvz/; [n]档案室,档案; [or]gmat;
ardent: [a]/ˈɑːrdnt/; [adj]热心的,热烈的; [or]gmat;
arid: [a]/ˈærɪd/; [adj](土地或气候)干燥的,干旱的,贫瘠的,荒芜的;无创见的,无新意的; [or]gmat;
aristocracy: [a]/ˌærɪˈstɑːkrəsi/; [n]贵族;贵族统治;贵族政治;贵族品质; [or]gmat;
arithmetic: [a]/əˈrɪθmətɪk/; [n]计算;算术; [or]gmat;
array: [a]/əˈreɪ/; [n]一系列;陈列;编队; [v]排列;部署; [or]gmat;
artery: [a]/ˈɑːrtəri/; [n]动脉;干线; [or]gmat;
arthritis: [a]/ɑːrˈθraɪtɪs/; [n]<外科>关节炎; [or]gmat;
articulate: [a]/ɑːrˈtɪkjuleɪt/; [adj]善于表达的;发音清晰的; [v]清晰地发音;清楚地讲话;连接,接合;与.合成整体 ,使相互连贯; [or]gmat;
artifact: [a]/ˈɑːrtɪfækt/; [n]人工制品;手工艺品; [or]gmat;
artificial: [a]/ˌɑːrtɪˈfɪʃl/; [adj]人造的,人工的,假的;假装的,虚伪的; [n]人造肥料;<美>假花; [or]gmat;
artisan: [a]/ˈɑːrtəzn/; [n]工匠,手艺人; [or]gmat;
ascending: [a]/əˈsendɪŋ/; [adj]上升的; [or]gmat;
ascribe: [a]/əˈskraɪb/; [v]把.归因于;把.归属于; [or]gmat;
aspersion: [a]/ə'spɜːʒən/; [n]诽谤,中伤; [or]gmat;
aspiration: [a]/ˌæspəˈreɪʃn/; [n]抱负,志向;发 h 音; [or]gmat;
aspire: [a]/əˈspaɪər/; [vi]渴望,有志于(与to,for,after连用或后接不定式); [or]gmat;
assassination: [a]/əˌsæsəˈneɪʃn/; [n]暗杀; [or]gmat;
assemble: [a]/əˈsembl/; [v]装配(机器等);集合;召集; [or]gmat;
assembly line: [a]/əˈsembli laɪn/; [n]装配线(生产上一环接一环的),流水线; [or]gmat;
assert: [a]/əˈsɜːrt/; [v]断言;肯定地说;坚持;维护; [or]gmat;
assess: [a]/əˈses/; [v]评估;估值; [or]gmat;
asset: [a]/ˈæset/; [n]财产,资产,有价值的东西或人; [or]gmat;
assign: [a]/əˈsaɪn/; [v]布置;分配;指定;指派;归因;确定; [or]gmat;
assume: [a]/əˈsuːm/; [v]猜想;以为,假设;呈现;就职;(想当然地)认为;承担(责任); [or]gmat;
asteroid: [a]/ˈæstərɔɪd/; [n]小行星; [adj]星状的; [or]gmat;
asthma: [a]/ˈæzmə/; [n]哮喘症; [or]gmat;
astronomy: [a]/əˈstrɑːnəmi/; [n]天文学; [or]gmat;
astute: [a]/əˈstuːt/; [adj]机敏的,精明的,狡猾的; [or]gmat;
asunder: [a]/əˈsʌndər/; [adv]分离;化为碎片; [or]gmat;
at stake: [a]/ət steɪk/; [phr]存亡攸关,处于危险中; [or]gmat;
attain: [a]/əˈteɪn/; [v]获得;达到(某个年纪,水平,条件);实现; [n]成就; [or]gmat;
attorney: [a]/əˈtɜːrni/; [n](辩护)律师; [or]gmat;
auction: [a]/ˈɔːkʃn/; [n]拍卖; [v]拍卖; [or]gmat;
audit: [a]/ˈɔːdɪt/; [v]审计,查账;旁听; [n]审计;查帐; [or]gmat;
aura: [a]/ˈɔːrə/; [n](人或物发出的)气味,气氛,先兆; [or]gmat;
aurora: [a]/ɔːˌrɔːrə/; [n]极光;曙光; [or]gmat;
austere: [a]/ɔːˈstɪr/; [adj]严峻的;简朴的;苦行的;无装饰的; [or]gmat;
authentic: [a]/ɔːˈθentɪk/; [adj]真实的;真正的;可靠的; [or]gmat;
authenticate: [a]/ɔːˈθentɪkeɪt/; [v]鉴定;证明.是真实的; [or]gmat;
authority: [a]/əˈθɔːrəti/; [n]权威;威信;当局,官方;权力,职权; [or]gmat;
authorize: [a]/ˈɔːθəraɪz/; [v]批准;授权; [or]gmat;
automate: [a]/ˈɔːtəmeɪt/; [v]使自动化,自动操作; [or]gmat;
automation: [a]/ˌɔːtəˈmeɪʃn/; [n]自动化; [or]gmat;
autonomous: [a]/ɔːˈtɑːnəməs/; [adj]自动驾驶的;自治的,独立自主的;自主的; [or]gmat;
autonomy: [a]/ɔːˈtɑːnəmi/; [n]人身自由;自治;自治权; [or]gmat;
availability: [a]/əˌveɪləˈbɪləti/; [n]可得到的人(或物);可用性; [or]gmat;
average: [a]/ˈævərɪdʒ/; [n]平均数,平均水平; [adj]通常的,一般的;平均的; [v]平均为; [or]gmat;
aversion: [a]/əˈvɜːrʒn/; [n]厌恶;讨厌的人,(或东西); [or]gmat;
aviator: [a]/ˈeɪvieɪtər/; [n]飞行员; [or]gmat;
backdrop: [a]/ˈbækdrɑːp/; [n]背景幕;(事件的)背景; [or]gmat;
bacterium: [a]/bæk'tɪriəm/; [n]细菌; [or]gmat;
balcony: [a]/ˈbælkəni/; [n]阳台,剧院楼厅; [or]gmat;
balk: [a]/bɔːk/; [v]畏缩;阻止;停止; [n]障碍;错误; [or]gmat;
ballad: [a]/ˈbæləd/; [n]歌谣;小曲; [or]gmat;
ballistic: [a]/bəˈlɪstɪk/; [adj]弹道(学)的,发射的,衡量冲击强度的; [or]gmat;
bankruptcy: [a]/ˈbæŋkrʌptsi/; [n]破产; [or]gmat;
baptism: [a]/ˈbæptɪzəm/; [n]洗礼;严峻考验; [or]gmat;
bar: [a]/bɑːr/; [n]酒吧;(金属)棒;闩;障碍;柜台; [vt]阻挡;禁止;闩住; prep. 除.之外; [or]gmat;
bargain: [a]/ˈbɑːrɡən/; [n]交易,特价商品;便宜货;契约; [vi]讨价还价,讲价;成交; [vt]经讨价还价成交;用.交换; [adj](价格),低廉的; [or]gmat;
bark: [a]/bɑːrk/; [v]狗吠;厉声发令; [n]树皮;吠声; [or]gmat;
barrel: [a]/ˈbærəl/; [n]桶;枪管; [vi]快速移动; [or]gmat;
barren: [a]/ˈbærən/; [adj]贫瘠的,不孕的; [n]荒原,不毛之地; [or]gmat;
barrier: [a]/ˈbæriər/; [n]障碍;屏障;隔阂;壁垒; [v]用栅栏围住; [or]gmat;
base: [a]/beɪs/; [n]地基,基础;底座;<化>碱; [adj]卑鄙的,无耻的; [vt]以..作基础; [or]gmat;
basketry: [a]/'bɑskɪtrɪ/; [n](篮,篓,筐等的)编织术,(总称)(篮子等)编织物; [or]gmat;
battalion: [a]/bəˈtæliən/; [n]营,军营;军队,部队; [or]gmat;
bead: [a]/biːd/; [n]珠子;水珠; [or]gmat;
beam: [a]/biːm/; [n]光线;(房屋等)大梁;(横)梁; [v]发光;照射;发射,播送;微笑;用梁支撑; [or]gmat;
beatific: [a]/ˌbiːəˈtɪfɪk/; [adj]祝福的,有福的; [or]gmat;
beehive: [a]/ˈbiːhaɪv/; [n]蜂箱; [or]gmat;
behest: [a]/bɪˈhest/; [n]命令,训谕; [or]gmat;
benchmark: [a]/ˈbentʃmɑːrk/; [n]基准;标准检查程序; [v]用基准问题测试(计算机系统等); [or]gmat;
benefactor: [a]/ˈbenɪfæktər/; [n]恩人;捐助者;施主; [or]gmat;
beneficiary: [a]/ˌbenɪˈfɪʃieri/; [n]<金融>受益人,受惠者;封臣; [adj]拥有封地的;受圣俸的; [or]gmat;
bereft: [a]/bɪˈreft/; [adj]丧失的;被剥夺的;失去亲人的; [or]gmat;
beset: [a]/bɪˈset/; [v]困扰;镶嵌;围绕; [or]gmat;
besiege: [a]/bɪˈsiːdʒ/; [v]围攻,困扰; [or]gmat;
bestow: [a]/bɪˈstoʊ/; [v]给予; [or]gmat;
betray: [a]/bɪˈtreɪ/; [v]背叛;失信于;泄露(秘密等);(非故意地)暴露; [or]gmat;
betrayal: [a]/bɪˈtreɪəl/; [n]背叛;辜负;暴露; [or]gmat;
better off: [a]/ˈbetər ɑf/; [adj]境况(尤指经济境况)较好; [or]gmat;
beverage: [a]/ˈbevərɪdʒ/; [n](水,酒等之外的)饮料; [or]gmat;
bias: [a]/ˈbaɪəs/; [n]倾斜;偏心;偏见; [v]使有偏见; [or]gmat;
bicentenary: [a]/ˌbaɪsenˈtenəri/; [adj]二百年的; [n]二百周年纪念; [or]gmat;
bicker: [a]/ˈbɪkər/; [v]斗嘴,流动,闪动; [n]口角,流水声; [or]gmat;
bid: [a]/bɪd/; [n]出价;投标;努力争取; [v]出价;投标;问候;道别;吩咐; [or]gmat;
bilateral: [a]/ˌbaɪˈlætərəl/; [adj]双边的,有两面的; [or]gmat;
bilingual: [a]/ˌbaɪˈlɪŋɡwəl/; [adj]使用两种语言的,用两种文字写成的; [or]gmat;
binary: [a]/ˈbaɪnəri/; [adj]二进位的,二元的; [n]一双;双体;二进制数;双子星; [or]gmat;
bind: [a]/baɪnd/; [v]捆绑;装订;约束;结合; [n]窘境,困境;讨厌的事情;捆绑;植物的藤蔓; [or]gmat;
biography: [a]/baɪˈɑːɡrəfi/; [n]传记文学,传记; [or]gmat;
biota: [a]/baɪ'oʊtə/; [n]生物区系; [or]gmat;
bipartisan: [a]/ˌbaɪˈpɑːrtɪzn/; [adj]由两党成员组成的;被两党支持的; [or]gmat;
bipedalism: [a]/'baɪpedlɪzəm/; [n]二足类; [or]gmat;
birch: [a]/bɜːrtʃ/; [n]桦木,桦树,赤杨; [or]gmat;
bisect: [a]/baɪˈsekt/; [n]对剖邮票; [vi]分开; [vt]把.分切为二,把.二等分;二等分; [or]gmat;
bizarre: [a]/bɪˈzɑːr/; [adj]稀奇古怪的; [or]gmat;
blackout: [a]/ˈblækaʊt/; [n]断电; [adj]防空袭的; [or]gmat;
bland: [a]/blænd/; [vi]变得平淡无奇,变得枯燥无味; [adj]温和的;(食物等)清淡的;漠不关心的; [vt]使变得淡而无味,使变得枯燥无味;除掉.的特性; [or]gmat;
blast: [a]/blæst/; [n]一阵(疾风等);爆炸;冲击波; [v](用炸药)炸,摧毁; [or]gmat;
bleak: [a]/bliːk/; [adj]凄凉的;萧瑟的;阴郁的;无希望的; [or]gmat;
blemish: [a]/ˈblemɪʃ/; [v]损害,玷污; [n]瑕疵,缺点; [or]gmat;
blind spot: [a]/ˈblaɪnd spɑːt/; [n]［物］盲点,［无］静区,(驾驶车辆等视力以外的)盲区; [or]gmat;
blob: [a]/blɑːb/; [n]一滴,一抹,难以名状的一团; [v]弄脏,把.做错,得零分; [or]gmat;
bloc: [a]/blɑːk/; [n]集团; [or]gmat;
block: [a]/blɑːk/; [v]阻挡;妨碍;阻塞; [n]街区;块状物;积木;阻碍;大厦; [or]gmat;
blockade: [a]/blɑːˈkeɪd/; [n]封锁,阻碍物; [v]封锁; [or]gmat;
blot: [a]/blɑːt/; [n]墨水渍;污点;缺点; [v]涂污;(用吸水纸)吸干墨水;遮暗; [or]gmat;
blurry: [a]/ˈblɜːri/; [adj]模糊的,难辩认的; [or]gmat;
boardinghouse: [a]/'boʊrdɪŋˌhaʊs/; [n]公寓;供膳食的寄宿处; [or]gmat;
bog: [a]/bɑːɡ/; [n]沼泽;泥塘; [v]陷于泥沼;动弹不得; [or]gmat;
bold: [a]/boʊld/; [adj]大胆的,勇敢的;无耻的,放肆的;醒目的; [n]粗体字; [or]gmat;
bolster: [a]/ˈboʊlstər/; [n]枕垫; [v]支持,鼓励,增强; [or]gmat;
bolt: [a]/boʊlt/; [n]门栓,螺栓;闪电;弩箭; [v]闩门;(马受惊)脱缰; [adv]突然地;像箭似地;直立地; [or]gmat;
bombardment: [a]/bɑːmˈbɑːrdmənt/; [n]炮轰; [or]gmat;
bona fides: [a]/ˌboʊnə ˈfaɪdiːz/; [n]［拉］诚意,善意; [or]gmat;
bond: [a]/bɑːnd/; [n]束缚物,联结物;凝聚力;债券;保释金;联系; [vi]结合;团结一致; [or]gmat;
bondage: [a]/ˈbɑːndɪdʒ/; [n]奴役,束缚; [or]gmat;
bonus: [a]/ˈboʊnəs/; [n]奖金,额外津贴; [or]gmat;
boom: [a]/buːm/; [n]隆隆声;繁荣;景气;激增; [v]发出低沉有回响的声音;迅速发展,蓬勃发展;以低沉有回响的声音发出; [or]gmat;
boost: [a]/buːst/; [v]增加;偷盗; [n]提高;激励;后推;助推发动机; [or]gmat;
booth: [a]/buːθ/; [n]小舍;隔开的小间;公用电话亭;有篷的售货摊;窝棚; [or]gmat;
boreal: [a]/'bɔːriːl/; [adj]北的,北方的,北风的,北半球北部山区的; [or]gmat;
bottleneck: [a]/ˈbɑːtlnek/; [n]瓶颈口,(喻)交通易阻塞的狭口;妨碍生产流程的一环; [v]阻碍;交通堵塞; [adj](街道等)狭隘的; [or]gmat;
bounce: [a]/baʊns/; [vi]弹起,蹦跳; [vt]使弹起; [v]拒付 (支票); [n]弹跳,弹力,活力; [or]gmat;
bound: [a]/baʊnd/; [adj]受约束的;有义务的;一定的; [v]束缚;跳跃着前行; [n]跳跃;范围;界限; [or]gmat;
bountiful: [a]/ˈbaʊntɪfl/; [adj]充足的,慷慨的,丰裕的; [or]gmat;
bounty: [a]/ˈbaʊnti/; [n]慷慨;赠物;奖金; [vt]发给.奖金; [or]gmat;
bouquet: [a]/buˈkeɪ/; [n]花束,(酒的)芳香; [or]gmat;
bout: [a]/baʊt/; [n]一回合,较量,一阵; [or]gmat;
bower: [a]/ˈbaʊər/; [n]凉亭,树荫下凉快之处; [or]gmat;
boycott: [a]/ˈbɔɪkɑːt/; [vt]抵制; [n]抵制; [or]gmat;
brace: [a]/breɪs/; [n]<医学>牙齿定位器; [v]支柱;支撑;加固;使绷紧; [or]gmat;
brass: [a]/bræs/; [n]黄铜(器);铜管乐器;<口语>厚脸皮;高级将领官员;黄铜; [v]付(款); [or]gmat;
brazen: [a]/ˈbreɪzn/; [adj]厚脸皮的,厚颜无耻的;黄铜(制)的; [v]厚着脸皮干,使变得无耻; [or]gmat;
breakthrough: [a]/ˈbreɪkθruː/; [n]突破,突破性进展,重要的新发现; [adj]突破性的; [or]gmat;
brevity: [a]/ˈbrevəti/; [n]简短,短小,精炼; [or]gmat;
brew: [a]/bruː/; [v]调制;酿造;冲泡 (茶,咖啡等);酝酿;筹划; [n]酝酿的饮料;啤酒; [or]gmat;
brewery: [a]/ˈbruːəri/; [n]啤酒厂; [or]gmat;
bring about: [a]/brɪŋ əˈbaʊt/; [phr]导致,引起; [or]gmat;
briny: [a]/ˈbraɪni/; [n]海洋; [adj]很咸的,海水的; [or]gmat;
broccoli: [a]/ˈbrɑːkəli/; [n]硬花球花椰菜;花茎甘蓝; [or]gmat;
brochure: [a]/broʊˈʃʊr/; [n]手册,小册子; [or]gmat;
broker: [a]/ˈbroʊkər/; [n]经纪人,掮客; [v]作为经纪人进行谈判,以中间人等身份安排; [or]gmat;
brokerage: [a]/ˈbroʊkərɪdʒ/; [n]中间人业务,经济业;付给经纪人的经手费,佣金,回扣; [or]gmat;
bronze: [a]/brɑːnz/; [n]青铜,青铜色,青铜器; [or]gmat;
browse: [a]/braʊz/; [v]浏览;随意翻阅;(牛,羊等)吃草; [or]gmat;
brutal: [a]/ˈbruːtl/; [adj]残忍的,粗鲁的;严酷的,难以忍受的;严峻的; [or]gmat;
bucolic: [a]/bjuːˈkɑːlɪk/; [adj]乡村的;牧羊的; [or]gmat;
budget: [a]/ˈbʌdʒɪt/; [n]预算; [v]预算,安排; [adj]廉价的; [or]gmat;
buffer: [a]/ˈbʌfər/; [n]缓冲,缓冲区; [v]缓冲; [or]gmat;
bugbear: [a]/ˈbʌɡber/; [n]使人恐惧的东西,妖怪; [or]gmat;
bulge: [a]/bʌldʒ/; [n]凸出部分; [v]凸出,膨胀; [or]gmat;
bulk: [a]/bʌlk/; [n]大批;容量;体积;大块; [adj]大量的;散装的; [v]膨胀;显得重要; [or]gmat;
bumblebee: [a]/ˈbʌmblbiː/; [n](动)野蜂,大蜂; [or]gmat;
bummer: [a]/ˈbʌmər/; [n]懒汉,游手好闲的人; [adj]差劲的; [v]流浪,乞讨; [or]gmat;
bunch: [a]/bʌntʃ/; [n]束;串;群,伙; [v]集中,挤在一起;使成一束(或一群等); [or]gmat;
buoyant: [a]/ˈbɔɪənt/; [adj]有浮力的;愉快的;(股市)保持高价的; [or]gmat;
burden: [a]/ˈbɜːrdn/; [n]负担,重担; [v]使负重,装载;烦扰; [or]gmat;
bureau: [a]/ˈbjʊroʊ/; [n]局,司,处,社,所; [or]gmat;
bureaucrat: [a]/ˈbjʊrəkræt/; [n]官僚,官僚主义者; [or]gmat;
burgeon: [a]/ˈbɜːrdʒən/; [v]发芽,迅速成长; [n]嫩枝; [or]gmat;
burglarize: [a]/'bɜːɡləraɪz/; [v]进行夜盗; [or]gmat;
burrow: [a]/ˈbɜːroʊ/; [n]洞穴,地道;藏身处,住处; [v]挖;钻进;搜寻; [vt]掩蔽; [or]gmat;
bust: [a]/bʌst/; [n]半身塑像;胸部; [v]打碎;搜捕;降级;终止; [adj]破产的;打碎的; [or]gmat;
bustle: [a]/ˈbʌsl/; [n]喧闹,熙攘;腰垫;奔走,奔忙; [v]喧闹;忙乱,奔忙; [or]gmat;
buttress: [a]/ˈbʌtrəs/; [n]扶墙,拱壁; [v]支持; [or]gmat;
bylaw: [a]/'baɪˌlɔː/; [n]地方法规; [or]gmat;
cabin: [a]/ˈkæbɪn/; [n](简陋的)小屋;船舱;客舱,机舱; [v]住在小屋里; [or]gmat;
cabinet: [a]/ˈkæbɪnət/; [n]橱;柜;内阁; [or]gmat;
cache: [a]/kæʃ/; [n]隐藏处所,隐藏的粮食或物资,贮藏物; [vt]贮藏; [vi]躲藏; [or]gmat;
calamitous: [a]/kəˈlæmɪtəs/; [adj]造成灾祸的,灾难的,悲惨的; [or]gmat;
calcium: [a]/ˈkælsiəm/; [n]钙; [or]gmat;
calculate: [a]/ˈkælkjuleɪt/; [vt]计算;估计;计划; [vi]计算;估计; [or]gmat;
calf: [a]/kæf/; [n]小牛,小牛皮,小腿; [or]gmat;
caliph: [a]/ˈkeɪlɪf/; [n]哈里发(伊斯兰国家政教合一的领袖称号); [or]gmat;
call for: [a]/kɔːl fɔr/; [v]需要;邀请;呼吁; [or]gmat;
calorie: [a]/ˈkæləri/; [n]卡(热量单位); [or]gmat;
campaign: [a]/kæmˈpeɪn/; [n](社会性,政治性)活动,运动;战役; [v]从事活动,参加运动; [or]gmat;
canary: [a]/kəˈneri/; [n]金丝雀,女歌星; [adj]加那利群岛的;鲜黄色的; [or]gmat;
cancerous: [a]/ˈkænsərəs/; [adj]癌的,患癌症的; [or]gmat;
candidate: [a]/ˈkændɪdət/; [n](官职,获奖资格等的)候选人;投考人;申请求职者; [or]gmat;
cannon: [a]/ˈkænən/; [n]大炮;机关炮; [v]相撞;开炮; [or]gmat;
canopy: [a]/ˈkænəpi/; [n]华盖;天篷;顶篷;苍穹; [vt]用天篷遮盖;遮蔽; [or]gmat;
canvas: [a]/ˈkænvəs/; [n]帆布,(帆布)油画; [or]gmat;
capacity: [a]/kəˈpæsəti/; [n]产能;容量;本领;才能;负载量;职位; [or]gmat;
capricious: [a]/kəˈprɪʃəs/; [adj]变化无常的,任性的; [or]gmat;
capsule: [a]/ˈkæpsl/; [n]胶囊;航天舱,密封舱; [or]gmat;
captious: [a]/'kæpʃəs/; [adj]挑剔的,吹毛求疵的; [or]gmat;
captivate: [a]/ˈkæptɪveɪt/; [v]吸引,迷惑; [or]gmat;
captive: [a]/ˈkæptɪv/; [adj]被捕获的;被俘虏的; [n]俘虏; [or]gmat;
captivity: [a]/kæpˈtɪvəti/; [n]囚禁;被关; [or]gmat;
capture: [a]/ˈkæptʃər/; [v]捕获,俘获;俘虏;掌控;使迷住;捕捉,留存; [n]战利品; [or]gmat;
carbohydrate: [a]/ˌkɑːrboʊˈhaɪdreɪt/; [n]<化>碳水化合物;淀粉质食物; [or]gmat;
carcass: [a]/ˈkɑːrkəs/; [n](动物,人)尸体;(屠宰后)兽体;(废屋,废船等的)骨架,遗骸; [or]gmat;
carcinogen: [a]/kɑːrˈsɪnədʒən/; [n]［医］致癌物,诱癌物; [or]gmat;
cardiac: [a]/ˈkɑːrdiæk/; [adj]心脏的,心脏病的; [n]心脏病患者;强心剂;健胃剂; [or]gmat;
cardiovascular: [a]/ˌkɑːrdioʊˈvæskjələr/; [adj]［医］心血管的; [or]gmat;
cargo: [a]/ˈkɑːrɡoʊ/; [n]货物; [or]gmat;
caricature: [a]/ˈkærɪkətʃər/; [n]讽刺画,滑稽模仿;扭曲,夸张的描述; [or]gmat;
caries: [a]/ˈkeriːz/; [n]［拉］［医］龋,骨疡; [or]gmat;
carnivore: [a]/ˈkɑːrnɪvɔːr/; [n]食肉动物,食虫植物; [or]gmat;
carol: [a]/ˈkærəl/; [v]欢唱,歌颂; [n]颂歌,赞美诗,欢乐之歌; [or]gmat;
carpal: [a]/ˈkɑːrpl/; [n]［解］腕骨; [adj]腕骨的; [or]gmat;
cartel: [a]/kɑːrˈtel/; [n]卡特尔;企业联合;垄断联盟;俘虏交换条约; [or]gmat;
cartographer: [a]/kɑːrˈtɑːɡrəfər/; [n]制图师;地图制作者; [or]gmat;
cascade: [a]/kæˈskeɪd/; [n]层叠;小瀑布;喷流; [v]像瀑布般冲下或倾泻; [or]gmat;
cash in on: [a]/kæʃ ɪn ɔn/; [v]以.获利,营利; [or]gmat;
caste: [a]/kæst/; [n](印度社会中的)种姓;(具有严格等级差别的)社会地位;(排他的)社会团体; [or]gmat;
casualty: [a]/ˈkæʒuəlti/; [n]伤亡人员,死伤者,受害人;急诊室(英); [or]gmat;
catalog: [a]/ˈkætəlɔːɡ/; [n]目录,目录册,商品目录; [v]为..编目录,登记; [or]gmat;
catalyst: [a]/ˈkætəlɪst/; [n]催化剂;造成变化的人或事; [or]gmat;
catastrophe: [a]/kəˈtæstrəfi/; [n]大灾难; [or]gmat;
categorical: [a]/ˌkætəˈɡɔːrɪkl/; [adj]绝对的;直接了当的;无条件的;属于某一范畴的; [or]gmat;
category: [a]/ˈkætəɡɔːri/; [n]类别;范畴; [or]gmat;
cater: [a]/ˈkeɪtər/; [v]供应伙食;为(集会,婚礼等)承办酒席; [or]gmat;
caterpillar: [a]/ˈkætərpɪlər/; [n]毛虫,蝴蝶的幼虫; [or]gmat;
cathedral: [a]/kəˈθiːdrəl/; [n]大教堂; [adj]有权威的;大教堂的; [or]gmat;
causative: [a]/ˈkɔːzətɪv/; [adj]成为原因的,引起.的; [n]使役动词; [or]gmat;
caveat: [a]/ˈkæviæt/; [n]警告;防止误解的说明; [or]gmat;
caviar: [a]/ˈkæviɑːr/; [n]鱼子酱; [or]gmat;
cease: [a]/siːs/; [v]停止,结束; [n]停止,停息; [or]gmat;
cedar: [a]/ˈsiːdər/; [n]雪松,香柏,西洋杉木; [or]gmat;
celebrity: [a]/səˈlebrəti/; [n]名人;名流; [adj]有名望的;名人的; [or]gmat;
celestial: [a]/səˈlestʃl/; [adj]天体的,天上的; [n]天人,神仙;(指封建时代的)中国人,天朝之人; [or]gmat;
cellular: [a]/ˈseljələr/; [adj]细胞的,无线的;蜂窝式的; [or]gmat;
censure: [a]/ˈsenʃər/; [v]责难,责备; [n]责难,责备; [or]gmat;
census: [a]/ˈsensəs/; [n]人口普查,人口调查;统计; [v]调查(某地区等的)人口数字;统计.的数字; [or]gmat;
center: [a]/ˈsentər/; [n]中央,中心; [v]集中;居中; [or]gmat;
centrifugal: [a]/ˌsentrɪˈfjuːɡl/; [adj]离心的;远中的; [n]离心机; [or]gmat;
ceramic: [a]/səˈræmɪk/; [adj]陶器的,陶瓷的; [n]陶瓷制品; [or]gmat;
cereal: [a]/ˈsɪriəl/; [n]谷物;谷类食物;谷类食品; [adj]谷类的;谷类制成的; [or]gmat;
ceremonial: [a]/ˌserɪˈmoʊniəl/; [n]宗教仪式;礼节; [adj]仪式的;礼仪的,正式的; [or]gmat;
certificate: [a]/sərˈtɪfɪkət/; [n]合格证书,文凭;证明,证明书; [v]给..发证书; [or]gmat;
certify: [a]/ˈsɜːrtɪfaɪ/; [v](发给证书)证明;证实; [or]gmat;
certitude: [a]/ˈsɜːrtɪtuːd/; [n]确实;确信;必然性; [or]gmat;
cessation: [a]/seˈseɪʃn/; [n]停止,中止,中断; [or]gmat;
chalice: [a]/ˈtʃælɪs/; [n](高脚)酒杯;圣餐杯;［植］杯状花; [or]gmat;
chamber: [a]/ˈtʃeɪmbər/; [n]会议室;(作特殊用途的)房间;议院; [or]gmat;
chameleon: [a]/kəˈmiːliən/; [n]蜥蜴;变色龙;善变的人; [or]gmat;
chant: [a]/tʃænt/; [v]吟唱;诵扬; [n]圣歌;赞美诗;旋律; [or]gmat;
char: [a]/tʃɑːr/; [n]炭,木炭,［常用复］家庭杂物; [v](把..)烧成炭,烧焦; [or]gmat;
character: [a]/ˈkærəktər/; [n]人物,角色;性格;(书写或印刷)符号,(汉)字;特点;人格,品性; [or]gmat;
charge: [a]/tʃɑːrdʒ/; [v]充电,充值;索价;控告;向.冲去; [n]费用;主管;控告; [or]gmat;
charity: [a]/ˈtʃærəti/; [n]慈善团体;慈善;仁慈;施舍; [or]gmat;
chart: [a]/tʃɑːrt/; [n]图表,表格;航海图;每周排行榜; [v]制成图表;制航海图; [or]gmat;
charter: [a]/ˈtʃɑːrtər/; [n]宪章;特权,豁免权;契约,证书;租赁; [v]包,租(飞机,汽车等); [adj]包租的,租用的; [or]gmat;
chauvinism: [a]/ˈʃoʊvɪnɪzəm/; [n]沙文主义者,盲目爱国主义; [or]gmat;
check: [a]/tʃek/; [v]检查;阻止; [n]支票;阻止;检查;阻止物; [or]gmat;
cheetah: [a]/ˈtʃiːtə/; [n]猎豹; [or]gmat;
chef: [a]/ʃef/; [n]主厨;厨师; [or]gmat;
chip: [a]/tʃɪp/; [n]木屑,碎片;缺口;圆形筹码;芯片;炸薯条,炸薯片; [v]碎裂;削,凿;将.削成,凿成; [or]gmat;
chisel: [a]/ˈtʃɪzl/; [v]刻,凿; [n]凿子; [or]gmat;
cholesterol: [a]/kəˈlestərɔːl/; [n]胆固醇; [or]gmat;
chord: [a]/kɔːrd/; [n]和弦;和音;心弦;(数学)弦; [or]gmat;
chordate: [a]/'kɔːˌdeɪt/; [n]脊索动; [adj]<动>脊索动物的; [or]gmat;
chore: [a]/tʃɔːr/; [n]日常家庭杂务,日常工作;琐碎烦人的杂务; [or]gmat;
choreographer: [a]/ˌkɔːriˈɑːɡrəfər/; [n]舞蹈编导; [or]gmat;
choreography: [a]/ˌkɔːriˈɑːɡrəfi/; [n]编舞艺术;舞蹈编排;舞蹈编排; [or]gmat;
chromosome: [a]/ˈkroʊməsoʊm/; [n]染色体; [or]gmat;
chronic: [a]/ˈkrɑːnɪk/; [adj](疾病)慢性的;长期的;(人)久病的;积习难改的;严重的; [or]gmat;
chronicle: [a]/ˈkrɑːnɪkl/; [n]编年史,年代记,记录; [v]记录,把.载入编年史; [or]gmat;
chronology: [a]/krəˈnɑːlədʒi/; [n]年代学;(事件等)按年月次序的排列;年表; [or]gmat;
churn: [a]/tʃɜːrn/; [n](炼制黄油用的)搅乳器; [v]用搅乳器搅拌; [or]gmat;
cinder: [a]/ˈsɪndər/; [n]余烬,矿渣; [or]gmat;
circadian: [a]/sɜːrˈkeɪdiən/; [adj]［生］生理节奏的;以24小时为周期的; [or]gmat;
circle: [a]/ˈsɜːrkl/; [n]周期;范围;圆圈; [v]围绕; [or]gmat;
circuit: [a]/ˈsɜːrkɪt/; [n]电路,线路;巡游,环形; [or]gmat;
circular: [a]/ˈsɜːrkjələr/; [adj]圆形的;环形的; [n]通知; [or]gmat;
circulate: [a]/ˈsɜːrkjəleɪt/; [v](使)流通;(使)循环;(使)传播,流传; [or]gmat;
circulation: [a]/ˌsɜːrkjəˈleɪʃn/; [n]流传,传播;发行,发行量;(体液的)循环;(水,空气等的)流通;(货币等的)流通; [or]gmat;
circumference: [a]/sərˈkʌmfərəns/; [n]圆周长度,圆周;周围; [or]gmat;
circumscribe: [a]/ˈsɜːrkəmskraɪb/; [v]限制;在.周围画线;<数>使外接,使外切; [or]gmat;
circumspect: [a]/ˈsɜːrkəmspekt/; [adj]慎重的,仔细的; [or]gmat;
circumvent: [a]/ˌsɜːrkəmˈvent/; [v]用计避免,规避; [or]gmat;
civic: [a]/ˈsɪvɪk/; [adj]城市的;公民的,市民的; [or]gmat;
civil: [a]/ˈsɪvl/; [adj]公民的,民用的;国内的;有礼貌的,客气的; [or]gmat;
claim: [a]/kleɪm/; [v]声称;要求;断言;主张;认领;索赔; [n]索赔;主张;声称;断言;要求; [or]gmat;
clam: [a]/klæm/; [n]蛤,蚶;沉默寡言的人; [or]gmat;
clan: [a]/klæn/; [n]家族;氏族;部落;宗派;亲族; [or]gmat;
clandestine: [a]/klænˈdestɪn/; [adj]秘密的,私下的,暗中的; [or]gmat;
clarify: [a]/ˈklærəfaɪ/; [v]阐明,澄清;净化; [or]gmat;
clarity: [a]/ˈklærəti/; [n]清楚;清澈; [or]gmat;
classify: [a]/ˈklæsɪfaɪ/; [v]把.分类; [or]gmat;
clergy: [a]/ˈklɜːrdʒi/; [n]教牧人员,神职人员; [or]gmat;
clerical: [a]/ˈklerɪkl/; [adj]书记的;牧师的;办事员的; [n]牧师; [or]gmat;
client: [a]/ˈklaɪənt/; [n]委托人,当事人,主顾,客户;客户端; [or]gmat;
clientele: [a]/ˌklaɪənˈtel/; [n]顾客,常客; [or]gmat;
cliff: [a]/klɪf/; [n]悬崖;峭壁; [or]gmat;
climatologist: [a]/ˌklaɪməˈtɑːlədʒist/; [n]气候学家; [or]gmat;
clipping: [a]/ˈklɪpɪŋ/; [n]剪下物,剪辑,剪报; [adj]快速的; [or]gmat;
clockwise: [a]/ˈklɑːkwaɪz/; [adj]顺时针方向的; [adv]顺时针方向地; [or]gmat;
clog: [a]/klɑːɡ/; [v]阻塞,阻碍; [n]障碍;木底鞋; [or]gmat;
clone: [a]/kloʊn/; [n]克隆;无性繁殖系个体;复制品; [v]复制;克隆; [or]gmat;
closed-circuit television: [a]/ˌkloʊzd ˌsɜːrkɪt ˈtelɪvɪʒn/; [n]闭路电视; [or]gmat;
clothesline: [a]/'kloʊzˌlaɪn/; [n]晒衣绳; [vt](用胳膊勾住脖子)击倒对手; [or]gmat;
clump: [a]/klʌmp/; [n]土块; [v]丛生; [or]gmat;
clumsy: [a]/ˈklʌmzi/; [adj]笨拙的,不灵活的;拙劣的,不得体的; [or]gmat;
cluster: [a]/ˈklʌstər/; [n]一串;一簇; [v]群集;丛生; [or]gmat;
coalesce: [a]/ˌkoʊəˈles/; [v]联合,合并,结合; [or]gmat;
coalition: [a]/ˌkoʊəˈlɪʃn/; [n]结合;联盟;联合; [or]gmat;
cobble: [a]/ˈkɑːbl/; [v]修,拙劣地修补;铺鹅卵石,用圆石铺面; [n]鹅卵石,圆石; [or]gmat;
cocaine: [a]/koʊˈkeɪn/; [n]可卡因,古柯碱; [or]gmat;
cocoa: [a]/ˈkoʊkoʊ/; [n]可可粉; [or]gmat;
coda: [a]/ˈkoʊdə/; [n]［音］结尾,符尾; [or]gmat;
code: [a]/koʊd/; [n]编码,代码;准则,法典;密码; [v]将.编码; [or]gmat;
codify: [a]/ˈkɑːdɪfaɪ/; [v]编纂;将..编成法典; [or]gmat;
cognitive: [a]/ˈkɑːɡnətɪv/; [adj]认识能力的;认知的; [or]gmat;
coherent: [a]/koʊˈhɪrənt/; [adj]协调一致的;条理清楚的,有条理的;连贯的;有黏性的,黏合在一起的,粘着的; [or]gmat;
coinage: [a]/ˈkɔɪnɪdʒ/; [n]铸币造币(权);货币,货币制度; [or]gmat;
coincide: [a]/ˌkoʊɪnˈsaɪd/; [v]巧合,一致,相符; [or]gmat;
coleslaw: [a]/ˈkoʊlslɔː/; [n]凉拌卷心菜丝; [or]gmat;
collaborate: [a]/kəˈlæbəreɪt/; [v]合作; [or]gmat;
collapse: [a]/kəˈlæps/; [v](使)倒塌,(使)崩溃,(使)瓦解; [n]倒塌,崩溃,暴跌; [or]gmat;
collateral: [a]/kəˈlætərəl/; [adj]间接的,旁系的; [n]抵押品; [or]gmat;
collective: [a]/kəˈlektɪv/; [adj]集体的,共同的; [n]集体; [or]gmat;
collide: [a]/kəˈlaɪd/; [vi]碰撞;互撞;抵触; [or]gmat;
colossal: [a]/kəˈlɑːsl/; [adj]巨像(似)的;巨大的,庞大的; [or]gmat;
combat: [a]/ˈkɑːmbæt/; [n]战斗,格斗; [v]与.战斗,与.斗争; [adj]战斗的; [or]gmat;
combination: [a]/ˌkɑːmbɪˈneɪʃn/; [n]结合,联合,组合;(保险锁等的)暗码; [or]gmat;
combine: [a]/kəmˈbaɪn/; [v]使混合(结合,组合,联合);结合;联合;组合; [n]联合体,联合企业;联合收割机; [or]gmat;
combustion: [a]/kəmˈbʌstʃən/; [n]燃烧; [or]gmat;
comedian: [a]/kəˈmiːdiən/; [n]喜剧演员; [or]gmat;
comet: [a]/ˈkɑːmət/; [n]彗星; [or]gmat;
commend: [a]/kəˈmend/; [v]称赞;推荐;委托保管; [or]gmat;
commensurate: [a]/kəˈmenʃərət/; [adj]相称的,相应的;同量的;同样大小的; [or]gmat;
comment: [a]/ˈkɑːment/; [n]评论,议论;批评,意见;注解; [vt]评论; [vi]进行评论;为.作评语; [or]gmat;
commercial: [a]/kəˈmɜːrʃl/; [adj]商业性的,贸易的; [n]商业广告; [or]gmat;
commission: [a]/kəˈmɪʃn/; [n]委员会;任务;权限;委任;销售佣金; [v]委任; [or]gmat;
commit: [a]/kəˈmɪt/; [v]犯(罪);进行 (自杀);调拨 (钱,资源);监禁;送交 (到精神病院,监狱等);承诺,保证; [or]gmat;
commodity: [a]/kəˈmɑːdəti/; [n]商品,货物; [or]gmat;
communal: [a]/kəˈmjuːnl/; [adj]公社的;公共的; [or]gmat;
community: [a]/kəˈmjuːnəti/; [n]社区;团体;(生)群落;人群,很多个体的集合体; [or]gmat;
commute: [a]/kəˈmjuːt/; [n]在两地之间乘车往返; [v]经常乘车往返于两地之间; [vt]减免; [or]gmat;
compact: [a]/ˈkɑːmpækt/; [adj]小巧的,小型的,袖珍的,体积小的;紧密的,紧凑的,密集的; [v]把..压紧;变得坚实; [n]带镜小粉盒;合约,条约; [or]gmat;
compactness: [a]/kəmˈpæktnəs/; [n]紧密;小巧;紧凑; [or]gmat;
compassion: [a]/kəmˈpæʃn/; [n]同情;怜悯; [or]gmat;
compatible: [a]/kəmˈpætəbl/; [adj]可和谐共存的;兼容的; [or]gmat;
compel: [a]/kəmˈpel/; [v]强迫;迫使屈服;(使)不得已; [or]gmat;
compensate: [a]/ˈkɑːmpenseɪt/; [v]补偿,赔偿,给..报酬; [or]gmat;
compensatory: [a]/kəmˈpensətɔːri/; [adj]补偿的,赔偿的; [or]gmat;
competence: [a]/ˈkɑːmpɪtəns/; [n]能力,胜任,称职; [or]gmat;
compile: [a]/kəmˈpaɪl/; [v]收集,汇编; [or]gmat;
complacency: [a]/kəmˈpleɪsnsi/; [n]自满,自鸣得意;满足; [or]gmat;
complement: [a]/ˈkɑːmplɪment/; [v]补充;与.相配; [n]补充;互为补充的东西;补语; [or]gmat;
complementary: [a]/ˌkɑːmplɪˈmentri/; [adj]补足的,补充的,互补的; [or]gmat;
complex: [a]/ˈkɑːmpleks/; [adj]复杂的,难解的;复合的; [n]情结;建筑群;综合体,集合体; [or]gmat;
compliance: [a]/kəmˈplaɪəns/; [n]遵守,依从;承诺,答应; [or]gmat;
comply: [a]/kəmˈplaɪ/; [vi]依从,服从,遵守; [or]gmat;
component: [a]/kəmˈpoʊnənt/; [n]零件; [adj]组成的; [or]gmat;
compose: [a]/kəmˈpoʊz/; [v]创作,作曲,形成,构成; [or]gmat;
composite number: [a]/kəmˈpɑːzət ˈnʌmbər/; [phr]合成数,合数; [or]gmat;
compound interest: [a]/ˌkɑːmpaʊnd ˈɪntrəst/; [phr]复利; [or]gmat;
compound: [a]/ˈkɑːmpaʊnd/; [n]复合物;<化学>化合物; [adj]合成的;复合的;多功能的; [vi]妥协;和解; [vt]混合;调和;调停;使恶化; [or]gmat;
comprehend: [a]/ˌkɑːmprɪˈhend/; [v]由.组成;了解;领会;包含; [or]gmat;
compress: [a]/kəmˈpres/; [v]压紧,压缩,压榨; [or]gmat;
comprise: [a]/kəmˈpraɪz/; [v]包含,包括;构成; [or]gmat;
compromise: [a]/ˈkɑːmprəmaɪz/; [n]妥协;折中; [v]妥协;使遭受危害; [or]gmat;
compulsory: [a]/kəmˈpʌlsəri/; [adj]强制的,必修的; [or]gmat;
computation: [a]/ˌkɑːmpjuˈteɪʃn/; [n]估计,计算; [or]gmat;
conceal: [a]/kənˈsiːl/; [v]隐藏,隐瞒,掩盖; [or]gmat;
concede: [a]/kənˈsiːd/; [v]承认;承认失败;让给,让与;让步; [or]gmat;
conceive: [a]/kənˈsiːv/; [v]怀孕;设想,想出; [or]gmat;
concentrate: [a]/ˈkɑːnsntreɪt/; [v]全神贯注于,集中于;浓缩; [n]浓缩物; [or]gmat;
concentric circle: [a]/kənˈsentrɪk ˈsɜːrkl/; [phr]同心圆; [or]gmat;
conceptual: [a]/kənˈseptʃuəl/; [adj]概念的; [or]gmat;
concern: [a]/kənˈsɜːrn/; [n]关心,担忧; [v]感兴趣,涉及,关心,(使)担忧; [or]gmat;
concert: [a]/ˈkɑːnsərt/; [n]音乐会;一致;和谐,合作; [or]gmat;
concerto: [a]/kənˈtʃɜːrtoʊ/; [n]<音乐>协奏曲; [or]gmat;
concession: [a]/kənˈseʃn/; [n]让步;特许,特许权;承认; [or]gmat;
concrete: [a]/ˈkɑːŋkriːt/; [n]混凝土; [adj]具体的,实质性的; [v]给 (道路等) 浇混凝土; [or]gmat;
concurrent: [a]/kənˈkɜːrənt/; [adj]一致的;同时发生的; [n]同时发生的事件; [or]gmat;
condemn: [a]/kənˈdem/; [v]谴责,责备;判(某人某罪); [or]gmat;
condense: [a]/kənˈdens/; [v]压缩;精炼;冷凝; [or]gmat;
condescending: [a]/ˌkɑːndɪˈsendɪŋ/; [adj]贬低的;有优越感的; [or]gmat;
condor: [a]/ˈkɑːndɔːr/; [n]<动物>神鹰;秃鹫; [or]gmat;
conduct: [a]/kənˈdʌkt/; [v]指挥;进行;实施;处理;传导(电,热等);护送; [n]行为,举止;指挥,带领; [or]gmat;
cone: [a]/koʊn/; [n]圆锥体;球果;甜筒; [vt]使成锥形; [or]gmat;
confederation: [a]/kənˌfedəˈreɪʃn/; [n]同盟,联盟; [or]gmat;
confer: [a]/kənˈfɜːr/; [v]授予(奖项,学位,荣誉或权利);商讨,协商; [or]gmat;
confess: [a]/kənˈfes/; [v](向神父或上帝)忏悔;承认,坦白; [or]gmat;
confidential: [a]/ˌkɑːnfɪˈdenʃl/; [adj]机密的;表示信任的;悄悄的; [or]gmat;
configuration: [a]/kənˌfɪɡjəˈreɪʃn/; [n]配置,布局,构造; [or]gmat;
confine: [a]/kənˈfaɪn/; [v]限制;监禁; [n]范围,界限,约束,限制; [or]gmat;
confinement: [a]/kənˈfaɪnmənt/; [n]限制;监禁;分娩; [or]gmat;
confirm: [a]/kənˈfɜːrm/; [v]确认;证实;批准; [or]gmat;
conform: [a]/kənˈfɔːrm/; [vi]一致;遵照,顺从;符合; [vt]使一致;使遵照; [adj]一致的; [or]gmat;
confront: [a]/kənˈfrʌnt/; [v]与某人对峙;与..对抗;正视; [or]gmat;
congenial: [a]/kənˈdʒiːniəl/; [adj]意气相投的,令人愉快的,意气相投的,协调的; [or]gmat;
congested: [a]/kənˈdʒestɪd/; [adj]拥挤的,密集的; [or]gmat;
congestion: [a]/kənˈdʒestʃən/; [n]拥挤,充血; [or]gmat;
conglomerate: [a]/kənˈɡlɑːmərət/; [n]砾岩;联合大企业; [vi]聚集; [adj]混合的;联合大企业的; [vt]使聚集;使结成;结合; [or]gmat;
congregation: [a]/ˌkɑːŋɡrɪˈɡeɪʃn/; [n]集合在一起的群众; [or]gmat;
congress: [a]/ˈkɑːŋɡrəs/; [n]国会(美);代表大会;议会;立法机关; [or]gmat;
congruent: [a]/ˈkɑːŋɡruənt/; [adj]和谐一致的,全等的; [or]gmat;
connive: [a]/kəˈnaɪv/; [v]默许,共谋; [or]gmat;
conscience: [a]/ˈkɑːnʃəns/; [n]良心,良知; [or]gmat;
consecutive: [a]/kənˈsekjətɪv/; [adj]连续的,连贯的; [or]gmat;
consensus: [a]/kənˈsensəs/; [n]一致同意,合意; [or]gmat;
consent: [a]/kənˈsent/; [n]同意,准许;赞成; [v]同意; [or]gmat;
consequence: [a]/ˈkɑːnsɪkwens/; [n]结果,后果;重要性; [or]gmat;
conserve: [a]/kənˈsɜːrv/; [v]保藏,保存;节约; [n]蜜饯,果酱; [or]gmat;
consistency: [a]/kənˈsɪstənsi/; [n]连结,结合;坚固性;浓度,密度;一致性;连贯性; [or]gmat;
conspiracy: [a]/kənˈspɪrəsi/; [n]密谋,阴谋; [or]gmat;
conspire: [a]/kənˈspaɪər/; [v]密谋策划;共谋,串通一气; [or]gmat;
constant: [a]/ˈkɑːnstənt/; [adj]不变的,始终如一的;持续不断的; [n]常数,恒量; [or]gmat;
constellation: [a]/ˌkɑːnstəˈleɪʃn/; [n]星座,星群,一系列,一群; [or]gmat;
constituent: [a]/kənˈstɪtʃuənt/; [adj]组成的;有选举权的; [n]选民;成分; [or]gmat;
constitute: [a]/ˈkɑːnstətuːt/; [v]构成,组成;任命; [or]gmat;
constraint: [a]/kənˈstreɪnt/; [n]限制;强迫,拘束;强制; [or]gmat;
constrict: [a]/kənˈstrɪkt/; [v]约束,收缩,妨碍; [or]gmat;
consult: [a]/kənˈsʌlt/; [v]请教,咨询;查阅;商量; [or]gmat;
consumption: [a]/kənˈsʌmpʃn/; [n]消耗,消费,耗尽;肺痨; [or]gmat;
contagious: [a]/kənˈteɪdʒəs/; [adj](病)有传染性的;(人)患传染病的;有感染力的; [or]gmat;
contaminant: [a]/kənˈtæmɪnənt/; [n]污染物,致污物; [or]gmat;
contaminate: [a]/kənˈtæmɪneɪt/; [v]弄脏,污染; [or]gmat;
contemplate: [a]/ˈkɑːntəmpleɪt/; [v]沉思;对..周密考虑;注视; [or]gmat;
contemporary: [a]/kənˈtempəreri/; [adj]同时代的;当代的,现代的; [n]同龄人,同时代的人; [or]gmat;
contemptuous: [a]/kənˈtemptʃuəs/; [adj]藐视的,倨傲的; [or]gmat;
contend: [a]/kənˈtend/; [v]争辩;坚决主张;搏斗; [or]gmat;
contentious: [a]/kənˈtenʃəs/; [adj]好辩的,爱争论的; [or]gmat;
context: [a]/ˈkɑːntekst/; [n]上下文,语境;背景; [or]gmat;
contiguous: [a]/kənˈtɪɡjuəs/; [adj]相接的;邻近的,附近的; [or]gmat;
contingency: [a]/kənˈtɪndʒənsi/; [n]偶然性;<安全>意外事故;可能性;<审计>意外开支; [or]gmat;
contingent: [a]/kənˈtɪndʒənt/; [n]分遣队; [adj]意外的,视情况条件而定的; [or]gmat;
contract: [a]/ˈkɑːntrækt/; [n]合同,契约; [v]感染(疾病);招致;订合同;订立(婚约);缩减; [or]gmat;
contraction: [a]/kənˈtrækʃn/; [n]收缩,紧缩;缩写式; [or]gmat;
contradict: [a]/ˌkɑːntrəˈdɪkt/; [v]与..发生矛盾,与..抵触,与..对立; [or]gmat;
control: [a]/kənˈtroʊl/; [n]控制;对照实验;控制装置; [vt]控制,管理; [or]gmat;
controversy: [a]/ˈkɑːntrəvɜːrsi/; [n]争论,辩论; [or]gmat;
convalescence: [a]/ˌkɑːnvəˈlesns/; [n]康复,恢复,病后康复期; [or]gmat;
conversion: [a]/kənˈvɜːrʒn/; [n]转变,转换;宗教,信仰上的转变;<经济学>兑换; [or]gmat;
convert: [a]/kənˈvɜːrt/; [v]可转变为,可变换成;改变,转变,转化;使改变信仰; [n]皈依者;改变宗教信仰者; [or]gmat;
convey: [a]/kənˈveɪ/; [v]传送,运送;表达,传达; [or]gmat;
conviction: [a]/kənˈvɪkʃn/; [n]定罪;信服;坚强信念; [or]gmat;
convince: [a]/kənˈvɪns/; [v]使确信;使信服; [or]gmat;
convoluted: [a]/ˈkɑːnvəluːtɪd/; [adj]旋绕的,费解的; [or]gmat;
coordinate: [a]/koʊˈɔːrdɪneɪt/; [v]使协调,使一致,调整; [n]坐标,同等的人物,配套服装; [adj]并列的;同等的; [or]gmat;
copper: [a]/ˈkɑːpər/; [n]铜;铜币;警官;铜色;铜(制); [or]gmat;
coral: [a]/ˈkɔːrəl/; [n]珊瑚; [or]gmat;
cord: [a]/kɔːrd/; [n]细绳,索,(电工学)电绳;索,(电工学)电绳; [or]gmat;
coriander: [a]/ˌkɔːriˈændər/; [n]［植］芫荽,香菜; [or]gmat;
cornerstone: [a]/ˈkɔːrnərstoʊn/; [n]奠基石;基础; [or]gmat;
cornstalk: [a]/'kɔːnˌstɔːk/; [n]玉米秆; [or]gmat;
corny: [a]/ˈkɔːrni/; [adj]谷类的,乡下味的,粗野的,有鸡眼的; [or]gmat;
coronary: [a]/ˈkɔːrəneri/; [adj]冠的,冠状的,花冠的; [n]冠状动脉;(病理学)冠状动脉血栓形成; [or]gmat;
corporate: [a]/ˈkɔːrpərət/; [adj]公司的;全体的;共同的;(法人)团体的; [or]gmat;
corps: [a]/kɔːr/; [n](由两个或以上师组成的)军,兵团;一群人;特别小组; [or]gmat;
corral: [a]/kəˈræl/; [n]畜栏,环形车阵; [v]把.关进畜栏,捕捉,把.布成车阵; [or]gmat;
correlate: [a]/ˈkɔːrələt/; [v](使)相关联; [n]相关物; [or]gmat;
correspond: [a]/ˌkɔːrəˈspɑːnd/; [v]符合;相符,一致;通信; [or]gmat;
corridor: [a]/ˈkɔːrɪdɔːr/; [n]走廊,长条地带,回廊,通道; [or]gmat;
corroborate: [a]/kəˈrɑːbəreɪt/; [v]支持或证实,强化; [n]确证者,证物; [or]gmat;
corrosion: [a]/kəˈroʊʒn/; [n]侵蚀,腐蚀状态; [or]gmat;
corruption: [a]/kəˈrʌpʃn/; [n]腐败,受贿,贪污,堕落;词的变体,变化了的形式; [or]gmat;
cortex: [a]/ˈkɔːrteks/; [n]<解剖>皮质,树皮,果皮; [or]gmat;
cosmetic: [a]/kɑːzˈmetɪk/; [n]化妆品; [adj]化妆用的,美容的;装门面的 <表不满>; [or]gmat;
cosmic: [a]/ˈkɑːzmɪk/; [adj]宇宙的;广大无边的; [or]gmat;
council: [a]/ˈkaʊnsl/; [n]议会;理事会;委员会; [or]gmat;
counteract: [a]/ˌkaʊntərˈækt/; [v]抵消;中和;阻碍; [or]gmat;
counterclockwise: [a]/ˌkaʊntərˈklɑːkwaɪz/; [adv]逆时针方向; [adj]逆时针方向的,自右向左的; [or]gmat;
counterfeit: [a]/ˈkaʊntərfɪt/; [n]仿制品,伪造物; [adj]仿造的.假冒的; [v]伪造,仿造; [or]gmat;
counterpart: [a]/ˈkaʊntərpɑːrt/; [n]对应的人(物);副本;对手; [or]gmat;
countervail: [a]/'kaʊntəˌveɪl/; [v]抵销,对抗,补偿; [adj]抗衡的;抵消的; [or]gmat;
coupon: [a]/ˈkuːpɑːn/; [n](债券等)息券;赠券;配给券;折扣券; [or]gmat;
courier: [a]/ˈkʊriər/; [n]快递员,通讯员,导游; [or]gmat;
courtesy: [a]/ˈkɜːrtəsi/; [n]礼貌; [or]gmat;
coy: [a]/kɔɪ/; [adj]腼腆的,怕羞的;卖弄风情的; [or]gmat;
coyote: [a]/kaɪˈoʊti/; [n](美国西部的)郊狼,小狼; [or]gmat;
crack: [a]/kræk/; [v]敲出裂痕,敲破;垮掉;断裂,折断;说(笑话); [n]裂缝;破裂声;挖苦话;强效纯可卡因; [adj]最好的,一流的; [adv]尖锐地; [vi]断裂,折断; [or]gmat;
cramped: [a]/kræmpt/; [adj]狭窄的,挤在一起的; [or]gmat;
crass: [a]/kræs/; [adj]粗鲁的,粗俗的,愚钝的; [or]gmat;
crate: [a]/kreɪt/; [n]板条箱,篓; [v]将某物装入大木箱或板条箱中; [or]gmat;
crater: [a]/ˈkreɪtər/; [n]火山口;弹坑; [v]在.上形成坑;毁坏; [or]gmat;
credence: [a]/ˈkriːdns/; [n]信任,相信; [or]gmat;
credit: [a]/ˈkredɪt/; [n]信用;荣誉;学分;信贷;称赞;债权; [v]信赖;归因于;记学分; [or]gmat;
credo: [a]/ˈkriːdoʊ/; [n]信条,教义; [or]gmat;
crest: [a]/krest/; [n]鸟冠,盔上的装饰(如羽毛),顶部,顶峰; [v]到达绝顶,加以顶饰; [or]gmat;
criminology: [a]/ˌkrɪmɪˈnɑːlədʒi/; [n]犯罪学,刑事学; [or]gmat;
cripple: [a]/ˈkrɪpl/; [n]跛子,伤残人(或动物); [v]使跛;使受伤致残;严重削弱; [or]gmat;
criteria: [a]/kraɪ'tɪəriə/; [n]标准,条件; [or]gmat;
critic: [a]/ˈkrɪtɪk/; [n]评论家,批判者;挑剔的人; [or]gmat;
critique: [a]/krɪˈtiːk/; [n]批评;评论文章; [v]批判,评论;评论; [or]gmat;
crucial: [a]/ˈkruːʃl/; [adj]关键的;决定性的; [or]gmat;
crude: [a]/kruːd/; [adj]天然的;粗糙的;粗鲁的;简陋的; [n]原油; [or]gmat;
crumple: [a]/ˈkrʌmpl/; [v]把.揉作一团,弄皱;压碎; [or]gmat;
crunch: [a]/krʌntʃ/; [n]嘎吱嘎吱的声音; [vt]嘎吱嘎吱地咀嚼; [vi]嘎吱嘎吱地咀嚼;嘎吱嘎吱地动;发嘎吱嘎吱声; [or]gmat;
crusade: [a]/kruːˈseɪd/; [n]改革运动,十字军东侵; [v]加入十字军,从事改革运动; [or]gmat;
crust: [a]/krʌst/; [n]外壳,面包皮,硬外皮; [or]gmat;
crypt: [a]/krɪpt/; [n]地窟,［解］腺窝,小囊; pref. 隐藏的;秘密的(=crypto); [or]gmat;
cryptic: [a]/ˈkrɪptɪk/; [adj]秘密的,含义模糊的,神秘的,隐藏的; [or]gmat;
cube: [a]/kjuːb/; [n]立方体,立方; [or]gmat;
cue: [a]/kjuː/; [n]提示;暗号;球杆; [v]给.提示; [or]gmat;
cuisine: [a]/kwɪˈziːn/; [n]烹饪;菜肴; [or]gmat;
culminate: [a]/ˈkʌlmɪneɪt/; [v]使达高潮,使结束; [or]gmat;
culpability: [a]/ˌkʌlpəˈbɪləti/; [n]有罪,该受谴责; [or]gmat;
cult: [a]/kʌlt/; [n]异教;风尚,热潮;信徒; [adj]流行的;风靡一时的; [or]gmat;
cultivation: [a]/ˌkʌltɪˈveɪʃn/; [n]耕种,种植;培养,教化;文雅; [or]gmat;
cumbersome: [a]/ˈkʌmbərsəm/; [adj]笨重的;麻烦的; [or]gmat;
cupidity: [a]/kjuːˈpɪdəti/; [n]贪婪; [or]gmat;
curb: [a]/kɜːrb/; [v]勒住;抑制;控制;约束; [n]路缘;控制;约束; [or]gmat;
cure-all: [a]/ˈkjʊr ɔːl/; [n]万灵药; [or]gmat;
currency: [a]/ˈkɜːrənsi/; [n]货币;流通;流行; [or]gmat;
curriculum: [a]/kəˈrɪkjələm/; [n]课程,(学校或专业的)全部课程; [or]gmat;
curtail: [a]/kɜːrˈteɪl/; [vt]截短;削减;剥夺.特权; [or]gmat;
customize: [a]/ˈkʌstəmaɪz/; [v]定制,定做;按规格改制;定制,定做;依照指定的规格制造; [or]gmat;
customs: [a]/ˈkʌstəmz/; [n]海关;风俗;关税; [adj]定做的;专做定货的; [or]gmat;
cylinder: [a]/ˈsɪlɪndər/; [n]圆柱体,圆筒;汽缸,泵(或桶)体; [or]gmat;
cynical: [a]/ˈsɪnɪkl/; [adj]愤世嫉俗的;恶意的;悲观的; [or]gmat;
cytology: [a]/saɪˈtɑːlədʒi/; [n]细胞学; [or]gmat;
darn: [a]/dɑːrn/; [v]缝补; [adj]可恶的;完全的; [adv]极其; [int]可恶; [n]补丁;织补之处; [or]gmat;
daylight saving time: [a]/ˌdeɪlaɪt ˈseɪvɪŋ taɪm/; [phr]夏时制; [or]gmat;
debase: [a]/dɪˈbeɪs/; [v]贬值,降低; [or]gmat;
debate: [a]/dɪˈbeɪt/; [n]辩论;讨论; [v]辩论;争论;议论; [or]gmat;
debilitate: [a]/dɪˈbɪlɪteɪt/; [v]使衰弱; [or]gmat;
debris: [a]/dəˈbriː/; [n]废墟,残骸; [or]gmat;
debunk: [a]/ˌdiːˈbʌŋk/; [v]揭穿真面目,证明为假; [or]gmat;
debut: [a]/deɪˈbjuː/; [n]初次登台,在社交场合的初次露脸; [v]初次露面,初次表演;首次推出; [adj]首张的,首场的,首次的; [or]gmat;
decade: [a]/ˈdekeɪd/; [n]十年,十年间; [or]gmat;
decay: [a]/dɪˈkeɪ/; [v]腐烂;衰退;腐朽; [n]腐烂;衰退;腐败; [or]gmat;
decent: [a]/ˈdiːsnt/; [adj]体面的;像样的;合宜的;正直的; [or]gmat;
decimal: [a]/ˈdesɪml/; [n]小数; [adj]小数的;十进制的; [or]gmat;
decimate: [a]/ˈdesɪmeɪt/; [v]大量杀死,十中抽一,大量毁灭; [or]gmat;
decipher: [a]/dɪˈsaɪfər/; [n]密电译文; [vt]解释;破译; [or]gmat;
decorate: [a]/ˈdekəreɪt/; [v]装饰,布置;把(勋章)授给(某人); [or]gmat;
decorous: [a]/ˈdekərəs/; [adj]端庄稳重的,正派得体的,有礼貌的,高雅的; [or]gmat;
decrease: [a]/dɪˈkriːs/; [v]减少;减; [n]减;减少; [or]gmat;
deduce: [a]/dɪˈduːs/; [v]演绎;推论,推断; [or]gmat;
deduct: [a]/dɪˈdʌkt/; [v]减去; [or]gmat;
deem: [a]/diːm/; [v]认为,视为;知道,相信; [or]gmat;
default: [a]/dɪˈfɔːlt/; [n]违约;缺席;缺乏;默认; [vi]不履行义务;拖欠; [vt]不履行;不参加; [or]gmat;
defendant: [a]/dɪˈfendənt/; [n]被告; [or]gmat;
deferential: [a]/ˌdefəˈrenʃl/; [adj]恭敬的; [or]gmat;
deficit: [a]/ˈdefɪsɪt/; [n]亏损;赤字;不足额; [or]gmat;
definitive: [a]/dɪˈfɪnətɪv/; [adj]可靠的,明确的,权威的;决定性的; [or]gmat;
deflect: [a]/dɪˈflekt/; [v](使)偏斜,(使)偏转; [or]gmat;
deform: [a]/dɪˈfɔːrm/; [v](使)变形; [adj]畸形的;丑陋的; [or]gmat;
defrost: [a]/ˌdiːˈfrɔːst/; [v]除霜,解冻; [or]gmat;
deft: [a]/deft/; [adj]灵巧的,敏捷的,熟练的; [or]gmat;
degenerate: [a]/dɪˈdʒenəreɪt/; [v]堕落,衰减; [adj]腐化的,颓废的,退化的;变质的; [n]堕落者; [or]gmat;
degrade: [a]/dɪˈɡreɪd/; [v]贬低;降低品格(身价,价值等);分解;降低; [or]gmat;
dehydrate: [a]/diːˈhaɪdreɪt/; [v]除去水份,脱水; [or]gmat;
deleterious: [a]/ˌdeləˈtɪriəs/; [adj]有害的;有毒的; [or]gmat;
deliberate: [a]/dɪˈlɪbərət/; [adj]故意的;深思熟虑的;从容不迫的; [v]仔细考虑;研讨; [or]gmat;
delicate: [a]/ˈdelɪkət/; [adj]易碎的,易坏的,脆弱的;(人)娇弱的,体弱多病的;精美的,精致的,精巧的;微妙的,需要谨慎处理的;优美的,优雅的;柔和的,清淡的,淡雅的; [or]gmat;
delineate: [a]/dɪˈlɪnieɪt/; [v]描画;画出..轮廓; [or]gmat;
delinquency: [a]/dɪˈlɪŋkwənsi/; [n]失职,玩忽职守,拖欠债务,缺点,过错;<法律>少年犯罪,不法行为(青少年),行为不当; [or]gmat;
delinquent: [a]/dɪˈlɪŋkwənt/; [n]少年罪犯,违犯者; [adj]不尽责的;怠工的;〈美〉拖欠(税款)的; [or]gmat;
delta: [a]/ˈdeltə/; [n](河流的)三角洲; [or]gmat;
deluge: [a]/ˈdeljuːdʒ/; [n]洪水;暴雨;泛滥; [v]使泛滥;压倒; [or]gmat;
delusion: [a]/dɪˈluːʒn/; [n]错觉; [or]gmat;
deluxe: [a]/dɪˈlʌks/; [adj]豪华的,华丽的; [or]gmat;
delve: [a]/delv/; [v]钻研;探究;挖; [n]穴;洞; [or]gmat;
demise: [a]/dɪˈmaɪz/; [n]死亡,终结; [or]gmat;
democrat: [a]/ˈdeməkræt/; [n]民主党人,民主主义者; [or]gmat;
demographic: [a]/ˌdeməˈɡræfɪk/; [adj]人口统计学的;人口学的; [or]gmat;
demolition: [a]/ˌdeməˈlɪʃn/; [n]拆除(等于demolishment);破坏,毁坏; [or]gmat;
demonstrate: [a]/ˈdemənstreɪt/; [vt](用实例,实验)论证;演示,展示;示范; [vi]示威; [or]gmat;
demur: [a]/dɪˈmɜːr/; [n]异议; [v]异议,反对,拒绝; [or]gmat;
denigrate: [a]/ˈdenɪɡreɪt/; [v]抹黑,贬低; [or]gmat;
denominator: [a]/dɪˈnɑːmɪneɪtər/; [n]<数>分母; [or]gmat;
denote: [a]/dɪˈnoʊt/; [v]是.的标志;指出; [vt]指示;代表(或表示); [or]gmat;
denouement: [a]/ˌdeɪnuːˈmɑ̃ː/; [n]结局,终场; [or]gmat;
dense: [a]/dens/; [adj](物质) 密度大的;稠密的,浓密的;愚钝的;难懂的,费解的; [or]gmat;
dentition: [a]/denˈtɪʃn/; [n]长牙齿,牙列; [or]gmat;
depart: [a]/dɪˈpɑːrt/; [v]离开;起程;出发;起程;出发;离职; [or]gmat;
depict: [a]/dɪˈpɪkt/; [v]描绘,描写; [or]gmat;
deplete: [a]/dɪˈpliːt/; [v]使大大减少;耗尽,用尽; [or]gmat;
depletion: [a]/dɪˈpliːʃn/; [n]消耗,损耗,放血; [or]gmat;
deploy: [a]/dɪˈplɔɪ/; [v]部署,设置;展开,散开; [or]gmat;
deposit: [a]/dɪˈpɑːzɪt/; [v]存款,存放;沉淀; [n]存款,定金;沉积物,矿床; [or]gmat;
deprecate: [a]/ˈdeprəkeɪt/; [v]反对;轻视; [or]gmat;
depreciation: [a]/dɪˌpriːʃiˈeɪʃn/; [n](货币的)贬值;减价;折旧;蔑视; [or]gmat;
depress: [a]/dɪˈpres/; [vt]使沮丧;使萧条;压下,压低; [or]gmat;
depression: [a]/dɪˈpreʃn/; [n]抑郁,沮丧;不景气,萧条(期);洼地,凹陷; [or]gmat;
deprivation: [a]/ˌdeprɪˈveɪʃn/; [n]剥夺;免职;匮乏;丧失;损失;免职; [or]gmat;
deride: [a]/dɪˈraɪd/; [v]嘲弄,愚弄; [or]gmat;
derision: [a]/dɪˈrɪʒn/; [n]嘲笑,嘲笑的目标,笑柄; [or]gmat;
derivative: [a]/dɪˈrɪvətɪv/; [n]派生物;<化学>衍生物; [adj]被引申出的,被诱导的;衍生的;第二手的; [or]gmat;
derive: [a]/dɪˈraɪv/; [v]获取;得自;起源; [or]gmat;
derogatory: [a]/dɪˈrɑːɡətɔːri/; [adj]不敬的,诽谤的; [or]gmat;
descend: [a]/dɪˈsend/; [vi]走下;降临; [v]下降,下来;突然访问;下移,下降; [or]gmat;
description: [a]/dɪˈskrɪpʃn/; [n]描写,形容,叙述;种类,类型; [or]gmat;
desegregation: [a]/ˌdiːˌseɡrɪˈɡeɪʃn/; [n]取消种族隔离; [or]gmat;
deserve: [a]/dɪˈzɜːrv/; [v]值得,应得;应受; [or]gmat;
designate: [a]/ˈdezɪɡneɪt/; [adj]已受委派而尚未上任的; [v]标出,说出;委任,任命,提名;指定; [or]gmat;
desire: [a]/dɪˈzaɪər/; [n]渴望;欲望;愿望;要求; [vi]有希望,期望,愿望; [vt]希望,渴望;请求,要求; [or]gmat;
desktop: [a]/ˈdesktɑːp/; [n]桌面;台式机; [adj]台式的;桌上用的; [or]gmat;
despise: [a]/dɪˈspaɪz/; [vt]轻视,蔑视,看不起; [or]gmat;
detach: [a]/dɪˈtætʃ/; [v]使分开,拆卸;派遣; [or]gmat;
detached: [a]/dɪˈtætʃt/; [adj]孤立的,分开的,超然公平的; [or]gmat;
detection: [a]/dɪˈtekʃn/; [n]察觉;侦察;检测,检验; [or]gmat;
deter: [a]/dɪˈtɜːr/; [v]防止,阻止,使踌躇; [or]gmat;
detergent: [a]/dɪˈtɜːrdʒənt/; [n]洗涤剂,清洁剂; [or]gmat;
deteriorate: [a]/dɪˈtɪriəreɪt/; [v]恶化;变质;衰退; [or]gmat;
deterioration: [a]/dɪˌtɪriəˈreɪʃn/; [n]变坏,退化,恶化;堕落; [or]gmat;
deterrent: [a]/dɪˈtɜːrənt/; [n]威慑物; [v]威慑的; [or]gmat;
detractor: [a]/dɪˈtræktər/; [n](批评者)诽谤者,恶意批评者; [or]gmat;
detrimental: [a]/ˌdetrɪˈmentl/; [adj]有害的,不利的; [or]gmat;
devastate: [a]/ˈdevəsteɪt/; [v]摧毁;使垮掉,使不知所措,使陷于混乱; [or]gmat;
devise: [a]/dɪˈvaɪz/; [v]设计,想出;密谋;遗赠(不动产); [n]设计,发明,遗赠; [or]gmat;
devoid: [a]/dɪˈvɔɪd/; [adj]全无的,缺乏的; [or]gmat;
dexterity: [a]/dekˈsterəti/; [n]纯熟;灵巧; [or]gmat;
diabetes: [a]/ˌdaɪəˈbiːtiːz/; [n]糖尿病,多尿症; [or]gmat;
diagnose: [a]/ˌdaɪəɡˈnoʊs/; [v]诊断(疾病),对(病人)下诊断结论; [or]gmat;
diagonal: [a]/daɪˈæɡənl/; [n]对角线; [adj]对角线的;斜的;斜纹的; [or]gmat;
dialect: [a]/ˈdaɪəlekt/; [n]方言;语调; [adj]方言的; [or]gmat;
diameter: [a]/daɪˈæmɪtər/; [n]直径; [or]gmat;
diaper: [a]/ˈdaɪpər/; [n]尿布; [or]gmat;
dichotomy: [a]/daɪˈkɑːtəmi/; [n]二分,本质对立; [or]gmat;
dictate: [a]/ˈdɪkteɪt/; [v]规定;命令;口授;听写; [n]命令;指令; [or]gmat;
didactic: [a]/daɪˈdæktɪk/; [adj]说教的;教诲的; [or]gmat;
die out: [a]/daɪ aʊt/; [phr]灭绝,绝种; [or]gmat;
diesel: [a]/ˈdiːzl/; [n]内燃机,柴油机; [or]gmat;
dietary: [a]/ˈdaɪəteri/; [adj]饮食的,与饮食有关的; [or]gmat;
differentiate: [a]/ˌdɪfəˈrenʃieɪt/; [v]使有差异;区别; [or]gmat;
digest: [a]/daɪˈdʒest/; [v]消化;领会,理解; [n]摘要; [or]gmat;
digit: [a]/ˈdɪdʒɪt/; [n]阿拉伯数字,手指,足趾,一指之宽; [or]gmat;
dilemma: [a]/dɪˈlemə/; [n]进退两难的窘境; [or]gmat;
dilute: [a]/daɪˈluːt/; [v]使变淡,稀释;使病弱; [or]gmat;
dilution: [a]/daɪˈluːʃn/; [n]稀释;冲淡;稀释法; [or]gmat;
dimension: [a]/dɪˈmenʃn/; [n]维度;尺寸;尺度;方面; [or]gmat;
diminish: [a]/dɪˈmɪnɪʃ/; [v]减少;失势,削弱.的权势, 减弱.的权势; [or]gmat;
dine: [a]/daɪn/; [v]吃饭,用餐;招待..吃饭;用正餐(晚餐); [or]gmat;
dinosaur: [a]/ˈdaɪnəsɔːr/; [n]恐龙; [or]gmat;
dioxide: [a]/daɪˈɑːksaɪd/; [n]二氧化物; [or]gmat;
dip: [a]/dɪp/; [v]浸,蘸; [n]倾斜,下降;调味汁; [or]gmat;
diphtheria: [a]/dɪfˈθɪriə/; [n]［医］白喉［症］; [or]gmat;
diploma: [a]/dɪˈploʊmə/; [n]毕业文凭,毕业证书;文凭课程; [or]gmat;
diplomatic: [a]/ˌdɪpləˈmætɪk/; [adj]外交的,从事外交的;老练的,圆滑的; [or]gmat;
dire: [a]/ˈdaɪər/; [adj]可怕的;悲惨的;极端的; [or]gmat;
directive: [a]/dəˈrektɪv/; [n]指示,指令; [adj]指导的,管理的;方向的; [or]gmat;
disarm: [a]/dɪsˈɑːrm/; [vt]放下武器;使人消除敌意; [vi]解除武装; [or]gmat;
disaster: [a]/dɪˈzæstər/; [n]灾难,天灾; [or]gmat;
disavow: [a]/ˌdɪsəˈvaʊ/; [v]不承认,抵赖,拒绝对..承担责任; [or]gmat;
discard: [a]/dɪsˈkɑːrd/; [v]丢弃;抛弃;遗弃; [or]gmat;
discern: [a]/dɪˈsɜːrn/; [v]辨别;识别;看出; [or]gmat;
discharge: [a]/dɪsˈtʃɑːrdʒ/; [n]发射;释放;解雇;放电; [v]卸掉负担;发射;放电;卸(货);使爆炸;履行;解雇;允许.离开;排出,放出;清偿(债务); [or]gmat;
disciple: [a]/dɪˈsaɪpl/; [n]信徒,门徒;耶稣的信徒(或门徒,使徒); [or]gmat;
discipline: [a]/ˈdɪsəplɪn/; [n]纪律;学科;训练; [v]训练;惩罚;管制; [or]gmat;
discord: [a]/ˈdɪskɔːrd/; [n]不和,争吵;(声音)不和谐; [or]gmat;
discount: [a]/ˈdɪskaʊnt/; [n](价格,债款等)折扣; [v]打折扣,不全信,怀疑地看待; [or]gmat;
discourse: [a]/ˈdɪskɔːrs/; [n]交谈,演讲,论述,讲道; [v]演讲,谈论; [or]gmat;
discrepancy: [a]/dɪsˈkrepənsi/; [n]不一致,差异,不符; [or]gmat;
discrete: [a]/dɪˈskriːt/; [adj]分开的;不连续的; [or]gmat;
discretionary: [a]/dɪˈskreʃəneri/; [adj]分立的,自理自由的;任意的; [or]gmat;
discriminate: [a]/dɪˈskrɪmɪneɪt/; [v]区别,辨别;歧视; [or]gmat;
discrimination: [a]/dɪˌskrɪmɪˈneɪʃn/; [n]歧视,偏见; [or]gmat;
disguise: [a]/dɪsˈɡaɪz/; [v]伪装;掩饰; [n]伪装物;伪装; [or]gmat;
disinclination: [a]/ˌdɪsˌɪnklɪˈneɪʃn/; [n]不感兴趣,厌恶; [or]gmat;
dislocation: [a]/ˌdɪsloʊˈkeɪʃn/; [n]转位,混乱,<医>脱臼; [or]gmat;
dislodge: [a]/dɪsˈlɑːdʒ/; [v]驱逐;移去;取出; [or]gmat;
dismal: [a]/ˈdɪzməl/; [n]低落的情绪; [adj]惨淡的;沉闷的,凄凉的; [or]gmat;
dismantle: [a]/dɪsˈmæntl/; [v]拆开;拆除; [or]gmat;
dismay: [a]/dɪsˈmeɪ/; [n]失望;沮丧;惊愕; [v]使惊恐; [or]gmat;
dismember: [a]/dɪsˈmembər/; [v]肢解;瓜分; [or]gmat;
disorder: [a]/dɪsˈɔːrdər/; [n]混乱;紊乱;动乱; [vt]使混乱;使紊乱; [or]gmat;
disorient: [a]/dɪs'ɔːrient/; [v]使迷失方位,使迷惑; [or]gmat;
disparate: [a]/ˈdɪspərət/; [adj]迥然不同的; [or]gmat;
disparity: [a]/dɪˈspærəti/; [n]不同,不一致,不等; [or]gmat;
dispassionate: [a]/dɪsˈpæʃənət/; [adj]平心静气的,不带感情的; [or]gmat;
dispel: [a]/dɪˈspel/; [v]驱散,驱逐;消除(烦恼等); [or]gmat;
dispense: [a]/dɪˈspens/; [v]分发,分配,免除,执行; [or]gmat;
disperse: [a]/dɪˈspɜːrs/; [v]使散开;分散,散开; [or]gmat;
displace: [a]/dɪsˈpleɪs/; [v]取代,替代,迫使(某人)离开家园,使离开原位; [or]gmat;
dispose: [a]/dɪˈspoʊz/; [v]处理,处置,除去;使愿意; [or]gmat;
disproportionate: [a]/ˌdɪsprəˈpɔːrʃənət/; [adj]不成比例的; [or]gmat;
disrupt: [a]/dɪsˈrʌpt/; [v]扰乱; [or]gmat;
disseminate: [a]/dɪˈsemɪneɪt/; [v]宣传,传播;散布; [or]gmat;
dissent: [a]/dɪˈsent/; [v]不同意;不信奉国教; [n]异议;(大写)不信奉国教; [or]gmat;
dissenter: [a]/dɪˈsentər/; [n]持异议者;反对者; [or]gmat;
dissipate: [a]/ˈdɪsɪpeɪt/; [v]消散,消失;浪费; [or]gmat;
distill: [a]/dɪˈstɪl/; [v]抽出..的精华;蒸馏; [or]gmat;
distinct: [a]/dɪˈstɪŋkt/; [adj]截然不同的;独特的;明显的;清晰的; [or]gmat;
distinguish: [a]/dɪˈstɪŋɡwɪʃ/; [v]区别,识别,辨别,使显著; [or]gmat;
distort: [a]/dɪˈstɔːrt/; [v]扭曲,使变形;歪曲,曲解; [or]gmat;
distraction: [a]/dɪˈstrækʃn/; [n]分心,分神;分心的事物;消遣,娱乐; [or]gmat;
distribute: [a]/dɪˈstrɪbjuːt/; [v]分发,分配,配送;散布; [or]gmat;
distribution: [a]/ˌdɪstrɪˈbjuːʃn/; [n]分布;分配;分发;散布; [or]gmat;
district: [a]/ˈdɪstrɪkt/; [n]地区;区域; [vt]把..划分成区; [or]gmat;
disturb: [a]/dɪˈstɜːrb/; [v]打扰,妨碍;弄乱;使烦恼; [or]gmat;
diva: [a]/ˈdiːvə/; [n]著名女歌唱家,歌剧女主角; [or]gmat;
diverge: [a]/daɪˈvɜːrdʒ/; [v]分歧,分开; [or]gmat;
divergence: [a]/daɪˈvɜːrdʒəns/; [n]分歧;背离; [or]gmat;
divergent: [a]/daɪˈvɜːrdʒənt/; [adj]叉开的;分歧的; [or]gmat;
diverse: [a]/daɪˈvɜːrs/; [adj]不同的,差异的,多种多样的; [or]gmat;
divest: [a]/daɪˈvest/; [v]剥夺;使脱去;迫使放弃; [or]gmat;
dividend: [a]/ˈdɪvɪdend/; [n](股份的)红利,回报,效益,被除数; [or]gmat;
divine: [a]/dɪˈvaɪn/; [adj]神的,神圣的;极好的; [v](凭直觉)发现,猜到; [n]神学家;圣职人员;教士;上帝; [or]gmat;
division: [a]/dɪˈvɪʒn/; [n]分,分配,除法,部门,分裂; [or]gmat;
divisive: [a]/dɪˈvaɪsɪv/; [adj]分裂的;区分的;造成不和的; [or]gmat;
divulge: [a]/daɪˈvʌldʒ/; [v]泄露,透露; [or]gmat;
docile: [a]/ˈdɑːsl/; [adj]驯服的,温顺的; [or]gmat;
doctorate: [a]/ˈdɑːktərət/; [n]博士头衔; [or]gmat;
doctrine: [a]/ˈdɑːktrɪn/; [n]教条,学说,信条,原则; [or]gmat;
dogma: [a]/ˈdɔːɡmə/; [n]教条;武断的意见; [adj]教义的,教条的,信条的; [or]gmat;
dogwood: [a]/ˈdɔːɡwʊd/; [n]木属植物,山茱萸; [adj]山茱萸科植物的,淡黄褐色的; [or]gmat;
domain: [a]/doʊˈmeɪn/; [n]域名;领土;管区,势力圈; [or]gmat;
domestic: [a]/dəˈmestɪk/; [adj]国产的;国内的;家庭的;驯养的; [n]家仆;家庭纷争; [or]gmat;
domesticate: [a]/dəˈmestɪkeɪt/; [vt]使习惯于家庭生活;驯养;引进; [or]gmat;
dominate: [a]/ˈdɑːmɪneɪt/; [v]在.中占首要地位;支配,统治,控制;耸立于,俯视;处于支配地位,拥有优势; [or]gmat;
donate: [a]/ˈdoʊneɪt/; [v]捐献;捐赠; [vi]捐献;捐赠; [or]gmat;
donor: [a]/ˈdoʊnər/; [n]捐献者; [or]gmat;
doom: [a]/duːm/; [v]注定;命定; [n]毁灭;厄运;劫数; [or]gmat;
dopamine: [a]/ˈdoʊpəmiːn/; [n]［生化］多巴胺; [or]gmat;
dope: [a]/doʊp/; [n]毒品;粘稠物,胶状物,添加剂;傻瓜,蠢货;内幕消息; [v]给.服用麻醉剂; [adj]<俚>极好的; [or]gmat;
dormant: [a]/ˈdɔːrmənt/; [adj]睡眠的,休眠的;静止的,隐伏的; [or]gmat;
dose: [a]/doʊs/; [n](药)剂量,用量,一剂; [vt]给..服药; [or]gmat;
doubtless: [a]/ˈdaʊtləs/; [adv]无疑地;肯定地; [adj]无疑的;肯定的; [or]gmat;
drab: [a]/dræb/; [adj]枯黄色的,无聊的,单调的; [n]单调;淡褐色;[印,纺]淡褐色厚呢;邋遢女人; [or]gmat;
drain: [a]/dreɪn/; [vi]排出,排水; [v]流干,沥干;喝光,耗尽,减少,消逝; [vt]使流出,排掉水; [n]下水道,排水管;消耗,排水; [or]gmat;
drastic: [a]/ˈdræstɪk/; [adj]极端的;猛烈的;激烈的; [or]gmat;
drizzle: [a]/ˈdrɪzl/; [v]下毛毛雨; [n]细雨,毛毛雨; [or]gmat;
dubious: [a]/ˈduːbiəs/; [adj]可疑的;怀疑的;无把握的; [or]gmat;
ductile: [a]/ˈdʌktaɪl/; [adj](某些金属)有延展性的;可塑的;易受影响的; [or]gmat;
dummy: [a]/ˈdʌmi/; [n]哑巴,笨蛋,傀儡,人形靶; [adj]虚拟的,假的; [or]gmat;
dump: [a]/dʌmp/; [v]倾倒,丢弃;抛弃(某人); [n]垃圾场,废物堆;军需品临时堆放的地方; [or]gmat;
duplicate: [a]/ˈduːplɪkeɪt/; [n]复制品; [v]复制;重复; [adj]完全一样的; [or]gmat;
dwelling: [a]/ˈdwelɪŋ/; [n]住所; [or]gmat;
dwindle: [a]/ˈdwɪndl/; [v]日渐减少,变小,缩小; [or]gmat;
dynamics: [a]/daɪ'næmɪks/; [n]动力学;力学; [or]gmat;
dysfunction: [a]/dɪsˈfʌŋkʃn/; [n]功能紊乱,机能障碍,官能不良; [v]功能失调,出现机能障碍,垮掉; [or]gmat;
echelon: [a]/ˈeʃəlɑːn/; [n]等级,阶层,梯形,梯次编队; [vi]形成梯队; [vt]排成梯队; [or]gmat;
ecology: [a]/iˈkɑːlədʒi/; [n]生态,生态学; [or]gmat;
economic: [a]/ˌekəˈnɑːmɪk/; [adj]经济上的,经济学的;合算的;有利可图的; [or]gmat;
economical: [a]/ˌekəˈnɑːmɪkl/; [adj]节约的;经济的;合算的; [or]gmat;
economy: [a]/ɪˈkɑːnəmi/; [n]经济,经济制度;节约; [or]gmat;
ecosystem: [a]/ˈiːkoʊsɪstəm/; [n]生态系统; [or]gmat;
edge: [a]/edʒ/; [n](悬崖,峭壁的)边缘;边缘;锋利,尖锐;刀口,刃;优势; [v]徐徐移动;给.开刃,使锐利; [or]gmat;
effigy: [a]/ˈefɪdʒi/; [n]肖像,模拟像; [or]gmat;
effluent: [a]/ˈefluənt/; [n]污水; [adj]流出的; [or]gmat;
eggnog: [a]/ˈeɡnɑːɡ/; [n]蛋奶酒; [or]gmat;
egregious: [a]/ɪˈɡriːdʒiəs/; [adj]非常恶劣的,过分的;恶名昭彰的;惊人的; [or]gmat;
elaborate: [a]/ɪˈlæbəreɪt/; [adj]精心设计的,精巧的;复杂的; [v]详细说明,详尽阐述; [vt]变得复杂; [or]gmat;
elective: [a]/ɪˈlektɪv/; [adj]选修的,选举的,选任的; [n]选修课程; [or]gmat;
electorate: [a]/ɪˈlektərət/; [n]选民;选区; [or]gmat;
electromagnetic: [a]/ɪˌlektroʊmæɡˈnetɪk/; [adj]电磁的; [or]gmat;
electron: [a]/ɪˈlektrɑːn/; [n]电子; [or]gmat;
elevate: [a]/ˈelɪveɪt/; [v]上升;提高;举起;提拔; [or]gmat;
elicit: [a]/iˈlɪsɪt/; [v]引出;诱出;探出; [or]gmat;
eligible: [a]/ˈelɪdʒəbl/; [adj]适合被选的,符合条件的;(尤指婚姻等)合适的,合意的; [or]gmat;
eliminate: [a]/ɪˈlɪmɪneɪt/; [v]消灭,铲除;消除,根除;(在比赛中)淘汰; [or]gmat;
elite: [a]/ɪˈliːt/; [n]精英; [adj]高级的; [or]gmat;
elliptical: [a]/ɪˈlɪptɪkl/; [adj]椭圆的;省略的; [or]gmat;
elongate: [a]/ɪˈlɔːŋɡeɪt/; [v]延长,伸长; [adj]延长了的;细长的; [or]gmat;
elongation: [a]/ˌiːlɔːŋˈɡeɪʃn/; [n]伸长,伸长率,延伸率; [or]gmat;
eloquent: [a]/ˈeləkwənt/; [adj]有口才的;雄辩的;演说动人的; [or]gmat;
elude: [a]/iˈluːd/; [v]逃避,躲避;使.错过,使.找不到;使.不记得;把.难住; [or]gmat;
elusive: [a]/iˈluːsɪv/; [adj]难懂的;难捉摸的;难找的;难懂的;易忘的;逃避的;难捉摸的; [or]gmat;
emanate: [a]/ˈeməneɪt/; [v]发出;放射; [or]gmat;
emancipation: [a]/ɪˌmænsɪˈpeɪʃn/; [n]释放;解放; [or]gmat;
embalm: [a]/ɪmˈbɑːm/; [v]以香油(或药料)涂,防腐,使不朽; [or]gmat;
embargo: [a]/ɪmˈbɑːrɡoʊ/; [v]禁止出入港口;禁止或限制贸易;征用或扣押; [n]禁令;禁止;封港令; [or]gmat;
embark: [a]/ɪmˈbɑːrk/; [v]上船或飞机;开始,着手,从事; [or]gmat;
embellish: [a]/ɪmˈbelɪʃ/; [vt]装饰; [v]吹嘘;润色(文章); [vi]装饰起来;加以润色;添加细节,对...添枝加叶; [or]gmat;
embody: [a]/ɪmˈbɑːdi/; [v]包含;体现,象征; [or]gmat;
embrace: [a]/ɪmˈbreɪs/; [v]拥抱;包含;欣然接受,乐意采纳; [n]拥抱;接受;领会; [or]gmat;
embroider: [a]/ɪmˈbrɔɪdər/; [v]刺绣,绣花;润色,渲染; [or]gmat;
embryo: [a]/ˈembrioʊ/; [n]<动物学>胚胎; [or]gmat;
emerald: [a]/ˈemərəld/; [n]祖母绿,翡翠; [adj]翠绿色的; [or]gmat;
emergency: [a]/iˈmɜːrdʒənsi/; [n]紧急情况;突发事件; [or]gmat;
eminent: [a]/ˈemɪnənt/; [adj]显赫的;杰出的;有名的;(品质)优良的; [or]gmat;
emission: [a]/iˈmɪʃn/; [n]排放物;放射物; [or]gmat;
emulate: [a]/ˈemjuleɪt/; [v]努力赶上(超过),仿效; [n]仿真; [or]gmat;
enact: [a]/ɪˈnækt/; [v]颁布;制定法律;扮演; [or]gmat;
encapsulate: [a]/ɪnˈkæpsjuleɪt/; [v]装入胶囊,压缩;概述; [or]gmat;
encephalitis: [a]/enˌsefəˈlaɪtəs/; [n]<内科>脑炎; [or]gmat;
enclose: [a]/ɪnˈkloʊz/; [v]围住;圈起;装入信封;附有; [or]gmat;
encode: [a]/ɪnˈkoʊd/; [v]把(电文等)译成电码(或密码),编码; [or]gmat;
encompass: [a]/ɪnˈkʌmpəs/; [vt]环绕,包围;包含;完成; [or]gmat;
encounter: [a]/ɪnˈkaʊntər/; [v]邂逅,遭遇,偶遇; [n]偶然碰见,遭遇; [or]gmat;
encroach: [a]/ɪnˈkroʊtʃ/; [v]侵犯,侵占;蚕食(on); [or]gmat;
encyclopedia: [a]/ɪnˌsaɪkləˈpiːdiə/; [n]百科全书; [or]gmat;
endanger: [a]/ɪnˈdeɪndʒər/; [v]危及,危害; [or]gmat;
endeavor: [a]/ɪnˈdevər/; [n]尝试,努力,尽力; [v]努力,尽力; [or]gmat;
endemic: [a]/enˈdemɪk/; [adj]地方性的; [n]地方病; [or]gmat;
endorse: [a]/ɪnˈdɔːrs/; [v]赞同,认可;签注(文件); [or]gmat;
endorsement: [a]/ɪnˈdɔːrsmənt/; [n]认可,支持;背书;签注(文件); [or]gmat;
endowment: [a]/ɪnˈdaʊmənt/; [n]捐赠,捐助,捐款;(人的)天赋,天资; [or]gmat;
enervation: [a]/ˌenərˈveɪʃn/; [n]虚弱,无力; [or]gmat;
enforce: [a]/ɪnˈfɔːrs/; [v]实施;执行;强制; [or]gmat;
engage: [a]/ɪnˈɡeɪdʒ/; [vt]吸引住(注意力,兴趣);雇,聘; [vi]使加入,使融入;订婚; [v](军队)交战;啮合; [or]gmat;
engender: [a]/ɪnˈdʒendər/; [v]产生; [or]gmat;
engrave: [a]/ɪnˈɡreɪv/; [v]雕刻;铭记; [or]gmat;
engulf: [a]/ɪnˈɡʌlf/; [v]吞噬,吞没,狼吞虎咽; [or]gmat;
enhance: [a]/ɪnˈhæns/; [v]提高(强度,力量,数量等);增加,加强; [or]gmat;
enlist: [a]/ɪnˈlɪst/; [v]得到.的赞助或帮助,应募,招募,参加,加入; [or]gmat;
enormous: [a]/ɪˈnɔːrməs/; [adj]极大的,极大量的;巨大的;庞大的; [or]gmat;
enrich: [a]/ɪnˈrɪtʃ/; [v]使丰富;使富裕; [or]gmat;
enroll: [a]/ɪnˈroʊl/; [v]入学,加入,登记,入伍; [or]gmat;
ensemble: [a]/ɑːnˈsɑːmbl/; [n]合唱团,表演团体;总效果;全套服装;全套家具; [or]gmat;
ensue: [a]/ɪnˈsuː/; [v]跟着发生,接踵而来;因而产生; [or]gmat;
enterprise: [a]/ˈentərpraɪz/; [n]企业(或事业)单位,公司;事业;事业心; [or]gmat;
entertainment: [a]/ˌentərˈteɪnmənt/; [n]娱乐;招待,款待; [or]gmat;
enthusiastically: [a]/ɪnˌθuːziˈæstɪkli/; [adv]热心地;满腔热情地; [or]gmat;
entice: [a]/ɪnˈtaɪs/; [v]怂恿,引诱; [or]gmat;
entitle: [a]/ɪnˈtaɪtl/; [v]给(书)题名;给予.权利; [or]gmat;
entrant: [a]/ˈentrənt/; [n]进入者,新成员,参加竞赛者; [or]gmat;
entree: [a]/ˈɑːntreɪ/; [n]进入,入场权,［美］主菜,(歌剧等)开始的乐章; [or]gmat;
entrepreneur: [a]/ˌɑːntrəprəˈnɜːr/; [n]企业家,演出承包人; [or]gmat;
entry: [a]/ˈentri/; [n]入口处;登记;进入; [or]gmat;
enumerate: [a]/ɪˈnuːməreɪt/; [v]列举; [or]gmat;
enumeration: [a]/ɪˌnuːməˈreɪʃn/; [n]列举; [or]gmat;
envelop: [a]/ɪnˈveləp/; [v]包围,包上; [n]信封(同"envelope"); [or]gmat;
envelope: [a]/ˈenvəloʊp/; [n]信封;包装物,外壳,膜;气囊; [or]gmat;
envious: [a]/ˈenviəs/; [adj]羡慕的,嫉妒的; [or]gmat;
envision: [a]/ɪnˈvɪʒn/; [v]预测,想象,展望; [or]gmat;
enzyme: [a]/ˈenzaɪm/; [n]<生化>酶; [or]gmat;
epic: [a]/ˈepɪk/; [adj]史诗的,叙事诗的;壮丽的,宏大的; [n]史诗;叙事诗;史诗般的作品; [or]gmat;
epicenter: [a]/'epɪˌsentə/; [n]震中,中心,集中点; [or]gmat;
epidemic: [a]/ˌepɪˈdemɪk/; [adj]流行性的,传染的; [n]流行病,传染病,(犯罪等的)盛行; [or]gmat;
episode: [a]/ˈepɪsoʊd/; [n]插曲,片断;连续剧的一集;一段经历; [or]gmat;
equilateral triangle: [a]/ˌiːkwɪˌlætərəl ˈtraɪæŋɡl/; [phr]等边三角形; [or]gmat;
equip: [a]/ɪˈkwɪp/; [v]装备;具备; [or]gmat;
equity: [a]/ˈekwəti/; [n]公平,公正;衡平法;普通股;抵押资产的净值; [or]gmat;
equivalent: [a]/ɪˈkwɪvələnt/; [adj]相等的;等值的; [n]同义词;等价物; [or]gmat;
era: [a]/ˈɪrə/; [n]时代,年代;纪元; [or]gmat;
eradicate: [a]/ɪˈrædɪkeɪt/; [v]根除;消灭; [or]gmat;
erase: [a]/ɪˈreɪs/; [v](计算机)擦除;抹去;擦掉; [or]gmat;
erode: [a]/ɪˈroʊd/; [v]腐蚀;遭侵蚀,腐蚀,侵蚀;削弱; [vt]损害; [or]gmat;
errand: [a]/ˈerənd/; [n]差使;差事;使命; [or]gmat;
erratic: [a]/ɪˈrætɪk/; [adj]古怪的;反复无常的,不稳定的; [or]gmat;
ersatz: [a]/ˈersɑːts/; [adj]代用的,人造的,合成的; [n]代用品,仿制品; [or]gmat;
erudition: [a]/ˌeruˈdɪʃn/; [n]博学,学识,学问; [or]gmat;
escalate: [a]/ˈeskəleɪt/; [v]逐步升高,逐步增强,加剧恶化; [or]gmat;
eschew: [a]/ɪsˈtʃuː/; [v]避开;戒绝; [or]gmat;
espionage: [a]/ˈespiənɑːʒ/; [n]间谍活动,侦查,监视; [or]gmat;
espouse: [a]/ɪˈspaʊz/; [v]支持,拥护; [or]gmat;
essence: [a]/ˈesns/; [n]本质,实质;精髓,精华; [or]gmat;
estate: [a]/ɪˈsteɪt/; [n]地产,(上有大片建筑物的)土地,住宅,财产,遗产; [or]gmat;
esteem: [a]/ɪˈstiːm/; [n]尊敬;尊重; [vt]尊敬;认为;考虑;估计; [or]gmat;
estimate: [a]/ˈestɪmət/; [v]估价,估计,评价; [n]估计,评价; [or]gmat;
estrange: [a]/ɪ'streɪndʒ/; [v]使疏远,离间; [or]gmat;
eternal: [a]/ɪˈtɜːrnl/; [adj]永恒的,永不改变的; [or]gmat;
ethnic: [a]/ˈeθnɪk/; [adj]种族的,少数民族的; [n]少数民族成员;人种学; [or]gmat;
ethnicity: [a]/eθˈnɪsəti/; [n]种族,种族地位,种族特点; [or]gmat;
ethnocentric: [a]/ˌeθnoʊˈsentrɪk/; [adj]种族中心主义的,种族(或民族)优越感的; [or]gmat;
etymology: [a]/ˌetɪˈmɑːlədʒi/; [n]语源,语源学; [or]gmat;
euphoria: [a]/juːˈfɔːriə/; [n]幸福愉快感; [or]gmat;
eusocial: [a]/juː'soʊʃəl/; [adj](昆虫)完全社会性的,完全群居的; [or]gmat;
evacuation: [a]/ɪˌvækjuˈeɪʃn/; [n]疏散,撤离,排泄; [or]gmat;
evade: [a]/ɪˈveɪd/; [v]躲避,回避; [or]gmat;
evaporate: [a]/ɪˈvæpəreɪt/; [v]蒸发,失去水分;消失; [or]gmat;
eventual: [a]/ɪˈventʃuəl/; [adj]最后的,终于的; [or]gmat;
evict: [a]/ɪˈvɪkt/; [v]驱逐,逐出; [or]gmat;
evident: [a]/ˈevɪdənt/; [adj]显然的,明显的,明白的; [or]gmat;
evil: [a]/ˈiːvl/; [adj]邪恶的,罪恶的; [n]邪恶,罪恶; [or]gmat;
evolve: [a]/iˈvɑːlv/; [v]使进化;使发展; [or]gmat;
exacerbate: [a]/ɪɡˈzæsərbeɪt/; [v]加重;恶化;激怒; [or]gmat;
exaggerate: [a]/ɪɡˈzædʒəreɪt/; [vi]夸张; [vt]夸大,夸张;使扩大; [or]gmat;
excavate: [a]/ˈekskəveɪt/; [v]挖掘,挖出;挖(空),挖(洞); [or]gmat;
exceedingly: [a]/ɪkˈsiːdɪŋli/; [adv]过分地;非常; [or]gmat;
exceptional: [a]/ɪkˈsepʃənl/; [adj]优越的,杰出的;异常的; [or]gmat;
excerpt: [a]/ˈeksɜːrpt/; [n]摘录,节选; [v]摘,选;引用; [or]gmat;
excessive: [a]/ɪkˈsesɪv/; [adj]过多的; [or]gmat;
excise: [a]/ˈeksaɪz/; [v]切除,删去; [n]消费税,货物税,国产税; [or]gmat;
exclude: [a]/ɪkˈskluːd/; [vt]不包括;排挤;排除;驱逐,赶出; [or]gmat;
exclusively: [a]/ɪkˈskluːsɪvli/; [adv]专门地;特定地;排外地;仅仅; [or]gmat;
excrete: [a]/ɪkˈskriːt/; [v]排泄,分泌; [or]gmat;
excursion: [a]/ɪkˈskɜːrʒn/; [n]远足;短途旅行; [or]gmat;
execute: [a]/ˈeksɪkjuːt/; [v]处决;完成(动作);实行;执行(计划); [or]gmat;
executioner: [a]/ˌeksɪˈkjuːʃənər/; [n]刽子手,死刑执行人; [or]gmat;
exemplary: [a]/ɪɡˈzempləri/; [adj]模范的,可仿效的; [or]gmat;
exemplify: [a]/ɪɡˈzemplɪfaɪ/; [v]举例说明;例示,是..的典范; [or]gmat;
exert: [a]/ɪɡˈzɜːrt/; [v]尽(力),运用,发挥; [or]gmat;
exhaust: [a]/ɪɡˈzɔːst/; [v]使筋疲力尽;耗尽;详尽论述; [n]排气装置;废气; [or]gmat;
exhaustive: [a]/ɪɡˈzɔːstɪv/; [adj]详尽的;彻底的;消耗的; [or]gmat;
exhort: [a]/ɪɡˈzɔːrt/; [vt]敦促,劝告; [vi]规劝,劝告; [or]gmat;
exigency: [a]/ˈeksɪdʒənsi/; [n]紧急(状态);危急(关头);事变; [or]gmat;
exile: [a]/ˈeksaɪl/; [n]流亡国外;流放,充军; [vt]使流亡,放逐;使离乡背井; [or]gmat;
exodus: [a]/ˈeksədəs/; [n]大批离去,成群外出; [or]gmat;
exonerate: [a]/ɪɡˈzɑːnəreɪt/; [v]使免罪; [or]gmat;
exotic: [a]/ɪɡˈzɑːtɪk/; [adj]奇异的,珍奇的,来自异国的; [or]gmat;
expatriate: [a]/ˌeksˈpeɪtriət/; [v](使)移居国外;(使)放弃国籍;流放,放逐; [n]被流放者;移居国外者; [adj]移居国外的;被流放的; [or]gmat;
expedient: [a]/ɪkˈspiːdiənt/; [n]权宜之计,手段; [adj]有利的,方便的;权宜之计的; [or]gmat;
expedite: [a]/ˈekspədaɪt/; [v]加快;促进;发出; [adj]畅通的;迅速的;方便的; [or]gmat;
expedition: [a]/ˌekspəˈdɪʃn/; [n]远征队;探险;短途旅行;迅速; [or]gmat;
expertise: [a]/ˌekspɜːrˈtiːz/; [n]专门知识,专门技能; [or]gmat;
expire: [a]/ɪkˈspaɪər/; [v]期满,(期限)终止;断气,死亡; [or]gmat;
explicit: [a]/ɪkˈsplɪsɪt/; [adj]充分表达清楚的,明确的;直率的,直截了当的;〔描绘性或暴力的语言或画面〕清晰露骨的; [or]gmat;
explode: [a]/ɪkˈsploʊd/; [v]爆炸;激增;爆发;使爆炸;驳倒; [or]gmat;
exploit: [a]/ɪkˈsplɔɪt/; [v]剥削,利用;开发,开拓; [n]辉煌功绩; [or]gmat;
explore: [a]/ɪkˈsplɔːr/; [v]探险,探索,尝试; [or]gmat;
export: [a]/ˈekspɔːrt/; [v]出口,输出; [n]输出,出口,输出品; [or]gmat;
expound: [a]/ɪkˈspaʊnd/; [v]详细说明,解释,阐述; [or]gmat;
expressly: [a]/ɪkˈspresli/; [adv]清楚地,明显地;特别地,专门地; [or]gmat;
expulsion: [a]/ɪkˈspʌlʃn/; [n]驱逐;开除; [or]gmat;
exquisite: [a]/ɪkˈskwɪzɪt/; [adj]精致的,精选的;细腻的;强烈的; [n]过分讲究穿戴的人; [or]gmat;
extend: [a]/ɪkˈstend/; [v]伸展,展开;延伸;涉及;扩展;提供;使.竭尽全力; [or]gmat;
exterior: [a]/ɪkˈstɪriər/; [n]外表;外貌,外观; [adj]外部的;外界的;位于外边的;外交上的; [or]gmat;
exterminate: [a]/ɪkˈstɜːrmɪneɪt/; [v]消灭,灭绝;根除; [or]gmat;
external: [a]/ɪkˈstɜːrnl/; [adj]外面的,外部的;外国的; [or]gmat;
extinct: [a]/ɪkˈstɪŋkt/; [adj]灭绝的;破灭了的,消亡了的; [or]gmat;
extinguish: [a]/ɪkˈstɪŋɡwɪʃ/; [v]熄灭,扑灭;根除,消灭; [or]gmat;
extract: [a]/ɪkˈstrækt/; [v]取出;提取;摘录;设法得到;索取; [n]摘录;提出物; [or]gmat;
extracurricular: [a]/ˌekstrəkə'rɪkjələ/; [adj]课外的,业余的,婚外的; [or]gmat;
extradite: [a]/ˈekstrədaɪt/; [v]引渡,获取.的引渡; [or]gmat;
extraterrestrial: [a]/ˌekstrətəˈrestriəl/; [adj]地球外的,地球大气圈外的; [n]外星人,外星生物,宇航员; [or]gmat;
extreme: [a]/ɪkˈstriːm/; [adj]极端的;极远的;极限的;极度的;偏激的; [n]极端;极度(状态),最大程度; [or]gmat;
extricate: [a]/ˈekstrɪkeɪt/; [v]拯救,救出; [n]解脱;解脱者; [or]gmat;
extrinsic: [a]/eksˈtrɪnzɪk/; [adj]外在的,外部的; [or]gmat;
fabric: [a]/ˈfæbrɪk/; [n]布料,织物;质地,结构; [or]gmat;
fabrication: [a]/ˌfæbrɪˈkeɪʃn/; [n]制作;构成;捏造;伪造物;装配工; [or]gmat;
facade: [a]/fəˈsɑːd/; [n]建筑物的正面,外表; [or]gmat;
facial: [a]/ˈfeɪʃl/; [n]面部按摩,美容; [adj]表面的,面部的; [or]gmat;
facilitate: [a]/fəˈsɪlɪteɪt/; [v]为他人提供方便;使便利; [vt]促进; [or]gmat;
faction: [a]/ˈfækʃn/; [n]派别,小集团,小派系;派系斗争,内讧; [or]gmat;
factor: [a]/ˈfæktər/; [n]因素;<数>因子,商; [or]gmat;
faculty: [a]/ˈfæklti/; [n]教职工,全体教员;系;科;能力; [or]gmat;
fad: [a]/fæd/; [n]风尚,风行一时的东西; [adj]极好的; [or]gmat;
fade: [a]/feɪd/; [vi]褪色,褪去;失去;逐渐消失; [vt]使褪色; [n]淡入,淡出; [adj]乏味的; [or]gmat;
faith: [a]/feɪθ/; [n]信任;信心;信仰; [int]实在,确实; [or]gmat;
fake: [a]/feɪk/; [adj]假的,伪造的; [n]骗子;假货,赝品; [v]假造,杜撰;伪造;冒充,假装;假装; [or]gmat;
fallacy: [a]/ˈfæləsi/; [n]谬论,谬见;错误,谬误; [or]gmat;
fallout: [a]/ˈfɔːlaʊt/; [n]［原］微粒回降,放射性尘埃;附带的后果;不良后果; [v]争吵,争议; [or]gmat;
fallow: [a]/ˈfæloʊ/; [adj]休耕的;不活跃的;休闲地,休闲的; [n]休耕地;休耕; [v]使(翻耕后的土地)休闲; [or]gmat;
falter: [a]/ˈfɔːltər/; [v]蹒跚,摇摆;踌躇;畏缩; [n]踌躇;支吾;颤抖; [or]gmat;
famine: [a]/ˈfæmɪn/; [n]饥荒;严重的缺乏; [or]gmat;
fanatic: [a]/fəˈnætɪk/; [n]狂热者,盲信者; [adj]狂热的,入迷的,盲信的; [or]gmat;
fanfare: [a]/ˈfænfer/; [n]夸耀,嘹亮的喇叭声; [v]热闹地介绍<宣布>; [or]gmat;
far-reaching: [a]/ˌfɑːr ˈriːtʃɪŋ/; [adj]深远的;广泛的;伸至远处的; [or]gmat;
farce: [a]/fɑːrs/; [n]闹剧;胡闹;笑剧; [or]gmat;
fare: [a]/fer/; [n]交通费;票价;食物;出租车乘客; [v](事情)进行得(好或坏); [or]gmat;
fatal: [a]/ˈfeɪtl/; [adj]致命的;毁灭性的;决定性的; [or]gmat;
fatality: [a]/fəˈtæləti/; [n]死亡;宿命;致命性;不幸,灾祸; [or]gmat;
fault: [a]/fɔːlt/; [n]过失,过错;弱点,缺点;故障,缺陷;(地质学)断层;发球失误; [v]责备,挑错; [or]gmat;
fauna: [a]/ˈfɔːnə/; [n]动物区系,动物群; [or]gmat;
fava: [a]/'fɑːvə/; [n]蚕豆; [or]gmat;
feasible: [a]/ˈfiːzəbl/; [adj]可行的,行得通的; [or]gmat;
feat: [a]/fiːt/; [n]绝技,功绩,武艺; [or]gmat;
federal: [a]/ˈfedərəl/; [adj]联邦制的;联邦政府的; [or]gmat;
feeble: [a]/ˈfiːbl/; [adj]虚弱的; [or]gmat;
feline: [a]/ˈfiːlaɪn/; [n]猫科动物; [adj]猫科的,猫的; [or]gmat;
feminist: [a]/ˈfemənɪst/; [n]男女平等主义者,女权扩张论者; [adj]主张男女平等的,女权主义的; [or]gmat;
ferret: [a]/ˈferɪt/; [n]雪貂;白鼬;侦探; [v]搜寻;查获;驱出;用雪貂猎取; [adj]雪貂似的;搜索者般的;爱窥探的; [or]gmat;
ferrous: [a]/ˈferəs/; [adj]含铁的; [or]gmat;
fertility: [a]/fərˈtɪləti/; [n]多产;肥沃;<农经>生产力;丰饶; [or]gmat;
fervent: [a]/ˈfɜːrvənt/; [adj]热烈的,满怀热情的;狂热的; [or]gmat;
fetch: [a]/fetʃ/; [v]取来;接来;使发出;售得;带来;接住; [n]拿来,取来;诡计;风浪区; [or]gmat;
feudal: [a]/ˈfjuːdl/; [adj]领地的;封建制度的;封建时代的;世仇的; [or]gmat;
fiber: [a]/ˈfaɪbər/; [n]纤维(物质);纤维组织;(植物) 纤维; [or]gmat;
fickle: [a]/ˈfɪkl/; [adj](在感情等方面)反复无常的,轻浮的,善变的; [or]gmat;
fiction: [a]/ˈfɪkʃn/; [n]虚构;想象;小说; [or]gmat;
fictitious: [a]/fɪkˈtɪʃəs/; [adj]虚构的; [or]gmat;
fierce: [a]/fɪrs/; [adj]凶猛的;激烈的;猛烈的; [or]gmat;
filament: [a]/ˈfɪləmənt/; [n]灯丝,细丝; [or]gmat;
file: [a]/faɪl/; [n]文件夹,档案,文件; [vi]把文件归档,提交(申请等); [vt]把(文件等)归档; [or]gmat;
filibuster: [a]/ˈfɪlɪbʌstər/; [n]冗长演说; [v]拖延议事; [or]gmat;
finite: [a]/ˈfaɪnaɪt/; [adj]有限的;限定的; [or]gmat;
fiscal: [a]/ˈfɪskl/; [adj]会计的;财政的;国库的; [or]gmat;
fixture: [a]/ˈfɪkstʃər/; [n]固定装置;体育项目; [or]gmat;
fjord: [a]/ˈfjɔːrd/; [n]峡湾(尤指挪威海岸边的); [or]gmat;
flat: [a]/flæt/; [adj]平坦的;浅的;平面的;单调的; [n]平面;公寓; [adv]平直地; [or]gmat;
flavor: [a]/ˈfleɪvər/; [n]味,风味;调味品; [v]给..调味; [or]gmat;
fleck: [a]/flek/; [n]斑点,斑纹;雀斑;微粒,小片; [v]使起斑点;使有斑纹; [or]gmat;
fledgling: [a]/ˈfledʒlɪŋ/; [n]刚学飞的幼鸟,无经验的人; [adj]刚开始的;无经验的; [or]gmat;
flexible: [a]/ˈfleksəbl/; [adj]易曲的,柔软的,灵活的; [or]gmat;
flippant: [a]/ˈflɪpənt/; [adj]无礼的,轻率的,随意的; [or]gmat;
flock: [a]/flɑːk/; [n](鸟兽)群;一群人;(对牧师而言的)教徒; [v]聚集,成群而行; [or]gmat;
flora: [a]/ˈflɔːrə/; [n]植物群; [or]gmat;
florid: [a]/ˈflɔːrɪd/; [adj]涨红的,华丽的,红润的; [or]gmat;
flourish: [a]/ˈflɜːrɪʃ/; [vi]繁荣,茂盛,兴旺; [vt]挥舞;夸耀; [n]兴旺;茂盛;炫耀;挥舞; [or]gmat;
fluctuate: [a]/ˈflʌktʃueɪt/; [v]波动;起伏;涨落; [or]gmat;
fluctuation: [a]/ˌflʌktʃuˈeɪʃn/; [n]波动;起伏; [or]gmat;
fluid: [a]/ˈfluːɪd/; [n]流体,液体; [adj]流动的;易变的;流畅的; [or]gmat;
fluorescent: [a]/ˌflɔːˈresnt/; [adj]荧光的;莹光的; [or]gmat;
focus: [a]/ˈfoʊkəs/; [n]焦点,聚焦;焦距;关注; [v]使聚焦,集中注意力; [or]gmat;
fodder: [a]/ˈfɑːdər/; [n]饲料,草料;(创作的)素材;弹药; [v]喂; [or]gmat;
foe: [a]/foʊ/; [n]敌人,敌军;危害物; [or]gmat;
folklore: [a]/ˈfoʊklɔːr/; [n]民俗学,民间传说;民间看法;民俗; [or]gmat;
follicle: [a]/ˈfɑːlɪkl/; [n]［解］小囊,滤泡,卵泡; [or]gmat;
folly: [a]/ˈfɑːli/; [n]愚蠢; [or]gmat;
fool around: [a]/ful əˈraʊnd/; [v]闲荡,干蠢事(或无用,琐悄的事); [or]gmat;
forage: [a]/ˈfɔːrɪdʒ/; [v]搜寻,翻寻,觅食; [n](牛马的)饲料,粮草; [or]gmat;
forebear: [a]/ˈfɔːrber/; [n]祖先,祖宗; [v]忍住; [or]gmat;
forecast: [a]/ˈfɔːrkæst/; [n]预测;预报; [v]预报,预测; [or]gmat;
foreclose: [a]/fɔːrˈkloʊz/; [v]排除,取消抵押品的赎回权; [or]gmat;
foresee: [a]/fɔːrˈsiː/; [v]预知,预料,预测; [or]gmat;
foreshadow: [a]/fɔːrˈʃædoʊ/; [v]预示; [n]预兆; [or]gmat;
foresight: [a]/ˈfɔːrsaɪt/; [n]先见,预见;远见,深谋远虑; [or]gmat;
forestall: [a]/fɔːrˈstɔːl/; [v]领先;占先一步;先发制人,阻止,妨碍;垄断;占先一步; [or]gmat;
forge: [a]/fɔːrdʒ/; [n]熔炉;锻工车间;铁匠店; [v]锻造;经锻炼而形成;伪造;推进,加强; [or]gmat;
format: [a]/ˈfɔːrmæt/; [n]版式;设计;格式; [v]设计一个版式;使格式化;设计.的版面; [or]gmat;
formidable: [a]/ˈfɔːrmɪdəbl/; [adj]令人畏惧的;可怕的;难以克服的;难应付的; [or]gmat;
formula: [a]/ˈfɔːrmjələ/; [n]公式,方程式;配方;方案;方法;配方奶; [or]gmat;
forthcoming: [a]/ˌfɔːrθˈkʌmɪŋ/; [adj]即将出现的,即将到来的;唾手可得的,可用的;乐于提供信息的; [or]gmat;
fortify: [a]/ˈfɔːrtɪfaɪ/; [v]设防于;增强; [or]gmat;
fortitude: [a]/ˈfɔːrtətuːd/; [n]坚强意志(精神),坚忍,刚毅; [or]gmat;
fortress: [a]/ˈfɔːrtrəs/; [n]堡垒;要塞; [or]gmat;
fossil: [a]/ˈfɑːsl/; [n]化石; [adj]从地下发掘出来的;化石的;属于旧时代的;陈腐的; [or]gmat;
foster: [a]/ˈfɔːstər/; [adj]收养的; [vt]养育;培养,促进; [or]gmat;
foul: [a]/faʊl/; [adj]难闻的,发臭的;糟透了的;污秽的;犯规的; [n]犯规; [vi]犯规; [vt]弄脏,使污秽;使纠缠; [or]gmat;
fraction: [a]/ˈfrækʃn/; [n]部分,片断,碎片;分数; [or]gmat;
fracture: [a]/ˈfræktʃər/; [n]骨折;折断;裂口; [v]使折断;使骨折; [or]gmat;
fragile: [a]/ˈfrædʒl/; [adj]易碎的;易损坏的;虚弱的;脆弱的; [or]gmat;
fragment: [a]/ˈfræɡmənt/; [n]片段;碎片; [v]使成碎片; [or]gmat;
fragrance: [a]/ˈfreɪɡrəns/; [n]香水;香味;芳香; [or]gmat;
frame: [a]/freɪm/; [n]构架,框,结构,体格; [v]表达;制定;拟订;陷害;构成,制定,给..装框架;使..适合; [or]gmat;
framework: [a]/ˈfreɪmwɜːrk/; [n]构架,框架,结构;体制,体系; [or]gmat;
fraternal: [a]/frəˈtɜːrnl/; [adj]兄弟的,兄弟般的,友爱的; [or]gmat;
fraudulent: [a]/ˈfrɔːdʒələnt/; [adj]欺诈的,欺骗性的,骗得的; [or]gmat;
free market: [a]/ˌfriː ˈmɑːrkɪt/; [n]［经］自由竞争的市场; [or]gmat;
freestanding: [a]/'friː'stændɪŋ/; [adj]［建］独立式的; [or]gmat;
fresco: [a]/ˈfreskoʊ/; [n]壁画;壁画法; [v]在..上做壁画;用壁画法画出; [or]gmat;
fretful: [a]/ˈfretfl/; [adj]烦躁的,焦躁的,(水面)起波纹的; [or]gmat;
friction: [a]/ˈfrɪkʃn/; [n]摩擦,摩擦力;争执,冲突; [or]gmat;
frivolous: [a]/ˈfrɪvələs/; [adj]轻佻的,不重要的,缺乏基础的; [or]gmat;
frontier: [a]/frʌnˈtɪr/; [n]边境,边疆;新领域;<美>边远地区,边界地区; [adj]开拓的; [or]gmat;
frugal: [a]/ˈfruːɡl/; [adj]节俭的,俭朴的;不昂贵的,廉价的,花钱少的,不充足的; [or]gmat;
frustrate: [a]/ˈfrʌstreɪt/; [v]使灰心;挫败;阻挠; [or]gmat;
fuel: [a]/ˈfjuːəl/; [v]给.加燃料; [n]燃料;刺激因素; [or]gmat;
fume: [a]/fjuːm/; [n]烟;愤怒; [v]冒烟;发怒; [or]gmat;
function: [a]/ˈfʌŋkʃn/; [n]功能,作用;函数;应变量;盛大聚会;职务,职责; [v]起作用;正常运转; [or]gmat;
fungi: [a]/ˈfʌŋɡaɪ/; [n]菌类;真菌; [or]gmat;
funnel: [a]/ˈfʌnl/; [n]漏斗;烟囱; [v]汇集;通过漏斗等;(使)成漏斗形; [or]gmat;
furnace: [a]/ˈfɜːrnɪs/; [n]炉子,熔炉; [or]gmat;
fusion: [a]/ˈfjuːʒn/; [n]融合,合并,核聚变; [or]gmat;
futile: [a]/ˈfjuːtl/; [adj]无益的,无用的; [or]gmat;
galaxy: [a]/ˈɡæləksi/; [n]星系; [or]gmat;
garment: [a]/ˈɡɑːrmənt/; [n]服装; [vt]给 ... 披上衣服;覆上...; [or]gmat;
gauge: [a]/ɡeɪdʒ/; [n]测量仪;尺度,标准; [v]估计,判断;计量; [or]gmat;
gear: [a]/ɡɪr/; [n]档位;齿轮;装备;衣物; [v]使适合; [or]gmat;
geese: [a]/ɡiːs/; [n]鹅; [or]gmat;
gel: [a]/dʒel/; [n]［物］［化］凝胶(体),冻胶; [v]胶化; [or]gmat;
gender: [a]/ˈdʒendər/; [n]性,性别;<语法>性,某些语言的(名词,代词和形容词)性的区分; [or]gmat;
generate: [a]/ˈdʒenəreɪt/; [v]产生(热,电等能量),创造; [or]gmat;
genetic: [a]/dʒəˈnetɪk/; [adj]遗传的,起源的; [or]gmat;
genial: [a]/ˈdʒiːniəl/; [adj]愉快的,脾气好的,友好的; [or]gmat;
gentry: [a]/ˈdʒentri/; [n]人们(多用贬义),贵族们,(英)上流社会人士; [or]gmat;
genuine: [a]/ˈdʒenjuɪn/; [adj]真正的;真的;真诚的; [or]gmat;
geometric: [a]/ˌdʒiːəˈmetrɪk/; [adj]几何学的,几何图形的; [or]gmat;
get by: [a]/ɡet baɪ/; [v]侥幸躲过,勉强生活; [or]gmat;
get through: [a]/ɡet θru/; [v]完成;穿过;(成功)渡过(困难时期);打通(电话); [or]gmat;
gimmick: [a]/ˈɡɪmɪk/; [n]吸引人的花招,噱头; [vt]用暗机关改变或影响; [or]gmat;
gingivitis: [a]/ˌdʒɪndʒɪˈvaɪtəs/; [n]［医］(齿)龈炎; [or]gmat;
girdle: [a]/ˈɡɜːrdl/; [n]腰带;妇女紧身褡; [v]围,包围,环绕; [or]gmat;
give rise to: [a]/ɡɪv raɪz tu/; [phr]引起,发生; [or]gmat;
give way to: [a]/ɡɪv weɪ tu/; [phr]让位于..;让路; [or]gmat;
glacier: [a]/ˈɡleɪʃər/; [n]冰川,冰河; [or]gmat;
glean: [a]/ɡliːn/; [v]收集(资料); [or]gmat;
gloomy: [a]/ˈɡluːmi/; [adj]愁容满面的,阴暗的,没有希望的; [or]gmat;
glut: [a]/ɡlʌt/; [n]供过于求,过多; [vt]使吃饱;使充斥; [vi]过量地吃; [or]gmat;
gorilla: [a]/ɡəˈrɪlə/; [n]大猩猩,打手,暴徒; [or]gmat;
gourmet: [a]/ˈɡʊrmeɪ/; [n]美食家,讲究吃喝的人; [adj]菜肴精美的; [or]gmat;
gradient: [a]/ˈɡreɪdiənt/; [n]斜坡;倾斜度;坡度;渐变; [adj]倾斜的;渐倾的; [or]gmat;
gradual: [a]/ˈɡrædʒuəl/; [adj]逐渐的,逐步的,平缓的; [or]gmat;
grandiloquent: [a]/ɡrænˈdɪləkwənt/; [adj](语言等)夸张的,夸大的; [or]gmat;
grant: [a]/ɡrænt/; [v]给予,许可,授予;承认; [n]许可;拨款,补助金; [or]gmat;
granular: [a]/ˈɡrænjələr/; [adj]粒状的,含颗粒的; [or]gmat;
graph: [a]/ɡræf/; [n](曲线)图,图表; [vt]用曲线图表示,把.绘入图表;用胶版印刷; [or]gmat;
graphite: [a]/ˈɡræfaɪt/; [n]石墨; [or]gmat;
graveside: [a]/'greɪvˌsaɪd/; [n]坟墓边; [adj]在墓旁的;在墓旁发生的; [or]gmat;
gravitate: [a]/ˈɡrævɪteɪt/; [v]受引力作用;被吸引; [or]gmat;
gravitational: [a]/ˌɡrævɪˈteɪʃənl/; [adj]重力的;万有引力的; [or]gmat;
graze: [a]/ɡreɪz/; [v](牲畜)吃草;放牧;擦过; [n]擦,擦伤; [or]gmat;
gregarious: [a]/ɡrɪˈɡeriəs/; [adj]群居的,爱社交的; [or]gmat;
grievance: [a]/ˈɡriːvəns/; [n]牢骚,委屈,抱怨; [or]gmat;
grill: [a]/ɡrɪl/; [n]烤架; [v]烤;拷问; [or]gmat;
grim: [a]/ɡrɪm/; [adj]严酷的,无情的;令人沮丧的,令人失望的;讨厌的,糟糕的; [or]gmat;
grind: [a]/ɡraɪnd/; [v]磨碎,碾碎;折磨;摩擦得吱吱作响; [n]苦差事,苦活儿;磨; [or]gmat;
grip: [a]/ɡrɪp/; [v]握紧,抓牢; [n]紧握,握力; [or]gmat;
grove: [a]/ɡroʊv/; [n]小树林;果园; [or]gmat;
gruesome: [a]/ˈɡruːsəm/; [adj]阴森的;可怕的; [or]gmat;
guarantee: [a]/ˌɡærənˈtiː/; [v]保证;担保;提供保修; [n]保证;担保;保修单;保证金; [or]gmat;
gullible: [a]/ˈɡʌləbl/; [adj]易受骗的;轻信的; [or]gmat;
gut: [a]/ɡʌt/; [n](pl.)内脏,(幽门到直肠间的)肠子,勇气,剧情,内容,肚子,内脏,海峡; [adj]情感的;直觉的,本能的; [vt]取出内脏,摧毁(房屋等的)内部装置; [or]gmat;
gymnast: [a]/ˈdʒɪmnæst/; [n]体操运动员; [or]gmat;
gynecologist: [a]/ˌgaɪnə'kɒlədʒɪst/; [n]妇科医生; [or]gmat;
gyration: [a]/dʒaɪˈreɪʃn/; [n]旋转,回旋;［动］螺层; [or]gmat;
gyroscope: [a]/ˈdʒaɪrəskoʊp/; [n]陀螺仪,回转仪; [or]gmat;
haberdashery: [a]/ˈhæbərdæʃəri/; [n](总称)男子服饰用品,缝纫用品; [or]gmat;
habitat: [a]/ˈhæbɪtæt/; [n]自然环境,栖息地; [or]gmat;
habitation: [a]/ˌhæbɪˈteɪʃn/; [n]住处; [or]gmat;
hadron: [a]/'hædrən/; [n]［物］强子(一种基本粒子); [or]gmat;
hail: [a]/heɪl/; [n]冰雹;一阵; [v]下冰雹;歌颂; [or]gmat;
hallmark: [a]/ˈhɔːlmɑːrk/; [n]特点;品质证明; [v]给.盖上品质证明印记;使具有.标志; [or]gmat;
hamper: [a]/ˈhæmpər/; [v]阻碍,妨碍,牵制; [n](有盖的)大篮子; [or]gmat;
hamster: [a]/ˈhæmstər/; [n](动)仓鼠; [or]gmat;
handicap: [a]/ˈhændikæp/; [n]障碍,阻碍,不利条件,不利因素;残疾,缺陷,生理缺陷;<高尔夫>给弱者增加的杆数(按击球次数计数,并随参赛者的进步而减少); [v]使不利,妨碍; [or]gmat;
hardy: [a]/ˈhɑːrdi/; [adj](植物)耐寒的;能吃苦耐劳的;勇敢的; [n]强壮的人; [or]gmat;
harmonize: [a]/ˈhɑːrmənaɪz/; [v]使调和,使一致; [or]gmat;
harness: [a]/ˈhɑːrnɪs/; [n]挽具,马具,降落伞背带; [v]上挽具;治理(河流等);利用; [or]gmat;
hatch: [a]/hætʃ/; [n]船舱盖; [v]孵出,孵;策划; [or]gmat;
hatchback: [a]/ˈhætʃbæk/; [n]［美］有可向上开启天窗的汽车背部; [or]gmat;
haunt: [a]/hɔːnt/; [v]常去,萦绕于..;(鬼,魂)常出没于;(思想)萦绕; [n]常去的地方; [or]gmat;
haven: [a]/ˈheɪvn/; [n]港湾;避难所; [vt]为.提供庇护所; [or]gmat;
havoc: [a]/ˈhævək/; [n](天灾,战争等造成的)大破坏,大毁灭; [vi]损毁; [vt]严重破坏; [or]gmat;
hazard: [a]/ˈhæzərd/; [n]公害;危险;危险的事物;机会; [v]使冒危险;冒险做; [or]gmat;
hazardous: [a]/ˈhæzərdəs/; [adj]有危险的;碰运气的; [adv]冒险地,有危险地; [n]冒险,危险; [or]gmat;
haze: [a]/heɪz/; [n]阴霾;薄雾;疑惑,迷糊; [v](使)变朦胧;(使)变糊涂; [or]gmat;
headquarters: [a]/ˈhedkwɔːrtərz/; [n]司令部,指挥部;总部,总局; [or]gmat;
hedge: [a]/hedʒ/; [v]防范,规避;避免直接答复,避免直接回答;围住;用树篱围起; [n]篱笆,树篱;保障; [or]gmat;
hedgehog: [a]/ˈhedʒhɔːɡ/; [n]刺猬; [or]gmat;
hedonist: [a]/ˈhiːdənɪst/; [n]享乐主义者,［心］欢乐主义者; [adj]享乐主义者的; [or]gmat;
heed: [a]/hiːd/; [vt]注意;留心; [v]注意; [vi]留心; [n]注意;留心; [or]gmat;
hefty: [a]/ˈhefti/; [adj]重的,肌肉发达的,异常大的; [adv]强有力地,非常; [n]体格健壮的人; [or]gmat;
hegemony: [a]/hɪˈdʒemoʊni/; [n]霸权,领导权; [or]gmat;
helicopter: [a]/ˈhelɪkɑːptər/; [n]直升机; [v]用直升飞机载送,乘直升机; [or]gmat;
helium: [a]/ˈhiːliəm/; [n]<化学>氦(元素符号He); [or]gmat;
hem: [a]/hem/; [n]边,缘;摺边; [v]给..缝边;包围; [or]gmat;
hemoglobin: [a]/ˌhiːmə'gloʊbɪn/; [n]［生化］血红蛋白; [or]gmat;
hepatitis: [a]/ˌhepəˈtaɪtɪs/; [n]肝炎; [or]gmat;
herbicide: [a]/ˈɜːrbɪsaɪd/; [n]<农药>除草剂; [or]gmat;
herd: [a]/hɜːrd/; [n]兽群,牧群; [v]放牧,群集; [or]gmat;
hereditary: [a]/həˈredɪteri/; [adj]世袭的,遗传的; [or]gmat;
heretical: [a]/həˈretɪkl/; [adj]异端的,异教的; [or]gmat;
heritage: [a]/ˈherɪtɪdʒ/; [n]遗产;继承物;传统;文化遗产; [or]gmat;
herring: [a]/ˈherɪŋ/; [n]鲱鱿; [or]gmat;
heterogeneity: [a]/ˌhetərədʒəˈniːəti/; [n]异类,不同,不均匀性,不纯一性,异质性; [or]gmat;
hexagon: [a]/ˈheksəɡɑːn/; [n]六角形,六边形; [adj]六角形的; [or]gmat;
hide: [a]/haɪd/; [vt]躲藏,把.藏起来;隐瞒; [n]藏身处;隐密场所,隐蔽处;(尤指买卖或用作皮革的)皮;兽皮;人身安全; [or]gmat;
hierarchy: [a]/ˈhaɪərɑːrki/; [n]阶层,等级制度; [or]gmat;
hieroglyphic: [a]/ˌhaɪərəˈɡlɪfɪk/; [adj]象形文字的; [n]象形文字,象形文字写成的文章; [or]gmat;
highlight: [a]/ˈhaɪlaɪt/; [vt]使突出,强调,高亮; [n]最精彩的部分,最重要的事件; [or]gmat;
hike: [a]/haɪk/; [n]远足,徒步旅行;(数量,价格等)增加,上升; [v]作长途徒步旅行;使高涨,提高(价格); [or]gmat;
hinder: [a]/ˈhɪndər/; [v]阻碍,妨碍; [adj]后面的,后方的; [or]gmat;
hint: [a]/hɪnt/; [v]作暗示;透露; [n]暗示,示意;建议; [or]gmat;
hinterland: [a]/ˈhɪntərlænd/; [n]内地;腹地;穷乡僻壤;远离城镇的地方; [or]gmat;
hitherto: [a]/ˌhɪðərˈtuː/; [adv]到目前为止,迄今为止; [or]gmat;
hoary: [a]/ˈhɔːri/; [adj]年纪高迈的;(头发等)灰白的;古老的; [or]gmat;
hockey: [a]/ˈhɑːki/; [n]曲棍球; [or]gmat;
holistic: [a]/hoʊˈlɪstɪk/; [adj]整体的;全盘的; [or]gmat;
homicide: [a]/ˈhɑːmɪsaɪd/; [n]杀人,杀人者; [or]gmat;
hominid: [a]/ˈhɑːmɪnɪd/; [n]原始人类;人科动物; [or]gmat;
homogeneous: [a]/ˌhoʊməˈdʒiːniəs/; [adj]同类的,同质的,有相同特征的; [or]gmat;
hone: [a]/hoʊn/; [n]细磨刀石; [v]磨刀; [or]gmat;
hormone: [a]/ˈhɔːrmoʊn/; [n]荷尔蒙,激素; [or]gmat;
horrendous: [a]/həˈrendəs/; [adj]可怕的,令人惊惧的; [or]gmat;
hospitable: [a]/hɑːˈspɪtəbl/; [adj]好客的;有利的;宜人的; [or]gmat;
hostility: [a]/hɑːˈstɪləti/; [n]虐待,敌意;不友善;敌对; [or]gmat;
household: [a]/ˈhaʊshoʊld/; [n]同住在一家的人;家务;家常普通的; [adj]家庭的,家内的,一家的;家喻户晓的; [or]gmat;
hover: [a]/ˈhʌvər/; [v](鸟,直升机)盘旋,翱翔;(人)逗留在附近,徘徊; [or]gmat;
howl: [a]/haʊl/; [v](狼,狗等)嗥叫;(风等)呼啸;(因愤怒,痛苦等)吼叫,哀号; [n]嚎叫,哀号; [or]gmat;
hue: [a]/hjuː/; [n]色彩;色度,颜色;叫声; [or]gmat;
hum: [a]/hʌm/; [v]发出嗡嗡声,哼(歌曲); [n]轰鸣声,嗡嗡营营声; [or]gmat;
humane: [a]/hjuːˈmeɪn/; [adj]人道的;仁慈的; [or]gmat;
humanitarian: [a]/hjuːˌmænɪˈteriən/; [n]慈善家;人道主义者;博爱主义者; [adj]人道主义者的;慈善的;博爱的; [or]gmat;
humble: [a]/ˈhʌmbl/; [adj]卑微的;(级别或地位)低下的,简陋的;谦逊的; [v]使⋯谦逊,使⋯卑下;轻松打败(尤指强大的对手); [or]gmat;
humid: [a]/ˈhjuːmɪd/; [adj]潮湿的;湿润的;多湿气的; [or]gmat;
hurricane: [a]/ˈhɜːrəkeɪn/; [n]飓风; [or]gmat;
hybrid: [a]/ˈhaɪbrɪd/; [n]杂种,混血儿,混合物; [adj]混合的;杂种的; [or]gmat;
hydrocarbon: [a]/ˌhaɪdrəˈkɑːrbən/; [n]碳氢化合物,烃; [or]gmat;
hydrogen: [a]/ˈhaɪdrədʒən/; [n]氢,氢气; [or]gmat;
hyperbole: [a]/haɪˈpɜːrbəli/; [n]夸张的语句;夸张法; [or]gmat;
hypersensitive: [a]/ˌhaɪpərˈsensətɪv/; [adj]敏感的;很容易生气的;过敏的;超感光度的; [or]gmat;
hypertension: [a]/ˌhaɪpərˈtenʃn/; [n]［医］高血压,过度紧张; [or]gmat;
hypnotist: [a]/ˈhɪpnətɪst/; [n]施行催眠术的人; [or]gmat;
hypotenuse: [a]/haɪˈpɑːtənuːs/; [n](直角三角形的)斜边; [or]gmat;
hypothalamus: [a]/ˌhaɪpəˈθæləməs/; [n]下丘脑; [or]gmat;
hypothesis: [a]/haɪˈpɑːθəsɪs/; [n]假说;假设; [or]gmat;
hypothesize: [a]/haɪˈpɑːθəsaɪz/; [v]假设,假定; [or]gmat;
ibuprofen: [a]/ˌaɪbjuːˈproʊfen/; [n]布洛芬(镇痛药); [or]gmat;
iconography: [a]/ˌaɪkəˈnɑːɡrəfi/; [n]肖像画法,肖像学,插画,图解; [or]gmat;
identical: [a]/aɪˈdentɪkl/; [adj]相同的,同样的,一模一样的;相似的; [n]完全相同的事物; [or]gmat;
identify: [a]/aɪˈdentɪfaɪ/; [v]认出,联系;识别;确定,鉴定,发现;认为.等同,认为.关系紧密;表明.的身份;认同,有共鸣,有同感; [or]gmat;
identity: [a]/aɪˈdentəti/; [n]身份;特性;一致; [or]gmat;
ideographic: [a]/ˌɪdɪə'græfɪk/; [adj]表意的,表意文字的; [or]gmat;
ideology: [a]/ˌaɪdiˈɑːlədʒi/; [n]意识形态,思想(体系); [or]gmat;
idioglossia: [a]/ɪdɪə'glɔːsɪə/; [n]自解语症(只有自己懂的语言),自语症; [or]gmat;
idiosyncrasy: [a]/ˌɪdiəˈsɪŋkrəsi/; [n]特殊癖性或行为; [or]gmat;
idle: [a]/ˈaɪdl/; [adj]空闲的;懒散的; [v]无所事事;虚度;空转;使空转; [vt]虚度; [or]gmat;
ignite: [a]/ɪɡˈnaɪt/; [v]点燃,发光,燃烧; [or]gmat;
ignition: [a]/ɪɡˈnɪʃn/; [n]点火,着火;点火开关; [or]gmat;
iguana: [a]/ɪˈɡwɑːnə/; [n]美洲大蜥蜴; [or]gmat;
illegal: [a]/ɪˈliːɡl/; [adj]不合法的,非法的; [n]非法移民,非法劳工;间谍; [or]gmat;
illicit: [a]/ɪˈlɪsɪt/; [adj]违法的,违禁的; [or]gmat;
illiterate: [a]/ɪˈlɪtərət/; [n]文盲,目不识丁者; [adj]不识字的;缺乏(某方面)知识的;语法错误的; [or]gmat;
illuminate: [a]/ɪˈluːmɪneɪt/; [vt]照亮;阐释;说明; [or]gmat;
illusory: [a]/ɪˈluːsəri/; [adj]错觉的,幻影的,虚假的,产生幻觉的; [or]gmat;
illustrate: [a]/ˈɪləstreɪt/; [v]举例说明,阐明;图解,加插图; [or]gmat;
imitate: [a]/ˈɪmɪteɪt/; [v]模仿; [or]gmat;
immaterial: [a]/ˌɪməˈtɪriəl/; [adj]非实体的,无关紧要的; [or]gmat;
immediate: [a]/ɪˈmiːdiət/; [adj]直系的;立即的,立刻的;紧邻的; [or]gmat;
imminent: [a]/ˈɪmɪnənt/; [adj]迫近的,紧迫的,即将来临的; [or]gmat;
immoral: [a]/ɪˈmɔːrəl/; [adj]不道德的;邪恶的;淫荡的; [or]gmat;
immune: [a]/ɪˈmjuːn/; [adj]免疫的,有免疫力的;不受影响的;免除的; [or]gmat;
immunological: [a]/ˌɪmjunəˈlɑːdʒɪkl/; [adj]［医］免疫学的; [or]gmat;
immutable: [a]/ɪˈmjuːtəbl/; [adj]永远不变的,永恒的; [or]gmat;
impact: [a]/ˈɪmpækt/; [n]碰撞,冲击;冲击力;影响; [v]冲击;压紧;产生影响;塞满; [or]gmat;
impart: [a]/ɪmˈpɑːrt/; [v]传授,给予,将(某性质)给予或赋予某事物; [or]gmat;
impartial: [a]/ɪmˈpɑːrʃl/; [adj]公平的,不偏不倚的; [or]gmat;
impartiality: [a]/ˌɪmˌpɑːrʃiˈæləti/; [n]公正,公平;不偏不倚; [or]gmat;
impasse: [a]/ˈɪmpæs/; [n]僵局;死路; [or]gmat;
impede: [a]/ɪmˈpiːd/; [v]妨碍,阻碍; [or]gmat;
impediment: [a]/ɪmˈpedɪmənt/; [n]妨碍,阻碍;障碍物;(言语)障碍;口吃; [or]gmat;
imperative: [a]/ɪmˈperətɪv/; [adj]必要的;祈使的;急需的; [n]命令;必要的事;义务;驱使; [or]gmat;
imperial: [a]/ɪmˈpɪriəl/; [adj]帝王的,壮丽的,至尊的; [n]帝国,皇家; [or]gmat;
impersonal: [a]/ɪmˈpɜːrsənl/; [adj]客观的,没有人情味的,不及物的; [n]<语>非人称动词;非人称代名词;不具人格的事物; [or]gmat;
impetus: [a]/ˈɪmpɪtəs/; [n]推动力;促进; [or]gmat;
impinge: [a]/ɪmˈpɪndʒ/; [v]侵犯,撞击,碰撞; [or]gmat;
implant: [a]/ɪmˈplænt/; [v]嵌入,注入,灌输; [n]<医>植入物,植入管; [or]gmat;
implement: [a]/ˈɪmplɪment/; [n]工具;器具; [v]实施,执行;执行; [or]gmat;
implication: [a]/ˌɪmplɪˈkeɪʃn/; [n]暗示;含意;牵连;卷入;可能的后果; [or]gmat;
implicit: [a]/ɪmˈplɪsɪt/; [adj]隐含的;盲目的;完全的,绝对的;成为一部分的; [or]gmat;
imply: [a]/ɪmˈplaɪ/; [vt]暗示;暗指;意味着; [or]gmat;
impose: [a]/ɪmˈpoʊz/; [v]把.强加;强制实行,强迫接受; [or]gmat;
imposition: [a]/ˌɪmpəˈzɪʃn/; [n]征收;强加;欺骗;不公平的负担; [or]gmat;
impoverish: [a]/ɪmˈpɑːvərɪʃ/; [v]使成赤贫,使枯竭; [or]gmat;
impoverished: [a]/ɪmˈpɑːvərɪʃt/; [adj]穷困的,用尽了的,无创造性的; [or]gmat;
impressionable: [a]/ɪmˈpreʃənəbl/; [adj]敏感的;易受影响的; [or]gmat;
impulse: [a]/ˈɪmpʌls/; [n]冲动,脉冲,驱使; [or]gmat;
impunity: [a]/ɪmˈpjuːnəti/; [n]不受惩罚;无患; [or]gmat;
in full bloom: [a]/ɪn fʊl blum/; [phr]全盛时期; [or]gmat;
inadvertent: [a]/ˌɪnədˈvɜːrtənt/; [adj]疏忽的,漫不经心的,无意中的; [or]gmat;
inalienable: [a]/ɪnˈeɪliənəbl/; [adj]不可分割的; [or]gmat;
incandescent: [a]/ˌɪnkænˈdesnt/; [adj]白热的,热烈的; [or]gmat;
incentive: [a]/ɪnˈsentɪv/; [n]刺激,激励;鼓励; [or]gmat;
incipient: [a]/ɪnˈsɪpiənt/; [adj]初期的;刚出现的; [or]gmat;
incisive: [a]/ɪnˈsaɪsɪv/; [adj]一针见血的,敏锐的; [or]gmat;
incompatible: [a]/ˌɪnkəmˈpætəbl/; [adj]不兼容的,矛盾的,不调和的; [or]gmat;
incongruity: [a]/ˌɪnkɑːnˈɡruːəti/; [n]不协调,不一致,不适宜; [or]gmat;
inconsequential: [a]/ɪnˌkɑːnsɪˈkwenʃl/; [adj]不重要的,不合理的,不合逻辑的; [or]gmat;
inconsistent: [a]/ˌɪnkənˈsɪstənt/; [adj]不一致的,前后矛盾的; [or]gmat;
increase: [a]/ɪnˈkriːs/; [v]增加,提高; [n]增加,增强,提高; [or]gmat;
increment: [a]/ˈɪŋkrəmənt/; [n]增长;增值; [or]gmat;
incriminate: [a]/ɪnˈkrɪmɪneɪt/; [v]控告,暗示..有罪; [or]gmat;
incumbent: [a]/ɪnˈkʌmbənt/; [n]在职者,现任者; [adj]现任的;依靠的;负有职责的; [or]gmat;
incur: [a]/ɪnˈkɜːr/; [v]遭受;招致;引起; [or]gmat;
incursion: [a]/ɪnˈkɜːrʒn/; [n]入侵,侵犯; [or]gmat;
indelible: [a]/ɪnˈdeləbl/; [adj](印记等)无法擦除的,无法忘怀的; [or]gmat;
index: [a]/ˈɪndeks/; [n]索引;指标,标志;指数; [v]附以索引,编入索引; [or]gmat;
indicate: [a]/ˈɪndɪkeɪt/; [vt]指出,指示,标示;表明,表示,显示; [or]gmat;
indicative: [a]/ɪnˈdɪkətɪv/; [adj]指示的;暗示的;陈述的; [n]陈述语气; [or]gmat;
indices: [a]/ˈɪndɪsiːz/; [n]目录,指数; [or]gmat;
indifference: [a]/ɪnˈdɪfrəns/; [n]不关心,冷淡; [or]gmat;
indigenous: [a]/ɪnˈdɪdʒənəs/; [adj]土生土长的,本土的; [or]gmat;
indigent: [a]/ˈɪndɪdʒənt/; [adj]贫困的,贫穷的; [or]gmat;
indignation: [a]/ˌɪndɪɡˈneɪʃn/; [n]愤慨; [or]gmat;
indiscriminate: [a]/ˌɪndɪˈskrɪmɪnət/; [adj]任意的;不加区别的,不加选择的; [or]gmat;
indispensable: [a]/ˌɪndɪˈspensəbl/; [adj]必不可少的;必需的; [or]gmat;
induce: [a]/ɪnˈduːs/; [v]引导,劝诱,诱导; [or]gmat;
inducement: [a]/ɪnˈduːsmənt/; [n]诱因;刺激物;犯罪动因; [or]gmat;
indulge: [a]/ɪnˈdʌldʒ/; [v]沉迷于;放纵;满足; [or]gmat;
inept: [a]/ɪˈnept/; [adj]无能的;不称职的;笨拙的; [or]gmat;
inertia: [a]/ɪˈnɜːrʃə/; [n]惯性,惰性; [or]gmat;
inevitable: [a]/ɪnˈevɪtəbl/; [adj]不可避免的,必然的; [n]必然发生的事; [or]gmat;
inexorable: [a]/ɪnˈeksərəbl/; [adj]不为所动的,坚决不变的; [n]坚定不移的人; [or]gmat;
inexplicable: [a]/ˌɪnɪkˈsplɪkəbl/; [adj]无法解释的,难理解的,莫名其妙的; [or]gmat;
inextricable: [a]/ˌɪnɪkˈstrɪkəbl/; [adj]无法摆脱的,纠缠的; [adv]无法摆脱地,解不开地; [or]gmat;
inextricably: [a]/ˌɪnɪkˈstrɪkəbli/; [adv]无法摆脱地; [or]gmat;
infancy: [a]/ˈɪnfənsi/; [n]婴儿期,幼年; [or]gmat;
infect: [a]/ɪnˈfekt/; [v]传染,感染;使受影响; [or]gmat;
infectious: [a]/ɪnˈfekʃəs/; [adj]传染的;感染性的;易传播的; [or]gmat;
infer: [a]/ɪnˈfɜːr/; [vt]做出推论,推断;推理;暗示; [vi]推断; [or]gmat;
inferior: [a]/ɪnˈfɪriər/; [adj](等级,地位等)下等的,低等的;低劣的; [n]部下,地位低的人;次品; [or]gmat;
infest: [a]/ɪnˈfest/; [v]骚扰,寄生于,大批出没; [or]gmat;
infirmary: [a]/ɪnˈfɜːrməri/; [n]医院,医务室(尤指学校等附设的病房或配药处); [or]gmat;
inflammatory: [a]/ɪnˈflæmətɔːri/; [adj]炎症性的;煽动性的;激动的; [or]gmat;
inflate: [a]/ɪnˈfleɪt/; [v]充气,膨胀,扩大; [or]gmat;
inflection: [a]/ɪnˈflekʃn/; [n]弯曲,变形,音调变化; [or]gmat;
inflict: [a]/ɪnˈflɪkt/; [v]使遭受(损伤,痛苦等);使承担(负担等); [or]gmat;
influx: [a]/ˈɪnflʌks/; [n]流入,涌入;河口; [or]gmat;
infrared: [a]/ˌɪnfrəˈred/; [adj]红外线的; [n]红外线; [or]gmat;
infuse: [a]/ɪnˈfjuːz/; [v]沏(茶),泡(草药);灌输;使充满; [or]gmat;
ingenious: [a]/ɪnˈdʒiːniəs/; [adj]聪明的;有发明天才的;有独创性的,别出心裁的; [or]gmat;
ingenuity: [a]/ˌɪndʒəˈnuːəti/; [n]机灵,心灵手巧,富于创造天赋; [or]gmat;
ingest: [a]/ɪnˈdʒest/; [v]咽下;摄取;吸收;接待; [or]gmat;
ingredient: [a]/ɪnˈɡriːdiənt/; [n](烹调的)原料;(构成的)要素,因素; [or]gmat;
inhabit: [a]/ɪnˈhæbɪt/; [v]居住于; [or]gmat;
inherent: [a]/ɪnˈhɪrənt/; [adj]内在的,固有的;生来就有的; [or]gmat;
inherit: [a]/ɪnˈherɪt/; [v]经遗传而得(特性等);接受遗产;沿袭;继任; [or]gmat;
inherited: [a]/ɪnˈherɪtɪd/; [adj]遗传的(病等),继承权的,通过继承得到的; [or]gmat;
inhibit: [a]/ɪnˈhɪbɪt/; [v]阻碍;阻止,防止;抑制,约束; [or]gmat;
inhumane: [a]/ˌɪnhjuːˈmeɪn/; [adj]残忍的,无人情味的; [or]gmat;
iniquitous: [a]/ɪˈnɪkwɪtəs/; [adj]邪恶的;不公正的; [or]gmat;
initial: [a]/ɪˈnɪʃl/; [adj]第一的;最初的;开始的; [n]首字母; [or]gmat;
initiate: [a]/ɪˈnɪʃieɪt/; [v]开始,发动; [n]新加入组织的人; [or]gmat;
injunction: [a]/ɪnˈdʒʌŋkʃn/; [n]<法>指令,禁令; [or]gmat;
inlet: [a]/ˈɪnlet/; [n]水湾,小湾;进口,入口; [or]gmat;
innate: [a]/ɪˈneɪt/; [adj]与生俱来的,天生的; [or]gmat;
inoculate: [a]/ɪˈnɑːkjuleɪt/; [v]<医>给..接种,给..注射预防针,<植>嫁接,灌输; [or]gmat;
inordinate: [a]/ɪnˈɔːrdɪnət/; [adj]过度的,无节制的;紊乱的; [or]gmat;
inpatient: [a]/ˈɪnpeɪʃnt/; [n]住院病人; [or]gmat;
input: [a]/ˈɪnpʊt/; [n]投入;[电学,计算机]输入; [vt]输入; [or]gmat;
inquisitive: [a]/ɪnˈkwɪzətɪv/; [adj]好奇的,好打听的; [or]gmat;
insatiable: [a]/ɪnˈseɪʃəbl/; [adj]不能满足的,贪得无厌的; [or]gmat;
inscribe: [a]/ɪnˈskraɪb/; [v]刻; [or]gmat;
insecticide: [a]/ɪnˈsektɪsaɪd/; [n]杀虫剂; [or]gmat;
insert: [a]/ɪnˈsɜːrt/; [vt]插入,嵌入; [n]插入物;插页; [or]gmat;
insidious: [a]/ɪnˈsɪdiəs/; [adj](暗中或逐渐)为害的; [or]gmat;
insight: [a]/ˈɪnsaɪt/; [n]深刻的理解,洞察力,见识; [or]gmat;
insomnia: [a]/ɪnˈsɑːmniə/; [n]失眠; [or]gmat;
inspection: [a]/ɪnˈspekʃn/; [n]检查,细看; [or]gmat;
install: [a]/ɪnˈstɔːl/; [v]安装,安置,使就职; [or]gmat;
installation: [a]/ˌɪnstəˈleɪʃn/; [n]安装,装置;就职; [or]gmat;
instantaneous: [a]/ˌɪnstənˈteɪniəs/; [adj]瞬间的;即刻的;猝发的; [or]gmat;
instigate: [a]/ˈɪnstɪɡeɪt/; [v]发起,煽动; [or]gmat;
institution: [a]/ˌɪnstɪˈtuːʃn/; [n]机构;制度;惯例;习俗;建立,设立,制定; [or]gmat;
instruct: [a]/ɪnˈstrʌkt/; [v]指导;教;指示;通知; [or]gmat;
instrument: [a]/ˈɪnstrəmənt/; [n]仪器;工具;乐器;手段; [or]gmat;
insulate: [a]/ˈɪnsəleɪt/; [v]隔离,使隔绝(以免受到影响);使隔热; [or]gmat;
insulin: [a]/ˈɪnsəlɪn/; [n]胰岛素; [or]gmat;
insuperable: [a]/ɪnˈsuːpərəbl/; [adj]难以克服的,无敌的; [or]gmat;
intact: [a]/ɪnˈtækt/; [adj]原封未动的,未受损的,完整无缺的; [or]gmat;
intake: [a]/ˈɪnteɪk/; [n]吸入,收纳;纳入(数量); [or]gmat;
intangible: [a]/ɪnˈtændʒəbl/; [adj]不可捉摸的,无形的; [n]无形的东西; [or]gmat;
integer: [a]/ˈɪntɪdʒər/; [n]整数;整体; [or]gmat;
integral: [a]/ˈɪntɪɡrəl/; [adj](用于构成整体)必需的,不可缺少的,必不可少的;基本的,作为组成部分的,内置的;整体的,完整的; [or]gmat;
integrated: [a]/ˈɪntɪɡreɪtɪd/; [adj]综合的,完整的,互相协调的; [or]gmat;
intense: [a]/ɪnˈtens/; [adj]强烈的,激烈的;紧张的;认真的;热情的; [or]gmat;
intensify: [a]/ɪnˈtensɪfaɪ/; [v]增强;加剧; [or]gmat;
intent: [a]/ɪnˈtent/; [adj]全神贯注的;专心致志的; [n]意图;意向;目的; [or]gmat;
intention: [a]/ɪnˈtenʃn/; [n]意图,意向,目的,打算; [or]gmat;
intentional: [a]/ɪnˈtenʃənl/; [adj]故意的;有意图的; [or]gmat;
interact: [a]/ˌɪntərˈækt/; [v]交流,沟通,互动;互相作用,互相影响; [or]gmat;
intercept: [a]/ˌɪntərˈsept/; [v]中途拦截,截取; [n]拦截;<数>截距;侦听; [or]gmat;
interdependence: [a]/ˌɪntərdɪˈpendəns/; [n]互相依赖; [or]gmat;
interdependency: [a]/ɪn'tədɪpendənsɪ/; [n]相互依赖,相关性; [or]gmat;
interest rate: [a]/ˈɪntrəst reɪt/; [phr]利率; [or]gmat;
interfere: [a]/ˌɪntərˈfɪr/; [v]干涉,妨碍;妨碍;干涉; [vi]妨碍; [or]gmat;
interior: [a]/ɪnˈtɪriər/; [adj]内部的; [n]内部,内心; [or]gmat;
interlude: [a]/ˈɪntərluːd/; [n]插曲;穿插;间歇;幕间节目; [or]gmat;
intermediary: [a]/ˌɪntərˈmiːdieri/; [adj]中间的;媒介的;中途的; [n]中间人;仲裁者;调解者;媒介物; [or]gmat;
intermediate: [a]/ˌɪntərˈmiːdiət/; [adj]中间的,居间的;中级的; [n]中间体,媒介物; [v]调解,干涉; [or]gmat;
intermittent: [a]/ˌɪntərˈmɪtənt/; [adj]断断续续的,间歇的; [or]gmat;
internecine: [a]/ˌɪntərˈniːsaɪn/; [adj]互相残杀的,两败俱伤的,内部冲突的; [or]gmat;
interrogate: [a]/ɪnˈterəɡeɪt/; [v]审问,审讯; [or]gmat;
intersect: [a]/ˌɪntərˈsekt/; [v]横截,横断;贯穿;相交;交叉; [or]gmat;
intersection: [a]/ˌɪntərˈsekʃn/; [n]交点,十字路口; [or]gmat;
interstellar: [a]/ˌɪntərˈstelər/; [adj]星际的; [or]gmat;
interval: [a]/ˈɪntərvl/; [n]间隔;中场休息,幕间休息;间距; [or]gmat;
intervention: [a]/ˌɪntərˈvenʃn/; [n]介入;调停;干涉,干预; [or]gmat;
intestinal: [a]/ɪnˈtestɪnl/; [adj]肠的; [or]gmat;
intestine: [a]/ɪnˈtestɪn/; [n]肠; [or]gmat;
intimate: [a]/ˈɪntɪmət/; [adj]亲密的,密切的;详细的; [v]暗示;宣布,通知; [n]密友,知己; [or]gmat;
intracellular: [a]/ˌɪntrə'seljələ/; [adj]细胞内部的; [or]gmat;
intricate: [a]/ˈɪntrɪkət/; [adj]错综复杂的; [or]gmat;
intrigue: [a]/ɪnˈtriːɡ/; [n]阴谋;诡计; [v]密谋;欺骗;引起极大兴趣; [or]gmat;
intriguing: [a]/ɪnˈtriːɡɪŋ/; [adj]迷人的,有迷惑力的,引起兴趣(或好奇心)的; [or]gmat;
intrinsic: [a]/ɪnˈtrɪnsɪk/; [adj]固有的; [or]gmat;
intuition: [a]/ˌɪntuˈɪʃn/; [n]直觉;感觉; [or]gmat;
invade: [a]/ɪnˈveɪd/; [v]侵略;侵犯;侵害;涌入;渗透;侵略,侵犯; [or]gmat;
invalidate: [a]/ɪnˈvælɪdeɪt/; [v]使无效;使无价值; [or]gmat;
inventory: [a]/ˈɪnvəntɔːri/; [n]详细目录;存货清单; [or]gmat;
invertebrate: [a]/ɪnˈvɜːrtɪbrət/; [adj]无脊椎的(动物);没骨气的,懦弱的; [n]无脊椎动物;没骨气的人; [or]gmat;
inverted: [a]/ɪnˈvɜːrtɪd/; [adj]反向的,倒转的,倒置,颠倒; [or]gmat;
inveterate: [a]/ɪnˈvetərət/; [adj]积习已深的,根深蒂固的,长期形成的; [or]gmat;
invigorate: [a]/ɪnˈvɪɡəreɪt/; [v]鼓舞;提神,使精力充沛; [adj]生气勃勃的,精力充沛的,健壮的; [n]滋补;鼓舞; [or]gmat;
invoke: [a]/ɪnˈvoʊk/; [v]调用,祈求,恳求,引起; [or]gmat;
ion: [a]/ˈaɪən/; [n]［物］离子; [or]gmat;
irate: [a]/aɪˈreɪt/; [adj]发怒的,愤怒的; [or]gmat;
iridium: [a]/ɪˈrɪdiəm/; [n]铱; [or]gmat;
ironic: [a]/aɪˈrɑːnɪk/; [adj]讽刺的; [or]gmat;
ironically: [a]/aɪˈrɑːnɪkli/; [adv]讽刺地;出乎意料地; [or]gmat;
irradiation: [a]/ɪˌreɪdiˈeɪʃn/; [n]照射,发光,放射; [or]gmat;
irrational: [a]/ɪˈræʃənl/; [adj]无理性的,失去理性的; [or]gmat;
irreconcilable: [a]/ɪˈrekənsaɪləbl/; [adj]不能妥协的,不能和解的,不能协调的; [n]不能和解的人,(政治上的)死硬派; [or]gmat;
irrelevant: [a]/ɪˈreləvənt/; [adj]不相关的; [or]gmat;
irreversible: [a]/ˌɪrɪˈvɜːrsəbl/; [adj]不能翻转的;不可撤销的;不可逆的; [or]gmat;
irritant: [a]/ˈɪrɪtənt/; [adj]刺激的,刺激性的; [n]<医>刺激物,刺激剂; [or]gmat;
islamic: [a]/ɪzˈlæmɪk/; [adj]伊斯兰教的,穆斯林的; [or]gmat;
isolate: [a]/ˈaɪsəleɪt/; [v]使隔离;使孤立; [adj]孤立的;单独的; [or]gmat;
isolation: [a]/ˌaɪsəˈleɪʃn/; [n]孤独,孤立状态;孤立;隔离;<电>绝缘;<化学>离析; [or]gmat;
isotope: [a]/ˈaɪsətoʊp/; [n]同位素; [or]gmat;
jasper: [a]/'dʒæspə/; [n]［矿］碧玉,墨绿色; [or]gmat;
jawbone: [a]/ˈdʒɔːboʊn/; [v]赊买或借贷; [n]颚骨,牙床骨; [adv]〈美俚〉凭信用地; [or]gmat;
jeopardize: [a]/ˈdʒepərdaɪz/; [v]危及,损害(也作jeopardise); [or]gmat;
jettison: [a]/ˈdʒetɪsn/; [v]向外抛弃,投弃(船舶遇难时投弃货物以为减轻负载); [n]抛弃的货物; [or]gmat;
jolt: [a]/dʒoʊlt/; [n]猛的一击,摇晃,震惊; [v](使)颠簸,摇晃;使震惊; [or]gmat;
judicial: [a]/dʒuˈdɪʃl/; [adj]司法的,法庭的,法律的,审判(上)的; [or]gmat;
judicious: [a]/dʒuˈdɪʃəs/; [adj]有判断力的;明智的; [or]gmat;
jumbo: [a]/ˈdʒʌmboʊ/; [adj]巨大的,特大的; [n]体大而笨拙的人或物;大型喷气式客机;庞然大物; [or]gmat;
jurisdiction: [a]/ˌdʒʊrɪsˈdɪkʃn/; [n]司法权,审判权;管辖权;权限,权力; [or]gmat;
juror: [a]/ˈdʒʊrər/; [n]审查委员,陪审员; [or]gmat;
juvenile: [a]/ˈdʒuːvənl/; [n]青少年;雏鸟; [adj]青少年的;幼稚的; [or]gmat;
juxtapose: [a]/ˌdʒʌkstəˈpoʊz/; [v]使并排;使并置;使并列; [or]gmat;
kelp: [a]/kelp/; [n]海草,巨藻;海草灰(从中可提取碘); [or]gmat;
kidnap: [a]/ˈkɪdnæp/; [v]诱拐;绑架; [or]gmat;
kidney: [a]/ˈkɪdni/; [n]肾,腰子; [or]gmat;
kin: [a]/kɪn/; [n]亲属; [or]gmat;
kinetic: [a]/kɪˈnetɪk/; [adj]运动的; [or]gmat;
kinship: [a]/ˈkɪnʃɪp/; [n]<法>亲属关系,家属关系;亲密关系; [or]gmat;
knack: [a]/næk/; [n]诀窍;本领;熟练技术;巧妙手法; [or]gmat;
lactic: [a]/'læktɪk/; [adj]乳汁的,乳的; [or]gmat;
lag: [a]/læɡ/; [n]落后,延迟; [v]落后;缓慢进行,减退; [or]gmat;
landfill: [a]/ˈlændfɪl/; [n]垃圾堆; [vt]在垃圾填埋地上处理; [or]gmat;
landlocked: [a]/ˈlændlɑːkt/; [adj]被陆地包围的,地处内陆的; [or]gmat;
landscape: [a]/ˈlændskeɪp/; [n]风景;风景画;景观;横向打印格式; [v]美化环境; [or]gmat;
lane: [a]/leɪn/; [n]小径,巷,行车道; [or]gmat;
lapse: [a]/læps/; [n]失误,过失;行为失检;(时间)流逝; [v]退步,倒退,衰退;失效;背弃,放弃(宗教信仰); [or]gmat;
larva: [a]/ˈlɑːrvə/; [n]幼虫,幼体; [or]gmat;
larvae: [a]/'lɑːrviː/; [n]幼虫;幼体; [or]gmat;
laser: [a]/ˈleɪzər/; [n]激光,激光器; [or]gmat;
latch: [a]/lætʃ/; [n]闩,碰锁,弹簧锁; [v]用闩把..闩上; [or]gmat;
lateral: [a]/ˈlætərəl/; [n]侧面部分;支线; [adj]侧面的;横向的; [or]gmat;
latitude: [a]/ˈlætɪtuːd/; [n]纬度;地区;(言论,行动的)自由; [or]gmat;
laudable: [a]/ˈlɔːdəbl/; [adj]值得称赞的; [or]gmat;
laudatory: [a]/ˈlɔːdətɔːri/; [adj]表扬的,赞扬的; [or]gmat;
launch: [a]/lɔːntʃ/; [v]发射;出海;创办,开始从事; [n]发射,投放市场;(游艇,汽艇)下水;发行; [or]gmat;
laurel: [a]/ˈlɔːrəl/; [n]月桂树,桂冠,殊荣; [v]使戴桂冠;给以荣誉; [or]gmat;
laxity: [a]/ˈlæksəti/; [n]松弛,放纵; [or]gmat;
lay sb. off: [a]/leɪ ˈsʌmbədi ɑf/; [v]解雇;关闭;停止活动; [n](临时)解雇期; [or]gmat;
lease: [a]/liːs/; [v]出租,租得; [n]租约,租契; [or]gmat;
leaven: [a]/ˈlevn/; [n]发酵剂,影响力; [v]发酵,影响,渐变; [or]gmat;
leery: [a]/ˈlɪri/; [adj]机警的,狡猾的; [or]gmat;
leeway: [a]/ˈliːweɪ/; [n]［海］［空］风压差;余地; [or]gmat;
legislature: [a]/ˈledʒɪsleɪtʃər/; [n]立法机关,立法机构; [or]gmat;
legitimate: [a]/lɪˈdʒɪtɪmət/; [adj]合法的;合理的; [vt]使合法;授权;宣布..为合法; [or]gmat;
length: [a]/leŋθ/; [n]长,长度,持续时间;一段 (绳子,布,木头等); [or]gmat;
lessen: [a]/ˈlesn/; [v]减少;减轻; [or]gmat;
lethal: [a]/ˈliːθl/; [adj]致命的,致死的;杀伤性的; [n]致死因子; [or]gmat;
letup: [a]/'letˌʌp/; [n]放松,停顿; [or]gmat;
leukemia: [a]/luː'kiːmɪə/; [n]<医>白血病; [or]gmat;
lever: [a]/ˈlevər/; [n]杠杆;控制杆;施加影响的手段; [v]用杠杆移动;撬开; [or]gmat;
levy: [a]/ˈlevi/; [v]征收(税等); [n]征税;税款; [or]gmat;
lexicographer: [a]/ˌleksɪˈkɑːɡrəfər/; [n]词典编纂人; [or]gmat;
liability: [a]/ˌlaɪəˈbɪləti/; [n]责任;债务;倾向;可能性;不利因素;惹麻烦的人(或事); [or]gmat;
liable: [a]/ˈlaɪəbl/; [adj](for)有责任的;有义务的;(to)有.倾向的;易于.的,有可能.; [or]gmat;
liken: [a]/ˈlaɪkən/; [v]把..比作,比拟; [or]gmat;
limestone: [a]/ˈlaɪmstoʊn/; [n]<地质学>石灰岩;石灰石; [or]gmat;
linear: [a]/ˈlɪniər/; [adj]线的,线性的;直线的;长度的; [or]gmat;
lingo: [a]/ˈlɪŋɡoʊ/; [n]外国话(贬义),行话,方言,隐语; [or]gmat;
linguist: [a]/ˈlɪŋɡwɪst/; [n]语言学家;会多国语言的人; [or]gmat;
linguistics: [a]/lɪŋˈɡwɪstɪks/; [n]语言学; [or]gmat;
lionize: [a]/ˈlaɪənaɪz/; [v]崇拜,把..奉为名人; [or]gmat;
lipid: [a]/ˈlɪpɪd/; [n]脂质,油脂; [or]gmat;
liquidation: [a]/ˌlɪkwɪˈdeɪʃn/; [n](公司等的)清理,清算,(债务的)清偿,了结; [v]破坏,毁灭,杀掉; [or]gmat;
liquidator: [a]/ˈlɪkwɪdeɪtər/; [n]清算人; [or]gmat;
list price: [a]/ˈlɪst praɪs/; [phr]目录价格,标价; [or]gmat;
listless: [a]/ˈlɪstləs/; [adj]无精打采的,倦怠的,情绪低落的;冷漠的; [or]gmat;
literacy: [a]/ˈlɪtərəsi/; [n]读写能力;识字;有文化;教养; [or]gmat;
live show: [a]/lɪv ʃoʊ/; [n]现场表演; [or]gmat;
livelihood: [a]/ˈlaɪvlihʊd/; [n]生活,生计;谋生方式; [or]gmat;
liver: [a]/ˈlɪvər/; [n]肝脏;(供食用的动物)肝脏; [or]gmat;
livestock: [a]/ˈlaɪvstɑːk/; [n]家畜,牲畜; [or]gmat;
lizard: [a]/ˈlɪzərd/; [n]蜥蜴; [or]gmat;
loaf: [a]/loʊf/; [n](一条)面包; [v]虚度光阴; [or]gmat;
lobby: [a]/ˈlɑːbi/; [n]门厅,大厅;休息室;游说团;投票厅; [vt]向(议员,政府官员等)进行游说(或疏通); [or]gmat;
lobbyist: [a]/ˈlɑːbiɪst/; [n]院外活动集团的成员,说客; [or]gmat;
lobe: [a]/loʊb/; [n]耳垂,波瓣,(脑,肺等的)叶,裂片; [or]gmat;
lobster: [a]/ˈlɑːbstər/; [n]龙虾; [v]捕龙虾; [or]gmat;
locomotion: [a]/ˌloʊkəˈmoʊʃn/; [n]运动;移动;旅行; [or]gmat;
lodge: [a]/lɑːdʒ/; [v]住宿;存放,保管; [n]小屋;兽穴; [or]gmat;
logotype: [a]/'lɒgəˌtaɪp/; [n]［印］连合活字,广告等用的标识; [or]gmat;
longevity: [a]/lɔːnˈdʒevəti/; [n]长寿,长命;寿命; [or]gmat;
loom: [a]/luːm/; [n]织布机; [v]阴森地逼近;隐现;即将来临; [or]gmat;
lore: [a]/lɔːr/; [n]传说;(专门的)知识,学问; [or]gmat;
lot: [a]/lɑːt/; pro[n]大量,许多;场地;一批;某一类人; [adv](与形容词和副词连用)很;非常;(与动词连用)非常; [v]分组;把.划分(常与out连用);把(土地)划分成块;抽签;拈阄; [or]gmat;
lounge: [a]/laʊndʒ/; [n]候机室,休息室,酒吧间;沙发,躺椅;懒散的步子; [v](懒散地)倚,躺;闲逛; [or]gmat;
lucrative: [a]/ˈluːkrətɪv/; [adj]合算的;获利的;有利可图的; [or]gmat;
lumber: [a]/ˈlʌmbər/; [v]缓慢地移动;拖累,迫使担负;伐木;杂乱地堆积;隆隆地行进; [n]木材;废旧家具,不用的大件物品;无用的杂物;隆隆声; [or]gmat;
luminescence: [a]/ˌluːmɪˈnesns/; [n]发光; [or]gmat;
luminosity: [a]/ˌluːmɪˈnɑːsəti/; [n]光明,发光体;发光度; [or]gmat;
lump: [a]/lʌmp/; [n]团;肿块;粗笨的人;一小方块 (糖); [v]成团,成堆;使成块; [or]gmat;
lunar: [a]/ˈluːnər/; [adj]月亮的; [or]gmat;
lure: [a]/lʊr/; [v]引诱;以诱饵吸引; [n]诱惑力;诱惑物;鱼饵; [or]gmat;
lush: [a]/lʌʃ/; [adj]草木茂盛的,多的,丰富豪华的; [n]酒;醉汉; [or]gmat;
lymph: [a]/lɪmf/; [n]［医］淋巴,淋巴液,(淋巴液似的)浆,苗; [or]gmat;
lyrical: [a]/ˈlɪrɪkl/; [adj]抒情诗调的;感情丰富的;充满愉悦的; [or]gmat;
macaque: [a]/məˈkæk/; [n]猕猴,恒河猴,短尾猴; [or]gmat;
magnesium: [a]/mæɡˈniːziəm/; [n]镁; [or]gmat;
magnet: [a]/ˈmæɡnət/; [n]磁体,磁铁; [or]gmat;
magnetic: [a]/mæɡˈnetɪk/; [adj]有磁性的;有吸引力的; [or]gmat;
magnitude: [a]/ˈmæɡnɪtuːd/; [n]巨大;震级;重要性;<数>量值; [or]gmat;
maim: [a]/meɪm/; [v]使残废; [or]gmat;
mainstream: [a]/ˈmeɪnstriːm/; [n]主流,主要倾向; [v]使.成为主流;将(残障儿童等)纳入正规班级; [adj]主流的; [or]gmat;
maize: [a]/meɪz/; [n]玉米; [adj]黄色的,玉米色的; [or]gmat;
maladaptive: [a]/ˌmælə'dæptɪv/; [adj]不适应的; [or]gmat;
malady: [a]/ˈmælədi/; [n]疾病,弊病; [or]gmat;
malaria: [a]/məˈleriə/; [n]瘴气;疟疾; [or]gmat;
malfunction: [a]/ˌmælˈfʌŋkʃn/; [v]发生故障;不起作用; [n]故障;失灵;疾病; [or]gmat;
malleable: [a]/ˈmæliəbl/; [adj](金属)可锻的;有延展性的;(性格)可训练的;易适应的; [or]gmat;
mandatory: [a]/ˈmændətɔːri/; [adj]命令的,强制性的; [or]gmat;
maneuver: [a]/məˈnʊvər/; [v]操纵; [n]操纵;花招;调遣;策略; [or]gmat;
manipulate: [a]/məˈnɪpjuleɪt/; [v]操纵,影响;正骨; [or]gmat;
mannerism: [a]/ˈmænərɪzəm/; [n](说话,举止等的)习气,癖性,矫揉造作; [or]gmat;
mantle: [a]/ˈmæntl/; [n]外壳;披风;地幔; [v]覆盖; [or]gmat;
manual: [a]/ˈmænjuəl/; [n]手册;指南; [adj]手的;手制的;手工的;体力的; [or]gmat;
manufacture: [a]/ˌmænjuˈfæktʃər/; [v]生产;制造; [n]制造,生产;制造业;(复)产品; [or]gmat;
manuscript: [a]/ˈmænjuskrɪpt/; [n]手稿;底稿;手抄本; [or]gmat;
margin: [a]/ˈmɑːrdʒən/; [n]页边的空白,边缘;优势;利润; [or]gmat;
marginal: [a]/ˈmɑːrdʒɪnl/; [adj]微小的,不重要的;仅以微弱多数票获胜的; [n](议会或地方委员会的)边缘席位; [or]gmat;
marijuana: [a]/ˌmærəˈwɑːnə/; [n]大麻,大麻中的毒质; [or]gmat;
marine: [a]/məˈriːn/; [adj]海洋的,航海的,海产的,海军的; [n]海军士兵; [or]gmat;
marital: [a]/ˈmærɪtl/; [adj]婚姻的; [or]gmat;
mark down: [a]/mɑrk daʊn/; [v]降价; [n]降价; [or]gmat;
mark up: [a]/mɑːrk ʌp/; [phr]标记;加价;提高分数; [or]gmat;
marrow: [a]/ˈmæroʊ/; [n]骨髓,精华; [or]gmat;
marshy: [a]/ˈmɑːrʃi/; [adj]沼泽的;湿地的; [or]gmat;
martial: [a]/ˈmɑːrʃl/; [adj]武术的;好战的;军事的; [or]gmat;
masculine: [a]/ˈmæskjəlɪn/; [adj]男性的;男子气概的; [or]gmat;
masculinity: [a]/ˌmæskjuˈlɪnəti/; [n]男性(气概); [or]gmat;
mask: [a]/mæsk/; [n]面具;遮蔽物;伪装; [v]隐藏(感情);掩盖,掩饰,掩护;伪装; [or]gmat;
mason: [a]/ˈmeɪsn/; [n]泥瓦匠,共济会会员(等于freemason); [or]gmat;
mass: [a]/mæs/; [n]众多;大多数;<物>质量;群众; [adj]大量的,大规模的; [v]聚集; [or]gmat;
maternal: [a]/məˈtɜːrnl/; [adj]母亲的,母性的;母方的,母系的; [or]gmat;
matrix: [a]/ˈmeɪtrɪks/; [n]<数>矩阵,模子; [or]gmat;
mature: [a]/məˈtʃʊr/; [adj]成熟的;到期的; [vt]使成熟; [vi]成熟; [or]gmat;
maxim: [a]/ˈmæksɪm/; [n]格言;准则;座右铭; [or]gmat;
maximum: [a]/ˈmæksɪməm/; [n]最大值;最大限度; [adj]最大的; [or]gmat;
meander: [a]/miˈændər/; [n]蜿蜒曲折,迂回曲折的旅程;漫步; [v]迂回曲折;漫步;漫谈; [or]gmat;
measles: [a]/ˈmiːzlz/; [n]<医>麻疹; [or]gmat;
mechanism: [a]/ˈmekənɪzəm/; [n]机械装置;机制,机理,原理; [or]gmat;
median: [a]/ˈmiːdiən/; [n]中值,中位数;中线; [adj]中值的;中央的; [or]gmat;
mediate: [a]/ˈmiːdieɪt/; [v]调解,调停,斡旋; [or]gmat;
medication: [a]/ˌmedɪˈkeɪʃn/; [n]药物;药物治疗;药物处理; [or]gmat;
medieval: [a]/ˌmediˈiːvl/; [adj]中世纪的,中古(时代)的; [or]gmat;
medium: [a]/ˈmiːdiəm/; [adj]中等的;适中的; [n]手段;媒介;材料; [or]gmat;
meek: [a]/miːk/; [adj]温顺的,逆来顺受的;谦恭的; [n]温顺的人;谦恭的人; [or]gmat;
megalithic: [a]/ˌmeɡəˈlɪθɪk/; [adj]巨石制的,有巨石物征的; [or]gmat;
melancholy: [a]/ˈmelənkɑːli/; [n]忧郁,悲哀; [adj]忧郁的,令人伤感的; [or]gmat;
membrane: [a]/ˈmembreɪn/; [n]膜;薄膜;羊皮纸; [or]gmat;
memento: [a]/məˈmentoʊ/; [n]纪念品; [or]gmat;
memoir: [a]/ˈmemwɑːr/; [n]回忆录,自传(memoirs);传略; [or]gmat;
merchant: [a]/ˈmɜːrtʃənt/; [n]商人;批发商; [or]gmat;
metamorphose: [a]/ˌmetəˈmɔːrfoʊz/; [v]使变形,使变质; [or]gmat;
metaphor: [a]/ˈmetəfər/; [n]暗喻,隐喻; [or]gmat;
meteor: [a]/ˈmiːtiər/; [n]流星,大气现象; [or]gmat;
meteorite: [a]/ˈmiːtiəraɪt/; [n]流星;陨星; [or]gmat;
meteorologist: [a]/ˌmiːtiəˈrɑːlədʒɪst/; [n]气象学者; [or]gmat;
methane: [a]/ˈmeθeɪn/; [n]<有化>甲烷,<能源>沼气; [or]gmat;
methodology: [a]/ˌmeθəˈdɑːlədʒi/; [n]方法论,方法学;(某一学科的)一套方法; [or]gmat;
metric: [a]/ˈmetrɪk/; [adj]米制的,公制的; [n]度量标准;<数学>度量;诗体,韵文,诗韵; [or]gmat;
metropolitan: [a]/ˌmetrəˈpɑːlɪtən/; [adj]大城市的,大都会的;大主教区的; [or]gmat;
microbe: [a]/ˈmaɪkroʊb/; [n]微生物;细菌; [or]gmat;
microscopic: [a]/ˌmaɪkrəˈskɑːpɪk/; [adj]极小的;用显微镜可见的; [or]gmat;
migraine: [a]/ˈmaɪɡreɪn/; [n]［法］［医］周期性偏头痛; [or]gmat;
migrant: [a]/ˈmaɪɡrənt/; [n]候鸟;移民; [or]gmat;
mileage: [a]/ˈmaɪlɪdʒ/; [n]英里数; [or]gmat;
milieu: [a]/mɪlˈjuː/; [n]周围环境;背景;周围;出身背景; [or]gmat;
millennium: [a]/mɪˈleniəm/; [n]千禧年;太平盛世; [or]gmat;
mimic: [a]/ˈmɪmɪk/; [v]模仿,戏弄; [n]模仿者; [adj]模拟的;假的,伪装的; [or]gmat;
mingle: [a]/ˈmɪŋɡl/; [v]使混合,使相混; [vi]相交往,相往来; [or]gmat;
miniature: [a]/ˈmɪnətʃər/; [adj]小型的,微小的; [n]微小的模型,缩影,微型人物像; [vt]使成小型;把.画成纤细画;缩写; [or]gmat;
minimum: [a]/ˈmɪnɪməm/; [adj]最少的,最低程度的; [n]最低限度,最小量; [or]gmat;
mint: [a]/mɪnt/; [n]薄荷,薄荷糖,造币厂; [v]铸造(硬币); [or]gmat;
minus: [a]/ˈmaɪnəs/; prep. 减(去); [adj]负的; [n]减号;劣势; [or]gmat;
minute: [a]/ˈmɪnɪt/; [adj]微小的;详细的; [n]一分钟,瞬间; [v]记录; [or]gmat;
miracle: [a]/ˈmɪrəkl/; [n]奇迹; [or]gmat;
mishap: [a]/ˈmɪshæp/; [n]不幸的事,灾祸;晦气; [or]gmat;
misrepresent: [a]/ˌmɪsˌreprɪˈzent/; [vi]作虚假陈述; [vt]歪曲;误传; [or]gmat;
missile: [a]/ˈmɪsl/; [n]导弹;投射出的物体或武器; [adj]导弹的;可投掷的;用以发射导弹的; [or]gmat;
mite: [a]/maɪt/; [n]极小量,小虫; [or]gmat;
mitigate: [a]/ˈmɪtɪɡeɪt/; [v]减轻,缓和; [or]gmat;
mob: [a]/mɑːb/; [n]乌合之众,(尤指)暴民; [v](指民众)包围(为攻击或赞赏); [or]gmat;
mobility: [a]/moʊˈbɪləti/; [n]活动性,灵活性,迁移率,机动性; [or]gmat;
modem: [a]/ˈmoʊdem/; [n]调制解调器; [v]<计>通过调制解调器向.发送电子邮件;用调制解调器联通; [or]gmat;
modest: [a]/ˈmɑːdɪst/; [adj]谦虚的,谦逊的;端庄的,羞怯的;不太大(或太贵,太重要)的,适度的; [or]gmat;
modification: [a]/ˌmɑːdɪfɪˈkeɪʃn/; [n]修改,改进,改造; [or]gmat;
modify: [a]/ˈmɑːdɪfaɪ/; [v]改装,修改,更改;修饰,限定; [or]gmat;
mold: [a]/moʊld/; [vt]塑造;使形成; [v]把..塑造成; [n]霉菌;模子;气质; [or]gmat;
mole: [a]/moʊl/; [n]<动>鼹鼠;黑痣;<化>克分子(量),摩尔;长期潜伏的间谍,内奸;防波堤; [or]gmat;
molecule: [a]/ˈmɑːlɪkjuːl/; [n]分子,微粒; [or]gmat;
molten: [a]/ˈmoʊltən/; [adj]熔化的; [or]gmat;
monarch: [a]/ˈmɑːnərk/; [n]君主;帝王;统治者; [or]gmat;
monitor: [a]/ˈmɑːnɪtər/; [n]显示器;监视器;班长; [v]监视;监督;监测; [or]gmat;
monochrome: [a]/ˈmɑːnəkroʊm/; [adj]单色的; [n]单色画;单色照片,黑白照片; [or]gmat;
monopoly: [a]/məˈnɑːpəli/; [n]垄断;专卖;垄断商品;专卖商品; [or]gmat;
monotonous: [a]/məˈnɑːtənəs/; [adj]单调的,无聊的; [or]gmat;
monsoon: [a]/ˌmɑːnˈsuːn/; [n]季雨,季风,大雨; [or]gmat;
morale: [a]/məˈræl/; [n]士气,斗志; [or]gmat;
morphine: [a]/ˈmɔːrfiːn/; [n]吗啡; [or]gmat;
mortality: [a]/mɔːrˈtæləti/; [n]死亡数,死亡率;必死的命运; [or]gmat;
mortgage: [a]/ˈmɔːrɡɪdʒ/; [n]按揭贷款,抵押贷款; [v]抵押; [or]gmat;
mosaic: [a]/moʊˈzeɪɪk/; [n]镶嵌细工,马赛克; [adj]摩西的;拼花的; [vt]镶嵌;用马赛克装饰; [or]gmat;
mosque: [a]/mɑːsk/; [n]伊斯兰教寺院;清真寺; [or]gmat;
mosquito: [a]/məˈskiːtoʊ/; [n]蚊子; [or]gmat;
moth: [a]/mɔːθ/; [n]蛾; [or]gmat;
motion: [a]/ˈmoʊʃn/; [n]运动,移动;手势;提议; [v]示意; [or]gmat;
mound: [a]/maʊnd/; [n]堆,高地,护堤; [v]堆起,积成堆; [or]gmat;
mount: [a]/maʊnt/; [v]登上;爬上;骑上;增长;组织,安排; [n]山;峰; [or]gmat;
movement: [a]/ˈmuːvmənt/; [n]动作,移动;运动;(交响乐)乐章; [or]gmat;
mow: [a]/moʊ/; [n]干草堆;谷堆; [v]刈,收割庄稼;扫除,扫倒; [or]gmat;
multiple: [a]/ˈmʌltɪpl/; [adj]多重的,复合的,倍数的; [n]倍数; [or]gmat;
multiplier: [a]/ˈmʌltɪplaɪər/; [n]乘数; [or]gmat;
multiply: [a]/ˈmʌltɪplaɪ/; [v]乘;繁殖;增加; [or]gmat;
multitude: [a]/ˈmʌltɪtuːd/; [n]大量;众多;大批;群众; [or]gmat;
mundane: [a]/mʌnˈdeɪn/; [adj]普通的,平凡的;单调的;现世的,世俗的; [or]gmat;
mural: [a]/ˈmjʊrəl/; [n]壁画;壁饰; [adj]墙壁的;挂在墙壁上的; [or]gmat;
mutation: [a]/mjuːˈteɪʃn/; [n]变化,突变;变异; [or]gmat;
mute: [a]/mjuːt/; [n]弱音器; [adj]缄默的;哑的; [vt]减弱.的声音; [or]gmat;
mutiny: [a]/ˈmjuːtəni/; [n]兵变,叛乱,暴动; [v]反叛,暴动,参加叛乱; [or]gmat;
mutual: [a]/ˈmjuːtʃuəl/; [adj]互相的;彼此的;共同的; [or]gmat;
myopic: [a]/maɪˈɑːpɪk/; [n]近视; [adj]近视的;目光短浅的; [or]gmat;
mystic: [a]/ˈmɪstɪk/; [adj]神秘的,神秘主义的; [n]神秘主义者; [or]gmat;
mythological: [a]/ˌmɪθəˈlɑːdʒɪkl/; [adj]神话的,虚构的; [or]gmat;
mythology: [a]/mɪˈθɑːlədʒi/; [n]神话,神话学; [or]gmat;
nadir: [a]/ˈneɪdɪr/; [n]最低点,无底; [or]gmat;
narcissistic: [a]/ˌnɑːrsɪˈsɪstɪk/; [adj]自我陶醉的,自恋的; [or]gmat;
narrator: [a]/ˈnæreɪtər/; [n]叙述者;解说员; [or]gmat;
natal: [a]/ˈneɪtl/; [adj]出生的;分娩的;与生俱来的; [or]gmat;
natural number: [a]/ˌnætʃrəl ˈnʌmbər/; [phr]自然数; [or]gmat;
naval: [a]/ˈneɪvl/; [adj]海军的,军舰的; [or]gmat;
navigation: [a]/ˌnævɪˈɡeɪʃn/; [n]导航,航行,航海; [or]gmat;
navy: [a]/ˈneɪvi/; [n]海军; [or]gmat;
needy: [a]/ˈniːdi/; [adj]贫困的;贫穷的;生活艰苦的; [or]gmat;
negative: [a]/ˈneɡətɪv/; [adj]消极的,负面的;否定的; [n]否定,否定词;底片; [or]gmat;
negligence: [a]/ˈneɡlɪdʒəns/; [n]疏忽; [or]gmat;
negotiate: [a]/nɪˈɡoʊʃieɪt/; [v]谈判,交涉,商议;成功越过,渡过; [or]gmat;
neologism: [a]/niˈɑːlədʒɪzəm/; [n]新生词; [or]gmat;
neonate: [a]/ˈniːoʊneɪt/; [n]初生婴儿; [or]gmat;
neural: [a]/ˈnʊrəl/; [adj]神经的;神经系统的;背的;神经中枢的; [or]gmat;
neuroleptic: [a]/ˌnjʊəˌnʊrə'leptɪk/; [adj]抑制精神的,安定的; [n]安定药,精神抑制药; [or]gmat;
neuron: [a]/ˈnʊrɑːn/; [n]神经元,神经细胞; [or]gmat;
neutral: [a]/ˈnuːtrəl/; [adj]中立的;中性的; [n]中立国;中性色; [or]gmat;
neutrino: [a]/nuːˈtriːnoʊ/; [n]中微子; [or]gmat;
neutron: [a]/ˈnuːtrɑːn/; [n]中子; [or]gmat;
nexus: [a]/ˈneksəs/; [n]关系;连结; [or]gmat;
niche: [a]/nɪtʃ/; [n]壁龛;合适的职业,生活方式;(有利可图的)市场,商机; [vt]放在适当的位置; [or]gmat;
nickel: [a]/ˈnɪkl/; [n]镍;美国五分镍币;五分钱; [or]gmat;
nicotine: [a]/ˈnɪkətiːn/; [n]尼古丁; [or]gmat;
nitric: [a]/'naɪtrɪk/; [adj]氮的,含氮的; [or]gmat;
nitrogen: [a]/ˈnaɪtrədʒən/; [n]氮; [or]gmat;
nocturnal: [a]/nɑːkˈtɜːrnl/; [adj]夜晚的,夜间发生的; [or]gmat;
nomad: [a]/ˈnoʊmæd/; [n]流浪者,游牧民; [adj]游牧的;流浪的; [or]gmat;
nominate: [a]/ˈnɑːmɪneɪt/; [v]提名;任命; [adj]有特定名字的;被提名的;被指定的; [or]gmat;
noncommittal: [a]/ˌnɒnkə'mɪtəl/; [adj]态度不明朗的;不承担义务的;无明确意义的; [or]gmat;
nostalgia: [a]/nəˈstældʒə/; [n]怀旧之情,思乡病; [or]gmat;
note: [a]/noʊt/; [n]笔记,便条,注释;纸币;音符; [v]注意,记录; [or]gmat;
notify: [a]/ˈnoʊtɪfaɪ/; [v]通知,告知;报告; [or]gmat;
notorious: [a]/noʊˈtɔːriəs/; [adj]臭名昭著的,声名狼藉的; [or]gmat;
novel: [a]/ˈnɑːvl/; [n]小说,长篇故事; [adj]新奇的,新颖的,不同的; [or]gmat;
novelty: [a]/ˈnɑːvlti/; [n]新奇;新奇的事物;新颖小巧而廉价的小物品; [adj]新奇的;风格独特的; [or]gmat;
novice: [a]/ˈnɑːvɪs/; [n]生手,新手; [or]gmat;
novocaine: [a]/ˈnoʊvəkeɪn/; [n]奴佛卜因(一种麻醉药); [or]gmat;
noxious: [a]/ˈnɑːkʃəs/; [adj]有害的,有毒的; [or]gmat;
nuance: [a]/ˈnuːɑːns/; [n]细微差别; [or]gmat;
nuclear: [a]/ˈnuːkliər/; [adj]原子核的;原子能的;细胞核的; [or]gmat;
nucleus: [a]/ˈnuːkliəs/; [n]原子核,核心,细胞核; [or]gmat;
null: [a]/nʌl/; [adj]无效的;不存在的; [n]零; [or]gmat;
nutrition: [a]/nuˈtrɪʃn/; [n]营养,营养学; [or]gmat;
nutritious: [a]/nuˈtrɪʃəs/; [adj]有营养的,滋养的; [or]gmat;
nylon: [a]/ˈnaɪlɑːn/; [n]尼龙,尼龙长袜; [or]gmat;
oatmeal: [a]/ˈoʊtmiːl/; [n]燕麦片,燕麦粥; [or]gmat;
oats: [a]/oʊts/; [n]燕麦,燕麦片,燕麦粥; [or]gmat;
obedience: [a]/oʊˈbiːdiəns/; [n]服从,顺从; [or]gmat;
obeisance: [a]/oʊˈbiːsns/; [n]鞠躬,敬礼;尊敬; [or]gmat;
obese: [a]/oʊˈbiːs/; [adj]肥胖的;过胖的; [or]gmat;
obesity: [a]/oʊˈbiːsəti/; [n]肥胖; [or]gmat;
obituary: [a]/oʊˈbɪtʃueri/; [n]讣告; [adj]关于死者的,讣告的; [or]gmat;
objective: [a]/əbˈdʒektɪv/; [n]目标;目的; [adj]客观的; [or]gmat;
obligatory: [a]/əˈblɪɡətɔːri/; [adj]强制性的;义务的;必须的; [or]gmat;
oblique: [a]/əˈbliːk/; [adj]斜的,非直角的,隐射的; [v]倾斜; [n]<解>斜肌(尤指腹部的肌肉);倾斜物;<军>倾斜航空照片; [adv]<军>以45度角; [or]gmat;
obnoxious: [a]/əbˈnɑːkʃəs/; [adj]非常讨厌的;可憎的; [or]gmat;
obscure: [a]/əbˈskjʊr/; [v]隐藏,使.模糊;使变暗;遮掩; [adj]不清楚的;难以理解的; [n]某种模糊的或不清楚的东西; [or]gmat;
observatory: [a]/əbˈzɜːrvətɔːri/; [n]天文台,气象台,瞭望台; [or]gmat;
obsess: [a]/əbˈses/; [vt]迷住,使着迷,使烦扰; [or]gmat;
obsidian: [a]/əbˈsɪdiən/; [n]黑曜石; [or]gmat;
obsolescence: [a]/ˌɑːbsəˈlesns/; [n]即将过时; [or]gmat;
obstacle: [a]/ˈɑːbstəkl/; [n]障碍;障碍物;妨碍; [or]gmat;
obstetrical: [a]/əb'stetrɪkl/; [adj]产科(学)的,助产的; [or]gmat;
obtrusive: [a]/əbˈtruːsɪv/; [adj]突出的,爱管闲事的,冒失的,强迫人的; [or]gmat;
obviate: [a]/ˈɑːbvieɪt/; [v]排除,避免,消除; [or]gmat;
occupy: [a]/ˈɑːkjupaɪ/; [v]占领,占据,侵占;住在,居住,住进;担任(职务),任职;占用(时间,空间等),占有;使用(房屋,建筑); [or]gmat;
ocher: [a]/'oʊkə/; [n]［矿］赭石,(黄)褐色; [or]gmat;
odd number: [a]/ɑd ˈnʌmbər/; [phr]奇数; [or]gmat;
odd: [a]/ɑːd/; [adj]奇怪的;古怪的;奇数的;多种多样的;临时的; [n]奇特的事物;怪人;<高尔夫球>多于对方的一次击球; [adv](用于数字后)大约,左右,略多; [or]gmat;
odds: [a]/ɑːdz/; [n]几率;可能性;投注赔率;优势;差异,不平等; [or]gmat;
odometer: [a]/oʊˈdɑːmɪtər/; [n](汽车的)里程表,<车辆>里程; [or]gmat;
odor: [a]/ˈoʊdər/; [n]气味; [or]gmat;
off-the-shelf: [a]/ˌɔːf ðə ˈʃelf/; [adj](货品)现成常备的,非定制的; [adv]现成地,无需作重大修改地; [or]gmat;
offset: [a]/ˈɔːfset/; [v]抵消; [adj]胶印的,透印版印刷的; [n]分支;抵销; [or]gmat;
offshoot: [a]/ˈɔːfʃuːt/; [n]分支,支流,衍生物; [or]gmat;
offspring: [a]/ˈɔːfsprɪŋ/; [n]后代; [or]gmat;
olfactory: [a]/ɑːlˈfæktəri/; [adj]嗅觉的; [or]gmat;
omen: [a]/ˈoʊmən/; [n]征兆,预兆; [vt]预示;预告;有.的前兆; [or]gmat;
omission: [a]/əˈmɪʃn/; [n]省略;遗漏,疏忽; [or]gmat;
omnipotent: [a]/ɑːmˈnɪpətənt/; [adj]全能的,万能的; [n]全能者; [or]gmat;
ongoing: [a]/ˈɑːnɡoʊɪŋ/; [n]进行,前进,发展; [adj]进行中的,不间断的; [or]gmat;
onset: [a]/ˈɑːnset/; [n]开始;攻击,袭击; [or]gmat;
opaque: [a]/oʊˈpeɪk/; [adj]不透明的;难懂的; [or]gmat;
optical: [a]/ˈɑːptɪkl/; [adj]光学的;视觉的; [or]gmat;
optimal: [a]/ˈɑːptɪməl/; [adj]最佳的,最理想的; [or]gmat;
optimism: [a]/ˈɑːptɪmɪzəm/; [n]乐观,乐观主义; [or]gmat;
optimum: [a]/ˈɑːptɪməm/; [adj]最适宜的;最佳的; [n]最适条件;最适宜; [or]gmat;
optometrist: [a]/ɑːpˈtɑːmətrɪst/; [n]配镜师,验光师; [or]gmat;
opulent: [a]/ˈɑːpjələnt/; [adj]富裕的,充足的; [or]gmat;
orchestra: [a]/ˈɔːrkɪstrə/; [n]管弦乐队; [adj]管弦乐队的; [or]gmat;
ordinance: [a]/ˈɔːrdɪnəns/; [n]法令;条例;条例;圣餐式; [or]gmat;
ordinate: [a]/ˈɔːrdɪnət/; [n]纵坐标; [or]gmat;
ore: [a]/ɔːr/; [n]矿石;矿砂;矿,矿石; [or]gmat;
organelle: [a]/ˌɔːgə'nel/; [n]［生］细胞器; [or]gmat;
organism: [a]/ˈɔːrɡənɪzəm/; [n]生物,有机体;有机的组织; [or]gmat;
orientation: [a]/ˌɔːriənˈteɪʃn/; [n]信仰;倾向;<计>定向;(学生)迎新会;定向,方向;(任职,上学等之前的) 情况介绍;训练; [or]gmat;
originality: [a]/əˌrɪdʒəˈnæləti/; [n]创造性;独创性; [or]gmat;
originate: [a]/əˈrɪdʒɪneɪt/; [vi]起源;开始; [vt]开创; [or]gmat;
ornamentation: [a]/ˌɔːrnəmenˈteɪʃn/; [n]装饰品; [or]gmat;
orthodox: [a]/ˈɔːrθədɑːks/; [adj]正统的;传统的;(Orthodox)东正教的; [or]gmat;
osprey: [a]/ˈɑːspreɪ/; [n]［动］鹗,鱼鹰;白色装饰羽毛; [or]gmat;
ostensible: [a]/ɑːˈstensəbl/; [adj]表面上的,伪装的; [or]gmat;
ostentation: [a]/ˌɑːstenˈteɪʃn/; [n]卖弄,炫耀; [or]gmat;
oust: [a]/aʊst/; [v]罢免,驱逐,剥夺,取代; [or]gmat;
outcome: [a]/ˈaʊtkʌm/; [n]结果,后果; [or]gmat;
outdated: [a]/ˌaʊtˈdeɪtɪd/; [adj]过时的,老式的;落伍的; [or]gmat;
outdistance: [a]/ˌaʊtˈdɪstəns/; [v](指赛跑或竞争中)把..远远抛在后面,大大超越; [or]gmat;
outfit: [a]/ˈaʊtfɪt/; [n]装备,全部用品,(协同工作)的一组人; [v]提供装备; [or]gmat;
outgrowth: [a]/ˈaʊtɡroʊθ/; [n]结果;副产物;自然的发展;分枝; [or]gmat;
outlaw: [a]/ˈaʊtlɔː/; [n]歹徒,逃犯,丧失公权者; [v]将..放逐,宣布..为不合法; [or]gmat;
outlay: [a]/ˈaʊtleɪ/; [v]花费; [n]<会计>费用;支出;经费; [or]gmat;
outlet: [a]/ˈaʊtlet/; [n]出口;插座;表现机会,发泄方法;廉价经销店; [or]gmat;
outline: [a]/ˈaʊtlaɪn/; [n]外形,轮廓;大纲,概要; [v]描绘,画出..的轮廓; [or]gmat;
outlying: [a]/ˈaʊtlaɪɪŋ/; [adj]远离中心的;边远的; [or]gmat;
outmoded: [a]/ˌaʊtˈmoʊdɪd/; [adj]不再流行的,过时的; [or]gmat;
outnumber: [a]/ˌaʊtˈnʌmbər/; [v]在数量上超过; [or]gmat;
output: [a]/ˈaʊtpʊt/; [n]产量,输出; [vt]生产,出产,制造;输出; [vi]生产,出产,制造;输出; [or]gmat;
outrage: [a]/ˈaʊtreɪdʒ/; [n]残暴;暴行,愤怒; [v]使震怒,使愤慨; [or]gmat;
outrageous: [a]/aʊtˈreɪdʒəs/; [adj]粗暴的,无礼的; [or]gmat;
outright: [a]/ˈaʊtraɪt/; [adj]完全的,彻底的,全部地;直率的; [adv]完全地;直率地,痛快地;直截了当地; [or]gmat;
outstrip: [a]/ˌaʊtˈstrɪp/; [v]比.优越,胜过,比.跑得快; [or]gmat;
oval: [a]/ˈoʊvl/; [adj]椭圆形的; [n]椭圆形; [or]gmat;
ovarian: [a]/oʊˈveriən/; [adj]［解］卵巢的,［植］子房的; [or]gmat;
overall: [a]/ˌoʊvərˈɔːl/; [adj]全面的,全部的; [n]罩衫,工装裤; [adv]总的来说;总共; [or]gmat;
overflow: [a]/ˌoʊvərˈfloʊ/; [v]满得外溢,外流,泛滥;充满,洋溢; [n]溢流口,溢流管;容纳不下的物(或人);溢出,满出;超出额; [adj]充满的; [or]gmat;
overlap: [a]/ˌoʊvərˈlæp/; [n]重叠,重复; [v](部分地)重叠; [or]gmat;
overlay: [a]/ˌoʊvərˈleɪ/; [n]覆盖图;覆盖物; [vt]在表面上铺一薄层,镀; [or]gmat;
overlie: [a]/ˌoʊvərˈlaɪ/; [v]躺在..上面,压在..上面,盖得使窒息; [or]gmat;
overlook: [a]/ˌoʊvərˈlʊk/; [v]忽视,未注意到;眺望,俯视; [n]忽视,远眺; [or]gmat;
overlord: [a]/ˈoʊvərlɔːrd/; [n]封建领主; [or]gmat;
overrun: [a]/ˈoʊvərʌn/; [v]溢出,泛滥;(侵略军)横行; [n]泛滥成灾;超出限度; [or]gmat;
overt: [a]/oʊˈvɜːrt/; [adj]明显的;公开的;公然的; [or]gmat;
overtone: [a]/ˈoʊvərtoʊn/; [n]<声>泛音,暗示,弦外之音; [v]<摄>使曝光过度; [or]gmat;
overuse: [a]/ˌoʊvərˈjuːs/; [n]过度的使用; [vt]使用.过度;使用.过多; [or]gmat;
overview: [a]/ˈoʊvərvjuː/; [n]综述,概观; [or]gmat;
overweening: [a]/ˌoʊvərˈwiːnɪŋ/; [adj]自负的,过于自信的,傲慢的; [or]gmat;
overwhelm: [a]/ˌoʊvərˈwelm/; [v]压垮;不知所措;淹没;打败,压倒; [or]gmat;
ozone: [a]/ˈoʊzoʊn/; [n]臭氧;(口语)新鲜空气;能使人兴奋的力量; [or]gmat;
pact: [a]/pækt/; [n]合同;协约; [or]gmat;
pad: [a]/pæd/; [n]衬垫;护具;便笺簿;(动物的)脚;浮叶; [v]填塞; [or]gmat;
painstaking: [a]/ˈpeɪnzteɪkɪŋ/; [adj](不辞)劳苦的,辛勤的; [n]辛劳,煞费苦心; [or]gmat;
pair: [a]/per/; [n]一对; [v]成对,配对; [or]gmat;
palatability: [a]/'pælətəbəlɪtɪ/; [n]可口性,风味; [or]gmat;
palatable: [a]/ˈpælətəbl/; [adj]美味的,合口味的,合心意的; [or]gmat;
paleolithic: [a]/ˌpeɪlɪə'lɪθɪk/; [adj]旧石器时代的; [or]gmat;
paleontologist: [a]/ˌpelɪɑn'tɑlədʒɪst/; [n]古生物学家; [or]gmat;
pall: [a]/pɔːl/; [n]幕;棺罩;遮盖物; [v]覆盖;使乏味;走味; [or]gmat;
pallid: [a]/ˈpælɪd/; [adj]苍白的,病态的,无生气的; [or]gmat;
palm: [a]/pɑːm/; [n]手掌,手心,棕榈树; [or]gmat;
paltry: [a]/ˈpɔːltri/; [adj]不足取的,无价值的,琐碎的,卑鄙的; [or]gmat;
pamphlet: [a]/ˈpæmflət/; [n]小册子; [or]gmat;
panacea: [a]/ˌpænəˈsiːə/; [n]灵丹妙药,万能药; [or]gmat;
panel: [a]/ˈpænl/; [n]讨论小组;仪表板;面,板; [v]嵌镶; [or]gmat;
pang: [a]/pæŋ/; [n]剧痛,痛苦; [v]使剧痛,折磨; [or]gmat;
pant: [a]/pænt/; [v]喘息;气喘吁吁地说;喘气; [n]喘气; [or]gmat;
paperwork: [a]/ˈpeɪpərwɜːrk/; [n]日常文书工作; [or]gmat;
paradigm: [a]/ˈpærədaɪm/; [n]范例,示范; [or]gmat;
paradox: [a]/ˈpærədɑːks/; [n]矛盾;似矛盾而正确的说法; [or]gmat;
parallax: [a]/ˈpærəlæks/; [n]［物］［天］视差,［天］周年(日)视差; [or]gmat;
parallel: [a]/ˈpærəlel/; [adj]平行的;相似的; [n]相似物;平行线; [v]与..相似;与..匹配; [adv]并行地,平行地; [or]gmat;
parallelogram: [a]/ˌpærəˈleləɡræm/; [n]平行四边形; [or]gmat;
paralysis: [a]/pəˈræləsɪs/; [n]瘫痪(症),麻痹(症); [or]gmat;
parameter: [a]/pəˈræmɪtər/; [n]决定因素;界限;参(变)数;参量; [or]gmat;
paramount: [a]/ˈpærəmaʊnt/; [n]元首;最高; [adj]最高的,至上的,首要的; [or]gmat;
paranormal: [a]/ˌpærəˈnɔːrml/; [adj]超自然的,异常的; [n]超常事件(或话题); [or]gmat;
paraphrase: [a]/ˈpærəfreɪz/; [v]解释,释义; [n]转述,释义; [or]gmat;
parapsychology: [a]/ˌpærəsaɪˈkɑːlədʒi/; [n]灵学;超心理学; [or]gmat;
parasite: [a]/ˈpærəsaɪt/; [n]寄生虫;靠他人为生的人; [or]gmat;
pare: [a]/per/; [v]削去,剥去; [or]gmat;
parenthetical: [a]/ˌpærənˈθetɪkl/; [adj]作为插入语的,放在括号里的,［喻］插曲的; [or]gmat;
parish: [a]/ˈpærɪʃ/; [n]教区; [or]gmat;
parity: [a]/ˈpærəti/; [n]相等;同等;平价; [or]gmat;
parliament: [a]/ˈpɑːrləmənt/; [n]议会;国会; [or]gmat;
parlor: [a]/'pɑːlə/; [n]店,营业室,客厅; [adj]客厅的; [or]gmat;
parochial: [a]/pəˈroʊkiəl/; [adj]教区的;地方范围的; [or]gmat;
parole: [a]/pəˈroʊl/; [n]特别口令;假释; [v]有条件释放,假释;使假释出狱;宣誓后释放; [adj]假释的; [or]gmat;
partial: [a]/ˈpɑːrʃl/; [adj]偏爱的,特别喜欢的;偏袒的,不公平的,有偏见的;部分的;不完全的; [n]<数学>偏微商; [or]gmat;
particle: [a]/ˈpɑːrtɪkl/; [n]粒子,微粒;<语>小品词; [or]gmat;
particular: [a]/pərˈtɪkjələr/; [adj]特殊的;特定的;特别的;不寻常的;挑剔的; [n]详细情况; [or]gmat;
partisan: [a]/ˈpɑːrtəzn/; [adj]党派的;效忠的;偏袒的;盲目推崇的; [n]党羽;虔诚信徒;游击队; [or]gmat;
passbook: [a]/ˈpæsbʊk/; [n]存折; [or]gmat;
passive: [a]/ˈpæsɪv/; [adj]被动的;消极的; [n]被动语态; [or]gmat;
pasta: [a]/ˈpɑːstə/; [n]意大利面食; [or]gmat;
pastoral: [a]/ˈpæstərəl/; [adj]田园生活的,牧师的; [n]牧歌;田园诗;田园景色;牧师写给教区居民的公开信; [or]gmat;
pasture: [a]/ˈpæstʃər/; [n]牧场,草地;生活状况; [v]放牧; [or]gmat;
patch: [a]/pætʃ/; [n]补丁;眼罩;斑点; [v]打补丁;修补;匆忙拼凑; [or]gmat;
patent: [a]/ˈpætnt/; [n]专利; [adj]显然的,明显的;专利的;独创的; [v]取得.的专利权; [or]gmat;
pathogenic: [a]/ˌpæθəˈdʒenɪk/; [adj]病原的,致病的,发病的; [or]gmat;
patriotic: [a]/ˌpeɪtriˈɑːtɪk/; [adj]爱国的,有爱国心的,显示爱国精神的; [or]gmat;
patrol: [a]/pəˈtroʊl/; [n]巡逻兵;巡逻; [v]巡逻;巡查,巡游; [or]gmat;
patron: [a]/ˈpeɪtrən/; [n]老主顾;赞助人;支持者; [or]gmat;
patronage: [a]/ˈpætrənɪdʒ/; [n]惠顾;赞助;任免权; [or]gmat;
patronize: [a]/ˈpeɪtrənaɪz/; [v]惠顾;赞助,资助; [or]gmat;
payroll: [a]/ˈpeɪroʊl/; [n]工资单; [or]gmat;
peak: [a]/piːk/; [n]顶峰;山顶;尖端; [v]达到最高点; [adj]最高度的;高峰时期的;巅峰状态的; [or]gmat;
peculiar: [a]/pɪˈkjuːliər/; [adj]奇怪的,古怪的;特有的,特别的; [or]gmat;
pecuniary: [a]/pɪˈkjuːnieri/; [adj]金钱(上)的; [or]gmat;
pedagogical: [a]/ˌpedəˈɡɑdʒɪk(ə)l/; [adj]教育的;教学法的; [or]gmat;
peddle: [a]/ˈpedl/; [v]叫卖,散播; [or]gmat;
peddler: [a]/ˈpedlər/; [n]小贩; [or]gmat;
pedestrian: [a]/pəˈdestriən/; [n]步行者,行人; [adj]步行的;平庸无奇的,无聊的; [or]gmat;
peel: [a]/piːl/; [v]剥皮,削皮,去壳; [n]果皮,外皮; [or]gmat;
peer: [a]/pɪr/; [n]同龄人,同等地位的人;贵族; [v]仔细看,费力地看; [or]gmat;
pelvic: [a]/ˈpelvɪk/; [adj]［解］骨盆的; [n]骨盆部; [or]gmat;
pelvis: [a]/ˈpelvɪs/; [n]骨盆; [or]gmat;
penalty: [a]/ˈpenəlti/; [n]惩罚,处罚,不利,罚球; [adj]处罚的; [or]gmat;
pendant: [a]/ˈpendənt/; [n]吊坠,下垂物; [or]gmat;
penetrate: [a]/ˈpenətreɪt/; [v]刺穿,穿透;进入;了解; [or]gmat;
peninsula: [a]/pəˈnɪnsələ/; [n]半岛; [or]gmat;
penitence: [a]/ˈpenɪtəns/; [n]后悔,忏悔; [or]gmat;
penitentiary: [a]/ˌpenɪˈtenʃəri/; [n]监狱,感化院; [adj]应处监禁的,监禁的,忏悔的; [or]gmat;
pension: [a]/ˈpenʃn/; [n]养老金,抚恤金;廉租屋; [v]发给..养老金; [or]gmat;
pentagon: [a]/ˈpentəɡɑːn/; [n]五边形; [or]gmat;
per capita: [a]/pər ˈkæpɪtə/; [phr]人均; [or]gmat;
perceive: [a]/pərˈsiːv/; [v]意识到,察觉,发觉;看待,理解; [or]gmat;
perception: [a]/pərˈsepʃn/; [n]洞察力,理解力;洞察力,理解力,认识,观念,看法; [or]gmat;
perennial: [a]/pəˈreniəl/; [adj]终年的,永久的;四季不断的;反复的; [n]多年生植物; [or]gmat;
perfunctory: [a]/pərˈfʌŋktəri/; [adj]草率的,敷衍搪塞的; [or]gmat;
perimeter: [a]/pəˈrɪmɪtər/; [n]周长;周界; [or]gmat;
periodical: [a]/ˌpɪriˈɑːdɪkl/; [n]期刊;杂志; [or]gmat;
peripheral: [a]/pəˈrɪfərəl/; [adj]外围的; [n]外围设备; [or]gmat;
periphery: [a]/pəˈrɪfəri/; [n]外围,不重要的部份; [or]gmat;
perish: [a]/ˈperɪʃ/; [vi]死去;毁灭,灭亡; [v]脆裂,老化,腐烂; [or]gmat;
periwinkle: [a]/ˈperiwɪŋkl/; [n]［植］常春花; [or]gmat;
perk: [a]/pɜːrk/; [v]昂首,意气洋洋,振作; [n]好处;福利; [adj]〈罕〉同"perky"; [or]gmat;
permanent: [a]/ˈpɜːrmənənt/; [adj]永久的,持久的; [n]电烫发; [or]gmat;
permeate: [a]/ˈpɜːrmieɪt/; [v]弥漫;普及;渗透; [or]gmat;
permit: [a]/pərˈmɪt/; [vt]允许,许可; [n]执照; [v]使可能; [or]gmat;
pernicious: [a]/pərˈnɪʃəs/; [adj]有害的,恶性的,致命的; [or]gmat;
perpendicular: [a]/ˌpɜːrpənˈdɪkjələr/; [adj]成直角的,垂直的;直立的; [n]垂直线; [or]gmat;
perpetrator: [a]/ˈpɜːrpətreɪtər/; [n]作恶者,犯罪者,行凶者; [or]gmat;
perpetuate: [a]/pərˈpetʃueɪt/; [adj]长存的; [vt]使永久存在,使不朽; [or]gmat;
perplex: [a]/pərˈpleks/; [v]使困惑; [or]gmat;
persecute: [a]/ˈpɜːrsɪkjuːt/; [v](尤指因宗教或政治信仰不同)迫害;烦扰,纠缠; [or]gmat;
persist: [a]/pərˈsɪst/; [v]坚持,固执;继续存留; [or]gmat;
personnel: [a]/ˌpɜːrsəˈnel/; [n]人事部门,员工,人员; [or]gmat;
perspective: [a]/pərˈspektɪv/; [n]角度,视角,观点,想法;(对事物的)合理判断,正确认识;远景;透视图,透视法,透视效果; [adj]透视的; [or]gmat;
perspiration: [a]/ˌpɜːrspəˈreɪʃn/; [n]汗水;出汗; [or]gmat;
pertinent: [a]/ˈpɜːrtnənt/; [adj]有关的;适当的;中肯的; [n]附属物;参考; [or]gmat;
perturb: [a]/pərˈtɜːrb/; [vt]使不安;烦扰;使紊乱; [or]gmat;
pervasive: [a]/pərˈveɪsɪv/; [adj]深入人心的,普遍的; [or]gmat;
perversion: [a]/pərˈvɜːrʒn/; [n]堕落,曲解;性怪癖; [or]gmat;
pesticide: [a]/ˈpestɪsaɪd/; [n]杀虫剂;农药; [or]gmat;
petition: [a]/pəˈtɪʃn/; [n]请愿;请愿书;祈求; [v]请愿; [or]gmat;
petroleum: [a]/pəˈtroʊliəm/; [n]石油; [or]gmat;
pharmaceutical: [a]/ˌfɑːrməˈsuːtɪkl/; [adj]制药的,药物的; [n]药物; [or]gmat;
pharmacologist: [a]/ˌfɑːrməˈkɑːlədʒɪst/; [n]药理学家,药物学家; [or]gmat;
pharmacy: [a]/ˈfɑːrməsi/; [n]药房,药剂学,配药业,制药业,一批备用药品; [or]gmat;
phase: [a]/feɪz/; [n](月等的)变相;盈亏;方面;阶段; [or]gmat;
philanthropic: [a]/ˌfɪlənˈθrɑːpɪk/; [adj]博爱的,为他人着想的; [or]gmat;
philosophy: [a]/fəˈlɑːsəfi/; [n]哲学,哲学体系;哲学思想; [or]gmat;
phonograph: [a]/ˈfoʊnəɡræf/; [n]留声机; [or]gmat;
phony: [a]/ˈfoʊni/; [adj]假的,伪造的; [n]假冒者; suf. 表声音; [or]gmat;
phosphate: [a]/ˈfɑːsfeɪt/; [n]磷酸盐,磷酸酯; [or]gmat;
photosynthesis: [a]/ˌfoʊtoʊˈsɪnθəsɪs/; [n]光合作用; [or]gmat;
physiological: [a]/ˌfɪziəˈlɑːdʒɪkl/; [adj]生理的,生理学的; [or]gmat;
physiology: [a]/ˌfɪziˈɑːlədʒi/; [n]生理机能,生理学; [or]gmat;
pigment: [a]/ˈpɪɡmənt/; [n]天然色素,颜料; [or]gmat;
pinnacle: [a]/ˈpɪnəkl/; [n](哥德式建筑的)小尖塔,顶峰; [v]置于尖顶上,置于高处; [or]gmat;
pinpoint: [a]/ˈpɪnpɔɪnt/; [v]准确地解释或说明; [adj]精确的; [n]针尖,极小之物,极不重要的事物; [or]gmat;
pint: [a]/paɪnt/; [n]品脱(液量,干量名〈美〉液量=0.47升,干量=0.55升); [or]gmat;
pinto: [a]/ˈpɪntoʊ/; [n]杂色马,斑豆; [adj]杂色的; [or]gmat;
pirate: [a]/ˈpaɪrət/; [n]海盗;剽窃者; [v]剽窃; [or]gmat;
pituitary: [a]/pɪˈtuːəteri/; [adj]［解］脑垂体的,粘液的; [n]垂体,脑垂体; [or]gmat;
placate: [a]/ˈpleɪkeɪt/; [vt]安抚,抚慰; [or]gmat;
plague: [a]/pleɪɡ/; [n]瘟疫;灾难;麻烦; [v]折磨;烦扰;造成麻烦; [or]gmat;
plaintiff: [a]/ˈpleɪntɪf/; [n]原告; [or]gmat;
plaque: [a]/plæk/; [n]饰板,匾,斑块; [or]gmat;
plasma: [a]/ˈplæzmə/; [n]血浆;等离子体;深绿玉髓; [or]gmat;
plateau: [a]/plæˈtoʊ/; [n]高原; [vi]到达平稳阶段; [or]gmat;
platform: [a]/ˈplætfɔːrm/; [n]站台;平台;讲台;舞台;论坛; [or]gmat;
plausible: [a]/ˈplɔːzəbl/; [adj]似乎有理的;巧嘴的; [or]gmat;
plead: [a]/pliːd/; [v]恳求,辩护,(不)认罪;提出.为理由; [or]gmat;
pledge: [a]/pledʒ/; [v]发誓,保证,以.抵押,向.祝酒; [n]保证,誓言; [or]gmat;
pliant: [a]/ˈplaɪənt/; [adj]易弯的,柔软的; [n]顺从; [or]gmat;
pliers: [a]/ˈplaɪərz/; [n]钳子; [or]gmat;
plot: [a]/plɑːt/; [n]情节,阴谋,小块土地; [v]密谋,计划,为小说写情节; [or]gmat;
plow: [a]/plau/; [v]犁,耕; [n]犁; [or]gmat;
plumb: [a]/plʌm/; [n]铅锤,测锤; [vi]垂直悬挂; [adj]垂直的; [vt]用铅锤测量; [adv]垂直地; [or]gmat;
plummet: [a]/ˈplʌmɪt/; [v]垂直或突然地堕下,骤然下降; [n]测锤(钓丝的)坠子;线锤;铅锤线;锤规; [or]gmat;
plunge: [a]/plʌndʒ/; [v]跳进,(使)投入;使陷入;暴跌; [n]卷入,参与;暴跌,骤减; [or]gmat;
pluralistic: [a]/ˌplʊərə'lɪstɪk/; [adj]兼职的,［哲］多元论的; [or]gmat;
plus: [a]/plʌs/; prep. 加,加上; [n]加号;有利因素; [adj]正的,多的;有利的;阳性的; [conj]此外,而且,况且; [or]gmat;
plywood: [a]/ˈplaɪwʊd/; [n]胶合板,层压木板; [or]gmat;
pneumonia: [a]/nuːˈmoʊniə/; [n]肺炎; [or]gmat;
pointed: [a]/ˈpɔɪntɪd/; [adj]尖锐的;率直的; [or]gmat;
poke: [a]/poʊk/; [v]刺,戳;拨开,拨(弄);探(出),露出; [n]戳,捅; [or]gmat;
polar: [a]/ˈpoʊlər/; [adj]极地的;南北两极的;截然对立的,正好相反的; [or]gmat;
polarity: [a]/pəˈlærəti/; [n](分)极性;相对的观点; [or]gmat;
poll: [a]/poʊl/; [n]投票,投票数;投票站;民意测验; [v]获得(票数); [adj]<法>当事人一方作成的; [or]gmat;
pollen: [a]/ˈpɑːlən/; [n]花粉; [or]gmat;
pollinate: [a]/ˈpɑːləneɪt/; [vt]传花粉给.; [or]gmat;
pollination: [a]/ˌpɑːləˈneɪʃn/; [n]授粉; [or]gmat;
polygon: [a]/ˈpɑːliɡɑːn/; [n]多角形,多边形; [or]gmat;
polygraph: [a]/ˈpɑːliɡræf/; [n]复写仪,测谎器,多产作家; [vi]用测谎仪测出结果; [vt]用测谎仪测试(某人); [or]gmat;
pompous: [a]/ˈpɑːmpəs/; [adj]傲慢的,浮华的; [or]gmat;
pop: [a]/pɑːp/; [v]发出(砰的响声),突然出现,爆开,开枪; [n]砰的一声爆破声;流行音乐;汽水; [adj]流行的,大众的; [or]gmat;
porcelain: [a]/ˈpɔːrsəlɪn/; [adj]瓷的;精美的;易碎的; [n]瓷,瓷器; [or]gmat;
pornography: [a]/pɔːrˈnɑːɡrəfi/; [n]色情描写,色情文学,色情画; [or]gmat;
portage: [a]/ˈpɔːrtɪdʒ/; [n]搬运,运输线路; [v]转到陆上运输,运输; [or]gmat;
portend: [a]/pɔːrˈtend/; [v]预兆,预示; [or]gmat;
portfolio: [a]/pɔːrtˈfoʊlioʊ/; [n]公文包,文件夹,投资组合;股份单; [or]gmat;
portrait: [a]/ˈpɔːrtrət/; [n]肖像,(人物)描写,标本; [or]gmat;
portray: [a]/pɔːrˈtreɪ/; [v]描绘;描述; [or]gmat;
portrayal: [a]/pɔːrˈtreɪəl/; [n]画像,描画,描写; [or]gmat;
posit: [a]/ˈpɑːzɪt/; [v]假定; [n]安置;论断; [or]gmat;
positive: [a]/ˈpɑːzətɪv/; [adj]积极的;肯定的,明确的;正面的;阳性的; [n]正面;肯定;优点;正数; [or]gmat;
possess: [a]/pəˈzes/; [v]拥有,占有;缠住,迷住;支配; [or]gmat;
posterity: [a]/pɑːˈsterəti/; [n]子孙,后裔,后代; [or]gmat;
potassium: [a]/pəˈtæsiəm/; [n]钾; [or]gmat;
potent: [a]/ˈpoʊtnt/; [adj]强有力的;有权势的;有说服力的; [or]gmat;
potpourri: [a]/ˌpoʊpʊˈriː/; [n]百花香,杂物,杂曲,杂文集; [or]gmat;
potter: [a]/ˈpɑːtər/; [n]陶工; [v]懒散;闲逛;慢条斯理地做事; [or]gmat;
pottery: [a]/ˈpɑːtəri/; [n]陶器;陶艺;陶艺厂; [or]gmat;
practitioner: [a]/prækˈtɪʃənər/; [n](医生或律师等)开业者;实践者,从事者; [or]gmat;
pragmatic: [a]/præɡˈmætɪk/; [adj]国事的,团体事务的;实际的,注重实效的; [n]爱管闲事的人;专断的人;国事诏书;实际家; [or]gmat;
prairie: [a]/ˈpreri/; [n]大草原,(尤指)北美大草原;草原地带; [or]gmat;
precaution: [a]/prɪˈkɔːʃn/; [n]预防措施; [or]gmat;
precipitation: [a]/prɪˌsɪpɪˈteɪʃn/; [n]猛然摔下;促使;急促;沉淀;降水; [or]gmat;
precipitous: [a]/prɪˈsɪpɪtəs/; [adj]险峻的;急躁的,鲁莽的; [or]gmat;
precise: [a]/prɪˈsaɪs/; [adj]精确的;恰好的; [or]gmat;
precursor: [a]/priːˈkɜːrsər/; [n]先兆,先驱,前体; [or]gmat;
predation: [a]/prɪˈdeɪʃn/; [n]捕食;掠夺,抢夺;捕食动物的方法; [or]gmat;
predator: [a]/ˈpredətər/; [n]掠夺者,食肉动物; [or]gmat;
predecessor: [a]/ˈpredəsesər/; [n]前辈;(被取代的)原有事物; [or]gmat;
predicament: [a]/prɪˈdɪkəmənt/; [n]困境,穷境,尴尬的处境; [or]gmat;
predict: [a]/prɪˈdɪkt/; [v]预言,预告,预测; [or]gmat;
predisposition: [a]/ˌpriːdɪspəˈzɪʃn/; [n]倾向;素质;易染病体质; [or]gmat;
predominate: [a]/prɪˈdɑːmɪneɪt/; [v]居支配地位;主宰;在.中占优势; [or]gmat;
preeminence: [a]/priː'emɪnəns/; [n]杰出; [or]gmat;
preeminent: [a]/priˈemɪnənt/; [adj]卓越的,超群的; [adv]卓越地,杰出地; [or]gmat;
preface: [a]/ˈprefəs/; [n]序言,前言,开端; [or]gmat;
preferential: [a]/ˌprefəˈrenʃl/; [adj]优先的;选择的;特惠的; [or]gmat;
prejudice: [a]/ˈpredʒudɪs/; [n]偏见;成见;损害;侵害; [vt]使抱偏见; [or]gmat;
prejudicial: [a]/ˌpredʒuˈdɪʃl/; [adj]有害的,引起偏见的; [or]gmat;
premature: [a]/ˌpriːməˈtʃʊr/; [adj]早产的,过早的,早熟的; [n]早产儿; [or]gmat;
premise: [a]/ˈpremɪs/; [n]前提;房屋地基; [v]假定; [or]gmat;
premium: [a]/ˈpriːmiəm/; [adj]高级的;高价的;(汽油)辛烷值高的; [n]额外费用,溢价;保险金; [or]gmat;
preoccupation: [a]/priˌɑːkjuˈpeɪʃn/; [n]抢先占据;全神贯注;首先要做的事,急务; [or]gmat;
preoccupied: [a]/priˈɑːkjupaɪd/; [adj]全神贯注的,心事重重的,被先占的; [or]gmat;
preponderance: [a]/prɪˈpɑːndərəns/; [n]优势;多数;占优势; [or]gmat;
prerequisite: [a]/ˌpriːˈrekwəzɪt/; [n]先决条件,必要条件; [adj]必须先具备的,必要的; [or]gmat;
prescribe: [a]/prɪˈskraɪb/; [v]给..开药;命令,指示; [or]gmat;
presentation: [a]/ˌpriːzenˈteɪʃn/; [n]演讲;报告;介绍;颁奖仪式; [or]gmat;
preservative: [a]/prɪˈzɜːrvətɪv/; [n]防腐剂;预防法;防护层; [adj]有保存力的;防腐的;有保存力的;有保护性的; [or]gmat;
preserve: [a]/prɪˈzɜːrv/; [v]贮鲜,保鲜;保存;保护; [n]独揽之事,独占的活动; [or]gmat;
preside: [a]/prɪˈzaɪd/; [v]主持; [or]gmat;
prestige: [a]/preˈstiːʒ/; [n]威望,声望; [or]gmat;
prevalence: [a]/ˈprevələns/; [n]盛行;广泛分布;普遍; [or]gmat;
prevalent: [a]/ˈprevələnt/; [adj]普遍的,流行的; [or]gmat;
previous: [a]/ˈpriːviəs/; [adj]以前的;早先的;过早的; [or]gmat;
prey: [a]/preɪ/; [n]被掠食者,猎物;牺牲者; [v]使..苦恼; [vi]捕食;受..控制; [or]gmat;
priest: [a]/priːst/; [n]教士,神父; [or]gmat;
primary: [a]/ˈpraɪmeri/; [adj]初等教育的;初级的;基本的;首要的;主要的; [n]首选;(美)初选; [or]gmat;
primate: [a]/'praɪmeɪt/; [n]首领,大主教,灵长类的动物; [or]gmat;
prime number: [a]/ˌpraɪm ˈnʌmbər/; [phr]质数; [or]gmat;
primitive: [a]/ˈprɪmətɪv/; [adj]原始的;简陋的; [n]原始人; [or]gmat;
primordial: [a]/praɪˈmɔːrdiəl/; [adj]原始的;根本的;原生的; [or]gmat;
principal: [a]/ˈprɪnsəpl/; [n]校长,负责人;本金,资本; [adj]主要的,首要的; [or]gmat;
prior to: [a]/ˈpraɪr tu/; [phr]在..之前; [or]gmat;
priority: [a]/praɪˈɔːrəti/; [n]优先;优先权;优先考虑的事;重要事项; [or]gmat;
privilege: [a]/ˈprɪvəlɪdʒ/; [n]特权,优待;荣幸; [v]给..特权; [or]gmat;
probability: [a]/ˌprɑːbəˈbɪləti/; [n]可能性;几率,概率; [or]gmat;
probate: [a]/ˈproʊbeɪt/; [n]遗嘱检验; [v]遗嘱认证; [adj]<法> 遗嘱认证的; [or]gmat;
probe: [a]/proʊb/; [v]探测,探索; [n]探索,调查;探针,探测器; [or]gmat;
problematic: [a]/ˌprɑːbləˈmætɪk/; [adj]问题的;有疑问的;不确定的; [or]gmat;
procedure: [a]/prəˈsiːdʒər/; [n]步骤,过程;程序;手续; [or]gmat;
proceed: [a]/proʊˈsiːd/; [v]前进(尤指停止后继续进行);继续进行,继续做; [n]收入,获利; [or]gmat;
proceeds: [a]/ˈproʊsiːdz/; [n]收入; [v]进行;前进;(沿特定路线)行进;(尤指打断后)继续说; [or]gmat;
proclaim: [a]/prəˈkleɪm/; [v]声明,声称;宣告;表明; [or]gmat;
proctor: [a]/ˈprɑːktər/; [n]代理人,学监; [vt]监督; [or]gmat;
procure: [a]/prəˈkjʊr/; [vt](努力)取得;获得;导致;完成; [vi]介绍娼妓;拉皮条; [or]gmat;
prodigious: [a]/prəˈdɪdʒəs/; [adj]异常的,奇妙的;巨大的; [or]gmat;
prodigy: [a]/ˈprɑːdədʒi/; [n]天才; [or]gmat;
produce: [a]/prəˈduːs/; [v]生产;创作;产生; [vi]创作;生产;产生; [n]农产品; [or]gmat;
product: [a]/ˈprɑːdʌkt/; [n]产品,产物;(乘)积; [or]gmat;
proficient: [a]/prəˈfɪʃnt/; [adj]精通的,熟练的; [or]gmat;
profile: [a]/ˈproʊfaɪl/; [n]侧面像;外形,轮廓; [v]描绘..的轮廓,扼要描述; [or]gmat;
profit: [a]/ˈprɑːfɪt/; [n]利润,盈利;益处; [v]得益,有益于; [or]gmat;
profitability: [a]/ˌprɑːfɪtəˈbɪləti/; [n]赢利能力;收益性;利益率; [or]gmat;
profound: [a]/prəˈfaʊnd/; [adj]深刻的;知识渊博的;深奥的;极度的,完全的;深远的;渊博的; [n]深渊;深海; [or]gmat;
prognosis: [a]/prɑːɡˈnoʊsɪs/; [n]<医>预后;预知; [or]gmat;
progression: [a]/prəˈɡreʃn/; [n]前进;连续; [or]gmat;
progressive: [a]/prəˈɡresɪv/; [adj]进步的;逐步的,渐进的; [n]进步人士; [or]gmat;
prohibitive: [a]/prəˈhɪbətɪv/; [adj]禁止性的,阻止的;(费用,价格等)过高的;类同禁止的; [or]gmat;
project: [a]/ˈprɑːdʒekt/; [n]项目,工程;专题研究;课题方案; [v]映射,放映;计划,设计,打算,拟订方案;投掷,发射,喷射;表明..的特性,使呈现特性;阐述;突出,伸出;估计,预估; [or]gmat;
projection: [a]/prəˈdʒekʃn/; [n]预测,投射,投影规划; [or]gmat;
proliferate: [a]/prəˈlɪfəreɪt/; [v]激增,繁殖,增殖; [or]gmat;
prominent: [a]/ˈprɑːmɪnənt/; [adj]突起的,显眼的;突出的,杰出的; [or]gmat;
promising: [a]/ˈprɑːmɪsɪŋ/; [adj]有前途的,有希望的;(前景)光明的; [or]gmat;
prompt: [a]/prɑːmpt/; [v]提示;激起;促进,推动;敦促; [adj]迅速的,及时的; [n]提示; [or]gmat;
promulgate: [a]/ˈprɑːmlɡeɪt/; [v]公布;传播;发表; [or]gmat;
prone to: [a]/proʊn tu/; [phr]易于..的; [or]gmat;
pronounced: [a]/prəˈnaʊnst/; [adj]非常明显的;显著的;断然的; [v]发音;宣告;断言; [or]gmat;
propagate: [a]/ˈprɑːpəɡeɪt/; [v]繁殖,增殖; [vt]传播,宣传; [or]gmat;
propagation: [a]/ˌprɑːpəˈɡeɪʃn/; [n]繁殖;传播; [or]gmat;
propeller: [a]/prəˈpelər/; [n]螺旋桨;推进器; [or]gmat;
propensity: [a]/prəˈpensəti/; [n]嗜好,习性;倾向; [or]gmat;
property: [a]/ˈprɑːpərti/; [n]房产;财产;特性;性能; [or]gmat;
prophet: [a]/ˈprɑːfɪt/; [n]先知,预言者; [or]gmat;
propitious: [a]/prəˈpɪʃəs/; [adj]适合的;吉利的;顺利的; [or]gmat;
proponent: [a]/prəˈpoʊnənt/; [n]支持者;提议者;主张者;提出认证遗嘱者; [adj]建议的;支持的;辩护的; [or]gmat;
proportion: [a]/prəˈpɔːrʃn/; [n]比例;部分;相称; [v]使成比例;分配; [or]gmat;
proportional: [a]/prəˈpɔːrʃənl/; [adj]成比例的,相称的; [n]<数>比例项,比例量; [or]gmat;
propound: [a]/prəˈpaʊnd/; [v]提出(问题,计划)供考虑; [or]gmat;
proprietary: [a]/prəˈpraɪəteri/; [adj]所有的;专利的;私人拥有的; [n]所有权;所有物;所有人; [or]gmat;
prosaic: [a]/prəˈzeɪɪk/; [adj]平凡的,乏味的,散文体的; [or]gmat;
prose: [a]/proʊz/; [n]散文; [vt]用散文写,把.改写成散文;平淡无趣地写;啰啰唆唆地讲; [or]gmat;
prosecute: [a]/ˈprɑːsɪkjuːt/; [v]起诉;做检察官;从事; [or]gmat;
prospect: [a]/ˈprɑːspekt/; [n]前景,展望;视野;景象; [v]勘察;有前途;勘探;对..进行仔细调查; [or]gmat;
prospectus: [a]/prəˈspektəs/; [n]章程,内容简介;样张;创办计划书; [or]gmat;
prosper: [a]/ˈprɑːspər/; [v](生意等)成功;(城市,文化,植物生长等)繁荣; [or]gmat;
prosthetic: [a]/prɑːsˈθetɪk/; [adj]<医>修复术的,弥补性的; [or]gmat;
protagonist: [a]/prəˈtæɡənɪst/; [n]主角,领导者,积极参加者; [or]gmat;
protege: [a]/ˈproʊtəʒeɪ/; [n]被保护人,门徒,门生; [or]gmat;
protein: [a]/ˈproʊtiːn/; [n]蛋白质; [adj]蛋白质的; [or]gmat;
protocol: [a]/ˈproʊtəkɔːl/; [n]外交礼节;草案;外交议定书; [vi]拟定议定书; [vt]把.写入议定书; [or]gmat;
proton: [a]/ˈproʊtɑːn/; [n]质子; [or]gmat;
protoplasm: [a]/ˈproʊtəplæzəm/; [n]原生质,原浆,细胞质; [adj]〈生〉原生质的; [or]gmat;
prototype: [a]/ˈproʊtətaɪp/; [n]原型,典型,样本; [or]gmat;
provenance: [a]/ˈprɑːvənəns/; [n]出处,起源; [or]gmat;
provision: [a]/prəˈvɪʒn/; [n](法律等)条款;供应;预备,存粮;必需品; [v]为..提供必需品; [or]gmat;
provocative: [a]/prəˈvɑːkətɪv/; [adj]挑衅的,煽动的,刺激的;挑逗的; [or]gmat;
provoke: [a]/prəˈvoʊk/; [v]激怒;对.挑衅;引起; [or]gmat;
prowl: [a]/praʊl/; [n](鬼鬼祟祟)徘徊,觅食,游荡; [vi]徘徊,潜行; [vt]在.搜寻;潜行于; [or]gmat;
proximity: [a]/prɑːkˈsɪməti/; [n]接近;邻近; [or]gmat;
prudent: [a]/ˈpruːdnt/; [adj]谨慎的,精明的; [or]gmat;
prudery: [a]/ˈpruːdəri/; [n]过分拘谨,假正经; [or]gmat;
pry: [a]/praɪ/; [v]刺探,打听,撬开; [n]窥探;杠杆;爱打探的人; [or]gmat;
pseudonym: [a]/ˈsuːdənɪm/; [n]笔名,假名; [or]gmat;
psyche: [a]/ˈsaɪki/; [n]灵魂;心智; [or]gmat;
psychiatric: [a]/ˌsaɪkiˈætrɪk/; [adj]精神病的; [or]gmat;
psychoactive: [a]/ˌsaɪkoʊˈæktɪv/; [adj](药剂)对神经起显著(或特殊)作用的; [or]gmat;
psychological: [a]/ˌsaɪkəˈlɑːdʒɪkl/; [adj]心理的,心理学的; [or]gmat;
psychopath: [a]/ˈsaɪkəpæθ/; [n]精神变态者; [or]gmat;
psychosis: [a]/saɪˈkoʊsɪs/; [n]精神病,精神错乱,精神变态; [or]gmat;
psychotherapy: [a]/ˌsaɪkoʊˈθerəpi/; [n]心理疗法,精神疗法; [or]gmat;
pterosaur: [a]/'terəˌsɔː/; [n]翼龙; [or]gmat;
publicity: [a]/pʌbˈlɪsəti/; [n]公开(性),公众的关注;宣传;名声; [or]gmat;
pull away: [a]/pʊl əˈweɪ/; [phr]脱身,离开,脱出; [or]gmat;
pulp: [a]/pʌlp/; [n]果肉;果肉酱;纸浆; [v]去除果肉,捣成浆状; [or]gmat;
pulsation: [a]/pʌlˈseɪʃn/; [n]有节奏的鼓动,脉动; [or]gmat;
punctuation: [a]/ˌpʌŋktʃuˈeɪʃn/; [n]标点;全部标点符号; [or]gmat;
punitive: [a]/ˈpjuːnətɪv/; [adj]给予惩罚,刑罚的; [or]gmat;
pup: [a]/pʌp/; [n]小狗;幼畜; [v]生(小狗等小动物); [or]gmat;
pupation: [a]/pjʊ'peɪʃn/; [n]［动］化蛹; [or]gmat;
purge: [a]/pɜːrdʒ/; [v]通便,净化,使(身,心)清净; [n]驱赶,泻药,净化; [or]gmat;
pursue: [a]/pərˈsuː/; [v]进行,从事;追求,追赶; [or]gmat;
put away: [a]/pʊt əˈweɪ/; [phr]放好;把.收起来;储存; [or]gmat;
putty: [a]/ˈpʌti/; [n]［建］腻子,易于被人摆弄的人; [v]用油灰填塞; [or]gmat;
pyramid: [a]/ˈpɪrəmɪd/; [n]金字塔; [or]gmat;
quadrant: [a]/ˈkwɑːdrənt/; [n]象限,四分之一圆; [or]gmat;
quadrilateral: [a]/ˌkwɑːdrɪˈlætərəl/; [adj]四边形的; [or]gmat;
quail: [a]/kweɪl/; [n]鹌鹑; [v]畏缩;感到恐惧; [or]gmat;
qualify: [a]/ˈkwɑːlɪfaɪ/; [v]胜任,使具有资格;描述,形容; [or]gmat;
qualitative: [a]/ˈkwɑːləteɪtɪv/; [adj](性)质的,定性的; [or]gmat;
quandary: [a]/ˈkwɑːndəri/; [n]困惑;窘境;为难; [or]gmat;
quantitative: [a]/ˈkwɑːntəteɪtɪv/; [adj]定量的; [or]gmat;
quantum: [a]/ˈkwɑːntəm/; [n]量子论; [or]gmat;
quarantine: [a]/ˈkwɔːrəntiːn/; [v]检疫;隔离;使隔离; [n]检疫;隔离;检疫期;封锁; [or]gmat;
quarry: [a]/ˈkwɔːri/; [n]采石场;猎物;来源; [v]挖出;努力挖掘; [or]gmat;
quasar: [a]/ˈkweɪzɑːr/; [n](天)类星体; [or]gmat;
quest: [a]/kwest/; [n]探索,寻求; [v]寻找,搜索; [or]gmat;
questionnaire: [a]/ˌkwestʃəˈner/; [n]调查表,问卷; [or]gmat;
quiescent: [a]/kwaɪˈesnt/; [adj]静止的,沉寂的,不活动的; [or]gmat;
quintessential: [a]/ˌkwɪntɪˈsenʃl/; [adj]精华的,典型的; [or]gmat;
quiz: [a]/kwɪz/; [n]问答比赛,智力竞赛;小测验,小考; [v]考查,盘问; [or]gmat;
quota: [a]/ˈkwoʊtə/; [n]配额;限额;定额; [or]gmat;
quote: [a]/kwoʊt/; [v]报价;引用,援引; [n]引用; [or]gmat;
rabble: [a]/ˈræbl/; [n]下层社会;乌合之众;暴民; [or]gmat;
rabies: [a]/ˈreɪbiːz/; [n](单复同型)狂犬病; [or]gmat;
raccoon: [a]/ræˈkuːn/; [n]浣熊;浣熊毛皮; [or]gmat;
racist: [a]/ˈreɪsɪst/; [n]种族主义者; [adj]种族主义的; [or]gmat;
radial: [a]/ˈreɪdiəl/; [adj]光线的,放射状的,半径的; [n]光线,射线; [or]gmat;
radiant: [a]/ˈreɪdiənt/; [adj]光芒四射的,绚丽的;喜悦的; [or]gmat;
radiate: [a]/ˈreɪdieɪt/; [v]辐射,发出(光或热);流露,显示;(使)从中心发散; [or]gmat;
radical: [a]/ˈrædɪkl/; [n]激进分子;基础;原子团;根数,根式; [adj]重大的,彻底的;激进的; [or]gmat;
radioactive: [a]/ˌreɪdioʊˈæktɪv/; [adj]放射性的; [or]gmat;
radius: [a]/ˈreɪdiəs/; [n]半径;范围; [or]gmat;
radon: [a]/ˈreɪdɑːn/; [n]［化］氡; [or]gmat;
raffle: [a]/ˈræfl/; [n]废物;抽彩票; [v]抽彩票; [or]gmat;
rage: [a]/reɪdʒ/; [n]极怒;盛怒; [v]迅速蔓延,快速扩散;(战争等)激烈地进行; [or]gmat;
ragtime: [a]/ˈræɡtaɪm/; [n]拉格泰姆音乐; [adj]滑稽的;不严肃的; [or]gmat;
raid: [a]/reɪd/; [n]突袭;袭击; [v]袭击;劫掠;攫取;突然搜捕; [or]gmat;
rally: [a]/ˈræli/; [n]集会;公路汽车赛; [v]集合;恢复(健康等),重新振作; [or]gmat;
rampage: [a]/ræmˈpeɪdʒ/; [n]粗暴;胡闹; [v]暴跳;暴怒;狂暴地乱冲; [or]gmat;
ranch: [a]/ræntʃ/; [n]大农场; [or]gmat;
rancher: [a]/ˈræntʃər/; [n]牧场经营者; [or]gmat;
ransom: [a]/ˈrænsəm/; [n]赎金,赎身; [v]赎回,解救; [or]gmat;
rapid: [a]/ˈræpɪd/; [adj]迅速的;急促的; [or]gmat;
rare: [a]/rer/; [adj]罕见的,稀有的,难得的;半熟的;不寻常的;美好的; [or]gmat;
rate: [a]/reɪt/; [n]比率,率;速率;价格;频率; [v]评估;认为; [or]gmat;
rating: [a]/ˈreɪtɪŋ/; [n]评价;等级;等级评定;额定功率;评分,收视率; [or]gmat;
ratio: [a]/ˈreɪʃioʊ/; [n]比率,比例; [or]gmat;
ration: [a]/ˈræʃn/; [n]定量配给; [v]配给;定量供应; [or]gmat;
rational: [a]/ˈræʃnəl/; [adj]理性的;理智的;合理的; [or]gmat;
rationale: [a]/ˌræʃəˈnæl/; [n]基本原理;原理的阐述; [or]gmat;
rationality: [a]/ˌræʃəˈnæləti/; [n]合理性,合理的行动; [or]gmat;
ravenous: [a]/ˈrævənəs/; [adj]贪婪的;渴望的,极饿的;狼吞虎咽的; [or]gmat;
reactor: [a]/riˈæktər/; [n]［原］反应堆; [or]gmat;
readily: [a]/ˈredɪli/; [adv]容易地;乐意地;欣然地; [or]gmat;
real estate: [a]/ˈriːəl əsteɪt/; [n]不动产,房地产; [or]gmat;
realm: [a]/relm/; [n]王国;领域;国土; [or]gmat;
realtor: [a]/ˈriːəltər/; [n]房地产经纪人; [or]gmat;
rear: [a]/rɪr/; [n]后部; [adj]背面的; [v]抚养,举起; [or]gmat;
rebut: [a]/rɪˈbʌt/; [v](律)辩驳,揭露,戳穿; [or]gmat;
recall: [a]/rɪˈkɔːl/; [v]回想起,记起,回忆;召回; [n]召回(有问题的产品); [or]gmat;
recast: [a]/ˌriːˈkæst/; [v]重建; [or]gmat;
receipt: [a]/rɪˈsiːt/; [n]收据,收条;收入;收到; [or]gmat;
reception: [a]/rɪˈsepʃn/; [n]前台,接待处,接收,欢迎,招待会; [or]gmat;
receptive: [a]/rɪˈseptɪv/; [adj]善于接受的;能容纳的; [or]gmat;
receptor: [a]/rɪˈseptər/; [n]感觉器官;感受器;受体;接受器;受体;接受器; [or]gmat;
recession: [a]/rɪˈseʃn/; [n](经济)衰退,不景气;后退,撤回;凹处; [or]gmat;
recipe: [a]/ˈresəpi/; [n]方法;食谱; [or]gmat;
recipient: [a]/rɪˈsɪpiənt/; [n]接受者;容器;间接宾语; [adj]接受的;善于接受的;接受能力强的; [or]gmat;
reciprocal: [a]/rɪˈsɪprəkl/; [adj]相互的,互惠的; [n]倒数;互相关联的事物; [or]gmat;
reclaim: [a]/rɪˈkleɪm/; [v]开拓,开垦;感化;取回;改造;废物回收利用; [or]gmat;
reclamation: [a]/ˌrekləˈmeɪʃn/; [n]开垦,改造,感化,废料回收; [or]gmat;
recommend: [a]/ˌrekəˈmend/; [v]推荐,介绍;劝告,建议; [or]gmat;
reconcile: [a]/ˈrekənsaɪl/; [v]和解;调解;调和; [or]gmat;
reconvene: [a]/ˌriːkənˈviːn/; [v]重新集合,重新召集; [or]gmat;
recoup: [a]/rɪˈkuːp/; [v]收回;恢复;偿还;扣除; [n]获得补偿; [or]gmat;
recourse: [a]/ˈriːkɔːrs/; [n]求援(对象),求助(对象,<商><律>追索权; [or]gmat;
recreation: [a]/ˌrekriˈeɪʃn/; [n]娱乐活动,消遣; [or]gmat;
recruit: [a]/rɪˈkruːt/; [v]招募(新兵),招收(新成员); [n]新兵,新成员; [or]gmat;
rectangle: [a]/ˈrektæŋɡl/; [n]长方形,矩形; [or]gmat;
recur: [a]/rɪˈkɜːr/; [v]重新出现;再次发生;重新提起;诉诸;反复; [or]gmat;
redress: [a]/rɪˈdres/; [n]纠正,革除,救济; [v]修正,救济,革除; [or]gmat;
reduce: [a]/rɪˈduːs/; [v]减少,减小,降低,精简; [or]gmat;
reef: [a]/riːf/; [n]礁; [v]收帆,缩帆; [or]gmat;
referendum: [a]/ˌrefəˈrendəm/; [n]公民投票,复决权; [or]gmat;
refine: [a]/rɪˈfaɪn/; [v]精炼,改进; [or]gmat;
reflex: [a]/ˈriːfleks/; [n]条件反射,反映; [adj]有反应的;反作用的(效果,音响等);反省的;回想的; [or]gmat;
refrain: [a]/rɪˈfreɪn/; [v]抑制,避免; [n]歌曲的反复句,叠句; [or]gmat;
refugee: [a]/ˌrefjuˈdʒiː/; [n]避难者,难民; [v]避难; [adj]避难的; [or]gmat;
regenerate: [a]/rɪˈdʒenəreɪt/; [v]新生,再生,使革新; [adj]改过自新的,新生的; [n]重生者;再生器官; [or]gmat;
regime: [a]/reɪˈʒiːm/; [n]政权;政治制度;养生法,生活规则; [or]gmat;
regimen: [a]/ˈredʒɪmən/; [n]养生法,生活规则; [or]gmat;
regiment: [a]/ˈredʒɪmənt/; [n](军队)团; [v]组编成团;严格控制; [or]gmat;
regressive: [a]/rɪˈɡresɪv/; [adj]回归的,后退的,退化的; [or]gmat;
rehabilitate: [a]/ˌriːəˈbɪlɪteɪt/; [v]使康复,使恢复名誉,使恢复原状; [or]gmat;
rehash: [a]/ˈriːhæʃ/; [v]重讲,重新处理; [n]改头换面地作品; [or]gmat;
reign: [a]/reɪn/; [v]占主导地位,统治,当政; [n](君主)统治时期; [or]gmat;
reimburse: [a]/ˌriːɪmˈbɜːrs/; [v]偿还;赔偿;退还(钱),付还; [or]gmat;
reinforce: [a]/ˌriːɪnˈfɔːrs/; [v]加固;加强;增援;支持; [or]gmat;
reiterate: [a]/riˈɪtəreɪt/; [vt]反复讲,重申,反复做; [or]gmat;
rekindle: [a]/ˌriːˈkɪndl/; [v]重新点燃,使再振作精神; [or]gmat;
relativity: [a]/ˌreləˈtɪvəti/; [n]相关性;相对性; [or]gmat;
relay: [a]/ˈriːleɪ/; [n]替班;转播;接力赛跑; [v]转播;传递; [or]gmat;
release: [a]/rɪˈliːs/; [v]释放;解放;发行; [n]解除;免除;发表; [or]gmat;
relentless: [a]/rɪˈlentləs/; [adj]顽强的;持续的;坚定地;冷酷的; [or]gmat;
reliable: [a]/rɪˈlaɪəbl/; [adj]可靠的;可信赖的;确实的; [or]gmat;
relic: [a]/ˈrelɪk/; [n]遗迹;神圣的遗物;纪念物; [or]gmat;
relieve: [a]/rɪˈliːv/; [v]消除,减轻;换班; [or]gmat;
religious: [a]/rɪˈlɪdʒəs/; [adj]宗教的;虔诚的; [or]gmat;
relinquish: [a]/rɪˈlɪŋkwɪʃ/; [v]放弃,让出(权利,财产等),撤回; [or]gmat;
reluctant: [a]/rɪˈlʌktənt/; [adj]不情愿的;勉强的; [or]gmat;
remainder: [a]/rɪˈmeɪndər/; [n]剩下的人;剩余物,残留部分; [v]减价出售,削价处理; [adj]剩余的;留存下的; [or]gmat;
remedy: [a]/ˈremədi/; [v]治疗;恢复;补救; [n]治疗;补救;矫正; [or]gmat;
reminiscence: [a]/ˌremɪˈnɪsns/; [n]回忆,怀旧,引起联想的相似事物; [or]gmat;
remnant: [a]/ˈremnənt/; [n]遗迹;边角剩料; [or]gmat;
renaissance: [a]/ˈrenəsɑːns/; [n]新生,复兴;文艺复兴; [or]gmat;
renal: [a]/ˈriːnl/; [adj]肾脏的; [or]gmat;
render: [a]/ˈrendər/; [v]使成为,致使,使处于(某种状态);提供,给予,以.回报;(以某种方式)表达,表现;翻译;粉刷,往(墙上)抹灰;将(脂肪)熬成油,使熔化; [n]粉刷,打底,交纳; [or]gmat;
rendition: [a]/renˈdɪʃn/; [n]表演,演奏;译文;给予,提供; [or]gmat;
renegade: [a]/ˈrenɪɡeɪd/; [n]叛教者,脱党者,叛徒; [v]背叛,背教,变节; [adj]叛教的,背叛的,变节的; [or]gmat;
renounce: [a]/rɪˈnaʊns/; [vt]宣布放弃,与...断绝关系;抛弃; [vi]垫牌; [n]垫牌; [or]gmat;
renovation: [a]/ˌrenəˈveɪʃn/; [n]修理;恢复; [or]gmat;
renown: [a]/rɪˈnaʊn/; [n]声誉;名望; [vt]使有声望; [or]gmat;
repeal: [a]/rɪˈpiːl/; [n]撤销; [v]废除;废止; [or]gmat;
repertoire: [a]/ˈrepərtwɑːr/; [n](剧团,演员等的)全部节目;全部才能; [or]gmat;
repertory: [a]/ˈrepərtɔːri/; [n]储备;仓库;全部剧目; [or]gmat;
replete: [a]/rɪˈpliːt/; [adj]充满的,装满的; [n]<昆>贮蜜蚁; [or]gmat;
replicate: [a]/ˈreplɪkeɪt/; [v]复制;重复,反复; [or]gmat;
repository: [a]/rɪˈpɑːzətɔːri/; [n]储藏室;仓库;智囊人物;知识库; [or]gmat;
representative: [a]/ˌreprɪˈzentətɪv/; [n]代表;代理; [adj]典型的,有代表性的; [or]gmat;
reproach: [a]/rɪˈproʊtʃ/; [v]责备,指责; [n]指责; [or]gmat;
reptile: [a]/ˈreptaɪl/; [n]爬行动物,爬虫; [adj]爬行的,爬虫类的; [or]gmat;
reptilian: [a]/repˈtɪliən/; [adj]爬虫类的;卑下的; [n]两栖动物;卑劣的人; [or]gmat;
repudiate: [a]/rɪˈpjuːdieɪt/; [v]拒绝,否定,驳斥; [or]gmat;
rescind: [a]/rɪˈsɪnd/; [v]废除;取消;撤回; [or]gmat;
resemble: [a]/rɪˈzembl/; [v]像,相像,相似; [or]gmat;
resent: [a]/rɪˈzent/; [v]愤恨; [or]gmat;
reservation: [a]/ˌrezərˈveɪʃn/; [n](住处,席位的)预订;保留态度,保留意见;(美国印第安部落的)居留地; [or]gmat;
reserve: [a]/rɪˈzɜːrv/; [n]储备;保留;保护区; [v]保留;预定;储备; [or]gmat;
reservoir: [a]/ˈrezərvwɑːr/; [n]水库;贮藏量; [or]gmat;
reside: [a]/rɪˈzaɪd/; [v]居住; [or]gmat;
residue: [a]/ˈrezɪduː/; [n]剩余物;残渣;渣;残数; [or]gmat;
resign: [a]/rɪˈzaɪn/; [v]辞职; [or]gmat;
resist: [a]/rɪˈzɪst/; [v]抗拒;抵抗,抵制; [or]gmat;
resolve: [a]/rɪˈzɑːlv/; [n]决心; [v]解决,决定,表决; [or]gmat;
resonance: [a]/ˈrezənəns/; [n]共振;回声;(情感等的)共鸣; [or]gmat;
resort: [a]/rɪˈzɔːrt/; [vi]采取;求助; [n]求助;凭借;诉诸,采取;度假胜地; [or]gmat;
respective: [a]/rɪˈspektɪv/; [adj]各自的; [or]gmat;
respire: [a]/rɪˈspaɪər/; [v]呼吸; [or]gmat;
resplendent: [a]/rɪˈsplendənt/; [adj]华丽的,辉煌的; [or]gmat;
responsible: [a]/rɪˈspɑːnsəbl/; [adj]有责任,负责的; [or]gmat;
responsive: [a]/rɪˈspɑːnsɪv/; [adj]反应积极的,反应敏捷的;反应热烈的;响应的; [or]gmat;
restitution: [a]/ˌrestɪˈtuːʃn/; [n]归还,赔偿; [or]gmat;
restore: [a]/rɪˈstɔːr/; [v]恢复;修补;归还; [or]gmat;
restrain: [a]/rɪˈstreɪn/; [v]制止(做);抑制(愤怒等),控制;监禁; [or]gmat;
resume: [a]/ˈrezəmeɪ/; [n]简历; [v]重新开始;继续; [vt]回到;恢复;重新开始; [or]gmat;
resurgence: [a]/rɪˈsɜːrdʒəns/; [n]复活;再现;再起; [or]gmat;
resuscitation: [a]/rɪˌsʌsɪˈteɪʃn/; [n]复活,苏醒; [or]gmat;
retail: [a]/ˈriːteɪl/; [adj]零售的; [n]零售; [v]零售,零售价是; [adv]以零售方式,以零售形式; [or]gmat;
retain: [a]/rɪˈteɪn/; [v]保持,保留,保存;聘请; [or]gmat;
retaliation: [a]/rɪˌtæliˈeɪʃn/; [n]反击;回敬;报复; [or]gmat;
retard: [a]/rɪˈtɑːrd/; [v]延迟,使减速; [n]妨碍,阻碍; [or]gmat;
retention: [a]/rɪˈtenʃn/; [n]保留,保持; [or]gmat;
retentive: [a]/rɪˈtentɪv/; [adj]保持的;吸(水)的; [adv]有记性地,记性强地; [n]保持力;〈物〉顽磁性; [or]gmat;
reticent: [a]/ˈretɪsnt/; [adj]沉默不语的;有保留的;含蓄的; [or]gmat;
retrieve: [a]/rɪˈtriːv/; [v]取回,重新得到,挽回,检索; [or]gmat;
revamp: [a]/ˈriːvæmp/; [v]翻新,整修,升级; [n]改进,换新鞋面; [or]gmat;
revenue: [a]/ˈrevənuː/; [n]收入;财政收入;国家的税收; [or]gmat;
revere: [a]/rɪˈvɪr/; [v]敬畏;尊敬;崇敬; [or]gmat;
reverence: [a]/ˈrevərəns/; [n]崇敬,尊严,敬礼; [v]敬畏,尊敬; [or]gmat;
reverse: [a]/rɪˈvɜːrs/; [n]失败,挫折,倒退;相反,背面; [v]颠倒,翻转; [adj]相反的,反面的,颠倒的; [or]gmat;
revise: [a]/rɪˈvaɪz/; [v]修订;修改;温习(功课); [or]gmat;
revitalize: [a]/ˌriːˈvaɪtəlaɪz/; [v]使复活,使重新充满活力,使复兴; [or]gmat;
revival: [a]/rɪˈvaɪvl/; [n]复活,复兴; [or]gmat;
revive: [a]/rɪˈvaɪv/; [v](使)苏醒;(使)复苏;再兴起;重做; [or]gmat;
revolution: [a]/ˌrevəˈluːʃn/; [n]革命;旋转; [or]gmat;
rewind: [a]/ˌriːˈwaɪnd/; [v]倒回(磁带等),倒带; [or]gmat;
rhetoric: [a]/ˈretərɪk/; [n]修辞学,浮夸的言语;雄辩术; [or]gmat;
rheumatoid: [a]/'ruːməˌtɔɪd/; [adj]风湿病的,类风湿病的; [or]gmat;
rhinoceros: [a]/raɪˈnɑːsərəs/; [n]犀牛; [or]gmat;
rhinovirus: [a]/ˌraɪnoʊ'vaɪrəs/; [n]鼻病毒; [or]gmat;
rhythmical: [a]/ˈrɪðmɪk(ə)l/; [adj]有节奏的,有韵律的; [or]gmat;
rib: [a]/rɪb/; [n]肋骨,伞骨; [v]装肋于;用肋状物支撑; [or]gmat;
ridge: [a]/rɪdʒ/; [n]脊,岭,山脉,垄; [or]gmat;
ridicule: [a]/ˈrɪdɪkjuːl/; [v]嘲笑,愚弄; [n]嘲笑,愚弄; [or]gmat;
right angle: [a]/ˈraɪt æŋɡl/; [phr]直角; [or]gmat;
rigid: [a]/ˈrɪdʒɪd/; [adj]坚硬的;僵硬的;死板的; [or]gmat;
rigor: [a]/'rɪgə/; [n]严厉;精确;困难境地; [or]gmat;
rigorous: [a]/ˈrɪɡərəs/; [adj]严厉的,严格的; [or]gmat;
rim: [a]/rɪm/; [n](圆形物体的)边;轮辋,轮缘,轮圈; [v]形成边缘; [or]gmat;
rinse: [a]/rɪns/; [v](用清水)刷,冲洗掉,漂净,漱口; [n]嗽洗,漂洗,漂清,冲洗; [or]gmat;
ripple: [a]/ˈrɪpl/; [n]涟漪,波纹; [v](使)泛起层层细浪; [or]gmat;
ritual: [a]/ˈrɪtʃuəl/; [n](宗教等的)仪式,例行公事,老规矩; [adj]作为仪式一部分的,例行的; [or]gmat;
rival: [a]/ˈraɪvl/; [n]竞争者,对手; [v]与.竞争,与.匹敌; [adj]竞争的,敌对的; [or]gmat;
rivalry: [a]/ˈraɪvlri/; [n]竞争,敌对; [or]gmat;
robin: [a]/ˈrɑːbɪn/; [n]欧鸲,知更鸟; [or]gmat;
robust: [a]/roʊˈbʌst/; [adj]健壮的,强壮的;精力充沛的;坚固的;粗鲁的; [or]gmat;
rodent: [a]/ˈroʊdnt/; [n]啮齿类动物(如鼠等); [or]gmat;
roller coaster: [a]/ˈroʊlər koʊstər/; [n]过山车; [or]gmat;
roost: [a]/ruːst/; [n]鸟窝,巢穴,栖木; [vi]栖息; [or]gmat;
rotate: [a]/ˈroʊteɪt/; [v]以..轴转动,使旋转,使..轮流;轮换; [or]gmat;
rough-hewn: [a]/ˌrʌf ˈhjuːn/; [adj]粗凿成的,粗削的(石头,木材),毛坯的,草拟的; [or]gmat;
round: [a]/raʊnd/; [adj]圆的,球形的; [n]圆,圆形物; [adv]围绕着,循环地; [v]使成圆形; prep. 围着,绕过,在周围; [or]gmat;
rubble: [a]/ˈrʌbl/; [n]碎石,瓦砾; [or]gmat;
rudimentary: [a]/ˌruːdɪˈmentri/; [adj]基本的,初期的;发育不完全的;退化的; [or]gmat;
rug: [a]/rʌɡ/; [n](小)地毯;围毯;男子假发; [or]gmat;
rugby: [a]/ˈrʌɡbi/; [n]英式橄榄球;拉格比(英格兰中部的城市); [or]gmat;
rugged: [a]/ˈrʌɡɪd/; [adj]崎岖的,不平的,强壮的,艰苦的; [or]gmat;
ruin: [a]/ˈruːɪn/; [v]毁灭,毁坏;(使)破产;(使)堕落; [n]毁灭;废墟; [or]gmat;
rule of thumb: [a]/rul ɑv θʌm/; [n]单凭经验的做法;经验法则; [or]gmat;
rumor: [a]/'ruːmə/; [n]谣言;传闻; [or]gmat;
runner: [a]/ˈrʌnər/; [n]跑步者;信差;蔓藤植物; [or]gmat;
rupture: [a]/ˈrʌptʃər/; [n]破裂;割裂; [v]使破裂;断绝(关系); [or]gmat;
sabotage: [a]/ˈsæbətɑːʒ/; [n]怠工,蓄意破坏,妨碍; [v]怠工,从事破坏活动,故意阻挠; [or]gmat;
sacred: [a]/ˈseɪkrɪd/; [adj]神圣的,宗教(性)的;神圣不可侵犯的; [or]gmat;
sacrifice: [a]/ˈsækrɪfaɪs/; [vt]牺牲;祭献; [vi]奉献;做出牺牲; [n]祭品;牺牲; [or]gmat;
salable: [a]/'seɪləbəl/; [adj]可出售的,畅销的,有销路的; [or]gmat;
sale price: [a]/seɪl praɪs/; [n]特价,廉价; [or]gmat;
salient: [a]/ˈseɪliənt/; [adj]显著的;突出的;跳跃的; [n]凸角;突出部分; [or]gmat;
saline: [a]/ˈseɪliːn/; [adj]咸的,含盐的; [or]gmat;
saliva: [a]/səˈlaɪvə/; [n]唾液; [vi]分泌唾液; [or]gmat;
salvage: [a]/ˈsælvɪdʒ/; [n]抢救;从灾难中抢救出的物资; [vt]拯救;打捞; [or]gmat;
sample: [a]/ˈsæmpl/; [n]样品,样本;(用于检验,分析的) 试样; [adj]样品的,作为例子的; [vi]抽样检查; [vt]抽取.的试样; [v]品尝;体验,尝试; [or]gmat;
samurai: [a]/ˈsæmuraɪ/; [n](日本)武士阶层,陆军军官,军阀; [or]gmat;
sanction: [a]/ˈsæŋkʃn/; [n]批准;制裁,处罚; [v]批准,支持,对..实施制裁; [or]gmat;
sanctuary: [a]/ˈsæŋktʃueri/; [n]圣堂,避难所; [or]gmat;
sanitarium: [a]/ˌsænəˈteriəm/; [n]疗养院,休养地; [or]gmat;
sanitary: [a]/ˈsænəteri/; [adj]卫生的;清洁的; [or]gmat;
sap: [a]/sæp/; [n]树液,汁液;易上当的人; [v]削弱;逐渐耗竭; [vt]使伤元气; [vi]挖坑道进攻; [or]gmat;
saturate: [a]/ˈsætʃəreɪt/; [v]使充满,使饱和,使湿透; [or]gmat;
saturated: [a]/ˈsætʃəreɪtɪd/; [adj]湿透的;充满的;饱和的; [or]gmat;
scale: [a]/skeɪl/; [n]天平,磅秤;刻度,尺度,标度;等级,级别, 等级体系;鳞片,鳞状物;规模;水垢,牙垢; [v]攀登;按比例决定;称重;刮鳞,剥落; [or]gmat;
scan: [a]/skæn/; [v]细看;浏览;扫描; [n]扫描;浏览; [or]gmat;
scapegoat: [a]/ˈskeɪpɡoʊt/; [n]替罪羊; [or]gmat;
scarce: [a]/skers/; [adj]缺乏的,不足的;稀少的,罕见的; [adv]仅仅,几乎不; [or]gmat;
scarcity: [a]/ˈskersəti/; [n]缺乏,不足; [or]gmat;
scatter: [a]/ˈskætər/; [v](使)分散,撒开,散播; [or]gmat;
scenario: [a]/səˈnærioʊ/; [n]剧情梗概;情况,情节;设想; [or]gmat;
scent: [a]/sent/; [n]气味;香味;迹象; [v]嗅到;察觉; [or]gmat;
scheme: [a]/skiːm/; [n]方案,计划;阴谋,诡计; [v]图谋,密谋; [adj]计划的; [or]gmat;
schizophrenia: [a]/ˌskɪtsəˈfriːniə/; [n]<内科>精神分裂症; [or]gmat;
school: [a]/skuːl/; [n]学校;学院;流派;(鱼,海豚的)一群; [v]教育; [or]gmat;
scintillate: [a]/'sɪntlˌeɪt/; [v]闪烁,(淡吐)流露机智; [or]gmat;
scorch: [a]/skɔːrtʃ/; [v]烧焦;枯萎; [vi]高速行驶,疾驰,飞驰; [or]gmat;
scorn: [a]/skɔːrn/; [n]鄙视; [v]轻蔑;对.不屑一顾; [or]gmat;
scour: [a]/ˈskaʊər/; [v]搜查;洗涤,洗刷,擦洗;冲刷成,冲刷出; [or]gmat;
scout: [a]/skaʊt/; [v]侦察;监视;嘲笑; [n]童子军,侦察员,守卫; [or]gmat;
scramble: [a]/ˈskræmbl/; [v]争夺,攀登; [or]gmat;
scrap: [a]/skræp/; [n]碎片;口角,吵架;小块,小片;废金属;残羹冷炙; [v]报废;舍弃;打架; [or]gmat;
scrape: [a]/skreɪp/; [n]擦伤;刮,擦; [v]刮,擦; [or]gmat;
screen: [a]/skriːn/; [n]屏幕,荧光屏;纱窗; [v]遮蔽;放映;检查; [or]gmat;
scrupulous: [a]/ˈskruːpjələs/; [adj]小心谨慎的;严谨的;细心的; [or]gmat;
scrutinize: [a]/ˈskruːtənaɪz/; [v]仔细检查,细看; [or]gmat;
sculpture: [a]/ˈskʌlptʃər/; [n]雕刻艺术;雕刻,雕塑; [or]gmat;
scurrilous: [a]/ˈskɜːrələs/; [adj]下流的,恶言毁谤的; [or]gmat;
scurry: [a]/ˈskɜːri/; [v]快速疾走,急跑,急躁不安地来回走动; [n]快步急跑;疾走;仓皇奔跑声;骤雨; [or]gmat;
seance: [a]/ˈseɪɑːns/; [n]［法］集会,会议,降神会; [or]gmat;
secluded: [a]/sɪˈkluːdɪd/; [adj]隐遁的,隔绝的; [or]gmat;
secrete: [a]/sɪˈkriːt/; [v]藏匿;私下侵吞;分泌; [or]gmat;
secretion: [a]/sɪˈkriːʃn/; [n]分泌,分泌物;隐藏; [or]gmat;
secure: [a]/səˈkjʊr/; [adj]安心的;安全的; [v]使安全;保卫,保护;确保;获得; [or]gmat;
sedan: [a]/sɪˈdæn/; [n]轿子,轿车,单舱汽艇; [or]gmat;
sedentary: [a]/ˈsednteri/; [adj]久坐不动的;静止的;坐惯的,定栖的; [or]gmat;
sediment: [a]/ˈsedɪmənt/; [n]沉渣,沉淀物,沉淀; [or]gmat;
seductive: [a]/sɪˈdʌktɪv/; [adj]有魅力的;性感的;引人注意的; [or]gmat;
seedling: [a]/ˈsiːdlɪŋ/; [n]幼苗,籽苗; [or]gmat;
seesaw: [a]/ˈsiː sɔː/; [n]跷跷板;拉锯局面,不断起伏的状态; [adj]来回往复的;拉锯式的; [v]摇摆不定,时起时伏; [adv]上下动地<的>, 前后动地<的>,交互地<的>,拉锯性地<的>; [or]gmat;
segment: [a]/ˈseɡmənt/; [n]部分;片段;(橘子等的)瓣; [v]分割; [or]gmat;
segregate: [a]/ˈseɡrɪɡeɪt/; [v]分开,隔离,进行种族隔离; [or]gmat;
segregation: [a]/ˌseɡrɪˈɡeɪʃn/; [n]分离,隔离,种族隔离; [or]gmat;
seismic: [a]/ˈsaɪzmɪk/; [adj]地震的;地震引起的;剧烈的; [or]gmat;
semiarid: [a]/ˌsemɪ'ærɪd/; [adj]半干旱的; [or]gmat;
semicircle: [a]/ˈsemisɜːrkl/; [n]半圆形; [or]gmat;
semiconductor: [a]/ˌsemikənˈdʌktər/; [n]半导体; [or]gmat;
seminal: [a]/ˈsemɪnl/; [adj]重要的,精液的,种子的; [or]gmat;
seminar: [a]/ˈsemɪnɑːr/; [n]研究班;研讨会; [or]gmat;
semiotic: [a]/ˌsemiˈɑːtɪk/; [n]［哲］符号学; [adj]症状的,符号学的,记号语言的; [or]gmat;
senate: [a]/ˈsenət/; [n]参议院,上院; [or]gmat;
seniority: [a]/ˌsiːniˈɔːrəti/; [n]年长,资历深,职位高; [or]gmat;
sensation: [a]/senˈseɪʃn/; [n]感觉;知觉;轰动; [or]gmat;
sensational: [a]/senˈseɪʃənl/; [adj]轰动性的;使人感动的,非常好的;引起哗然的; [or]gmat;
sensible: [a]/ˈsensəbl/; [adj]明智的,理智的;可觉察的;实用耐穿的; [or]gmat;
sensitive: [a]/ˈsensətɪv/; [adj]敏感的,过敏的;灵敏的;善解人意的,体恤的; [or]gmat;
sensuality: [a]/ˌsenʃuˈæləti/; [n]淫荡,好色; [or]gmat;
sentient: [a]/ˈsentiənt/; [adj]有感情的,有感觉力的,意识到的; [n]有知觉的人; [or]gmat;
sentiment: [a]/ˈsentɪmənt/; [n]感情;情绪; [or]gmat;
sentinel: [a]/ˈsentɪnl/; [n]哨兵,看守; [v]守卫,放哨; [or]gmat;
separate: [a]/ˈsepəreɪt/; [adj]独立的;分开的;单独的; [v]使分开,分离,分割,划分; [or]gmat;
sequel: [a]/ˈsiːkwəl/; [n]续集;结局;继续;后果; [or]gmat;
sequence: [a]/ˈsiːkwəns/; [n]顺序,次序;连续,继续; [or]gmat;
sequential: [a]/sɪˈkwenʃl/; [adj]连续的;相继的;有顺序的; [n]〈美俚〉按期服食的避孕丸; [or]gmat;
sequester: [a]/sɪˈkwestər/; [v]使隔离,隔绝,使隐退,没收,扣押; [or]gmat;
sermonize: [a]/ˈsɜːrmənaɪz/; [v]说教,讲道; [or]gmat;
session: [a]/ˈseʃn/; [n]一段时间的(活动);(法庭的)开庭;(议会等的)开会;学期;讲习会; [adj]为录音的歌手或乐队伴奏的; [or]gmat;
severe: [a]/sɪˈvɪr/; [adj]严重的;严厉的;严酷的;剧烈的; [or]gmat;
sewage: [a]/ˈsuːɪdʒ/; [n](下水道)污水;污物; [or]gmat;
shareholder: [a]/ˈʃerhoʊldər/; [n]股东,股票持有者; [or]gmat;
shatter: [a]/ˈʃætər/; [v]使粉碎;砸碎;打碎;粉碎; [or]gmat;
shave: [a]/ʃeɪv/; [v]剃,刮; [n]剃须,修面,剃刀; [or]gmat;
shed: [a]/ʃed/; [v]流出(眼泪);蜕皮;脱落;使清晰;流下;去除,摆脱; [n]棚屋; [or]gmat;
sheer: [a]/ʃɪr/; [adj]陡峭的;纯粹的; [v](off)急转向,偏离; [n]透明薄纱,透明布料的衣服; [adv]完全地,全然;垂直地,陡峭地; [or]gmat;
shelter: [a]/ˈʃeltər/; [n]隐蔽处,躲避处(常用来指住处);庇护; [v]遮蔽,掩护,庇护; [or]gmat;
shield: [a]/ʃiːld/; [n]盾牌;防护物; [v]保护; [or]gmat;
shift: [a]/ʃɪft/; [n]转移;替换;轮值; [v]移动;售卖(难卖的物品);换挡;改换,替换; [or]gmat;
shoplifting: [a]/ˈʃɑːplɪftɪŋ/; [n]冒充顾客进商店行窃; [or]gmat;
shortfall: [a]/ˈʃɔːrtfɔːl/; [n]不足,亏空; [or]gmat;
shrewd: [a]/ʃruːd/; [adj]精明的;机灵的; [n]精明;精明者; [or]gmat;
shrill: [a]/ʃrɪl/; [adj]尖声的,刺耳的; [vi]尖叫; [vt]尖叫着说; [n]尖叫声; [adv]尖声地,无节制地; [or]gmat;
shrink: [a]/ʃrɪŋk/; [v]收缩;缩小;退缩; [n](非正式用法)心理医生,精神病医生; [or]gmat;
shroud: [a]/ʃraʊd/; [n]寿衣,覆盖物; [v]覆盖,包以尸衣; [or]gmat;
shrub: [a]/ʃrʌb/; [n]灌木; [or]gmat;
shut off: [a]/ʃʌt ɑf/; [phr]关掉(煤气等),切断,使隔绝,脱离; [or]gmat;
shuttle: [a]/ˈʃʌtl/; [n]短程穿梭运行的车辆,接驳车;梭子;穿梭;航天飞机; [v]穿梭移动;穿梭往返;往返于两地之间; [or]gmat;
sibling: [a]/ˈsɪblɪŋ/; [n]兄弟姊妹;同胞;(生物)同科,同属; [or]gmat;
sickle: [a]/ˈsɪkl/; [n]镰刀; [vt]用镰刀割.;使(红血细胞)成镰状; [vi]呈现出一种异常的月牙状,用于指红血细胞; [or]gmat;
side effect: [a]/ˈsaɪd ɪfekt/; [phr]副作用; [or]gmat;
sidestep: [a]/ˈsaɪdstep/; [n](侧面)台阶;拳击等横跨一步躲避打击;［喻］回避(困难); [v]回避;横跨一步躲避; [or]gmat;
siege: [a]/siːdʒ/; [n]围困;包围; [or]gmat;
signify: [a]/ˈsɪɡnɪfaɪ/; [vi]具有重要性; [vt]表示; [or]gmat;
simple interest: [a]/ˌsɪmpl ˈɪntrəst/; [phr]单利; [or]gmat;
simulate: [a]/ˈsɪmjuleɪt/; [v]假装;模仿;模拟; [or]gmat;
simultaneous: [a]/ˌsaɪmlˈteɪniəs/; [adj]同时发生的; [or]gmat;
sinew: [a]/ˈsɪnjuː/; [n]腱,筋,中坚力量; [v]用腱连结,(好像使用肌筋似的)给..以力量,支持; [or]gmat;
sinusitis: [a]/ˌsaɪnəˈsaɪtɪs/; [n]<医>窦炎; [or]gmat;
sip: [a]/sɪp/; [v]啜饮; [n]一小口; [or]gmat;
skeleton: [a]/ˈskelɪtn/; [n]骨骼,梗概;骨瘦如柴的人或动物; [or]gmat;
skeptic: [a]/ˈskeptɪk/; [n]怀疑论者;怀疑者;无神论者; [or]gmat;
skeptical: [a]/ˈskeptɪkl/; [adj]表示怀疑的; [or]gmat;
skepticism: [a]/ˈskeptɪsɪzəm/; [n]怀疑态度;怀疑论;多疑癖; [or]gmat;
sketch: [a]/sketʃ/; [n]梗概,素描; [v]速写,打草稿; [or]gmat;
sketchy: [a]/ˈsketʃi/; [adj]概略的,粗略的; [or]gmat;
skull: [a]/skʌl/; [n]颅骨;脑壳; [or]gmat;
slam: [a]/slæm/; [v]砰地关上;猛力拉,扔;砰地放下;猛烈抨击; [n]砰的一声;大满贯; [or]gmat;
slander: [a]/ˈslændər/; [n]诽谤,诋毁; [v]讲坏话,污蔑,诽谤; [or]gmat;
slice: [a]/slaɪs/; [v]把..切成片;大幅度削减;切开; [n]薄片;份额,部分; [or]gmat;
slick: [a]/slɪk/; [adj]光滑的;圆滑的;顺利的;不费力的; [n]海面浮油;小块湿润的区域; [v]使平滑; [or]gmat;
slight: [a]/slaɪt/; [adj]轻微的,微小的;纤细的,瘦弱的;少量的; [n]轻视,蔑视; [vt]轻视,忽略; [or]gmat;
slip: [a]/slɪp/; [v]滑倒,跌落,溜走,疏忽;偷偷地给;被遗忘; [n]溜走;疏忽,错误;纸条; [adj]打有活结的;可拆卸的;滑动的; [or]gmat;
slope: [a]/sloʊp/; [n]山坡,斜坡,倾斜; [v]倾斜; [or]gmat;
slot: [a]/slɑːt/; [n]狭缝,狭槽,(机构的)职位; [v]把.放入狭长开口中,把.纳入; [or]gmat;
sloth: [a]/slɑːθ/; [n]懒惰;树懒; [or]gmat;
slowdown: [a]/ˈsloʊdaʊn/; [n]减速,减退;怠工; [or]gmat;
sluggish: [a]/ˈslʌɡɪʃ/; [adj]行动迟缓的,迟钝的;偷懒的; [or]gmat;
slump: [a]/slʌmp/; [v]突然倒下;暴跌; [n]下降;经济萧条时期; [or]gmat;
smallpox: [a]/ˈsmɔːlpɑːks/; [n]天花; [or]gmat;
smear: [a]/smɪr/; [n]油渍,污点,中伤; [v]涂上,玷污,诽谤,抹去; [or]gmat;
smite: [a]/smaɪt/; [n]重击,猛打; [vi]打,重击,猛烈撞击; [vt]猛打,杀死,惩罚; [or]gmat;
smog: [a]/smɑːɡ/; [n]烟雾; [or]gmat;
smokestack: [a]/ˈsmoʊkstæk/; [n]烟囱,烟窗; [adj]低技术制造业的,大工厂的; [or]gmat;
snap: [a]/snæp/; [v]使喀嚓一声折断,使发出吧嗒一声(关上或打开); [n]吧嗒声;快照; [adj]仓促的,突然的; [or]gmat;
snapdragon: [a]/ˈsnæpdræɡən/; [n]［植］金鱼草属植物,金鱼草; [or]gmat;
snout: [a]/snaʊt/; [n]猪嘴,猪鼻子; [v]装管嘴; [or]gmat;
snuff: [a]/snʌf/; [v](伤风鼻阻时)用鼻子使劲地吸,扑灭; [n]灯花,烛花,鼻吸气息,气息; [or]gmat;
soar: [a]/sɔːr/; [v]高飞,翱翔;飞腾;猛增;高飞越过; [n]高飞;高涨; [or]gmat;
sodium: [a]/ˈsoʊdiəm/; [n]<化学>钠(11号元素,符号Na); [or]gmat;
sojourn: [a]/ˈsoʊdʒɜːrn/; [n]逗留,旅居; [vi]逗留,旅居; [or]gmat;
solar: [a]/ˈsoʊlər/; [adj]太阳的;太阳系的;日光的; [n]日光浴室; [or]gmat;
solicit: [a]/səˈlɪsɪt/; [v]乞求,恳求给予(帮助,金钱); [or]gmat;
solidarity: [a]/ˌsɑːlɪˈdærəti/; [n]团结一致; [or]gmat;
solitary: [a]/ˈsɑːləteri/; [adj]孤独的,单独的,隐居的; [n]独居者,隐士;单独禁闭; [or]gmat;
soloist: [a]/ˈsoʊloʊɪst/; [n]独奏者,独唱者,［空］单飞者; [or]gmat;
solvency: [a]/ˈsɑːlvənsi/; [n]偿付能力;溶解力; [or]gmat;
somatic: [a]/soʊ'mætɪk/; [adj]肉体的; [or]gmat;
sophisticated: [a]/səˈfɪstɪkeɪtɪd/; [adj](仪器)精密的,复杂的;老于世故的,老练的,富有经验的;高雅的,精致的; [or]gmat;
sophomore: [a]/ˈsɑːfəmɔːr/; [n]大二年级学生; [adj]二年级的;二年级学生的; [or]gmat;
soprano: [a]/səˈprɑːnoʊ/; [n]女高音,女高音歌手,女高音声部; [adj]女高音的,童声高音的,女高音声部的; [or]gmat;
sovereign: [a]/ˈsɑːvrən/; [adj]至高无上的,具有独立主权的,有最高统治权的; [n]最高统治者,君主,元首; [or]gmat;
span: [a]/spæn/; [n]跨度;时间段;范围;持续时间; [v]持续;横跨;包括; [or]gmat;
spark: [a]/spɑːrk/; [n]火花,火星;丝毫,微量; [v]发出火花;发动;激励; [or]gmat;
sparse: [a]/spɑːrs/; [adj]稀少的;稀疏的; [or]gmat;
spate: [a]/speɪt/; [n]洪水;一阵;大雨;突然迸发; [or]gmat;
spatial: [a]/ˈspeɪʃl/; [adj]空间的,关于空间的; [or]gmat;
spawn: [a]/spɔːn/; [n]卵;菌丝;产物; [v]产卵;酿成,造成;大量生产; [or]gmat;
speak out: [a]/spik aʊt/; [phr]大胆地说,清楚和响亮地说; [or]gmat;
specialize: [a]/ˈspeʃəlaɪz/; [v]专门研究,专门从事; [or]gmat;
species: [a]/ˈspiːʃiːz/; [n](单复同)物种;种类;人类; [adj]物种上的; [or]gmat;
specific: [a]/spəˈsɪfɪk/; [adj]具体的,明确的;特定的;特殊的;针对..的; [n]详情;特性; [or]gmat;
specify: [a]/ˈspesɪfaɪ/; [v]详细说明; [or]gmat;
specimen: [a]/ˈspesɪmən/; [n]标本,样本,样品; [or]gmat;
specious: [a]/ˈspiːʃəs/; [adj]外表美观,华而不实的,徒有其表的; [or]gmat;
spectacular: [a]/spekˈtækjələr/; [adj]壮观的,引人入胜的; [n]壮观的场面,精彩的表演; [or]gmat;
spectator: [a]/ˈspekteɪtər/; [n]旁观者;观众;目击者; [or]gmat;
specter: [a]/'spektə/; [n]鬼魂,幽灵,恐惧; [or]gmat;
spectrum: [a]/ˈspektrəm/; [n]光谱,范围,系列; [or]gmat;
speculate: [a]/ˈspekjuleɪt/; [vi]推测,猜测;投机,做投机买卖; [vt]推测; [or]gmat;
sphere: [a]/sfɪr/; [n]球;球形;领域; [or]gmat;
spherule: [a]/'sfeəuːl/; [n]小球(体); [or]gmat;
spiced: [a]/spaɪst/; [adj]五香的,调过味的,含香料的; [or]gmat;
spillover: [a]/ˈspɪloʊvər/; [n]溢出(量);外流人口(大城市容纳不下的); [or]gmat;
spin: [a]/spɪn/; [v](使)旋转;纺织;疾驰;眩晕; [n]旋转;纺织;眩晕; [or]gmat;
spine: [a]/spaɪn/; [n]脊椎; [or]gmat;
spiral: [a]/ˈspaɪrəl/; [n]螺旋,螺线; [v]不断急剧地上升(或下降),螺旋形行进; [adj]螺旋的; [or]gmat;
spleen: [a]/spliːn/; [n]脾,脾气,怒气; [or]gmat;
splinter: [a]/ˈsplɪntər/; [n]碎片;微小的东西;极瘦的人; [v]分裂;裂成碎片; [or]gmat;
spoil: [a]/spɔɪl/; [v]溺爱;娇惯;(食物)变质;毁坏; [n]溺爱;战利品;犒劳;成功所带来的好处; [or]gmat;
sponsor: [a]/ˈspɑːnsər/; [n]倡导者;提案人;赞助人;担保人;教父,教母; [vt]发起;倡议;做.的保人;赞助;资助; [or]gmat;
sporadically: [a]/spəˈrædɪkli/; [adv]偶尔; [or]gmat;
spouse: [a]/spaʊs/; [n]配偶,夫妇;夫,妻; [v]和.结婚; [or]gmat;
spray: [a]/spreɪ/; [n]浪花;水雾;喷雾; [vi]飞溅,喷; [vt]喷;向..扫射;散布; [or]gmat;
spring: [a]/sprɪŋ/; [n]春天;弹簧,弹性;泉,泉源;跳跃; [v]反弹,跳,跃,(使)跳起,(使)弹开;生长,涌出,跃出; [or]gmat;
sprinkler: [a]/ˈsprɪŋklər/; [n]洒水装置,洒水车; [or]gmat;
spruce: [a]/spruːs/; [n]云杉; [v](弄)整洁,(把)打扮漂亮; [adj]整洁的,潇洒的; [or]gmat;
spur: [a]/spɜːr/; [v]策马,用踢马刺驱马前进;激励,鞭策;推动; [n]踢马刺,靴刺;刺激,鞭策,鼓励;尖坡; [or]gmat;
square: [a]/skwer/; [n]正方形;广场; [adj]正方形的;平方的;直角的; [v]把..弄成方形; [adv]直接地; [or]gmat;
squash: [a]/skwɑːʃ/; [v]压扁,压制; [n]南瓜,易压烂的物品,拥挤的人群,壁球; [or]gmat;
stage: [a]/steɪdʒ/; [n]阶段;舞台;戏剧; [v]举行;展现;上演;筹划;适于上演;适合在舞台上演出;乘公交车(或驿车)旅行;<军事>中间集结;扎营; [or]gmat;
stagnant: [a]/ˈstæɡnənt/; [adj]不流动的;停滞的;萧条的; [or]gmat;
stake: [a]/steɪk/; [n]木桩;赌注;利害关系;股份,股本;(赛马)奖金; [v]下注,以桩来支撑; [or]gmat;
stale: [a]/steɪl/; [adj]不新鲜的;走了味的;陈腐的; [v]变得不新鲜;使陈旧; [n](猎人做掩蔽用的)假马;笑柄;受人愚弄成为笑谈的人;畜尿; [or]gmat;
stamina: [a]/ˈstæmɪnə/; [n]耐力,持久力; [or]gmat;
stance: [a]/stæns/; [n]立场,姿态,位置; [or]gmat;
standpoint: [a]/ˈstændpɔɪnt/; [n]立场,观点; [or]gmat;
staple: [a]/ˈsteɪpl/; [v]用订书钉订; [n]订书钉;主食;主要产品; [adj]主要的;基本的;标准的; [or]gmat;
starch: [a]/stɑːrtʃ/; [n]淀粉; [v]给.上浆; [or]gmat;
stark: [a]/stɑːrk/; [adj]完全的,明显的,荒凉的; [adv]完全,明显地; [or]gmat;
startling: [a]/ˈstɑːrtlɪŋ/; [adj]令人吃惊的;颜色极鲜亮的; [or]gmat;
static: [a]/ˈstætɪk/; [adj]静电的,静态的,静止的; [n]静电,静电干扰; [or]gmat;
stationary: [a]/ˈsteɪʃəneri/; [adj]静止的;固定的; [n]定居者,驻军; [or]gmat;
statistic: [a]/stəˈtɪstɪk/; [n]统计;统计数值;统计学; [or]gmat;
stature: [a]/ˈstætʃər/; [n]身高,身材;(精神,道德等的)高度; [or]gmat;
status quo: [a]/ˌsteɪtəs ˈkwoʊ/; [n]［拉］现状; [or]gmat;
status: [a]/ˈsteɪtəs/; [n]地位;状态;身份; [or]gmat;
statute: [a]/ˈstætʃuːt/; [n]法令,法规,条例; [or]gmat;
statutory: [a]/ˈstætʃətɔːri/; [adj]法定的;法令的;可依法惩处的; [or]gmat;
stave: [a]/steɪv/; [n]梯子,杖,梯级; [v]延缓,破碎,穿孔; [or]gmat;
steep: [a]/stiːp/; [v]沉浸于..; [adj]陡峭的;急剧的;过高的; [n]陡坡; [or]gmat;
steer: [a]/stɪr/; [v]操纵,驾驶,掌舵,引导; [n]公牛,食用牛; [or]gmat;
steerage: [a]/ˈstɪrɪdʒ/; [n]驾驶,操纵,下等客舱; [or]gmat;
stellar: [a]/ˈstelər/; [adj]星的,星球的,主要的; [or]gmat;
stem: [a]/stem/; [n]茎,(树)干; [v]阻止;起源于;遏制,抑制; [or]gmat;
stench: [a]/stentʃ/; [n]臭气,恶臭; [vi](使)发恶臭; [vt]发恶臭; [or]gmat;
steppe: [a]/step/; [n](尤指东南欧或西伯利地区)无树林的大平原; [or]gmat;
stereotype: [a]/ˈsteriətaɪp/; [n]老套的模式,陈规,成见; [v]对..产生成见; [or]gmat;
sterile: [a]/ˈsterəl/; [adj]不孕的,无细菌的,贫瘠的; [or]gmat;
stew: [a]/stuː/; [v]炖,焖,受闷热;使焦虑不安; [n]炖肉(或菜);鱼塘; [or]gmat;
stimulant: [a]/ˈstɪmjələnt/; [n]<药>兴奋剂;刺激物;酒精饮料; [adj]激励的;使人兴奋的; [or]gmat;
stimulus: [a]/ˈstɪmjələs/; [n]刺激物;鼓励;促进因素; [or]gmat;
sting: [a]/stɪŋ/; [v]叮;刺疼;使苦闷;蜇; [n](因被刺而引起的)疼痛;(警方为抓捕罪犯精心设计的)圈套; [or]gmat;
stipend: [a]/ˈstaɪpend/; [n]奖学金;固定薪金;定期津贴;养老金; [or]gmat;
stipulate: [a]/ˈstɪpjuleɪt/; [v]规定;保证;保证;要求以.为条件; [or]gmat;
stitch: [a]/stɪtʃ/; [v]缝,绣; [n]一针,线迹;缝法,编结法;(肋部的)突然剧痛;缝合(伤口); [or]gmat;
stock: [a]/stɑːk/; [n]股票;股份;存货;储备;家畜; [v]给..装满;储存; [adj]储备的; [or]gmat;
stockpile: [a]/ˈstɑːkpaɪl/; [n]储备; [v]储备,贮存; [or]gmat;
storefront: [a]/ˈstɔːrfrʌnt/; [n]店面; [adj]临街的; [or]gmat;
strain: [a]/streɪn/; [n]负担;紧张;拉力;(生物体)品种,种类; [v]拉紧;劳累;过分使用; [or]gmat;
strait: [a]/streɪt/; [n]海峡;窘迫; [or]gmat;
strand: [a]/strænd/; [n](线等的)股,缕;一个组成部分;海滨,河岸,海滩,湖滨; [v]使陷入困境;使滞留,使搁浅; [or]gmat;
strata: [a]/ˈstreɪtə/; [n]层;地层;阶层; [or]gmat;
strategic: [a]/strəˈtiːdʒɪk/; [adj]战略(上)的,对全局有重要意义的,关键的; [or]gmat;
strategy: [a]/ˈstrætədʒi/; [n]谋略,策略,计谋; [or]gmat;
strenuous: [a]/ˈstrenjuəs/; [adj]费力的;奋发的;热心的;艰苦的;紧张的; [or]gmat;
strep throat: [a]/ˌstrep ˈθroʊt/; [n]［医］脓毒性咽喉炎; [or]gmat;
streptomycin: [a]/ˌstreptə'maɪsɪn/; [n]［药］链霉素; [or]gmat;
stride: [a]/straɪd/; [v]大步走;越过;跨越; [vt]大步走过;跨骑在.上; [n]大步;阔步行走的姿势;一大步;跨越;正常的进展; [or]gmat;
strife: [a]/straɪf/; [n]纷争,倾轧; [or]gmat;
string: [a]/strɪŋ/; [n]弦,线,细绳,一系列;一行; [v]串起;悬挂;使紧张; [adj]线的,线织的;由弦乐器组成的; [or]gmat;
stringent: [a]/ˈstrɪndʒənt/; [adj]严厉的;迫切的;银根紧的; [or]gmat;
strive: [a]/straɪv/; [v]斗争;努力,奋斗; [or]gmat;
stroke: [a]/stroʊk/; [n]击打;一击,一次,一举;中风;抚摸;笔画; [v]拭去;轻抚; [or]gmat;
stroll: [a]/stroʊl/; [n]漫步;散步;闲荡;溜达; [vi]散步; [vt]溜达;游荡;在.散步;在.漫步; [or]gmat;
strut: [a]/strʌt/; [n]高视阔步,抗压装置; [v]昂首阔步地走,趾高气昂地走; [or]gmat;
stultify: [a]/ˈstʌltɪfaɪ/; [v]使显得愚蠢,愚弄,使无效,使无价值; [or]gmat;
stumble: [a]/ˈstʌmbl/; [v]绊跌,绊倒;结结巴巴说话; [n]绊倒;失足;失误;失败; [or]gmat;
stumbling block: [a]/ˈstʌmblɪŋ blɑːk/; [n]障碍物,绊脚石; [or]gmat;
stun: [a]/stʌn/; [v]使昏迷,使发愣; [or]gmat;
stunt: [a]/stʌnt/; [n]惊人表演,特技;矮小的人(或物); [v]阻碍..发育;作惊人表演;使绝招; [or]gmat;
sturdy: [a]/ˈstɜːrdi/; [adj]结实的;坚固的;强壮的;健壮的; [n](羊的)晕倒病; [or]gmat;
subconscious: [a]/ˌsʌbˈkɑːnʃəs/; [adj]下意识的; [n]潜意识; [or]gmat;
subcontract: [a]/ˌsʌbˈkɑːntrækt/; [n]转包合同,分包合同; [v]承作,转包; [or]gmat;
subdue: [a]/səbˈduː/; [v]征服,压制,减轻; [or]gmat;
subject: [a]/ˈsʌbdʒɪkt/; [n]科目;主题;受试者;国民; [adj]易患的,服从的; [vt]使服从,使隶属,使遭遇; [or]gmat;
submarine: [a]/ˈsʌbməriːn/; [n]潜水艇; [adj]水底的,海底的; [or]gmat;
submit: [a]/səbˈmɪt/; [v]提交;屈服,使...服从;建议,主张; [or]gmat;
subordinate: [a]/səˈbɔːrdɪnət/; [n]部下;下属; [adj]次要的;从属的;下级的; [v]使从属于;使处于次要地位; [or]gmat;
subscribe: [a]/səbˈskraɪb/; [vi]捐款;订阅;认购(股份); [vt]申请; [or]gmat;
subscriber: [a]/səbˈskraɪbər/; [n]订购者,捐献者; [or]gmat;
subscription: [a]/səbˈskrɪpʃn/; [n]订阅;捐款;签署;同意;会费; [adj]收费的; [or]gmat;
subsequent: [a]/ˈsʌbsɪkwənt/; [adj]随后的; [or]gmat;
subsidiary: [a]/səbˈsɪdieri/; [adj]辅助的,次要的,附属的; [n]子公司,附属机构; [or]gmat;
subsidize: [a]/ˈsʌbsɪdaɪz/; [v]给予补助金; [or]gmat;
subsidy: [a]/ˈsʌbsədi/; [n]补助金,津贴; [or]gmat;
subsistence: [a]/səbˈsɪstəns/; [n]存在,生存;生活; [adj]收成仅够自身口粮的; [or]gmat;
substance: [a]/ˈsʌbstəns/; [n]物质;实质,本质;药物; [or]gmat;
substantiate: [a]/səbˈstænʃieɪt/; [v]证实;使实体化; [or]gmat;
substantive: [a]/səbˈstæntɪv/; [adj]有实质的;大量的;真实的;独立存在的; [n]实词,名词,名词性词组; [or]gmat;
substitute: [a]/ˈsʌbstɪtuːt/; [v]代替; [n]代替者,代用品,替补队员; [or]gmat;
subterfuge: [a]/ˈsʌbtərfjuːdʒ/; [n]托词,借口,诡计; [or]gmat;
subtle: [a]/ˈsʌtl/; [adj]微妙的;敏锐的;不明显的;精细的;狡猾的; [or]gmat;
subtract: [a]/səbˈtrækt/; [v]减少;减去;扣除; [vt]减去; [or]gmat;
succession: [a]/səkˈseʃn/; [n]连续,继续;一连串;继承权; [or]gmat;
succumb: [a]/səˈkʌm/; [v]屈从,屈服,因.死亡(to); [or]gmat;
sue: [a]/suː/; [v]控告,提起诉讼;控告;起诉; [n]女子名(Sue); [or]gmat;
suffice: [a]/səˈfaɪs/; [v]足够; [or]gmat;
sugarcane: [a]/'ʃʊgəˌkeɪn/; [n]甘蔗; [or]gmat;
sulfur: [a]/ˈsʌlfər/; [n]硫磺; [or]gmat;
sultan: [a]/ˈsʌltən/; [n]苏丹(某些伊斯兰国家最高统治者称号); [or]gmat;
summit: [a]/ˈsʌmɪt/; [n]山顶,顶点;(政府间的)峰会; [or]gmat;
superb: [a]/suːˈpɜːrb/; [adj]极好的;壮丽的; [or]gmat;
superficial: [a]/ˌsuːpərˈfɪʃl/; [adj]肤浅的;表面的;微不足道的; [n]表面文章; [or]gmat;
superior: [a]/suːˈpɪriər/; [n]上级,高手; [adj]较高级的,上层的,出众的; [or]gmat;
supersede: [a]/ˌsuːpərˈsiːd/; [v]代替;紧接着而到来; [or]gmat;
superstition: [a]/ˌsuːpərˈstɪʃn/; [n]迷信,盲目恐惧; [or]gmat;
supplement: [a]/ˈsʌplɪmənt/; [n]增补,补充物,保健品;附录; [v]补充; [or]gmat;
supplicant: [a]/ˈsʌplɪkənt/; [n]乞求者,恳求者; [or]gmat;
suppress: [a]/səˈpres/; [v]镇压;禁止发表;抑制(感情等);阻止.的生长; [or]gmat;
suppressant: [a]/səˈpresnt/; [n]抑制药; [adj]制止的,抑制性的,遏抑的; [or]gmat;
supreme: [a]/suːˈpriːm/; [adj]至高的;最重要的;极度的; [or]gmat;
surcharge: [a]/ˈsɜːrtʃɑːrdʒ/; [n]额外费用,过高的要价; [v]追加罚款;使.装载过多;使.负担过重; [or]gmat;
surface: [a]/ˈsɜːrfɪs/; [v]浮上水面;显露; [n]表面,面,水面;外表,外观; [adj]表面的;水面的;外观的;(对高架及地下铁路说的)平地上的; [or]gmat;
surge: [a]/sɜːrdʒ/; [n]波涛汹涌;波动;激增; [v]波浪般汹涌奔腾;激增; [or]gmat;
surgeon: [a]/ˈsɜːrdʒən/; [n]外科医生; [or]gmat;
surpass: [a]/sərˈpæs/; [v]胜过;超出; [or]gmat;
surplus: [a]/ˈsɜːrplʌs/; [adj]过剩的,多余的; [n]过剩,盈余;顺差; [or]gmat;
survey: [a]/ˈsɜːrveɪ/; [n]调查;测量;鉴定; [v]测量,勘测;鉴定;调查; [or]gmat;
susceptibility: [a]/səˌseptəˈbɪləti/; [n]易感性的,敏感性,感情; [or]gmat;
susceptible: [a]/səˈseptəbl/; [adj]易受感染的;易受影响的;多情的; [or]gmat;
suspect: [a]/səˈspekt/; [n]嫌疑犯,可疑分子; [v]怀疑,猜疑;推测; [adj]可疑的; [or]gmat;
suspicion: [a]/səˈspɪʃn/; [n]怀疑,猜疑,疑心;少许; [or]gmat;
sustain: [a]/səˈsteɪn/; [v]维持;支撑,承受;供养;忍受;遭受,蒙受; [or]gmat;
sustenance: [a]/ˈsʌstənəns/; [n]生计;食物,粮食; [or]gmat;
swell: [a]/swel/; [v](使)膨胀,(使)鼓起; [n]增大,膨胀,肿胀,汹涌; [adj]时髦的;一流的;很好的; [or]gmat;
swiftly: [a]/ˈswɪftli/; [adv]迅速地,敏捷地; [or]gmat;
switch: [a]/swɪtʃ/; [n]开关;转变;转向;转辙器; [v]转换,转变;调换;转移;打开,关上; [vt]交换; [or]gmat;
syllable: [a]/ˈsɪləbl/; [n]音节; [or]gmat;
symbiotic: [a]/ˌsɪmbaɪˈɑːtɪk/; [adj]<生态>共栖的;共生的; [or]gmat;
symmetrical: [a]/sɪˈmetrɪkl/; [adj]对称的; [or]gmat;
sympathetic: [a]/ˌsɪmpəˈθetɪk/; [adj]有同情心的,同情的;支持的;称心的; [or]gmat;
symptom: [a]/ˈsɪmptəm/; [n]症状;征兆; [or]gmat;
syndicate: [a]/ˈsɪndɪkət/; [n]辛迪加;企业联合;财团; [v]联合成辛迪加;组成企业联合组织;在多家报刊上同时发表; [or]gmat;
syndrome: [a]/ˈsɪndroʊm/; [n]［医］综合征;一系列表现; [or]gmat;
synonymous: [a]/sɪˈnɑːnɪməs/; [adj]同义的;同义词的;同义突变的; [or]gmat;
synthesis: [a]/ˈsɪnθəsɪs/; [n]合成; [or]gmat;
synthesize: [a]/ˈsɪnθəsaɪz/; [v]<化>合成;综合;人工合成; [or]gmat;
tablet: [a]/ˈtæblət/; [n]药片;便笺簿;碑,匾; [or]gmat;
taboo: [a]/təˈbuː/; [n]禁忌,(宗教)戒律; [adj](因不道德或危险而)讳忌的,戒律的; [or]gmat;
tack: [a]/tæk/; [n]平头钉;行动步骤; [v]钉住;使(船)抢风转变航向; [or]gmat;
tactic: [a]/ˈtæktɪk/; [n](达到目的)手段,战术,策略; [adj]按顺序的;依次排列的; [or]gmat;
tactical: [a]/ˈtæktɪkl/; [adj]手段的,战术的; [or]gmat;
tactile: [a]/ˈtæktl/; [adj]有触觉的;能触知的; [or]gmat;
tag: [a]/tæɡ/; [n]附加语;标签; [v]装包头于(鞋带等);加标签于;连接,合并; [or]gmat;
take issue with: [a]/teɪk ˈɪʃu wɪθ/; quant. 与...争论;对...提出异议; [or]gmat;
take issue: [a]/teɪk ˈɪʃu/; [v]就某事与某人争论; [or]gmat;
take over: [a]/teɪk ˈoʊvər/; [phr]接收,接管,接任,夺取; [or]gmat;
take precedence over: [a]/teɪk ˈpresɪdəns ˈoʊvər/; [phr]优先于..,地位在..之上; [or]gmat;
takeover: [a]/ˈteɪkoʊvər/; [n]接收,接管,接任;收买; [or]gmat;
tally: [a]/ˈtæli/; [n]计数器;标签;记账;完全相似; [v]使符合;计算;记录;一致; [or]gmat;
tamarind: [a]/ˈtæmərɪnd/; [n]［植］罗望子树,罗望子果(味酸,常做清凉轻泻剂用); [or]gmat;
tamper: [a]/ˈtæmpər/; [v]篡改;玩弄;贿赂; [n]填塞者;捣棒; [or]gmat;
tangent: [a]/ˈtændʒənt/; [n]切线; [adj]无关的; [or]gmat;
tariff: [a]/ˈtærɪf/; [n]关税,价目表; [vt]征收关税;定税率;定收费标准; [or]gmat;
tartan: [a]/ˈtɑːrtn/; [n]单桅三角帆船,格子花,格子织物; [adj]格子花呢的; [or]gmat;
tease: [a]/tiːz/; [v]取笑;挑逗;逗弄;使..渴望;逆梳; [n]爱戏弄别人者; [or]gmat;
technocrat: [a]/ˈteknəkræt/; [n]技术人员,技术统治; [or]gmat;
tedious: [a]/ˈtiːdiəs/; [adj]沉闷的,冗长乏味的; [or]gmat;
teem: [a]/tiːm/; [vi]充满;大量存在于; [vt]生下; [or]gmat;
temperance: [a]/ˈtempərəns/; [n]自制;节制;禁酒; [or]gmat;
temperate: [a]/ˈtempərət/; [adj]温和的;适度的,有节制的; [or]gmat;
tempo: [a]/ˈtempoʊ/; [n]<音>节奏,拍子;行进速度; [or]gmat;
temporary: [a]/ˈtempəreri/; [adj]暂时的,临时的; [or]gmat;
tempt: [a]/tempt/; [v]诱惑;吸引;冒..的风险,不顾; [or]gmat;
tenant: [a]/ˈtenənt/; [n]承租人,租客,佃户; [or]gmat;
tenet: [a]/ˈtenɪt/; [n]信念,原则,教条; [or]gmat;
tenor: [a]/ˈtenər/; [n]男高音,要点,要旨,稳定的进程; [adj](乐器)次中音的;(组钟中的)最低音的;男高音的; [or]gmat;
tentative: [a]/ˈtentətɪv/; [adj]试探性的;不确定的;暂时的;犹豫不决的; [or]gmat;
tenure: [a]/ˈtenjər/; [n]任期;终身职位; [or]gmat;
terminate: [a]/ˈtɜːrmɪneɪt/; [adj]终止的;可结尾的; [vi]结束;结尾; [v]使结束,终止; [or]gmat;
terminology: [a]/ˌtɜːrməˈnɑːlədʒi/; [n]术语,术语学; [or]gmat;
termite: [a]/ˈtɜːrmaɪt/; [n]白蚁; [or]gmat;
terra-cotta: [a]/ˌterəˈkɑtə/; [n]赤土,赤陶,一种带褐色的柑子; [or]gmat;
terrain: [a]/təˈreɪn/; [n]地面,地形; [or]gmat;
terrestrial: [a]/təˈrestriəl/; [adj]地球的,陆地的; [n]陆地生物;地球上的人; [or]gmat;
territory: [a]/ˈterətɔːri/; [n]地区,领土;版图;领域;范围;属地; [or]gmat;
terrorism: [a]/ˈterərɪzəm/; [n]恐怖主义; [or]gmat;
terse: [a]/tɜːrs/; [adj]简洁的,简明的; [or]gmat;
testify: [a]/ˈtestɪfaɪ/; [vt]作证; [vi]证明; [v]声明;见证(上帝的存在);证实; [or]gmat;
testimony: [a]/ˈtestɪmoʊni/; [n]证据,证词;表明,说明;见证,证明; [or]gmat;
theme: [a]/θiːm/; [n]主题;主旨;主旋律; [adj]主题的; [v]赋予.某种主题; [or]gmat;
therapy: [a]/ˈθerəpi/; [n]治疗,理疗;疗法; [or]gmat;
thermal: [a]/ˈθɜːrml/; [adj]保暖的;温泉的;热的; [n]保暖内衣裤; [or]gmat;
threshold: [a]/ˈθreʃhoʊld/; [n]门槛;开端; [or]gmat;
thrive: [a]/θraɪv/; [v]茁壮成长;繁荣,兴旺; [or]gmat;
throne: [a]/θroʊn/; [n]王座;君主; [or]gmat;
thwart: [a]/θwɔːrt/; [n]<船>横坐板; [v]阻挠,阻碍,横过; [adj]横放的; [adv]横过; prep. 〈古〉横跨,横过; [or]gmat;
thyroid: [a]/ˈθaɪrɔɪd/; [adj]［解］甲状腺的; [n]甲状腺; [or]gmat;
tickle: [a]/ˈtɪkl/; [v]呵.痒,使发痒;使高兴; [n]痒; [or]gmat;
tile: [a]/taɪl/; [n]瓦;瓷砖; [v]贴砖于;用瓦盖; [or]gmat;
tilt: [a]/tɪlt/; [v](使)倾斜; [n]倾斜,斜坡; [or]gmat;
timber: [a]/ˈtɪmbər/; [n]木料;树木;性格,素质; excl. 树要倒啦!; [adj]木材的,木制的; [v]用木材作骨架;以林木覆盖; [or]gmat;
tinge: [a]/tɪndʒ/; [n]淡淡的(颜色,神色),轻微,少量; [v]给.染色,轻微地影响; [or]gmat;
tinker: [a]/ˈtɪŋkər/; [n](流动的)补锅工人; [v]做拙劣修补; [or]gmat;
tissue: [a]/ˈtɪʃuː/; [n]面巾纸,(动植物的)组织,纱布; [or]gmat;
toddler: [a]/ˈtɑːdlər/; [n]蹒跚而行的人,学步小孩; [or]gmat;
tonality: [a]/toʊˈnæləti/; [n]音质,音调; [or]gmat;
topographical: [a]/ˌtɑːpəˈɡræfɪkl/; [adj]地形的,地形学的,地形测量的; [or]gmat;
topple: [a]/ˈtɑːpl/; [v]摇摇欲坠,推翻,颠覆; [or]gmat;
topsoil: [a]/ˈtɑːpsɔɪl/; [n]表层土;上层土; [v]去掉表土; [or]gmat;
tortillas: [a]/tɔ'tijəz/; [n](墨西哥人用以代替面包的)未经发酵的玉米饼; [or]gmat;
torture: [a]/ˈtɔːrtʃər/; [v]对.施以酷刑,拷问,折磨; [n]酷刑,折磨; [adj]遭受重创的;饱受煎熬的; [or]gmat;
total: [a]/ˈtoʊtl/; [adj]完全的;整个的,总体的; [n]总数,总额; [or]gmat;
totalitarian: [a]/toʊˌtæləˈteriən/; [n]极权主义者; [adj]极权主义的; [or]gmat;
tout: [a]/taʊt/; [v]招徕顾客,极力赞扬; [or]gmat;
toxic: [a]/ˈtɑːksɪk/; [n]毒物; [adj]有毒的;中毒的; [or]gmat;
toxin: [a]/ˈtɑːksɪn/; [n]毒素,毒质; [or]gmat;
tract: [a]/trækt/; [n]器官系统;一大片地;短文,小册子; [or]gmat;
trade off: [a]/treɪd ɑf/; [v]交替换位,通过交换抛掉,权衡; [or]gmat;
tragedy: [a]/ˈtrædʒədi/; [n]悲剧; [or]gmat;
trait: [a]/treɪt/; [n]特征; [or]gmat;
traitorous: [a]/ˈtreɪtərəs/; [adj]叛徒的,不忠的,卖国贼的,奸诈的; [or]gmat;
trajectory: [a]/trəˈdʒektəri/; [n]弹道,航线;轨线; [or]gmat;
transcribe: [a]/trænˈskraɪb/; [v]抄写,转录; [or]gmat;
transfer: [a]/trænsˈfɜːr/; [v]转移;调任;换乘;转变;改编; [n]转让;转移;调任;汇兑; [or]gmat;
transform: [a]/trænsˈfɔːrm/; [v]将..变形,改变,转换; [or]gmat;
transistor: [a]/trænˈzɪstər/; [n]晶体管;半导体收音机; [or]gmat;
transit: [a]/ˈtrænzɪt/; [n]运输;运送; [v]运送;通过; [or]gmat;
transmit: [a]/trænsˈmɪt/; [v]传送;传播,传导;发射; [or]gmat;
transmitter: [a]/trænsˈmɪtər/; [n]传送者,送话器;发射机;发射台;话筒; [or]gmat;
transplant: [a]/trænsˈplænt/; [n]移种;移植; [v]移植(器官),使移居,移种(植物等); [or]gmat;
transport: [a]/ˈtrænspɔːrt/; [v]运输;使狂喜;流放; [n]运输;运输工具;流放犯; [or]gmat;
trapezium: [a]/trəˈpiːziəm/; [n](英)梯形,(美)不规则四边形; [or]gmat;
trauma: [a]/ˈtraʊmə/; [n]精神创伤,外伤; [or]gmat;
traverse: [a]/trəˈvɜːrs/; [v]横越;穿过; [n]横越; [or]gmat;
treasury: [a]/ˈtreʒəri/; [n]国库,金库;财政部;宝库; [or]gmat;
treaty: [a]/ˈtriːti/; [n]条约;协议;协定; [or]gmat;
tremendous: [a]/trəˈmendəs/; [adj]巨大的;极大的;惊人的; [or]gmat;
trench: [a]/trentʃ/; [n]沟;壕沟,战壕;海沟; [or]gmat;
trenchant: [a]/ˈtrentʃənt/; [adj]犀利的,锐利的,有力的,清晰的,一针见血的; [or]gmat;
triangle: [a]/ˈtraɪæŋɡl/; [n]三角形; [or]gmat;
tribal: [a]/ˈtraɪbl/; [adj]部落的; [n]部落成员; [or]gmat;
tribute: [a]/ˈtrɪbjuːt/; [n]致敬;悼念;贡品;称赞; [or]gmat;
trigger: [a]/ˈtrɪɡər/; [n](枪等的)扳机,诱因; [v]触发,引起,激发,扣扳机; [or]gmat;
trim: [a]/trɪm/; [n]修剪;整齐;装饰; [v]修剪;整理;装饰; [adj](人)苗条的;整洁的; [adv]整齐<整洁>地; [or]gmat;
triple: [a]/ˈtrɪpl/; [v]使成三倍,三倍于; [adj]三倍的; [or]gmat;
trite: [a]/traɪt/; [adj]陈腐的;平庸的;老一套的; [or]gmat;
triumph: [a]/ˈtraɪʌmf/; [n]喜悦,狂喜;凯旋,胜利; [v]成功,获胜; [or]gmat;
tropical: [a]/ˈtrɑːpɪkl/; [adj]热带的; [or]gmat;
truce: [a]/truːs/; [n]停战;休战;休战协定; [or]gmat;
tuberculosis: [a]/tuːˌbɜːrkjəˈloʊsɪs/; [n]肺结核; [or]gmat;
tuition: [a]/tuˈɪʃn/; [n]学费,教学,讲授; [or]gmat;
tumble: [a]/ˈtʌmbl/; [v]翻滚;不由自主地卷入;(价格等)暴跌;跌倒,摔下,滚下; [n]跌倒,摔倒; [or]gmat;
turbine: [a]/ˈtɜːrbaɪn/; [n]汽轮机,叶轮机; [or]gmat;
turbulent: [a]/ˈtɜːrbjələnt/; [adj]湍急的;混乱的,动荡的;骚动的; [or]gmat;
turmoil: [a]/ˈtɜːrmɔɪl/; [n]骚动,骚乱; [or]gmat;
turn down: [a]/tɜrn daʊn/; [phr]拒绝;调低;关小; [or]gmat;
turnover: [a]/ˈtɜːrnoʊvər/; [n]成交量;营业收入;人员更替率;半圆卷饼; [or]gmat;
tyrannical: [a]/tɪˈrænɪkl/; [adj]暴君的,专制的,残酷的; [or]gmat;
ultimate: [a]/ˈʌltɪmət/; [adj]根本的;最后的,最终的; [or]gmat;
unbridled: [a]/ʌnˈbraɪdld/; [adj]无拘束的;激烈的;放纵的;放纵的,无约束的; [or]gmat;
undercut: [a]/ˌʌndərˈkʌt/; [v]廉价出售;较便宜的工资工作;从下边削球; [n]底切;牛腰部下侧嫩肉;砍口;切球; [adj]下部被削去[切去,挖掉,凿去]的; [or]gmat;
undergo: [a]/ˌʌndərˈɡoʊ/; [v]经历;遭受; [or]gmat;
underlie: [a]/ˌʌndərˈlaɪ/; [v]位于..之下;成为..的基础; [or]gmat;
underline: [a]/ˌʌndərˈlaɪn/; [v]划线于.之下;突出显示;强调; [n]下划线;下期节目预告;图下说明文字; [or]gmat;
underlying: [a]/ˌʌndərˈlaɪɪŋ/; [adj]基本的;潜在的;在下面的; [or]gmat;
undermine: [a]/ˌʌndərˈmaɪn/; [v]暗中破坏;逐渐削弱;侵蚀.的基础;在...下挖坑道,从根基处损害; [or]gmat;
underscore: [a]/ˌʌndərˈskɔːr/; [v]强调,加强,划线于.下; [n]底线; [or]gmat;
undertake: [a]/ˌʌndərˈteɪk/; [v]保证;承担,承包; [or]gmat;
underwrite: [a]/ˌʌndərˈraɪt/; [v]给.保险,承诺支付;同意赔款(海上保险); [or]gmat;
undue: [a]/ˌʌnˈduː/; [adj]过分的,不适当的;过度的;尚未到期的; [or]gmat;
unearth: [a]/ʌnˈɜːrθ/; [vt]发掘,掘出,揭露,发现;揭发; [or]gmat;
uneven: [a]/ʌnˈiːvn/; [adj]不平坦的;不均匀的,不规则的;不公正的; [or]gmat;
unification: [a]/ˌjuːnɪfɪˈkeɪʃn/; [n]统一,联合,一致; [or]gmat;
uniform: [a]/ˈjuːnɪfɔːrm/; [n]制服,军服; [adj]相同的,一致的,统一的; [or]gmat;
unique: [a]/juˈniːk/; [adj]独特的,独一无二的;(唯一的)特有的;不同寻常的; [or]gmat;
unison: [a]/ˈjuːnɪsn/; [n]一致,(音)齐唱; [adj]同音的; [or]gmat;
universality: [a]/ˌjuːnɪvɜːrˈsæləti/; [n]普遍性,一般性; [or]gmat;
unobtrusive: [a]/ˌʌnəbˈtruːsɪv/; [adj]不唐突的,谦虚的,不引人注目的; [or]gmat;
unparalleled: [a]/ʌnˈpærəleld/; [adj]无比的,无双的,空前的; [or]gmat;
unprecedented: [a]/ʌnˈpresɪdentɪd/; [adj]前所未有的,空前的,无前例的; [or]gmat;
unscrupulous: [a]/ʌnˈskruːpjələs/; [adj]肆无忌惮的,无天理的; [or]gmat;
unsubstantiated: [a]/ˌʌnsəbˈstænʃieɪtɪd/; [adj]未经证实的,无事实根据的; [or]gmat;
untenable: [a]/ʌnˈtenəbl/; [adj]防守不住的,站不住脚的; [or]gmat;
unwarranted: [a]/ʌnˈwɔːrəntɪd/; [adj]未经保证的,无根据的,不合适的; [or]gmat;
unwieldy: [a]/ʌnˈwiːldi/; [adj]使用不便的,不灵巧的,难处理的;笨重的; [or]gmat;
unwitting: [a]/ʌnˈwɪtɪŋ/; [adj]不知情的;无意的; [or]gmat;
updrafts: [a]/ˈəpˌdræfts/; [n]向上排气,通风; [or]gmat;
upgrade: [a]/ˈʌpɡreɪd/; [v]升级;提高; [n]改善,提高;升级;升舱; [or]gmat;
upheaval: [a]/ʌpˈhiːvl/; [n]动乱,大变动; [or]gmat;
upsurge: [a]/ˈʌpsɜːrdʒ/; [n]高潮,高涨; [or]gmat;
upturn: [a]/ˈʌptɜːrn/; [n]情况好转; [v]朝上,向上;翻转; [or]gmat;
uranium: [a]/juˈreɪniəm/; [n]铀; [or]gmat;
urbanize: [a]/'ɜːbənˌaɪz/; [v]使都市化;使文雅; [or]gmat;
urchin: [a]/ˈɜːrtʃɪn/; [n]海胆,刺猬,小淘气,顽童; [or]gmat;
urine: [a]/ˈjʊrən/; [n]尿; [or]gmat;
usurp: [a]/juːˈzɜːrp/; [vi]篡夺,篡位; [vt]篡夺,强夺; [or]gmat;
utensil: [a]/juːˈtensl/; [n]工具,(厨房)用具; [or]gmat;
utilize: [a]/ˈjuːtəlaɪz/; [v]利用;使用; [or]gmat;
vacancy: [a]/ˈveɪkənsi/; [n]空,空白,空房;(职位)空缺;空虚; [or]gmat;
vacant: [a]/ˈveɪkənt/; [adj]空的,未被占用的;闲置的;空缺的;茫然的; [or]gmat;
vaccine: [a]/vækˈsiːn/; [n]牛痘苗,疫苗; [adj]牛痘的;预防疫苗的;种痘的; [or]gmat;
vacuum: [a]/ˈvækjuəm/; [n]真空吸尘器;真空;空虚,茫然若失; [v]用吸尘器打扫; [or]gmat;
vague: [a]/veɪɡ/; [adj]含糊的,模糊的,不明确的,茫然的; [n]模糊不定状态; [or]gmat;
valance: [a]/ˈvæləns/; [n]窗帘上部的框架,帷幔,挂布; [or]gmat;
validity: [a]/vəˈlɪdəti/; [n]正确(性);有效(性),效力; [or]gmat;
vanity: [a]/ˈvænəti/; [n]自负;无价值的东西;(带镜子的)梳妆台; [or]gmat;
variable: [a]/ˈveriəbl/; [adj]易变的,可变的; [n]变量,可变物; [or]gmat;
varicose: [a]/'værɪˌkoʊs/; [adj]［医］静脉曲张的,治疗静脉曲张用的; [or]gmat;
various: [a]/ˈveriəs/; [adj]各种各样的;不同的; [or]gmat;
vascular: [a]/ˈvæskjələr/; [adj]血管的,脉管的; [or]gmat;
vector: [a]/ˈvektər/; [n]<数>向量;矢量;带菌者; [or]gmat;
vegetarian: [a]/ˌvedʒəˈteriən/; [n]吃素的人; [adj]素食的; [or]gmat;
vegetation: [a]/ˌvedʒəˈteɪʃn/; [n]植被; [or]gmat;
vehement: [a]/ˈviːəmənt/; [adj]猛烈的,强烈的; [or]gmat;
vein: [a]/veɪn/; [n]静脉;血管;叶脉;纹理;迹象;风格,性情; [or]gmat;
velocity: [a]/vəˈlɑːsəti/; [n]速度;迅速,快速; [or]gmat;
velvet: [a]/ˈvelvɪt/; [n]天鹅绒;鹿茸的嫩皮; [adj]天鹅绒的; [or]gmat;
vendor: [a]/ˈvendər/; [n]小贩,卖主,供应商; [or]gmat;
veneer: [a]/vəˈnɪr/; [n](镶于劣质东西上的)镶面板;掩饰; [v]虚饰;给.镶以饰片; [or]gmat;
venerable: [a]/ˈvenərəbl/; [adj]令人尊敬的;(因历史悠久而) 神圣庄严的; [or]gmat;
vengeance: [a]/ˈvendʒəns/; [n]复仇,报仇; [or]gmat;
venom: [a]/ˈvenəm/; [n]毒液;恶意;怨恨; [vt]使有毒;放毒; [or]gmat;
vent: [a]/vent/; [n]发泄;通风口,排气口;(上衣背部或两侧的)开衩;(小型动物的)排泄口; [v]发泄(情绪),开孔,泄露; [or]gmat;
venture: [a]/ˈventʃər/; [n]企业;(商业)冒险;投机,风险投资; [vi]冒险前进; [vt]冒.的危险;以.做赌注; [or]gmat;
verdict: [a]/ˈvɜːrdɪkt/; [n](陪审团)裁决;定论;意见; [or]gmat;
verge: [a]/vɜːrdʒ/; [n]边缘;边界; [v]接近;濒临; [or]gmat;
verify: [a]/ˈverɪfaɪ/; [v]查证,证明,证实; [or]gmat;
verisimilitude: [a]/ˌverɪsɪˈmɪlɪtuːd/; [n]逼真,真实性; [or]gmat;
vernacular: [a]/vərˈnækjələr/; [adj]本国的,地方的,用本地语写成的; [n]方言;土语;(建筑的)民间风格; [or]gmat;
versatility: [a]/ˌvɜːrsəˈtɪləti/; [n]多功能;多用途; [or]gmat;
version: [a]/ˈvɜːrʒn/; [n]版本;译文;(某人对于某件事不同于其他人的)描述,说法; [or]gmat;
vertebrate: [a]/ˈvɜːrtɪbrət/; [adj]有脊椎的; [n]脊椎动物; [or]gmat;
vessel: [a]/ˈvesl/; [n]船,容器,血管; [or]gmat;
vestige: [a]/ˈvestɪdʒ/; [n]遗迹,(生)退化的器官,残余,微量(一般用于否定句); [or]gmat;
veteran: [a]/ˈvetərən/; [n]老兵;退役军人; [adj]经验丰富的;老练的; [or]gmat;
viable: [a]/ˈvaɪəbl/; [adj]可行的;能养活的;能生育的; [or]gmat;
vicinity: [a]/vəˈsɪnəti/; [n]附近地区;近邻;附近; [or]gmat;
vicious: [a]/ˈvɪʃəs/; [adj]罪恶的;恶意的;凶猛的,残忍的; [or]gmat;
victim: [a]/ˈvɪktɪm/; [n]牺牲品,受害者,替罪羊; [or]gmat;
victor: [a]/ˈvɪktər/; [n]胜利者; [adj]胜利者的; [or]gmat;
villainy: [a]/ˈvɪləni/; [n]邪恶,恶行,腐化堕落,道德败坏,(复)犯罪行为; [or]gmat;
vine: [a]/vaɪn/; [n]藤,蔓; [or]gmat;
vintner: [a]/ˈvɪntnər/; [n]葡萄酒商; [or]gmat;
vinyl: [a]/ˈvaɪnl/; [n]［化］乙烯基,塑料; [or]gmat;
viola: [a]/viˈoʊlə/; [n]中提琴; [or]gmat;
violate: [a]/ˈvaɪəleɪt/; [v]违反,违背;侵犯,妨碍;亵渎; [or]gmat;
virgin: [a]/ˈvɜːrdʒɪn/; [n]处女;处男;贞女; [adj]处女的; [or]gmat;
virtuoso: [a]/ˌvɜːrtʃuˈoʊsoʊ/; [n]艺术品鉴赏家,古董收藏家,艺术大师; [adj]行家里手的,艺术爱好者的; [or]gmat;
virtuous: [a]/ˈvɜːrtʃuəs/; [adj]善良的,有德行的,贞洁的; [or]gmat;
viscosity: [a]/vɪˈskɑːsəti/; [n]黏性;黏度; [or]gmat;
visionary: [a]/ˈvɪʒəneri/; [n]有远见的人;幻想家; [adj]有远见的;爱幻想的; [or]gmat;
visual: [a]/ˈvɪʒuəl/; [adj]看的,视觉的; [n]视觉资料(指说明性的图片,影片等); [or]gmat;
vitriolic: [a]/ˌvɪtriˈɑːlɪk/; [adj]刻薄的,强烈的,硫酸(盐)的,由硫酸制成的; [or]gmat;
vocal: [a]/ˈvoʊkl/; [n]声乐作品; [adj]畅言无忌的;声音的; [or]gmat;
volatile: [a]/ˈvɑːlətl/; [adj]易气化的;爆炸性的;反复无常的;短暂的;不稳定的; [or]gmat;
voluminous: [a]/vəˈluːmɪnəs/; [adj]大量的;长篇的,多产的;庞大的; [adv]宽松地;容量大地;篇幅长地; [n]宽松;容量大,篇幅长; [or]gmat;
wage: [a]/weɪdʒ/; [n]薪水,报酬; [v]开展,进行(战争,运动); [or]gmat;
warrior: [a]/ˈwɔːriər/; [n]战士,武士,勇士; [or]gmat;
wary: [a]/ˈweri/; [adj]谨慎的,小心的,提防的;考虑周到的; [or]gmat;
wayside: [a]/ˈweɪsaɪd/; [n]路边; [adj]路边的; [or]gmat;
wedge-shaped: [a]/'wedʒˌʃeɪpt/; [adj]楔形的;v字形的; [or]gmat;
weld: [a]/weld/; [v]焊接;使结合,使成整体; [n]焊接; [or]gmat;
welfare: [a]/ˈwelfer/; [n]福利;幸福,健康; [or]gmat;
well-being: [a]/ˈwel biːɪŋ/; [n]健康,幸福,福利; [or]gmat;
whim: [a]/wɪm/; [n]一时的兴致,心血来潮,奇想,幻想; [or]gmat;
whirl: [a]/wɜːrl/; [v]回旋;使旋转; [n]回旋;一个接一个的活动; [or]gmat;
whirligig: [a]/ˈwɜːrliɡɪɡ/; [n]旋转玩具,循环变迁; [or]gmat;
whisker: [a]/ˈwɪskər/; [n]胡须;腮须; [or]gmat;
whole number: [a]/ˌhoʊl ˈnʌmbər/; [phr]整数; [or]gmat;
wholesale: [a]/ˈhoʊlseɪl/; [n]批发; [adv]大批大批地; [adj]大规模的;批发的; [v]批发; [or]gmat;
width: [a]/wɪdθ/; [n]宽度,广度,宽阔; [or]gmat;
wield: [a]/wiːld/; [v]运用,行使;挥; [vt]使用; [or]gmat;
wig: [a]/wɪɡ/; [n]假发;呵斥; [v]呵斥; [adj]戴假发的; [or]gmat;
willy-nilly: [a]/ˌwɪli ˈnɪli/; [adj]犹豫不决的,不容分辨的,随意的; [adv]乱七八糟地,不管愿不愿意地; [or]gmat;
windshield: [a]/ˈwɪndʃiːld/; [n]挡风玻璃; [or]gmat;
wingspan: [a]/ˈwɪŋspæn/; [n]翼展(相当wingspread); [or]gmat;
withdraw: [a]/wɪðˈdrɔː/; [v]取款;撤退,收回,撤离; [or]gmat;
wither: [a]/ˈwɪðər/; [v]枯萎;凋谢; [vt]使枯萎,使凋谢,萎缩;使人感觉羞惭或迷惑; [or]gmat;
withstand: [a]/wɪðˈstænd/; [v]忍受;抵挡; [or]gmat;
womb: [a]/wuːm/; [n]子宫,发源地; [vi]容纳; [vt]容纳; [or]gmat;
wrap: [a]/ræp/; [v]裹,包,捆;覆盖; [n]包裹物,覆盖物;外衣; [or]gmat;
wreak: [a]/riːk/; [v]实施(报复);造成(破坏或混乱); [or]gmat;
wreath: [a]/riːθ/; [n]花圈;花环;圈状物; [or]gmat;
wreck: [a]/rek/; [n]沉船,失事船;失事;(事故中)遭严重损坏的汽车(飞机等); [v]破坏,使毁灭; [or]gmat;
wrestle: [a]/ˈresl/; [v]摔跤,角斗;斗争,努力; [n]摔跤,角力,扭斗; [or]gmat;
wristband: [a]/ˈrɪstbænd/; [n](衬衫等的)袖口,腕套,手表带; [or]gmat;
xenophobia: [a]/ˌzenəˈfoʊbiə/; [n]仇外,对外国人的恐惧或憎恨; [or]gmat;
yeast: [a]/jiːst/; [n]酵母,发酵物;兴奋; [or]gmat;
yield: [a]/jiːld/; [v]出产;屈服;弯曲;让行; [n]收益; [or]gmat;
zing: [a]/zɪŋ/; [n](子弹等的)尖啸声,精力,省略; [v]对.挑剔,发尖啸声; [or]gmat;
zoning: [a]/ˈzoʊnɪŋ/; [n]分区制,都市的区域划分; [or]gmat;
zoom: [a]/zuːm/; [v](镜头)拉近(拉远);急速上升,嗡嗡作响; [n]车辆疾驰的声音,嗡嗡声,(摄影)变焦; [or]gmat;
